block,genome,chr/contig,start,end,orientation,length
244,BUMA.1121.00042,2,120845,128674,+,7829
244,BUMA.1121.00026,2,127848,135677,-,7829
243,BUMA.1121.00042,1,1724491,1756949,+,32458
243,BUMA.1121.00026,1,3149741,3182167,+,32426
242,BUMA.1121.00087,2,2077448,2085775,+,8327
242,BUMA.1121.00086,2,1810285,1818612,+,8327
242,BUMA.1121.00034,2,434232,442560,-,8328
242,BUMA.1121.00017,2,434198,442526,-,8328
242,BUMA.1121.00042,2,517668,525981,-,8313
242,BUMA.1121.00036,2,2130282,2138610,-,8328
242,BUMA.1121.00013,2,2014162,2022489,+,8327
242,BUMA.1121.00028,2,434158,442486,-,8328
242,BUMA.1121.00004,2,434199,442527,-,8328
242,BUMA.1121.00008,2,434044,442372,-,8328
242,BUMA.1121.00022,2,1002390,1010717,+,8327
242,BUMA.1121.00024,2,434076,442404,-,8328
242,BUMA.1121.00032,2,858520,866848,-,8328
242,BUMA.1121.00019,2,434143,442471,-,8328
242,BUMA.1121.00044,2,485348,493676,-,8328
242,BUMA.1121.00030,2,1679241,1687568,+,8327
242,BUMA.1121.00020,2,434179,442507,-,8328
241,BUMA.1121.00087,2,1214998,1220452,+,5454
241,BUMA.1121.00086,2,947501,952955,+,5454
241,BUMA.1121.00034,2,630699,636153,+,5454
241,BUMA.1121.00017,2,630671,636125,+,5454
241,BUMA.1121.00002,2,1182064,1187518,+,5454
241,BUMA.1121.00042,2,984732,990174,-,5442
241,BUMA.1121.00036,2,199279,204733,+,5454
241,BUMA.1121.00028,2,656796,662250,+,5454
241,BUMA.1121.00010,2,2037907,2043361,+,5454
241,BUMA.1121.00004,2,721343,726797,+,5454
241,BUMA.1121.00008,2,720623,726077,+,5454
241,BUMA.1121.00022,2,140154,145608,+,5454
241,BUMA.1121.00026,2,1271686,1277140,+,5454
241,BUMA.1121.00024,2,656736,662191,+,5455
241,BUMA.1121.00024,2,750663,756115,+,5452
241,BUMA.1121.00032,2,1123322,1128776,+,5454
241,BUMA.1121.00019,2,721328,726782,+,5454
241,BUMA.1121.00044,2,681813,687267,+,5454
241,BUMA.1121.00030,2,1485633,1491088,-,5455
241,BUMA.1121.00020,2,721364,726818,+,5454
240,BUMA.1121.00081,2,1626858,1636010,+,9152
240,BUMA.1121.00006,2,687504,696656,-,9152
240,BUMA.1121.00087,2,2223010,2232162,+,9152
240,BUMA.1121.00040,2,653942,663102,-,9160
240,BUMA.1121.00086,2,722784,731936,-,9152
240,BUMA.1121.00054,2,487654,496805,-,9151
240,BUMA.1121.00034,2,1378014,1387153,+,9139
240,BUMA.1121.00048,2,40852,50004,+,9152
240,BUMA.1121.00017,2,1378007,1387146,+,9139
240,BUMA.1121.00038,2,687539,696691,-,9152
240,BUMA.1121.00042,2,1139959,1149148,+,9189
240,BUMA.1121.00036,2,931406,940558,+,9152
240,BUMA.1121.00013,2,1154070,1163204,-,9134
240,BUMA.1121.00028,2,1404176,1413314,+,9138
240,BUMA.1121.00004,2,1362865,1372003,+,9138
240,BUMA.1121.00008,2,1362189,1371327,+,9138
240,BUMA.1121.00022,2,2267602,2276754,-,9152
240,BUMA.1121.00026,2,1114031,1123198,-,9167
240,BUMA.1121.00024,2,1497966,1507105,+,9139
240,BUMA.1121.00019,2,1442085,1451224,+,9139
240,BUMA.1121.00044,2,1429115,1438253,+,9138
240,BUMA.1121.00030,2,734644,743782,-,9138
240,BUMA.1121.00020,2,1362950,1372089,+,9139
239,BUMA.1121.00050,2,2306771,2321567,+,14796
239,BUMA.1121.00081,2,1,14732,+,14731
239,BUMA.1121.00006,2,2308814,2323552,-,14738
239,BUMA.1121.00087,2,588465,603204,-,14739
239,BUMA.1121.00040,2,59302,74060,-,14758
239,BUMA.1121.00086,2,1,14733,+,14732
239,BUMA.1121.00054,2,2108906,2123644,-,14738
239,BUMA.1121.00034,2,3258,18032,+,14774
239,BUMA.1121.00048,2,739438,754175,+,14737
239,BUMA.1121.00017,2,3258,18032,+,14774
239,BUMA.1121.00038,2,2210015,2224753,-,14738
239,BUMA.1121.00085,2,1164186,1178924,+,14738
239,BUMA.1121.00002,2,556759,571553,-,14794
239,BUMA.1121.00046,2,1113598,1128375,-,14777
239,BUMA.1121.00042,2,1698212,1712933,-,14721
239,BUMA.1121.00036,2,1581057,1595817,-,14760
239,BUMA.1121.00013,2,430434,445165,+,14731
239,BUMA.1121.00028,2,3258,18032,+,14774
239,BUMA.1121.00010,2,1408648,1423442,-,14794
239,BUMA.1121.00004,2,3258,18032,+,14774
239,BUMA.1121.00015,2,252330,267071,+,14741
239,BUMA.1121.00008,2,3258,18032,+,14774
239,BUMA.1121.00022,2,1544975,1559727,+,14752
239,BUMA.1121.00026,2,602311,617056,+,14745
239,BUMA.1121.00024,2,3258,18032,+,14774
239,BUMA.1121.00052,2,117845,132583,+,14738
239,BUMA.1121.00032,2,548883,563650,+,14767
239,BUMA.1121.00019,2,3258,18025,+,14767
239,BUMA.1121.00044,2,54445,69219,+,14774
239,BUMA.1121.00030,2,2103726,2118501,-,14775
239,BUMA.1121.00020,2,3258,18025,+,14767
238,BUMA.1121.00050,2,2252586,2302216,+,49630
238,BUMA.1121.00081,2,2270783,2320459,+,49676
238,BUMA.1121.00006,2,3110,52786,-,49676
238,BUMA.1121.00087,2,608105,657645,-,49540
238,BUMA.1121.00040,2,77378,126918,-,49540
238,BUMA.1121.00086,2,2298247,2347787,+,49540
238,BUMA.1121.00054,2,2128559,2178233,-,49674
238,BUMA.1121.00034,2,2069370,2118908,+,49538
238,BUMA.1121.00048,2,684847,734523,+,49676
238,BUMA.1121.00017,2,2069365,2118903,+,49538
238,BUMA.1121.00038,2,3110,52786,-,49676
238,BUMA.1121.00085,2,1111314,1160871,+,49557
238,BUMA.1121.00002,2,576457,625976,-,49519
238,BUMA.1121.00046,2,1132930,1182560,-,49630
238,BUMA.1121.00042,2,1717844,1767353,-,49509
238,BUMA.1121.00036,2,1600718,1650267,-,49549
238,BUMA.1121.00013,2,377548,427117,+,49569
238,BUMA.1121.00028,2,2095496,2145058,+,49562
238,BUMA.1121.00010,2,1428346,1477865,-,49519
238,BUMA.1121.00004,2,2054067,2103616,+,49549
238,BUMA.1121.00015,2,199367,249015,+,49648
238,BUMA.1121.00008,2,2053566,2103116,+,49550
238,BUMA.1121.00022,2,1490537,1540074,+,49537
238,BUMA.1121.00026,2,547842,597401,+,49559
238,BUMA.1121.00024,2,2189239,2238801,+,49562
238,BUMA.1121.00052,2,64973,114530,+,49557
238,BUMA.1121.00032,2,494425,543963,+,49538
238,BUMA.1121.00019,2,2134689,2184239,+,49550
238,BUMA.1121.00044,2,1,49524,+,49523
238,BUMA.1121.00030,2,3115,52653,-,49538
238,BUMA.1121.00020,2,2055536,2105086,+,49550
237,BUMA.1121.00050,2,2228437,2245209,+,16772
237,BUMA.1121.00081,2,173134,189912,-,16778
237,BUMA.1121.00006,2,2133606,2150378,+,16772
237,BUMA.1121.00087,2,412189,428961,+,16772
237,BUMA.1121.00040,2,134302,151080,-,16778
237,BUMA.1121.00086,2,174296,191074,-,16778
237,BUMA.1121.00054,2,1933719,1950491,+,16772
237,BUMA.1121.00034,2,1917764,1934536,+,16772
237,BUMA.1121.00048,2,912583,929361,-,16778
237,BUMA.1121.00017,2,1917760,1934532,+,16772
237,BUMA.1121.00038,2,2034821,2051593,+,16772
237,BUMA.1121.00085,2,1337313,1354098,-,16785
237,BUMA.1121.00002,2,380365,397137,+,16772
237,BUMA.1121.00046,2,1189930,1206708,-,16778
237,BUMA.1121.00042,2,1774728,1791506,-,16778
237,BUMA.1121.00036,2,1472158,1488930,+,16772
237,BUMA.1121.00013,2,603756,620541,-,16785
237,BUMA.1121.00028,2,1943888,1960660,+,16772
237,BUMA.1121.00010,2,1232369,1249139,+,16770
237,BUMA.1121.00004,2,1902446,1919218,+,16772
237,BUMA.1121.00015,2,425390,442161,-,16771
237,BUMA.1121.00008,2,1901993,1918765,+,16772
237,BUMA.1121.00022,2,1719440,1736218,-,16778
237,BUMA.1121.00026,2,523686,540458,+,16772
237,BUMA.1121.00024,2,2037647,2054419,+,16772
237,BUMA.1121.00052,2,290972,307757,-,16785
237,BUMA.1121.00032,2,342825,359597,+,16772
237,BUMA.1121.00019,2,1981860,1998632,+,16772
237,BUMA.1121.00044,2,1968661,1985433,+,16772
237,BUMA.1121.00030,2,187462,204240,-,16778
237,BUMA.1121.00020,2,1902715,1919487,+,16772
236,BUMA.1121.00050,2,2149914,2224732,+,74818
236,BUMA.1121.00081,2,193617,268401,-,74784
236,BUMA.1121.00006,2,2055118,2129901,+,74783
236,BUMA.1121.00087,2,333767,408484,+,74717
236,BUMA.1121.00040,2,154785,229440,-,74655
236,BUMA.1121.00086,2,194779,269560,-,74781
236,BUMA.1121.00054,2,1855238,1930014,+,74776
236,BUMA.1121.00034,2,1839365,1914059,+,74694
236,BUMA.1121.00048,2,933066,1007794,-,74728
236,BUMA.1121.00017,2,1839354,1914055,+,74701
236,BUMA.1121.00038,2,1956311,2031116,+,74805
236,BUMA.1121.00085,2,1357803,1432625,-,74822
236,BUMA.1121.00002,2,301905,376660,+,74755
236,BUMA.1121.00046,2,1210413,1285232,-,74819
236,BUMA.1121.00042,2,1795211,1869874,-,74663
236,BUMA.1121.00036,2,1393682,1468453,+,74771
236,BUMA.1121.00013,2,624246,699061,-,74815
236,BUMA.1121.00028,2,1865489,1940183,+,74694
236,BUMA.1121.00010,2,1154095,1228664,+,74569
236,BUMA.1121.00004,2,1824040,1898741,+,74701
236,BUMA.1121.00015,2,445866,520685,-,74819
236,BUMA.1121.00008,2,1823601,1898288,+,74687
236,BUMA.1121.00022,2,1739923,1814614,-,74691
236,BUMA.1121.00026,2,445227,519981,+,74754
236,BUMA.1121.00024,2,1959241,2033942,+,74701
236,BUMA.1121.00052,2,311462,386263,-,74801
236,BUMA.1121.00032,2,264405,339120,+,74715
236,BUMA.1121.00019,2,1903433,1978155,+,74722
236,BUMA.1121.00044,2,1890255,1964956,+,74701
236,BUMA.1121.00030,2,207945,282646,-,74701
236,BUMA.1121.00020,2,1824288,1899010,+,74722
235,BUMA.1121.00050,2,2118839,2148687,+,29848
235,BUMA.1121.00081,2,269612,299475,-,29863
235,BUMA.1121.00006,2,2024044,2053907,+,29863
235,BUMA.1121.00087,2,302686,332555,+,29869
235,BUMA.1121.00040,2,230651,260513,-,29862
235,BUMA.1121.00086,2,270771,300641,-,29870
235,BUMA.1121.00054,2,1824164,1854027,+,29863
235,BUMA.1121.00034,2,1808284,1838154,+,29870
235,BUMA.1121.00048,2,1009005,1038868,-,29863
235,BUMA.1121.00017,2,1808273,1838143,+,29870
235,BUMA.1121.00038,2,1925237,1955100,+,29863
235,BUMA.1121.00085,2,1433836,1463700,-,29864
235,BUMA.1121.00002,2,270823,300694,+,29871
235,BUMA.1121.00046,2,1286458,1316307,-,29849
235,BUMA.1121.00042,2,1871085,1902268,-,31183
235,BUMA.1121.00036,2,1362599,1392469,+,29870
235,BUMA.1121.00013,2,700272,730136,-,29864
235,BUMA.1121.00028,2,1834408,1864278,+,29870
235,BUMA.1121.00010,2,1123012,1152884,+,29872
235,BUMA.1121.00004,2,1792960,1822829,+,29869
235,BUMA.1121.00015,2,521896,551760,-,29864
235,BUMA.1121.00008,2,1792520,1822390,+,29870
235,BUMA.1121.00022,2,1815825,1845695,-,29870
235,BUMA.1121.00026,2,412833,444016,+,31183
235,BUMA.1121.00024,2,1928160,1958030,+,29870
235,BUMA.1121.00052,2,387474,417338,-,29864
235,BUMA.1121.00032,2,233324,263194,+,29870
235,BUMA.1121.00019,2,1872352,1902222,+,29870
235,BUMA.1121.00044,2,1859174,1889044,+,29870
235,BUMA.1121.00030,2,283857,313727,-,29870
235,BUMA.1121.00020,2,1793207,1823077,+,29870
234,BUMA.1121.00050,2,2104519,2114451,+,9932
234,BUMA.1121.00081,2,303847,313837,-,9990
234,BUMA.1121.00006,2,2009682,2019656,+,9974
234,BUMA.1121.00087,2,287112,297058,+,9946
234,BUMA.1121.00040,2,263649,273639,-,9990
234,BUMA.1121.00086,2,306253,316215,-,9962
234,BUMA.1121.00054,2,1809802,1819776,+,9974
234,BUMA.1121.00034,2,1792689,1802656,+,9967
234,BUMA.1121.00048,2,1043240,1053230,-,9990
234,BUMA.1121.00017,2,1792678,1802645,+,9967
234,BUMA.1121.00038,2,1910875,1920849,+,9974
234,BUMA.1121.00085,2,1468072,1478055,-,9983
234,BUMA.1121.00002,2,256503,266435,+,9932
234,BUMA.1121.00046,2,1320679,1330627,-,9948
234,BUMA.1121.00042,2,1906640,1916595,-,9955
234,BUMA.1121.00036,2,1347001,1356975,+,9974
234,BUMA.1121.00013,2,734508,744505,-,9997
234,BUMA.1121.00028,2,1818820,1828780,+,9960
234,BUMA.1121.00010,2,1108693,1118624,+,9931
234,BUMA.1121.00004,2,1777365,1787332,+,9967
234,BUMA.1121.00015,2,556132,566052,-,9920
234,BUMA.1121.00008,2,1776926,1786892,+,9966
234,BUMA.1121.00022,2,1851307,1861325,-,10018
234,BUMA.1121.00026,2,398478,408445,+,9967
234,BUMA.1121.00024,2,1912565,1922532,+,9967
234,BUMA.1121.00052,2,421710,431693,-,9983
234,BUMA.1121.00032,2,217729,227696,+,9967
234,BUMA.1121.00019,2,1856757,1866724,+,9967
234,BUMA.1121.00044,2,1843579,1853546,+,9967
234,BUMA.1121.00030,2,319339,329322,-,9983
234,BUMA.1121.00020,2,1777612,1787579,+,9967
233,BUMA.1121.00050,2,2098877,2104517,+,5640
233,BUMA.1121.00081,2,313838,319481,-,5643
233,BUMA.1121.00006,2,2004038,2009680,+,5642
233,BUMA.1121.00087,2,279877,285532,+,5655
233,BUMA.1121.00040,2,273640,279283,-,5643
233,BUMA.1121.00086,2,317795,323450,-,5655
233,BUMA.1121.00054,2,1804158,1809800,+,5642
233,BUMA.1121.00034,2,1785454,1791109,+,5655
233,BUMA.1121.00048,2,1053231,1058874,-,5643
233,BUMA.1121.00017,2,1785443,1791098,+,5655
233,BUMA.1121.00038,2,1905231,1910873,+,5642
233,BUMA.1121.00085,2,1479637,1485292,-,5655
233,BUMA.1121.00002,2,249268,254923,+,5655
233,BUMA.1121.00046,2,1330628,1336268,-,5640
233,BUMA.1121.00042,2,1447919,1453574,+,5655
233,BUMA.1121.00036,2,1339763,1345418,+,5655
233,BUMA.1121.00013,2,746087,751742,-,5655
233,BUMA.1121.00028,2,1811585,1817240,+,5655
233,BUMA.1121.00010,2,1101458,1107113,+,5655
233,BUMA.1121.00004,2,1770130,1775785,+,5655
233,BUMA.1121.00015,2,566053,571696,-,5643
233,BUMA.1121.00008,2,1769691,1775346,+,5655
233,BUMA.1121.00022,2,1862905,1868560,-,5655
233,BUMA.1121.00026,2,684242,689897,-,5655
233,BUMA.1121.00024,2,1905330,1910985,+,5655
233,BUMA.1121.00052,2,433275,438930,-,5655
233,BUMA.1121.00032,2,210494,216149,+,5655
233,BUMA.1121.00019,2,1849522,1855177,+,5655
233,BUMA.1121.00044,2,1836344,1841999,+,5655
233,BUMA.1121.00030,2,330902,336557,-,5655
233,BUMA.1121.00020,2,1770377,1776032,+,5655
232,BUMA.1121.00050,2,2088807,2096630,+,7823
232,BUMA.1121.00081,2,321725,329548,-,7823
232,BUMA.1121.00006,2,1993970,2001793,+,7823
232,BUMA.1121.00087,2,271405,279228,+,7823
232,BUMA.1121.00040,2,279931,287754,-,7823
232,BUMA.1121.00086,2,324098,331921,-,7823
232,BUMA.1121.00054,2,1794090,1801913,+,7823
232,BUMA.1121.00034,2,1776982,1784805,+,7823
232,BUMA.1121.00048,2,1061118,1068941,-,7823
232,BUMA.1121.00017,2,1776971,1784794,+,7823
232,BUMA.1121.00038,2,1895163,1902986,+,7823
232,BUMA.1121.00085,2,1485940,1493763,-,7823
232,BUMA.1121.00002,2,240796,248619,+,7823
232,BUMA.1121.00046,2,1338515,1346338,-,7823
232,BUMA.1121.00042,2,1439447,1447270,+,7823
232,BUMA.1121.00036,2,1331293,1339114,+,7821
232,BUMA.1121.00013,2,752390,760213,-,7823
232,BUMA.1121.00028,2,1803113,1810936,+,7823
232,BUMA.1121.00010,2,1092986,1100809,+,7823
232,BUMA.1121.00004,2,1761658,1769481,+,7823
232,BUMA.1121.00015,2,573940,581763,-,7823
232,BUMA.1121.00008,2,1761219,1769042,+,7823
232,BUMA.1121.00022,2,1869208,1877031,-,7823
232,BUMA.1121.00026,2,690545,698368,-,7823
232,BUMA.1121.00024,2,1896858,1904681,+,7823
232,BUMA.1121.00052,2,439578,447401,-,7823
232,BUMA.1121.00032,2,202022,209845,+,7823
232,BUMA.1121.00019,2,1841050,1848873,+,7823
232,BUMA.1121.00044,2,1827872,1835695,+,7823
232,BUMA.1121.00030,2,337205,345028,-,7823
232,BUMA.1121.00020,2,1761905,1769728,+,7823
231,BUMA.1121.00050,2,2049148,2087530,+,38382
231,BUMA.1121.00081,2,330825,369263,-,38438
231,BUMA.1121.00006,2,1954248,1992693,+,38445
231,BUMA.1121.00087,2,231758,270128,+,38370
231,BUMA.1121.00040,2,289031,327428,-,38397
231,BUMA.1121.00086,2,333198,371569,-,38371
231,BUMA.1121.00054,2,1754368,1792813,+,38445
231,BUMA.1121.00034,2,1737325,1775705,+,38380
231,BUMA.1121.00048,2,1070217,1108663,-,38446
231,BUMA.1121.00017,2,1737314,1775694,+,38380
231,BUMA.1121.00038,2,1855441,1893886,+,38445
231,BUMA.1121.00085,2,1497465,1535849,-,38384
231,BUMA.1121.00002,2,201107,239520,+,38413
231,BUMA.1121.00046,2,1347615,1385997,-,38382
231,BUMA.1121.00042,2,1398977,1437328,+,38351
231,BUMA.1121.00036,2,1291601,1330018,+,38417
231,BUMA.1121.00013,2,763915,802315,-,38400
231,BUMA.1121.00028,2,1763488,1801836,+,38348
231,BUMA.1121.00010,2,1053288,1091709,+,38421
231,BUMA.1121.00004,2,1722025,1760381,+,38356
231,BUMA.1121.00015,2,583040,621422,-,38382
231,BUMA.1121.00008,2,1721546,1759942,+,38396
231,BUMA.1121.00022,2,1878308,1916610,-,38302
231,BUMA.1121.00026,2,700073,738435,-,38362
231,BUMA.1121.00024,2,1857218,1895581,+,38363
231,BUMA.1121.00052,2,451103,489487,-,38384
231,BUMA.1121.00032,2,162389,200745,+,38356
231,BUMA.1121.00019,2,1801425,1839773,+,38348
231,BUMA.1121.00044,2,1788216,1826595,+,38379
231,BUMA.1121.00030,2,346305,384686,-,38381
231,BUMA.1121.00020,2,1722280,1760628,+,38348
230,BUMA.1121.00050,2,2009734,2049146,+,39412
230,BUMA.1121.00081,2,369264,408719,-,39455
230,BUMA.1121.00006,2,1914791,1954246,+,39455
230,BUMA.1121.00087,2,192416,231756,+,39340
230,BUMA.1121.00040,2,327429,366776,-,39347
230,BUMA.1121.00086,2,371570,410911,-,39341
230,BUMA.1121.00054,2,1714912,1754366,+,39454
230,BUMA.1121.00034,2,1697983,1737323,+,39340
230,BUMA.1121.00048,2,1108664,1148120,-,39456
230,BUMA.1121.00017,2,1697972,1737312,+,39340
230,BUMA.1121.00038,2,1815985,1855439,+,39454
230,BUMA.1121.00085,2,1535850,1575244,-,39394
230,BUMA.1121.00002,2,161785,201105,+,39320
230,BUMA.1121.00046,2,1385998,1425421,-,39423
230,BUMA.1121.00042,2,1358381,1397740,+,39359
230,BUMA.1121.00036,2,1252249,1291599,+,39350
230,BUMA.1121.00013,2,802316,841705,-,39389
230,BUMA.1121.00028,2,1724146,1763486,+,39340
230,BUMA.1121.00010,2,1013966,1053286,+,39320
230,BUMA.1121.00004,2,1682683,1722023,+,39340
230,BUMA.1121.00015,2,621423,660740,-,39317
230,BUMA.1121.00008,2,1682214,1721544,+,39330
230,BUMA.1121.00022,2,1916611,1955912,-,39301
230,BUMA.1121.00026,2,739672,779021,-,39349
230,BUMA.1121.00024,2,1817898,1857216,+,39318
230,BUMA.1121.00052,2,489488,528882,-,39394
230,BUMA.1121.00032,2,123057,162387,+,39330
230,BUMA.1121.00019,2,1762093,1801423,+,39330
230,BUMA.1121.00044,2,1748874,1788214,+,39340
230,BUMA.1121.00030,2,384687,424028,-,39341
230,BUMA.1121.00020,2,1682948,1722278,+,39330
229,BUMA.1121.00050,2,1986696,2008518,+,21822
229,BUMA.1121.00081,2,409935,431757,-,21822
229,BUMA.1121.00006,2,1891753,1913575,+,21822
229,BUMA.1121.00087,2,169378,191200,+,21822
229,BUMA.1121.00086,2,412127,433949,-,21822
229,BUMA.1121.00054,2,1691874,1713696,+,21822
229,BUMA.1121.00034,2,1675031,1696767,+,21736
229,BUMA.1121.00048,2,1149336,1171158,-,21822
229,BUMA.1121.00017,2,1675020,1696756,+,21736
229,BUMA.1121.00038,2,1792947,1814769,+,21822
229,BUMA.1121.00046,2,1426637,1448459,-,21822
229,BUMA.1121.00042,2,1335350,1357156,+,21806
229,BUMA.1121.00036,2,1229211,1251033,+,21822
229,BUMA.1121.00013,2,842943,864755,-,21812
229,BUMA.1121.00028,2,1701194,1722919,+,21725
229,BUMA.1121.00004,2,1659731,1681467,+,21736
229,BUMA.1121.00008,2,1659262,1680998,+,21736
229,BUMA.1121.00022,2,1957128,1978950,-,21822
229,BUMA.1121.00026,2,780248,802054,-,21806
229,BUMA.1121.00024,2,1794946,1816671,+,21725
229,BUMA.1121.00032,2,100105,121841,+,21736
229,BUMA.1121.00019,2,1739141,1760877,+,21736
229,BUMA.1121.00044,2,1725922,1747658,+,21736
229,BUMA.1121.00030,2,425244,446980,-,21736
229,BUMA.1121.00020,2,1659996,1681732,+,21736
228,BUMA.1121.00050,2,1975475,1982336,+,6861
228,BUMA.1121.00081,2,436117,442977,-,6860
228,BUMA.1121.00006,2,1880532,1887393,+,6861
228,BUMA.1121.00087,2,1005453,1012313,-,6860
228,BUMA.1121.00040,2,1779386,1786247,+,6861
228,BUMA.1121.00086,2,1942890,1949751,+,6861
228,BUMA.1121.00054,2,1680653,1687514,+,6861
228,BUMA.1121.00048,2,1175518,1182378,-,6860
228,BUMA.1121.00038,2,1781726,1788587,+,6861
228,BUMA.1121.00085,2,754586,761447,+,6861
228,BUMA.1121.00002,2,975818,982678,-,6860
228,BUMA.1121.00046,2,1452819,1459679,-,6860
228,BUMA.1121.00042,2,527218,534076,-,6858
228,BUMA.1121.00036,2,1999127,2005987,-,6860
228,BUMA.1121.00013,2,20649,27510,+,6861
228,BUMA.1121.00010,2,1829259,1836119,-,6860
228,BUMA.1121.00015,2,664003,670863,-,6860
228,BUMA.1121.00022,2,1135014,1141875,+,6861
228,BUMA.1121.00052,2,1443137,1449998,+,6861
227,BUMA.1121.00050,2,1957284,1970949,+,13665
227,BUMA.1121.00081,2,447504,461210,-,13706
227,BUMA.1121.00006,2,1862299,1875964,+,13665
227,BUMA.1121.00087,2,1016840,1030546,-,13706
227,BUMA.1121.00040,2,1761129,1774818,+,13689
227,BUMA.1121.00086,2,1924657,1938322,+,13665
227,BUMA.1121.00054,2,1662420,1676085,+,13665
227,BUMA.1121.00048,2,1186905,1200611,-,13706
227,BUMA.1121.00038,2,1763493,1777158,+,13665
227,BUMA.1121.00085,2,736357,750018,+,13661
227,BUMA.1121.00002,2,987205,1000911,-,13706
227,BUMA.1121.00046,2,1464164,1477870,-,13706
227,BUMA.1121.00042,2,538610,552340,-,13730
227,BUMA.1121.00036,2,2010514,2024244,-,13730
227,BUMA.1121.00013,2,2416,16081,+,13665
227,BUMA.1121.00010,2,1843100,1856806,-,13706
227,BUMA.1121.00015,2,675390,689096,-,13706
227,BUMA.1121.00022,2,1116757,1130446,+,13689
227,BUMA.1121.00052,2,1424904,1438569,+,13665
226,BUMA.1121.00050,2,1939691,1947788,+,8097
226,BUMA.1121.00081,2,470688,478764,-,8076
226,BUMA.1121.00006,2,1844745,1852821,+,8076
226,BUMA.1121.00087,2,1040040,1048129,-,8089
226,BUMA.1121.00040,2,1743544,1751647,+,8103
226,BUMA.1121.00086,2,1907074,1915163,+,8089
226,BUMA.1121.00054,2,1644866,1652942,+,8076
226,BUMA.1121.00048,2,1210083,1218159,-,8076
226,BUMA.1121.00038,2,1745939,1754015,+,8076
226,BUMA.1121.00085,2,718835,726911,+,8076
226,BUMA.1121.00002,2,1010382,1018493,-,8111
226,BUMA.1121.00046,2,178912,187009,+,8097
226,BUMA.1121.00036,2,2033736,2041811,-,8075
226,BUMA.1121.00013,2,2110906,2118982,+,8076
226,BUMA.1121.00010,2,1866278,1874389,-,8111
226,BUMA.1121.00015,2,698617,706693,-,8076
226,BUMA.1121.00022,2,1099154,1107271,+,8117
226,BUMA.1121.00052,2,1407382,1415458,+,8076
225,BUMA.1121.00050,2,1909047,1938628,+,29581
225,BUMA.1121.00081,2,479827,509407,-,29580
225,BUMA.1121.00006,2,1814102,1843682,+,29580
225,BUMA.1121.00087,2,1049192,1078773,-,29581
225,BUMA.1121.00040,2,1712903,1742481,+,29578
225,BUMA.1121.00086,2,1876430,1906011,+,29581
225,BUMA.1121.00054,2,1614223,1643803,+,29580
225,BUMA.1121.00048,2,1219222,1248802,-,29580
225,BUMA.1121.00038,2,1715296,1744876,+,29580
225,BUMA.1121.00085,2,688192,717772,+,29580
225,BUMA.1121.00002,2,1019556,1049137,-,29581
225,BUMA.1121.00046,2,148268,177849,+,29581
225,BUMA.1121.00042,2,430173,459897,-,29724
225,BUMA.1121.00036,2,2042874,2072455,-,29581
225,BUMA.1121.00013,2,2080263,2109843,+,29580
225,BUMA.1121.00010,2,1875452,1905033,-,29581
225,BUMA.1121.00015,2,707756,737337,-,29581
225,BUMA.1121.00022,2,1068510,1098091,+,29581
225,BUMA.1121.00052,2,1376739,1406319,+,29580
224,BUMA.1121.00050,2,1867888,1907806,+,39918
224,BUMA.1121.00081,2,510648,550528,-,39880
224,BUMA.1121.00006,2,1772981,1812861,+,39880
224,BUMA.1121.00087,2,1080013,1119970,-,39957
224,BUMA.1121.00040,2,1671692,1711662,+,39970
224,BUMA.1121.00086,2,1835233,1875190,+,39957
224,BUMA.1121.00054,2,1573102,1612982,+,39880
224,BUMA.1121.00034,2,377669,417611,-,39942
224,BUMA.1121.00048,2,1250043,1289923,-,39880
224,BUMA.1121.00017,2,377648,417582,-,39934
224,BUMA.1121.00038,2,1674175,1714055,+,39880
224,BUMA.1121.00085,2,647031,686951,+,39920
224,BUMA.1121.00002,2,1050377,1090280,-,39903
224,BUMA.1121.00046,2,107109,147027,+,39918
224,BUMA.1121.00042,2,461138,501048,-,39910
224,BUMA.1121.00036,2,2073695,2113661,-,39966
224,BUMA.1121.00013,2,2039110,2079022,+,39912
224,BUMA.1121.00028,2,377595,417537,-,39942
224,BUMA.1121.00010,2,1906273,1946176,-,39903
224,BUMA.1121.00004,2,377641,417578,-,39937
224,BUMA.1121.00015,2,738578,778497,-,39919
224,BUMA.1121.00008,2,377513,417423,-,39910
224,BUMA.1121.00022,2,1027337,1067270,+,39933
224,BUMA.1121.00026,2,1365394,1405351,-,39957
224,BUMA.1121.00024,2,377513,417455,-,39942
224,BUMA.1121.00052,2,1335578,1375498,+,39920
224,BUMA.1121.00032,2,801982,841899,-,39917
224,BUMA.1121.00019,2,377580,417522,-,39942
224,BUMA.1121.00044,2,428785,468727,-,39942
224,BUMA.1121.00030,2,1704188,1744129,+,39941
224,BUMA.1121.00020,2,377616,417558,-,39942
223,BUMA.1121.00050,2,1826394,1851227,+,24833
223,BUMA.1121.00081,2,567193,592097,-,24904
223,BUMA.1121.00006,2,1731414,1756318,+,24904
223,BUMA.1121.00087,2,2050488,2075384,+,24896
223,BUMA.1121.00086,2,1783325,1808221,+,24896
223,BUMA.1121.00054,2,1531534,1556438,+,24904
223,BUMA.1121.00048,2,1306587,1331491,-,24904
223,BUMA.1121.00038,2,1632607,1657511,+,24904
223,BUMA.1121.00046,2,65610,90443,+,24833
223,BUMA.1121.00036,2,2140666,2165507,-,24841
223,BUMA.1121.00028,2,443752,468699,-,24947
223,BUMA.1121.00004,2,443793,468727,-,24934
223,BUMA.1121.00008,2,443638,468572,-,24934
223,BUMA.1121.00022,2,975413,1000333,+,24920
223,BUMA.1121.00026,2,824438,849269,-,24831
223,BUMA.1121.00024,2,443670,468604,-,24934
223,BUMA.1121.00032,2,868114,893048,-,24934
223,BUMA.1121.00019,2,443737,468671,-,24934
223,BUMA.1121.00020,2,443773,468707,-,24934
222,BUMA.1121.00050,2,1807878,1825181,+,17303
222,BUMA.1121.00081,2,593310,610613,-,17303
222,BUMA.1121.00006,2,1712898,1730201,+,17303
222,BUMA.1121.00087,2,2031972,2049275,+,17303
222,BUMA.1121.00086,2,1764809,1782112,+,17303
222,BUMA.1121.00054,2,1513018,1530321,+,17303
222,BUMA.1121.00048,2,1332704,1350007,-,17303
222,BUMA.1121.00038,2,1614091,1631394,+,17303
222,BUMA.1121.00002,2,1951129,1968432,+,17303
222,BUMA.1121.00046,2,47094,64397,+,17303
222,BUMA.1121.00042,2,2129431,2146721,-,17290
222,BUMA.1121.00036,2,2166720,2184023,-,17303
222,BUMA.1121.00010,2,709710,726999,+,17289
222,BUMA.1121.00004,2,469940,487243,-,17303
222,BUMA.1121.00015,2,1589774,1607065,+,17291
222,BUMA.1121.00008,2,469785,487088,-,17303
222,BUMA.1121.00022,2,956897,974200,+,17303
222,BUMA.1121.00026,2,256562,273875,+,17313
222,BUMA.1121.00032,2,894261,911564,-,17303
222,BUMA.1121.00019,2,469884,487187,-,17303
222,BUMA.1121.00020,2,469920,487223,-,17303
221,BUMA.1121.00050,2,1783104,1807876,+,24772
221,BUMA.1121.00081,2,610614,635406,-,24792
221,BUMA.1121.00006,2,1688104,1712896,+,24792
221,BUMA.1121.00087,2,2007236,2031970,+,24734
221,BUMA.1121.00086,2,1740010,1764807,+,24797
221,BUMA.1121.00054,2,1488224,1513016,+,24792
221,BUMA.1121.00048,2,1350008,1374800,-,24792
221,BUMA.1121.00038,2,1589293,1614089,+,24796
221,BUMA.1121.00002,2,1926400,1951127,+,24727
221,BUMA.1121.00046,2,22319,47092,+,24773
221,BUMA.1121.00042,2,1,24753,-,24752
221,BUMA.1121.00036,2,2184024,2208877,-,24853
221,BUMA.1121.00010,2,684961,709708,+,24747
221,BUMA.1121.00004,2,487244,511932,-,24688
221,BUMA.1121.00015,2,1564973,1589772,+,24799
221,BUMA.1121.00008,2,487089,511807,-,24718
221,BUMA.1121.00022,2,932031,956895,+,24864
221,BUMA.1121.00026,2,231835,256560,+,24725
221,BUMA.1121.00032,2,911565,936227,-,24662
221,BUMA.1121.00019,2,487188,511915,-,24727
221,BUMA.1121.00020,2,487224,511942,-,24718
220,BUMA.1121.00050,2,1761711,1781600,+,19889
220,BUMA.1121.00081,2,636911,656703,-,19792
220,BUMA.1121.00006,2,1666810,1686600,+,19790
220,BUMA.1121.00087,2,1985835,2005732,+,19897
220,BUMA.1121.00086,2,1718433,1738506,+,20073
220,BUMA.1121.00054,2,1466927,1486720,+,19793
220,BUMA.1121.00048,2,1376305,1396113,-,19808
220,BUMA.1121.00038,2,1568004,1587789,+,19785
220,BUMA.1121.00002,2,1904977,1924896,+,19919
220,BUMA.1121.00046,2,935,20815,+,19880
220,BUMA.1121.00042,2,26258,46153,-,19895
220,BUMA.1121.00036,2,2210382,2230337,-,19955
220,BUMA.1121.00010,2,663697,683457,+,19760
220,BUMA.1121.00004,2,513437,533253,-,19816
220,BUMA.1121.00015,2,1543628,1563469,+,19841
220,BUMA.1121.00008,2,513312,533104,-,19792
220,BUMA.1121.00022,2,910526,930527,+,20001
220,BUMA.1121.00026,2,210477,230331,+,19854
220,BUMA.1121.00032,2,937732,957560,-,19828
220,BUMA.1121.00019,2,513420,533231,-,19811
220,BUMA.1121.00020,2,513447,533260,-,19813
219,BUMA.1121.00050,2,1749126,1757121,+,7995
219,BUMA.1121.00081,2,661294,669288,-,7994
219,BUMA.1121.00006,2,1654225,1662220,+,7995
219,BUMA.1121.00087,2,1972734,1980729,+,7995
219,BUMA.1121.00040,2,1641929,1649923,+,7994
219,BUMA.1121.00086,2,1705332,1713327,+,7995
219,BUMA.1121.00054,2,1454342,1462337,+,7995
219,BUMA.1121.00034,2,447303,455297,-,7994
219,BUMA.1121.00048,2,1400688,1408682,-,7994
219,BUMA.1121.00017,2,447269,455263,-,7994
219,BUMA.1121.00038,2,1555419,1563414,+,7995
219,BUMA.1121.00002,2,1891876,1899871,+,7995
219,BUMA.1121.00046,2,2133137,2141132,+,7995
219,BUMA.1121.00042,2,47371,55358,-,7987
219,BUMA.1121.00036,2,2235444,2243438,-,7994
219,BUMA.1121.00013,2,2000763,2008758,+,7995
219,BUMA.1121.00028,2,473400,481394,-,7994
219,BUMA.1121.00010,2,650612,658606,+,7994
219,BUMA.1121.00004,2,537954,545948,-,7994
219,BUMA.1121.00015,2,1531043,1539038,+,7995
219,BUMA.1121.00008,2,537805,545799,-,7994
219,BUMA.1121.00022,2,897425,905420,+,7995
219,BUMA.1121.00026,2,201265,209253,+,7988
219,BUMA.1121.00024,2,473305,481299,-,7994
219,BUMA.1121.00032,2,962261,970255,-,7994
219,BUMA.1121.00019,2,537932,545926,-,7994
219,BUMA.1121.00044,2,498419,506413,-,7994
219,BUMA.1121.00030,2,1666503,1674498,+,7995
219,BUMA.1121.00020,2,537961,545955,-,7994
218,BUMA.1121.00050,2,1708404,1748225,+,39821
218,BUMA.1121.00081,2,670189,709944,-,39755
218,BUMA.1121.00006,2,1613570,1653324,+,39754
218,BUMA.1121.00087,2,1932067,1971833,+,39766
218,BUMA.1121.00040,2,1601291,1641028,+,39737
218,BUMA.1121.00086,2,1664664,1704431,+,39767
218,BUMA.1121.00054,2,1413687,1453441,+,39754
218,BUMA.1121.00034,2,456198,495955,-,39757
218,BUMA.1121.00048,2,1409583,1449338,-,39755
218,BUMA.1121.00017,2,456164,495921,-,39757
218,BUMA.1121.00038,2,1514764,1554518,+,39754
218,BUMA.1121.00002,2,1851169,1890975,+,39806
218,BUMA.1121.00046,2,2092415,2132236,+,39821
218,BUMA.1121.00042,2,56259,96058,-,39799
218,BUMA.1121.00036,2,2244339,2284094,-,39755
218,BUMA.1121.00013,2,1960082,1999862,+,39780
218,BUMA.1121.00028,2,482295,522052,-,39757
218,BUMA.1121.00010,2,609917,649711,+,39794
218,BUMA.1121.00004,2,546849,586606,-,39757
218,BUMA.1121.00015,2,1490335,1530142,+,39807
218,BUMA.1121.00008,2,546700,586457,-,39757
218,BUMA.1121.00022,2,856782,896524,+,39742
218,BUMA.1121.00026,2,160618,200364,+,39746
218,BUMA.1121.00024,2,482200,521957,-,39757
218,BUMA.1121.00032,2,971156,1010907,-,39751
218,BUMA.1121.00019,2,546827,586584,-,39757
218,BUMA.1121.00044,2,507314,547071,-,39757
218,BUMA.1121.00030,2,1625846,1665602,+,39756
218,BUMA.1121.00020,2,546856,586613,-,39757
217,BUMA.1121.00050,2,1700573,1708070,+,7497
217,BUMA.1121.00081,2,710277,717775,-,7498
217,BUMA.1121.00006,2,1605739,1613236,+,7497
217,BUMA.1121.00087,2,1924236,1931733,+,7497
217,BUMA.1121.00040,2,1593460,1600957,+,7497
217,BUMA.1121.00086,2,1656833,1664330,+,7497
217,BUMA.1121.00054,2,1405856,1413353,+,7497
217,BUMA.1121.00034,2,496288,503786,-,7498
217,BUMA.1121.00048,2,1449671,1457169,-,7498
217,BUMA.1121.00017,2,496254,503752,-,7498
217,BUMA.1121.00038,2,1506933,1514430,+,7497
217,BUMA.1121.00002,2,1843338,1850835,+,7497
217,BUMA.1121.00046,2,2084584,2092081,+,7497
217,BUMA.1121.00042,2,96391,103890,-,7499
217,BUMA.1121.00036,2,345,7843,-,7498
217,BUMA.1121.00013,2,1952251,1959748,+,7497
217,BUMA.1121.00028,2,522385,529883,-,7498
217,BUMA.1121.00010,2,602086,609583,+,7497
217,BUMA.1121.00004,2,586939,594437,-,7498
217,BUMA.1121.00015,2,1482504,1490001,+,7497
217,BUMA.1121.00008,2,586790,594288,-,7498
217,BUMA.1121.00022,2,848951,856448,+,7497
217,BUMA.1121.00026,2,152786,160284,+,7498
217,BUMA.1121.00024,2,522290,529788,-,7498
217,BUMA.1121.00032,2,1011240,1018738,-,7498
217,BUMA.1121.00019,2,586917,594415,-,7498
217,BUMA.1121.00044,2,547404,554902,-,7498
217,BUMA.1121.00030,2,1618015,1625512,+,7497
217,BUMA.1121.00020,2,586946,594444,-,7498
216,BUMA.1121.00050,2,1692197,1699828,+,7631
216,BUMA.1121.00081,2,718519,726164,-,7645
216,BUMA.1121.00006,2,1597349,1604994,+,7645
216,BUMA.1121.00087,2,1914261,1921892,+,7631
216,BUMA.1121.00040,2,1585084,1592715,+,7631
216,BUMA.1121.00086,2,1646858,1654489,+,7631
216,BUMA.1121.00054,2,1397466,1405111,+,7645
216,BUMA.1121.00034,2,506127,513758,-,7631
216,BUMA.1121.00048,2,1457913,1465558,-,7645
216,BUMA.1121.00017,2,506093,513724,-,7631
216,BUMA.1121.00038,2,1498543,1506188,+,7645
216,BUMA.1121.00002,2,1833364,1840995,+,7631
216,BUMA.1121.00046,2,2076208,2083839,+,7631
216,BUMA.1121.00042,2,104643,112274,-,7631
216,BUMA.1121.00036,2,10184,17815,-,7631
216,BUMA.1121.00013,2,1943875,1951506,+,7631
216,BUMA.1121.00028,2,532224,539855,-,7631
216,BUMA.1121.00010,2,592115,599746,+,7631
216,BUMA.1121.00004,2,596778,604409,-,7631
216,BUMA.1121.00015,2,1474128,1481759,+,7631
216,BUMA.1121.00008,2,596629,604260,-,7631
216,BUMA.1121.00022,2,838977,846608,+,7631
216,BUMA.1121.00026,2,144631,152032,+,7401
216,BUMA.1121.00024,2,532129,539760,-,7631
216,BUMA.1121.00032,2,1021079,1028710,-,7631
216,BUMA.1121.00019,2,596756,604387,-,7631
216,BUMA.1121.00044,2,557243,564874,-,7631
216,BUMA.1121.00030,2,1608042,1615673,+,7631
216,BUMA.1121.00020,2,596785,604416,-,7631
215,BUMA.1121.00050,2,1684866,1691581,+,6715
215,BUMA.1121.00081,2,726781,733496,-,6715
215,BUMA.1121.00006,2,1590018,1596733,+,6715
215,BUMA.1121.00087,2,1906930,1913645,+,6715
215,BUMA.1121.00040,2,1577747,1584462,+,6715
215,BUMA.1121.00086,2,1639527,1646242,+,6715
215,BUMA.1121.00054,2,1390135,1396850,+,6715
215,BUMA.1121.00034,2,514375,521096,-,6721
215,BUMA.1121.00048,2,1466175,1472890,-,6715
215,BUMA.1121.00017,2,514341,521062,-,6721
215,BUMA.1121.00038,2,1491212,1497927,+,6715
215,BUMA.1121.00002,2,1826033,1832748,+,6715
215,BUMA.1121.00046,2,2068877,2075592,+,6715
215,BUMA.1121.00046,2,2146103,2152800,+,6697
215,BUMA.1121.00042,2,112891,119606,-,6715
215,BUMA.1121.00036,2,18432,25153,-,6721
215,BUMA.1121.00013,2,1936544,1943259,+,6715
215,BUMA.1121.00028,2,540472,547193,-,6721
215,BUMA.1121.00010,2,584784,591499,+,6715
215,BUMA.1121.00004,2,605026,611747,-,6721
215,BUMA.1121.00015,2,1466797,1473512,+,6715
215,BUMA.1121.00008,2,604877,611598,-,6721
215,BUMA.1121.00022,2,831646,838361,+,6715
215,BUMA.1121.00026,2,137300,144015,+,6715
215,BUMA.1121.00024,2,540377,547098,-,6721
215,BUMA.1121.00032,2,1029327,1036048,-,6721
215,BUMA.1121.00019,2,605004,611725,-,6721
215,BUMA.1121.00044,2,565491,572212,-,6721
215,BUMA.1121.00030,2,1600705,1607420,+,6715
215,BUMA.1121.00020,2,605033,611754,-,6721
214,BUMA.1121.00050,2,1622128,1683247,+,61119
214,BUMA.1121.00081,2,735115,796343,-,61228
214,BUMA.1121.00006,2,1527170,1588399,+,61229
214,BUMA.1121.00087,2,1844186,1905308,+,61122
214,BUMA.1121.00040,2,1515062,1576128,+,61066
214,BUMA.1121.00086,2,1576783,1637905,+,61122
214,BUMA.1121.00054,2,1327287,1388516,+,61229
214,BUMA.1121.00034,2,1207572,1268718,+,61146
214,BUMA.1121.00048,2,1474509,1535723,-,61214
214,BUMA.1121.00017,2,1207558,1268711,+,61153
214,BUMA.1121.00038,2,1428372,1489593,+,61221
214,BUMA.1121.00085,2,578374,639673,+,61299
214,BUMA.1121.00002,2,1763194,1824411,+,61217
214,BUMA.1121.00046,2,2006148,2067258,+,61110
214,BUMA.1121.00042,2,196606,257797,-,61191
214,BUMA.1121.00036,2,26774,87871,-,61097
214,BUMA.1121.00013,2,1873715,1934925,+,61210
214,BUMA.1121.00028,2,1233717,1294880,+,61163
214,BUMA.1121.00010,2,521987,583162,+,61175
214,BUMA.1121.00004,2,1192447,1253578,+,61131
214,BUMA.1121.00015,2,1404180,1465178,+,60998
214,BUMA.1121.00008,2,1191732,1252893,+,61161
214,BUMA.1121.00022,2,769006,830024,+,61018
214,BUMA.1121.00026,2,112,61323,+,61211
214,BUMA.1121.00024,2,1327545,1388670,+,61125
214,BUMA.1121.00052,2,1266921,1328220,+,61299
214,BUMA.1121.00019,2,1271630,1332789,+,61159
214,BUMA.1121.00044,2,1258680,1319819,+,61139
214,BUMA.1121.00030,2,853079,914216,-,61137
214,BUMA.1121.00020,2,1192486,1253654,+,61168
213,BUMA.1121.00050,2,1580626,1621501,+,40875
213,BUMA.1121.00081,2,796970,837905,-,40935
213,BUMA.1121.00006,2,1485515,1526543,+,41028
213,BUMA.1121.00087,2,1802452,1843559,+,41107
213,BUMA.1121.00040,2,1473514,1514435,+,40921
213,BUMA.1121.00086,2,1535069,1576156,+,41087
213,BUMA.1121.00054,2,1285634,1326660,+,41026
213,BUMA.1121.00034,2,1166210,1206945,+,40735
213,BUMA.1121.00048,2,1536350,1577271,-,40921
213,BUMA.1121.00017,2,1166189,1206931,+,40742
213,BUMA.1121.00038,2,1386681,1427745,+,41064
213,BUMA.1121.00085,2,536918,577747,+,40829
213,BUMA.1121.00002,2,1721767,1762567,+,40800
213,BUMA.1121.00046,2,1964435,2005521,+,41086
213,BUMA.1121.00042,2,258418,299216,-,40798
213,BUMA.1121.00036,2,88498,129432,-,40934
213,BUMA.1121.00013,2,1832223,1873088,+,40865
213,BUMA.1121.00028,2,1192330,1233090,+,40760
213,BUMA.1121.00010,2,480571,521360,+,40789
213,BUMA.1121.00004,2,1151065,1191820,+,40755
213,BUMA.1121.00015,2,1362469,1403553,+,41084
213,BUMA.1121.00008,2,1150365,1191105,+,40740
213,BUMA.1121.00022,2,727377,768379,+,41002
213,BUMA.1121.00026,2,1817185,1858030,+,40845
213,BUMA.1121.00024,2,1286193,1326918,+,40725
213,BUMA.1121.00052,2,1225465,1266294,+,40829
213,BUMA.1121.00019,2,1230219,1271003,+,40784
213,BUMA.1121.00044,2,1217314,1258053,+,40739
213,BUMA.1121.00030,2,914843,955470,-,40627
213,BUMA.1121.00020,2,1151096,1191859,+,40763
212,BUMA.1121.00050,2,1553753,1578765,+,25012
212,BUMA.1121.00081,2,1062977,1087968,-,24991
212,BUMA.1121.00006,2,1235562,1260554,+,24992
212,BUMA.1121.00087,2,1414561,1439582,-,25021
212,BUMA.1121.00040,2,1156059,1181090,-,25031
212,BUMA.1121.00086,2,1147064,1172085,-,25021
212,BUMA.1121.00054,2,1035685,1060677,+,24992
212,BUMA.1121.00034,2,830205,855236,-,25031
212,BUMA.1121.00048,2,1802349,1827340,-,24991
212,BUMA.1121.00017,2,830177,855208,-,25031
212,BUMA.1121.00038,2,1136722,1161714,+,24992
212,BUMA.1121.00085,2,7245,32255,-,25010
212,BUMA.1121.00002,2,1694889,1719905,+,25016
212,BUMA.1121.00046,2,1937562,1962574,+,25012
212,BUMA.1121.00042,2,679900,705064,-,25164
212,BUMA.1121.00036,2,398867,423888,-,25021
212,BUMA.1121.00013,2,1408528,1433538,-,25010
212,BUMA.1121.00028,2,856311,881342,-,25031
212,BUMA.1121.00010,2,453694,478710,+,25016
212,BUMA.1121.00004,2,815060,840090,-,25030
212,BUMA.1121.00015,2,994875,1019893,-,25018
212,BUMA.1121.00008,2,814340,839371,-,25031
212,BUMA.1121.00022,2,339643,364653,-,25010
212,BUMA.1121.00026,2,1626146,1651341,-,25195
212,BUMA.1121.00024,2,950176,975207,-,25031
212,BUMA.1121.00052,2,695812,720822,-,25010
212,BUMA.1121.00032,2,1322777,1347808,-,25031
212,BUMA.1121.00019,2,815045,840076,-,25031
212,BUMA.1121.00044,2,881318,906348,-,25030
212,BUMA.1121.00030,2,1266550,1291582,+,25032
212,BUMA.1121.00020,2,815081,840112,-,25031
211,BUMA.1121.00050,2,1544995,1552231,+,7236
211,BUMA.1121.00081,2,1089490,1096726,-,7236
211,BUMA.1121.00006,2,1226804,1234040,+,7236
211,BUMA.1121.00087,2,1441104,1448342,-,7238
211,BUMA.1121.00040,2,1182612,1189848,-,7236
211,BUMA.1121.00086,2,1173607,1180845,-,7238
211,BUMA.1121.00054,2,1026927,1034163,+,7236
211,BUMA.1121.00034,2,856758,863996,-,7238
211,BUMA.1121.00048,2,1828862,1836098,-,7236
211,BUMA.1121.00017,2,856730,863968,-,7238
211,BUMA.1121.00038,2,1127964,1135200,+,7236
211,BUMA.1121.00085,2,33777,41012,-,7235
211,BUMA.1121.00002,2,1685936,1693367,+,7431
211,BUMA.1121.00046,2,1928804,1936040,+,7236
211,BUMA.1121.00042,2,706586,713824,-,7238
211,BUMA.1121.00036,2,425410,432648,-,7238
211,BUMA.1121.00013,2,1435060,1442295,-,7235
211,BUMA.1121.00028,2,882864,890102,-,7238
211,BUMA.1121.00010,2,444740,452171,+,7431
211,BUMA.1121.00004,2,841612,848850,-,7238
211,BUMA.1121.00015,2,1021415,1028650,-,7235
211,BUMA.1121.00008,2,840893,848131,-,7238
211,BUMA.1121.00022,2,366175,373413,-,7238
211,BUMA.1121.00026,2,1652863,1660101,-,7238
211,BUMA.1121.00024,2,976729,983967,-,7238
211,BUMA.1121.00052,2,722344,729579,-,7235
211,BUMA.1121.00032,2,1349330,1356568,-,7238
211,BUMA.1121.00019,2,841598,848836,-,7238
211,BUMA.1121.00044,2,907870,915108,-,7238
211,BUMA.1121.00030,2,1257791,1265028,+,7237
211,BUMA.1121.00020,2,841634,848872,-,7238
210,BUMA.1121.00050,2,1495209,1543748,+,48539
210,BUMA.1121.00081,2,1097975,1146577,-,48602
210,BUMA.1121.00006,2,1176954,1225556,+,48602
210,BUMA.1121.00087,2,1448350,1496883,-,48533
210,BUMA.1121.00040,2,1191097,1239629,-,48532
210,BUMA.1121.00086,2,1180853,1229386,-,48533
210,BUMA.1121.00054,2,977077,1025679,+,48602
210,BUMA.1121.00034,2,864004,912571,-,48567
210,BUMA.1121.00048,2,1837347,1885949,-,48602
210,BUMA.1121.00017,2,863976,912550,-,48574
210,BUMA.1121.00038,2,1078114,1126716,+,48602
210,BUMA.1121.00085,2,42261,90579,-,48318
210,BUMA.1121.00002,2,1636148,1684689,+,48541
210,BUMA.1121.00046,2,1879017,1927556,+,48539
210,BUMA.1121.00042,2,715071,763613,-,48542
210,BUMA.1121.00036,2,432656,481218,-,48562
210,BUMA.1121.00013,2,1443544,1491848,-,48304
210,BUMA.1121.00028,2,890110,938670,-,48560
210,BUMA.1121.00010,2,394953,443494,+,48541
210,BUMA.1121.00004,2,848858,897425,-,48567
210,BUMA.1121.00015,2,1029899,1078560,-,48661
210,BUMA.1121.00008,2,848139,896692,-,48553
210,BUMA.1121.00022,2,373421,421919,-,48498
210,BUMA.1121.00026,2,1448854,1497368,+,48514
210,BUMA.1121.00024,2,983975,1032535,-,48560
210,BUMA.1121.00052,2,730828,779146,-,48318
210,BUMA.1121.00032,2,1356576,1405122,-,48546
210,BUMA.1121.00019,2,848844,897404,-,48560
210,BUMA.1121.00044,2,915116,963676,-,48560
210,BUMA.1121.00030,2,1209223,1257783,+,48560
210,BUMA.1121.00020,2,848880,897440,-,48560
209,BUMA.1121.00050,2,1469419,1493693,+,24274
209,BUMA.1121.00081,2,1148092,1172204,-,24112
209,BUMA.1121.00006,2,1151334,1175438,+,24104
209,BUMA.1121.00087,2,1498398,1522813,-,24415
209,BUMA.1121.00040,2,1241144,1265733,-,24589
209,BUMA.1121.00086,2,1230901,1255379,-,24478
209,BUMA.1121.00054,2,951450,975561,+,24111
209,BUMA.1121.00034,2,914086,938396,-,24310
209,BUMA.1121.00048,2,1887464,1911562,-,24098
209,BUMA.1121.00017,2,914065,938375,-,24310
209,BUMA.1121.00038,2,1052501,1076598,+,24097
209,BUMA.1121.00085,2,92094,116178,-,24084
209,BUMA.1121.00002,2,1610563,1634632,+,24069
209,BUMA.1121.00046,2,1853227,1877501,+,24274
209,BUMA.1121.00042,2,765128,788942,-,23814
209,BUMA.1121.00036,2,482733,507092,-,24359
209,BUMA.1121.00013,2,1493363,1517426,-,24063
209,BUMA.1121.00028,2,940185,964495,-,24310
209,BUMA.1121.00010,2,369368,393437,+,24069
209,BUMA.1121.00004,2,898940,923271,-,24331
209,BUMA.1121.00015,2,1080075,1104110,-,24035
209,BUMA.1121.00008,2,898207,922524,-,24317
209,BUMA.1121.00022,2,423434,447854,-,24420
209,BUMA.1121.00026,2,1423504,1447338,+,23834
209,BUMA.1121.00024,2,1034050,1058360,-,24310
209,BUMA.1121.00052,2,780661,804745,-,24084
209,BUMA.1121.00032,2,1406637,1430947,-,24310
209,BUMA.1121.00019,2,898919,923229,-,24310
209,BUMA.1121.00044,2,965191,989501,-,24310
209,BUMA.1121.00030,2,1183398,1207707,+,24309
209,BUMA.1121.00020,2,898955,923265,-,24310
208,BUMA.1121.00050,2,1441948,1463748,+,21800
208,BUMA.1121.00081,2,1229570,1251412,-,21842
208,BUMA.1121.00006,2,1072126,1093968,+,21842
208,BUMA.1121.00087,2,1381819,1403630,+,21811
208,BUMA.1121.00040,2,1123299,1145120,+,21821
208,BUMA.1121.00086,2,1114322,1136133,+,21811
208,BUMA.1121.00054,2,872242,894084,+,21842
208,BUMA.1121.00034,2,797471,819274,+,21803
208,BUMA.1121.00048,2,1968923,1990765,-,21842
208,BUMA.1121.00017,2,797443,819246,+,21803
208,BUMA.1121.00085,2,128798,150584,-,21786
208,BUMA.1121.00002,2,1348868,1370704,+,21836
208,BUMA.1121.00046,2,1825754,1847554,+,21800
208,BUMA.1121.00042,2,801563,823215,-,21652
208,BUMA.1121.00036,2,366136,387936,+,21800
208,BUMA.1121.00028,2,823577,845380,+,21803
208,BUMA.1121.00010,2,107739,129568,+,21829
208,BUMA.1121.00015,2,1109782,1131585,-,21803
208,BUMA.1121.00022,2,306929,328712,+,21783
208,BUMA.1121.00024,2,917441,939245,+,21804
208,BUMA.1121.00052,2,817364,839150,-,21786
208,BUMA.1121.00032,2,1290043,1311846,+,21803
208,BUMA.1121.00044,2,848584,870387,+,21803
208,BUMA.1121.00030,2,1302512,1324315,-,21803
207,BUMA.1121.00050,2,1430690,1440808,+,10118
207,BUMA.1121.00081,2,1252553,1262686,-,10133
207,BUMA.1121.00006,2,1060868,1070986,+,10118
207,BUMA.1121.00087,2,1370534,1380679,+,10145
207,BUMA.1121.00040,2,1112041,1122159,+,10118
207,BUMA.1121.00086,2,1103037,1113182,+,10145
207,BUMA.1121.00054,2,860984,871102,+,10118
207,BUMA.1121.00034,2,786204,796331,+,10127
207,BUMA.1121.00048,2,1991906,2002039,-,10133
207,BUMA.1121.00017,2,786176,796303,+,10127
207,BUMA.1121.00085,2,151725,161867,-,10142
207,BUMA.1121.00002,2,1337610,1347728,+,10118
207,BUMA.1121.00046,2,1814496,1824614,+,10118
207,BUMA.1121.00042,2,824356,834507,-,10151
207,BUMA.1121.00036,2,354851,364996,+,10145
207,BUMA.1121.00028,2,812310,822437,+,10127
207,BUMA.1121.00010,2,96481,106599,+,10118
207,BUMA.1121.00015,2,1132726,1142877,-,10151
207,BUMA.1121.00022,2,295644,305789,+,10145
207,BUMA.1121.00024,2,906174,916301,+,10127
207,BUMA.1121.00052,2,840291,850433,-,10142
207,BUMA.1121.00032,2,1278776,1288903,+,10127
207,BUMA.1121.00044,2,837317,847444,+,10127
207,BUMA.1121.00030,2,1325456,1335598,-,10142
206,BUMA.1121.00050,2,1369012,1430689,+,61677
206,BUMA.1121.00081,2,1262716,1324417,-,61701
206,BUMA.1121.00006,2,999121,1060867,+,61746
206,BUMA.1121.00087,2,1308730,1370533,+,61803
206,BUMA.1121.00040,2,1050327,1112040,+,61713
206,BUMA.1121.00086,2,1041233,1103036,+,61803
206,BUMA.1121.00054,2,799246,860983,+,61737
206,BUMA.1121.00034,2,724431,786203,+,61772
206,BUMA.1121.00048,2,2002069,2063783,-,61714
206,BUMA.1121.00017,2,724403,786175,+,61772
206,BUMA.1121.00085,2,161896,223526,-,61630
206,BUMA.1121.00002,2,1275781,1337609,+,61828
206,BUMA.1121.00046,2,1752818,1814495,+,61677
206,BUMA.1121.00042,2,836135,896533,-,60398
206,BUMA.1121.00036,2,293006,354850,+,61844
206,BUMA.1121.00028,2,750528,812309,+,61781
206,BUMA.1121.00010,2,34655,96480,+,61825
206,BUMA.1121.00015,2,1142906,1204632,-,61726
206,BUMA.1121.00022,2,233823,295643,+,61820
206,BUMA.1121.00024,2,844392,906173,+,61781
206,BUMA.1121.00052,2,850462,912091,-,61629
206,BUMA.1121.00032,2,1217054,1278775,+,61721
206,BUMA.1121.00044,2,775545,837316,+,61771
206,BUMA.1121.00030,2,1335627,1397355,-,61728
205,BUMA.1121.00050,2,1359828,1367739,+,7911
205,BUMA.1121.00081,2,1325690,1333601,-,7911
205,BUMA.1121.00006,2,989937,997848,+,7911
205,BUMA.1121.00087,2,1299553,1307457,+,7904
205,BUMA.1121.00040,2,1041155,1049054,+,7899
205,BUMA.1121.00086,2,1032056,1039960,+,7904
205,BUMA.1121.00054,2,790062,797973,+,7911
205,BUMA.1121.00034,2,715254,723158,+,7904
205,BUMA.1121.00048,2,2065024,2072951,-,7927
205,BUMA.1121.00017,2,715226,723130,+,7904
205,BUMA.1121.00038,2,989949,997876,+,7927
205,BUMA.1121.00085,2,224799,232704,-,7905
205,BUMA.1121.00002,2,1266597,1274508,+,7911
205,BUMA.1121.00046,2,1743634,1751545,+,7911
205,BUMA.1121.00042,2,897775,905695,-,7920
205,BUMA.1121.00036,2,283829,291733,+,7904
205,BUMA.1121.00013,2,1520358,1528278,-,7920
205,BUMA.1121.00028,2,741351,749255,+,7904
205,BUMA.1121.00010,2,25486,33413,+,7927
205,BUMA.1121.00004,2,805898,813818,+,7920
205,BUMA.1121.00015,2,1205905,1213817,-,7912
205,BUMA.1121.00008,2,805178,813098,+,7920
205,BUMA.1121.00022,2,224661,232581,+,7920
205,BUMA.1121.00026,2,1356218,1364138,+,7920
205,BUMA.1121.00024,2,741281,749198,+,7917
205,BUMA.1121.00024,2,835216,843119,+,7903
205,BUMA.1121.00052,2,913364,921269,-,7905
205,BUMA.1121.00032,2,1207877,1215781,+,7904
205,BUMA.1121.00019,2,805883,813803,+,7920
205,BUMA.1121.00044,2,766368,774272,+,7904
205,BUMA.1121.00030,2,1398628,1406533,-,7905
205,BUMA.1121.00020,2,805919,813839,+,7920
204,BUMA.1121.00050,2,1334363,1358556,+,24193
204,BUMA.1121.00081,2,1334873,1359066,-,24193
204,BUMA.1121.00006,2,964472,988665,+,24193
204,BUMA.1121.00087,2,1274088,1298281,+,24193
204,BUMA.1121.00040,2,1015682,1039883,+,24201
204,BUMA.1121.00086,2,1006591,1030784,+,24193
204,BUMA.1121.00054,2,764597,788790,+,24193
204,BUMA.1121.00034,2,689789,713982,+,24193
204,BUMA.1121.00048,2,2074223,2098416,-,24193
204,BUMA.1121.00017,2,689761,713954,+,24193
204,BUMA.1121.00038,2,964484,988677,+,24193
204,BUMA.1121.00085,2,233976,258169,-,24193
204,BUMA.1121.00002,2,1241142,1265325,+,24183
204,BUMA.1121.00046,2,1718169,1742362,+,24193
204,BUMA.1121.00042,2,906967,931153,-,24186
204,BUMA.1121.00036,2,258364,282557,+,24193
204,BUMA.1121.00013,2,1529550,1553743,-,24193
204,BUMA.1121.00028,2,715886,740079,+,24193
204,BUMA.1121.00010,2,31,24214,+,24183
204,BUMA.1121.00004,2,780433,804626,+,24193
204,BUMA.1121.00015,2,1215089,1239282,-,24193
204,BUMA.1121.00008,2,779713,803906,+,24193
204,BUMA.1121.00022,2,199196,223389,+,24193
204,BUMA.1121.00026,2,1330760,1354946,+,24186
204,BUMA.1121.00024,2,715816,740009,+,24193
204,BUMA.1121.00024,2,809751,833944,+,24193
204,BUMA.1121.00052,2,922541,946734,-,24193
204,BUMA.1121.00032,2,1182412,1206605,+,24193
204,BUMA.1121.00019,2,780418,804611,+,24193
204,BUMA.1121.00044,2,740903,765096,+,24193
204,BUMA.1121.00030,2,1407805,1431998,-,24193
204,BUMA.1121.00020,2,780454,804647,+,24193
203,BUMA.1121.00050,2,1314798,1332169,+,17371
203,BUMA.1121.00081,2,1361259,1378630,-,17371
203,BUMA.1121.00006,2,944907,962278,+,17371
203,BUMA.1121.00087,2,1254523,1271894,+,17371
203,BUMA.1121.00040,2,996118,1013488,+,17370
203,BUMA.1121.00086,2,987026,1004397,+,17371
203,BUMA.1121.00054,2,745032,762403,+,17371
203,BUMA.1121.00034,2,670224,687595,+,17371
203,BUMA.1121.00048,2,2100609,2117980,-,17371
203,BUMA.1121.00017,2,670196,687567,+,17371
203,BUMA.1121.00038,2,944919,962290,+,17371
203,BUMA.1121.00085,2,260362,277733,-,17371
203,BUMA.1121.00002,2,1221589,1238948,+,17359
203,BUMA.1121.00046,2,1698604,1715975,+,17371
203,BUMA.1121.00042,2,933346,950717,-,17371
203,BUMA.1121.00036,2,238799,256170,+,17371
203,BUMA.1121.00013,2,1555936,1573307,-,17371
203,BUMA.1121.00028,2,696321,713692,+,17371
203,BUMA.1121.00010,2,2077384,2094743,+,17359
203,BUMA.1121.00004,2,760868,778239,+,17371
203,BUMA.1121.00015,2,1241475,1258829,-,17354
203,BUMA.1121.00008,2,760148,777519,+,17371
203,BUMA.1121.00022,2,179631,197002,+,17371
203,BUMA.1121.00026,2,1311195,1328566,+,17371
203,BUMA.1121.00024,2,696251,713622,+,17371
203,BUMA.1121.00024,2,790186,807557,+,17371
203,BUMA.1121.00052,2,948927,966298,-,17371
203,BUMA.1121.00032,2,1162847,1180218,+,17371
203,BUMA.1121.00019,2,760853,778224,+,17371
203,BUMA.1121.00044,2,721338,738709,+,17371
203,BUMA.1121.00030,2,1434191,1451562,-,17371
203,BUMA.1121.00020,2,760889,778260,+,17371
202,BUMA.1121.00050,2,1280785,1313779,+,32994
202,BUMA.1121.00081,2,1379649,1412716,-,33067
202,BUMA.1121.00006,2,910822,943888,+,33066
202,BUMA.1121.00087,2,1220454,1253504,+,33050
202,BUMA.1121.00040,2,962049,995099,+,33050
202,BUMA.1121.00086,2,952957,986007,+,33050
202,BUMA.1121.00054,2,710947,744013,+,33066
202,BUMA.1121.00034,2,636155,669205,+,33050
202,BUMA.1121.00048,2,2118999,2152066,-,33067
202,BUMA.1121.00017,2,636127,669177,+,33050
202,BUMA.1121.00038,2,910834,943900,+,33066
202,BUMA.1121.00085,2,278752,311875,-,33123
202,BUMA.1121.00002,2,1187520,1220570,+,33050
202,BUMA.1121.00046,2,1664591,1697585,+,32994
202,BUMA.1121.00042,2,951736,984731,-,32995
202,BUMA.1121.00036,2,204735,237780,+,33045
202,BUMA.1121.00013,2,1574326,1607424,-,33098
202,BUMA.1121.00028,2,662252,695302,+,33050
202,BUMA.1121.00010,2,2043363,2076365,+,33002
202,BUMA.1121.00004,2,726799,759849,+,33050
202,BUMA.1121.00015,2,1259848,1292952,-,33104
202,BUMA.1121.00008,2,726079,759129,+,33050
202,BUMA.1121.00022,2,145610,178612,+,33002
202,BUMA.1121.00026,2,1277142,1310176,+,33034
202,BUMA.1121.00024,2,662193,695232,+,33039
202,BUMA.1121.00024,2,756117,789167,+,33050
202,BUMA.1121.00052,2,967317,1000432,-,33115
202,BUMA.1121.00032,2,1128778,1161828,+,33050
202,BUMA.1121.00019,2,726784,759834,+,33050
202,BUMA.1121.00044,2,687269,720319,+,33050
202,BUMA.1121.00030,2,1452581,1485632,-,33051
202,BUMA.1121.00020,2,726820,759870,+,33050
201,BUMA.1121.00050,2,1272579,1277952,+,5373
201,BUMA.1121.00081,2,1415549,1420921,-,5372
201,BUMA.1121.00006,2,902616,907989,+,5373
201,BUMA.1121.00087,2,1206582,1211955,+,5373
201,BUMA.1121.00040,2,1268650,1274022,-,5372
201,BUMA.1121.00086,2,939085,944458,+,5373
201,BUMA.1121.00054,2,702741,708114,+,5373
201,BUMA.1121.00034,2,622282,627656,+,5374
201,BUMA.1121.00048,2,2154897,2160269,-,5372
201,BUMA.1121.00017,2,622254,627628,+,5374
201,BUMA.1121.00038,2,902628,908001,+,5373
201,BUMA.1121.00085,2,314708,320080,-,5372
201,BUMA.1121.00002,2,1173648,1179021,+,5373
201,BUMA.1121.00046,2,1656385,1661758,+,5373
201,BUMA.1121.00042,2,189358,194743,+,5385
201,BUMA.1121.00036,2,190863,196236,+,5373
201,BUMA.1121.00013,2,1610257,1615629,-,5372
201,BUMA.1121.00028,2,648379,653753,+,5374
201,BUMA.1121.00010,2,2029491,2034864,+,5373
201,BUMA.1121.00004,2,712926,718300,+,5374
201,BUMA.1121.00015,2,1295785,1301157,-,5372
201,BUMA.1121.00008,2,712206,717580,+,5374
201,BUMA.1121.00022,2,131738,137111,+,5373
201,BUMA.1121.00026,2,63186,68558,-,5372
201,BUMA.1121.00024,2,648319,653693,+,5374
201,BUMA.1121.00052,2,1003265,1008637,-,5372
201,BUMA.1121.00032,2,1114905,1120279,+,5374
201,BUMA.1121.00019,2,712911,718285,+,5374
201,BUMA.1121.00044,2,673396,678770,+,5374
201,BUMA.1121.00030,2,1494131,1499504,-,5373
201,BUMA.1121.00020,2,712947,718321,+,5374
200,BUMA.1121.00050,2,1212854,1272578,+,59724
200,BUMA.1121.00081,2,1420923,1480369,-,59446
200,BUMA.1121.00006,2,843146,902615,+,59469
200,BUMA.1121.00087,2,1147055,1206581,+,59526
200,BUMA.1121.00040,2,1274024,1333400,-,59376
200,BUMA.1121.00086,2,879635,939084,+,59449
200,BUMA.1121.00054,2,643294,702740,+,59446
200,BUMA.1121.00034,2,563020,622281,+,59261
200,BUMA.1121.00048,2,2160271,2219717,-,59446
200,BUMA.1121.00017,2,562985,622253,+,59268
200,BUMA.1121.00038,2,843181,902627,+,59446
200,BUMA.1121.00085,2,320082,379749,-,59667
200,BUMA.1121.00002,2,1114265,1173647,+,59382
200,BUMA.1121.00046,2,1596556,1656384,+,59828
200,BUMA.1121.00042,2,128676,188122,+,59446
200,BUMA.1121.00036,2,131410,190862,+,59452
200,BUMA.1121.00013,2,1615631,1675166,-,59535
200,BUMA.1121.00028,2,589117,648378,+,59261
200,BUMA.1121.00010,2,1970148,2029490,+,59342
200,BUMA.1121.00004,2,653671,712925,+,59254
200,BUMA.1121.00015,2,1301159,1360606,-,59447
200,BUMA.1121.00008,2,652944,712205,+,59261
200,BUMA.1121.00022,2,72387,131737,+,59350
200,BUMA.1121.00026,2,68560,127847,-,59287
200,BUMA.1121.00024,2,589022,648318,+,59296
200,BUMA.1121.00052,2,1008639,1068306,-,59667
200,BUMA.1121.00032,2,1055580,1114904,+,59324
200,BUMA.1121.00019,2,653649,712910,+,59261
200,BUMA.1121.00044,2,614134,673395,+,59261
200,BUMA.1121.00030,2,1499506,1558781,-,59275
200,BUMA.1121.00020,2,653678,712946,+,59268
199,BUMA.1121.00050,2,1175595,1211401,+,35806
199,BUMA.1121.00081,2,1481822,1517614,-,35792
199,BUMA.1121.00006,2,805901,841693,+,35792
199,BUMA.1121.00087,2,1680727,1716523,-,35796
199,BUMA.1121.00040,2,772433,808238,+,35805
199,BUMA.1121.00086,2,1413337,1449133,-,35796
199,BUMA.1121.00054,2,606049,641841,+,35792
199,BUMA.1121.00034,2,1046212,1082049,-,35837
199,BUMA.1121.00048,2,2221170,2256962,-,35792
199,BUMA.1121.00017,2,1046191,1082028,-,35837
199,BUMA.1121.00038,2,805936,841728,+,35792
199,BUMA.1121.00085,2,499205,535052,-,35847
199,BUMA.1121.00002,2,1465512,1501379,+,35867
199,BUMA.1121.00046,2,1559297,1595103,+,35806
199,BUMA.1121.00042,2,362784,398543,+,35759
199,BUMA.1121.00036,2,665067,700851,-,35784
199,BUMA.1121.00013,2,1794520,1830357,-,35837
199,BUMA.1121.00028,2,1072323,1108160,-,35837
199,BUMA.1121.00010,2,224367,260214,+,35847
199,BUMA.1121.00004,2,1031068,1066905,-,35837
199,BUMA.1121.00008,2,1030368,1066205,-,35837
199,BUMA.1121.00022,2,605679,641513,-,35834
199,BUMA.1121.00026,2,1687646,1723451,-,35805
199,BUMA.1121.00024,2,1166174,1202011,-,35837
199,BUMA.1121.00052,2,1187752,1223599,-,35847
199,BUMA.1121.00019,2,1110228,1146065,-,35837
199,BUMA.1121.00044,2,1097316,1133153,-,35837
199,BUMA.1121.00030,2,1039745,1075582,+,35837
199,BUMA.1121.00020,2,1031105,1066942,-,35837
198,BUMA.1121.00050,2,1165478,1172409,+,6931
198,BUMA.1121.00081,2,900967,907898,+,6931
198,BUMA.1121.00006,2,1415637,1422567,-,6930
198,BUMA.1121.00087,2,1131126,1138056,-,6930
198,BUMA.1121.00040,2,1336624,1343554,-,6930
198,BUMA.1121.00086,2,863706,870636,-,6930
198,BUMA.1121.00054,2,1215756,1222686,-,6930
198,BUMA.1121.00034,2,552865,559796,+,6931
198,BUMA.1121.00048,2,1640331,1647262,+,6931
198,BUMA.1121.00017,2,552830,559761,+,6931
198,BUMA.1121.00038,2,1316803,1323733,-,6930
198,BUMA.1121.00085,2,1709840,1716771,+,6931
198,BUMA.1121.00002,2,1101436,1108366,-,6930
198,BUMA.1121.00042,2,993068,1000000,-,6932
198,BUMA.1121.00036,2,792684,799615,+,6931
198,BUMA.1121.00013,2,1390646,1397576,-,6930
198,BUMA.1121.00028,2,578962,585893,+,6931
198,BUMA.1121.00010,2,1957334,1964264,-,6930
198,BUMA.1121.00004,2,643516,650447,+,6931
198,BUMA.1121.00015,2,802017,808948,+,6931
198,BUMA.1121.00008,2,642789,649720,+,6931
198,BUMA.1121.00022,2,56421,63351,-,6930
198,BUMA.1121.00026,2,1261652,1268583,+,6931
198,BUMA.1121.00024,2,578867,585798,+,6931
198,BUMA.1121.00052,2,663486,670417,+,6931
198,BUMA.1121.00032,2,1045425,1052356,+,6931
198,BUMA.1121.00019,2,643494,650425,+,6931
198,BUMA.1121.00044,2,603979,610910,+,6931
198,BUMA.1121.00030,2,1562005,1568935,-,6930
198,BUMA.1121.00020,2,643523,650454,+,6931
197,BUMA.1121.00050,2,1147089,1152315,+,5226
197,BUMA.1121.00081,2,880741,885967,+,5226
197,BUMA.1121.00006,2,1437568,1442794,-,5226
197,BUMA.1121.00087,2,2098472,2103698,-,5226
197,BUMA.1121.00040,2,1358553,1363779,-,5226
197,BUMA.1121.00086,2,851249,856475,+,5226
197,BUMA.1121.00054,2,1237687,1242913,-,5226
197,BUMA.1121.00034,2,532639,537865,+,5226
197,BUMA.1121.00048,2,1620107,1625333,+,5226
197,BUMA.1121.00017,2,532605,537831,+,5226
197,BUMA.1121.00038,2,1338734,1343960,-,5226
197,BUMA.1121.00085,2,1729711,1734922,+,5211
197,BUMA.1121.00042,2,1016541,1021767,-,5226
197,BUMA.1121.00036,2,806842,812068,-,5226
197,BUMA.1121.00013,2,1378189,1383415,+,5226
197,BUMA.1121.00028,2,558736,563962,+,5226
197,BUMA.1121.00004,2,623290,628516,+,5226
197,BUMA.1121.00015,2,1618995,1624221,-,5226
197,BUMA.1121.00008,2,623141,628367,+,5226
197,BUMA.1121.00022,2,43967,49193,+,5226
197,BUMA.1121.00026,2,1241426,1246652,+,5226
197,BUMA.1121.00024,2,558641,563867,+,5226
197,BUMA.1121.00052,2,683357,688583,+,5226
197,BUMA.1121.00019,2,623268,628494,+,5226
197,BUMA.1121.00044,2,583754,588980,+,5226
197,BUMA.1121.00030,2,1583936,1589162,-,5226
197,BUMA.1121.00020,2,623297,628523,+,5226
196,BUMA.1121.00050,2,1137316,1147087,+,9771
196,BUMA.1121.00081,2,870966,880739,+,9773
196,BUMA.1121.00006,2,1442795,1452569,-,9774
196,BUMA.1121.00087,2,2103699,2113621,-,9922
196,BUMA.1121.00040,2,1365354,1375294,-,9940
196,BUMA.1121.00086,2,841326,851247,+,9921
196,BUMA.1121.00054,2,1242914,1252688,-,9774
196,BUMA.1121.00034,2,522716,532637,+,9921
196,BUMA.1121.00048,2,1610332,1620105,+,9773
196,BUMA.1121.00017,2,522682,532603,+,9921
196,BUMA.1121.00038,2,1343961,1353735,-,9774
196,BUMA.1121.00085,2,1719936,1729709,+,9773
196,BUMA.1121.00042,2,1021768,1031699,-,9931
196,BUMA.1121.00036,2,812069,821991,-,9922
196,BUMA.1121.00013,2,1368416,1378187,+,9771
196,BUMA.1121.00028,2,548813,558734,+,9921
196,BUMA.1121.00004,2,613367,623288,+,9921
196,BUMA.1121.00015,2,1624222,1633993,-,9771
196,BUMA.1121.00008,2,613218,623139,+,9921
196,BUMA.1121.00022,2,34044,43965,+,9921
196,BUMA.1121.00026,2,1231523,1241424,+,9901
196,BUMA.1121.00024,2,548718,558639,+,9921
196,BUMA.1121.00052,2,673582,683355,+,9773
196,BUMA.1121.00019,2,613345,623266,+,9921
196,BUMA.1121.00044,2,573832,583752,+,9920
196,BUMA.1121.00030,2,1589163,1599085,-,9922
196,BUMA.1121.00020,2,613374,623295,+,9921
195,BUMA.1121.00050,2,1130553,1136074,+,5521
195,BUMA.1121.00040,2,1376536,1382057,-,5521
195,BUMA.1121.00042,2,357251,362782,+,5531
195,BUMA.1121.00013,2,1361653,1367174,+,5521
195,BUMA.1121.00015,2,1635235,1640756,-,5521
195,BUMA.1121.00026,2,1723452,1728983,-,5531
194,BUMA.1121.00050,2,1122390,1125711,+,3321
194,BUMA.1121.00081,2,1173767,1178393,-,4626
194,BUMA.1121.00006,2,1145144,1149771,+,4627
194,BUMA.1121.00040,2,1386878,1390207,-,3329
194,BUMA.1121.00054,2,945260,949887,+,4627
194,BUMA.1121.00048,2,1913125,1917747,-,4622
194,BUMA.1121.00038,2,1046311,1050938,+,4627
194,BUMA.1121.00042,2,349096,352417,+,3321
194,BUMA.1121.00013,2,1353490,1356811,+,3321
194,BUMA.1121.00015,2,1645623,1648940,-,3317
194,BUMA.1121.00026,2,1733892,1737212,-,3320
193,BUMA.1121.00050,2,1099172,1122389,+,23217
193,BUMA.1121.00081,2,1178395,1201612,-,23217
193,BUMA.1121.00006,2,1121926,1145143,+,23217
193,BUMA.1121.00087,2,1717751,1740975,-,23224
193,BUMA.1121.00040,2,1390209,1413439,-,23230
193,BUMA.1121.00086,2,1450361,1473592,-,23231
193,BUMA.1121.00054,2,922042,945259,+,23217
193,BUMA.1121.00034,2,1083277,1106494,-,23217
193,BUMA.1121.00048,2,1917749,1940965,-,23216
193,BUMA.1121.00017,2,1083256,1106473,-,23217
193,BUMA.1121.00038,2,1023093,1046310,+,23217
193,BUMA.1121.00002,2,1441052,1464284,+,23232
193,BUMA.1121.00042,2,325881,349095,+,23214
193,BUMA.1121.00036,2,702079,725303,-,23224
193,BUMA.1121.00013,2,1330279,1353489,+,23210
193,BUMA.1121.00028,2,1109388,1132605,-,23217
193,BUMA.1121.00010,2,199905,223139,+,23234
193,BUMA.1121.00004,2,1068133,1091350,-,23217
193,BUMA.1121.00015,2,1648942,1672165,-,23223
193,BUMA.1121.00008,2,1067433,1090650,-,23217
193,BUMA.1121.00022,2,642741,665970,-,23229
193,BUMA.1121.00026,2,1737214,1760409,-,23195
193,BUMA.1121.00024,2,1203239,1226456,-,23217
193,BUMA.1121.00019,2,1147293,1170510,-,23217
193,BUMA.1121.00044,2,1134381,1157598,-,23217
193,BUMA.1121.00030,2,1015299,1038517,+,23218
193,BUMA.1121.00020,2,1068170,1091387,-,23217
192,BUMA.1121.00050,2,1090330,1098200,+,7870
192,BUMA.1121.00081,2,1202584,1210454,-,7870
192,BUMA.1121.00006,2,1113084,1120954,+,7870
192,BUMA.1121.00087,2,1741947,1749817,-,7870
192,BUMA.1121.00040,2,1414411,1422281,-,7870
192,BUMA.1121.00086,2,1474564,1482434,-,7870
192,BUMA.1121.00054,2,913200,921070,+,7870
192,BUMA.1121.00034,2,1107466,1115336,-,7870
192,BUMA.1121.00048,2,1941937,1949807,-,7870
192,BUMA.1121.00017,2,1107445,1115315,-,7870
192,BUMA.1121.00038,2,1014251,1022121,+,7870
192,BUMA.1121.00002,2,1432210,1440080,+,7870
192,BUMA.1121.00042,2,317039,324909,+,7870
192,BUMA.1121.00036,2,726275,734145,-,7870
192,BUMA.1121.00013,2,1321437,1329307,+,7870
192,BUMA.1121.00028,2,1133577,1141447,-,7870
192,BUMA.1121.00010,2,191063,198933,+,7870
192,BUMA.1121.00004,2,1092322,1100192,-,7870
192,BUMA.1121.00015,2,1673137,1681007,-,7870
192,BUMA.1121.00008,2,1091622,1099492,-,7870
192,BUMA.1121.00022,2,666942,674812,-,7870
192,BUMA.1121.00026,2,1761381,1769251,-,7870
192,BUMA.1121.00024,2,1227428,1235298,-,7870
192,BUMA.1121.00019,2,1171482,1179352,-,7870
192,BUMA.1121.00044,2,1158570,1166440,-,7870
192,BUMA.1121.00030,2,1006457,1014327,+,7870
192,BUMA.1121.00020,2,1092359,1100229,-,7870
191,BUMA.1121.00050,2,1075911,1089722,+,13811
191,BUMA.1121.00081,2,1211062,1224874,-,13812
191,BUMA.1121.00006,2,1098665,1112476,+,13811
191,BUMA.1121.00087,2,1750425,1764237,-,13812
191,BUMA.1121.00040,2,1422889,1436701,-,13812
191,BUMA.1121.00086,2,1483042,1496854,-,13812
191,BUMA.1121.00054,2,898781,912592,+,13811
191,BUMA.1121.00034,2,1115944,1129756,-,13812
191,BUMA.1121.00048,2,1950415,1964227,-,13812
191,BUMA.1121.00017,2,1115923,1129735,-,13812
191,BUMA.1121.00038,2,999832,1013643,+,13811
191,BUMA.1121.00002,2,1417805,1431616,+,13811
191,BUMA.1121.00042,2,301307,315134,+,13827
191,BUMA.1121.00036,2,734753,748565,-,13812
191,BUMA.1121.00013,2,1307018,1320829,+,13811
191,BUMA.1121.00028,2,1142055,1155867,-,13812
191,BUMA.1121.00010,2,176658,190469,+,13811
191,BUMA.1121.00004,2,1100800,1114612,-,13812
191,BUMA.1121.00015,2,1681615,1695427,-,13812
191,BUMA.1121.00008,2,1100100,1113912,-,13812
191,BUMA.1121.00022,2,675420,689232,-,13812
191,BUMA.1121.00026,2,1769859,1783671,-,13812
191,BUMA.1121.00024,2,1235906,1249718,-,13812
191,BUMA.1121.00019,2,1179960,1193772,-,13812
191,BUMA.1121.00044,2,1167048,1180860,-,13812
191,BUMA.1121.00030,2,992038,1005849,+,13811
191,BUMA.1121.00020,2,1100837,1114649,-,13812
190,BUMA.1121.00050,2,1044052,1073924,+,29872
190,BUMA.1121.00081,2,839881,869679,+,29798
190,BUMA.1121.00006,2,1453856,1483654,-,29798
190,BUMA.1121.00087,2,1770786,1800590,-,29804
190,BUMA.1121.00040,2,1441893,1471653,-,29760
190,BUMA.1121.00086,2,1503404,1533208,-,29804
190,BUMA.1121.00054,2,1253975,1283773,-,29798
190,BUMA.1121.00034,2,1134553,1164349,-,29796
190,BUMA.1121.00048,2,1579247,1609045,+,29798
190,BUMA.1121.00017,2,1134532,1164328,-,29796
190,BUMA.1121.00038,2,1355022,1384820,-,29798
190,BUMA.1121.00002,2,1381523,1411255,+,29732
190,BUMA.1121.00036,2,753853,783647,-,29794
190,BUMA.1121.00013,2,1272564,1302355,+,29791
190,BUMA.1121.00028,2,1160664,1190469,-,29805
190,BUMA.1121.00010,2,140388,170108,+,29720
190,BUMA.1121.00004,2,1119409,1149204,-,29795
190,BUMA.1121.00015,2,812144,841952,+,29808
190,BUMA.1121.00008,2,1118709,1148504,-,29795
190,BUMA.1121.00022,2,695782,725516,-,29734
190,BUMA.1121.00026,2,1784908,1814614,-,29706
190,BUMA.1121.00024,2,1254515,1284332,-,29817
190,BUMA.1121.00019,2,1198569,1228358,-,29789
190,BUMA.1121.00044,2,1185657,1215453,-,29796
190,BUMA.1121.00030,2,957446,987241,+,29795
190,BUMA.1121.00020,2,1119446,1149235,-,29789
189,BUMA.1121.00050,2,1017164,1042809,+,25645
189,BUMA.1121.00081,2,1036108,1061765,+,25657
189,BUMA.1121.00006,2,1261766,1287423,-,25657
189,BUMA.1121.00087,2,1525718,1551356,-,25638
189,BUMA.1121.00040,2,935153,960824,+,25671
189,BUMA.1121.00086,2,1258284,1283922,-,25638
189,BUMA.1121.00054,2,1061889,1087546,-,25657
189,BUMA.1121.00048,2,1775480,1801137,+,25657
189,BUMA.1121.00038,2,1162926,1188583,-,25657
189,BUMA.1121.00042,2,652982,678688,+,25706
189,BUMA.1121.00036,2,509995,535633,-,25638
189,BUMA.1121.00015,2,968024,993663,+,25639
189,BUMA.1121.00022,2,450757,476386,-,25629
189,BUMA.1121.00026,2,1599238,1624934,+,25696
188,BUMA.1121.00050,2,1008802,1014951,+,6149
188,BUMA.1121.00081,2,1027750,1033895,+,6145
188,BUMA.1121.00006,2,1289625,1295780,-,6155
188,BUMA.1121.00087,2,1555792,1561951,-,6159
188,BUMA.1121.00040,2,926791,932940,+,6149
188,BUMA.1121.00086,2,1288358,1294517,-,6159
188,BUMA.1121.00054,2,1089748,1095903,-,6155
188,BUMA.1121.00048,2,1767122,1773267,+,6145
188,BUMA.1121.00038,2,1190785,1196940,-,6155
188,BUMA.1121.00042,2,643637,649786,+,6149
188,BUMA.1121.00036,2,540064,546223,-,6159
188,BUMA.1121.00015,2,959662,965811,+,6149
188,BUMA.1121.00022,2,480822,486981,-,6159
188,BUMA.1121.00026,2,1589881,1596030,+,6149
187,BUMA.1121.00050,2,996646,1008801,+,12155
187,BUMA.1121.00081,2,1015579,1027749,+,12170
187,BUMA.1121.00006,2,1295782,1307952,-,12170
187,BUMA.1121.00087,2,1561953,1574256,-,12303
187,BUMA.1121.00040,2,914639,926790,+,12151
187,BUMA.1121.00086,2,1294519,1306906,-,12387
187,BUMA.1121.00054,2,1095905,1108075,-,12170
187,BUMA.1121.00048,2,1754951,1767121,+,12170
187,BUMA.1121.00038,2,1196942,1209112,-,12170
187,BUMA.1121.00085,2,380973,393167,-,12194
187,BUMA.1121.00042,2,631490,643636,+,12146
187,BUMA.1121.00036,2,546225,558480,-,12255
187,BUMA.1121.00013,2,1676390,1688578,-,12188
187,BUMA.1121.00015,2,947476,959661,+,12185
187,BUMA.1121.00022,2,486983,499250,-,12267
187,BUMA.1121.00026,2,1577728,1589880,+,12152
187,BUMA.1121.00052,2,1069530,1081724,-,12194
186,BUMA.1121.00050,2,943113,995433,+,52320
186,BUMA.1121.00081,2,962185,1014367,+,52182
186,BUMA.1121.00006,2,1309164,1361355,-,52191
186,BUMA.1121.00087,2,1575468,1627808,-,52340
186,BUMA.1121.00040,2,861146,913426,+,52280
186,BUMA.1121.00086,2,1308118,1360408,-,52290
186,BUMA.1121.00054,2,1109287,1161469,-,52182
186,BUMA.1121.00034,2,941299,993319,-,52020
186,BUMA.1121.00048,2,1701547,1753739,+,52192
186,BUMA.1121.00017,2,941278,993298,-,52020
186,BUMA.1121.00038,2,1210324,1262516,-,52192
186,BUMA.1121.00085,2,394379,446680,-,52301
186,BUMA.1121.00002,2,1555578,1607659,+,52081
186,BUMA.1121.00046,2,1503806,1556110,+,52304
186,BUMA.1121.00042,2,578260,630278,+,52018
186,BUMA.1121.00036,2,559692,612172,-,52480
186,BUMA.1121.00013,2,1689790,1741955,-,52165
186,BUMA.1121.00028,2,967398,1019430,-,52032
186,BUMA.1121.00010,2,314417,366464,+,52047
186,BUMA.1121.00004,2,926174,978183,-,52009
186,BUMA.1121.00015,2,893906,946263,+,52357
186,BUMA.1121.00008,2,925427,977475,-,52048
186,BUMA.1121.00022,2,500462,552758,-,52296
186,BUMA.1121.00026,2,1524563,1576516,+,51953
186,BUMA.1121.00024,2,1061263,1113281,-,52018
186,BUMA.1121.00052,2,1082936,1135227,-,52291
186,BUMA.1121.00032,2,1433850,1485838,-,51988
186,BUMA.1121.00019,2,926132,978174,-,52042
186,BUMA.1121.00019,2,1005302,1057332,-,52030
186,BUMA.1121.00044,2,992404,1044423,-,52019
186,BUMA.1121.00030,2,1128475,1180495,+,52020
186,BUMA.1121.00020,2,926168,978212,-,52044
185,BUMA.1121.00050,2,926673,940554,+,13881
185,BUMA.1121.00081,2,945745,959626,+,13881
185,BUMA.1121.00006,2,1363914,1377794,-,13880
185,BUMA.1121.00087,2,1630367,1644247,-,13880
185,BUMA.1121.00040,2,844706,858587,+,13881
185,BUMA.1121.00086,2,1362967,1376847,-,13880
185,BUMA.1121.00054,2,1164028,1177908,-,13880
185,BUMA.1121.00034,2,995878,1009758,-,13880
185,BUMA.1121.00048,2,1685107,1698988,+,13881
185,BUMA.1121.00017,2,995857,1009737,-,13880
185,BUMA.1121.00038,2,1265075,1278955,-,13880
185,BUMA.1121.00085,2,449239,463119,-,13880
185,BUMA.1121.00002,2,1537828,1553024,+,15196
185,BUMA.1121.00046,2,1487366,1501247,+,13881
185,BUMA.1121.00042,2,561820,575701,+,13881
185,BUMA.1121.00036,2,614731,628611,-,13880
185,BUMA.1121.00013,2,1744514,1758394,-,13880
185,BUMA.1121.00028,2,1021989,1035869,-,13880
185,BUMA.1121.00010,2,296670,311863,+,15193
185,BUMA.1121.00004,2,980742,994622,-,13880
185,BUMA.1121.00015,2,877466,891347,+,13881
185,BUMA.1121.00008,2,980034,993914,-,13880
185,BUMA.1121.00022,2,555317,569197,-,13880
185,BUMA.1121.00026,2,1508123,1522004,+,13881
185,BUMA.1121.00024,2,1115840,1129720,-,13880
185,BUMA.1121.00052,2,1137786,1151666,-,13880
185,BUMA.1121.00032,2,1488397,1502277,-,13880
185,BUMA.1121.00019,2,980733,994613,-,13880
185,BUMA.1121.00019,2,1059891,1073771,-,13880
185,BUMA.1121.00044,2,1046982,1060862,-,13880
185,BUMA.1121.00030,2,1112035,1125916,+,13881
185,BUMA.1121.00020,2,980771,994651,-,13880
184,BUMA.1121.00050,2,920725,926672,+,5947
184,BUMA.1121.00050,2,1947790,1953736,-,5946
184,BUMA.1121.00081,2,464758,470687,+,5929
184,BUMA.1121.00081,2,939815,945744,+,5929
184,BUMA.1121.00006,2,1377796,1383722,-,5926
184,BUMA.1121.00006,2,1852823,1858751,-,5928
184,BUMA.1121.00087,2,1034094,1040039,+,5945
184,BUMA.1121.00087,2,1644249,1650193,-,5944
184,BUMA.1121.00040,2,838774,844705,+,5931
184,BUMA.1121.00040,2,1751649,1757581,-,5932
184,BUMA.1121.00086,2,1376849,1382801,-,5952
184,BUMA.1121.00086,2,1915165,1921109,-,5944
184,BUMA.1121.00054,2,1177910,1183838,-,5928
184,BUMA.1121.00054,2,1652944,1658872,-,5928
184,BUMA.1121.00034,2,1009760,1015676,-,5916
184,BUMA.1121.00048,2,1204155,1210082,+,5927
184,BUMA.1121.00048,2,1679179,1685106,+,5927
184,BUMA.1121.00017,2,1009739,1015655,-,5916
184,BUMA.1121.00038,2,1278957,1284885,-,5928
184,BUMA.1121.00038,2,1754017,1759945,-,5928
184,BUMA.1121.00085,2,463121,469017,-,5896
184,BUMA.1121.00085,2,726913,732809,-,5896
184,BUMA.1121.00002,2,1004459,1010381,+,5922
184,BUMA.1121.00002,2,1531906,1537827,+,5921
184,BUMA.1121.00046,2,187011,192961,-,5950
184,BUMA.1121.00046,2,1481418,1487365,+,5947
184,BUMA.1121.00042,2,555888,561819,+,5931
184,BUMA.1121.00036,2,628613,634531,-,5918
184,BUMA.1121.00036,2,2027792,2033735,+,5943
184,BUMA.1121.00013,2,1758396,1764332,-,5936
184,BUMA.1121.00013,2,2118984,2124880,-,5896
184,BUMA.1121.00028,2,1035871,1041787,-,5916
184,BUMA.1121.00010,2,290740,296669,+,5929
184,BUMA.1121.00010,2,1860355,1866277,+,5922
184,BUMA.1121.00004,2,994624,1000532,-,5908
184,BUMA.1121.00015,2,692644,698616,+,5972
184,BUMA.1121.00015,2,871441,877465,+,6024
184,BUMA.1121.00008,2,993916,999832,-,5916
184,BUMA.1121.00022,2,569199,575143,-,5944
184,BUMA.1121.00022,2,1107273,1113209,-,5936
184,BUMA.1121.00026,2,1502161,1508122,+,5961
184,BUMA.1121.00024,2,1129722,1135638,-,5916
184,BUMA.1121.00052,2,1151668,1157564,-,5896
184,BUMA.1121.00052,2,1415460,1421356,-,5896
184,BUMA.1121.00032,2,1502279,1508231,-,5952
184,BUMA.1121.00019,2,994615,1000530,-,5915
184,BUMA.1121.00019,2,1073773,1079692,-,5919
184,BUMA.1121.00044,2,1060864,1066780,-,5916
184,BUMA.1121.00030,2,1106117,1112034,+,5917
184,BUMA.1121.00020,2,994653,1000569,-,5916
183,BUMA.1121.00050,2,892595,912684,+,20089
183,BUMA.1121.00081,2,911685,931774,+,20089
183,BUMA.1121.00006,2,1391760,1411850,-,20090
183,BUMA.1121.00087,2,1658232,1678322,-,20090
183,BUMA.1121.00040,2,810644,830733,+,20089
183,BUMA.1121.00086,2,1390841,1410931,-,20090
183,BUMA.1121.00054,2,1191879,1211969,-,20090
183,BUMA.1121.00034,2,1023716,1043806,-,20090
183,BUMA.1121.00048,2,1651049,1671138,+,20089
183,BUMA.1121.00017,2,1023695,1043785,-,20090
183,BUMA.1121.00038,2,1292926,1313016,-,20090
183,BUMA.1121.00085,2,477058,497148,-,20090
183,BUMA.1121.00002,2,1503785,1523865,+,20080
183,BUMA.1121.00046,2,201002,221092,-,20090
183,BUMA.1121.00042,2,400949,421043,+,20094
183,BUMA.1121.00036,2,642571,662661,-,20090
183,BUMA.1121.00013,2,1772373,1792463,-,20090
183,BUMA.1121.00028,2,1049827,1069917,-,20090
183,BUMA.1121.00010,2,262620,282700,+,20080
183,BUMA.1121.00004,2,1008572,1028662,-,20090
183,BUMA.1121.00015,2,843311,863400,+,20089
183,BUMA.1121.00008,2,1007872,1027962,-,20090
183,BUMA.1121.00022,2,583183,603273,-,20090
183,BUMA.1121.00026,2,1665146,1685240,-,20094
183,BUMA.1121.00024,2,1143678,1163768,-,20090
183,BUMA.1121.00052,2,1165605,1185695,-,20090
183,BUMA.1121.00032,2,1516271,1536361,-,20090
183,BUMA.1121.00019,2,1087732,1107822,-,20090
183,BUMA.1121.00044,2,1074820,1094910,-,20090
183,BUMA.1121.00030,2,1077988,1098077,+,20089
183,BUMA.1121.00020,2,1008609,1028699,-,20090
182,BUMA.1121.00050,2,862840,891273,+,28433
182,BUMA.1121.00081,2,1518856,1547288,-,28432
182,BUMA.1121.00006,2,776226,804659,+,28433
182,BUMA.1121.00087,2,2114871,2143314,-,28443
182,BUMA.1121.00040,2,742748,771191,+,28443
182,BUMA.1121.00086,2,811632,840076,+,28444
182,BUMA.1121.00054,2,576375,604807,+,28432
182,BUMA.1121.00034,2,1269967,1298395,-,28428
182,BUMA.1121.00048,2,2258204,2286636,-,28432
182,BUMA.1121.00017,2,1269960,1298388,-,28428
182,BUMA.1121.00038,2,776261,804694,+,28433
182,BUMA.1121.00046,2,222414,250846,-,28432
182,BUMA.1121.00042,2,1031709,1060163,-,28454
182,BUMA.1121.00036,2,823241,851675,-,28434
182,BUMA.1121.00013,2,1242848,1271327,+,28479
182,BUMA.1121.00028,2,1296129,1324557,-,28428
182,BUMA.1121.00004,2,1254827,1283254,-,28427
182,BUMA.1121.00015,2,1697378,1725798,-,28420
182,BUMA.1121.00008,2,1254142,1282570,-,28428
182,BUMA.1121.00022,2,4365,32794,+,28429
182,BUMA.1121.00026,2,1203024,1231513,+,28489
182,BUMA.1121.00024,2,1389919,1418347,-,28428
182,BUMA.1121.00019,2,1334038,1362466,-,28428
182,BUMA.1121.00044,2,1321068,1349496,-,28428
182,BUMA.1121.00030,2,823401,851830,+,28429
182,BUMA.1121.00020,2,1254903,1283331,-,28428
181,BUMA.1121.00050,2,824076,859730,+,35654
181,BUMA.1121.00081,2,1550399,1586021,-,35622
181,BUMA.1121.00006,2,737494,773116,+,35622
181,BUMA.1121.00087,2,2146425,2182029,-,35604
181,BUMA.1121.00040,2,704014,739638,+,35624
181,BUMA.1121.00086,2,772918,808522,+,35604
181,BUMA.1121.00054,2,537643,573265,+,35622
181,BUMA.1121.00034,2,1301506,1337088,-,35582
181,BUMA.1121.00048,2,2289747,2325354,-,35607
181,BUMA.1121.00017,2,1301499,1337081,-,35582
181,BUMA.1121.00038,2,737529,773151,+,35622
181,BUMA.1121.00046,2,253957,289611,-,35654
181,BUMA.1121.00042,2,1063274,1099057,-,35783
181,BUMA.1121.00036,2,854786,890376,-,35590
181,BUMA.1121.00013,2,1204130,1239738,+,35608
181,BUMA.1121.00028,2,1327668,1363250,-,35582
181,BUMA.1121.00004,2,1286365,1321947,-,35582
181,BUMA.1121.00015,2,1728909,1764540,-,35631
181,BUMA.1121.00008,2,1285681,1321263,-,35582
181,BUMA.1121.00022,2,2317680,2353260,+,35580
181,BUMA.1121.00026,2,1164070,1199914,+,35844
181,BUMA.1121.00024,2,1421458,1457040,-,35582
181,BUMA.1121.00019,2,1365577,1401159,-,35582
181,BUMA.1121.00044,2,1352607,1388189,-,35582
181,BUMA.1121.00030,2,784709,820291,+,35582
181,BUMA.1121.00020,2,1286442,1322024,-,35582
180,BUMA.1121.00050,2,804723,824074,+,19351
180,BUMA.1121.00081,2,1586022,1605364,-,19342
180,BUMA.1121.00006,2,718151,737492,+,19341
180,BUMA.1121.00087,2,2182030,2201462,-,19432
180,BUMA.1121.00040,2,684641,704012,+,19371
180,BUMA.1121.00086,2,753485,772916,+,19431
180,BUMA.1121.00054,2,518300,537641,+,19341
180,BUMA.1121.00034,2,1337089,1356475,-,19386
180,BUMA.1121.00048,2,1,19358,-,19357
180,BUMA.1121.00017,2,1337082,1356468,-,19386
180,BUMA.1121.00038,2,718186,737527,+,19341
180,BUMA.1121.00046,2,289612,308964,-,19352
180,BUMA.1121.00042,2,1099058,1118411,-,19353
180,BUMA.1121.00036,2,890377,909849,-,19472
180,BUMA.1121.00013,2,1184753,1204128,+,19375
180,BUMA.1121.00028,2,1363251,1382637,-,19386
180,BUMA.1121.00004,2,1321948,1341326,-,19378
180,BUMA.1121.00015,2,1764541,1783855,-,19314
180,BUMA.1121.00008,2,1321264,1340650,-,19386
180,BUMA.1121.00022,2,2298303,2317678,+,19375
180,BUMA.1121.00026,2,1144747,1164068,+,19321
180,BUMA.1121.00024,2,1457041,1476427,-,19386
180,BUMA.1121.00019,2,1401160,1420546,-,19386
180,BUMA.1121.00044,2,1388190,1407576,-,19386
180,BUMA.1121.00030,2,765322,784707,+,19385
180,BUMA.1121.00020,2,1322025,1341411,-,19386
179,BUMA.1121.00050,2,793691,803199,+,9508
179,BUMA.1121.00081,2,1606887,1616342,-,9455
179,BUMA.1121.00006,2,707173,716627,+,9454
179,BUMA.1121.00087,2,2202985,2212494,-,9509
179,BUMA.1121.00040,2,673618,683117,+,9499
179,BUMA.1121.00086,2,742453,751961,+,9508
179,BUMA.1121.00054,2,507322,516776,+,9454
179,BUMA.1121.00034,2,1357998,1367498,-,9500
179,BUMA.1121.00048,2,20881,30336,-,9455
179,BUMA.1121.00017,2,1357991,1367491,-,9500
179,BUMA.1121.00038,2,707208,716662,+,9454
179,BUMA.1121.00046,2,310487,319996,-,9509
179,BUMA.1121.00042,2,1119934,1129443,-,9509
179,BUMA.1121.00036,2,911372,920890,-,9518
179,BUMA.1121.00013,2,1173721,1183229,+,9508
179,BUMA.1121.00028,2,1384160,1393660,-,9500
179,BUMA.1121.00004,2,1342849,1352349,-,9500
179,BUMA.1121.00015,2,1785378,1794896,-,9518
179,BUMA.1121.00008,2,1342173,1351673,-,9500
179,BUMA.1121.00022,2,2287271,2296779,+,9508
179,BUMA.1121.00026,2,1133715,1143223,+,9508
179,BUMA.1121.00024,2,1477950,1487450,-,9500
179,BUMA.1121.00019,2,1422069,1431569,-,9500
179,BUMA.1121.00044,2,1409099,1418599,-,9500
179,BUMA.1121.00030,2,754299,763798,+,9499
179,BUMA.1121.00020,2,1342934,1352434,-,9500
178,BUMA.1121.00050,2,788496,792387,+,3891
178,BUMA.1121.00081,2,1617645,1621542,-,3897
178,BUMA.1121.00006,2,701973,705869,+,3896
178,BUMA.1121.00087,2,2213797,2217694,-,3897
178,BUMA.1121.00040,2,668419,672314,+,3895
178,BUMA.1121.00086,2,737253,741149,+,3896
178,BUMA.1121.00054,2,502122,506018,+,3896
178,BUMA.1121.00034,2,1368801,1372698,-,3897
178,BUMA.1121.00048,2,31639,35536,-,3897
178,BUMA.1121.00017,2,1368794,1372691,-,3897
178,BUMA.1121.00038,2,702008,705904,+,3896
178,BUMA.1121.00046,2,321299,325191,-,3892
178,BUMA.1121.00042,2,1130746,1134643,-,3897
178,BUMA.1121.00036,2,922193,926090,-,3897
178,BUMA.1121.00013,2,1168521,1172417,+,3896
178,BUMA.1121.00028,2,1394963,1398860,-,3897
178,BUMA.1121.00004,2,1353652,1357549,-,3897
178,BUMA.1121.00015,2,1796199,1800096,-,3897
178,BUMA.1121.00008,2,1352976,1356873,-,3897
178,BUMA.1121.00022,2,2282071,2285967,+,3896
178,BUMA.1121.00026,2,1128515,1132411,+,3896
178,BUMA.1121.00024,2,1488753,1492650,-,3897
178,BUMA.1121.00019,2,1432872,1436769,-,3897
178,BUMA.1121.00044,2,1419902,1423799,-,3897
178,BUMA.1121.00030,2,749099,752995,+,3896
178,BUMA.1121.00020,2,1353737,1357634,-,3897
177,BUMA.1121.00050,2,783182,787422,+,4240
177,BUMA.1121.00081,2,1622616,1626857,-,4241
177,BUMA.1121.00006,2,696658,700898,+,4240
177,BUMA.1121.00087,2,2218768,2223009,-,4241
177,BUMA.1121.00040,2,663104,667344,+,4240
177,BUMA.1121.00086,2,731938,736178,+,4240
177,BUMA.1121.00054,2,496807,501047,+,4240
177,BUMA.1121.00034,2,1373772,1378013,-,4241
177,BUMA.1121.00048,2,36610,40851,-,4241
177,BUMA.1121.00017,2,1373765,1378006,-,4241
177,BUMA.1121.00038,2,696693,700933,+,4240
177,BUMA.1121.00046,2,326264,330505,-,4241
177,BUMA.1121.00042,2,1135717,1139958,-,4241
177,BUMA.1121.00036,2,927164,931405,-,4241
177,BUMA.1121.00013,2,1163206,1167446,+,4240
177,BUMA.1121.00028,2,1399934,1404175,-,4241
177,BUMA.1121.00004,2,1358623,1362864,-,4241
177,BUMA.1121.00015,2,1801170,1805411,-,4241
177,BUMA.1121.00008,2,1357947,1362188,-,4241
177,BUMA.1121.00022,2,2276756,2280996,+,4240
177,BUMA.1121.00026,2,1123200,1127440,+,4240
177,BUMA.1121.00024,2,1493724,1497965,-,4241
177,BUMA.1121.00019,2,1437843,1442084,-,4241
177,BUMA.1121.00044,2,1424873,1429114,-,4241
177,BUMA.1121.00030,2,743784,748024,+,4240
177,BUMA.1121.00020,2,1358708,1362949,-,4241
176,BUMA.1121.00050,2,778160,781623,+,3463
176,BUMA.1121.00081,2,1639596,1643055,-,3459
176,BUMA.1121.00006,2,680459,683918,+,3459
176,BUMA.1121.00087,2,2235742,2239204,-,3462
176,BUMA.1121.00040,2,647146,650609,+,3463
176,BUMA.1121.00086,2,715742,719198,+,3456
176,BUMA.1121.00054,2,480609,484068,+,3459
176,BUMA.1121.00034,2,1389969,1393431,-,3462
176,BUMA.1121.00048,2,53590,57048,-,3458
176,BUMA.1121.00017,2,1389962,1393424,-,3462
176,BUMA.1121.00038,2,680494,683953,+,3459
176,BUMA.1121.00002,2,1971703,1975180,-,3477
176,BUMA.1121.00046,2,332064,335541,-,3477
176,BUMA.1121.00042,2,1151504,1154947,-,3443
176,BUMA.1121.00036,2,944140,947595,-,3455
176,BUMA.1121.00013,2,1146247,1149703,+,3456
176,BUMA.1121.00028,2,1416130,1419592,-,3462
176,BUMA.1121.00010,2,730283,733745,-,3462
176,BUMA.1121.00004,2,1374819,1378281,-,3462
176,BUMA.1121.00015,2,1806970,1810432,-,3462
176,BUMA.1121.00008,2,1374143,1377605,-,3462
176,BUMA.1121.00022,2,2260561,2264024,+,3463
176,BUMA.1121.00026,2,1108230,1111674,+,3444
176,BUMA.1121.00024,2,1509921,1513383,-,3462
176,BUMA.1121.00032,2,1541655,1545117,-,3462
176,BUMA.1121.00019,2,1454040,1457502,-,3462
176,BUMA.1121.00044,2,1441069,1444531,-,3462
176,BUMA.1121.00030,2,728366,731829,+,3463
176,BUMA.1121.00020,2,1374905,1378367,-,3462
175,BUMA.1121.00050,2,716980,776331,+,59351
175,BUMA.1121.00081,2,1644296,1703651,-,59355
175,BUMA.1121.00006,2,619864,679218,+,59354
175,BUMA.1121.00087,2,2241036,2300532,-,59496
175,BUMA.1121.00040,2,585983,645317,+,59334
175,BUMA.1121.00086,2,654380,713912,+,59532
175,BUMA.1121.00054,2,420014,479368,+,59354
175,BUMA.1121.00034,2,1395261,1454791,-,59530
175,BUMA.1121.00048,2,58289,117645,-,59356
175,BUMA.1121.00017,2,1395254,1454784,-,59530
175,BUMA.1121.00038,2,619899,679253,+,59354
175,BUMA.1121.00002,2,1976996,2036372,-,59376
175,BUMA.1121.00046,2,337356,396716,-,59360
175,BUMA.1121.00042,2,1156777,1216640,-,59863
175,BUMA.1121.00036,2,949426,1008875,-,59449
175,BUMA.1121.00013,2,1085034,1144418,+,59384
175,BUMA.1121.00028,2,1421422,1480924,-,59502
175,BUMA.1121.00010,2,735575,795085,-,59510
175,BUMA.1121.00004,2,1380111,1439639,-,59528
175,BUMA.1121.00015,2,1811941,1871376,-,59435
175,BUMA.1121.00008,2,1379435,1438980,-,59545
175,BUMA.1121.00022,2,2199275,2258732,+,59457
175,BUMA.1121.00026,2,1046444,1106401,+,59957
175,BUMA.1121.00024,2,1515213,1574660,-,59447
175,BUMA.1121.00032,2,1546947,1606495,-,59548
175,BUMA.1121.00019,2,1459332,1518886,-,59554
175,BUMA.1121.00044,2,1446361,1505891,-,59530
175,BUMA.1121.00030,2,667007,726537,+,59530
175,BUMA.1121.00020,2,1380197,1439751,-,59554
174,BUMA.1121.00050,2,666091,716978,+,50887
174,BUMA.1121.00081,2,1703652,1754524,-,50872
174,BUMA.1121.00006,2,568990,619862,+,50872
174,BUMA.1121.00087,2,2300533,2351417,-,50884
174,BUMA.1121.00040,2,535069,585981,+,50912
174,BUMA.1121.00086,2,603510,654378,+,50868
174,BUMA.1121.00054,2,369141,420012,+,50871
174,BUMA.1121.00034,2,1454792,1505640,-,50848
174,BUMA.1121.00048,2,117646,168518,-,50872
174,BUMA.1121.00017,2,1454785,1505631,-,50846
174,BUMA.1121.00038,2,569025,619897,+,50872
174,BUMA.1121.00002,2,2036373,2087213,-,50840
174,BUMA.1121.00046,2,396717,447604,-,50887
174,BUMA.1121.00036,2,1008876,1059753,-,50877
174,BUMA.1121.00013,2,1034151,1085032,+,50881
174,BUMA.1121.00028,2,1480925,1531773,-,50848
174,BUMA.1121.00010,2,795086,845926,-,50840
174,BUMA.1121.00004,2,1439640,1490487,-,50847
174,BUMA.1121.00015,2,1871377,1922328,-,50951
174,BUMA.1121.00008,2,1438981,1489829,-,50848
174,BUMA.1121.00022,2,2148429,2199273,+,50844
174,BUMA.1121.00024,2,1574661,1625509,-,50848
174,BUMA.1121.00032,2,1606496,1657336,-,50840
174,BUMA.1121.00019,2,1518887,1569735,-,50848
174,BUMA.1121.00044,2,1505892,1556739,-,50847
174,BUMA.1121.00030,2,616157,667005,+,50848
174,BUMA.1121.00020,2,1439752,1490600,-,50848
173,BUMA.1121.00050,2,659986,666090,+,6104
173,BUMA.1121.00081,2,1754526,1760629,-,6103
173,BUMA.1121.00006,2,562885,568989,+,6104
173,BUMA.1121.00087,2,1,6089,-,6088
173,BUMA.1121.00040,2,528964,535068,+,6104
173,BUMA.1121.00086,2,597405,603509,+,6104
173,BUMA.1121.00054,2,363036,369140,+,6104
173,BUMA.1121.00034,2,1505642,1511745,-,6103
173,BUMA.1121.00048,2,168520,174623,-,6103
173,BUMA.1121.00017,2,1505633,1511736,-,6103
173,BUMA.1121.00038,2,562920,569024,+,6104
173,BUMA.1121.00002,2,2087215,2093334,-,6119
173,BUMA.1121.00046,2,447606,453709,-,6103
173,BUMA.1121.00036,2,1059755,1065858,-,6103
173,BUMA.1121.00013,2,1028046,1034150,+,6104
173,BUMA.1121.00028,2,1531775,1537878,-,6103
173,BUMA.1121.00010,2,845928,852031,-,6103
173,BUMA.1121.00004,2,1490489,1496592,-,6103
173,BUMA.1121.00015,2,1922330,1928433,-,6103
173,BUMA.1121.00008,2,1489831,1495934,-,6103
173,BUMA.1121.00022,2,2142324,2148428,+,6104
173,BUMA.1121.00024,2,1625511,1631614,-,6103
173,BUMA.1121.00032,2,1657338,1663441,-,6103
173,BUMA.1121.00019,2,1569737,1575840,-,6103
173,BUMA.1121.00044,2,1556741,1562844,-,6103
173,BUMA.1121.00030,2,610052,616156,+,6104
173,BUMA.1121.00020,2,1490602,1496705,-,6103
172,BUMA.1121.00050,2,656137,659712,+,3575
172,BUMA.1121.00081,2,1760903,1764479,-,3576
172,BUMA.1121.00006,2,559036,562611,+,3575
172,BUMA.1121.00087,2,6363,9939,-,3576
172,BUMA.1121.00040,2,525115,528690,+,3575
172,BUMA.1121.00086,2,593556,597131,+,3575
172,BUMA.1121.00054,2,359187,362762,+,3575
172,BUMA.1121.00034,2,1512019,1515595,-,3576
172,BUMA.1121.00048,2,174897,178473,-,3576
172,BUMA.1121.00017,2,1512010,1515586,-,3576
172,BUMA.1121.00038,2,559071,562646,+,3575
172,BUMA.1121.00002,2,17,3608,-,3591
172,BUMA.1121.00046,2,453983,457559,-,3576
172,BUMA.1121.00036,2,1066132,1069708,-,3576
172,BUMA.1121.00013,2,1024197,1027772,+,3575
172,BUMA.1121.00028,2,1538152,1541728,-,3576
172,BUMA.1121.00010,2,852305,855881,-,3576
172,BUMA.1121.00004,2,1496866,1500442,-,3576
172,BUMA.1121.00015,2,1928707,1932283,-,3576
172,BUMA.1121.00008,2,1496208,1499784,-,3576
172,BUMA.1121.00022,2,2138475,2142050,+,3575
172,BUMA.1121.00024,2,1631888,1635464,-,3576
172,BUMA.1121.00032,2,1663715,1667291,-,3576
172,BUMA.1121.00019,2,1576114,1579690,-,3576
172,BUMA.1121.00044,2,1563118,1566694,-,3576
172,BUMA.1121.00030,2,606203,609778,+,3575
172,BUMA.1121.00020,2,1496979,1500555,-,3576
171,BUMA.1121.00050,2,648523,656095,+,7572
171,BUMA.1121.00081,2,1764521,1772093,-,7572
171,BUMA.1121.00006,2,551422,558994,+,7572
171,BUMA.1121.00087,2,9981,17553,-,7572
171,BUMA.1121.00040,2,517501,525073,+,7572
171,BUMA.1121.00086,2,585942,593514,+,7572
171,BUMA.1121.00054,2,351573,359145,+,7572
171,BUMA.1121.00034,2,1515637,1523209,-,7572
171,BUMA.1121.00048,2,178515,186087,-,7572
171,BUMA.1121.00017,2,1515628,1523200,-,7572
171,BUMA.1121.00038,2,551457,559029,+,7572
171,BUMA.1121.00002,2,3650,11210,-,7560
171,BUMA.1121.00046,2,457601,465173,-,7572
171,BUMA.1121.00042,2,1216871,1224135,-,7264
171,BUMA.1121.00036,2,1069750,1077322,-,7572
171,BUMA.1121.00013,2,1016583,1024155,+,7572
171,BUMA.1121.00028,2,1541770,1549342,-,7572
171,BUMA.1121.00010,2,855923,863483,-,7560
171,BUMA.1121.00004,2,1500484,1508056,-,7572
171,BUMA.1121.00015,2,1932325,1939897,-,7572
171,BUMA.1121.00008,2,1499826,1507398,-,7572
171,BUMA.1121.00022,2,2130861,2138433,+,7572
171,BUMA.1121.00026,2,1038949,1046213,+,7264
171,BUMA.1121.00024,2,1635506,1643078,-,7572
171,BUMA.1121.00032,2,1667333,1674905,-,7572
171,BUMA.1121.00019,2,1579732,1587304,-,7572
171,BUMA.1121.00044,2,1566736,1574308,-,7572
171,BUMA.1121.00030,2,598589,606161,+,7572
171,BUMA.1121.00020,2,1500597,1508169,-,7572
170,BUMA.1121.00050,2,629944,648521,+,18577
170,BUMA.1121.00081,2,1772094,1790668,-,18574
170,BUMA.1121.00006,2,532847,551420,+,18573
170,BUMA.1121.00087,2,17554,36202,-,18648
170,BUMA.1121.00040,2,498902,517499,+,18597
170,BUMA.1121.00086,2,567291,585940,+,18649
170,BUMA.1121.00054,2,332998,351571,+,18573
170,BUMA.1121.00034,2,1523210,1541805,-,18595
170,BUMA.1121.00048,2,186088,204662,-,18574
170,BUMA.1121.00017,2,1523201,1541786,-,18585
170,BUMA.1121.00038,2,532882,551455,+,18573
170,BUMA.1121.00002,2,11211,29830,-,18619
170,BUMA.1121.00046,2,465174,483751,-,18577
170,BUMA.1121.00036,2,1077323,1095879,-,18556
170,BUMA.1121.00013,2,997978,1016581,+,18603
170,BUMA.1121.00028,2,1549343,1567936,-,18593
170,BUMA.1121.00010,2,863484,882103,-,18619
170,BUMA.1121.00004,2,1508057,1526656,-,18599
170,BUMA.1121.00015,2,1939898,1958627,-,18729
170,BUMA.1121.00008,2,1507399,1525994,-,18595
170,BUMA.1121.00022,2,2112255,2130859,+,18604
170,BUMA.1121.00024,2,1643079,1661673,-,18594
170,BUMA.1121.00032,2,1674906,1693501,-,18595
170,BUMA.1121.00019,2,1587305,1605900,-,18595
170,BUMA.1121.00044,2,1574309,1592904,-,18595
170,BUMA.1121.00030,2,579996,598587,+,18591
170,BUMA.1121.00020,2,1508170,1526763,-,18593
169,BUMA.1121.00050,2,596686,628703,+,32017
169,BUMA.1121.00081,2,1791879,1823912,-,32033
169,BUMA.1121.00006,2,499603,531636,+,32033
169,BUMA.1121.00087,2,37428,69461,-,32033
169,BUMA.1121.00040,2,465659,497691,+,32032
169,BUMA.1121.00086,2,534033,566066,+,32033
169,BUMA.1121.00054,2,299754,331787,+,32033
169,BUMA.1121.00034,2,1543046,1575064,-,32018
169,BUMA.1121.00048,2,205873,237906,-,32033
169,BUMA.1121.00017,2,1543027,1575045,-,32018
169,BUMA.1121.00038,2,499638,531671,+,32033
169,BUMA.1121.00085,2,1673921,1705954,+,32033
169,BUMA.1121.00002,2,31041,63068,-,32027
169,BUMA.1121.00046,2,484992,517010,-,32018
169,BUMA.1121.00042,2,1225359,1257392,-,32033
169,BUMA.1121.00036,2,1097090,1129123,-,32033
169,BUMA.1121.00013,2,964734,996767,+,32033
169,BUMA.1121.00028,2,1569177,1601195,-,32018
169,BUMA.1121.00010,2,883314,915341,-,32027
169,BUMA.1121.00004,2,1527897,1559915,-,32018
169,BUMA.1121.00015,2,1959838,1991871,-,32033
169,BUMA.1121.00008,2,1527235,1559253,-,32018
169,BUMA.1121.00022,2,2078997,2111030,+,32033
169,BUMA.1121.00026,2,1005692,1037725,+,32033
169,BUMA.1121.00024,2,1662914,1694932,-,32018
169,BUMA.1121.00052,2,627567,659600,+,32033
169,BUMA.1121.00032,2,1694742,1726745,-,32003
169,BUMA.1121.00019,2,1607141,1639159,-,32018
169,BUMA.1121.00044,2,1594145,1626163,-,32018
169,BUMA.1121.00030,2,546738,578755,+,32017
169,BUMA.1121.00020,2,1528004,1560022,-,32018
168,BUMA.1121.00050,2,562553,596684,+,34131
168,BUMA.1121.00081,2,1823913,1858087,-,34174
168,BUMA.1121.00006,2,465420,499601,+,34181
168,BUMA.1121.00087,2,69462,103498,-,34036
168,BUMA.1121.00040,2,431524,465657,+,34133
168,BUMA.1121.00086,2,499827,534031,+,34204
168,BUMA.1121.00054,2,265579,299752,+,34173
168,BUMA.1121.00034,2,1575065,1609135,-,34070
168,BUMA.1121.00048,2,237907,272126,-,34219
168,BUMA.1121.00017,2,1575046,1609124,-,34078
168,BUMA.1121.00038,2,465454,499636,+,34182
168,BUMA.1121.00085,2,1639999,1673919,+,33920
168,BUMA.1121.00002,2,63069,97019,-,33950
168,BUMA.1121.00046,2,517011,551090,-,34079
168,BUMA.1121.00042,2,1257393,1291575,-,34182
168,BUMA.1121.00036,2,1129124,1163332,-,34208
168,BUMA.1121.00013,2,930619,964732,+,34113
168,BUMA.1121.00028,2,1601196,1635298,-,34102
168,BUMA.1121.00010,2,915342,949200,-,33858
168,BUMA.1121.00004,2,1559916,1593835,-,33919
168,BUMA.1121.00015,2,1991872,2025916,-,34044
168,BUMA.1121.00008,2,1559254,1593366,-,34112
168,BUMA.1121.00022,2,2044813,2078995,+,34182
168,BUMA.1121.00026,2,971630,1005690,+,34060
168,BUMA.1121.00024,2,1694933,1729050,-,34117
168,BUMA.1121.00052,2,593637,627565,+,33928
168,BUMA.1121.00032,2,1,34209,-,34208
168,BUMA.1121.00019,2,1639160,1673245,-,34085
168,BUMA.1121.00044,2,1626164,1660026,-,33862
168,BUMA.1121.00030,2,512874,546736,+,33862
168,BUMA.1121.00020,2,1560023,1594100,-,34077
167,BUMA.1121.00050,2,520227,560921,+,40694
167,BUMA.1121.00081,2,1859719,1900440,-,40721
167,BUMA.1121.00006,2,423067,463788,+,40721
167,BUMA.1121.00087,2,105130,145916,-,40786
167,BUMA.1121.00040,2,389108,429892,+,40784
167,BUMA.1121.00086,2,457409,498195,+,40786
167,BUMA.1121.00054,2,223226,263947,+,40721
167,BUMA.1121.00034,2,1610767,1651570,-,40803
167,BUMA.1121.00048,2,273758,314480,-,40722
167,BUMA.1121.00017,2,1610756,1651559,-,40803
167,BUMA.1121.00038,2,423101,463822,+,40721
167,BUMA.1121.00085,2,1597576,1638367,+,40791
167,BUMA.1121.00002,2,98651,139453,-,40802
167,BUMA.1121.00046,2,552722,593417,-,40695
167,BUMA.1121.00042,2,1293200,1334126,-,40926
167,BUMA.1121.00036,2,1164964,1205750,-,40786
167,BUMA.1121.00013,2,888200,928987,+,40787
167,BUMA.1121.00028,2,1636930,1677733,-,40803
167,BUMA.1121.00010,2,950832,991634,-,40802
167,BUMA.1121.00004,2,1595467,1636270,-,40803
167,BUMA.1121.00015,2,2027548,2068229,-,40681
167,BUMA.1121.00008,2,1594998,1635801,-,40803
167,BUMA.1121.00022,2,2002395,2043181,+,40786
167,BUMA.1121.00026,2,927819,968758,+,40939
167,BUMA.1121.00024,2,1730682,1771485,-,40803
167,BUMA.1121.00052,2,551214,592005,+,40791
167,BUMA.1121.00032,2,35841,76644,-,40803
167,BUMA.1121.00019,2,1674877,1715680,-,40803
167,BUMA.1121.00044,2,1661658,1702461,-,40803
167,BUMA.1121.00030,2,470440,511242,+,40802
167,BUMA.1121.00020,2,1595732,1636535,-,40803
166,BUMA.1121.00050,2,499107,518162,+,19055
166,BUMA.1121.00081,2,1902505,1921560,-,19055
166,BUMA.1121.00006,2,401947,421002,+,19055
166,BUMA.1121.00087,2,147997,167052,-,19055
166,BUMA.1121.00040,2,367988,387043,+,19055
166,BUMA.1121.00086,2,436274,455329,+,19055
166,BUMA.1121.00054,2,202106,221161,+,19055
166,BUMA.1121.00034,2,1653651,1672706,-,19055
166,BUMA.1121.00048,2,316545,335600,-,19055
166,BUMA.1121.00017,2,1653640,1672695,-,19055
166,BUMA.1121.00038,2,401981,421036,+,19055
166,BUMA.1121.00085,2,1576456,1595511,+,19055
166,BUMA.1121.00002,2,141518,160573,-,19055
166,BUMA.1121.00046,2,595482,614521,-,19039
166,BUMA.1121.00042,2,2109079,2128143,+,19064
166,BUMA.1121.00036,2,1207831,1226886,-,19055
166,BUMA.1121.00013,2,867080,886135,+,19055
166,BUMA.1121.00028,2,1679814,1698869,-,19055
166,BUMA.1121.00010,2,993699,1012754,-,19055
166,BUMA.1121.00004,2,1638351,1657406,-,19055
166,BUMA.1121.00015,2,2070294,2089349,-,19055
166,BUMA.1121.00008,2,1637882,1656937,-,19055
166,BUMA.1121.00022,2,1981275,2000315,+,19040
166,BUMA.1121.00026,2,803278,822342,+,19064
166,BUMA.1121.00024,2,1773566,1792621,-,19055
166,BUMA.1121.00052,2,530094,549149,+,19055
166,BUMA.1121.00032,2,78725,97780,-,19055
166,BUMA.1121.00019,2,1717761,1736816,-,19055
166,BUMA.1121.00044,2,1704542,1723597,-,19055
166,BUMA.1121.00030,2,449305,468360,+,19055
166,BUMA.1121.00020,2,1638616,1657671,-,19055
165,BUMA.1121.00050,2,463050,496756,+,33706
165,BUMA.1121.00081,2,1923911,1957616,-,33705
165,BUMA.1121.00006,2,365890,399596,+,33706
165,BUMA.1121.00087,2,968599,1002307,+,33708
165,BUMA.1121.00040,2,1789393,1823097,-,33704
165,BUMA.1121.00086,2,1952897,1986604,-,33707
165,BUMA.1121.00054,2,166049,199755,+,33706
165,BUMA.1121.00034,2,342513,376221,+,33708
165,BUMA.1121.00048,2,337951,371656,-,33705
165,BUMA.1121.00017,2,342492,376200,+,33708
165,BUMA.1121.00038,2,365924,399630,+,33706
165,BUMA.1121.00085,2,765834,799538,-,33704
165,BUMA.1121.00002,2,938964,972672,+,33708
165,BUMA.1121.00046,2,616811,650516,-,33705
165,BUMA.1121.00036,2,1962259,1995981,+,33722
165,BUMA.1121.00013,2,31897,65601,-,33704
165,BUMA.1121.00028,2,342439,376147,+,33708
165,BUMA.1121.00010,2,1792405,1826113,+,33708
165,BUMA.1121.00004,2,342485,376193,+,33708
165,BUMA.1121.00015,2,2091700,2125405,-,33705
165,BUMA.1121.00008,2,342357,376065,+,33708
165,BUMA.1121.00022,2,1145021,1178728,-,33707
165,BUMA.1121.00024,2,342357,376065,+,33708
165,BUMA.1121.00052,2,1454385,1488089,-,33704
165,BUMA.1121.00032,2,766826,800534,+,33708
165,BUMA.1121.00019,2,342424,376132,+,33708
165,BUMA.1121.00044,2,393629,427337,+,33708
165,BUMA.1121.00030,2,1745578,1779285,-,33707
165,BUMA.1121.00020,2,342460,376168,+,33708
164,BUMA.1121.00050,2,448953,458963,+,10010
164,BUMA.1121.00081,2,1961423,1971713,-,10290
164,BUMA.1121.00006,2,351793,361803,+,10010
164,BUMA.1121.00087,2,954503,964514,+,10011
164,BUMA.1121.00040,2,1826904,1837211,-,10307
164,BUMA.1121.00086,2,1990409,2000700,-,10291
164,BUMA.1121.00054,2,151952,161962,+,10010
164,BUMA.1121.00034,2,328417,338428,+,10011
164,BUMA.1121.00048,2,375463,385753,-,10290
164,BUMA.1121.00017,2,328396,338407,+,10011
164,BUMA.1121.00038,2,351827,361837,+,10010
164,BUMA.1121.00085,2,803345,813635,-,10290
164,BUMA.1121.00002,2,924869,934880,+,10011
164,BUMA.1121.00046,2,654323,664613,-,10290
164,BUMA.1121.00042,2,2093742,2103768,+,10026
164,BUMA.1121.00036,2,1948179,1958190,+,10011
164,BUMA.1121.00013,2,69408,79698,-,10290
164,BUMA.1121.00028,2,328343,338354,+,10011
164,BUMA.1121.00010,2,1778310,1788321,+,10011
164,BUMA.1121.00004,2,328389,338400,+,10011
164,BUMA.1121.00015,2,2129212,2139502,-,10290
164,BUMA.1121.00008,2,328261,338272,+,10011
164,BUMA.1121.00022,2,1182533,1192824,-,10291
164,BUMA.1121.00026,2,913722,923748,+,10026
164,BUMA.1121.00024,2,328261,338272,+,10011
164,BUMA.1121.00052,2,1491896,1502186,-,10290
164,BUMA.1121.00032,2,752730,762741,+,10011
164,BUMA.1121.00019,2,328328,338339,+,10011
164,BUMA.1121.00044,2,379533,389544,+,10011
164,BUMA.1121.00030,2,1783090,1793381,-,10291
164,BUMA.1121.00020,2,328364,338375,+,10011
163,BUMA.1121.00050,2,433755,447374,+,13619
163,BUMA.1121.00081,2,1973292,1986912,-,13620
163,BUMA.1121.00006,2,336595,350214,+,13619
163,BUMA.1121.00087,2,939306,952925,+,13619
163,BUMA.1121.00040,2,1838759,1852367,-,13608
163,BUMA.1121.00086,2,2002278,2015898,-,13620
163,BUMA.1121.00054,2,136754,150373,+,13619
163,BUMA.1121.00034,2,313231,326839,+,13608
163,BUMA.1121.00048,2,387332,400952,-,13620
163,BUMA.1121.00017,2,313210,326818,+,13608
163,BUMA.1121.00038,2,336629,350248,+,13619
163,BUMA.1121.00085,2,815214,828834,-,13620
163,BUMA.1121.00002,2,909673,923291,+,13618
163,BUMA.1121.00046,2,666192,679812,-,13620
163,BUMA.1121.00042,2,2078562,2092197,+,13635
163,BUMA.1121.00036,2,1932982,1946601,+,13619
163,BUMA.1121.00013,2,81277,94897,-,13620
163,BUMA.1121.00028,2,313157,326765,+,13608
163,BUMA.1121.00010,2,1763114,1776749,+,13635
163,BUMA.1121.00004,2,313203,326811,+,13608
163,BUMA.1121.00015,2,2141081,2154701,-,13620
163,BUMA.1121.00008,2,313075,326683,+,13608
163,BUMA.1121.00022,2,1194383,1208018,-,13635
163,BUMA.1121.00026,2,898541,912176,+,13635
163,BUMA.1121.00024,2,313075,326683,+,13608
163,BUMA.1121.00052,2,1503765,1517385,-,13620
163,BUMA.1121.00032,2,737544,751152,+,13608
163,BUMA.1121.00019,2,313142,326750,+,13608
163,BUMA.1121.00044,2,364347,377955,+,13608
163,BUMA.1121.00030,2,1794959,1808568,-,13609
163,BUMA.1121.00020,2,313178,326786,+,13608
162,BUMA.1121.00050,2,400248,433753,+,33505
162,BUMA.1121.00081,2,1986913,2020397,-,33484
162,BUMA.1121.00006,2,303110,336593,+,33483
162,BUMA.1121.00087,2,906023,939304,+,33281
162,BUMA.1121.00040,2,1853609,1887134,-,33525
162,BUMA.1121.00086,2,2015899,2049392,-,33493
162,BUMA.1121.00054,2,103269,136752,+,33483
162,BUMA.1121.00034,2,279730,313229,+,33499
162,BUMA.1121.00048,2,400953,434437,-,33484
162,BUMA.1121.00017,2,279709,313208,+,33499
162,BUMA.1121.00038,2,303144,336627,+,33483
162,BUMA.1121.00085,2,828835,862295,-,33460
162,BUMA.1121.00002,2,876155,909671,+,33516
162,BUMA.1121.00046,2,679813,713254,-,33441
162,BUMA.1121.00042,2,2045034,2078560,+,33526
162,BUMA.1121.00036,2,1899365,1932980,+,33615
162,BUMA.1121.00013,2,94898,128358,-,33460
162,BUMA.1121.00028,2,279647,313155,+,33508
162,BUMA.1121.00010,2,1729623,1763112,+,33489
162,BUMA.1121.00004,2,279694,313201,+,33507
162,BUMA.1121.00015,2,2154702,2188189,-,33487
162,BUMA.1121.00008,2,279637,313073,+,33436
162,BUMA.1121.00022,2,1208019,1241518,-,33499
162,BUMA.1121.00026,2,865022,898539,+,33517
162,BUMA.1121.00024,2,279565,313073,+,33508
162,BUMA.1121.00052,2,1517386,1550846,-,33460
162,BUMA.1121.00032,2,704043,737542,+,33499
162,BUMA.1121.00019,2,279650,313140,+,33490
162,BUMA.1121.00044,2,330846,364345,+,33499
162,BUMA.1121.00030,2,1808569,1842079,-,33510
162,BUMA.1121.00020,2,279686,313176,+,33490
161,BUMA.1121.00050,2,385747,396400,+,10653
161,BUMA.1121.00081,2,2024229,2034881,-,10652
161,BUMA.1121.00006,2,288625,299278,+,10653
161,BUMA.1121.00087,2,891551,902210,+,10659
161,BUMA.1121.00040,2,1890950,1901606,-,10656
161,BUMA.1121.00086,2,2053205,2063863,-,10658
161,BUMA.1121.00054,2,88784,99437,+,10653
161,BUMA.1121.00034,2,265212,275865,+,10653
161,BUMA.1121.00048,2,438269,448921,-,10652
161,BUMA.1121.00017,2,265191,275844,+,10653
161,BUMA.1121.00038,2,288665,299318,+,10653
161,BUMA.1121.00085,2,866155,876819,-,10664
161,BUMA.1121.00002,2,861661,872314,+,10653
161,BUMA.1121.00046,2,717102,727754,-,10652
161,BUMA.1121.00036,2,1884861,1895514,+,10653
161,BUMA.1121.00013,2,132213,142877,-,10664
161,BUMA.1121.00028,2,265159,275812,+,10653
161,BUMA.1121.00010,2,1715137,1725790,+,10653
161,BUMA.1121.00004,2,265170,275823,+,10653
161,BUMA.1121.00015,2,2192059,2202717,-,10658
161,BUMA.1121.00008,2,265155,275808,+,10653
161,BUMA.1121.00022,2,1245296,1255948,-,10652
161,BUMA.1121.00026,2,850493,861163,+,10670
161,BUMA.1121.00024,2,265107,275760,+,10653
161,BUMA.1121.00052,2,1554706,1565370,-,10664
161,BUMA.1121.00032,2,689549,700202,+,10653
161,BUMA.1121.00019,2,265162,275815,+,10653
161,BUMA.1121.00044,2,316322,326975,+,10653
161,BUMA.1121.00030,2,1845950,1856602,-,10652
161,BUMA.1121.00020,2,265192,275845,+,10653
160,BUMA.1121.00050,2,350780,385746,+,34966
160,BUMA.1121.00081,2,2034883,2070164,-,35281
160,BUMA.1121.00006,2,253405,288624,+,35219
160,BUMA.1121.00087,2,857074,891550,+,34476
160,BUMA.1121.00040,2,1901608,1936360,-,34752
160,BUMA.1121.00086,2,2063865,2098746,-,34881
160,BUMA.1121.00054,2,53529,88783,+,35254
160,BUMA.1121.00034,2,230350,265211,+,34861
160,BUMA.1121.00048,2,448923,484267,-,35344
160,BUMA.1121.00017,2,230336,265190,+,34854
160,BUMA.1121.00038,2,253423,288664,+,35241
160,BUMA.1121.00085,2,876821,911633,-,34812
160,BUMA.1121.00002,2,826981,861660,+,34679
160,BUMA.1121.00046,2,727756,762869,-,35113
160,BUMA.1121.00042,2,2005242,2039958,+,34716
160,BUMA.1121.00036,2,1849985,1884860,+,34875
160,BUMA.1121.00013,2,142879,177635,-,34756
160,BUMA.1121.00028,2,230399,265158,+,34759
160,BUMA.1121.00010,2,1680226,1715136,+,34910
160,BUMA.1121.00004,2,230346,265169,+,34823
160,BUMA.1121.00015,2,2202719,2237503,-,34784
160,BUMA.1121.00008,2,230342,265154,+,34812
160,BUMA.1121.00022,2,1255950,1290901,-,34951
160,BUMA.1121.00026,2,275106,309776,-,34670
160,BUMA.1121.00024,2,230392,265106,+,34714
160,BUMA.1121.00052,2,1565372,1600162,-,34790
160,BUMA.1121.00032,2,654757,689548,+,34791
160,BUMA.1121.00019,2,230335,265161,+,34826
160,BUMA.1121.00044,2,281502,316321,+,34819
160,BUMA.1121.00030,2,1856604,1891429,-,34825
160,BUMA.1121.00020,2,230355,265191,+,34836
159,BUMA.1121.00050,2,329780,350779,+,20999
159,BUMA.1121.00081,2,2070166,2091175,-,21009
159,BUMA.1121.00006,2,232393,253404,+,21011
159,BUMA.1121.00087,2,836074,857073,+,20999
159,BUMA.1121.00040,2,1936362,1957420,-,21058
159,BUMA.1121.00086,2,2098748,2119746,-,20998
159,BUMA.1121.00054,2,32517,53528,+,21011
159,BUMA.1121.00034,2,209329,230349,+,21020
159,BUMA.1121.00048,2,484269,505279,-,21010
159,BUMA.1121.00017,2,209315,230335,+,21020
159,BUMA.1121.00038,2,232411,253422,+,21011
159,BUMA.1121.00085,2,911635,932627,-,20992
159,BUMA.1121.00002,2,805975,826980,+,21005
159,BUMA.1121.00046,2,762871,783869,-,20998
159,BUMA.1121.00042,2,1984230,2005241,+,21011
159,BUMA.1121.00036,2,1828967,1849984,+,21017
159,BUMA.1121.00013,2,177637,198629,-,20992
159,BUMA.1121.00028,2,209384,230398,+,21014
159,BUMA.1121.00010,2,1659220,1680225,+,21005
159,BUMA.1121.00004,2,209325,230345,+,21020
159,BUMA.1121.00015,2,1,20996,-,20995
159,BUMA.1121.00008,2,209321,230341,+,21020
159,BUMA.1121.00022,2,1290903,1311907,-,21004
159,BUMA.1121.00026,2,309778,330830,-,21052
159,BUMA.1121.00024,2,209377,230391,+,21014
159,BUMA.1121.00052,2,1600164,1621156,-,20992
159,BUMA.1121.00032,2,633736,654756,+,21020
159,BUMA.1121.00019,2,209314,230334,+,21020
159,BUMA.1121.00044,2,260481,281501,+,21020
159,BUMA.1121.00030,2,1891431,1912451,-,21020
159,BUMA.1121.00020,2,209334,230354,+,21020
158,BUMA.1121.00050,2,303378,329536,+,26158
158,BUMA.1121.00081,2,2091420,2117577,-,26157
158,BUMA.1121.00006,2,205991,232149,+,26158
158,BUMA.1121.00087,2,808359,835830,+,27471
158,BUMA.1121.00040,2,1957665,1983822,-,26157
158,BUMA.1121.00086,2,2119991,2147461,-,27470
158,BUMA.1121.00054,2,6115,32273,+,26158
158,BUMA.1121.00034,2,180037,207495,+,27458
158,BUMA.1121.00048,2,505524,531681,-,26157
158,BUMA.1121.00017,2,180023,207481,+,27458
158,BUMA.1121.00038,2,206009,232167,+,26158
158,BUMA.1121.00085,2,932872,959029,-,26157
158,BUMA.1121.00002,2,778260,805731,+,27471
158,BUMA.1121.00046,2,784114,810271,-,26157
158,BUMA.1121.00042,2,1957834,1983986,+,26152
158,BUMA.1121.00036,2,1801253,1828723,+,27470
158,BUMA.1121.00013,2,198874,225031,-,26157
158,BUMA.1121.00028,2,180092,207550,+,27458
158,BUMA.1121.00010,2,1631505,1658976,+,27471
158,BUMA.1121.00004,2,180033,207491,+,27458
158,BUMA.1121.00015,2,21241,47398,-,26157
158,BUMA.1121.00008,2,180029,207487,+,27458
158,BUMA.1121.00022,2,1312152,1339622,-,27470
158,BUMA.1121.00026,2,331075,357226,-,26151
158,BUMA.1121.00024,2,180085,207543,+,27458
158,BUMA.1121.00052,2,1621401,1647558,-,26157
158,BUMA.1121.00019,2,180022,207480,+,27458
158,BUMA.1121.00044,2,231189,258647,+,27458
158,BUMA.1121.00030,2,1914284,1941742,-,27458
158,BUMA.1121.00020,2,180042,207500,+,27458
157,BUMA.1121.00050,2,297277,302774,+,5497
157,BUMA.1121.00081,2,2118181,2123678,-,5497
157,BUMA.1121.00006,2,199890,205387,+,5497
157,BUMA.1121.00087,2,802258,807755,+,5497
157,BUMA.1121.00040,2,1984426,1989923,-,5497
157,BUMA.1121.00086,2,2148065,2153562,-,5497
157,BUMA.1121.00054,2,1,5511,+,5510
157,BUMA.1121.00034,2,173936,179433,+,5497
157,BUMA.1121.00048,2,532285,537782,-,5497
157,BUMA.1121.00017,2,173922,179419,+,5497
157,BUMA.1121.00038,2,199908,205405,+,5497
157,BUMA.1121.00085,2,959633,965130,-,5497
157,BUMA.1121.00002,2,772143,777656,+,5513
157,BUMA.1121.00046,2,810875,816372,-,5497
157,BUMA.1121.00042,2,1951733,1957230,+,5497
157,BUMA.1121.00036,2,1795152,1800649,+,5497
157,BUMA.1121.00013,2,225635,231132,-,5497
157,BUMA.1121.00028,2,173991,179488,+,5497
157,BUMA.1121.00010,2,1625388,1630901,+,5513
157,BUMA.1121.00004,2,173932,179429,+,5497
157,BUMA.1121.00015,2,48002,53499,-,5497
157,BUMA.1121.00008,2,173928,179425,+,5497
157,BUMA.1121.00022,2,1340226,1345723,-,5497
157,BUMA.1121.00026,2,357830,363327,-,5497
157,BUMA.1121.00024,2,173984,179481,+,5497
157,BUMA.1121.00052,2,1648162,1653659,-,5497
157,BUMA.1121.00019,2,173921,179418,+,5497
157,BUMA.1121.00044,2,225088,230585,+,5497
157,BUMA.1121.00030,2,1942346,1947843,-,5497
157,BUMA.1121.00020,2,173941,179438,+,5497
156,BUMA.1121.00050,2,286722,295919,+,9197
156,BUMA.1121.00081,2,2125036,2134314,-,9278
156,BUMA.1121.00006,2,189254,198532,+,9278
156,BUMA.1121.00087,2,791617,800900,+,9283
156,BUMA.1121.00040,2,1991281,2000583,-,9302
156,BUMA.1121.00086,2,2154920,2164203,-,9283
156,BUMA.1121.00054,2,2314700,2323978,+,9278
156,BUMA.1121.00048,2,539140,548418,-,9278
156,BUMA.1121.00038,2,189272,198550,+,9278
156,BUMA.1121.00085,2,966488,975775,-,9287
156,BUMA.1121.00002,2,761524,770785,+,9261
156,BUMA.1121.00046,2,817730,826927,-,9197
156,BUMA.1121.00042,2,1941109,1950375,+,9266
156,BUMA.1121.00036,2,1784494,1793794,+,9300
156,BUMA.1121.00013,2,232490,241764,-,9274
156,BUMA.1121.00010,2,1614769,1624030,+,9261
156,BUMA.1121.00015,2,54857,64131,-,9274
156,BUMA.1121.00022,2,1347081,1356354,-,9273
156,BUMA.1121.00026,2,364685,373963,-,9278
156,BUMA.1121.00052,2,1655017,1664304,-,9287
155,BUMA.1121.00050,2,263825,283753,+,19928
155,BUMA.1121.00081,2,2137269,2157197,-,19928
155,BUMA.1121.00006,2,166371,186299,+,19928
155,BUMA.1121.00087,2,769786,789717,+,19931
155,BUMA.1121.00040,2,2003580,2023523,-,19943
155,BUMA.1121.00086,2,2166099,2186015,-,19916
155,BUMA.1121.00054,2,2291818,2311745,+,19927
155,BUMA.1121.00034,2,1937167,1957095,-,19928
155,BUMA.1121.00048,2,551324,571252,-,19928
155,BUMA.1121.00017,2,1937163,1957091,-,19928
155,BUMA.1121.00038,2,166389,186317,+,19928
155,BUMA.1121.00085,2,978751,998678,-,19927
155,BUMA.1121.00002,2,739686,759629,+,19943
155,BUMA.1121.00046,2,829896,849824,-,19928
155,BUMA.1121.00042,2,1918160,1938103,+,19943
155,BUMA.1121.00036,2,1762681,1782597,+,19916
155,BUMA.1121.00013,2,244740,264667,-,19927
155,BUMA.1121.00028,2,1963291,1983219,-,19928
155,BUMA.1121.00010,2,1592930,1612873,+,19943
155,BUMA.1121.00004,2,1921849,1941776,-,19927
155,BUMA.1121.00015,2,67100,87019,-,19919
155,BUMA.1121.00008,2,1921396,1941324,-,19928
155,BUMA.1121.00022,2,1358250,1378166,-,19916
155,BUMA.1121.00026,2,376969,396897,-,19928
155,BUMA.1121.00024,2,2057050,2076978,-,19928
155,BUMA.1121.00052,2,1667280,1687207,-,19927
155,BUMA.1121.00032,2,362228,382156,-,19928
155,BUMA.1121.00019,2,2001263,2021191,-,19928
155,BUMA.1121.00044,2,1988064,2007992,-,19928
155,BUMA.1121.00030,2,164909,184837,+,19928
155,BUMA.1121.00020,2,1922118,1942046,-,19928
154,BUMA.1121.00050,2,216148,262262,+,46114
154,BUMA.1121.00081,2,2158776,2204844,-,46068
154,BUMA.1121.00006,2,118725,164792,+,46067
154,BUMA.1121.00087,2,722145,768235,+,46090
154,BUMA.1121.00040,2,2025070,2071211,-,46141
154,BUMA.1121.00086,2,2187582,2233672,-,46090
154,BUMA.1121.00054,2,2244172,2290239,+,46067
154,BUMA.1121.00034,2,1958674,2004768,-,46094
154,BUMA.1121.00048,2,572831,618899,-,46068
154,BUMA.1121.00017,2,1958670,2004764,-,46094
154,BUMA.1121.00038,2,118743,164810,+,46067
154,BUMA.1121.00085,2,1000257,1046350,-,46093
154,BUMA.1121.00002,2,692133,738138,+,46005
154,BUMA.1121.00046,2,851388,897502,-,46114
154,BUMA.1121.00042,2,1455137,1503891,-,48754
154,BUMA.1121.00036,2,1715016,1761115,+,46099
154,BUMA.1121.00013,2,266246,312799,-,46553
154,BUMA.1121.00028,2,1984798,2030892,-,46094
154,BUMA.1121.00010,2,1543796,1589792,+,45996
154,BUMA.1121.00004,2,1943355,1989448,-,46093
154,BUMA.1121.00015,2,88585,134709,-,46124
154,BUMA.1121.00008,2,1942903,1989006,-,46103
154,BUMA.1121.00022,2,1379751,1425841,-,46090
154,BUMA.1121.00024,2,2078557,2124651,-,46094
154,BUMA.1121.00052,2,1688786,1734864,-,46078
154,BUMA.1121.00032,2,383735,429829,-,46094
154,BUMA.1121.00019,2,2022770,2068873,-,46103
154,BUMA.1121.00044,2,2009571,2055665,-,46094
154,BUMA.1121.00030,2,117237,163330,+,46093
154,BUMA.1121.00020,2,1943625,1989728,-,46103
153,BUMA.1121.00050,2,158067,216146,+,58079
153,BUMA.1121.00081,2,2204845,2262742,-,57897
153,BUMA.1121.00006,2,60826,118723,+,57897
153,BUMA.1121.00087,2,664444,722143,+,57699
153,BUMA.1121.00040,2,2071212,2129227,-,58015
153,BUMA.1121.00086,2,2233673,2291446,-,57773
153,BUMA.1121.00054,2,2186273,2244170,+,57897
153,BUMA.1121.00034,2,2004769,2062569,-,57800
153,BUMA.1121.00048,2,618900,676805,-,57905
153,BUMA.1121.00017,2,2004765,2062564,-,57799
153,BUMA.1121.00038,2,60826,118741,+,57915
153,BUMA.1121.00085,2,1046351,1104513,-,58162
153,BUMA.1121.00002,2,634364,692131,+,57767
153,BUMA.1121.00046,2,897503,955534,-,58031
153,BUMA.1121.00042,2,1503892,1561725,-,57833
153,BUMA.1121.00036,2,1657067,1715014,+,57947
153,BUMA.1121.00013,2,312800,370747,-,57947
153,BUMA.1121.00028,2,2030893,2088695,-,57802
153,BUMA.1121.00010,2,1486249,1543794,+,57545
153,BUMA.1121.00004,2,1989449,2047266,-,57817
153,BUMA.1121.00015,2,134710,192566,-,57856
153,BUMA.1121.00008,2,1989007,2046765,-,57758
153,BUMA.1121.00022,2,1425842,1483737,-,57895
153,BUMA.1121.00024,2,2124652,2182438,-,57786
153,BUMA.1121.00052,2,1,58172,-,58171
153,BUMA.1121.00032,2,429830,487624,-,57794
153,BUMA.1121.00019,2,2068874,2126664,-,57790
153,BUMA.1121.00044,2,2055666,2113457,-,57791
153,BUMA.1121.00030,2,59453,117235,+,57782
153,BUMA.1121.00020,2,1989729,2047511,-,57782
152,BUMA.1121.00050,2,101693,151387,+,49694
152,BUMA.1121.00081,2,116203,165869,+,49666
152,BUMA.1121.00006,2,2157650,2207235,-,49585
152,BUMA.1121.00087,2,436232,485855,-,49623
152,BUMA.1121.00040,2,2135909,2185518,-,49609
152,BUMA.1121.00086,2,117327,167031,+,49704
152,BUMA.1121.00054,2,1957763,2007348,-,49585
152,BUMA.1121.00034,2,120444,170163,+,49719
152,BUMA.1121.00048,2,855653,905319,+,49666
152,BUMA.1121.00017,2,120430,170149,+,49719
152,BUMA.1121.00038,2,2058865,2108450,-,49585
152,BUMA.1121.00085,2,1280331,1330048,+,49717
152,BUMA.1121.00002,2,404403,454077,-,49674
152,BUMA.1121.00046,2,962216,1011822,-,49606
152,BUMA.1121.00042,2,1567109,1616811,-,49702
152,BUMA.1121.00013,2,546789,596491,+,49702
152,BUMA.1121.00028,2,120499,170218,+,49719
152,BUMA.1121.00010,2,1256401,1306035,-,49634
152,BUMA.1121.00004,2,120440,170159,+,49719
152,BUMA.1121.00015,2,368445,418125,+,49680
152,BUMA.1121.00008,2,120436,170155,+,49719
152,BUMA.1121.00022,2,1662471,1712182,+,49711
152,BUMA.1121.00024,2,120492,170211,+,49719
152,BUMA.1121.00052,2,233990,283707,+,49717
152,BUMA.1121.00019,2,120429,170148,+,49719
152,BUMA.1121.00044,2,171596,221315,+,49719
152,BUMA.1121.00030,2,1951617,2001255,-,49638
152,BUMA.1121.00020,2,120449,170168,+,49719
151,BUMA.1121.00050,2,89787,101691,+,11904
151,BUMA.1121.00081,2,104429,116201,+,11772
151,BUMA.1121.00006,2,2207236,2219110,-,11874
151,BUMA.1121.00087,2,485856,497523,-,11667
151,BUMA.1121.00040,2,2185519,2197391,-,11872
151,BUMA.1121.00086,2,105739,117325,+,11586
151,BUMA.1121.00054,2,2007349,2019202,-,11853
151,BUMA.1121.00034,2,108776,120442,+,11666
151,BUMA.1121.00048,2,843879,855651,+,11772
151,BUMA.1121.00017,2,108776,120428,+,11652
151,BUMA.1121.00038,2,2108451,2120304,-,11853
151,BUMA.1121.00085,2,1268564,1280329,+,11765
151,BUMA.1121.00002,2,454078,465906,-,11828
151,BUMA.1121.00046,2,1011823,1023805,-,11982
151,BUMA.1121.00013,2,535007,546787,+,11780
151,BUMA.1121.00028,2,108810,120497,+,11687
151,BUMA.1121.00010,2,1306036,1317792,-,11756
151,BUMA.1121.00004,2,108832,120438,+,11606
151,BUMA.1121.00015,2,356707,368443,+,11736
151,BUMA.1121.00008,2,108838,120434,+,11596
151,BUMA.1121.00022,2,1650690,1662469,+,11779
151,BUMA.1121.00024,2,108831,120490,+,11659
151,BUMA.1121.00052,2,222223,233988,+,11765
151,BUMA.1121.00019,2,108824,120427,+,11603
151,BUMA.1121.00044,2,159942,171594,+,11652
151,BUMA.1121.00030,2,2001256,2013003,-,11747
151,BUMA.1121.00020,2,108831,120447,+,11616
150,BUMA.1121.00050,2,67239,87923,+,20684
150,BUMA.1121.00081,2,81909,102565,+,20656
150,BUMA.1121.00006,2,2220974,2241630,-,20656
150,BUMA.1121.00087,2,499387,519984,-,20597
150,BUMA.1121.00040,2,2199255,2219873,-,20618
150,BUMA.1121.00086,2,83278,103875,+,20597
150,BUMA.1121.00054,2,2021066,2041722,-,20656
150,BUMA.1121.00034,2,86318,106912,+,20594
150,BUMA.1121.00048,2,821359,842015,+,20656
150,BUMA.1121.00017,2,86318,106912,+,20594
150,BUMA.1121.00038,2,2122168,2142831,-,20663
150,BUMA.1121.00085,2,1246107,1266700,+,20593
150,BUMA.1121.00002,2,467770,488335,-,20565
150,BUMA.1121.00046,2,1025669,1046346,-,20677
150,BUMA.1121.00042,2,1618672,1639238,-,20566
150,BUMA.1121.00036,2,1492095,1512643,-,20548
150,BUMA.1121.00013,2,512517,533158,+,20641
150,BUMA.1121.00028,2,86359,106946,+,20587
150,BUMA.1121.00010,2,1319640,1340205,-,20565
150,BUMA.1121.00004,2,86374,106968,+,20594
150,BUMA.1121.00015,2,334234,354843,+,20609
150,BUMA.1121.00008,2,86380,106974,+,20594
150,BUMA.1121.00022,2,1628187,1648826,+,20639
150,BUMA.1121.00024,2,86373,106967,+,20594
150,BUMA.1121.00052,2,199766,220359,+,20593
150,BUMA.1121.00019,2,86366,106960,+,20594
150,BUMA.1121.00044,2,137505,158078,+,20573
150,BUMA.1121.00030,2,2014867,2035440,-,20573
150,BUMA.1121.00020,2,86366,106967,+,20601
149,BUMA.1121.00050,2,60924,65621,+,4697
149,BUMA.1121.00081,2,75593,80290,+,4697
149,BUMA.1121.00006,2,2243250,2247947,-,4697
149,BUMA.1121.00087,2,521603,526300,-,4697
149,BUMA.1121.00040,2,2221493,2226175,-,4682
149,BUMA.1121.00086,2,76962,81659,+,4697
149,BUMA.1121.00054,2,2043342,2048039,-,4697
149,BUMA.1121.00034,2,80002,84699,+,4697
149,BUMA.1121.00048,2,815043,819740,+,4697
149,BUMA.1121.00017,2,80002,84699,+,4697
149,BUMA.1121.00038,2,2144451,2149148,-,4697
149,BUMA.1121.00085,2,1239791,1244488,+,4697
149,BUMA.1121.00002,2,489956,494653,-,4697
149,BUMA.1121.00046,2,1047966,1052663,-,4697
149,BUMA.1121.00036,2,1514261,1518958,-,4697
149,BUMA.1121.00013,2,506201,510898,+,4697
149,BUMA.1121.00028,2,80043,84740,+,4697
149,BUMA.1121.00010,2,1341825,1346522,-,4697
149,BUMA.1121.00004,2,80058,84755,+,4697
149,BUMA.1121.00015,2,327918,332615,+,4697
149,BUMA.1121.00008,2,80064,84761,+,4697
149,BUMA.1121.00022,2,1621871,1626568,+,4697
149,BUMA.1121.00026,2,677925,682622,+,4697
149,BUMA.1121.00024,2,80057,84754,+,4697
149,BUMA.1121.00052,2,193450,198147,+,4697
149,BUMA.1121.00032,2,625711,630408,+,4697
149,BUMA.1121.00019,2,80050,84747,+,4697
149,BUMA.1121.00044,2,131189,135886,+,4697
149,BUMA.1121.00030,2,2037060,2041757,-,4697
149,BUMA.1121.00020,2,80050,84747,+,4697
148,BUMA.1121.00050,2,21348,57455,+,36107
148,BUMA.1121.00081,2,36093,72131,+,36038
148,BUMA.1121.00006,2,2251409,2287454,-,36045
148,BUMA.1121.00087,2,529762,565866,-,36104
148,BUMA.1121.00040,2,1863,37942,-,36079
148,BUMA.1121.00086,2,37333,73500,+,36167
148,BUMA.1121.00054,2,2051501,2087546,-,36045
148,BUMA.1121.00034,2,40632,76540,+,35908
148,BUMA.1121.00048,2,775536,811581,+,36045
148,BUMA.1121.00017,2,40632,76540,+,35908
148,BUMA.1121.00038,2,2152610,2188655,-,36045
148,BUMA.1121.00085,2,1200285,1236329,+,36044
148,BUMA.1121.00002,2,498122,534160,-,36038
148,BUMA.1121.00046,2,1056133,1092238,-,36105
148,BUMA.1121.00042,2,1640822,1676866,-,36044
148,BUMA.1121.00036,2,1522420,1558458,-,36038
148,BUMA.1121.00013,2,466526,502739,+,36213
148,BUMA.1121.00028,2,40632,76581,+,35949
148,BUMA.1121.00010,2,1349991,1386050,-,36059
148,BUMA.1121.00004,2,40632,76596,+,35964
148,BUMA.1121.00015,2,288432,324456,+,36024
148,BUMA.1121.00008,2,40632,76602,+,35970
148,BUMA.1121.00022,2,1582327,1618409,+,36082
148,BUMA.1121.00026,2,638402,674472,+,36070
148,BUMA.1121.00024,2,40632,76595,+,35963
148,BUMA.1121.00052,2,153944,189988,+,36044
148,BUMA.1121.00032,2,586250,622249,+,35999
148,BUMA.1121.00019,2,40625,76588,+,35963
148,BUMA.1121.00044,2,91819,127727,+,35908
148,BUMA.1121.00030,2,2045219,2081127,-,35908
148,BUMA.1121.00020,2,40625,76588,+,35963
147,BUMA.1121.00050,2,3178,21346,+,18168
147,BUMA.1121.00081,2,17923,36091,+,18168
147,BUMA.1121.00006,2,2287455,2305623,-,18168
147,BUMA.1121.00087,2,567102,585274,-,18172
147,BUMA.1121.00040,2,37943,56111,-,18168
147,BUMA.1121.00086,2,17924,36097,+,18173
147,BUMA.1121.00054,2,2087547,2105715,-,18168
147,BUMA.1121.00034,2,21223,39396,+,18173
147,BUMA.1121.00048,2,757366,775534,+,18168
147,BUMA.1121.00017,2,21223,39396,+,18173
147,BUMA.1121.00038,2,2188656,2206824,-,18168
147,BUMA.1121.00085,2,1182115,1200283,+,18168
147,BUMA.1121.00002,2,535396,553568,-,18172
147,BUMA.1121.00046,2,1092239,1110407,-,18168
147,BUMA.1121.00042,2,1676867,1695036,-,18169
147,BUMA.1121.00036,2,1559694,1577866,-,18172
147,BUMA.1121.00013,2,448356,466524,+,18168
147,BUMA.1121.00028,2,21223,39396,+,18173
147,BUMA.1121.00010,2,1387286,1405457,-,18171
147,BUMA.1121.00004,2,21223,39396,+,18173
147,BUMA.1121.00015,2,270262,288430,+,18168
147,BUMA.1121.00008,2,21223,39396,+,18173
147,BUMA.1121.00022,2,1562918,1581091,+,18173
147,BUMA.1121.00026,2,620232,638400,+,18168
147,BUMA.1121.00024,2,21223,39396,+,18173
147,BUMA.1121.00052,2,135774,153942,+,18168
147,BUMA.1121.00032,2,566841,585014,+,18173
147,BUMA.1121.00019,2,21216,39389,+,18173
147,BUMA.1121.00044,2,72410,90583,+,18173
147,BUMA.1121.00030,2,2082363,2100535,-,18172
147,BUMA.1121.00020,2,21216,39389,+,18173
146,BUMA.1121.00022,1,3549163,3559649,+,10486
146,BUMA.1121.00024,1,3109260,3119855,-,10595
146,BUMA.1121.00054,1,154961,165556,-,10595
146,BUMA.1121.00052,1,2973126,2983633,+,10507
146,BUMA.1121.00048,1,260046,270539,+,10493
146,BUMA.1121.00050,1,783837,794453,-,10616
146,BUMA.1121.00015,1,2455926,2466440,+,10514
146,BUMA.1121.00086,1,171629,182217,-,10588
146,BUMA.1121.00085,1,2570072,2580579,+,10507
146,BUMA.1121.00040,1,3212878,3223400,+,10522
146,BUMA.1121.00020,1,3245280,3255875,-,10595
146,BUMA.1121.00044,1,2438982,2449577,-,10595
146,BUMA.1121.00002,1,1978623,1989162,-,10539
146,BUMA.1121.00087,1,3136883,3147369,+,10486
146,BUMA.1121.00042,1,1100763,1111372,-,10609
146,BUMA.1121.00046,1,1957245,1967759,+,10514
146,BUMA.1121.00036,1,2618764,2629292,+,10528
146,BUMA.1121.00038,1,467518,478011,+,10493
146,BUMA.1121.00081,1,467587,478080,+,10493
146,BUMA.1121.00034,1,3210812,3221407,-,10595
146,BUMA.1121.00013,1,3265222,3275729,+,10507
146,BUMA.1121.00032,1,1233934,1244529,-,10595
146,BUMA.1121.00004,1,3260700,3271295,-,10595
146,BUMA.1121.00006,1,467518,478011,+,10493
146,BUMA.1121.00017,1,3108477,3119072,-,10595
146,BUMA.1121.00008,1,3192066,3202661,-,10595
146,BUMA.1121.00028,1,3180460,3191055,-,10595
146,BUMA.1121.00026,1,2180125,2190678,-,10553
146,BUMA.1121.00010,1,1951770,1962309,-,10539
146,BUMA.1121.00030,1,3108545,3119140,-,10595
146,BUMA.1121.00019,1,3131793,3142388,-,10595
145,BUMA.1121.00022,1,3487058,3547808,+,60750
145,BUMA.1121.00024,1,2997503,3058215,+,60712
145,BUMA.1121.00054,1,42873,103636,+,60763
145,BUMA.1121.00052,1,2839872,2900472,+,60600
145,BUMA.1121.00048,1,321963,382719,-,60756
145,BUMA.1121.00050,1,671784,732496,+,60712
145,BUMA.1121.00015,1,2509208,2569936,-,60728
145,BUMA.1121.00086,1,1755119,1815712,+,60593
145,BUMA.1121.00085,1,2436818,2497418,+,60600
145,BUMA.1121.00040,1,3080737,3141490,+,60753
145,BUMA.1121.00020,1,3133523,3194242,+,60719
145,BUMA.1121.00044,1,2334281,2394993,+,60712
145,BUMA.1121.00002,1,2060589,2121353,-,60764
145,BUMA.1121.00087,1,1501158,1561751,-,60593
145,BUMA.1121.00042,1,1182947,1243649,-,60702
145,BUMA.1121.00046,1,2019200,2079913,-,60713
145,BUMA.1121.00036,1,983152,1043887,-,60735
145,BUMA.1121.00038,1,529438,590194,-,60756
145,BUMA.1121.00081,1,529507,590263,-,60756
145,BUMA.1121.00034,1,3106111,3166823,+,60712
145,BUMA.1121.00013,1,3131991,3192593,+,60602
145,BUMA.1121.00032,1,1122184,1182896,+,60712
145,BUMA.1121.00004,1,3148950,3209662,+,60712
145,BUMA.1121.00006,1,529438,590193,-,60755
145,BUMA.1121.00017,1,3003776,3064488,+,60712
145,BUMA.1121.00008,1,3080316,3141028,+,60712
145,BUMA.1121.00028,1,3068710,3129422,+,60712
145,BUMA.1121.00026,1,2260575,2321149,-,60574
145,BUMA.1121.00010,1,2033730,2094494,-,60764
145,BUMA.1121.00030,1,3003846,3064556,+,60710
145,BUMA.1121.00019,1,3020043,3080755,+,60712
144,BUMA.1121.00022,1,3478702,3486548,+,7846
144,BUMA.1121.00024,1,2989154,2996993,+,7839
144,BUMA.1121.00054,1,34590,42363,+,7773
144,BUMA.1121.00054,1,3531061,3538786,+,7725
144,BUMA.1121.00052,1,2831516,2839362,+,7846
144,BUMA.1121.00048,1,383228,390999,-,7771
144,BUMA.1121.00050,1,663503,671274,+,7771
144,BUMA.1121.00015,1,2570445,2578216,-,7771
144,BUMA.1121.00086,1,1746763,1754609,+,7846
144,BUMA.1121.00085,1,2428462,2436308,+,7846
144,BUMA.1121.00040,1,3072381,3080227,+,7846
144,BUMA.1121.00020,1,3125174,3133013,+,7839
144,BUMA.1121.00044,1,2325932,2333771,+,7839
144,BUMA.1121.00002,1,2121862,2129706,-,7844
144,BUMA.1121.00087,1,1562260,1570104,-,7844
144,BUMA.1121.00042,1,1244158,1252009,-,7851
144,BUMA.1121.00046,1,2080422,2088191,-,7769
144,BUMA.1121.00036,1,1044396,1052240,-,7844
144,BUMA.1121.00038,1,590703,598474,-,7771
144,BUMA.1121.00081,1,590772,598543,-,7771
144,BUMA.1121.00034,1,3097762,3105601,+,7839
144,BUMA.1121.00013,1,3123635,3131481,+,7846
144,BUMA.1121.00032,1,1113835,1121674,+,7839
144,BUMA.1121.00004,1,3140601,3148440,+,7839
144,BUMA.1121.00006,1,590702,598473,-,7771
144,BUMA.1121.00017,1,2995427,3003266,+,7839
144,BUMA.1121.00008,1,3071967,3079806,+,7839
144,BUMA.1121.00028,1,3060361,3068200,+,7839
144,BUMA.1121.00026,1,2321658,2329502,-,7844
144,BUMA.1121.00010,1,2095003,2102847,-,7844
144,BUMA.1121.00030,1,2995497,3003336,+,7839
144,BUMA.1121.00019,1,3011694,3019533,+,7839
143,BUMA.1121.00022,1,3466456,3476547,+,10091
143,BUMA.1121.00024,1,2976908,2986999,+,10091
143,BUMA.1121.00054,1,22311,32435,+,10124
143,BUMA.1121.00048,1,393141,403280,-,10139
143,BUMA.1121.00050,1,651237,661358,+,10121
143,BUMA.1121.00015,1,2580373,2590478,-,10105
143,BUMA.1121.00086,1,1734516,1744601,+,10085
143,BUMA.1121.00040,1,3060133,3070226,+,10093
143,BUMA.1121.00020,1,3112928,3123019,+,10091
143,BUMA.1121.00044,1,2313686,2323777,+,10091
143,BUMA.1121.00087,1,1572268,1582353,-,10085
143,BUMA.1121.00042,1,1255893,1266033,+,10140
143,BUMA.1121.00046,1,2090340,2100460,-,10120
143,BUMA.1121.00036,1,1054378,1064484,-,10106
143,BUMA.1121.00038,1,600631,610755,-,10124
143,BUMA.1121.00081,1,600700,610824,-,10124
143,BUMA.1121.00034,1,3085516,3095607,+,10091
143,BUMA.1121.00013,1,3110721,3120855,-,10134
143,BUMA.1121.00004,1,3128356,3138446,+,10090
143,BUMA.1121.00006,1,600630,610754,-,10124
143,BUMA.1121.00017,1,2983181,2993272,+,10091
143,BUMA.1121.00008,1,3059721,3069812,+,10091
143,BUMA.1121.00028,1,3048115,3058206,+,10091
143,BUMA.1121.00030,1,2983251,2993342,+,10091
143,BUMA.1121.00019,1,2999448,3009539,+,10091
142,BUMA.1121.00022,1,3449071,3461328,+,12257
142,BUMA.1121.00054,1,4659,16934,+,12275
142,BUMA.1121.00054,1,3514772,3527050,+,12278
142,BUMA.1121.00052,1,2815466,2827751,+,12285
142,BUMA.1121.00048,1,408657,420935,-,12278
142,BUMA.1121.00050,1,633824,646109,+,12285
142,BUMA.1121.00015,1,2595606,2607884,-,12278
142,BUMA.1121.00086,1,1717130,1729388,+,12258
142,BUMA.1121.00085,1,2412412,2424697,+,12285
142,BUMA.1121.00040,1,3042720,3055005,+,12285
142,BUMA.1121.00020,1,3095536,3107800,+,12264
142,BUMA.1121.00044,1,2296294,2308558,+,12264
142,BUMA.1121.00002,1,2133472,2145750,-,12278
142,BUMA.1121.00087,1,1587481,1599739,-,12258
142,BUMA.1121.00042,1,1268869,1281210,-,12341
142,BUMA.1121.00046,1,2105588,2117873,-,12285
142,BUMA.1121.00036,1,1069614,1081871,-,12257
142,BUMA.1121.00038,1,616132,628410,-,12278
142,BUMA.1121.00081,1,616201,628479,-,12278
142,BUMA.1121.00034,1,3068124,3080388,+,12264
142,BUMA.1121.00013,1,3095592,3107884,+,12292
142,BUMA.1121.00032,1,1097807,1110071,+,12264
142,BUMA.1121.00004,1,3010848,3023111,+,12263
142,BUMA.1121.00004,1,3060904,3073167,+,12263
142,BUMA.1121.00004,1,3110960,3123228,+,12268
142,BUMA.1121.00006,1,616131,628409,-,12278
142,BUMA.1121.00017,1,2965789,2978053,+,12264
142,BUMA.1121.00008,1,3042329,3054593,+,12264
142,BUMA.1121.00028,1,3030723,3042987,+,12264
142,BUMA.1121.00026,1,2332441,2344740,-,12299
142,BUMA.1121.00010,1,2106613,2118891,-,12278
142,BUMA.1121.00030,1,2965859,2978123,+,12264
142,BUMA.1121.00019,1,2982056,2994320,+,12264
141,BUMA.1121.00022,1,3445385,3449070,+,3685
141,BUMA.1121.00054,1,1000,4658,+,3658
141,BUMA.1121.00054,1,3511084,3514771,+,3687
141,BUMA.1121.00052,1,2811778,2815465,+,3687
141,BUMA.1121.00048,1,420937,424624,-,3687
141,BUMA.1121.00050,1,630136,633823,+,3687
141,BUMA.1121.00050,2,2224734,2228436,-,3702
141,BUMA.1121.00015,1,2607886,2611573,-,3687
141,BUMA.1121.00081,2,189914,193616,+,3702
141,BUMA.1121.00006,2,2129903,2133605,-,3702
141,BUMA.1121.00086,1,1713442,1717129,+,3687
141,BUMA.1121.00085,1,2408724,2412411,+,3687
141,BUMA.1121.00040,1,3039032,3042719,+,3687
141,BUMA.1121.00087,2,408486,412188,-,3702
141,BUMA.1121.00040,2,151082,154784,+,3702
141,BUMA.1121.00020,1,3091848,3095535,+,3687
141,BUMA.1121.00044,1,2292606,2296293,+,3687
141,BUMA.1121.00086,2,191076,194778,+,3702
141,BUMA.1121.00054,2,1930016,1933718,-,3702
141,BUMA.1121.00002,1,2145752,2149439,-,3687
141,BUMA.1121.00087,1,1599741,1603428,-,3687
141,BUMA.1121.00042,1,1281212,1284899,-,3687
141,BUMA.1121.00034,2,1914061,1917763,-,3702
141,BUMA.1121.00048,2,929363,933065,+,3702
141,BUMA.1121.00017,2,1914057,1917759,-,3702
141,BUMA.1121.00038,2,2031118,2034820,-,3702
141,BUMA.1121.00085,2,1354100,1357802,+,3702
141,BUMA.1121.00002,2,376662,380364,-,3702
141,BUMA.1121.00046,1,2117875,2121562,-,3687
141,BUMA.1121.00046,2,1206710,1210412,+,3702
141,BUMA.1121.00042,2,1791508,1795210,+,3702
141,BUMA.1121.00036,1,1081873,1085560,-,3687
141,BUMA.1121.00038,1,628412,632099,-,3687
141,BUMA.1121.00036,2,1468455,1472157,-,3702
141,BUMA.1121.00013,2,620543,624245,+,3702
141,BUMA.1121.00081,1,628481,632168,-,3687
141,BUMA.1121.00034,1,3064436,3068123,+,3687
141,BUMA.1121.00028,2,1940185,1943887,-,3702
141,BUMA.1121.00013,1,3091904,3095591,+,3687
141,BUMA.1121.00010,2,1228666,1232368,-,3702
141,BUMA.1121.00004,2,1898743,1902445,-,3702
141,BUMA.1121.00032,1,1094119,1097806,+,3687
141,BUMA.1121.00015,2,442163,445865,+,3702
141,BUMA.1121.00004,1,3007160,3010847,+,3687
141,BUMA.1121.00004,1,3057216,3060903,+,3687
141,BUMA.1121.00004,1,3107272,3110959,+,3687
141,BUMA.1121.00006,1,628411,632098,-,3687
141,BUMA.1121.00017,1,2962101,2965788,+,3687
141,BUMA.1121.00008,1,3038641,3042328,+,3687
141,BUMA.1121.00028,1,3027035,3030722,+,3687
141,BUMA.1121.00008,2,1898290,1901992,-,3702
141,BUMA.1121.00022,2,1736220,1739922,+,3702
141,BUMA.1121.00026,2,519983,523685,-,3702
141,BUMA.1121.00026,1,2344742,2348429,-,3687
141,BUMA.1121.00024,2,2033944,2037646,-,3702
141,BUMA.1121.00052,2,307759,311461,+,3702
141,BUMA.1121.00032,2,339122,342824,-,3702
141,BUMA.1121.00010,1,2118893,2122580,-,3687
141,BUMA.1121.00019,2,1978157,1981859,-,3702
141,BUMA.1121.00030,1,2962171,2965858,+,3687
141,BUMA.1121.00044,2,1964958,1968660,-,3702
141,BUMA.1121.00030,2,204242,207944,+,3702
141,BUMA.1121.00020,2,1899012,1902714,-,3702
141,BUMA.1121.00019,1,2978368,2982055,+,3687
140,BUMA.1121.00022,1,3430742,3444364,+,13622
140,BUMA.1121.00054,1,3496444,3510051,+,13607
140,BUMA.1121.00052,1,2797138,2810745,+,13607
140,BUMA.1121.00048,1,425648,439263,-,13615
140,BUMA.1121.00050,1,615488,629095,+,13607
140,BUMA.1121.00015,1,2612597,2626212,-,13615
140,BUMA.1121.00086,1,1698814,1712421,+,13607
140,BUMA.1121.00085,1,2394084,2407691,+,13607
140,BUMA.1121.00040,1,3024384,3037991,+,13607
140,BUMA.1121.00020,1,3077208,3090815,+,13607
140,BUMA.1121.00044,1,2277966,2291573,+,13607
140,BUMA.1121.00002,1,2150463,2164078,-,13615
140,BUMA.1121.00087,1,1604440,1618055,-,13615
140,BUMA.1121.00042,1,1285923,1299737,-,13814
140,BUMA.1121.00046,1,2122586,2136209,-,13623
140,BUMA.1121.00036,1,1086584,1100199,-,13615
140,BUMA.1121.00038,1,633123,646738,-,13615
140,BUMA.1121.00081,1,633192,646807,-,13615
140,BUMA.1121.00034,1,3049796,3063403,+,13607
140,BUMA.1121.00013,1,3077264,3090871,+,13607
140,BUMA.1121.00032,1,1079479,1093086,+,13607
140,BUMA.1121.00004,1,2992520,3006127,+,13607
140,BUMA.1121.00004,1,3042576,3056183,+,13607
140,BUMA.1121.00004,1,3092632,3106239,+,13607
140,BUMA.1121.00006,1,633122,646737,-,13615
140,BUMA.1121.00017,1,2947461,2961068,+,13607
140,BUMA.1121.00008,1,3024001,3037608,+,13607
140,BUMA.1121.00028,1,3012395,3026002,+,13607
140,BUMA.1121.00026,1,2349441,2363257,-,13816
140,BUMA.1121.00010,1,2123604,2137219,-,13615
140,BUMA.1121.00030,1,2947531,2961138,+,13607
140,BUMA.1121.00019,1,2963728,2977335,+,13607
139,BUMA.1121.00022,1,3412901,3429505,+,16604
139,BUMA.1121.00054,1,3479830,3496443,+,16613
139,BUMA.1121.00052,1,2780522,2797137,+,16615
139,BUMA.1121.00048,1,439265,455878,-,16613
139,BUMA.1121.00050,1,598872,615487,+,16615
139,BUMA.1121.00015,1,2626214,2642829,-,16615
139,BUMA.1121.00086,1,1682218,1698813,+,16595
139,BUMA.1121.00085,1,2377468,2394083,+,16615
139,BUMA.1121.00040,1,3007768,3024383,+,16615
139,BUMA.1121.00020,1,3060592,3077207,+,16615
139,BUMA.1121.00044,1,2261350,2277965,+,16615
139,BUMA.1121.00002,1,2164080,2180695,-,16615
139,BUMA.1121.00087,1,1618057,1634652,-,16595
139,BUMA.1121.00042,1,1299739,1316354,-,16615
139,BUMA.1121.00046,1,2136211,2152826,-,16615
139,BUMA.1121.00036,1,1100201,1116816,-,16615
139,BUMA.1121.00038,1,646740,663353,-,16613
139,BUMA.1121.00081,1,646809,663422,-,16613
139,BUMA.1121.00034,1,3033180,3049795,+,16615
139,BUMA.1121.00013,1,3060648,3077263,+,16615
139,BUMA.1121.00032,1,1062863,1079478,+,16615
139,BUMA.1121.00004,1,2975915,2992519,+,16604
139,BUMA.1121.00004,1,3025962,3042575,+,16613
139,BUMA.1121.00004,1,3076018,3092631,+,16613
139,BUMA.1121.00006,1,646739,663352,-,16613
139,BUMA.1121.00017,1,2930845,2947460,+,16615
139,BUMA.1121.00008,1,3007385,3024000,+,16615
139,BUMA.1121.00028,1,2995779,3012394,+,16615
139,BUMA.1121.00026,1,2363259,2379874,-,16615
139,BUMA.1121.00010,1,2137221,2153836,-,16615
139,BUMA.1121.00030,1,2930915,2947530,+,16615
139,BUMA.1121.00019,1,2947112,2963727,+,16615
138,BUMA.1121.00022,1,3393062,3412899,+,19837
138,BUMA.1121.00054,1,3460009,3479828,+,19819
138,BUMA.1121.00052,1,2760695,2780520,+,19825
138,BUMA.1121.00048,1,455879,475699,-,19820
138,BUMA.1121.00050,1,579060,598870,+,19810
138,BUMA.1121.00015,1,2642830,2662634,-,19804
138,BUMA.1121.00086,1,1662412,1682216,+,19804
138,BUMA.1121.00085,1,2357641,2377466,+,19825
138,BUMA.1121.00040,1,2987947,3007766,+,19819
138,BUMA.1121.00020,1,3040786,3060590,+,19804
138,BUMA.1121.00044,1,2241544,2261348,+,19804
138,BUMA.1121.00002,1,2180696,2200516,-,19820
138,BUMA.1121.00087,1,1634653,1654457,-,19804
138,BUMA.1121.00042,1,1316355,1336169,-,19814
138,BUMA.1121.00046,1,2152827,2172637,-,19810
138,BUMA.1121.00036,1,1116817,1136631,-,19814
138,BUMA.1121.00038,1,663354,683174,-,19820
138,BUMA.1121.00081,1,663423,683243,-,19820
138,BUMA.1121.00034,1,3013374,3033178,+,19804
138,BUMA.1121.00013,1,3040821,3060646,+,19825
138,BUMA.1121.00032,1,1043057,1062861,+,19804
138,BUMA.1121.00006,1,663353,683173,-,19820
138,BUMA.1121.00017,1,2911039,2930843,+,19804
138,BUMA.1121.00008,1,2987579,3007383,+,19804
138,BUMA.1121.00028,1,2975973,2995777,+,19804
138,BUMA.1121.00026,1,2379875,2399685,-,19810
138,BUMA.1121.00010,1,2153837,2173657,-,19820
138,BUMA.1121.00030,1,2911109,2930913,+,19804
138,BUMA.1121.00019,1,2927306,2947110,+,19804
137,BUMA.1121.00022,1,3386664,3391851,+,5187
137,BUMA.1121.00024,1,2968220,2973391,+,5171
137,BUMA.1121.00054,1,3453611,3458797,+,5186
137,BUMA.1121.00052,1,2754297,2759483,+,5186
137,BUMA.1121.00048,1,476912,482098,-,5186
137,BUMA.1121.00050,1,572647,577833,+,5186
137,BUMA.1121.00015,1,2663862,2669048,-,5186
137,BUMA.1121.00086,1,1655999,1661170,+,5171
137,BUMA.1121.00085,1,2351243,2356429,+,5186
137,BUMA.1121.00040,1,2981549,2986735,+,5186
137,BUMA.1121.00020,1,3034373,3039544,+,5171
137,BUMA.1121.00044,1,2235131,2240302,+,5171
137,BUMA.1121.00002,1,2201727,2206914,-,5187
137,BUMA.1121.00087,1,1655699,1660871,-,5172
137,BUMA.1121.00042,1,1337380,1342567,-,5187
137,BUMA.1121.00046,1,2173865,2179051,-,5186
137,BUMA.1121.00036,1,1137841,1143028,-,5187
137,BUMA.1121.00038,1,684386,689572,-,5186
137,BUMA.1121.00081,1,684455,689641,-,5186
137,BUMA.1121.00034,1,3006961,3012132,+,5171
137,BUMA.1121.00013,1,3034423,3039609,+,5186
137,BUMA.1121.00032,1,1036644,1041815,+,5171
137,BUMA.1121.00004,1,2969503,2974674,+,5171
137,BUMA.1121.00006,1,684385,689571,-,5186
137,BUMA.1121.00017,1,2904626,2909797,+,5171
137,BUMA.1121.00008,1,2981166,2986337,+,5171
137,BUMA.1121.00028,1,2969560,2974731,+,5171
137,BUMA.1121.00026,1,2400896,2406083,-,5187
137,BUMA.1121.00010,1,2174868,2180055,-,5187
137,BUMA.1121.00030,1,2904696,2909867,+,5171
137,BUMA.1121.00019,1,2920893,2926064,+,5171
136,BUMA.1121.00022,1,3377564,3383388,+,5824
136,BUMA.1121.00024,1,2959120,2964944,+,5824
136,BUMA.1121.00054,1,3444511,3450335,+,5824
136,BUMA.1121.00052,1,2745197,2751021,+,5824
136,BUMA.1121.00048,1,485373,491197,-,5824
136,BUMA.1121.00050,1,563547,569371,+,5824
136,BUMA.1121.00015,1,2672323,2678147,-,5824
136,BUMA.1121.00086,1,1646899,1652723,+,5824
136,BUMA.1121.00085,1,2342143,2347967,+,5824
136,BUMA.1121.00040,1,2972449,2978273,+,5824
136,BUMA.1121.00020,1,3025273,3031097,+,5824
136,BUMA.1121.00044,1,2226031,2231855,+,5824
136,BUMA.1121.00002,1,2210189,2216013,-,5824
136,BUMA.1121.00087,1,1664146,1669970,-,5824
136,BUMA.1121.00042,1,1347423,1353262,-,5839
136,BUMA.1121.00046,1,2182326,2188150,-,5824
136,BUMA.1121.00036,1,1146303,1152127,-,5824
136,BUMA.1121.00038,1,692847,698671,-,5824
136,BUMA.1121.00081,1,692916,698740,-,5824
136,BUMA.1121.00034,1,2997861,3003685,+,5824
136,BUMA.1121.00013,1,3025323,3031147,+,5824
136,BUMA.1121.00032,1,1027544,1033368,+,5824
136,BUMA.1121.00004,1,2960403,2966227,+,5824
136,BUMA.1121.00006,1,692846,698670,-,5824
136,BUMA.1121.00017,1,2895526,2901350,+,5824
136,BUMA.1121.00008,1,2972066,2977890,+,5824
136,BUMA.1121.00028,1,2960460,2966284,+,5824
136,BUMA.1121.00026,1,2410939,2416778,-,5839
136,BUMA.1121.00010,1,2183330,2189154,-,5824
136,BUMA.1121.00030,1,2895596,2901420,+,5824
136,BUMA.1121.00019,1,2911793,2917617,+,5824
135,BUMA.1121.00022,1,3328236,3375728,+,47492
135,BUMA.1121.00024,1,2909786,2957269,+,47483
135,BUMA.1121.00054,1,3395158,3442675,+,47517
135,BUMA.1121.00052,1,2695870,2743345,+,47475
135,BUMA.1121.00048,1,493034,540550,-,47516
135,BUMA.1121.00050,1,514180,561711,+,47531
135,BUMA.1121.00015,1,2679985,2727471,-,47486
135,BUMA.1121.00086,1,1597527,1645061,+,47534
135,BUMA.1121.00085,1,2292816,2340291,+,47475
135,BUMA.1121.00040,1,2921747,2970612,+,48865
135,BUMA.1121.00020,1,2975939,3023422,+,47483
135,BUMA.1121.00044,1,2176691,2224180,+,47489
135,BUMA.1121.00002,1,2217850,2265379,-,47529
135,BUMA.1121.00087,1,1671809,1719343,-,47534
135,BUMA.1121.00042,1,1355099,1402743,-,47644
135,BUMA.1121.00046,1,2189987,2237518,-,47531
135,BUMA.1121.00036,1,1153964,1201456,-,47492
135,BUMA.1121.00038,1,700508,748024,-,47516
135,BUMA.1121.00081,1,700577,748093,-,47516
135,BUMA.1121.00034,1,2948521,2996010,+,47489
135,BUMA.1121.00013,1,2975998,3023471,+,47473
135,BUMA.1121.00032,1,978211,1025693,+,47482
135,BUMA.1121.00004,1,2911070,2958552,+,47482
135,BUMA.1121.00006,1,700507,748023,-,47516
135,BUMA.1121.00017,1,2846186,2893675,+,47489
135,BUMA.1121.00008,1,2922732,2970215,+,47483
135,BUMA.1121.00028,1,2911126,2958609,+,47483
135,BUMA.1121.00026,1,2418615,2466246,-,47631
135,BUMA.1121.00010,1,2190988,2238517,-,47529
135,BUMA.1121.00030,1,2846256,2893745,+,47489
135,BUMA.1121.00019,1,2862459,2909942,+,47483
134,BUMA.1121.00022,1,3322822,3326356,+,3534
134,BUMA.1121.00024,1,2904379,2907906,+,3527
134,BUMA.1121.00054,1,3388479,3392027,+,3548
134,BUMA.1121.00052,1,2690535,2694076,+,3541
134,BUMA.1121.00048,1,543681,547245,-,3564
134,BUMA.1121.00050,1,508749,512291,+,3542
134,BUMA.1121.00015,1,2729359,2732930,-,3571
134,BUMA.1121.00086,1,1592106,1595647,+,3541
134,BUMA.1121.00085,1,2287481,2291022,+,3541
134,BUMA.1121.00040,1,2916309,2919858,+,3549
134,BUMA.1121.00020,1,2970532,2974059,+,3527
134,BUMA.1121.00044,1,2171284,2174811,+,3527
134,BUMA.1121.00002,1,2370599,2374164,-,3565
134,BUMA.1121.00087,1,1721222,1724763,-,3541
134,BUMA.1121.00046,1,2239406,2242933,-,3527
134,BUMA.1121.00036,1,1203335,1206869,-,3534
134,BUMA.1121.00038,1,751155,754703,-,3548
134,BUMA.1121.00081,1,751224,754772,-,3548
134,BUMA.1121.00034,1,2943114,2946641,+,3527
134,BUMA.1121.00013,1,2970568,2974109,+,3541
134,BUMA.1121.00032,1,972804,976331,+,3527
134,BUMA.1121.00004,1,2905663,2909190,+,3527
134,BUMA.1121.00006,1,751154,754702,-,3548
134,BUMA.1121.00017,1,2840779,2844306,+,3527
134,BUMA.1121.00008,1,2917325,2920852,+,3527
134,BUMA.1121.00028,1,2905719,2909246,+,3527
134,BUMA.1121.00026,1,2468134,2471740,-,3606
134,BUMA.1121.00010,1,2343722,2347271,-,3549
134,BUMA.1121.00030,1,2840849,2844376,+,3527
134,BUMA.1121.00019,1,2857052,2860579,+,3527
133,BUMA.1121.00022,1,3302198,3321243,+,19045
133,BUMA.1121.00024,1,2883781,2902816,+,19035
133,BUMA.1121.00054,1,3367891,3386900,+,19009
133,BUMA.1121.00052,1,2669940,2688956,+,19016
133,BUMA.1121.00048,1,548793,567818,-,19025
133,BUMA.1121.00050,1,488106,507203,+,19097
133,BUMA.1121.00015,1,2734478,2753548,-,19070
133,BUMA.1121.00086,1,1571446,1590527,+,19081
133,BUMA.1121.00085,1,2266886,2285902,+,19016
133,BUMA.1121.00040,1,2895599,2914761,+,19162
133,BUMA.1121.00020,1,2950001,2968969,+,18968
133,BUMA.1121.00044,1,2150642,2169721,+,19079
133,BUMA.1121.00002,1,2375711,2394679,-,18968
133,BUMA.1121.00087,1,1726342,1745433,-,19091
133,BUMA.1121.00042,1,2309935,2328948,+,19013
133,BUMA.1121.00046,1,2244512,2263603,-,19091
133,BUMA.1121.00036,1,1208448,1227546,-,19098
133,BUMA.1121.00038,1,756282,775292,-,19010
133,BUMA.1121.00081,1,756351,775361,-,19010
133,BUMA.1121.00034,1,2922544,2941551,+,19007
133,BUMA.1121.00013,1,2949982,2968989,+,19007
133,BUMA.1121.00032,1,952189,971241,+,19052
133,BUMA.1121.00004,1,2885022,2904100,+,19078
133,BUMA.1121.00006,1,756281,775291,-,19010
133,BUMA.1121.00017,1,2820137,2839216,+,19079
133,BUMA.1121.00008,1,2896794,2915762,+,18968
133,BUMA.1121.00028,1,2885104,2904156,+,19052
133,BUMA.1121.00026,1,2473288,2492274,-,18986
133,BUMA.1121.00010,1,2348836,2367795,-,18959
133,BUMA.1121.00030,1,2820207,2839286,+,19079
133,BUMA.1121.00019,1,2836512,2855489,+,18977
132,BUMA.1121.00022,1,3289836,3299901,+,10065
132,BUMA.1121.00024,1,2871419,2881484,+,10065
132,BUMA.1121.00054,1,3355529,3365594,+,10065
132,BUMA.1121.00052,1,1373929,1383995,-,10066
132,BUMA.1121.00048,1,570114,580180,-,10066
132,BUMA.1121.00050,1,475744,485809,+,10065
132,BUMA.1121.00015,1,2755844,2765910,-,10066
132,BUMA.1121.00086,1,1559084,1569149,+,10065
132,BUMA.1121.00085,1,970819,980885,-,10066
132,BUMA.1121.00040,1,2881916,2891980,+,10064
132,BUMA.1121.00020,1,2937639,2947704,+,10065
132,BUMA.1121.00044,1,2138280,2148345,+,10065
132,BUMA.1121.00002,1,2396975,2407041,-,10066
132,BUMA.1121.00087,1,1747729,1757795,-,10066
132,BUMA.1121.00042,1,2297573,2307638,+,10065
132,BUMA.1121.00046,1,2265899,2275965,-,10066
132,BUMA.1121.00036,1,1229842,1239908,-,10066
132,BUMA.1121.00038,1,777588,787654,-,10066
132,BUMA.1121.00081,1,777657,787723,-,10066
132,BUMA.1121.00034,1,2910182,2920247,+,10065
132,BUMA.1121.00013,1,1574750,1584816,-,10066
132,BUMA.1121.00032,1,939827,949892,+,10065
132,BUMA.1121.00004,1,2872660,2882725,+,10065
132,BUMA.1121.00006,1,777587,787653,-,10066
132,BUMA.1121.00017,1,2807775,2817840,+,10065
132,BUMA.1121.00008,1,2884433,2894497,+,10064
132,BUMA.1121.00028,1,2872742,2882807,+,10065
132,BUMA.1121.00026,1,2494570,2504636,-,10066
132,BUMA.1121.00010,1,2370091,2380157,-,10066
132,BUMA.1121.00030,1,2807845,2817910,+,10065
132,BUMA.1121.00019,1,2824150,2834215,+,10065
131,BUMA.1121.00022,1,3276015,3288297,+,12282
131,BUMA.1121.00024,1,2857556,2869880,+,12324
131,BUMA.1121.00054,1,1019042,1031359,+,12317
131,BUMA.1121.00052,1,1358498,1370839,-,12341
131,BUMA.1121.00048,1,2904430,2916747,-,12317
131,BUMA.1121.00050,1,461923,474218,-,12295
131,BUMA.1121.00015,1,2767436,2779783,+,12347
131,BUMA.1121.00086,1,1545249,1557545,+,12296
131,BUMA.1121.00085,1,955388,967729,-,12341
131,BUMA.1121.00040,1,2868055,2880378,+,12323
131,BUMA.1121.00020,1,2923776,2936100,+,12324
131,BUMA.1121.00044,1,2124417,2136741,+,12324
131,BUMA.1121.00087,1,1759333,1771630,-,12297
131,BUMA.1121.00046,1,2277491,2289785,+,12294
131,BUMA.1121.00036,1,1241445,1253727,-,12282
131,BUMA.1121.00038,1,3111746,3124063,-,12317
131,BUMA.1121.00081,1,3111938,3124255,-,12317
131,BUMA.1121.00034,1,2896319,2908643,+,12324
131,BUMA.1121.00013,1,1559329,1571660,-,12331
131,BUMA.1121.00032,1,925964,938288,+,12324
131,BUMA.1121.00004,1,2858797,2871121,+,12324
131,BUMA.1121.00006,1,3111823,3124140,-,12317
131,BUMA.1121.00017,1,2793912,2806236,+,12324
131,BUMA.1121.00008,1,2870570,2882894,+,12324
131,BUMA.1121.00028,1,2858879,2871203,+,12324
131,BUMA.1121.00026,1,2506173,2518478,-,12305
131,BUMA.1121.00030,1,2793982,2806306,+,12324
130,BUMA.1121.00022,1,3253289,3272485,+,19196
130,BUMA.1121.00024,1,2834844,2854029,+,19185
130,BUMA.1121.00054,1,2295603,2314796,-,19193
130,BUMA.1121.00052,1,2647615,2666818,+,19203
130,BUMA.1121.00048,1,1620919,1640114,+,19195
130,BUMA.1121.00050,1,2851584,2870770,-,19186
130,BUMA.1121.00015,1,1199392,1218588,-,19196
130,BUMA.1121.00086,1,1522537,1541722,+,19185
130,BUMA.1121.00085,1,2244561,2263764,+,19203
130,BUMA.1121.00040,1,2846198,2865394,+,19196
130,BUMA.1121.00020,1,2901064,2920249,+,19185
130,BUMA.1121.00044,1,2101705,2120890,+,19185
130,BUMA.1121.00002,1,2410882,2430063,-,19181
130,BUMA.1121.00087,1,1775146,1794342,-,19196
130,BUMA.1121.00042,1,2276256,2295449,+,19193
130,BUMA.1121.00046,1,3390420,3409606,+,19186
130,BUMA.1121.00036,1,1257258,1276454,-,19196
130,BUMA.1121.00038,1,1828375,1847569,+,19194
130,BUMA.1121.00081,1,1828459,1847653,+,19194
130,BUMA.1121.00034,1,2873607,2892792,+,19185
130,BUMA.1121.00013,1,2927657,2946860,+,19203
130,BUMA.1121.00032,1,903252,922437,+,19185
130,BUMA.1121.00004,1,2836086,2855270,+,19184
130,BUMA.1121.00006,1,1828386,1847580,+,19194
130,BUMA.1121.00017,1,2771200,2790385,+,19185
130,BUMA.1121.00008,1,2847859,2867043,+,19184
130,BUMA.1121.00028,1,2836167,2855352,+,19185
130,BUMA.1121.00026,1,2522017,2541200,-,19183
130,BUMA.1121.00010,1,2383981,2403162,-,19181
130,BUMA.1121.00030,1,2771271,2790455,+,19184
130,BUMA.1121.00019,1,2801127,2820312,+,19185
129,BUMA.1121.00022,1,3219021,3248871,+,29850
129,BUMA.1121.00024,1,2800590,2830424,+,29834
129,BUMA.1121.00054,1,2320810,2350637,-,29827
129,BUMA.1121.00052,1,2611737,2641602,+,29865
129,BUMA.1121.00048,1,1585079,1614906,+,29827
129,BUMA.1121.00050,1,2875173,2905007,-,29834
129,BUMA.1121.00015,1,1223006,1252849,-,29843
129,BUMA.1121.00086,1,1488276,1518118,+,29842
129,BUMA.1121.00085,1,2208683,2238548,+,29865
129,BUMA.1121.00040,1,2811905,2841779,+,29874
129,BUMA.1121.00020,1,2866818,2896644,+,29826
129,BUMA.1121.00044,1,2067451,2097285,+,29834
129,BUMA.1121.00002,1,2434481,2464317,-,29836
129,BUMA.1121.00087,1,1798761,1828603,-,29842
129,BUMA.1121.00042,1,2240419,2270268,+,29849
129,BUMA.1121.00046,1,3356182,3386017,+,29835
129,BUMA.1121.00036,1,1280872,1310699,-,29827
129,BUMA.1121.00038,1,1792534,1822361,+,29827
129,BUMA.1121.00081,1,1792618,1822445,+,29827
129,BUMA.1121.00034,1,2839353,2869187,+,29834
129,BUMA.1121.00013,1,2892110,2921644,+,29534
129,BUMA.1121.00032,1,868998,898832,+,29834
129,BUMA.1121.00004,1,2801832,2831666,+,29834
129,BUMA.1121.00006,1,1792545,1822372,+,29827
129,BUMA.1121.00017,1,2736946,2766780,+,29834
129,BUMA.1121.00008,1,2813605,2843439,+,29834
129,BUMA.1121.00028,1,2801913,2831747,+,29834
129,BUMA.1121.00026,1,2547199,2577048,-,29849
129,BUMA.1121.00010,1,2407579,2437415,-,29836
129,BUMA.1121.00030,1,2737017,2766851,+,29834
129,BUMA.1121.00019,1,2766881,2796707,+,29826
128,BUMA.1121.00022,1,3113681,3213422,+,99741
128,BUMA.1121.00024,1,2695242,2794961,+,99719
128,BUMA.1121.00054,1,2356252,2455977,-,99725
128,BUMA.1121.00052,1,2506422,2606138,+,99716
128,BUMA.1121.00048,1,1479741,1579467,+,99726
128,BUMA.1121.00050,1,2910637,3010347,-,99710
128,BUMA.1121.00015,1,1258448,1358180,-,99732
128,BUMA.1121.00086,1,1382936,1482677,+,99741
128,BUMA.1121.00085,1,2103368,2203084,+,99716
128,BUMA.1121.00040,1,2706615,2806307,+,99692
128,BUMA.1121.00020,1,2761470,2861189,+,99719
128,BUMA.1121.00044,1,1962098,2061822,+,99724
128,BUMA.1121.00002,1,293803,394848,+,101045
128,BUMA.1121.00087,1,1834202,1933942,-,99740
128,BUMA.1121.00042,1,2135107,2234818,+,99711
128,BUMA.1121.00046,1,3250843,3350569,+,99726
128,BUMA.1121.00036,1,1316329,1416061,-,99732
128,BUMA.1121.00038,1,1687194,1786920,+,99726
128,BUMA.1121.00081,1,1687278,1787004,+,99726
128,BUMA.1121.00034,1,2734000,2833724,+,99724
128,BUMA.1121.00013,1,2786790,2886511,+,99721
128,BUMA.1121.00032,1,763650,863369,+,99719
128,BUMA.1121.00004,1,2696484,2796203,+,99719
128,BUMA.1121.00006,1,1687205,1786931,+,99726
128,BUMA.1121.00017,1,2631626,2731317,+,99691
128,BUMA.1121.00008,1,2708257,2807976,+,99719
128,BUMA.1121.00028,1,2696565,2796284,+,99719
128,BUMA.1121.00026,1,2582650,2682353,-,99703
128,BUMA.1121.00010,1,268494,369538,+,101044
128,BUMA.1121.00030,1,2631664,2731388,+,99724
128,BUMA.1121.00019,1,2661533,2761252,+,99719
59,BUMA.1121.00022,1,1324965,1330550,+,5585
59,BUMA.1121.00024,1,365,5950,+,5585
59,BUMA.1121.00054,1,627124,632709,-,5585
59,BUMA.1121.00052,1,3229694,3235279,+,5585
59,BUMA.1121.00048,1,3303079,3308664,+,5585
59,BUMA.1121.00050,1,1307759,1313344,+,5585
59,BUMA.1121.00015,1,544687,550272,+,5585
59,BUMA.1121.00086,1,434,6019,+,5585
59,BUMA.1121.00085,1,2826640,2832225,+,5585
59,BUMA.1121.00040,1,29,5614,+,5585
59,BUMA.1121.00020,1,365,5950,+,5585
59,BUMA.1121.00044,1,2802368,2807953,+,5585
59,BUMA.1121.00002,1,438966,444551,+,5585
59,BUMA.1121.00087,1,3310542,3316127,-,5585
59,BUMA.1121.00042,1,531410,536995,+,5585
59,BUMA.1121.00046,1,1438388,1443973,-,5585
59,BUMA.1121.00036,1,443366,448951,-,5585
59,BUMA.1121.00038,1,365,5950,+,5585
59,BUMA.1121.00081,1,434,6019,+,5585
59,BUMA.1121.00034,1,365,5950,+,5585
59,BUMA.1121.00013,1,1215664,1221249,-,5585
59,BUMA.1121.00032,1,1597350,1602935,+,5585
59,BUMA.1121.00004,1,365,5950,+,5585
59,BUMA.1121.00006,1,365,5950,+,5585
59,BUMA.1121.00017,1,365,5950,+,5585
59,BUMA.1121.00008,1,365,5950,+,5585
59,BUMA.1121.00028,1,365,5950,+,5585
59,BUMA.1121.00026,1,767259,772844,+,5585
59,BUMA.1121.00010,1,413642,419227,+,5585
59,BUMA.1121.00030,1,365,5950,+,5585
59,BUMA.1121.00019,1,365,5950,+,5585
58,BUMA.1121.00022,1,1319106,1324532,+,5426
58,BUMA.1121.00024,1,3501864,3507290,+,5426
58,BUMA.1121.00054,1,633142,638568,-,5426
58,BUMA.1121.00052,1,3223835,3229261,+,5426
58,BUMA.1121.00048,1,3297220,3302646,+,5426
58,BUMA.1121.00050,1,1301900,1307326,+,5426
58,BUMA.1121.00015,1,538829,544254,+,5425
58,BUMA.1121.00086,1,3490262,3495687,+,5425
58,BUMA.1121.00085,1,2820781,2826207,+,5426
58,BUMA.1121.00040,1,3548161,3553587,+,5426
58,BUMA.1121.00020,1,3620354,3625780,+,5426
58,BUMA.1121.00044,1,2796509,2801935,+,5426
58,BUMA.1121.00002,1,433107,438533,+,5426
58,BUMA.1121.00087,1,3316560,3321986,-,5426
58,BUMA.1121.00042,1,525551,530977,+,5426
58,BUMA.1121.00046,1,1444406,1449832,-,5426
58,BUMA.1121.00036,1,449384,454810,-,5426
58,BUMA.1121.00038,1,3504538,3509964,+,5426
58,BUMA.1121.00081,1,3504723,3510148,+,5425
58,BUMA.1121.00034,1,3568325,3573751,+,5426
58,BUMA.1121.00013,1,1221682,1227108,-,5426
58,BUMA.1121.00032,1,1591491,1596917,+,5426
58,BUMA.1121.00004,1,3618209,3623635,+,5426
58,BUMA.1121.00006,1,3504615,3510041,+,5426
58,BUMA.1121.00017,1,3465990,3471416,+,5426
58,BUMA.1121.00008,1,3552910,3558336,+,5426
58,BUMA.1121.00028,1,3573072,3578498,+,5426
58,BUMA.1121.00026,1,761400,766826,+,5426
58,BUMA.1121.00010,1,407783,413209,+,5426
58,BUMA.1121.00030,1,3466069,3471495,+,5426
58,BUMA.1121.00019,1,3506862,3512288,+,5426
57,BUMA.1121.00022,1,1308269,1317688,+,9419
57,BUMA.1121.00024,1,3455845,3465321,+,9476
57,BUMA.1121.00024,1,3473410,3482884,+,9474
57,BUMA.1121.00024,1,3490973,3500446,+,9473
57,BUMA.1121.00054,1,498673,508161,+,9488
57,BUMA.1121.00052,1,3213095,3222599,+,9504
57,BUMA.1121.00048,1,3427627,3437114,-,9487
57,BUMA.1121.00050,1,1291196,1300664,+,9468
57,BUMA.1121.00015,1,387781,397264,-,9483
57,BUMA.1121.00086,1,2265271,2274738,-,9467
57,BUMA.1121.00086,1,2283798,2293265,-,9467
57,BUMA.1121.00085,1,2810041,2819545,+,9504
57,BUMA.1121.00040,1,3537464,3546925,+,9461
57,BUMA.1121.00020,1,3591902,3601376,+,9474
57,BUMA.1121.00020,1,3609464,3618936,+,9472
57,BUMA.1121.00044,1,2785617,2795091,+,9474
57,BUMA.1121.00002,1,1652394,1661907,-,9513
57,BUMA.1121.00087,1,1042351,1051819,+,9468
57,BUMA.1121.00042,1,513408,522867,+,9459
57,BUMA.1121.00046,1,1451068,1460535,-,9467
57,BUMA.1121.00036,1,456228,465695,-,9467
57,BUMA.1121.00038,1,124913,134400,-,9487
57,BUMA.1121.00081,1,124982,134469,-,9487
57,BUMA.1121.00034,1,3557433,3566907,+,9474
57,BUMA.1121.00013,1,3505202,3514714,+,9512
57,BUMA.1121.00032,1,1580599,1590073,+,9474
57,BUMA.1121.00004,1,3607317,3616791,+,9474
57,BUMA.1121.00006,1,124913,134400,-,9487
57,BUMA.1121.00017,1,3455098,3464572,+,9474
57,BUMA.1121.00008,1,3542018,3551492,+,9474
57,BUMA.1121.00028,1,3527040,3536521,+,9481
57,BUMA.1121.00028,1,3544612,3554084,+,9472
57,BUMA.1121.00028,1,3562180,3571654,+,9474
57,BUMA.1121.00026,1,749249,758714,+,9465
57,BUMA.1121.00010,1,1626037,1635541,-,9504
57,BUMA.1121.00030,1,3455177,3464651,+,9474
57,BUMA.1121.00019,1,3478409,3487875,+,9466
57,BUMA.1121.00019,1,3495966,3505444,+,9478
56,BUMA.1121.00022,1,1289267,1297630,+,8363
56,BUMA.1121.00024,1,3436843,3445206,+,8363
56,BUMA.1121.00054,1,480806,489169,+,8363
56,BUMA.1121.00052,1,3194092,3202455,+,8363
56,BUMA.1121.00048,1,3446618,3454982,-,8364
56,BUMA.1121.00050,1,1272193,1280556,+,8363
56,BUMA.1121.00015,1,407904,416268,-,8364
56,BUMA.1121.00086,1,2303904,2312268,-,8364
56,BUMA.1121.00085,1,2791038,2799401,+,8363
56,BUMA.1121.00040,1,3519682,3528045,+,8363
56,BUMA.1121.00020,1,3572899,3581262,+,8363
56,BUMA.1121.00044,1,2766614,2774977,+,8363
56,BUMA.1121.00002,1,1672080,1680433,-,8353
56,BUMA.1121.00087,1,1023350,1031713,+,8363
56,BUMA.1121.00042,1,495540,503903,+,8363
56,BUMA.1121.00046,1,1471175,1479539,-,8364
56,BUMA.1121.00036,1,476333,484697,-,8364
56,BUMA.1121.00038,1,143904,152268,-,8364
56,BUMA.1121.00081,1,143973,152337,-,8364
56,BUMA.1121.00034,1,3538430,3546793,+,8363
56,BUMA.1121.00013,1,3486199,3494562,+,8363
56,BUMA.1121.00032,1,1561596,1569959,+,8363
56,BUMA.1121.00004,1,3588314,3596677,+,8363
56,BUMA.1121.00006,1,143904,152268,-,8364
56,BUMA.1121.00017,1,3436095,3444458,+,8363
56,BUMA.1121.00008,1,3519678,3528041,+,8363
56,BUMA.1121.00028,1,3508036,3516399,+,8363
56,BUMA.1121.00026,1,730576,738939,+,8363
56,BUMA.1121.00010,1,1646395,1654748,-,8353
56,BUMA.1121.00030,1,3436174,3444537,+,8363
56,BUMA.1121.00019,1,3459412,3467775,+,8363
55,BUMA.1121.00022,1,1263044,1288917,+,25873
55,BUMA.1121.00024,1,3410562,3436493,+,25931
55,BUMA.1121.00054,1,454426,480456,+,26030
55,BUMA.1121.00052,1,3167747,3193742,+,25995
55,BUMA.1121.00048,1,3455331,3481362,-,26031
55,BUMA.1121.00050,1,1245932,1271843,+,25911
55,BUMA.1121.00015,1,416617,442620,-,26003
55,BUMA.1121.00086,1,2312617,2338512,-,25895
55,BUMA.1121.00085,1,2764693,2790688,+,25995
55,BUMA.1121.00040,1,3493295,3519332,+,26037
55,BUMA.1121.00020,1,3546590,3572549,+,25959
55,BUMA.1121.00044,1,2740291,2766264,+,25973
55,BUMA.1121.00002,1,1682032,1707999,-,25967
55,BUMA.1121.00087,1,997106,1023000,+,25894
55,BUMA.1121.00042,1,469246,495190,+,25944
55,BUMA.1121.00046,1,1479888,1505807,-,25919
55,BUMA.1121.00036,1,485046,511083,-,26037
55,BUMA.1121.00038,1,152617,178648,-,26031
55,BUMA.1121.00081,1,152686,178717,-,26031
55,BUMA.1121.00034,1,3512121,3538080,+,25959
55,BUMA.1121.00013,1,3459875,3485849,+,25974
55,BUMA.1121.00032,1,1535280,1561246,+,25966
55,BUMA.1121.00004,1,3562005,3587964,+,25959
55,BUMA.1121.00006,1,152617,178648,-,26031
55,BUMA.1121.00017,1,3409786,3435745,+,25959
55,BUMA.1121.00008,1,3493376,3519328,+,25952
55,BUMA.1121.00028,1,3481755,3507686,+,25931
55,BUMA.1121.00026,1,704151,730226,+,26075
55,BUMA.1121.00010,1,1656348,1682314,-,25966
55,BUMA.1121.00030,1,3409851,3435824,+,25973
55,BUMA.1121.00019,1,3433103,3459062,+,25959
54,BUMA.1121.00022,1,1234204,1261435,+,27231
54,BUMA.1121.00024,1,3381722,3408953,+,27231
54,BUMA.1121.00054,1,425586,452817,+,27231
54,BUMA.1121.00052,1,3138907,3166138,+,27231
54,BUMA.1121.00048,1,3482955,3510187,-,27232
54,BUMA.1121.00050,1,1054658,1081905,+,27247
54,BUMA.1121.00015,1,604505,631752,-,27247
54,BUMA.1121.00086,1,2340110,2367357,-,27247
54,BUMA.1121.00085,1,2735853,2763084,+,27231
54,BUMA.1121.00040,1,3464469,3491701,+,27232
54,BUMA.1121.00020,1,3517750,3544981,+,27231
54,BUMA.1121.00044,1,2711436,2738682,+,27246
54,BUMA.1121.00002,1,1709590,1736837,-,27247
54,BUMA.1121.00087,1,968261,995508,+,27247
54,BUMA.1121.00042,1,440388,467655,+,27267
54,BUMA.1121.00046,1,1669801,1697048,-,27247
54,BUMA.1121.00036,1,512699,539946,-,27247
54,BUMA.1121.00038,1,180256,207488,-,27232
54,BUMA.1121.00081,1,180325,207557,-,27232
54,BUMA.1121.00034,1,3483266,3510512,+,27246
54,BUMA.1121.00013,1,3431035,3458266,+,27231
54,BUMA.1121.00032,1,1506440,1533671,+,27231
54,BUMA.1121.00004,1,3533165,3560396,+,27231
54,BUMA.1121.00006,1,180256,207488,-,27232
54,BUMA.1121.00017,1,3380931,3408177,+,27246
54,BUMA.1121.00008,1,3464536,3491767,+,27231
54,BUMA.1121.00028,1,3452915,3480146,+,27231
54,BUMA.1121.00026,1,675281,702558,+,27277
54,BUMA.1121.00010,1,1683902,1711149,-,27247
54,BUMA.1121.00030,1,3380996,3408242,+,27246
54,BUMA.1121.00019,1,3404263,3431494,+,27231
53,BUMA.1121.00022,1,1158483,1234202,+,75719
53,BUMA.1121.00024,1,3305928,3381720,+,75792
53,BUMA.1121.00054,1,349868,425584,+,75716
53,BUMA.1121.00052,1,3063114,3138905,+,75791
53,BUMA.1121.00048,1,1,75733,-,75732
53,BUMA.1121.00050,1,978844,1054656,+,75812
53,BUMA.1121.00015,1,631753,707559,-,75806
53,BUMA.1121.00086,1,2367358,2443061,-,75703
53,BUMA.1121.00085,1,2660060,2735851,+,75791
53,BUMA.1121.00040,1,3388681,3464467,+,75786
53,BUMA.1121.00020,1,3441948,3517748,+,75800
53,BUMA.1121.00044,1,2635650,2711434,+,75784
53,BUMA.1121.00002,1,1736838,1812685,-,75847
53,BUMA.1121.00087,1,892557,968259,+,75702
53,BUMA.1121.00042,1,364669,440386,+,75717
53,BUMA.1121.00046,1,1697049,1772854,-,75805
53,BUMA.1121.00036,1,539947,615716,-,75769
53,BUMA.1121.00038,1,207489,283206,-,75717
53,BUMA.1121.00081,1,207558,283275,-,75717
53,BUMA.1121.00034,1,3407480,3483264,+,75784
53,BUMA.1121.00013,1,3355209,3431033,+,75824
53,BUMA.1121.00032,1,1430638,1506438,+,75800
53,BUMA.1121.00004,1,3457368,3533163,+,75795
53,BUMA.1121.00006,1,207489,283206,-,75717
53,BUMA.1121.00017,1,3305145,3380929,+,75784
53,BUMA.1121.00008,1,3388734,3464534,+,75800
53,BUMA.1121.00028,1,3377128,3452913,+,75785
53,BUMA.1121.00026,1,599498,675279,+,75781
53,BUMA.1121.00010,1,1711150,1786996,-,75846
53,BUMA.1121.00030,1,3305212,3380994,+,75782
53,BUMA.1121.00019,1,3328461,3404261,+,75800
52,BUMA.1121.00022,1,1149433,1156985,+,7552
52,BUMA.1121.00024,1,7163,14715,-,7552
52,BUMA.1121.00054,1,618353,625911,+,7558
52,BUMA.1121.00052,1,3236492,3244044,-,7552
52,BUMA.1121.00048,1,3309877,3317435,-,7558
52,BUMA.1121.00050,1,1127374,1134926,+,7552
52,BUMA.1121.00015,1,551485,559037,-,7552
52,BUMA.1121.00086,1,2444559,2452111,-,7552
52,BUMA.1121.00085,1,2833438,2840990,-,7552
52,BUMA.1121.00040,1,6827,14379,-,7552
52,BUMA.1121.00020,1,7163,14715,-,7552
52,BUMA.1121.00044,1,2809166,2816718,-,7552
52,BUMA.1121.00002,1,445764,453316,-,7552
52,BUMA.1121.00087,1,883507,891059,+,7552
52,BUMA.1121.00042,1,538221,545808,-,7587
52,BUMA.1121.00046,1,1616780,1624332,-,7552
52,BUMA.1121.00036,1,434612,442153,+,7541
52,BUMA.1121.00038,1,7163,14721,-,7558
52,BUMA.1121.00081,1,7232,14790,-,7558
52,BUMA.1121.00034,1,7163,14715,-,7552
52,BUMA.1121.00013,1,1206899,1214451,+,7552
52,BUMA.1121.00032,1,1604148,1611700,-,7552
52,BUMA.1121.00004,1,7163,14715,-,7552
52,BUMA.1121.00006,1,7163,14721,-,7558
52,BUMA.1121.00017,1,7163,14715,-,7552
52,BUMA.1121.00008,1,7163,14715,-,7552
52,BUMA.1121.00028,1,7163,14715,-,7552
52,BUMA.1121.00026,1,774072,781653,-,7581
52,BUMA.1121.00010,1,420440,427992,-,7552
52,BUMA.1121.00030,1,7163,14715,-,7552
52,BUMA.1121.00019,1,7163,14715,-,7552
51,BUMA.1121.00022,1,1146208,1149431,+,3223
51,BUMA.1121.00024,1,14716,17939,-,3223
51,BUMA.1121.00054,1,615128,618351,+,3223
51,BUMA.1121.00052,1,3244045,3247268,-,3223
51,BUMA.1121.00048,1,3317436,3320659,-,3223
51,BUMA.1121.00050,1,1124149,1127372,+,3223
51,BUMA.1121.00015,1,559038,562261,-,3223
51,BUMA.1121.00086,1,2452112,2455335,-,3223
51,BUMA.1121.00085,1,2840991,2844214,-,3223
51,BUMA.1121.00040,1,14380,17603,-,3223
51,BUMA.1121.00020,1,14716,17939,-,3223
51,BUMA.1121.00044,1,2816719,2819942,-,3223
51,BUMA.1121.00002,1,453317,456540,-,3223
51,BUMA.1121.00087,1,880282,883505,+,3223
51,BUMA.1121.00042,1,545809,549043,-,3234
51,BUMA.1121.00046,1,1624333,1627556,-,3223
51,BUMA.1121.00036,1,430136,433375,+,3239
51,BUMA.1121.00038,1,14722,17945,-,3223
51,BUMA.1121.00081,1,14791,18014,-,3223
51,BUMA.1121.00034,1,14716,17939,-,3223
51,BUMA.1121.00013,1,1203674,1206897,+,3223
51,BUMA.1121.00032,1,1611701,1614924,-,3223
51,BUMA.1121.00004,1,14716,17939,-,3223
51,BUMA.1121.00006,1,14722,17945,-,3223
51,BUMA.1121.00017,1,14716,17939,-,3223
51,BUMA.1121.00008,1,14716,17939,-,3223
51,BUMA.1121.00028,1,14716,17939,-,3223
51,BUMA.1121.00026,1,781654,784888,-,3234
51,BUMA.1121.00010,1,427993,431216,-,3223
51,BUMA.1121.00030,1,14716,17939,-,3223
51,BUMA.1121.00019,1,14716,17939,-,3223
50,BUMA.1121.00022,1,1109648,1144132,+,34484
50,BUMA.1121.00024,1,20016,54500,-,34484
50,BUMA.1121.00054,1,578574,613052,+,34478
50,BUMA.1121.00052,1,3249345,3283829,-,34484
50,BUMA.1121.00048,1,3322736,3357214,-,34478
50,BUMA.1121.00050,1,1087586,1122073,+,34487
50,BUMA.1121.00015,1,564338,598825,-,34487
50,BUMA.1121.00086,1,2457412,2491896,-,34484
50,BUMA.1121.00085,1,2846291,2880775,-,34484
50,BUMA.1121.00040,1,19680,54164,-,34484
50,BUMA.1121.00020,1,20016,54500,-,34484
50,BUMA.1121.00044,1,2822019,2856503,-,34484
50,BUMA.1121.00002,1,458617,493101,-,34484
50,BUMA.1121.00087,1,843722,878206,+,34484
50,BUMA.1121.00042,1,550397,584873,-,34476
50,BUMA.1121.00046,1,1629633,1664120,-,34487
50,BUMA.1121.00036,1,393576,428060,+,34484
50,BUMA.1121.00038,1,20022,54500,-,34478
50,BUMA.1121.00081,1,20091,54569,-,34478
50,BUMA.1121.00034,1,20016,54500,-,34484
50,BUMA.1121.00013,1,1167114,1201598,+,34484
50,BUMA.1121.00032,1,1617001,1651485,-,34484
50,BUMA.1121.00004,1,20016,54500,-,34484
50,BUMA.1121.00006,1,20022,54500,-,34478
50,BUMA.1121.00017,1,20016,54500,-,34484
50,BUMA.1121.00008,1,20016,54500,-,34484
50,BUMA.1121.00028,1,20016,54500,-,34484
50,BUMA.1121.00026,1,786242,820685,-,34443
50,BUMA.1121.00010,1,433293,467776,-,34483
50,BUMA.1121.00030,1,20016,54500,-,34484
50,BUMA.1121.00019,1,20016,54500,-,34484
49,BUMA.1121.00022,1,1105514,1109646,+,4132
49,BUMA.1121.00024,1,54501,58618,-,4117
49,BUMA.1121.00054,1,574440,578572,+,4132
49,BUMA.1121.00052,1,3283830,3287963,-,4133
49,BUMA.1121.00048,1,3357215,3361348,-,4133
49,BUMA.1121.00050,1,1083452,1087584,+,4132
49,BUMA.1121.00015,1,598826,602959,-,4133
49,BUMA.1121.00086,1,2491897,2496014,-,4117
49,BUMA.1121.00085,1,2880776,2884909,-,4133
49,BUMA.1121.00040,1,54165,58298,-,4133
49,BUMA.1121.00020,1,54501,58618,-,4117
49,BUMA.1121.00044,1,2856504,2860621,-,4117
49,BUMA.1121.00002,1,493102,497235,-,4133
49,BUMA.1121.00087,1,839603,843720,+,4117
49,BUMA.1121.00042,1,584874,589007,-,4133
49,BUMA.1121.00046,1,1664121,1668254,-,4133
49,BUMA.1121.00036,1,389442,393574,+,4132
49,BUMA.1121.00038,1,54501,58634,-,4133
49,BUMA.1121.00081,1,54570,58703,-,4133
49,BUMA.1121.00034,1,54501,58618,-,4117
49,BUMA.1121.00013,1,1162980,1167112,+,4132
49,BUMA.1121.00032,1,1651486,1655603,-,4117
49,BUMA.1121.00004,1,54501,58618,-,4117
49,BUMA.1121.00006,1,54501,58634,-,4133
49,BUMA.1121.00017,1,54501,58618,-,4117
49,BUMA.1121.00008,1,54501,58618,-,4117
49,BUMA.1121.00028,1,54501,58618,-,4117
49,BUMA.1121.00010,1,467777,471909,-,4132
49,BUMA.1121.00030,1,54501,58618,-,4117
49,BUMA.1121.00019,1,54501,58618,-,4117
48,BUMA.1121.00022,1,1090230,1101258,+,11028
48,BUMA.1121.00024,1,965047,976075,+,11028
48,BUMA.1121.00054,1,781149,792168,+,11019
48,BUMA.1121.00052,1,3293465,3304485,-,11020
48,BUMA.1121.00048,1,3143618,3154638,-,11020
48,BUMA.1121.00050,1,1411207,1422226,+,11019
48,BUMA.1121.00015,1,216555,227575,-,11020
48,BUMA.1121.00086,1,3386339,3397367,+,11028
48,BUMA.1121.00085,1,2890410,2901430,-,11020
48,BUMA.1121.00040,1,313002,324022,-,11020
48,BUMA.1121.00020,1,1029990,1041018,+,11028
48,BUMA.1121.00044,1,230584,241612,+,11028
48,BUMA.1121.00002,1,501496,512534,-,11038
48,BUMA.1121.00087,1,3414856,3425885,-,11029
48,BUMA.1121.00042,1,3034972,3046010,-,11038
48,BUMA.1121.00046,1,1329505,1340525,-,11020
48,BUMA.1121.00036,1,374158,385186,+,11028
48,BUMA.1121.00038,1,3350936,3361956,-,11020
48,BUMA.1121.00081,1,3351121,3362141,-,11020
48,BUMA.1121.00034,1,1002477,1013505,+,11028
48,BUMA.1121.00013,1,1146458,1157477,+,11019
48,BUMA.1121.00032,1,2495562,2506590,+,11028
48,BUMA.1121.00004,1,966244,977272,+,11028
48,BUMA.1121.00006,1,3351013,3362033,-,11020
48,BUMA.1121.00017,1,900096,911124,+,11028
48,BUMA.1121.00008,1,968792,979820,+,11028
48,BUMA.1121.00028,1,965046,976074,+,11028
48,BUMA.1121.00026,1,825722,836760,-,11038
48,BUMA.1121.00010,1,476166,487204,-,11038
48,BUMA.1121.00030,1,900156,911184,+,11028
48,BUMA.1121.00019,1,965090,976118,+,11028
47,BUMA.1121.00022,1,1068622,1090228,+,21606
47,BUMA.1121.00024,1,943428,965045,+,21617
47,BUMA.1121.00054,1,759536,781147,+,21611
47,BUMA.1121.00052,1,3304486,3326081,-,21595
47,BUMA.1121.00048,1,3154639,3176250,-,21611
47,BUMA.1121.00050,1,1389610,1411205,+,21595
47,BUMA.1121.00015,1,227576,249171,-,21595
47,BUMA.1121.00086,1,3364743,3386337,+,21594
47,BUMA.1121.00085,1,2901431,2923026,-,21595
47,BUMA.1121.00040,1,324023,345618,-,21595
47,BUMA.1121.00020,1,1008371,1029988,+,21617
47,BUMA.1121.00044,1,208965,230582,+,21617
47,BUMA.1121.00002,1,512535,534141,-,21606
47,BUMA.1121.00087,1,3425886,3447480,-,21594
47,BUMA.1121.00042,1,3047593,3069214,-,21621
47,BUMA.1121.00046,1,1340526,1362121,-,21595
47,BUMA.1121.00036,1,352550,374156,+,21606
47,BUMA.1121.00038,1,3361957,3383568,-,21611
47,BUMA.1121.00081,1,3362142,3383753,-,21611
47,BUMA.1121.00034,1,980858,1002475,+,21617
47,BUMA.1121.00013,1,1124861,1146456,+,21595
47,BUMA.1121.00032,1,2473943,2495560,+,21617
47,BUMA.1121.00004,1,944625,966242,+,21617
47,BUMA.1121.00006,1,3362034,3383645,-,21611
47,BUMA.1121.00017,1,878477,900094,+,21617
47,BUMA.1121.00008,1,947173,968790,+,21617
47,BUMA.1121.00028,1,943427,965044,+,21617
47,BUMA.1121.00026,1,838342,859963,-,21621
47,BUMA.1121.00010,1,487205,508811,-,21606
47,BUMA.1121.00030,1,878537,900154,+,21617
47,BUMA.1121.00019,1,943471,965088,+,21617
46,BUMA.1121.00022,1,1049791,1066628,+,16837
46,BUMA.1121.00024,1,924585,941434,+,16849
46,BUMA.1121.00054,1,740690,757542,+,16852
46,BUMA.1121.00052,1,3328075,3344907,-,16832
46,BUMA.1121.00048,1,3178244,3195097,-,16853
46,BUMA.1121.00050,1,1370753,1387616,+,16863
46,BUMA.1121.00015,1,251165,268018,-,16853
46,BUMA.1121.00086,1,3345900,3362749,+,16849
46,BUMA.1121.00085,1,2925020,2941852,-,16832
46,BUMA.1121.00040,1,347612,364449,-,16837
46,BUMA.1121.00020,1,989528,1006377,+,16849
46,BUMA.1121.00044,1,190122,206971,+,16849
46,BUMA.1121.00002,1,536135,552984,-,16849
46,BUMA.1121.00087,1,3449474,3466323,-,16849
46,BUMA.1121.00042,1,3071208,3088057,-,16849
46,BUMA.1121.00046,1,1364115,1380979,-,16864
46,BUMA.1121.00036,1,333707,350556,+,16849
46,BUMA.1121.00038,1,3385562,3402415,-,16853
46,BUMA.1121.00081,1,3385747,3402600,-,16853
46,BUMA.1121.00034,1,962015,978864,+,16849
46,BUMA.1121.00013,1,1106035,1122867,+,16832
46,BUMA.1121.00032,1,2455100,2471949,+,16849
46,BUMA.1121.00004,1,925783,942631,+,16848
46,BUMA.1121.00006,1,3385639,3402492,-,16853
46,BUMA.1121.00017,1,859634,876483,+,16849
46,BUMA.1121.00008,1,928330,945179,+,16849
46,BUMA.1121.00028,1,924584,941433,+,16849
46,BUMA.1121.00026,1,861957,878806,-,16849
46,BUMA.1121.00010,1,510805,527654,-,16849
46,BUMA.1121.00030,1,859694,876543,+,16849
46,BUMA.1121.00019,1,924628,941477,+,16849
45,BUMA.1121.00022,1,1039653,1049790,+,10137
45,BUMA.1121.00024,1,914447,924584,+,10137
45,BUMA.1121.00054,1,728973,739107,+,10134
45,BUMA.1121.00052,1,3344909,3355046,-,10137
45,BUMA.1121.00048,1,3196679,3206814,-,10135
45,BUMA.1121.00050,1,1359036,1369170,+,10134
45,BUMA.1121.00015,1,269600,279735,-,10135
45,BUMA.1121.00086,1,3335762,3345899,+,10137
45,BUMA.1121.00085,1,2941854,2951991,-,10137
45,BUMA.1121.00040,1,364451,374588,-,10137
45,BUMA.1121.00020,1,979390,989527,+,10137
45,BUMA.1121.00044,1,179984,190121,+,10137
45,BUMA.1121.00002,1,552986,563118,-,10132
45,BUMA.1121.00087,1,3466325,3476186,-,9861
45,BUMA.1121.00042,1,3088059,3098196,-,10137
45,BUMA.1121.00046,1,1382561,1392696,-,10135
45,BUMA.1121.00036,1,323569,333706,+,10137
45,BUMA.1121.00038,1,3403997,3414132,-,10135
45,BUMA.1121.00081,1,3404182,3414317,-,10135
45,BUMA.1121.00034,1,951877,962014,+,10137
45,BUMA.1121.00013,1,1095897,1106034,+,10137
45,BUMA.1121.00032,1,2444962,2455099,+,10137
45,BUMA.1121.00004,1,915645,925782,+,10137
45,BUMA.1121.00006,1,3404074,3414209,-,10135
45,BUMA.1121.00017,1,849496,859633,+,10137
45,BUMA.1121.00008,1,918192,928329,+,10137
45,BUMA.1121.00028,1,914446,924583,+,10137
45,BUMA.1121.00026,1,878808,888945,-,10137
45,BUMA.1121.00010,1,527656,537788,-,10132
45,BUMA.1121.00030,1,849556,859693,+,10137
45,BUMA.1121.00019,1,914490,924627,+,10137
44,BUMA.1121.00022,1,1034535,1039651,+,5116
44,BUMA.1121.00024,1,909329,914445,+,5116
44,BUMA.1121.00054,1,723855,728971,+,5116
44,BUMA.1121.00052,1,3355047,3360163,-,5116
44,BUMA.1121.00048,1,3206815,3211931,-,5116
44,BUMA.1121.00050,1,1353918,1359034,+,5116
44,BUMA.1121.00015,1,279736,284852,-,5116
44,BUMA.1121.00086,1,3330644,3335760,+,5116
44,BUMA.1121.00085,1,2951992,2957108,-,5116
44,BUMA.1121.00040,1,374589,379705,-,5116
44,BUMA.1121.00020,1,974272,979388,+,5116
44,BUMA.1121.00044,1,174866,179982,+,5116
44,BUMA.1121.00002,1,563119,568235,-,5116
44,BUMA.1121.00087,1,209,5340,-,5131
44,BUMA.1121.00042,1,3098197,3103313,-,5116
44,BUMA.1121.00046,1,1392697,1397813,-,5116
44,BUMA.1121.00036,1,318451,323567,+,5116
44,BUMA.1121.00038,1,3414133,3419249,-,5116
44,BUMA.1121.00081,1,3414318,3419434,-,5116
44,BUMA.1121.00034,1,946759,951875,+,5116
44,BUMA.1121.00013,1,1090779,1095895,+,5116
44,BUMA.1121.00032,1,2439844,2444960,+,5116
44,BUMA.1121.00004,1,910527,915643,+,5116
44,BUMA.1121.00006,1,3414210,3419326,-,5116
44,BUMA.1121.00017,1,844378,849494,+,5116
44,BUMA.1121.00008,1,913074,918190,+,5116
44,BUMA.1121.00028,1,909328,914444,+,5116
44,BUMA.1121.00026,1,888946,894062,-,5116
44,BUMA.1121.00010,1,537789,542905,-,5116
44,BUMA.1121.00030,1,844438,849554,+,5116
44,BUMA.1121.00019,1,909372,914488,+,5116
43,BUMA.1121.00022,1,1015116,1034529,+,19413
43,BUMA.1121.00024,1,889910,909323,+,19413
43,BUMA.1121.00054,1,704448,723849,+,19401
43,BUMA.1121.00052,1,3361766,3381162,-,19396
43,BUMA.1121.00048,1,3211938,3231339,-,19401
43,BUMA.1121.00050,1,1334520,1353912,+,19392
43,BUMA.1121.00015,1,284859,304251,-,19392
43,BUMA.1121.00086,1,3311225,3330638,+,19413
43,BUMA.1121.00085,1,2958711,2978107,-,19396
43,BUMA.1121.00040,1,381305,400708,-,19403
43,BUMA.1121.00020,1,954853,974266,+,19413
43,BUMA.1121.00044,1,155447,174860,+,19413
43,BUMA.1121.00002,1,568242,587655,-,19413
43,BUMA.1121.00087,1,5347,24760,-,19413
43,BUMA.1121.00042,1,3103320,3122741,-,19421
43,BUMA.1121.00046,1,1397820,1417212,-,19392
43,BUMA.1121.00036,1,299032,318445,+,19413
43,BUMA.1121.00038,1,3419256,3438657,-,19401
43,BUMA.1121.00081,1,3419441,3438842,-,19401
43,BUMA.1121.00034,1,927340,946753,+,19413
43,BUMA.1121.00013,1,1071372,1090773,+,19401
43,BUMA.1121.00032,1,2420425,2439838,+,19413
43,BUMA.1121.00004,1,891108,910521,+,19413
43,BUMA.1121.00006,1,3419333,3438734,-,19401
43,BUMA.1121.00017,1,824959,844372,+,19413
43,BUMA.1121.00008,1,893655,913068,+,19413
43,BUMA.1121.00028,1,889909,909322,+,19413
43,BUMA.1121.00026,1,894069,913490,-,19421
43,BUMA.1121.00010,1,542912,562325,-,19413
43,BUMA.1121.00030,1,825019,844432,+,19413
43,BUMA.1121.00019,1,889953,909366,+,19413
42,BUMA.1121.00022,1,995151,1014976,+,19825
42,BUMA.1121.00024,1,869945,889770,+,19825
42,BUMA.1121.00054,1,684485,704308,+,19823
42,BUMA.1121.00052,1,3381302,3401133,-,19831
42,BUMA.1121.00048,1,3231479,3251302,-,19823
42,BUMA.1121.00050,1,1314555,1334380,+,19825
42,BUMA.1121.00015,1,304391,324216,-,19825
42,BUMA.1121.00086,1,3291260,3311085,+,19825
42,BUMA.1121.00085,1,2978247,2998078,-,19831
42,BUMA.1121.00040,1,402104,421929,-,19825
42,BUMA.1121.00020,1,934888,954713,+,19825
42,BUMA.1121.00044,1,135482,155307,+,19825
42,BUMA.1121.00002,1,587795,607626,-,19831
42,BUMA.1121.00087,1,24900,44725,-,19825
42,BUMA.1121.00042,1,3122881,3142693,-,19812
42,BUMA.1121.00046,1,1417352,1437177,-,19825
42,BUMA.1121.00036,1,279067,298892,+,19825
42,BUMA.1121.00038,1,3438797,3458620,-,19823
42,BUMA.1121.00081,1,3438982,3458805,-,19823
42,BUMA.1121.00034,1,907375,927200,+,19825
42,BUMA.1121.00013,1,1051401,1071232,+,19831
42,BUMA.1121.00032,1,2400460,2420285,+,19825
42,BUMA.1121.00004,1,869903,889712,+,19809
42,BUMA.1121.00006,1,3438874,3458697,-,19823
42,BUMA.1121.00017,1,804994,824819,+,19825
42,BUMA.1121.00008,1,873690,893515,+,19825
42,BUMA.1121.00028,1,869944,889769,+,19825
42,BUMA.1121.00026,1,913630,933442,-,19812
42,BUMA.1121.00010,1,562465,582296,-,19831
42,BUMA.1121.00030,1,805054,824879,+,19825
42,BUMA.1121.00019,1,869988,889813,+,19825
41,BUMA.1121.00022,1,987802,993924,+,6122
41,BUMA.1121.00024,1,862596,868734,+,6138
41,BUMA.1121.00054,1,677151,683274,+,6123
41,BUMA.1121.00052,1,3402344,3408466,-,6122
41,BUMA.1121.00048,1,3252513,3258635,-,6122
41,BUMA.1121.00050,1,1136139,1142277,-,6138
41,BUMA.1121.00015,1,3359536,3365659,+,6123
41,BUMA.1121.00086,1,2615893,2622016,-,6123
41,BUMA.1121.00085,1,2999289,3005411,-,6122
41,BUMA.1121.00040,1,423140,429278,-,6138
41,BUMA.1121.00020,1,927539,933677,+,6138
41,BUMA.1121.00044,1,128133,134271,+,6138
41,BUMA.1121.00002,1,608837,614975,-,6138
41,BUMA.1121.00087,1,713602,719724,+,6122
41,BUMA.1121.00042,1,3143904,3150053,-,6149
41,BUMA.1121.00046,1,1609444,1615567,+,6123
41,BUMA.1121.00036,1,271718,277840,+,6122
41,BUMA.1121.00038,1,3459831,3465953,-,6122
41,BUMA.1121.00081,1,3460016,3466138,-,6122
41,BUMA.1121.00034,1,900026,906164,+,6138
41,BUMA.1121.00013,1,1044067,1050190,+,6123
41,BUMA.1121.00032,1,2393111,2399249,+,6138
41,BUMA.1121.00004,1,862554,868692,+,6138
41,BUMA.1121.00006,1,3459908,3466030,-,6122
41,BUMA.1121.00017,1,797645,803783,+,6138
41,BUMA.1121.00008,1,866341,872479,+,6138
41,BUMA.1121.00028,1,862595,868733,+,6138
41,BUMA.1121.00026,1,934668,940802,-,6134
41,BUMA.1121.00010,1,583507,589645,-,6138
41,BUMA.1121.00030,1,797705,803843,+,6138
41,BUMA.1121.00019,1,862639,868777,+,6138
40,BUMA.1121.00022,1,950759,986255,+,35496
40,BUMA.1121.00024,1,1155669,1191136,+,35467
40,BUMA.1121.00054,1,640090,675572,+,35482
40,BUMA.1121.00052,1,3410046,3445567,-,35521
40,BUMA.1121.00048,1,3260215,3295697,-,35482
40,BUMA.1121.00050,1,1143825,1179322,-,35497
40,BUMA.1121.00015,1,3322474,3357956,+,35482
40,BUMA.1121.00086,1,2195516,2230996,-,35480
40,BUMA.1121.00085,1,3006991,3042512,-,35521
40,BUMA.1121.00040,1,430827,465979,-,35152
40,BUMA.1121.00020,1,1220602,1256069,+,35467
40,BUMA.1121.00044,1,421155,456622,+,35467
40,BUMA.1121.00002,1,616539,652004,-,35465
40,BUMA.1121.00087,1,1086092,1121572,+,35480
40,BUMA.1121.00042,1,3183108,3218617,+,35509
40,BUMA.1121.00046,1,1572421,1607864,+,35443
40,BUMA.1121.00036,1,234671,270167,+,35496
40,BUMA.1121.00038,1,3467533,3503015,-,35482
40,BUMA.1121.00081,1,3467718,3503200,-,35482
40,BUMA.1121.00034,1,1193057,1228524,+,35467
40,BUMA.1121.00013,1,1006966,1042487,+,35521
40,BUMA.1121.00032,1,2686039,2721506,+,35467
40,BUMA.1121.00004,1,1156885,1192352,+,35467
40,BUMA.1121.00006,1,3467610,3503092,-,35482
40,BUMA.1121.00017,1,1090694,1126161,+,35467
40,BUMA.1121.00008,1,1159384,1194850,+,35466
40,BUMA.1121.00028,1,1155713,1191180,+,35467
40,BUMA.1121.00026,1,942366,977886,-,35520
40,BUMA.1121.00010,1,591210,626675,-,35465
40,BUMA.1121.00030,1,1090735,1126201,+,35466
40,BUMA.1121.00019,1,1155725,1191192,+,35467
39,BUMA.1121.00022,1,919258,949250,+,29992
39,BUMA.1121.00024,1,1124167,1154160,+,29993
39,BUMA.1121.00054,1,509384,539348,-,29964
39,BUMA.1121.00052,1,3447077,3477063,-,29986
39,BUMA.1121.00048,1,3396423,3426404,+,29981
39,BUMA.1121.00050,1,1180832,1210803,-,29971
39,BUMA.1121.00015,1,3290993,3320965,+,29972
39,BUMA.1121.00086,1,2232506,2262489,-,29983
39,BUMA.1121.00085,1,3044022,3074008,-,29986
39,BUMA.1121.00040,1,467489,497457,-,29968
39,BUMA.1121.00020,1,1189100,1219093,+,29993
39,BUMA.1121.00044,1,389653,419646,+,29993
39,BUMA.1121.00002,1,653514,683507,-,29993
39,BUMA.1121.00087,1,1054600,1084583,+,29983
39,BUMA.1121.00042,1,3151598,3181599,+,30001
39,BUMA.1121.00046,1,1540940,1570896,+,29956
39,BUMA.1121.00036,1,203170,233162,+,29992
39,BUMA.1121.00038,1,93725,123690,+,29965
39,BUMA.1121.00081,1,93794,123759,+,29965
39,BUMA.1121.00034,1,1161555,1191548,+,29993
39,BUMA.1121.00013,1,975471,1005457,+,29986
39,BUMA.1121.00032,1,2654537,2684530,+,29993
39,BUMA.1121.00004,1,1125383,1155376,+,29993
39,BUMA.1121.00006,1,93725,123690,+,29965
39,BUMA.1121.00017,1,1059192,1089185,+,29993
39,BUMA.1121.00008,1,1127882,1157875,+,29993
39,BUMA.1121.00028,1,1124211,1154204,+,29993
39,BUMA.1121.00026,1,979396,1009381,-,29985
39,BUMA.1121.00010,1,628185,658178,-,29993
39,BUMA.1121.00030,1,1059233,1089226,+,29993
39,BUMA.1121.00019,1,1124223,1154216,+,29993
38,BUMA.1121.00022,1,900556,910541,+,9985
38,BUMA.1121.00024,1,1105152,1115449,+,10297
38,BUMA.1121.00054,1,1454476,1464982,+,10506
38,BUMA.1121.00052,1,405446,415460,+,10014
38,BUMA.1121.00052,1,3485780,3495794,-,10014
38,BUMA.1121.00048,1,2470721,2481314,-,10593
38,BUMA.1121.00050,1,2008960,2019398,+,10438
38,BUMA.1121.00015,1,3209581,3220027,-,10446
38,BUMA.1121.00086,1,3472940,3482909,+,9969
38,BUMA.1121.00085,1,1767,11781,+,10014
38,BUMA.1121.00085,1,3082725,3092739,-,10014
38,BUMA.1121.00040,1,842556,852538,+,9982
38,BUMA.1121.00020,1,1170109,1180382,+,10273
38,BUMA.1121.00044,1,370710,380935,+,10225
38,BUMA.1121.00002,1,1464243,1474346,-,10103
38,BUMA.1121.00087,1,3329338,3339307,-,9969
38,BUMA.1121.00042,1,3370539,3380537,-,9998
38,BUMA.1121.00046,1,732486,742884,-,10398
38,BUMA.1121.00036,1,184484,194453,+,9969
38,BUMA.1121.00038,1,2678128,2688614,-,10486
38,BUMA.1121.00081,1,2678263,2688813,-,10550
38,BUMA.1121.00034,1,1142596,1152837,+,10241
38,BUMA.1121.00013,1,956739,966753,+,10014
38,BUMA.1121.00032,1,2635555,2645820,+,10265
38,BUMA.1121.00004,1,1106432,1116665,+,10233
38,BUMA.1121.00006,1,2678073,2688698,-,10625
38,BUMA.1121.00017,1,1040236,1050474,+,10238
38,BUMA.1121.00008,1,1108867,1119164,+,10297
38,BUMA.1121.00028,1,1105172,1115493,+,10321
38,BUMA.1121.00026,1,1613301,1623283,+,9982
38,BUMA.1121.00010,1,1437910,1448083,-,10173
38,BUMA.1121.00030,1,1040268,1050517,+,10249
38,BUMA.1121.00019,1,1105216,1115505,+,10289
37,BUMA.1121.00022,1,883289,897161,+,13872
37,BUMA.1121.00024,1,1087874,1101760,+,13886
37,BUMA.1121.00054,1,1438822,1452680,+,13858
37,BUMA.1121.00052,1,743,14629,-,13886
37,BUMA.1121.00052,1,389754,403650,+,13896
37,BUMA.1121.00048,1,2483111,2496968,-,13857
37,BUMA.1121.00050,1,1993285,2007164,+,13879
37,BUMA.1121.00015,1,3221824,3235737,-,13913
37,BUMA.1121.00086,1,3455684,3469542,+,13858
37,BUMA.1121.00085,1,3094536,3108435,-,13899
37,BUMA.1121.00085,1,3483550,3497450,+,13900
37,BUMA.1121.00040,1,826902,840760,+,13858
37,BUMA.1121.00020,1,1152845,1166717,+,13872
37,BUMA.1121.00044,1,353425,367318,+,13893
37,BUMA.1121.00002,1,1440253,1454132,+,13879
37,BUMA.1121.00087,1,3342706,3356563,-,13857
37,BUMA.1121.00042,1,3382334,3396205,-,13871
37,BUMA.1121.00046,1,744681,758559,-,13878
37,BUMA.1121.00036,1,167156,181091,+,13935
37,BUMA.1121.00038,1,2690411,2704268,-,13857
37,BUMA.1121.00081,1,2690610,2704467,-,13857
37,BUMA.1121.00034,1,1125311,1139204,+,13893
37,BUMA.1121.00013,1,941113,954943,+,13830
37,BUMA.1121.00032,1,2618298,2632163,+,13865
37,BUMA.1121.00004,1,1089147,1103040,+,13893
37,BUMA.1121.00006,1,2690495,2704352,-,13857
37,BUMA.1121.00017,1,1022951,1036844,+,13893
37,BUMA.1121.00008,1,1091603,1105475,+,13872
37,BUMA.1121.00028,1,1087908,1101780,+,13872
37,BUMA.1121.00026,1,1597591,1611505,+,13914
37,BUMA.1121.00010,1,1413422,1427278,+,13856
37,BUMA.1121.00030,1,1022983,1036876,+,13893
37,BUMA.1121.00019,1,1087952,1101824,+,13872
36,BUMA.1121.00022,1,857038,880865,+,23827
36,BUMA.1121.00024,1,1061623,1085450,+,23827
36,BUMA.1121.00054,1,1412920,1436747,+,23827
36,BUMA.1121.00052,1,17054,40880,-,23826
36,BUMA.1121.00048,1,2499044,2522870,-,23826
36,BUMA.1121.00050,1,1967383,1991210,+,23827
36,BUMA.1121.00015,1,3237813,3261639,-,23826
36,BUMA.1121.00086,1,3429433,3453260,+,23827
36,BUMA.1121.00085,1,3110860,3134686,-,23826
36,BUMA.1121.00040,1,800651,824478,+,23827
36,BUMA.1121.00020,1,1126594,1150421,+,23827
36,BUMA.1121.00044,1,327174,351001,+,23827
36,BUMA.1121.00002,1,1414003,1437830,+,23827
36,BUMA.1121.00087,1,3358988,3382814,-,23826
36,BUMA.1121.00042,1,3398630,3422456,-,23826
36,BUMA.1121.00046,1,760635,784461,-,23826
36,BUMA.1121.00036,1,140905,164732,+,23827
36,BUMA.1121.00038,1,2706344,2730170,-,23826
36,BUMA.1121.00081,1,2706543,2730369,-,23826
36,BUMA.1121.00034,1,1099060,1122887,+,23827
36,BUMA.1121.00013,1,914862,938689,+,23827
36,BUMA.1121.00032,1,2592047,2615874,+,23827
36,BUMA.1121.00004,1,1062896,1086723,+,23827
36,BUMA.1121.00006,1,2706428,2730254,-,23826
36,BUMA.1121.00017,1,996700,1020527,+,23827
36,BUMA.1121.00008,1,1065352,1089179,+,23827
36,BUMA.1121.00028,1,1061657,1085484,+,23827
36,BUMA.1121.00026,1,1571340,1595167,+,23827
36,BUMA.1121.00010,1,1387174,1411001,+,23827
36,BUMA.1121.00030,1,996732,1020559,+,23827
36,BUMA.1121.00019,1,1061701,1085528,+,23827
35,BUMA.1121.00022,1,836628,853746,+,17118
35,BUMA.1121.00024,1,1041213,1058331,+,17118
35,BUMA.1121.00054,1,1392510,1409628,+,17118
35,BUMA.1121.00052,1,44172,61290,-,17118
35,BUMA.1121.00048,1,2526162,2543280,-,17118
35,BUMA.1121.00050,1,1946973,1964091,+,17118
35,BUMA.1121.00015,1,3264931,3282049,-,17118
35,BUMA.1121.00086,1,3409023,3426141,+,17118
35,BUMA.1121.00085,1,3137978,3155096,-,17118
35,BUMA.1121.00040,1,780241,797359,+,17118
35,BUMA.1121.00020,1,1106184,1123302,+,17118
35,BUMA.1121.00044,1,306764,323882,+,17118
35,BUMA.1121.00002,1,1393595,1410711,+,17116
35,BUMA.1121.00087,1,3386106,3403224,-,17118
35,BUMA.1121.00042,1,3425748,3442866,-,17118
35,BUMA.1121.00046,1,787753,804871,-,17118
35,BUMA.1121.00036,1,120495,137613,+,17118
35,BUMA.1121.00038,1,2733462,2750580,-,17118
35,BUMA.1121.00081,1,2733661,2750779,-,17118
35,BUMA.1121.00034,1,1078650,1095768,+,17118
35,BUMA.1121.00013,1,894452,911570,+,17118
35,BUMA.1121.00032,1,2571637,2588755,+,17118
35,BUMA.1121.00004,1,1042486,1059604,+,17118
35,BUMA.1121.00006,1,2733546,2750664,-,17118
35,BUMA.1121.00017,1,976290,993408,+,17118
35,BUMA.1121.00008,1,1044942,1062060,+,17118
35,BUMA.1121.00028,1,1041247,1058365,+,17118
35,BUMA.1121.00026,1,1550930,1568048,+,17118
35,BUMA.1121.00010,1,1366764,1383882,+,17118
35,BUMA.1121.00030,1,976322,993440,+,17118
35,BUMA.1121.00019,1,1041291,1058409,+,17118
34,BUMA.1121.00022,1,820811,827692,+,6881
34,BUMA.1121.00024,1,613652,620532,+,6880
34,BUMA.1121.00054,1,1263386,1270266,-,6880
34,BUMA.1121.00052,1,378920,385803,+,6883
34,BUMA.1121.00048,1,2665531,2672411,+,6880
34,BUMA.1121.00050,1,1817941,1824821,-,6880
34,BUMA.1121.00015,1,327533,334413,-,6880
34,BUMA.1121.00086,1,2623576,2630458,-,6882
34,BUMA.1121.00085,1,3472716,3479599,+,6883
34,BUMA.1121.00040,1,186015,192894,+,6879
34,BUMA.1121.00020,1,613667,620547,+,6880
34,BUMA.1121.00044,1,3415661,3422541,+,6880
34,BUMA.1121.00002,1,1254099,1260979,-,6880
34,BUMA.1121.00087,1,705159,712042,+,6883
34,BUMA.1121.00042,1,3451813,3458696,-,6883
34,BUMA.1121.00046,1,927030,933913,+,6883
34,BUMA.1121.00036,1,104678,111558,+,6880
34,BUMA.1121.00038,1,2872831,2879711,+,6880
34,BUMA.1121.00081,1,2873030,2879910,+,6880
34,BUMA.1121.00034,1,613655,620535,+,6880
34,BUMA.1121.00034,1,715972,722852,+,6880
34,BUMA.1121.00013,1,569986,576868,-,6882
34,BUMA.1121.00032,1,2042053,2048933,-,6880
34,BUMA.1121.00004,1,613653,620533,+,6880
34,BUMA.1121.00006,1,2872915,2879795,+,6880
34,BUMA.1121.00017,1,613659,620539,+,6880
34,BUMA.1121.00008,1,613674,620554,+,6880
34,BUMA.1121.00028,1,613661,620541,+,6880
34,BUMA.1121.00026,1,1426929,1433813,+,6884
34,BUMA.1121.00010,1,1227414,1234294,-,6880
34,BUMA.1121.00030,1,613659,620539,+,6880
34,BUMA.1121.00019,1,613673,620553,+,6880
33,BUMA.1121.00022,1,802778,820810,+,18032
33,BUMA.1121.00024,1,595633,613651,+,18018
33,BUMA.1121.00054,1,1270268,1288456,-,18188
33,BUMA.1121.00052,1,360873,378919,+,18046
33,BUMA.1121.00048,1,2647335,2665530,+,18195
33,BUMA.1121.00050,1,1824823,1842941,-,18118
33,BUMA.1121.00015,1,334415,352554,-,18139
33,BUMA.1121.00086,1,2630460,2648485,-,18025
33,BUMA.1121.00085,1,3454669,3472715,+,18046
33,BUMA.1121.00040,1,167936,186014,+,18078
33,BUMA.1121.00020,1,595648,613666,+,18018
33,BUMA.1121.00044,1,3397642,3415660,+,18018
33,BUMA.1121.00044,1,3499975,3517959,+,17984
33,BUMA.1121.00002,1,1260981,1279190,-,18209
33,BUMA.1121.00087,1,687244,705158,+,17914
33,BUMA.1121.00042,1,3458698,3476706,-,18008
33,BUMA.1121.00046,1,908911,927029,+,18118
33,BUMA.1121.00036,1,86638,104677,+,18039
33,BUMA.1121.00038,1,2854635,2872830,+,18195
33,BUMA.1121.00081,1,2854834,2873029,+,18195
33,BUMA.1121.00034,1,595641,613654,+,18013
33,BUMA.1121.00034,1,697961,715971,+,18010
33,BUMA.1121.00013,1,576870,594909,-,18039
33,BUMA.1121.00032,1,2048935,2066953,-,18018
33,BUMA.1121.00004,1,595634,613652,+,18018
33,BUMA.1121.00006,1,2854719,2872914,+,18195
33,BUMA.1121.00017,1,595640,613658,+,18018
33,BUMA.1121.00008,1,595655,613673,+,18018
33,BUMA.1121.00028,1,595642,613660,+,18018
33,BUMA.1121.00026,1,1408899,1426928,+,18029
33,BUMA.1121.00010,1,1234296,1252365,-,18069
33,BUMA.1121.00030,1,595640,613658,+,18018
33,BUMA.1121.00019,1,595654,613672,+,18018
32,BUMA.1121.00022,1,778481,801096,+,22615
32,BUMA.1121.00024,1,547461,570085,-,22624
32,BUMA.1121.00054,1,1356876,1379510,-,22634
32,BUMA.1121.00052,1,129153,151777,-,22624
32,BUMA.1121.00048,1,2556280,2578915,+,22635
32,BUMA.1121.00050,1,1854310,1876940,+,22630
32,BUMA.1121.00015,1,363923,386553,+,22630
32,BUMA.1121.00086,1,2650166,2672781,-,22615
32,BUMA.1121.00085,1,3222959,3245583,-,22624
32,BUMA.1121.00040,1,120999,143623,-,22624
32,BUMA.1121.00020,1,547476,570100,-,22624
32,BUMA.1121.00044,1,3349470,3372094,-,22624
32,BUMA.1121.00002,1,1303528,1326143,+,22615
32,BUMA.1121.00087,1,662947,685562,+,22615
32,BUMA.1121.00042,1,3478387,3501019,-,22632
32,BUMA.1121.00046,1,874912,897541,-,22629
32,BUMA.1121.00036,1,62341,84956,+,22615
32,BUMA.1121.00038,1,2763580,2786215,+,22635
32,BUMA.1121.00081,1,2763779,2786414,+,22635
32,BUMA.1121.00034,1,547469,570093,-,22624
32,BUMA.1121.00013,1,803986,826611,+,22625
32,BUMA.1121.00032,1,2092500,2115125,+,22625
32,BUMA.1121.00004,1,547462,570086,-,22624
32,BUMA.1121.00006,1,2763664,2786299,+,22635
32,BUMA.1121.00017,1,547468,570092,-,22624
32,BUMA.1121.00008,1,547483,570107,-,22624
32,BUMA.1121.00028,1,547470,570094,-,22624
32,BUMA.1121.00026,1,1384601,1407218,+,22617
32,BUMA.1121.00010,1,1276703,1299318,+,22615
32,BUMA.1121.00030,1,547468,570092,-,22624
32,BUMA.1121.00019,1,547482,570106,-,22624
31,BUMA.1121.00022,1,769176,778480,+,9304
31,BUMA.1121.00024,1,570087,579391,-,9304
31,BUMA.1121.00054,1,1379512,1388816,-,9304
31,BUMA.1121.00052,1,151779,161083,-,9304
31,BUMA.1121.00048,1,2546975,2556279,+,9304
31,BUMA.1121.00050,1,1845005,1854309,+,9304
31,BUMA.1121.00015,1,354618,363922,+,9304
31,BUMA.1121.00086,1,2672783,2682087,-,9304
31,BUMA.1121.00085,1,3245585,3254889,-,9304
31,BUMA.1121.00040,1,143625,152929,-,9304
31,BUMA.1121.00020,1,570102,579406,-,9304
31,BUMA.1121.00044,1,3372096,3381400,-,9304
31,BUMA.1121.00002,1,1294223,1303527,+,9304
31,BUMA.1121.00087,1,653642,662946,+,9304
31,BUMA.1121.00042,1,1,9261,-,9260
31,BUMA.1121.00046,1,897543,906847,-,9304
31,BUMA.1121.00036,1,53036,62340,+,9304
31,BUMA.1121.00038,1,2754275,2763579,+,9304
31,BUMA.1121.00081,1,2754474,2763778,+,9304
31,BUMA.1121.00034,1,570095,579399,-,9304
31,BUMA.1121.00013,1,794681,803985,+,9304
31,BUMA.1121.00032,1,2083195,2092499,+,9304
31,BUMA.1121.00004,1,570088,579392,-,9304
31,BUMA.1121.00006,1,2754359,2763663,+,9304
31,BUMA.1121.00017,1,570094,579398,-,9304
31,BUMA.1121.00008,1,570109,579413,-,9304
31,BUMA.1121.00028,1,570096,579400,-,9304
31,BUMA.1121.00026,1,1375296,1384600,+,9304
31,BUMA.1121.00010,1,1267398,1276702,+,9304
31,BUMA.1121.00030,1,570094,579398,-,9304
31,BUMA.1121.00019,1,570108,579412,-,9304
30,BUMA.1121.00022,1,755856,768790,+,12934
30,BUMA.1121.00024,1,581016,593950,-,12934
30,BUMA.1121.00052,1,346253,359196,-,12943
30,BUMA.1121.00086,1,2682472,2695406,-,12934
30,BUMA.1121.00085,1,3440049,3452992,-,12943
30,BUMA.1121.00040,1,153314,166254,-,12940
30,BUMA.1121.00020,1,581031,593965,-,12934
30,BUMA.1121.00044,1,3383025,3395959,-,12934
30,BUMA.1121.00002,1,1280867,1293837,+,12970
30,BUMA.1121.00087,1,640322,653256,+,12934
30,BUMA.1121.00042,1,9646,22582,-,12936
30,BUMA.1121.00036,1,39711,52650,+,12939
30,BUMA.1121.00034,1,581024,593958,-,12934
30,BUMA.1121.00013,1,596586,609529,+,12943
30,BUMA.1121.00032,1,2068635,2081569,+,12934
30,BUMA.1121.00004,1,581017,593951,-,12934
30,BUMA.1121.00017,1,581023,593957,-,12934
30,BUMA.1121.00008,1,581038,593972,-,12934
30,BUMA.1121.00028,1,581025,593959,-,12934
30,BUMA.1121.00026,1,1361981,1374910,+,12929
30,BUMA.1121.00010,1,1254047,1267012,+,12965
30,BUMA.1121.00030,1,581023,593957,-,12934
30,BUMA.1121.00019,1,581037,593971,-,12934
13,BUMA.1121.00022,1,314970,346214,+,31244
13,BUMA.1121.00024,1,406900,438159,-,31259
13,BUMA.1121.00054,1,1183888,1215148,-,31260
13,BUMA.1121.00052,1,281724,312983,+,31259
13,BUMA.1121.00048,1,2720651,2751910,+,31259
13,BUMA.1121.00050,1,1738439,1769699,-,31260
13,BUMA.1121.00015,1,3411787,3443046,+,31259
13,BUMA.1121.00086,1,3071575,3102817,-,31242
13,BUMA.1121.00085,1,3375530,3406779,+,31249
13,BUMA.1121.00040,1,904052,935312,-,31260
13,BUMA.1121.00020,1,406915,438174,-,31259
13,BUMA.1121.00044,1,3208909,3240168,-,31259
13,BUMA.1121.00002,1,959152,990430,+,31278
13,BUMA.1121.00087,1,233143,264385,+,31242
13,BUMA.1121.00042,1,898127,929372,-,31245
13,BUMA.1121.00046,1,982000,1013259,+,31259
13,BUMA.1121.00036,1,3357348,3388592,-,31244
13,BUMA.1121.00038,1,2927950,2959209,+,31259
13,BUMA.1121.00081,1,2928149,2959408,+,31259
13,BUMA.1121.00034,1,406908,438167,-,31259
13,BUMA.1121.00013,1,642798,674058,-,31260
13,BUMA.1121.00032,1,2002314,2033589,-,31275
13,BUMA.1121.00004,1,406901,438160,-,31259
13,BUMA.1121.00006,1,2928034,2959293,+,31259
13,BUMA.1121.00017,1,406907,438166,-,31259
13,BUMA.1121.00008,1,406922,438181,-,31259
13,BUMA.1121.00028,1,406909,438168,-,31259
13,BUMA.1121.00026,1,1209339,1240584,-,31245
13,BUMA.1121.00010,1,932478,963757,+,31279
13,BUMA.1121.00030,1,406907,438166,-,31259
13,BUMA.1121.00019,1,406921,438180,-,31259
12,BUMA.1121.00022,1,276995,313728,+,36733
12,BUMA.1121.00024,1,439401,476110,-,36709
12,BUMA.1121.00054,1,1216360,1253098,-,36738
12,BUMA.1121.00052,1,426005,462728,+,36723
12,BUMA.1121.00048,1,2682700,2719438,+,36738
12,BUMA.1121.00050,1,1770911,1807655,-,36744
12,BUMA.1121.00015,1,3373852,3410575,+,36723
12,BUMA.1121.00086,1,3104059,3140787,-,36728
12,BUMA.1121.00085,1,22833,59556,+,36723
12,BUMA.1121.00040,1,203183,239892,+,36709
12,BUMA.1121.00020,1,439416,476125,-,36709
12,BUMA.1121.00044,1,3241410,3278119,-,36709
12,BUMA.1121.00002,1,921143,957938,+,36795
12,BUMA.1121.00087,1,195174,231901,+,36727
12,BUMA.1121.00042,1,195739,232498,-,36759
12,BUMA.1121.00046,1,944044,980788,+,36744
12,BUMA.1121.00036,1,3389834,3426569,-,36735
12,BUMA.1121.00038,1,2890000,2926738,+,36738
12,BUMA.1121.00081,1,2890199,2926937,+,36738
12,BUMA.1121.00034,1,439409,476118,-,36709
12,BUMA.1121.00013,1,523541,560265,-,36724
12,BUMA.1121.00032,1,2186475,2223199,+,36724
12,BUMA.1121.00004,1,439402,476111,-,36709
12,BUMA.1121.00006,1,2890084,2926822,+,36738
12,BUMA.1121.00017,1,439408,476117,-,36709
12,BUMA.1121.00008,1,439423,476132,-,36709
12,BUMA.1121.00028,1,439410,476119,-,36709
12,BUMA.1121.00026,1,1505211,1541980,-,36769
12,BUMA.1121.00010,1,894496,931266,+,36770
12,BUMA.1121.00030,1,439408,476117,-,36709
12,BUMA.1121.00019,1,439422,476131,-,36709
11,BUMA.1121.00022,1,270012,275227,+,5215
11,BUMA.1121.00024,1,477864,483064,-,5200
11,BUMA.1121.00054,1,1254835,1260065,-,5230
11,BUMA.1121.00052,1,419543,424267,+,4724
11,BUMA.1121.00048,1,2675732,2680962,+,5230
11,BUMA.1121.00050,1,1809390,1814636,-,5246
11,BUMA.1121.00015,1,3366869,3372114,+,5245
11,BUMA.1121.00086,1,3142553,3147753,-,5200
11,BUMA.1121.00085,1,15864,21095,+,5231
11,BUMA.1121.00040,1,196215,201445,+,5230
11,BUMA.1121.00020,1,477879,483079,-,5200
11,BUMA.1121.00044,1,3279873,3285073,-,5200
11,BUMA.1121.00002,1,1216824,1222024,+,5200
11,BUMA.1121.00087,1,188231,193431,+,5200
11,BUMA.1121.00042,1,235804,241049,+,5245
11,BUMA.1121.00046,1,937076,942306,+,5230
11,BUMA.1121.00036,1,3428349,3433565,-,5216
11,BUMA.1121.00038,1,2883032,2888262,+,5230
11,BUMA.1121.00081,1,2883231,2888461,+,5230
11,BUMA.1121.00034,1,477872,483072,-,5200
11,BUMA.1121.00013,1,562002,567249,-,5247
11,BUMA.1121.00032,1,2179521,2184721,+,5200
11,BUMA.1121.00004,1,477865,483065,-,5200
11,BUMA.1121.00006,1,2883116,2888346,+,5230
11,BUMA.1121.00017,1,477871,483071,-,5200
11,BUMA.1121.00008,1,477886,483086,-,5200
11,BUMA.1121.00028,1,477873,483073,-,5200
11,BUMA.1121.00026,1,1437129,1442359,+,5230
11,BUMA.1121.00010,1,1190126,1195341,+,5215
11,BUMA.1121.00030,1,477871,483071,-,5200
11,BUMA.1121.00019,1,477885,483085,-,5200
10,BUMA.1121.00022,1,229560,266722,+,37162
10,BUMA.1121.00024,1,762408,799614,+,37206
10,BUMA.1121.00054,1,1473700,1510958,-,37258
10,BUMA.1121.00052,1,845303,882449,+,37146
10,BUMA.1121.00048,1,2424747,2462005,+,37258
10,BUMA.1121.00050,1,2028116,2065344,-,37228
10,BUMA.1121.00015,1,3163767,3200977,+,37210
10,BUMA.1121.00086,1,3184464,3221611,-,37147
10,BUMA.1121.00085,1,442138,479284,+,37146
10,BUMA.1121.00040,1,241105,278283,+,37178
10,BUMA.1121.00020,1,827357,864557,+,37200
10,BUMA.1121.00044,1,27945,65151,+,37206
10,BUMA.1121.00002,1,789096,826348,+,37252
10,BUMA.1121.00087,1,114374,151536,+,37162
10,BUMA.1121.00042,1,777627,814807,+,37180
10,BUMA.1121.00046,1,686535,723752,+,37217
10,BUMA.1121.00036,1,2971479,3008737,+,37258
10,BUMA.1121.00038,1,2632160,2669411,+,37251
10,BUMA.1121.00081,1,2632287,2669545,+,37258
10,BUMA.1121.00034,1,799838,837044,+,37206
10,BUMA.1121.00013,1,103933,141074,-,37141
10,BUMA.1121.00032,1,2292917,2330129,+,37212
10,BUMA.1121.00004,1,762366,799572,+,37206
10,BUMA.1121.00006,1,2632098,2669356,+,37258
10,BUMA.1121.00017,1,697517,734663,+,37146
10,BUMA.1121.00008,1,766159,803359,+,37200
10,BUMA.1121.00028,1,762407,799613,+,37206
10,BUMA.1121.00026,1,1630628,1667832,-,37204
10,BUMA.1121.00010,1,763762,800938,+,37176
10,BUMA.1121.00030,1,697517,734723,+,37206
10,BUMA.1121.00019,1,762457,799657,+,37200
9,BUMA.1121.00022,1,222812,227822,+,5010
9,BUMA.1121.00024,1,755660,760670,+,5010
9,BUMA.1121.00054,1,1513599,1518593,-,4994
9,BUMA.1121.00052,1,838570,843565,+,4995
9,BUMA.1121.00048,1,2417111,2422106,+,4995
9,BUMA.1121.00050,1,2067082,2072076,-,4994
9,BUMA.1121.00015,1,3157034,3162029,+,4995
9,BUMA.1121.00086,1,3223349,3228359,-,5010
9,BUMA.1121.00085,1,435405,440400,+,4995
9,BUMA.1121.00040,1,936536,941513,-,4977
9,BUMA.1121.00020,1,820609,825619,+,5010
9,BUMA.1121.00044,1,21197,26207,+,5010
9,BUMA.1121.00044,1,3492771,3497781,+,5010
9,BUMA.1121.00002,1,781800,786795,+,4995
9,BUMA.1121.00087,1,107626,112636,+,5010
9,BUMA.1121.00042,1,770954,775962,+,5008
9,BUMA.1121.00046,1,679802,684797,+,4995
9,BUMA.1121.00036,1,2964731,2969741,+,5010
9,BUMA.1121.00038,1,2624524,2629519,+,4995
9,BUMA.1121.00081,1,2624651,2629646,+,4995
9,BUMA.1121.00034,1,690758,695767,+,5009
9,BUMA.1121.00034,1,793090,798100,+,5010
9,BUMA.1121.00013,1,142812,147806,-,4994
9,BUMA.1121.00032,1,2286169,2291179,+,5010
9,BUMA.1121.00004,1,755618,760628,+,5010
9,BUMA.1121.00006,1,2624462,2629457,+,4995
9,BUMA.1121.00017,1,690769,695779,+,5010
9,BUMA.1121.00008,1,759411,764421,+,5010
9,BUMA.1121.00028,1,755659,760669,+,5010
9,BUMA.1121.00026,1,1669570,1674580,-,5010
9,BUMA.1121.00010,1,756464,761459,+,4995
9,BUMA.1121.00030,1,690769,695779,+,5010
9,BUMA.1121.00019,1,755709,760719,+,5010
8,BUMA.1121.00022,1,201586,221236,+,19650
8,BUMA.1121.00024,1,669515,689155,+,19640
8,BUMA.1121.00024,1,734436,754080,+,19644
8,BUMA.1121.00054,1,1518595,1538215,-,19620
8,BUMA.1121.00052,1,818919,838569,+,19650
8,BUMA.1121.00048,1,2397490,2417110,+,19620
8,BUMA.1121.00050,1,2072078,2091743,-,19665
8,BUMA.1121.00015,1,3137383,3157033,+,19650
8,BUMA.1121.00086,1,3229938,3249588,-,19650
8,BUMA.1121.00085,1,415754,435404,+,19650
8,BUMA.1121.00040,1,941515,961132,-,19617
8,BUMA.1121.00020,1,669510,689159,+,19649
8,BUMA.1121.00020,1,734446,754095,+,19649
8,BUMA.1121.00020,1,799382,819029,+,19647
8,BUMA.1121.00044,1,1,19617,+,19616
8,BUMA.1121.00044,1,3471544,3491191,+,19647
8,BUMA.1121.00002,1,762164,781799,+,19635
8,BUMA.1121.00087,1,86397,106045,+,19648
8,BUMA.1121.00042,1,749726,769375,+,19649
8,BUMA.1121.00046,1,660136,679801,+,19665
8,BUMA.1121.00036,1,2943501,2963151,+,19650
8,BUMA.1121.00038,1,2604903,2624523,+,19620
8,BUMA.1121.00081,1,2605030,2624650,+,19620
8,BUMA.1121.00034,1,669538,689177,+,19639
8,BUMA.1121.00034,1,771855,791510,+,19655
8,BUMA.1121.00013,1,147808,167458,-,19650
8,BUMA.1121.00032,1,2264942,2284589,+,19647
8,BUMA.1121.00004,1,669511,689155,+,19644
8,BUMA.1121.00004,1,734422,754038,+,19616
8,BUMA.1121.00006,1,2604841,2624461,+,19620
8,BUMA.1121.00017,1,669542,689189,+,19647
8,BUMA.1121.00008,1,669550,689194,+,19644
8,BUMA.1121.00008,1,738178,757831,+,19653
8,BUMA.1121.00028,1,669526,689169,+,19643
8,BUMA.1121.00028,1,734441,754079,+,19638
8,BUMA.1121.00026,1,1676155,1695790,-,19635
8,BUMA.1121.00010,1,736828,756463,+,19635
8,BUMA.1121.00030,1,669542,689189,+,19647
8,BUMA.1121.00019,1,669550,689198,+,19648
8,BUMA.1121.00019,1,734480,754129,+,19649
7,BUMA.1121.00022,1,161204,201584,+,40380
7,BUMA.1121.00024,1,629055,669513,+,40458
7,BUMA.1121.00024,1,693972,734434,+,40462
7,BUMA.1121.00054,1,1538216,1578625,-,40409
7,BUMA.1121.00052,1,778404,818917,+,40513
7,BUMA.1121.00048,1,2357080,2397488,+,40408
7,BUMA.1121.00050,1,2091744,2132132,-,40388
7,BUMA.1121.00015,1,3097029,3137381,+,40352
7,BUMA.1121.00086,1,3249589,3289991,-,40402
7,BUMA.1121.00085,1,375239,415752,+,40513
7,BUMA.1121.00040,1,961133,1001514,-,40381
7,BUMA.1121.00020,1,629070,669508,+,40438
7,BUMA.1121.00020,1,693975,734444,+,40469
7,BUMA.1121.00020,1,758911,799380,+,40469
7,BUMA.1121.00044,1,3431064,3471542,+,40478
7,BUMA.1121.00002,1,721761,762162,+,40401
7,BUMA.1121.00087,1,45994,86395,+,40401
7,BUMA.1121.00042,1,709351,749724,+,40373
7,BUMA.1121.00046,1,619740,660134,+,40394
7,BUMA.1121.00036,1,2903098,2943499,+,40401
7,BUMA.1121.00038,1,2564493,2604901,+,40408
7,BUMA.1121.00081,1,2564620,2605028,+,40408
7,BUMA.1121.00034,1,629058,669536,+,40478
7,BUMA.1121.00034,1,731375,771853,+,40478
7,BUMA.1121.00013,1,167459,207910,-,40451
7,BUMA.1121.00032,1,2224469,2264940,+,40471
7,BUMA.1121.00004,1,629056,669509,+,40453
7,BUMA.1121.00004,1,693972,734420,+,40448
7,BUMA.1121.00006,1,2564431,2604839,+,40408
7,BUMA.1121.00017,1,629062,669540,+,40478
7,BUMA.1121.00008,1,629076,669548,+,40472
7,BUMA.1121.00008,1,697714,738176,+,40462
7,BUMA.1121.00028,1,629064,669524,+,40460
7,BUMA.1121.00028,1,693986,734439,+,40453
7,BUMA.1121.00026,1,1695791,1736200,-,40409
7,BUMA.1121.00010,1,696428,736826,+,40398
7,BUMA.1121.00030,1,629062,669540,+,40478
7,BUMA.1121.00019,1,629076,669548,+,40472
7,BUMA.1121.00019,1,694015,734478,+,40463
6,BUMA.1121.00022,1,123248,157455,+,34207
6,BUMA.1121.00024,1,140645,174837,+,34192
6,BUMA.1121.00054,1,1581133,1616640,-,35507
6,BUMA.1121.00052,1,740478,775895,+,35417
6,BUMA.1121.00048,1,2319064,2354571,+,35507
6,BUMA.1121.00050,1,2134640,2170182,-,35542
6,BUMA.1121.00015,1,3059013,3094520,+,35507
6,BUMA.1121.00086,1,2577980,2612187,+,34207
6,BUMA.1121.00085,1,337313,372730,+,35417
6,BUMA.1121.00040,1,1004022,1038200,-,34178
6,BUMA.1121.00020,1,140666,174858,+,34192
6,BUMA.1121.00044,1,2942662,2976854,+,34192
6,BUMA.1121.00002,1,685055,719252,+,34197
6,BUMA.1121.00087,1,723430,757638,-,34208
6,BUMA.1121.00042,1,672625,706842,+,34217
6,BUMA.1121.00046,1,581704,617231,+,35527
6,BUMA.1121.00036,1,2865142,2899349,+,34207
6,BUMA.1121.00038,1,2526477,2561984,+,35507
6,BUMA.1121.00081,1,2526604,2562111,+,35507
6,BUMA.1121.00034,1,140659,174851,+,34192
6,BUMA.1121.00013,1,210418,245836,-,35418
6,BUMA.1121.00032,1,1737646,1771838,+,34192
6,BUMA.1121.00004,1,140652,174844,+,34192
6,BUMA.1121.00006,1,2526415,2561922,+,35507
6,BUMA.1121.00017,1,140659,174851,+,34192
6,BUMA.1121.00008,1,140673,174865,+,34192
6,BUMA.1121.00028,1,140659,174851,+,34192
6,BUMA.1121.00026,1,1738708,1772935,-,34227
6,BUMA.1121.00010,1,659722,693919,+,34197
6,BUMA.1121.00030,1,140659,174851,+,34192
6,BUMA.1121.00019,1,140666,174858,+,34192
5,BUMA.1121.00022,1,63158,121682,+,58524
5,BUMA.1121.00024,1,80539,139065,+,58526
5,BUMA.1121.00054,1,1618220,1676902,-,58682
5,BUMA.1121.00052,1,680017,738916,+,58899
5,BUMA.1121.00048,1,2258838,2317484,+,58646
5,BUMA.1121.00050,1,2171741,2230275,-,58534
5,BUMA.1121.00015,1,2998851,3057433,+,58582
5,BUMA.1121.00086,1,2517935,2576414,+,58479
5,BUMA.1121.00085,1,276845,335751,+,58906
5,BUMA.1121.00040,1,1039780,1098348,-,58568
5,BUMA.1121.00020,1,80539,139086,+,58547
5,BUMA.1121.00044,1,2882542,2941082,+,58540
5,BUMA.1121.00002,1,1476355,1534907,-,58552
5,BUMA.1121.00087,1,759203,817682,-,58479
5,BUMA.1121.00042,1,612526,671066,+,58540
5,BUMA.1121.00046,1,521600,580124,+,58524
5,BUMA.1121.00036,1,2805043,2863561,+,58518
5,BUMA.1121.00038,1,2466251,2524897,+,58646
5,BUMA.1121.00081,1,2466378,2525024,+,58646
5,BUMA.1121.00034,1,80539,139079,+,58540
5,BUMA.1121.00013,1,247398,306265,-,58867
5,BUMA.1121.00032,1,1677524,1736066,+,58542
5,BUMA.1121.00004,1,80539,139072,+,58533
5,BUMA.1121.00006,1,2466168,2524835,+,58667
5,BUMA.1121.00017,1,80539,139079,+,58540
5,BUMA.1121.00008,1,80539,139093,+,58554
5,BUMA.1121.00028,1,80539,139079,+,58540
5,BUMA.1121.00026,1,1774495,1833033,-,58538
5,BUMA.1121.00010,1,1450090,1508643,-,58553
5,BUMA.1121.00030,1,80539,139079,+,58540
5,BUMA.1121.00019,1,80539,139086,+,58547
4,BUMA.1121.00022,1,43967,63079,+,19112
4,BUMA.1121.00024,1,61348,80460,+,19112
4,BUMA.1121.00054,1,1678541,1697656,-,19115
4,BUMA.1121.00052,1,660839,679938,+,19099
4,BUMA.1121.00048,1,2238085,2257200,+,19115
4,BUMA.1121.00050,1,2231914,2251029,-,19115
4,BUMA.1121.00015,1,2978097,2997212,+,19115
4,BUMA.1121.00086,1,2498744,2517856,+,19112
4,BUMA.1121.00085,1,257667,276766,+,19099
4,BUMA.1121.00040,1,1098427,1117527,-,19100
4,BUMA.1121.00020,1,61348,80460,+,19112
4,BUMA.1121.00044,1,2863351,2882463,+,19112
4,BUMA.1121.00002,1,1534986,1554099,-,19113
4,BUMA.1121.00087,1,817761,836874,-,19113
4,BUMA.1121.00042,1,593329,612447,+,19118
4,BUMA.1121.00046,1,500846,519961,+,19115
4,BUMA.1121.00036,1,2784259,2803387,+,19128
4,BUMA.1121.00038,1,2445497,2464612,+,19115
4,BUMA.1121.00081,1,2445624,2464739,+,19115
4,BUMA.1121.00034,1,61348,80460,+,19112
4,BUMA.1121.00013,1,306344,325444,-,19100
4,BUMA.1121.00032,1,1658333,1677445,+,19112
4,BUMA.1121.00004,1,61348,80460,+,19112
4,BUMA.1121.00006,1,2445414,2464529,+,19115
4,BUMA.1121.00017,1,61348,80460,+,19112
4,BUMA.1121.00008,1,61348,80460,+,19112
4,BUMA.1121.00028,1,61348,80460,+,19112
4,BUMA.1121.00026,1,1833112,1852231,-,19119
4,BUMA.1121.00010,1,1508722,1527835,-,19113
4,BUMA.1121.00030,1,61348,80460,+,19112
4,BUMA.1121.00019,1,61348,80460,+,19112
3,BUMA.1121.00022,1,37099,41212,+,4113
3,BUMA.1121.00024,1,3068221,3072334,-,4113
3,BUMA.1121.00054,1,116163,120276,-,4113
3,BUMA.1121.00052,1,1098448,1102561,-,4113
3,BUMA.1121.00048,1,305323,309436,+,4113
3,BUMA.1121.00050,1,742502,746615,-,4113
3,BUMA.1121.00015,1,2495106,2499219,+,4113
3,BUMA.1121.00086,1,130277,134390,-,4113
3,BUMA.1121.00085,1,695283,699396,-,4113
3,BUMA.1121.00040,1,3260211,3264324,+,4113
3,BUMA.1121.00020,1,3204241,3208354,-,4113
3,BUMA.1121.00044,1,2404992,2409105,-,4113
3,BUMA.1121.00002,1,1936032,1940145,-,4113
3,BUMA.1121.00087,1,3182173,3186286,+,4113
3,BUMA.1121.00042,1,941742,945855,-,4113
3,BUMA.1121.00046,1,2005083,2009196,+,4113
3,BUMA.1121.00036,1,2666633,2670746,+,4113
3,BUMA.1121.00038,1,512798,516911,+,4113
3,BUMA.1121.00081,1,512867,516980,+,4113
3,BUMA.1121.00034,1,3176822,3180935,-,4113
3,BUMA.1121.00013,1,1294710,1298823,-,4113
3,BUMA.1121.00032,1,1192895,1197008,-,4113
3,BUMA.1121.00004,1,3219661,3223774,-,4113
3,BUMA.1121.00006,1,512798,516911,+,4113
3,BUMA.1121.00017,1,3074487,3078600,-,4113
3,BUMA.1121.00008,1,3151027,3155140,-,4113
3,BUMA.1121.00028,1,3139421,3143534,-,4113
3,BUMA.1121.00026,1,471726,475839,+,4113
3,BUMA.1121.00010,1,1910427,1914540,-,4113
3,BUMA.1121.00030,1,3074555,3078668,-,4113
3,BUMA.1121.00019,1,3090754,3094867,-,4113
2,BUMA.1121.00022,1,26293,33349,+,7056
2,BUMA.1121.00024,1,3075792,3082835,-,7043
2,BUMA.1121.00054,1,121490,128546,-,7056
2,BUMA.1121.00052,1,3010159,3017216,+,7057
2,BUMA.1121.00048,1,297052,304109,+,7057
2,BUMA.1121.00050,1,750365,757421,-,7056
2,BUMA.1121.00086,1,138140,145195,-,7055
2,BUMA.1121.00085,1,2607105,2614162,+,7057
2,BUMA.1121.00040,1,3249926,3256983,+,7057
2,BUMA.1121.00020,1,3211812,3218855,-,7043
2,BUMA.1121.00002,1,1945143,1952198,-,7055
2,BUMA.1121.00087,1,3173904,3180960,+,7056
2,BUMA.1121.00042,1,1068602,1075645,-,7043
2,BUMA.1121.00046,1,1994276,2001333,+,7057
2,BUMA.1121.00036,1,2655827,2662883,+,7056
2,BUMA.1121.00038,1,504527,511584,+,7057
2,BUMA.1121.00081,1,504596,511653,+,7057
2,BUMA.1121.00013,1,3302255,3309312,+,7057
2,BUMA.1121.00032,1,1200466,1207509,-,7043
2,BUMA.1121.00004,1,3227232,3234275,-,7043
2,BUMA.1121.00006,1,504527,511584,+,7057
2,BUMA.1121.00008,1,3158598,3165641,-,7043
2,BUMA.1121.00028,1,3146992,3154035,-,7043
2,BUMA.1121.00026,1,2147964,2155007,-,7043
2,BUMA.1121.00010,1,1918302,1925345,-,7043
2,BUMA.1121.00019,1,3098325,3105368,-,7043
1,BUMA.1121.00022,1,32,22899,+,22867
1,BUMA.1121.00024,1,3086238,3109097,-,22859
1,BUMA.1121.00054,1,131949,154798,-,22849
1,BUMA.1121.00052,1,2983694,3006756,+,23062
1,BUMA.1121.00048,1,270600,293651,+,23051
1,BUMA.1121.00050,1,760824,783674,-,22850
1,BUMA.1121.00015,1,2466501,2489563,+,23062
1,BUMA.1121.00086,1,148598,171466,-,22868
1,BUMA.1121.00085,1,2580640,2603702,+,23062
1,BUMA.1121.00040,1,3223461,3246523,+,23062
1,BUMA.1121.00020,1,3222258,3245117,-,22859
1,BUMA.1121.00044,1,2415960,2438819,-,22859
1,BUMA.1121.00002,1,1955601,1978460,-,22859
1,BUMA.1121.00087,1,3147430,3170501,+,23071
1,BUMA.1121.00042,1,1077734,1100600,-,22866
1,BUMA.1121.00046,1,1967820,1990873,+,23053
1,BUMA.1121.00036,1,2629353,2652424,+,23071
1,BUMA.1121.00038,1,478072,501124,+,23052
1,BUMA.1121.00081,1,478141,501193,+,23052
1,BUMA.1121.00034,1,3187790,3210649,-,22859
1,BUMA.1121.00013,1,3275790,3298852,+,23062
1,BUMA.1121.00032,1,1210912,1233771,-,22859
1,BUMA.1121.00004,1,3237678,3260537,-,22859
1,BUMA.1121.00006,1,478072,501124,+,23052
1,BUMA.1121.00017,1,3085455,3108314,-,22859
1,BUMA.1121.00008,1,3169044,3191903,-,22859
1,BUMA.1121.00028,1,3157438,3180297,-,22859
1,BUMA.1121.00026,1,2157096,2179962,-,22866
1,BUMA.1121.00010,1,1928748,1951607,-,22859
1,BUMA.1121.00030,1,3085523,3108382,-,22859
1,BUMA.1121.00019,1,3108771,3131630,-,22859
14,BUMA.1121.00022,1,346216,366935,+,20719
14,BUMA.1121.00024,1,384599,405315,-,20716
14,BUMA.1121.00054,1,1163167,1183887,-,20720
14,BUMA.1121.00052,1,312985,333704,+,20719
14,BUMA.1121.00048,1,2751912,2772631,+,20719
14,BUMA.1121.00050,1,1717718,1738438,-,20720
14,BUMA.1121.00015,1,3443048,3463767,+,20719
14,BUMA.1121.00086,1,3050854,3071574,-,20720
14,BUMA.1121.00085,1,3406781,3427500,+,20719
14,BUMA.1121.00040,1,883331,904051,-,20720
14,BUMA.1121.00020,1,384614,405330,-,20716
14,BUMA.1121.00044,1,3186608,3207324,-,20716
14,BUMA.1121.00002,1,990432,1011151,+,20719
14,BUMA.1121.00087,1,264387,285106,+,20719
14,BUMA.1121.00042,1,877406,898126,-,20720
14,BUMA.1121.00046,1,1013261,1033980,+,20719
14,BUMA.1121.00036,1,3336627,3357347,-,20720
14,BUMA.1121.00038,1,2959211,2979930,+,20719
14,BUMA.1121.00081,1,2959410,2980129,+,20719
14,BUMA.1121.00034,1,384607,405323,-,20716
14,BUMA.1121.00013,1,622077,642797,-,20720
14,BUMA.1121.00032,1,1980013,2000729,-,20716
14,BUMA.1121.00004,1,384600,405316,-,20716
14,BUMA.1121.00006,1,2959295,2980014,+,20719
14,BUMA.1121.00017,1,384606,405322,-,20716
14,BUMA.1121.00008,1,384621,405337,-,20716
14,BUMA.1121.00028,1,384608,405324,-,20716
14,BUMA.1121.00026,1,1188618,1209338,-,20720
14,BUMA.1121.00010,1,963759,984478,+,20719
14,BUMA.1121.00030,1,384606,405322,-,20716
14,BUMA.1121.00019,1,384620,405336,-,20716
15,BUMA.1121.00022,1,367789,378244,+,10455
15,BUMA.1121.00024,1,373295,383746,-,10451
15,BUMA.1121.00054,1,1151854,1162314,-,10460
15,BUMA.1121.00052,1,334558,345029,+,10471
15,BUMA.1121.00048,1,2773485,2783945,+,10460
15,BUMA.1121.00050,1,1706413,1716865,-,10452
15,BUMA.1121.00015,1,3464621,3475081,+,10460
15,BUMA.1121.00086,1,3039554,3050001,-,10447
15,BUMA.1121.00085,1,3428354,3438825,+,10471
15,BUMA.1121.00040,1,872018,882478,-,10460
15,BUMA.1121.00020,1,373310,383761,-,10451
15,BUMA.1121.00044,1,3175304,3185755,-,10451
15,BUMA.1121.00002,1,1012005,1022465,+,10460
15,BUMA.1121.00087,1,285960,296415,+,10455
15,BUMA.1121.00042,1,866101,876553,-,10452
15,BUMA.1121.00046,1,1034834,1045285,+,10451
15,BUMA.1121.00036,1,3325319,3335774,-,10455
15,BUMA.1121.00038,1,2980784,2991244,+,10460
15,BUMA.1121.00081,1,2980983,2991443,+,10460
15,BUMA.1121.00034,1,373303,383754,-,10451
15,BUMA.1121.00013,1,610753,621224,-,10471
15,BUMA.1121.00032,1,1968709,1979160,-,10451
15,BUMA.1121.00004,1,373296,383747,-,10451
15,BUMA.1121.00006,1,2980868,2991328,+,10460
15,BUMA.1121.00017,1,373302,383753,-,10451
15,BUMA.1121.00008,1,373317,383768,-,10451
15,BUMA.1121.00028,1,373304,383755,-,10451
15,BUMA.1121.00026,1,1177313,1187765,-,10452
15,BUMA.1121.00010,1,985332,995792,+,10460
15,BUMA.1121.00030,1,373302,383753,-,10451
15,BUMA.1121.00019,1,373316,383767,-,10451
16,BUMA.1121.00022,1,381118,389043,+,7925
16,BUMA.1121.00024,1,362502,370411,-,7909
16,BUMA.1121.00054,1,1141070,1148979,-,7909
16,BUMA.1121.00052,1,270931,278855,-,7924
16,BUMA.1121.00048,1,2786817,2794726,+,7909
16,BUMA.1121.00050,1,1588870,1596795,+,7925
16,BUMA.1121.00015,1,3477955,3485864,+,7909
16,BUMA.1121.00086,1,2920427,2928336,+,7909
16,BUMA.1121.00085,1,3364737,3372661,-,7924
16,BUMA.1121.00040,1,861219,869143,-,7924
16,BUMA.1121.00020,1,362517,370426,-,7909
16,BUMA.1121.00044,1,3164511,3172420,-,7909
16,BUMA.1121.00002,1,1025339,1033264,+,7925
16,BUMA.1121.00087,1,407564,415473,-,7909
16,BUMA.1121.00042,1,932225,940150,+,7925
16,BUMA.1121.00046,1,1154949,1162858,-,7909
16,BUMA.1121.00036,1,3314521,3322445,-,7924
16,BUMA.1121.00038,1,2994118,3002027,+,7909
16,BUMA.1121.00081,1,2994317,3002226,+,7909
16,BUMA.1121.00034,1,362510,370419,-,7909
16,BUMA.1121.00013,1,676926,684851,+,7925
16,BUMA.1121.00032,1,1957916,1965825,-,7909
16,BUMA.1121.00004,1,362503,370412,-,7909
16,BUMA.1121.00006,1,2994202,3002111,+,7909
16,BUMA.1121.00017,1,362509,370418,-,7909
16,BUMA.1121.00008,1,362524,370433,-,7909
16,BUMA.1121.00028,1,362511,370420,-,7909
16,BUMA.1121.00026,1,1243443,1251368,+,7925
16,BUMA.1121.00010,1,998666,1006591,+,7925
16,BUMA.1121.00030,1,362509,370418,-,7909
16,BUMA.1121.00019,1,362523,370432,-,7909
17,BUMA.1121.00022,1,390585,422390,+,31805
17,BUMA.1121.00024,1,801180,833000,+,31820
17,BUMA.1121.00054,1,540928,572849,+,31921
17,BUMA.1121.00052,1,626213,658109,-,31896
17,BUMA.1121.00048,1,3362939,3394875,-,31936
17,BUMA.1121.00050,1,1212383,1244295,+,31912
17,BUMA.1121.00015,1,444257,476145,-,31888
17,BUMA.1121.00086,1,3151102,3182885,-,31783
17,BUMA.1121.00085,1,223041,254937,-,31896
17,BUMA.1121.00040,1,499056,530953,+,31897
17,BUMA.1121.00020,1,866123,897943,+,31820
17,BUMA.1121.00044,1,66717,98537,+,31820
17,BUMA.1121.00002,1,827895,859814,+,31919
17,BUMA.1121.00087,1,153084,184883,+,31799
17,BUMA.1121.00042,1,3220182,3252138,+,31956
17,BUMA.1121.00046,1,1507444,1539360,-,31916
17,BUMA.1121.00036,1,3010288,3042113,+,31825
17,BUMA.1121.00038,1,60225,92145,-,31920
17,BUMA.1121.00081,1,60294,92214,-,31920
17,BUMA.1121.00034,1,838610,870430,+,31820
17,BUMA.1121.00013,1,328173,360070,+,31897
17,BUMA.1121.00032,1,2331695,2363515,+,31820
17,BUMA.1121.00004,1,801138,832958,+,31820
17,BUMA.1121.00006,1,60225,92145,-,31920
17,BUMA.1121.00017,1,736229,768049,+,31820
17,BUMA.1121.00008,1,804925,836745,+,31820
17,BUMA.1121.00028,1,801179,832999,+,31820
17,BUMA.1121.00026,1,1010945,1042992,+,32047
17,BUMA.1121.00010,1,802517,834420,+,31903
17,BUMA.1121.00030,1,736289,768109,+,31820
17,BUMA.1121.00019,1,801223,833043,+,31820
18,BUMA.1121.00022,1,424009,452872,+,28863
18,BUMA.1121.00024,1,980330,1009215,+,28885
18,BUMA.1121.00054,1,824535,853426,+,28891
18,BUMA.1121.00052,1,567735,596626,-,28891
18,BUMA.1121.00048,1,3082360,3111251,-,28891
18,BUMA.1121.00050,1,1454519,1483410,+,28891
18,BUMA.1121.00015,1,155314,184205,-,28891
18,BUMA.1121.00086,1,2786092,2814983,+,28891
18,BUMA.1121.00085,1,164563,193454,-,28891
18,BUMA.1121.00040,1,279830,308721,+,28891
18,BUMA.1121.00020,1,1045273,1074158,+,28885
18,BUMA.1121.00044,1,245867,274752,+,28885
18,BUMA.1121.00002,1,890670,919561,+,28891
18,BUMA.1121.00087,1,520773,549664,-,28891
18,BUMA.1121.00042,1,3253746,3282637,-,28891
18,BUMA.1121.00046,1,1268320,1297211,-,28891
18,BUMA.1121.00036,1,3071747,3100644,+,28897
18,BUMA.1121.00038,1,3289679,3318570,-,28891
18,BUMA.1121.00081,1,3289864,3318755,-,28891
18,BUMA.1121.00034,1,1017760,1046645,+,28885
18,BUMA.1121.00013,1,389650,418541,+,28891
18,BUMA.1121.00032,1,2510845,2539730,+,28885
18,BUMA.1121.00004,1,981527,1010412,+,28885
18,BUMA.1121.00006,1,3289756,3318647,-,28891
18,BUMA.1121.00017,1,915379,944264,+,28885
18,BUMA.1121.00008,1,984075,1012960,+,28885
18,BUMA.1121.00028,1,980329,1009214,+,28885
18,BUMA.1121.00026,1,1044602,1073493,-,28891
18,BUMA.1121.00010,1,864023,892914,+,28891
18,BUMA.1121.00030,1,915439,944324,+,28885
18,BUMA.1121.00019,1,980373,1009258,+,28885
19,BUMA.1121.00022,1,455921,505320,+,49399
19,BUMA.1121.00024,1,228689,278087,-,49398
19,BUMA.1121.00054,1,856475,905906,+,49431
19,BUMA.1121.00052,1,514086,563519,-,49433
19,BUMA.1121.00048,1,3029880,3079312,-,49432
19,BUMA.1121.00050,1,1486458,1535861,+,49403
19,BUMA.1121.00015,1,102818,152266,-,49448
19,BUMA.1121.00086,1,2818031,2867416,+,49385
19,BUMA.1121.00085,1,110914,160347,-,49433
19,BUMA.1121.00040,1,720347,769832,-,49485
19,BUMA.1121.00020,1,228710,278108,-,49398
19,BUMA.1121.00044,1,3030706,3080104,-,49398
19,BUMA.1121.00002,1,1116084,1165478,+,49394
19,BUMA.1121.00087,1,468340,517725,-,49385
19,BUMA.1121.00042,1,3313659,3363194,+,49535
19,BUMA.1121.00046,1,1215868,1265272,-,49404
19,BUMA.1121.00036,1,3103692,3153140,+,49448
19,BUMA.1121.00038,1,3237198,3286630,-,49432
19,BUMA.1121.00081,1,3237383,3286815,-,49432
19,BUMA.1121.00034,1,228703,278101,-,49398
19,BUMA.1121.00013,1,422757,472189,+,49432
19,BUMA.1121.00032,1,1825684,1875092,-,49408
19,BUMA.1121.00004,1,228695,278093,-,49398
19,BUMA.1121.00006,1,3237275,3286707,-,49432
19,BUMA.1121.00017,1,228703,278101,-,49398
19,BUMA.1121.00008,1,228717,278115,-,49398
19,BUMA.1121.00028,1,228703,278101,-,49398
19,BUMA.1121.00026,1,1076442,1125991,+,49549
19,BUMA.1121.00010,1,1089410,1138821,+,49411
19,BUMA.1121.00030,1,228703,278101,-,49398
19,BUMA.1121.00019,1,228710,278108,-,49398
20,BUMA.1121.00022,1,507200,555476,+,48276
20,BUMA.1121.00024,1,178542,226836,-,48294
20,BUMA.1121.00054,1,907760,956060,+,48300
20,BUMA.1121.00052,1,463969,512233,-,48264
20,BUMA.1121.00048,1,2979728,3028026,-,48298
20,BUMA.1121.00050,1,1537711,1586002,+,48291
20,BUMA.1121.00015,1,52689,100965,-,48276
20,BUMA.1121.00086,1,2869268,2917559,+,48291
20,BUMA.1121.00085,1,60797,109061,-,48264
20,BUMA.1121.00040,1,670204,718495,-,48291
20,BUMA.1121.00020,1,178563,226857,-,48294
20,BUMA.1121.00044,1,2980559,3028853,-,48294
20,BUMA.1121.00002,1,1167332,1215583,+,48251
20,BUMA.1121.00087,1,418341,466487,-,48146
20,BUMA.1121.00042,1,816641,864860,+,48219
20,BUMA.1121.00046,1,1165727,1214017,-,48290
20,BUMA.1121.00036,1,3154992,3203268,+,48276
20,BUMA.1121.00038,1,3187045,3235344,-,48299
20,BUMA.1121.00081,1,3187230,3235529,-,48299
20,BUMA.1121.00034,1,178556,226850,-,48294
20,BUMA.1121.00013,1,474042,522300,+,48258
20,BUMA.1121.00032,1,1775543,1823831,-,48288
20,BUMA.1121.00004,1,178549,226842,-,48293
20,BUMA.1121.00006,1,3187122,3235421,-,48299
20,BUMA.1121.00017,1,178556,226850,-,48294
20,BUMA.1121.00008,1,178570,226864,-,48294
20,BUMA.1121.00028,1,178556,226850,-,48294
20,BUMA.1121.00026,1,1127842,1176072,+,48230
20,BUMA.1121.00010,1,1140658,1188916,+,48258
20,BUMA.1121.00030,1,178556,226850,-,48294
20,BUMA.1121.00019,1,178563,226857,-,48294
21,BUMA.1121.00022,1,556717,583766,+,27049
21,BUMA.1121.00024,1,1010796,1037916,-,27120
21,BUMA.1121.00054,1,1032584,1059704,+,27120
21,BUMA.1121.00052,1,162566,189652,+,27086
21,BUMA.1121.00048,1,2876093,2903205,-,27112
21,BUMA.1121.00050,1,1678118,1705172,-,27054
21,BUMA.1121.00015,1,24302,51448,-,27146
21,BUMA.1121.00086,1,3011300,3038313,-,27013
21,BUMA.1121.00085,1,3256372,3283458,+,27086
21,BUMA.1121.00040,1,641937,668993,-,27056
21,BUMA.1121.00020,1,1075739,1102887,-,27148
21,BUMA.1121.00044,1,276333,303467,-,27134
21,BUMA.1121.00002,1,1223775,1250796,-,27021
21,BUMA.1121.00087,1,297631,324660,+,27029
21,BUMA.1121.00042,1,23806,50839,+,27033
21,BUMA.1121.00046,1,1046526,1073609,+,27083
21,BUMA.1121.00036,1,3204509,3231586,+,27077
21,BUMA.1121.00038,1,3083394,3110521,-,27127
21,BUMA.1121.00081,1,3083593,3110713,-,27120
21,BUMA.1121.00034,1,1048226,1075353,-,27127
21,BUMA.1121.00013,1,766138,793198,-,27060
21,BUMA.1121.00032,1,2541311,2568340,-,27029
21,BUMA.1121.00004,1,1011993,1039189,-,27196
21,BUMA.1121.00006,1,3083478,3110598,-,27120
21,BUMA.1121.00017,1,945845,972993,-,27148
21,BUMA.1121.00008,1,1014541,1041645,-,27104
21,BUMA.1121.00028,1,1010795,1037950,-,27155
21,BUMA.1121.00026,1,1333780,1360757,-,26977
21,BUMA.1121.00010,1,1197086,1224108,-,27022
21,BUMA.1121.00030,1,945905,973025,-,27120
21,BUMA.1121.00019,1,1010839,1037994,-,27155
22,BUMA.1121.00022,1,585324,598007,+,12683
22,BUMA.1121.00024,1,348255,360923,-,12668
22,BUMA.1121.00054,1,1126820,1139491,-,12671
22,BUMA.1121.00052,1,256709,269384,-,12675
22,BUMA.1121.00048,1,2796305,2808976,+,12671
22,BUMA.1121.00050,1,1598341,1611027,+,12686
22,BUMA.1121.00015,1,3487443,3500114,+,12671
22,BUMA.1121.00086,1,2929915,2942583,+,12668
22,BUMA.1121.00085,1,3350515,3363190,-,12675
22,BUMA.1121.00040,1,560549,573232,+,12683
22,BUMA.1121.00020,1,348270,360938,-,12668
22,BUMA.1121.00044,1,3150264,3162932,-,12668
22,BUMA.1121.00002,1,1034827,1047495,+,12668
22,BUMA.1121.00087,1,393317,405985,-,12668
22,BUMA.1121.00042,1,52398,65081,+,12683
22,BUMA.1121.00046,1,1140699,1153370,-,12671
22,BUMA.1121.00036,1,3300285,3312969,-,12684
22,BUMA.1121.00038,1,3003606,3016277,+,12671
22,BUMA.1121.00081,1,3003805,3016476,+,12671
22,BUMA.1121.00034,1,348263,360931,-,12668
22,BUMA.1121.00013,1,686398,699072,+,12674
22,BUMA.1121.00032,1,1943669,1956337,-,12668
22,BUMA.1121.00004,1,348256,360924,-,12668
22,BUMA.1121.00006,1,3003690,3016361,+,12671
22,BUMA.1121.00017,1,348262,360930,-,12668
22,BUMA.1121.00008,1,348277,360945,-,12668
22,BUMA.1121.00028,1,348264,360932,-,12668
22,BUMA.1121.00026,1,1319568,1332219,-,12651
22,BUMA.1121.00010,1,1008139,1020822,+,12683
22,BUMA.1121.00030,1,348262,360930,-,12668
22,BUMA.1121.00019,1,348276,360944,-,12668
23,BUMA.1121.00022,1,598009,631883,+,33874
23,BUMA.1121.00024,1,314377,348254,-,33877
23,BUMA.1121.00054,1,1092940,1126819,-,33879
23,BUMA.1121.00052,1,222829,256708,-,33879
23,BUMA.1121.00048,1,2808978,2842857,+,33879
23,BUMA.1121.00050,1,1611029,1644908,+,33879
23,BUMA.1121.00015,1,3500116,3533995,+,33879
23,BUMA.1121.00086,1,2942585,2976462,+,33877
23,BUMA.1121.00085,1,3316635,3350514,-,33879
23,BUMA.1121.00040,1,573234,607113,+,33879
23,BUMA.1121.00020,1,314392,348269,-,33877
23,BUMA.1121.00044,1,3116386,3150263,-,33877
23,BUMA.1121.00002,1,1047497,1081374,+,33877
23,BUMA.1121.00087,1,359439,393316,-,33877
23,BUMA.1121.00042,1,66323,100202,+,33879
23,BUMA.1121.00046,1,1106819,1140698,-,33879
23,BUMA.1121.00036,1,3266409,3300284,-,33875
23,BUMA.1121.00038,1,3016279,3050158,+,33879
23,BUMA.1121.00081,1,3016478,3050357,+,33879
23,BUMA.1121.00034,1,314385,348262,-,33877
23,BUMA.1121.00013,1,699074,732953,+,33879
23,BUMA.1121.00032,1,1909791,1943668,-,33877
23,BUMA.1121.00004,1,314378,348255,-,33877
23,BUMA.1121.00006,1,3016363,3050242,+,33879
23,BUMA.1121.00017,1,314384,348261,-,33877
23,BUMA.1121.00008,1,314399,348276,-,33877
23,BUMA.1121.00028,1,314386,348263,-,33877
23,BUMA.1121.00026,1,1284415,1318294,-,33879
23,BUMA.1121.00010,1,1020824,1054701,+,33877
23,BUMA.1121.00030,1,314384,348261,-,33877
23,BUMA.1121.00019,1,314398,348275,-,33877
24,BUMA.1121.00022,1,635383,642405,+,7022
24,BUMA.1121.00024,1,303858,310878,-,7020
24,BUMA.1121.00054,1,1084014,1091037,-,7023
24,BUMA.1121.00052,1,213903,220926,-,7023
24,BUMA.1121.00048,1,2844760,2851782,+,7022
24,BUMA.1121.00050,1,1646811,1653833,+,7022
24,BUMA.1121.00015,1,3535898,3542936,+,7038
24,BUMA.1121.00086,1,2979988,2987010,+,7022
24,BUMA.1121.00085,1,3307709,3314732,-,7023
24,BUMA.1121.00040,1,610610,617632,+,7022
24,BUMA.1121.00020,1,303873,310893,-,7020
24,BUMA.1121.00044,1,3105867,3112887,-,7020
24,BUMA.1121.00002,1,1083277,1090299,+,7022
24,BUMA.1121.00087,1,348916,355939,-,7023
24,BUMA.1121.00042,1,102105,109127,+,7022
24,BUMA.1121.00046,1,1097893,1104916,-,7023
24,BUMA.1121.00036,1,3255888,3262911,-,7023
24,BUMA.1121.00038,1,3052061,3059083,+,7022
24,BUMA.1121.00081,1,3052260,3059282,+,7022
24,BUMA.1121.00034,1,303866,310886,-,7020
24,BUMA.1121.00013,1,734856,741878,+,7022
24,BUMA.1121.00032,1,1900865,1907888,-,7023
24,BUMA.1121.00004,1,303859,310879,-,7020
24,BUMA.1121.00006,1,3052145,3059167,+,7022
24,BUMA.1121.00017,1,303865,310885,-,7020
24,BUMA.1121.00008,1,303880,310900,-,7020
24,BUMA.1121.00028,1,303867,310887,-,7020
24,BUMA.1121.00026,1,1275489,1282512,-,7023
24,BUMA.1121.00010,1,1056604,1063626,+,7022
24,BUMA.1121.00030,1,303865,310885,-,7020
24,BUMA.1121.00019,1,303879,310899,-,7020
25,BUMA.1121.00022,1,642407,649241,+,6834
25,BUMA.1121.00024,1,297023,303857,-,6834
25,BUMA.1121.00054,1,1077179,1084013,-,6834
25,BUMA.1121.00052,1,207068,213902,-,6834
25,BUMA.1121.00048,1,2851784,2858618,+,6834
25,BUMA.1121.00050,1,1653835,1660669,+,6834
25,BUMA.1121.00015,1,1,6820,+,6819
25,BUMA.1121.00086,1,2987012,2993846,+,6834
25,BUMA.1121.00085,1,3300874,3307708,-,6834
25,BUMA.1121.00040,1,617634,624468,+,6834
25,BUMA.1121.00020,1,297038,303872,-,6834
25,BUMA.1121.00044,1,3099032,3105866,-,6834
25,BUMA.1121.00002,1,1090301,1097135,+,6834
25,BUMA.1121.00087,1,342081,348915,-,6834
25,BUMA.1121.00042,1,109129,115963,+,6834
25,BUMA.1121.00046,1,1091058,1097892,-,6834
25,BUMA.1121.00036,1,3249053,3255887,-,6834
25,BUMA.1121.00038,1,3059085,3065919,+,6834
25,BUMA.1121.00081,1,3059284,3066118,+,6834
25,BUMA.1121.00034,1,297031,303865,-,6834
25,BUMA.1121.00013,1,741880,748714,+,6834
25,BUMA.1121.00032,1,1894030,1900864,-,6834
25,BUMA.1121.00004,1,297024,303858,-,6834
25,BUMA.1121.00006,1,3059169,3066003,+,6834
25,BUMA.1121.00017,1,297030,303864,-,6834
25,BUMA.1121.00008,1,297045,303879,-,6834
25,BUMA.1121.00028,1,297032,303866,-,6834
25,BUMA.1121.00026,1,1268654,1275488,-,6834
25,BUMA.1121.00010,1,1063628,1070462,+,6834
25,BUMA.1121.00030,1,297030,303864,-,6834
25,BUMA.1121.00019,1,297044,303878,-,6834
26,BUMA.1121.00022,1,650092,664976,+,14884
26,BUMA.1121.00024,1,281309,296171,-,14862
26,BUMA.1121.00054,1,1061431,1076327,-,14896
26,BUMA.1121.00052,1,191378,206216,-,14838
26,BUMA.1121.00048,1,2859469,2874365,+,14896
26,BUMA.1121.00050,1,1661520,1676390,+,14870
26,BUMA.1121.00015,1,7671,22575,+,14904
26,BUMA.1121.00086,1,2994697,3009541,+,14844
26,BUMA.1121.00085,1,3285184,3300022,-,14838
26,BUMA.1121.00040,1,625319,640207,+,14888
26,BUMA.1121.00020,1,281332,296186,-,14854
26,BUMA.1121.00044,1,3083326,3098180,-,14854
26,BUMA.1121.00002,1,1097986,1112884,+,14898
26,BUMA.1121.00087,1,326385,341229,-,14844
26,BUMA.1121.00042,1,116814,131690,+,14876
26,BUMA.1121.00046,1,1075336,1090206,-,14870
26,BUMA.1121.00036,1,3233355,3248201,-,14846
26,BUMA.1121.00038,1,3066770,3081666,+,14896
26,BUMA.1121.00081,1,3066969,3081865,+,14896
26,BUMA.1121.00034,1,281325,296179,-,14854
26,BUMA.1121.00013,1,749565,764411,+,14846
26,BUMA.1121.00032,1,1878316,1893178,-,14862
26,BUMA.1121.00004,1,281318,296172,-,14854
26,BUMA.1121.00006,1,3066854,3081750,+,14896
26,BUMA.1121.00017,1,281324,296178,-,14854
26,BUMA.1121.00008,1,281339,296193,-,14854
26,BUMA.1121.00028,1,281326,296180,-,14854
26,BUMA.1121.00026,1,1253083,1267802,-,14719
26,BUMA.1121.00010,1,1071313,1086219,+,14906
26,BUMA.1121.00030,1,281324,296178,-,14854
26,BUMA.1121.00019,1,281338,296192,-,14854
27,BUMA.1121.00022,1,666735,693178,+,26443
27,BUMA.1121.00024,1,834606,861034,-,26428
27,BUMA.1121.00054,1,796529,822974,-,26445
27,BUMA.1121.00052,1,598187,624623,+,26436
27,BUMA.1121.00048,1,3112812,3139257,+,26445
27,BUMA.1121.00050,1,1426522,1452958,-,26436
27,BUMA.1121.00015,1,185766,212202,+,26436
27,BUMA.1121.00086,1,2758087,2784530,-,26443
27,BUMA.1121.00085,1,195015,221451,+,26436
27,BUMA.1121.00040,1,532559,558985,-,26426
27,BUMA.1121.00020,1,899549,925977,-,26428
27,BUMA.1121.00044,1,100143,126571,-,26428
27,BUMA.1121.00002,1,862650,889109,-,26459
27,BUMA.1121.00087,1,551226,577669,+,26443
27,BUMA.1121.00042,1,3284201,3310708,+,26507
27,BUMA.1121.00046,1,1298772,1325208,+,26436
27,BUMA.1121.00036,1,3043708,3070151,-,26443
27,BUMA.1121.00038,1,3320131,3346576,+,26445
27,BUMA.1121.00081,1,3320316,3346761,+,26445
27,BUMA.1121.00034,1,872036,898464,-,26428
27,BUMA.1121.00013,1,361676,388089,-,26413
27,BUMA.1121.00032,1,2365121,2391549,-,26428
27,BUMA.1121.00004,1,834564,860992,-,26428
27,BUMA.1121.00006,1,3320208,3346653,+,26445
27,BUMA.1121.00017,1,769655,796083,-,26428
27,BUMA.1121.00008,1,838351,864779,-,26428
27,BUMA.1121.00028,1,834605,861033,-,26428
27,BUMA.1121.00010,1,836008,862467,-,26459
27,BUMA.1121.00030,1,769715,796143,-,26428
27,BUMA.1121.00019,1,834649,861077,-,26428
28,BUMA.1121.00022,1,694775,716162,+,21387
28,BUMA.1121.00024,1,486401,507777,+,21376
28,BUMA.1121.00054,1,1295779,1317157,+,21378
28,BUMA.1121.00052,1,70244,91631,+,21387
28,BUMA.1121.00048,1,2618634,2640012,-,21378
28,BUMA.1121.00050,1,1916646,1938033,-,21387
28,BUMA.1121.00015,1,477729,499116,+,21387
28,BUMA.1121.00086,1,2735107,2756494,-,21387
28,BUMA.1121.00085,1,3164050,3185437,+,21387
28,BUMA.1121.00040,1,59866,81252,+,21386
28,BUMA.1121.00020,1,486416,507792,+,21376
28,BUMA.1121.00044,1,3288410,3309786,+,21376
28,BUMA.1121.00002,1,1363255,1384642,-,21387
28,BUMA.1121.00087,1,579236,600623,+,21387
28,BUMA.1121.00042,1,133423,154801,+,21378
28,BUMA.1121.00046,1,813819,835206,+,21387
28,BUMA.1121.00036,1,3436875,3458247,+,21372
28,BUMA.1121.00038,1,2825934,2847312,-,21378
28,BUMA.1121.00081,1,2826133,2847511,-,21378
28,BUMA.1121.00034,1,486409,507785,+,21376
28,BUMA.1121.00013,1,864112,885499,-,21387
28,BUMA.1121.00032,1,2154809,2176185,-,21376
28,BUMA.1121.00004,1,486402,507778,+,21376
28,BUMA.1121.00006,1,2826018,2847396,-,21378
28,BUMA.1121.00017,1,486408,507784,+,21376
28,BUMA.1121.00008,1,486423,507799,+,21376
28,BUMA.1121.00028,1,486410,507786,+,21376
28,BUMA.1121.00026,1,1444117,1465495,+,21378
28,BUMA.1121.00010,1,1336430,1357817,-,21387
28,BUMA.1121.00030,1,486408,507784,+,21376
28,BUMA.1121.00019,1,486422,507798,+,21376
29,BUMA.1121.00022,1,716163,751983,+,35820
29,BUMA.1121.00024,1,507778,543598,+,35820
29,BUMA.1121.00054,1,1317158,1353013,+,35855
29,BUMA.1121.00052,1,91632,127487,+,35855
29,BUMA.1121.00048,1,2582778,2618632,-,35854
29,BUMA.1121.00050,1,1880803,1916644,-,35841
29,BUMA.1121.00015,1,499117,534958,+,35841
29,BUMA.1121.00086,1,2699280,2735105,-,35825
29,BUMA.1121.00085,1,3185438,3221293,+,35855
29,BUMA.1121.00040,1,81253,117136,+,35883
29,BUMA.1121.00020,1,507793,543613,+,35820
29,BUMA.1121.00044,1,3309787,3345607,+,35820
29,BUMA.1121.00002,1,1327427,1363253,-,35826
29,BUMA.1121.00087,1,600624,636450,+,35826
29,BUMA.1121.00042,1,154802,191880,+,37078
29,BUMA.1121.00046,1,835207,871049,+,35842
29,BUMA.1121.00036,1,1,35843,+,35842
29,BUMA.1121.00038,1,2790078,2825932,-,35854
29,BUMA.1121.00081,1,2790277,2826131,-,35854
29,BUMA.1121.00034,1,507786,543606,+,35820
29,BUMA.1121.00013,1,828277,864110,-,35833
29,BUMA.1121.00032,1,2118988,2154807,-,35819
29,BUMA.1121.00004,1,507779,543599,+,35820
29,BUMA.1121.00006,1,2790162,2826016,-,35854
29,BUMA.1121.00017,1,507785,543605,+,35820
29,BUMA.1121.00008,1,507800,543620,+,35820
29,BUMA.1121.00028,1,507787,543607,+,35820
29,BUMA.1121.00026,1,1465496,1501352,+,35856
29,BUMA.1121.00010,1,1300602,1336428,-,35826
29,BUMA.1121.00030,1,507785,543605,+,35820
29,BUMA.1121.00019,1,507799,543619,+,35820
60,BUMA.1121.00022,1,1332009,1348134,+,16125
60,BUMA.1121.00024,1,3288059,3304184,-,16125
60,BUMA.1121.00054,1,332238,348359,+,16121
60,BUMA.1121.00052,1,3045481,3061602,-,16121
60,BUMA.1121.00048,1,77242,93366,-,16124
60,BUMA.1121.00050,1,961212,977332,-,16120
60,BUMA.1121.00015,1,709070,725191,+,16121
60,BUMA.1121.00086,1,7478,23603,+,16125
60,BUMA.1121.00085,1,2642427,2658548,-,16121
60,BUMA.1121.00040,1,3332366,3348485,-,16119
60,BUMA.1121.00020,1,3424079,3440204,-,16125
60,BUMA.1121.00044,1,2617781,2633906,-,16125
60,BUMA.1121.00002,1,1814427,1830552,+,16125
60,BUMA.1121.00087,1,3292958,3309083,-,16125
60,BUMA.1121.00042,1,346858,362983,+,16125
60,BUMA.1121.00046,1,1774365,1790486,+,16121
60,BUMA.1121.00036,1,617460,633585,+,16125
60,BUMA.1121.00038,1,284715,300835,-,16120
60,BUMA.1121.00081,1,284784,300904,-,16120
60,BUMA.1121.00034,1,3389611,3405736,-,16125
60,BUMA.1121.00013,1,3337576,3353697,-,16121
60,BUMA.1121.00032,1,1412769,1428894,-,16125
60,BUMA.1121.00004,1,3439499,3455624,-,16125
60,BUMA.1121.00006,1,284715,300835,-,16120
60,BUMA.1121.00017,1,3287276,3303401,-,16125
60,BUMA.1121.00008,1,3370865,3386990,-,16125
60,BUMA.1121.00028,1,3359259,3375384,-,16125
60,BUMA.1121.00026,1,581639,597764,-,16125
60,BUMA.1121.00010,1,1788741,1804865,+,16124
60,BUMA.1121.00030,1,3287343,3303468,-,16125
60,BUMA.1121.00019,1,3310592,3326717,-,16125
61,BUMA.1121.00022,1,1349775,1383152,+,33377
61,BUMA.1121.00024,1,3253064,3286417,-,33353
61,BUMA.1121.00054,1,297644,330997,-,33353
61,BUMA.1121.00052,1,993353,1026667,+,33314
61,BUMA.1121.00048,1,94592,127956,+,33364
61,BUMA.1121.00050,1,926580,959985,-,33405
61,BUMA.1121.00015,1,726418,759779,+,33361
61,BUMA.1121.00086,1,25244,58600,+,33356
61,BUMA.1121.00085,1,590188,623502,+,33314
61,BUMA.1121.00040,1,3349726,3383005,+,33279
61,BUMA.1121.00020,1,3389084,3422437,-,33353
61,BUMA.1121.00044,1,2582786,2616139,-,33353
61,BUMA.1121.00002,1,1832194,1865523,+,33329
61,BUMA.1121.00087,1,3257960,3291315,-,33355
61,BUMA.1121.00042,1,311806,345228,-,33422
61,BUMA.1121.00046,1,1791713,1825117,+,33404
61,BUMA.1121.00036,1,635224,668619,+,33395
61,BUMA.1121.00038,1,302076,335429,+,33353
61,BUMA.1121.00081,1,302145,335498,+,33353
61,BUMA.1121.00034,1,3354616,3387969,-,33353
61,BUMA.1121.00013,1,3520116,3553455,-,33339
61,BUMA.1121.00032,1,1377738,1411127,-,33389
61,BUMA.1121.00004,1,3404504,3437857,-,33353
61,BUMA.1121.00006,1,302076,335429,+,33353
61,BUMA.1121.00017,1,3252281,3285634,-,33353
61,BUMA.1121.00008,1,3335870,3369223,-,33353
61,BUMA.1121.00028,1,3324264,3357617,-,33353
61,BUMA.1121.00026,1,546483,579866,-,33383
61,BUMA.1121.00010,1,1806506,1839834,+,33328
61,BUMA.1121.00030,1,3252348,3285701,-,33353
61,BUMA.1121.00019,1,3275597,3308950,-,33353
62,BUMA.1121.00022,1,1390496,1453228,+,62732
62,BUMA.1121.00024,1,3182875,3245599,-,62724
62,BUMA.1121.00054,1,229471,292181,-,62710
62,BUMA.1121.00052,1,1034133,1096842,+,62709
62,BUMA.1121.00048,1,133420,196130,+,62710
62,BUMA.1121.00050,1,858398,921117,-,62719
62,BUMA.1121.00015,1,2328047,2390760,+,62713
62,BUMA.1121.00086,1,65944,128671,+,62727
62,BUMA.1121.00085,1,630968,693677,+,62709
62,BUMA.1121.00040,1,3265934,3328664,-,62730
62,BUMA.1121.00020,1,3318895,3381619,-,62724
62,BUMA.1121.00044,1,2512597,2575321,-,62724
62,BUMA.1121.00002,1,1871690,1934425,+,62735
62,BUMA.1121.00087,1,3187890,3250617,-,62727
62,BUMA.1121.00042,1,242799,305503,-,62704
62,BUMA.1121.00046,1,1830581,1893300,+,62719
62,BUMA.1121.00036,1,675965,738696,+,62731
62,BUMA.1121.00038,1,340893,403603,+,62710
62,BUMA.1121.00081,1,340962,403672,+,62710
62,BUMA.1121.00034,1,3284427,3347151,-,62724
62,BUMA.1121.00013,1,1230407,1293104,+,62697
62,BUMA.1121.00032,1,1307549,1370273,-,62724
62,BUMA.1121.00004,1,3334315,3397039,-,62724
62,BUMA.1121.00006,1,340893,403603,+,62710
62,BUMA.1121.00017,1,3182092,3244816,-,62724
62,BUMA.1121.00008,1,3265681,3328405,-,62724
62,BUMA.1121.00028,1,3254075,3316799,-,62724
62,BUMA.1121.00026,1,477446,540180,-,62734
62,BUMA.1121.00010,1,1846090,1908823,+,62733
62,BUMA.1121.00030,1,3182160,3244883,-,62723
62,BUMA.1121.00019,1,3205408,3268132,-,62724
63,BUMA.1121.00022,1,1455697,1508433,+,52736
63,BUMA.1121.00024,1,1193607,1246343,+,52736
63,BUMA.1121.00054,1,1701276,1754012,+,52736
63,BUMA.1121.00052,1,884919,937655,+,52736
63,BUMA.1121.00048,1,2181728,2234464,-,52736
63,BUMA.1121.00050,1,2254649,2307401,+,52752
63,BUMA.1121.00015,1,2921740,2974476,-,52736
63,BUMA.1121.00086,1,2140309,2193045,-,52736
63,BUMA.1121.00085,1,481754,534490,+,52736
63,BUMA.1121.00040,1,1121147,1175207,+,54060
63,BUMA.1121.00020,1,1258540,1311276,+,52736
63,BUMA.1121.00044,1,459093,511829,+,52736
63,BUMA.1121.00002,1,1557714,1610450,+,52736
63,BUMA.1121.00087,1,1124043,1176779,+,52736
63,BUMA.1121.00042,1,2977062,3029798,-,52736
63,BUMA.1121.00046,1,444474,497225,-,52751
63,BUMA.1121.00036,1,2727859,2780595,-,52736
63,BUMA.1121.00038,1,2389140,2441876,-,52736
63,BUMA.1121.00081,1,2389267,2442003,-,52736
63,BUMA.1121.00034,1,1230995,1283731,+,52736
63,BUMA.1121.00013,1,48727,101463,-,52736
63,BUMA.1121.00032,1,2723977,2776713,+,52736
63,BUMA.1121.00004,1,1194823,1247559,+,52736
63,BUMA.1121.00006,1,2389057,2441793,-,52736
63,BUMA.1121.00017,1,1128632,1181368,+,52736
63,BUMA.1121.00008,1,1197321,1250057,+,52736
63,BUMA.1121.00028,1,1193651,1246387,+,52736
63,BUMA.1121.00026,1,1857438,1910139,+,52701
63,BUMA.1121.00010,1,1531449,1584185,+,52736
63,BUMA.1121.00030,1,1128672,1181408,+,52736
63,BUMA.1121.00019,1,1193663,1246399,+,52736
64,BUMA.1121.00022,1,1508435,1528659,+,20224
64,BUMA.1121.00024,1,1246345,1266585,+,20240
64,BUMA.1121.00054,1,1754014,1774254,+,20240
64,BUMA.1121.00052,1,937657,957897,+,20240
64,BUMA.1121.00048,1,2161487,2181727,-,20240
64,BUMA.1121.00050,1,2308638,2328867,+,20229
64,BUMA.1121.00015,1,2901499,2921739,-,20240
64,BUMA.1121.00086,1,2120083,2140308,-,20225
64,BUMA.1121.00085,1,534492,554732,+,20240
64,BUMA.1121.00040,1,1175209,1195449,+,20240
64,BUMA.1121.00020,1,1311278,1331518,+,20240
64,BUMA.1121.00044,1,511831,532071,+,20240
64,BUMA.1121.00002,1,1610452,1630692,+,20240
64,BUMA.1121.00087,1,1176781,1197005,+,20224
64,BUMA.1121.00042,1,2956821,2977061,-,20240
64,BUMA.1121.00046,1,423008,443237,-,20229
64,BUMA.1121.00036,1,2707633,2727858,-,20225
64,BUMA.1121.00038,1,2368899,2389139,-,20240
64,BUMA.1121.00081,1,2369026,2389266,-,20240
64,BUMA.1121.00034,1,1283733,1303973,+,20240
64,BUMA.1121.00013,1,28486,48726,-,20240
64,BUMA.1121.00032,1,2776715,2796955,+,20240
64,BUMA.1121.00004,1,1247561,1267801,+,20240
64,BUMA.1121.00006,1,2368816,2389056,-,20240
64,BUMA.1121.00017,1,1181370,1201610,+,20240
64,BUMA.1121.00008,1,1250059,1270299,+,20240
64,BUMA.1121.00028,1,1246389,1266629,+,20240
64,BUMA.1121.00026,1,1910141,1930381,+,20240
64,BUMA.1121.00010,1,1584187,1604427,+,20240
64,BUMA.1121.00030,1,1181410,1201650,+,20240
64,BUMA.1121.00019,1,1246401,1266641,+,20240
65,BUMA.1121.00022,1,1529886,1533264,+,3378
65,BUMA.1121.00024,1,1297610,1300972,-,3362
65,BUMA.1121.00054,1,1775465,1778843,+,3378
65,BUMA.1121.00052,1,988761,992139,-,3378
65,BUMA.1121.00048,1,2156898,2160276,-,3378
65,BUMA.1121.00050,1,2330078,2333456,+,3378
65,BUMA.1121.00015,1,2896910,2900288,-,3378
65,BUMA.1121.00086,1,2115479,2118857,-,3378
65,BUMA.1121.00085,1,585596,588974,-,3378
65,BUMA.1121.00040,1,1196660,1200038,+,3378
65,BUMA.1121.00020,1,1362563,1365925,-,3362
65,BUMA.1121.00044,1,563115,566477,-,3362
65,BUMA.1121.00002,1,417972,421341,+,3369
65,BUMA.1121.00087,1,1198232,1201610,+,3378
65,BUMA.1121.00042,1,958834,962212,-,3378
65,BUMA.1121.00046,1,418410,421797,-,3387
65,BUMA.1121.00036,1,2703029,2706407,-,3378
65,BUMA.1121.00038,1,2364310,2367688,-,3378
65,BUMA.1121.00081,1,2364437,2367815,-,3378
65,BUMA.1121.00034,1,1335017,1338379,-,3362
65,BUMA.1121.00013,1,3554669,3558047,+,3378
65,BUMA.1121.00032,1,2828094,2831456,-,3362
65,BUMA.1121.00004,1,1298849,1302211,-,3362
65,BUMA.1121.00006,1,2364227,2367605,-,3378
65,BUMA.1121.00017,1,1232654,1236016,-,3362
65,BUMA.1121.00008,1,1301343,1304705,-,3362
65,BUMA.1121.00028,1,1297673,1301035,-,3362
65,BUMA.1121.00026,1,398907,402285,-,3378
65,BUMA.1121.00010,1,392672,396026,+,3354
65,BUMA.1121.00030,1,1232694,1236056,-,3362
65,BUMA.1121.00019,1,1297690,1301052,-,3362
66,BUMA.1121.00022,1,1535637,1541485,+,5848
66,BUMA.1121.00024,1,1289389,1295237,-,5848
66,BUMA.1121.00054,1,1781215,1787063,+,5848
66,BUMA.1121.00052,1,980540,986388,-,5848
66,BUMA.1121.00048,1,2148679,2154527,-,5848
66,BUMA.1121.00050,1,2335829,2341677,+,5848
66,BUMA.1121.00015,1,2888689,2894537,-,5848
66,BUMA.1121.00086,1,2107258,2113106,-,5848
66,BUMA.1121.00085,1,577375,583223,-,5848
66,BUMA.1121.00040,1,1202412,1208234,+,5822
66,BUMA.1121.00020,1,1354322,1360170,-,5848
66,BUMA.1121.00044,1,554875,560723,-,5848
66,BUMA.1121.00002,1,424965,430813,+,5848
66,BUMA.1121.00087,1,1203984,1209832,+,5848
66,BUMA.1121.00042,1,950613,956461,-,5848
66,BUMA.1121.00046,1,410189,416037,-,5848
66,BUMA.1121.00036,1,2694809,2700657,-,5848
66,BUMA.1121.00038,1,2356090,2361938,-,5848
66,BUMA.1121.00081,1,2356216,2362065,-,5849
66,BUMA.1121.00034,1,1326777,1332625,-,5848
66,BUMA.1121.00013,1,1,5834,+,5833
66,BUMA.1121.00032,1,2819855,2825703,-,5848
66,BUMA.1121.00004,1,1290605,1296453,-,5848
66,BUMA.1121.00006,1,2356007,2361855,-,5848
66,BUMA.1121.00017,1,1224414,1230262,-,5848
66,BUMA.1121.00008,1,1293103,1298951,-,5848
66,BUMA.1121.00028,1,1289433,1295281,-,5848
66,BUMA.1121.00026,1,390686,396534,-,5848
66,BUMA.1121.00010,1,399641,405489,+,5848
66,BUMA.1121.00030,1,1224454,1230302,-,5848
66,BUMA.1121.00019,1,1289445,1295293,-,5848
67,BUMA.1121.00022,1,1543731,1559827,+,16096
67,BUMA.1121.00024,1,1271115,1287143,-,16028
67,BUMA.1121.00054,1,1789309,1805368,+,16059
67,BUMA.1121.00052,1,962520,978517,-,15997
67,BUMA.1121.00048,1,2130372,2146433,-,16061
67,BUMA.1121.00050,1,2343923,2359986,+,16063
67,BUMA.1121.00015,1,2870349,2886422,-,16073
67,BUMA.1121.00086,1,2088890,2105012,-,16122
67,BUMA.1121.00085,1,559355,575352,-,15997
67,BUMA.1121.00040,1,1210368,1226510,+,16142
67,BUMA.1121.00020,1,1336048,1352076,-,16028
67,BUMA.1121.00044,1,536601,552629,-,16028
67,BUMA.1121.00002,1,1635315,1651023,-,15708
67,BUMA.1121.00087,1,1212078,1228143,+,16065
67,BUMA.1121.00046,1,391879,407943,-,16064
67,BUMA.1121.00038,1,2337783,2353844,-,16061
67,BUMA.1121.00081,1,2337909,2353970,-,16061
67,BUMA.1121.00034,1,1308503,1324531,-,16028
67,BUMA.1121.00013,1,7857,23862,+,16005
67,BUMA.1121.00032,1,2801485,2817609,-,16124
67,BUMA.1121.00004,1,1272331,1288359,-,16028
67,BUMA.1121.00006,1,2337701,2353761,-,16060
67,BUMA.1121.00017,1,1206140,1222168,-,16028
67,BUMA.1121.00008,1,1274829,1290857,-,16028
67,BUMA.1121.00028,1,1271159,1287187,-,16028
67,BUMA.1121.00026,1,371649,387620,-,15971
67,BUMA.1121.00010,1,1609050,1624668,-,15618
67,BUMA.1121.00030,1,1206180,1222208,-,16028
67,BUMA.1121.00019,1,1271171,1287199,-,16028
68,BUMA.1121.00022,1,1564495,1584822,+,20327
68,BUMA.1121.00024,1,1302214,1322544,+,20330
68,BUMA.1121.00054,1,1809993,1830337,+,20344
68,BUMA.1121.00052,1,3023509,3043853,-,20344
68,BUMA.1121.00048,1,2105404,2125748,-,20344
68,BUMA.1121.00050,1,2364611,2384955,+,20344
68,BUMA.1121.00015,1,2845381,2865725,-,20344
68,BUMA.1121.00086,1,2063896,2084222,-,20326
68,BUMA.1121.00085,1,2620455,2640799,-,20344
68,BUMA.1121.00040,1,1231149,1251479,+,20330
68,BUMA.1121.00020,1,1367167,1387497,+,20330
68,BUMA.1121.00044,1,567719,588049,+,20330
68,BUMA.1121.00002,1,396416,416760,-,20344
68,BUMA.1121.00087,1,1232797,1253138,+,20341
68,BUMA.1121.00042,1,2825455,2845789,-,20334
68,BUMA.1121.00046,1,366911,387255,-,20344
68,BUMA.1121.00036,1,2672368,2692694,-,20326
68,BUMA.1121.00038,1,2312815,2333159,-,20344
68,BUMA.1121.00081,1,2312941,2333285,-,20344
68,BUMA.1121.00034,1,1339621,1359951,+,20330
68,BUMA.1121.00013,1,3315605,3335949,-,20344
68,BUMA.1121.00032,1,2832698,2853028,+,20330
68,BUMA.1121.00004,1,1303453,1323783,+,20330
68,BUMA.1121.00006,1,2312733,2333077,-,20344
68,BUMA.1121.00017,1,1237258,1257588,+,20330
68,BUMA.1121.00008,1,1305947,1326277,+,20330
68,BUMA.1121.00028,1,1302277,1322607,+,20330
68,BUMA.1121.00026,1,403497,423830,+,20333
68,BUMA.1121.00010,1,371102,391430,-,20328
68,BUMA.1121.00030,1,1237298,1257628,+,20330
68,BUMA.1121.00019,1,1302294,1322624,+,20330
69,BUMA.1121.00022,1,1588575,1614652,+,26077
69,BUMA.1121.00024,1,1326297,1352205,+,25908
69,BUMA.1121.00054,1,1834354,1860184,-,25830
69,BUMA.1121.00052,1,1103774,1129651,+,25877
69,BUMA.1121.00048,1,2075558,2101388,+,25830
69,BUMA.1121.00050,1,2388711,2414519,+,25808
69,BUMA.1121.00015,1,2300829,2326762,-,25933
69,BUMA.1121.00086,1,2034169,2060143,-,25974
69,BUMA.1121.00085,1,700609,726486,+,25877
69,BUMA.1121.00040,1,1255235,1281266,+,26031
69,BUMA.1121.00020,1,1391250,1417174,+,25924
69,BUMA.1121.00044,1,591802,617702,+,25900
69,BUMA.1121.00002,1,2472101,2497945,+,25844
69,BUMA.1121.00087,1,1256889,1282887,+,25998
69,BUMA.1121.00042,1,2780007,2805922,-,25915
69,BUMA.1121.00046,1,337347,363155,-,25808
69,BUMA.1121.00036,1,742445,768403,+,25958
69,BUMA.1121.00038,1,2282968,2308798,+,25830
69,BUMA.1121.00081,1,2283094,2308924,+,25830
69,BUMA.1121.00034,1,1363704,1389596,+,25892
69,BUMA.1121.00013,1,1300036,1325885,+,25849
69,BUMA.1121.00032,1,2856781,2882665,+,25884
69,BUMA.1121.00004,1,1327536,1353468,+,25932
69,BUMA.1121.00006,1,2282886,2308716,+,25830
69,BUMA.1121.00017,1,1261341,1287233,+,25892
69,BUMA.1121.00008,1,1330030,1355962,+,25932
69,BUMA.1121.00028,1,1326360,1352260,+,25900
69,BUMA.1121.00026,1,444897,470499,+,25602
69,BUMA.1121.00010,1,2449070,2474914,+,25844
69,BUMA.1121.00030,1,1261381,1287281,+,25900
69,BUMA.1121.00019,1,1326377,1352301,+,25924
70,BUMA.1121.00022,1,1616140,1634714,+,18574
70,BUMA.1121.00024,1,1353692,1372278,+,18586
70,BUMA.1121.00054,1,1861396,1879910,+,18514
70,BUMA.1121.00052,1,1131124,1149695,+,18571
70,BUMA.1121.00048,1,2055831,2074346,-,18515
70,BUMA.1121.00050,1,2415992,2434510,+,18518
70,BUMA.1121.00015,1,765170,783696,+,18526
70,BUMA.1121.00086,1,2014107,2032681,-,18574
70,BUMA.1121.00085,1,727959,746530,+,18571
70,BUMA.1121.00040,1,1282754,1301315,+,18561
70,BUMA.1121.00020,1,1418661,1437241,+,18580
70,BUMA.1121.00044,1,619189,637775,+,18586
70,BUMA.1121.00002,1,2499418,2517995,+,18577
70,BUMA.1121.00087,1,1284376,1302950,+,18574
70,BUMA.1121.00042,1,963423,982006,+,18583
70,BUMA.1121.00046,1,317356,335874,-,18518
70,BUMA.1121.00036,1,769875,788476,+,18601
70,BUMA.1121.00038,1,2263241,2281756,-,18515
70,BUMA.1121.00081,1,2263367,2281882,-,18515
70,BUMA.1121.00034,1,1391083,1409669,+,18586
70,BUMA.1121.00013,1,1327358,1345929,+,18571
70,BUMA.1121.00032,1,2884152,2902732,+,18580
70,BUMA.1121.00004,1,1354955,1373541,+,18586
70,BUMA.1121.00006,1,2263159,2281674,-,18515
70,BUMA.1121.00017,1,1288720,1307306,+,18586
70,BUMA.1121.00008,1,1357449,1376029,+,18580
70,BUMA.1121.00028,1,1353747,1372327,+,18580
70,BUMA.1121.00026,1,2042613,2061208,+,18595
70,BUMA.1121.00010,1,2476387,2494964,+,18577
70,BUMA.1121.00030,1,1288768,1307354,+,18586
70,BUMA.1121.00019,1,1353788,1372368,+,18580
71,BUMA.1121.00022,1,1634716,1649138,+,14422
71,BUMA.1121.00024,1,1372280,1386702,+,14422
71,BUMA.1121.00054,1,1879912,1894309,+,14397
71,BUMA.1121.00052,1,1149697,1164103,+,14406
71,BUMA.1121.00048,1,2041432,2055830,-,14398
71,BUMA.1121.00050,1,2435747,2450142,+,14395
71,BUMA.1121.00015,1,783698,798104,+,14406
71,BUMA.1121.00086,1,1999684,2014106,-,14422
71,BUMA.1121.00085,1,746532,760938,+,14406
71,BUMA.1121.00040,1,1301317,1315723,+,14406
71,BUMA.1121.00020,1,1437243,1451665,+,14422
71,BUMA.1121.00044,1,637777,652199,+,14422
71,BUMA.1121.00002,1,2517997,2532396,+,14399
71,BUMA.1121.00087,1,1302952,1317374,+,14422
71,BUMA.1121.00042,1,982008,996417,+,14409
71,BUMA.1121.00046,1,301723,316119,-,14396
71,BUMA.1121.00036,1,788478,802900,+,14422
71,BUMA.1121.00038,1,2248842,2263240,-,14398
71,BUMA.1121.00081,1,2248968,2263366,-,14398
71,BUMA.1121.00034,1,1409671,1424093,+,14422
71,BUMA.1121.00013,1,1345931,1360337,+,14406
71,BUMA.1121.00032,1,2902734,2917156,+,14422
71,BUMA.1121.00004,1,1373543,1387965,+,14422
71,BUMA.1121.00006,1,2248760,2263158,-,14398
71,BUMA.1121.00017,1,1307308,1321730,+,14422
71,BUMA.1121.00008,1,1376031,1390453,+,14422
71,BUMA.1121.00028,1,1372329,1386751,+,14422
71,BUMA.1121.00026,1,2061210,2075619,+,14409
71,BUMA.1121.00010,1,2494966,2509365,+,14399
71,BUMA.1121.00030,1,1307356,1321778,+,14422
71,BUMA.1121.00019,1,1372370,1386792,+,14422
72,BUMA.1121.00022,1,1650719,1689999,+,39280
72,BUMA.1121.00024,1,1388285,1427465,+,39180
72,BUMA.1121.00054,1,1894311,1933600,+,39289
72,BUMA.1121.00052,1,1164105,1203322,+,39217
72,BUMA.1121.00048,1,2002135,2041431,-,39296
72,BUMA.1121.00050,1,2450144,2489346,+,39202
72,BUMA.1121.00015,1,798106,837335,+,39229
72,BUMA.1121.00086,1,1958799,1998101,-,39302
72,BUMA.1121.00085,1,760940,800157,+,39217
72,BUMA.1121.00040,1,1315725,1355005,+,39280
72,BUMA.1121.00020,1,1453248,1492428,+,39180
72,BUMA.1121.00044,1,653782,692965,+,39183
72,BUMA.1121.00002,1,2532398,2571636,+,39238
72,BUMA.1121.00087,1,1318956,1358257,+,39301
72,BUMA.1121.00042,1,996419,1035726,+,39307
72,BUMA.1121.00046,1,262519,301722,-,39203
72,BUMA.1121.00036,1,804483,843844,+,39361
72,BUMA.1121.00038,1,2209551,2248841,-,39290
72,BUMA.1121.00081,1,2209677,2248967,-,39290
72,BUMA.1121.00034,1,1425676,1464859,+,39183
72,BUMA.1121.00013,1,1360339,1399559,+,39220
72,BUMA.1121.00032,1,2918739,2957929,+,39190
72,BUMA.1121.00004,1,1389548,1428671,+,39123
72,BUMA.1121.00006,1,2209459,2248759,-,39300
72,BUMA.1121.00017,1,1323313,1362496,+,39183
72,BUMA.1121.00008,1,1392036,1431215,+,39179
72,BUMA.1121.00028,1,1388334,1427514,+,39180
72,BUMA.1121.00026,1,2075621,2114915,+,39294
72,BUMA.1121.00010,1,2509367,2548575,+,39208
72,BUMA.1121.00030,1,1323361,1362550,+,39189
72,BUMA.1121.00019,1,1388375,1427561,+,39186
73,BUMA.1121.00022,1,1690535,1715678,+,25143
73,BUMA.1121.00024,1,1428001,1453124,+,25123
73,BUMA.1121.00054,1,1934136,1959271,+,25135
73,BUMA.1121.00052,1,1203858,1229019,+,25161
73,BUMA.1121.00048,1,1976465,2001599,-,25134
73,BUMA.1121.00050,1,2489882,2515029,+,25147
73,BUMA.1121.00015,1,837871,863031,+,25160
73,BUMA.1121.00086,1,1933121,1958263,-,25142
73,BUMA.1121.00085,1,800693,825854,+,25161
73,BUMA.1121.00040,1,1355541,1380666,+,25125
73,BUMA.1121.00020,1,1492964,1518087,+,25123
73,BUMA.1121.00044,1,693501,718624,+,25123
73,BUMA.1121.00002,1,2572172,2597281,+,25109
73,BUMA.1121.00087,1,1358793,1383936,+,25143
73,BUMA.1121.00042,1,1036262,1061375,+,25113
73,BUMA.1121.00046,1,236837,261983,-,25146
73,BUMA.1121.00036,1,844380,869503,+,25123
73,BUMA.1121.00038,1,2183881,2209015,-,25134
73,BUMA.1121.00081,1,2184007,2209141,-,25134
73,BUMA.1121.00034,1,1465395,1490518,+,25123
73,BUMA.1121.00013,1,1400095,1425244,+,25149
73,BUMA.1121.00032,1,2958465,2983588,+,25123
73,BUMA.1121.00004,1,1429207,1454330,+,25123
73,BUMA.1121.00006,1,2183789,2208923,-,25134
73,BUMA.1121.00017,1,1363032,1388155,+,25123
73,BUMA.1121.00008,1,1431751,1456874,+,25123
73,BUMA.1121.00028,1,1428050,1453173,+,25123
73,BUMA.1121.00026,1,2115451,2140580,+,25129
73,BUMA.1121.00010,1,2549111,2574220,+,25109
73,BUMA.1121.00030,1,1363086,1388208,+,25122
73,BUMA.1121.00019,1,1428097,1453220,+,25123
74,BUMA.1121.00022,1,1721799,1729738,+,7939
74,BUMA.1121.00024,1,1456241,1464180,+,7939
74,BUMA.1121.00054,1,1963835,1971774,+,7939
74,BUMA.1121.00052,1,1230576,1238515,+,7939
74,BUMA.1121.00048,1,1963960,1971900,-,7940
74,BUMA.1121.00050,1,2517253,2525192,+,7939
74,BUMA.1121.00015,1,867607,875546,+,7939
74,BUMA.1121.00086,1,1919059,1926999,-,7940
74,BUMA.1121.00085,1,827411,835350,+,7939
74,BUMA.1121.00040,1,1386810,1394745,+,7935
74,BUMA.1121.00020,1,1521204,1529143,+,7939
74,BUMA.1121.00044,1,721741,729680,+,7939
74,BUMA.1121.00002,1,2600396,2608337,+,7941
74,BUMA.1121.00087,1,1390057,1397996,+,7939
74,BUMA.1121.00042,1,2947558,2955498,-,7940
74,BUMA.1121.00046,1,226673,234613,-,7940
74,BUMA.1121.00036,1,872619,880558,+,7939
74,BUMA.1121.00038,1,2171377,2179317,-,7940
74,BUMA.1121.00081,1,2171503,2179443,-,7940
74,BUMA.1121.00034,1,1493635,1501574,+,7939
74,BUMA.1121.00013,1,1431401,1439340,+,7939
74,BUMA.1121.00032,1,2986705,2994644,+,7939
74,BUMA.1121.00004,1,1457447,1465386,+,7939
74,BUMA.1121.00006,1,2171285,2179225,-,7940
74,BUMA.1121.00017,1,1391272,1399211,+,7939
74,BUMA.1121.00008,1,1459991,1467930,+,7939
74,BUMA.1121.00028,1,1456290,1464229,+,7939
74,BUMA.1121.00026,1,1931606,1939545,+,7939
74,BUMA.1121.00010,1,2578203,2586144,+,7941
74,BUMA.1121.00030,1,1391325,1399264,+,7939
74,BUMA.1121.00019,1,1456337,1464276,+,7939
75,BUMA.1121.00022,1,1730268,1754137,+,23869
75,BUMA.1121.00024,1,1464710,1488459,+,23749
75,BUMA.1121.00054,1,1972304,1996116,+,23812
75,BUMA.1121.00052,1,1239045,1262978,+,23933
75,BUMA.1121.00048,1,1939619,1963430,-,23811
75,BUMA.1121.00050,1,2525722,2549702,+,23980
75,BUMA.1121.00015,1,876076,899984,+,23908
75,BUMA.1121.00086,1,1894533,1918529,-,23996
75,BUMA.1121.00085,1,835880,859868,+,23988
75,BUMA.1121.00040,1,1395275,1419199,+,23924
75,BUMA.1121.00020,1,1529673,1553430,+,23757
75,BUMA.1121.00044,1,730210,753983,+,23773
75,BUMA.1121.00002,1,2608867,2632567,+,23700
75,BUMA.1121.00087,1,1398526,1422339,+,23813
75,BUMA.1121.00042,1,2923185,2947028,-,23843
75,BUMA.1121.00046,1,202107,226143,-,24036
75,BUMA.1121.00036,1,881088,904941,+,23853
75,BUMA.1121.00038,1,2147036,2170847,-,23811
75,BUMA.1121.00081,1,2147162,2170973,-,23811
75,BUMA.1121.00034,1,1502104,1525885,+,23781
75,BUMA.1121.00013,1,1439870,1463850,+,23980
75,BUMA.1121.00032,1,2995174,3018955,+,23781
75,BUMA.1121.00004,1,1465916,1489641,+,23725
75,BUMA.1121.00006,1,2146952,2170755,-,23803
75,BUMA.1121.00017,1,1399741,1423514,+,23773
75,BUMA.1121.00008,1,1468460,1492185,+,23725
75,BUMA.1121.00028,1,1464759,1488508,+,23749
75,BUMA.1121.00026,1,1940075,1963864,+,23789
75,BUMA.1121.00010,1,2586674,2610318,+,23644
75,BUMA.1121.00030,1,1399794,1423567,+,23773
75,BUMA.1121.00019,1,1464806,1488563,+,23757
76,BUMA.1121.00022,1,1756010,1783435,+,27425
76,BUMA.1121.00024,1,1489879,1517304,+,27425
76,BUMA.1121.00054,1,1996747,2024201,+,27454
76,BUMA.1121.00052,1,1263609,1291063,+,27454
76,BUMA.1121.00048,1,1911533,1938988,-,27455
76,BUMA.1121.00050,1,2550333,2577760,+,27427
76,BUMA.1121.00015,1,900615,928051,+,27436
76,BUMA.1121.00086,1,1865225,1892659,-,27434
76,BUMA.1121.00085,1,860499,887953,+,27454
76,BUMA.1121.00040,1,1419830,1447257,+,27427
76,BUMA.1121.00020,1,1554850,1582275,+,27425
76,BUMA.1121.00044,1,755403,782828,+,27425
76,BUMA.1121.00002,1,2633198,2660634,+,27436
76,BUMA.1121.00087,1,1424212,1451646,+,27434
76,BUMA.1121.00042,1,2895148,2922554,-,27406
76,BUMA.1121.00046,1,174048,201476,-,27428
76,BUMA.1121.00036,1,906180,933614,+,27434
76,BUMA.1121.00038,1,2118950,2146405,-,27455
76,BUMA.1121.00081,1,2119076,2146531,-,27455
76,BUMA.1121.00034,1,1527305,1554730,+,27425
76,BUMA.1121.00013,1,1464481,1491926,+,27445
76,BUMA.1121.00032,1,3020375,3047800,+,27425
76,BUMA.1121.00004,1,1491061,1518486,+,27425
76,BUMA.1121.00006,1,2118866,2146321,-,27455
76,BUMA.1121.00017,1,1424934,1452359,+,27425
76,BUMA.1121.00008,1,1493605,1521030,+,27425
76,BUMA.1121.00028,1,1489928,1517353,+,27425
76,BUMA.1121.00026,1,1964495,1991976,+,27481
76,BUMA.1121.00010,1,2610949,2638385,+,27436
76,BUMA.1121.00030,1,1424987,1452412,+,27425
76,BUMA.1121.00019,1,1489983,1517408,+,27425
77,BUMA.1121.00022,1,1784533,1826534,+,42001
77,BUMA.1121.00024,1,1518402,1560386,+,41984
77,BUMA.1121.00054,1,2025299,2066420,+,41121
77,BUMA.1121.00052,1,1292161,1333289,+,41128
77,BUMA.1121.00048,1,1869315,1910435,-,41120
77,BUMA.1121.00050,1,2578858,2619878,+,41020
77,BUMA.1121.00015,1,929149,970177,+,41028
77,BUMA.1121.00086,1,1822117,1864127,-,42010
77,BUMA.1121.00085,1,889051,930179,+,41128
77,BUMA.1121.00040,1,1448355,1489401,+,41046
77,BUMA.1121.00020,1,1583373,1625357,+,41984
77,BUMA.1121.00044,1,783926,825910,+,41984
77,BUMA.1121.00002,1,2661732,2703659,+,41927
77,BUMA.1121.00087,1,1452744,1494755,+,42011
77,BUMA.1121.00042,1,2852195,2894050,-,41855
77,BUMA.1121.00046,1,131931,172950,-,41019
77,BUMA.1121.00036,1,934712,976747,+,42035
77,BUMA.1121.00038,1,2076732,2117852,-,41120
77,BUMA.1121.00081,1,2076858,2117978,-,41120
77,BUMA.1121.00034,1,1555828,1597812,+,41984
77,BUMA.1121.00013,1,1493024,1534120,+,41096
77,BUMA.1121.00032,1,3048898,3090882,+,41984
77,BUMA.1121.00004,1,1519584,1561568,+,41984
77,BUMA.1121.00006,1,2076645,2117768,-,41123
77,BUMA.1121.00017,1,1453457,1495441,+,41984
77,BUMA.1121.00008,1,1522128,1564112,+,41984
77,BUMA.1121.00028,1,1518451,1560435,+,41984
77,BUMA.1121.00026,1,1993074,2034954,+,41880
77,BUMA.1121.00010,1,2639483,2681410,+,41927
77,BUMA.1121.00030,1,1453510,1495494,+,41984
77,BUMA.1121.00019,1,1518506,1560490,+,41984
78,BUMA.1121.00022,1,1828025,1831728,+,3703
78,BUMA.1121.00024,1,1561877,1565564,+,3687
78,BUMA.1121.00054,1,2067911,2071598,+,3687
78,BUMA.1121.00052,1,1334780,1338467,+,3687
78,BUMA.1121.00048,1,1864136,1867823,-,3687
78,BUMA.1121.00050,1,2622596,2626296,+,3700
78,BUMA.1121.00015,1,971668,975355,+,3687
78,BUMA.1121.00086,1,1816923,1820625,-,3702
78,BUMA.1121.00085,1,931670,935357,+,3687
78,BUMA.1121.00040,1,1490892,1494581,+,3689
78,BUMA.1121.00020,1,1626848,1630535,+,3687
78,BUMA.1121.00044,1,827401,831088,+,3687
78,BUMA.1121.00002,1,2705150,2708837,+,3687
78,BUMA.1121.00087,1,1496246,1499949,+,3703
78,BUMA.1121.00042,1,2847001,2850703,-,3702
78,BUMA.1121.00046,1,125512,129213,-,3701
78,BUMA.1121.00036,1,978238,981941,+,3703
78,BUMA.1121.00038,1,2071553,2075240,-,3687
78,BUMA.1121.00081,1,2071679,2075366,-,3687
78,BUMA.1121.00034,1,1599303,1602990,+,3687
78,BUMA.1121.00013,1,1535611,1539298,+,3687
78,BUMA.1121.00032,1,3092373,3096060,+,3687
78,BUMA.1121.00004,1,1563059,1566746,+,3687
78,BUMA.1121.00006,1,2071466,2075153,-,3687
78,BUMA.1121.00017,1,1496932,1500619,+,3687
78,BUMA.1121.00008,1,1565603,1569306,+,3703
78,BUMA.1121.00028,1,1561926,1565613,+,3687
78,BUMA.1121.00026,1,2037699,2041402,+,3703
78,BUMA.1121.00010,1,2682901,2686604,+,3703
78,BUMA.1121.00030,1,1496985,1500672,+,3687
78,BUMA.1121.00019,1,1561981,1565668,+,3687
79,BUMA.1121.00022,1,1833076,1847373,+,14297
79,BUMA.1121.00024,1,3121347,3135644,+,14297
79,BUMA.1121.00054,1,168012,182309,+,14297
79,BUMA.1121.00052,1,2956024,2970321,-,14297
79,BUMA.1121.00048,1,243294,257591,-,14297
79,BUMA.1121.00050,1,796909,811206,+,14297
79,BUMA.1121.00015,1,2439173,2453470,-,14297
79,BUMA.1121.00086,1,183709,198006,+,14297
79,BUMA.1121.00085,1,2552970,2567267,-,14297
79,BUMA.1121.00040,1,3197090,3211387,-,14297
79,BUMA.1121.00020,1,3257367,3271664,+,14297
79,BUMA.1121.00044,1,2451069,2465366,+,14297
79,BUMA.1121.00002,1,1990654,2004951,+,14297
79,BUMA.1121.00087,1,3118559,3132856,-,14297
79,BUMA.1121.00042,1,1114687,1128963,+,14276
79,BUMA.1121.00046,1,1940492,1954789,-,14297
79,BUMA.1121.00036,1,2602975,2617272,-,14297
79,BUMA.1121.00038,1,450765,465062,-,14297
79,BUMA.1121.00081,1,450834,465131,-,14297
79,BUMA.1121.00034,1,3222899,3237196,+,14297
79,BUMA.1121.00013,1,3248120,3262417,-,14297
79,BUMA.1121.00032,1,1246021,1260318,+,14297
79,BUMA.1121.00004,1,3272787,3287084,+,14297
79,BUMA.1121.00006,1,450765,465062,-,14297
79,BUMA.1121.00017,1,3120564,3134861,+,14297
79,BUMA.1121.00008,1,3204153,3218450,+,14297
79,BUMA.1121.00028,1,3192547,3206844,+,14297
79,BUMA.1121.00026,1,2192287,2206563,+,14276
79,BUMA.1121.00010,1,1963800,1978097,+,14297
79,BUMA.1121.00030,1,3120632,3134929,+,14297
79,BUMA.1121.00019,1,3143880,3158177,+,14297
80,BUMA.1121.00022,1,1848935,1867142,+,18207
80,BUMA.1121.00024,1,3137206,3155413,+,18207
80,BUMA.1121.00054,1,183871,202066,+,18195
80,BUMA.1121.00052,1,2936266,2954462,-,18196
80,BUMA.1121.00048,1,223536,241732,-,18196
80,BUMA.1121.00050,1,812768,830963,+,18195
80,BUMA.1121.00015,1,2419415,2437611,-,18196
80,BUMA.1121.00086,1,199568,217769,+,18201
80,BUMA.1121.00085,1,2533212,2551408,-,18196
80,BUMA.1121.00040,1,3177332,3195528,-,18196
80,BUMA.1121.00020,1,3273226,3291433,+,18207
80,BUMA.1121.00044,1,2466928,2485135,+,18207
80,BUMA.1121.00002,1,2006514,2024745,+,18231
80,BUMA.1121.00087,1,3098795,3116997,-,18202
80,BUMA.1121.00042,1,1128965,1147160,+,18195
80,BUMA.1121.00046,1,1920734,1938930,-,18196
80,BUMA.1121.00036,1,2583218,2601414,-,18196
80,BUMA.1121.00038,1,431007,449203,-,18196
80,BUMA.1121.00081,1,431076,449272,-,18196
80,BUMA.1121.00034,1,3238758,3256965,+,18207
80,BUMA.1121.00013,1,3228362,3246558,-,18196
80,BUMA.1121.00032,1,1261880,1280087,+,18207
80,BUMA.1121.00004,1,3288646,3306853,+,18207
80,BUMA.1121.00006,1,431007,449203,-,18196
80,BUMA.1121.00017,1,3136423,3154630,+,18207
80,BUMA.1121.00008,1,3220012,3238219,+,18207
80,BUMA.1121.00028,1,3208406,3226613,+,18207
80,BUMA.1121.00026,1,2206565,2224766,+,18201
80,BUMA.1121.00010,1,1979653,1997884,+,18231
80,BUMA.1121.00030,1,3136491,3154698,+,18207
80,BUMA.1121.00019,1,3159739,3177946,+,18207
81,BUMA.1121.00022,1,1867718,1883950,+,16232
81,BUMA.1121.00024,1,3155989,3172211,+,16222
81,BUMA.1121.00054,1,202642,218847,+,16205
81,BUMA.1121.00052,1,2919474,2935691,-,16217
81,BUMA.1121.00048,1,206741,222961,-,16220
81,BUMA.1121.00050,1,831539,847774,+,16235
81,BUMA.1121.00015,1,2402624,2418840,-,16216
81,BUMA.1121.00086,1,218345,234562,+,16217
81,BUMA.1121.00085,1,2516420,2532637,-,16217
81,BUMA.1121.00040,1,3160524,3176757,-,16233
81,BUMA.1121.00020,1,3292009,3308231,+,16222
81,BUMA.1121.00044,1,2485711,2501933,+,16222
81,BUMA.1121.00002,1,2025321,2041547,+,16226
81,BUMA.1121.00087,1,3082002,3098220,-,16218
81,BUMA.1121.00042,1,1147736,1163966,+,16230
81,BUMA.1121.00046,1,1903923,1920159,-,16236
81,BUMA.1121.00036,1,2565179,2581388,-,16209
81,BUMA.1121.00038,1,414226,430432,-,16206
81,BUMA.1121.00081,1,414295,430501,-,16206
81,BUMA.1121.00034,1,3257541,3273763,+,16222
81,BUMA.1121.00013,1,3211570,3227787,-,16217
81,BUMA.1121.00032,1,1280663,1296885,+,16222
81,BUMA.1121.00004,1,3307429,3323651,+,16222
81,BUMA.1121.00006,1,414226,430432,-,16206
81,BUMA.1121.00017,1,3155206,3171428,+,16222
81,BUMA.1121.00008,1,3238795,3255017,+,16222
81,BUMA.1121.00028,1,3227189,3243411,+,16222
81,BUMA.1121.00026,1,2225342,2241574,+,16232
81,BUMA.1121.00010,1,1998460,2014686,+,16226
81,BUMA.1121.00030,1,3155274,3171496,+,16222
81,BUMA.1121.00019,1,3178522,3194744,+,16222
82,BUMA.1121.00022,1,1885512,1890340,+,4828
82,BUMA.1121.00024,1,3173791,3178636,+,4845
82,BUMA.1121.00054,1,220426,225235,+,4809
82,BUMA.1121.00052,1,2913040,2917894,-,4854
82,BUMA.1121.00048,1,200365,205174,-,4809
82,BUMA.1121.00050,1,849353,854162,+,4809
82,BUMA.1121.00015,1,2396231,2401044,-,4813
82,BUMA.1121.00086,1,236141,240959,+,4818
82,BUMA.1121.00085,1,2509986,2514840,-,4854
82,BUMA.1121.00040,1,3154109,3158944,-,4835
82,BUMA.1121.00020,1,3309811,3314656,+,4845
82,BUMA.1121.00044,1,2503513,2508358,+,4845
82,BUMA.1121.00002,1,2043096,2047965,+,4869
82,BUMA.1121.00087,1,3075605,3080423,-,4818
82,BUMA.1121.00042,1,1165515,1170349,+,4834
82,BUMA.1121.00046,1,1897535,1902344,-,4809
82,BUMA.1121.00036,1,2558773,2563600,-,4827
82,BUMA.1121.00038,1,407838,412647,-,4809
82,BUMA.1121.00081,1,407907,412716,-,4809
82,BUMA.1121.00034,1,3275343,3280188,+,4845
82,BUMA.1121.00013,1,3205154,3209990,-,4836
82,BUMA.1121.00032,1,1298465,1303310,+,4845
82,BUMA.1121.00004,1,3325231,3330076,+,4845
82,BUMA.1121.00006,1,407838,412647,-,4809
82,BUMA.1121.00017,1,3173008,3177853,+,4845
82,BUMA.1121.00008,1,3256597,3261442,+,4845
82,BUMA.1121.00028,1,3244991,3249836,+,4845
82,BUMA.1121.00026,1,2243124,2247984,+,4860
82,BUMA.1121.00010,1,2016255,2021109,+,4854
82,BUMA.1121.00030,1,3173076,3177921,+,4845
82,BUMA.1121.00019,1,3196324,3201169,+,4845
83,BUMA.1121.00022,1,1894627,1901742,+,7115
83,BUMA.1121.00024,1,3059457,3066587,-,7130
83,BUMA.1121.00054,1,107398,114528,-,7130
83,BUMA.1121.00052,1,2901683,2908776,-,7093
83,BUMA.1121.00048,1,311071,318200,+,7129
83,BUMA.1121.00050,1,733738,740868,-,7130
83,BUMA.1121.00015,1,2500852,2507997,+,7145
83,BUMA.1121.00086,1,245245,252367,+,7122
83,BUMA.1121.00085,1,2498629,2505722,-,7093
83,BUMA.1121.00040,1,3142702,3149845,-,7143
83,BUMA.1121.00020,1,3195484,3202607,-,7123
83,BUMA.1121.00044,1,2396235,2403358,-,7123
83,BUMA.1121.00002,1,2052233,2059378,+,7145
83,BUMA.1121.00087,1,3064215,3071338,-,7123
83,BUMA.1121.00042,1,1174611,1181736,+,7125
83,BUMA.1121.00046,1,2010829,2017958,+,7129
83,BUMA.1121.00036,1,2547343,2554473,-,7130
83,BUMA.1121.00038,1,518546,525675,+,7129
83,BUMA.1121.00081,1,518615,525744,+,7129
83,BUMA.1121.00034,1,3168065,3175188,-,7123
83,BUMA.1121.00013,1,3193804,3200890,-,7086
83,BUMA.1121.00032,1,1184138,1191261,-,7123
83,BUMA.1121.00004,1,3210904,3218027,-,7123
83,BUMA.1121.00006,1,518546,525675,+,7129
83,BUMA.1121.00017,1,3065730,3072853,-,7123
83,BUMA.1121.00008,1,3142270,3149393,-,7123
83,BUMA.1121.00028,1,3130664,3137787,-,7123
83,BUMA.1121.00026,1,2252246,2259364,+,7118
83,BUMA.1121.00010,1,2025375,2032520,+,7145
83,BUMA.1121.00030,1,3065798,3072921,-,7123
83,BUMA.1121.00019,1,3081997,3089120,-,7123
84,BUMA.1121.00022,1,1902984,1914212,+,11228
84,BUMA.1121.00024,1,1567450,1578680,+,11230
84,BUMA.1121.00054,1,2073484,2084705,+,11221
84,BUMA.1121.00052,1,1340353,1351574,+,11221
84,BUMA.1121.00048,1,1851029,1862251,-,11222
84,BUMA.1121.00050,1,2628182,2639403,+,11221
84,BUMA.1121.00015,1,977241,988462,+,11221
84,BUMA.1121.00086,1,253609,264837,+,11228
84,BUMA.1121.00085,1,937243,948464,+,11221
84,BUMA.1121.00040,1,1496384,1507614,+,11230
84,BUMA.1121.00020,1,1632421,1643651,+,11230
84,BUMA.1121.00044,1,832974,844204,+,11230
84,BUMA.1121.00002,1,2710723,2721953,+,11230
84,BUMA.1121.00087,1,3051745,3062973,-,11228
84,BUMA.1121.00042,1,2807793,2819014,+,11221
84,BUMA.1121.00046,1,112405,123627,-,11222
84,BUMA.1121.00036,1,2534890,2546121,-,11231
84,BUMA.1121.00038,1,2058446,2069668,-,11222
84,BUMA.1121.00081,1,2058572,2069794,-,11222
84,BUMA.1121.00034,1,1604876,1616106,+,11230
84,BUMA.1121.00013,1,1541184,1552405,+,11221
84,BUMA.1121.00032,1,3097946,3109176,+,11230
84,BUMA.1121.00004,1,1568632,1579862,+,11230
84,BUMA.1121.00006,1,2058359,2069581,-,11222
84,BUMA.1121.00017,1,1502505,1513735,+,11230
84,BUMA.1121.00028,1,1567499,1578729,+,11230
84,BUMA.1121.00026,1,431804,443026,-,11222
84,BUMA.1121.00010,1,2688474,2699704,+,11230
84,BUMA.1121.00030,1,1502558,1513788,+,11230
84,BUMA.1121.00019,1,1567554,1578784,+,11230
85,BUMA.1121.00022,1,1914268,1918496,+,4228
85,BUMA.1121.00024,1,1578736,1582964,+,4228
85,BUMA.1121.00054,1,2084761,2088989,+,4228
85,BUMA.1121.00052,1,1351630,1355858,+,4228
85,BUMA.1121.00048,1,1846746,1850974,-,4228
85,BUMA.1121.00050,1,2639459,2643687,+,4228
85,BUMA.1121.00015,1,988518,992746,+,4228
85,BUMA.1121.00086,1,264893,269121,+,4228
85,BUMA.1121.00085,1,948520,952748,+,4228
85,BUMA.1121.00040,1,1507670,1511898,+,4228
85,BUMA.1121.00020,1,1643707,1647935,+,4228
85,BUMA.1121.00044,1,844260,848488,+,4228
85,BUMA.1121.00002,1,2722009,2726237,+,4228
85,BUMA.1121.00087,1,3047462,3051690,-,4228
85,BUMA.1121.00042,1,2819070,2823276,+,4206
85,BUMA.1121.00046,1,108122,112350,-,4228
85,BUMA.1121.00036,1,2530607,2534835,-,4228
85,BUMA.1121.00038,1,2054163,2058391,-,4228
85,BUMA.1121.00081,1,2054289,2058517,-,4228
85,BUMA.1121.00034,1,1616162,1620390,+,4228
85,BUMA.1121.00013,1,1552461,1556689,+,4228
85,BUMA.1121.00032,1,3109232,3113460,+,4228
85,BUMA.1121.00004,1,1579918,1584146,+,4228
85,BUMA.1121.00006,1,2054076,2058304,-,4228
85,BUMA.1121.00017,1,1513791,1518019,+,4228
85,BUMA.1121.00008,1,1570618,1574845,+,4227
85,BUMA.1121.00008,1,1577682,1581910,+,4228
85,BUMA.1121.00008,1,1584747,1588975,+,4228
85,BUMA.1121.00008,1,1591812,1596040,+,4228
85,BUMA.1121.00028,1,1578785,1583013,+,4228
85,BUMA.1121.00026,1,427521,431749,-,4228
85,BUMA.1121.00010,1,2699760,2703988,+,4228
85,BUMA.1121.00030,1,1513844,1518072,+,4228
85,BUMA.1121.00019,1,1578840,1583068,+,4228
86,BUMA.1121.00022,1,1921231,1951083,+,29852
86,BUMA.1121.00024,1,1585699,1615496,+,29797
86,BUMA.1121.00054,1,2091724,2121531,+,29807
86,BUMA.1121.00052,1,1385218,1415053,+,29835
86,BUMA.1121.00048,1,1814203,1844011,-,29808
86,BUMA.1121.00050,1,2646435,2676247,+,29812
86,BUMA.1121.00015,1,995481,1025276,+,29795
86,BUMA.1121.00086,1,271856,301660,+,29804
86,BUMA.1121.00085,1,982108,1011943,+,29835
86,BUMA.1121.00040,1,1514632,1544487,+,29855
86,BUMA.1121.00020,1,1650670,1680467,+,29797
86,BUMA.1121.00044,1,851223,881028,+,29805
86,BUMA.1121.00002,1,2728972,2758778,+,29806
86,BUMA.1121.00087,1,3014922,3044727,-,29805
86,BUMA.1121.00042,1,2748693,2778535,-,29842
86,BUMA.1121.00046,1,75561,105374,-,29813
86,BUMA.1121.00036,1,2498039,2527872,-,29833
86,BUMA.1121.00038,1,2021620,2051428,-,29808
86,BUMA.1121.00081,1,2021746,2051554,-,29808
86,BUMA.1121.00034,1,1623125,1652930,+,29805
86,BUMA.1121.00013,1,1586039,1615864,+,29825
86,BUMA.1121.00032,1,3116195,3146004,+,29809
86,BUMA.1121.00004,1,1586881,1616684,+,29803
86,BUMA.1121.00006,1,2021533,2051341,-,29808
86,BUMA.1121.00017,1,1520754,1550559,+,29805
86,BUMA.1121.00008,1,1598775,1628572,+,29797
86,BUMA.1121.00028,1,1585748,1615545,+,29797
86,BUMA.1121.00026,1,337213,367060,-,29847
86,BUMA.1121.00010,1,2706723,2736530,+,29807
86,BUMA.1121.00030,1,1520807,1550612,+,29805
86,BUMA.1121.00019,1,1585803,1615600,+,29797
87,BUMA.1121.00022,1,1951814,2025842,+,74028
87,BUMA.1121.00024,1,1616227,1690184,+,73957
87,BUMA.1121.00054,1,2122262,2196342,+,74080
87,BUMA.1121.00052,1,1415784,1489858,+,74074
87,BUMA.1121.00048,1,1739395,1813472,-,74077
87,BUMA.1121.00050,1,2676978,2751035,+,74057
87,BUMA.1121.00015,1,1026007,1100129,+,74122
87,BUMA.1121.00086,1,302391,376566,+,74175
87,BUMA.1121.00085,1,1012674,1086769,+,74095
87,BUMA.1121.00040,1,1545218,1619226,+,74008
87,BUMA.1121.00020,1,1681198,1755169,+,73971
87,BUMA.1121.00044,1,881759,955737,+,73978
87,BUMA.1121.00002,1,2759509,2833474,+,73965
87,BUMA.1121.00087,1,2940206,3014191,-,73985
87,BUMA.1121.00042,1,2674054,2747962,-,73908
87,BUMA.1121.00046,1,768,74830,-,74062
87,BUMA.1121.00036,1,2423217,2497308,-,74091
87,BUMA.1121.00038,1,1946817,2020889,-,74072
87,BUMA.1121.00081,1,1946936,2021015,-,74079
87,BUMA.1121.00034,1,1653661,1727639,+,73978
87,BUMA.1121.00013,1,1616595,1690751,+,74156
87,BUMA.1121.00032,1,3146735,3220712,+,73977
87,BUMA.1121.00004,1,1617415,1691443,+,74028
87,BUMA.1121.00006,1,1946723,2020802,-,74079
87,BUMA.1121.00017,1,1551290,1625268,+,73978
87,BUMA.1121.00008,1,1629303,1703284,+,73981
87,BUMA.1121.00028,1,1616276,1690219,+,73943
87,BUMA.1121.00026,1,262540,336482,-,73942
87,BUMA.1121.00010,1,2737261,2811309,+,74048
87,BUMA.1121.00030,1,1551343,1625321,+,73978
87,BUMA.1121.00019,1,1616331,1690309,+,73978
88,BUMA.1121.00022,1,2026595,2038954,+,12359
88,BUMA.1121.00024,1,1690937,1703296,+,12359
88,BUMA.1121.00054,1,2197095,2209454,+,12359
88,BUMA.1121.00052,1,1490611,1502970,+,12359
88,BUMA.1121.00048,1,1726283,1738642,-,12359
88,BUMA.1121.00050,1,2751788,2765461,+,13673
88,BUMA.1121.00015,1,1100882,1113241,+,12359
88,BUMA.1121.00086,1,377319,389678,+,12359
88,BUMA.1121.00085,1,1087522,1099881,+,12359
88,BUMA.1121.00040,1,1619979,1632341,+,12362
88,BUMA.1121.00020,1,1755922,1768281,+,12359
88,BUMA.1121.00044,1,956490,968849,+,12359
88,BUMA.1121.00002,1,2834227,2846586,+,12359
88,BUMA.1121.00087,1,2927094,2939453,-,12359
88,BUMA.1121.00042,1,2660946,2673301,-,12355
88,BUMA.1121.00046,1,3495392,3509051,-,13659
88,BUMA.1121.00036,1,2410105,2422464,-,12359
88,BUMA.1121.00038,1,1933705,1946064,-,12359
88,BUMA.1121.00081,1,1933824,1946183,-,12359
88,BUMA.1121.00034,1,1728392,1740751,+,12359
88,BUMA.1121.00013,1,1691504,1703863,+,12359
88,BUMA.1121.00032,1,3221465,3233824,+,12359
88,BUMA.1121.00004,1,1692196,1704555,+,12359
88,BUMA.1121.00006,1,1933611,1945970,-,12359
88,BUMA.1121.00017,1,1626021,1638380,+,12359
88,BUMA.1121.00008,1,1704037,1716396,+,12359
88,BUMA.1121.00028,1,1690972,1703331,+,12359
88,BUMA.1121.00026,1,249428,261787,-,12359
88,BUMA.1121.00010,1,2812062,2824421,+,12359
88,BUMA.1121.00030,1,1626074,1638433,+,12359
88,BUMA.1121.00019,1,1691062,1703421,+,12359
89,BUMA.1121.00022,1,2038993,2082547,+,43554
89,BUMA.1121.00024,1,1703335,1746889,+,43554
89,BUMA.1121.00054,1,2209493,2254287,+,44794
89,BUMA.1121.00052,1,1503009,1546563,+,43554
89,BUMA.1121.00048,1,1681450,1726244,-,44794
89,BUMA.1121.00050,1,2765500,2810294,+,44794
89,BUMA.1121.00015,1,1113280,1158074,+,44794
89,BUMA.1121.00086,1,389717,433271,+,43554
89,BUMA.1121.00085,1,1099920,1143474,+,43554
89,BUMA.1121.00040,1,1632380,1675934,+,43554
89,BUMA.1121.00020,1,1768320,1811874,+,43554
89,BUMA.1121.00044,1,968888,1012442,+,43554
89,BUMA.1121.00002,1,2847865,2891419,+,43554
89,BUMA.1121.00087,1,2883501,2927055,-,43554
89,BUMA.1121.00042,1,2617362,2660907,-,43545
89,BUMA.1121.00046,1,3450559,3495353,-,44794
89,BUMA.1121.00036,1,2366512,2410066,-,43554
89,BUMA.1121.00038,1,1888872,1933666,-,44794
89,BUMA.1121.00081,1,1888991,1933785,-,44794
89,BUMA.1121.00034,1,1740790,1784344,+,43554
89,BUMA.1121.00013,1,1703902,1747456,+,43554
89,BUMA.1121.00032,1,3233863,3277417,+,43554
89,BUMA.1121.00004,1,1704594,1748148,+,43554
89,BUMA.1121.00006,1,1888778,1933572,-,44794
89,BUMA.1121.00017,1,1638419,1681973,+,43554
89,BUMA.1121.00008,1,1716435,1759989,+,43554
89,BUMA.1121.00028,1,1703370,1746924,+,43554
89,BUMA.1121.00026,1,205913,249389,-,43476
89,BUMA.1121.00010,1,2825700,2869254,+,43554
89,BUMA.1121.00030,1,1638472,1682026,+,43554
89,BUMA.1121.00019,1,1703460,1747014,+,43554
90,BUMA.1121.00022,1,2089894,2120102,+,30208
90,BUMA.1121.00024,1,1754238,1784154,+,29916
90,BUMA.1121.00054,1,2261636,2291748,+,30112
90,BUMA.1121.00052,1,1553909,1583740,+,29831
90,BUMA.1121.00048,1,1643970,1674101,-,30131
90,BUMA.1121.00050,1,2817642,2847728,+,30086
90,BUMA.1121.00015,1,1165424,1195536,+,30112
90,BUMA.1121.00086,1,440620,470632,+,30012
90,BUMA.1121.00085,1,1150823,1180685,+,29862
90,BUMA.1121.00040,1,1683283,1713267,+,29984
90,BUMA.1121.00020,1,1819223,1849013,+,29790
90,BUMA.1121.00044,1,1019791,1049742,+,29951
90,BUMA.1121.00002,1,2898766,2928499,+,29733
90,BUMA.1121.00087,1,2846126,2876151,-,30025
90,BUMA.1121.00042,1,2579069,2608764,-,29695
90,BUMA.1121.00046,1,3413462,3443209,-,29747
90,BUMA.1121.00036,1,2329324,2359162,-,29838
90,BUMA.1121.00038,1,1851425,1881522,-,30097
90,BUMA.1121.00081,1,1851509,1881641,-,30132
90,BUMA.1121.00034,1,1791693,1821616,+,29923
90,BUMA.1121.00013,1,1754805,1784779,+,29974
90,BUMA.1121.00032,1,3284765,3314589,+,29824
90,BUMA.1121.00004,1,1755497,1785417,+,29920
90,BUMA.1121.00006,1,1851436,1881428,-,29992
90,BUMA.1121.00017,1,1689322,1719266,+,29944
90,BUMA.1121.00008,1,1767338,1797197,+,29859
90,BUMA.1121.00028,1,1754273,1784201,+,29928
90,BUMA.1121.00026,1,168655,198564,-,29909
90,BUMA.1121.00010,1,2876601,2906222,+,29621
90,BUMA.1121.00030,1,1689375,1719322,+,29947
90,BUMA.1121.00019,1,1754363,1784258,+,29895
91,BUMA.1121.00022,1,2122523,2183233,+,60710
91,BUMA.1121.00024,1,1786575,1847323,+,60748
91,BUMA.1121.00054,1,957285,1017829,+,60544
91,BUMA.1121.00052,1,1585058,1645924,+,60866
91,BUMA.1121.00048,1,2917960,2978504,-,60544
91,BUMA.1121.00050,1,399930,460682,-,60752
91,BUMA.1121.00015,1,2781022,2841626,+,60604
91,BUMA.1121.00086,1,473053,533689,+,60636
91,BUMA.1121.00085,1,1182003,1242869,+,60866
91,BUMA.1121.00040,1,1715688,1776499,+,60811
91,BUMA.1121.00020,1,1851434,1912278,+,60844
91,BUMA.1121.00044,1,1052163,1112926,+,60763
91,BUMA.1121.00002,1,2930920,2992868,+,61948
91,BUMA.1121.00087,1,2783068,2843705,-,60637
91,BUMA.1121.00042,1,2515950,2576673,-,60723
91,BUMA.1121.00046,1,2291027,2351805,+,60778
91,BUMA.1121.00036,1,2266311,2326903,-,60592
91,BUMA.1121.00038,1,3125276,3185820,-,60544
91,BUMA.1121.00081,1,3125468,3186005,-,60537
91,BUMA.1121.00034,1,1824037,1884786,+,60749
91,BUMA.1121.00013,1,1786097,1847034,+,60937
91,BUMA.1121.00032,1,3317010,3377807,+,60797
91,BUMA.1121.00004,1,1787838,1848607,+,60769
91,BUMA.1121.00006,1,3125353,3185897,-,60544
91,BUMA.1121.00017,1,1721687,1782432,+,60745
91,BUMA.1121.00008,1,1799618,1860414,+,60796
91,BUMA.1121.00028,1,1786622,1847370,+,60748
91,BUMA.1121.00026,1,105190,166259,-,61069
91,BUMA.1121.00010,1,2908643,2970491,+,61848
91,BUMA.1121.00030,1,1721743,1782506,+,60763
91,BUMA.1121.00019,1,1786679,1847481,+,60802
92,BUMA.1121.00022,1,2184444,2224819,+,40375
92,BUMA.1121.00024,1,1848565,1888814,+,40249
92,BUMA.1121.00054,1,3313605,3354005,-,40400
92,BUMA.1121.00052,1,1647166,1687481,+,40315
92,BUMA.1121.00048,1,581704,622104,+,40400
92,BUMA.1121.00050,1,358415,398688,-,40273
92,BUMA.1121.00015,1,2259036,2299356,-,40320
92,BUMA.1121.00086,1,534930,575211,+,40281
92,BUMA.1121.00085,1,1244111,1284426,+,40315
92,BUMA.1121.00040,1,1778950,1819404,+,40454
92,BUMA.1121.00020,1,1913520,1953769,+,40249
92,BUMA.1121.00044,1,1114168,1154425,+,40257
92,BUMA.1121.00002,1,2994091,3034465,+,40374
92,BUMA.1121.00087,1,2741547,2781827,-,40280
92,BUMA.1121.00042,1,2474377,2514739,-,40362
92,BUMA.1121.00046,1,2353047,2393321,+,40274
92,BUMA.1121.00036,1,2224734,2265085,-,40351
92,BUMA.1121.00038,1,789178,829578,+,40400
92,BUMA.1121.00081,1,789247,829647,+,40400
92,BUMA.1121.00034,1,1886028,1926285,+,40257
92,BUMA.1121.00013,1,1848246,1888561,+,40315
92,BUMA.1121.00032,1,3379049,3419298,+,40249
92,BUMA.1121.00004,1,1849849,1890097,+,40248
92,BUMA.1121.00006,1,789177,829572,+,40395
92,BUMA.1121.00017,1,1783674,1823931,+,40257
92,BUMA.1121.00008,1,1861656,1901905,+,40249
92,BUMA.1121.00028,1,1848612,1888861,+,40249
92,BUMA.1121.00026,1,63680,103979,-,40299
92,BUMA.1121.00010,1,2971733,3012042,+,40309
92,BUMA.1121.00030,1,1783748,1824005,+,40257
92,BUMA.1121.00019,1,1848723,1888972,+,40249
93,BUMA.1121.00022,1,2224820,2234381,+,9561
93,BUMA.1121.00024,1,1888815,1898376,+,9561
93,BUMA.1121.00054,1,3304042,3313603,-,9561
93,BUMA.1121.00052,1,1687482,1697043,+,9561
93,BUMA.1121.00048,1,622105,631666,+,9561
93,BUMA.1121.00050,1,348837,358413,-,9576
93,BUMA.1121.00015,1,2249458,2259034,-,9576
93,BUMA.1121.00086,1,575212,584789,+,9577
93,BUMA.1121.00085,1,1284427,1293988,+,9561
93,BUMA.1121.00040,1,1819405,1828982,+,9577
93,BUMA.1121.00020,1,1953770,1963331,+,9561
93,BUMA.1121.00044,1,1154426,1163987,+,9561
93,BUMA.1121.00002,1,3034466,3044043,+,9577
93,BUMA.1121.00087,1,2731969,2741545,-,9576
93,BUMA.1121.00042,1,2463559,2473141,-,9582
93,BUMA.1121.00046,1,2393322,2402899,+,9577
93,BUMA.1121.00036,1,2215156,2224732,-,9576
93,BUMA.1121.00038,1,829579,839140,+,9561
93,BUMA.1121.00081,1,829648,839209,+,9561
93,BUMA.1121.00034,1,1926286,1935847,+,9561
93,BUMA.1121.00013,1,1888562,1898139,+,9577
93,BUMA.1121.00032,1,3419299,3428860,+,9561
93,BUMA.1121.00004,1,1890098,1899659,+,9561
93,BUMA.1121.00006,1,829573,839134,+,9561
93,BUMA.1121.00017,1,1823932,1833493,+,9561
93,BUMA.1121.00008,1,1901906,1911467,+,9561
93,BUMA.1121.00028,1,1888862,1898423,+,9561
93,BUMA.1121.00026,1,52872,62454,+,9582
93,BUMA.1121.00010,1,3012043,3021604,+,9561
93,BUMA.1121.00030,1,1824006,1833567,+,9561
93,BUMA.1121.00019,1,1888973,1898534,+,9561
94,BUMA.1121.00022,1,2237561,2289064,+,51503
94,BUMA.1121.00024,1,1901556,1953066,+,51510
94,BUMA.1121.00054,1,3249362,3300863,-,51501
94,BUMA.1121.00052,1,1700223,1751721,+,51498
94,BUMA.1121.00048,1,634846,686347,+,51501
94,BUMA.1121.00050,1,294151,345673,-,51522
94,BUMA.1121.00015,1,2194730,2246294,-,51564
94,BUMA.1121.00086,1,587953,639455,+,51502
94,BUMA.1121.00085,1,1297168,1348666,+,51498
94,BUMA.1121.00040,1,1832146,1883661,+,51515
94,BUMA.1121.00020,1,1966511,2018021,+,51510
94,BUMA.1121.00044,1,1167167,1218677,+,51510
94,BUMA.1121.00002,1,3047208,3098707,+,51499
94,BUMA.1121.00087,1,2677304,2728806,-,51502
94,BUMA.1121.00046,1,2406063,2457585,+,51522
94,BUMA.1121.00036,1,2160482,2211995,-,51513
94,BUMA.1121.00038,1,842320,893821,+,51501
94,BUMA.1121.00081,1,842389,893890,+,51501
94,BUMA.1121.00034,1,1939027,1990537,+,51510
94,BUMA.1121.00013,1,2338668,2390166,-,51498
94,BUMA.1121.00032,1,3432040,3483550,+,51510
94,BUMA.1121.00004,1,1902839,1954349,+,51510
94,BUMA.1121.00006,1,842314,893815,+,51501
94,BUMA.1121.00017,1,1836673,1888183,+,51510
94,BUMA.1121.00008,1,1914647,1966157,+,51510
94,BUMA.1121.00028,1,1901603,1953113,+,51510
94,BUMA.1121.00026,1,1,51634,-,51633
94,BUMA.1121.00010,1,3024784,3076283,+,51499
94,BUMA.1121.00030,1,1836747,1888257,+,51510
94,BUMA.1121.00019,1,1901714,1953224,+,51510
95,BUMA.1121.00022,1,2289065,2292977,+,3912
95,BUMA.1121.00024,1,1953067,1956979,+,3912
95,BUMA.1121.00054,1,3245449,3249360,-,3911
95,BUMA.1121.00052,1,1751722,1755625,+,3903
95,BUMA.1121.00048,1,686348,690260,+,3912
95,BUMA.1121.00050,1,290246,294149,-,3903
95,BUMA.1121.00015,1,2190824,2194728,-,3904
95,BUMA.1121.00086,1,639456,643359,+,3903
95,BUMA.1121.00085,1,1348667,1352570,+,3903
95,BUMA.1121.00040,1,1883662,1887574,+,3912
95,BUMA.1121.00020,1,2018022,2021934,+,3912
95,BUMA.1121.00044,1,1218678,1222590,+,3912
95,BUMA.1121.00002,1,3098708,3102620,+,3912
95,BUMA.1121.00087,1,2673391,2677302,-,3911
95,BUMA.1121.00046,1,2457586,2461489,+,3903
95,BUMA.1121.00036,1,2156577,2160480,-,3903
95,BUMA.1121.00038,1,893822,897734,+,3912
95,BUMA.1121.00081,1,893891,897803,+,3912
95,BUMA.1121.00034,1,1990538,1994450,+,3912
95,BUMA.1121.00013,1,2334763,2338666,-,3903
95,BUMA.1121.00032,1,3483551,3487463,+,3912
95,BUMA.1121.00004,1,1954350,1958262,+,3912
95,BUMA.1121.00006,1,893816,897728,+,3912
95,BUMA.1121.00017,1,1888184,1892096,+,3912
95,BUMA.1121.00008,1,1966158,1970070,+,3912
95,BUMA.1121.00028,1,1953114,1957026,+,3912
95,BUMA.1121.00026,1,3546696,3550623,-,3927
95,BUMA.1121.00010,1,3076284,3080196,+,3912
95,BUMA.1121.00030,1,1888258,1892170,+,3912
95,BUMA.1121.00019,1,1953225,1957137,+,3912
96,BUMA.1121.00022,1,2294207,2312234,+,18027
96,BUMA.1121.00024,1,1958198,1976224,+,18026
96,BUMA.1121.00054,1,3226192,3244219,-,18027
96,BUMA.1121.00052,1,1756864,1774890,+,18026
96,BUMA.1121.00048,1,691490,709517,+,18027
96,BUMA.1121.00050,1,270981,289004,-,18023
96,BUMA.1121.00015,1,2171561,2189588,-,18027
96,BUMA.1121.00086,1,644598,662625,+,18027
96,BUMA.1121.00085,1,1353809,1371835,+,18026
96,BUMA.1121.00040,1,2469240,2487267,-,18027
96,BUMA.1121.00020,1,2023153,2041179,+,18026
96,BUMA.1121.00044,1,1223809,1241835,+,18026
96,BUMA.1121.00002,1,2268482,2286509,+,18027
96,BUMA.1121.00087,1,2654133,2672160,-,18027
96,BUMA.1121.00042,1,2444318,2462344,-,18026
96,BUMA.1121.00046,1,2462731,2480755,+,18024
96,BUMA.1121.00036,1,2137313,2155339,-,18026
96,BUMA.1121.00038,1,898964,916991,+,18027
96,BUMA.1121.00081,1,899033,917060,+,18027
96,BUMA.1121.00034,1,1995669,2013722,+,18053
96,BUMA.1121.00013,1,2315498,2333525,-,18027
96,BUMA.1121.00032,1,25100,43126,+,18026
96,BUMA.1121.00032,1,3488682,3506640,+,17958
96,BUMA.1121.00004,1,1959481,1977507,+,18026
96,BUMA.1121.00006,1,898958,916985,+,18027
96,BUMA.1121.00017,1,1893315,1911341,+,18026
96,BUMA.1121.00008,1,1971289,1989315,+,18026
96,BUMA.1121.00028,1,1958245,1976271,+,18026
96,BUMA.1121.00026,1,3527450,3545477,-,18027
96,BUMA.1121.00010,1,2241621,2259647,+,18026
96,BUMA.1121.00030,1,1893389,1911415,+,18026
96,BUMA.1121.00019,1,1958356,1976382,+,18026
97,BUMA.1121.00022,1,2312996,2319744,+,6748
97,BUMA.1121.00024,1,1976986,1983734,+,6748
97,BUMA.1121.00054,1,3218687,3225429,-,6742
97,BUMA.1121.00052,1,1775652,1782400,+,6748
97,BUMA.1121.00048,1,710279,717021,+,6742
97,BUMA.1121.00050,1,263470,270218,-,6748
97,BUMA.1121.00015,1,2164050,2170798,-,6748
97,BUMA.1121.00086,1,663387,670135,+,6748
97,BUMA.1121.00085,1,1372597,1379345,+,6748
97,BUMA.1121.00040,1,2461730,2468477,-,6747
97,BUMA.1121.00020,1,2041941,2048689,+,6748
97,BUMA.1121.00044,1,1242597,1249345,+,6748
97,BUMA.1121.00002,1,2287271,2294019,+,6748
97,BUMA.1121.00087,1,2646622,2653370,-,6748
97,BUMA.1121.00042,1,2436807,2443555,-,6748
97,BUMA.1121.00046,1,2481517,2488265,+,6748
97,BUMA.1121.00036,1,2129802,2136550,-,6748
97,BUMA.1121.00038,1,917753,924495,+,6742
97,BUMA.1121.00081,1,917822,924564,+,6742
97,BUMA.1121.00034,1,2014484,2021232,+,6748
97,BUMA.1121.00013,1,2307987,2314735,-,6748
97,BUMA.1121.00032,1,43888,50636,+,6748
97,BUMA.1121.00004,1,1978269,1985017,+,6748
97,BUMA.1121.00006,1,917747,924489,+,6742
97,BUMA.1121.00017,1,1912103,1918851,+,6748
97,BUMA.1121.00008,1,1990077,1996825,+,6748
97,BUMA.1121.00028,1,1977033,1983781,+,6748
97,BUMA.1121.00026,1,3519939,3526687,-,6748
97,BUMA.1121.00010,1,2260409,2267157,+,6748
97,BUMA.1121.00030,1,1912177,1918925,+,6748
97,BUMA.1121.00019,1,1977144,1983892,+,6748
98,BUMA.1121.00022,1,2320347,2336162,+,15815
98,BUMA.1121.00024,1,1984337,2000116,+,15779
98,BUMA.1121.00054,1,3202280,3218085,-,15805
98,BUMA.1121.00052,1,1783003,1798761,+,15758
98,BUMA.1121.00048,1,717624,733429,+,15805
98,BUMA.1121.00050,1,247098,262868,-,15770
98,BUMA.1121.00015,1,2147669,2163448,-,15779
98,BUMA.1121.00086,1,670738,686526,+,15788
98,BUMA.1121.00085,1,1379948,1395706,+,15758
98,BUMA.1121.00040,1,2445313,2461128,-,15815
98,BUMA.1121.00020,1,2049292,2065071,+,15779
98,BUMA.1121.00044,1,1249948,1265727,+,15779
98,BUMA.1121.00002,1,2294622,2310419,+,15797
98,BUMA.1121.00087,1,2630241,2646020,-,15779
98,BUMA.1121.00042,1,2420380,2436205,-,15825
98,BUMA.1121.00046,1,2488868,2504638,+,15770
98,BUMA.1121.00036,1,2113403,2129200,-,15797
98,BUMA.1121.00038,1,925098,940903,+,15805
98,BUMA.1121.00081,1,925167,940972,+,15805
98,BUMA.1121.00034,1,2021835,2037614,+,15779
98,BUMA.1121.00013,1,2291609,2307385,-,15776
98,BUMA.1121.00032,1,51239,67018,+,15779
98,BUMA.1121.00004,1,1985620,2001399,+,15779
98,BUMA.1121.00006,1,925092,940895,+,15803
98,BUMA.1121.00017,1,1919454,1935233,+,15779
98,BUMA.1121.00008,1,1997428,2013207,+,15779
98,BUMA.1121.00028,1,1984384,2000163,+,15779
98,BUMA.1121.00026,1,3503512,3519337,-,15825
98,BUMA.1121.00010,1,2267760,2283542,+,15782
98,BUMA.1121.00030,1,1919528,1935307,+,15779
98,BUMA.1121.00019,1,1984495,2000274,+,15779
99,BUMA.1121.00022,1,2337373,2366934,+,29561
99,BUMA.1121.00024,1,2001327,2030906,+,29579
99,BUMA.1121.00054,1,3171507,3201069,-,29562
99,BUMA.1121.00052,1,1799972,1829541,+,29569
99,BUMA.1121.00048,1,734640,764201,+,29561
99,BUMA.1121.00050,1,216308,245888,-,29580
99,BUMA.1121.00015,1,2116896,2146458,-,29562
99,BUMA.1121.00086,1,687737,717289,+,29552
99,BUMA.1121.00085,1,1396917,1426486,+,29569
99,BUMA.1121.00040,1,2049135,2078705,+,29570
99,BUMA.1121.00020,1,2066282,2095852,+,29570
99,BUMA.1121.00044,1,1266938,1296508,+,29570
99,BUMA.1121.00002,1,2311630,2341209,+,29579
99,BUMA.1121.00087,1,2599476,2629029,-,29553
99,BUMA.1121.00042,1,2389606,2419169,-,29563
99,BUMA.1121.00046,1,2505849,2535428,+,29579
99,BUMA.1121.00036,1,2082630,2112192,-,29562
99,BUMA.1121.00038,1,942114,971675,+,29561
99,BUMA.1121.00081,1,942183,971744,+,29561
99,BUMA.1121.00034,1,2038825,2068395,+,29570
99,BUMA.1121.00013,1,2260827,2290398,-,29571
99,BUMA.1121.00032,1,68229,97799,+,29570
99,BUMA.1121.00004,1,2002610,2032180,+,29570
99,BUMA.1121.00006,1,942106,971667,+,29561
99,BUMA.1121.00017,1,1936444,1966014,+,29570
99,BUMA.1121.00008,1,2014418,2043988,+,29570
99,BUMA.1121.00028,1,2001374,2030953,+,29579
99,BUMA.1121.00026,1,3472739,3502301,-,29562
99,BUMA.1121.00010,1,2284753,2314332,+,29579
99,BUMA.1121.00030,1,1936518,1966088,+,29570
99,BUMA.1121.00019,1,2001485,2031055,+,29570
100,BUMA.1121.00022,1,2367475,2371237,+,3762
100,BUMA.1121.00024,1,2031447,2035209,+,3762
100,BUMA.1121.00054,1,3167204,3170966,-,3762
100,BUMA.1121.00052,1,1830082,1833844,+,3762
100,BUMA.1121.00048,1,764742,768504,+,3762
100,BUMA.1121.00050,1,212005,215767,-,3762
100,BUMA.1121.00015,1,2112593,2116355,-,3762
100,BUMA.1121.00086,1,717830,721592,+,3762
100,BUMA.1121.00085,1,1427027,1430789,+,3762
100,BUMA.1121.00040,1,2079246,2083008,+,3762
100,BUMA.1121.00020,1,2096393,2100155,+,3762
100,BUMA.1121.00044,1,1297049,1300811,+,3762
100,BUMA.1121.00002,1,2341750,2345512,+,3762
100,BUMA.1121.00087,1,2595173,2598935,-,3762
100,BUMA.1121.00042,1,2385303,2389065,-,3762
100,BUMA.1121.00046,1,2535969,2539731,+,3762
100,BUMA.1121.00036,1,2078327,2082089,-,3762
100,BUMA.1121.00038,1,972216,975978,+,3762
100,BUMA.1121.00081,1,972285,976047,+,3762
100,BUMA.1121.00034,1,2068936,2072698,+,3762
100,BUMA.1121.00013,1,2256524,2260286,-,3762
100,BUMA.1121.00032,1,98340,102102,+,3762
100,BUMA.1121.00004,1,2032721,2036483,+,3762
100,BUMA.1121.00006,1,972208,975970,+,3762
100,BUMA.1121.00017,1,1966555,1970317,+,3762
100,BUMA.1121.00008,1,2044529,2048291,+,3762
100,BUMA.1121.00028,1,2031494,2035256,+,3762
100,BUMA.1121.00026,1,3468436,3472198,-,3762
100,BUMA.1121.00010,1,2314873,2318635,+,3762
100,BUMA.1121.00030,1,1966629,1970391,+,3762
100,BUMA.1121.00019,1,2031596,2035358,+,3762
101,BUMA.1121.00022,1,2371239,2394129,+,22890
101,BUMA.1121.00024,1,2035211,2058104,+,22893
101,BUMA.1121.00054,1,3144307,3167203,-,22896
101,BUMA.1121.00052,1,1833846,1856708,+,22862
101,BUMA.1121.00048,1,768506,791401,+,22895
101,BUMA.1121.00050,1,189120,212004,-,22884
101,BUMA.1121.00015,1,2089741,2112592,-,22851
101,BUMA.1121.00086,1,721594,744468,+,22874
101,BUMA.1121.00085,1,1430791,1453653,+,22862
101,BUMA.1121.00040,1,2083010,2105887,+,22877
101,BUMA.1121.00020,1,2100157,2123050,+,22893
101,BUMA.1121.00044,1,1300813,1323697,+,22884
101,BUMA.1121.00002,1,2345514,2368413,+,22899
101,BUMA.1121.00087,1,2572297,2595172,-,22875
101,BUMA.1121.00042,1,2362430,2385302,-,22872
101,BUMA.1121.00046,1,2539733,2562616,+,22883
101,BUMA.1121.00036,1,2055451,2078326,-,22875
101,BUMA.1121.00038,1,975980,998875,+,22895
101,BUMA.1121.00081,1,976049,998944,+,22895
101,BUMA.1121.00034,1,2072700,2095584,+,22884
101,BUMA.1121.00013,1,2233668,2256523,-,22855
101,BUMA.1121.00032,1,46,22925,+,22879
101,BUMA.1121.00032,1,102104,124997,+,22893
101,BUMA.1121.00004,1,2036485,2058102,+,21617
101,BUMA.1121.00006,1,975972,998867,+,22895
101,BUMA.1121.00017,1,1970319,1993203,+,22884
101,BUMA.1121.00008,1,2048293,2071186,+,22893
101,BUMA.1121.00028,1,2035258,2058151,+,22893
101,BUMA.1121.00026,1,3445500,3468435,-,22935
101,BUMA.1121.00010,1,2318637,2341536,+,22899
101,BUMA.1121.00030,1,1970393,1993277,+,22884
101,BUMA.1121.00019,1,2035360,2058244,+,22884
102,BUMA.1121.00022,1,2396303,2449614,+,53311
102,BUMA.1121.00054,1,3089298,3142569,-,53271
102,BUMA.1121.00048,1,793140,846410,+,53270
102,BUMA.1121.00050,1,3231203,3284494,+,53291
102,BUMA.1121.00015,1,2034737,2088003,-,53266
102,BUMA.1121.00040,1,2108039,2161280,+,53241
102,BUMA.1121.00002,1,3103838,3157202,+,53364
102,BUMA.1121.00042,1,1639981,1693157,+,53176
102,BUMA.1121.00046,1,2976708,3030007,-,53299
102,BUMA.1121.00038,1,1000614,1053884,+,53270
102,BUMA.1121.00081,1,1000683,1053953,+,53270
102,BUMA.1121.00013,1,2178695,2231932,-,53237
102,BUMA.1121.00006,1,1000606,1053876,+,53270
102,BUMA.1121.00026,1,3065254,3118409,+,53155
102,BUMA.1121.00010,1,3081412,3134685,+,53273
103,BUMA.1121.00022,1,2450886,2464975,+,14089
103,BUMA.1121.00054,1,3073938,3088026,-,14088
103,BUMA.1121.00048,1,847682,861771,+,14089
103,BUMA.1121.00050,1,3285766,3299850,+,14084
103,BUMA.1121.00015,1,2019377,2033465,-,14088
103,BUMA.1121.00040,1,2162552,2176621,+,14069
103,BUMA.1121.00002,1,3158474,3172563,+,14089
103,BUMA.1121.00042,1,1694429,1708514,+,14085
103,BUMA.1121.00046,1,2961353,2975436,-,14083
103,BUMA.1121.00038,1,1055156,1069245,+,14089
103,BUMA.1121.00081,1,1055225,1069314,+,14089
103,BUMA.1121.00013,1,2163335,2177423,-,14088
103,BUMA.1121.00006,1,1055148,1069237,+,14089
103,BUMA.1121.00026,1,3119681,3133766,+,14085
103,BUMA.1121.00010,1,3135957,3150045,+,14088
104,BUMA.1121.00022,1,2464976,2470687,+,5711
104,BUMA.1121.00054,1,3068225,3073936,-,5711
104,BUMA.1121.00048,1,861772,867483,+,5711
104,BUMA.1121.00050,1,3299851,3305562,+,5711
104,BUMA.1121.00015,1,2013664,2019375,-,5711
104,BUMA.1121.00002,1,3172564,3178275,+,5711
104,BUMA.1121.00042,1,1708515,1714193,+,5678
104,BUMA.1121.00046,1,2955640,2961351,-,5711
104,BUMA.1121.00038,1,1069246,1074957,+,5711
104,BUMA.1121.00081,1,1069315,1075026,+,5711
104,BUMA.1121.00013,1,2157622,2163333,-,5711
104,BUMA.1121.00006,1,1069238,1074949,+,5711
104,BUMA.1121.00026,1,3133767,3139445,+,5678
104,BUMA.1121.00010,1,3150046,3155757,+,5711
105,BUMA.1121.00022,1,2472595,2476009,+,3414
105,BUMA.1121.00054,1,3063071,3066501,-,3430
105,BUMA.1121.00048,1,869223,872637,+,3414
105,BUMA.1121.00050,1,3307302,3310718,+,3416
105,BUMA.1121.00015,1,2008510,2011940,-,3430
105,BUMA.1121.00002,1,3180057,3183471,+,3414
105,BUMA.1121.00042,1,1715975,1719391,+,3416
105,BUMA.1121.00046,1,2950486,2953916,-,3430
105,BUMA.1121.00038,1,1076697,1080111,+,3414
105,BUMA.1121.00081,1,1076766,1080180,+,3414
105,BUMA.1121.00013,1,2152719,2156150,-,3431
105,BUMA.1121.00006,1,1076689,1080103,+,3414
105,BUMA.1121.00026,1,3141227,3144643,+,3416
105,BUMA.1121.00010,1,3157665,3161081,+,3416
106,BUMA.1121.00022,1,2477236,2490684,+,13448
106,BUMA.1121.00024,1,2303638,2317071,-,13433
106,BUMA.1121.00054,1,2837162,2850595,+,13433
106,BUMA.1121.00052,1,2112369,2125802,-,13433
106,BUMA.1121.00048,1,1085117,1098550,-,13433
106,BUMA.1121.00050,1,13664,27097,-,13433
106,BUMA.1121.00015,1,1739191,1752639,+,13448
106,BUMA.1121.00086,1,746656,760089,+,13433
106,BUMA.1121.00085,1,1709315,1722748,-,13433
106,BUMA.1121.00040,1,2430654,2444102,-,13448
106,BUMA.1121.00020,1,2368472,2381905,-,13433
106,BUMA.1121.00044,1,1569117,1582550,-,13433
106,BUMA.1121.00002,1,3184697,3198145,+,13448
106,BUMA.1121.00087,1,2556676,2570109,-,13433
106,BUMA.1121.00042,1,1452249,1465697,+,13448
106,BUMA.1121.00046,1,2724634,2738067,+,13433
106,BUMA.1121.00036,1,2039830,2053263,-,13433
106,BUMA.1121.00038,1,1292604,1306037,-,13433
106,BUMA.1121.00081,1,1292665,1306098,-,13433
106,BUMA.1121.00034,1,2340997,2354430,-,13433
106,BUMA.1121.00013,1,2393786,2407219,-,13433
106,BUMA.1121.00032,1,370482,383915,-,13433
106,BUMA.1121.00004,1,2303504,2316937,-,13433
106,BUMA.1121.00006,1,1292587,1306020,-,13433
106,BUMA.1121.00017,1,2238632,2252065,-,13433
106,BUMA.1121.00008,1,2316605,2330038,-,13433
106,BUMA.1121.00028,1,2303613,2317046,-,13433
106,BUMA.1121.00026,1,2877391,2890839,+,13448
106,BUMA.1121.00010,1,3162306,3175754,+,13448
106,BUMA.1121.00030,1,2238695,2252128,-,13433
106,BUMA.1121.00019,1,2268526,2281959,-,13433
107,BUMA.1121.00022,1,2493225,2504221,+,10996
107,BUMA.1121.00024,1,2290102,2301098,-,10996
107,BUMA.1121.00054,1,2853136,2864141,+,11005
107,BUMA.1121.00052,1,2098842,2109829,-,10987
107,BUMA.1121.00048,1,1071572,1082577,-,11005
107,BUMA.1121.00050,1,128,11124,-,10996
107,BUMA.1121.00015,1,1755180,1766167,+,10987
107,BUMA.1121.00086,1,762630,773626,+,10996
107,BUMA.1121.00085,1,1695788,1706775,-,10987
107,BUMA.1121.00040,1,2418356,2429352,-,10996
107,BUMA.1121.00020,1,2354936,2365932,-,10996
107,BUMA.1121.00044,1,1555581,1566577,-,10996
107,BUMA.1121.00002,1,127046,138042,-,10996
107,BUMA.1121.00087,1,2543139,2554135,-,10996
107,BUMA.1121.00042,1,1467587,1478583,+,10996
107,BUMA.1121.00046,1,2740608,2751604,+,10996
107,BUMA.1121.00036,1,2026294,2037290,-,10996
107,BUMA.1121.00038,1,1279059,1290064,-,11005
107,BUMA.1121.00081,1,1279120,1290125,-,11005
107,BUMA.1121.00034,1,2327461,2338457,-,10996
107,BUMA.1121.00013,1,1900223,1911210,+,10987
107,BUMA.1121.00032,1,356946,367942,-,10996
107,BUMA.1121.00004,1,2289968,2300964,-,10996
107,BUMA.1121.00006,1,1279042,1290047,-,11005
107,BUMA.1121.00017,1,2225096,2236092,-,10996
107,BUMA.1121.00008,1,2303069,2314065,-,10996
107,BUMA.1121.00028,1,2290077,2301073,-,10996
107,BUMA.1121.00026,1,2892729,2903715,+,10986
107,BUMA.1121.00010,1,103035,114031,-,10996
107,BUMA.1121.00030,1,2225159,2236155,-,10996
107,BUMA.1121.00019,1,2254990,2265986,-,10996
108,BUMA.1121.00022,1,2504460,2513178,+,8718
108,BUMA.1121.00024,1,2281157,2289863,-,8706
108,BUMA.1121.00054,1,2865620,2874326,+,8706
108,BUMA.1121.00052,1,2089885,2098603,-,8718
108,BUMA.1121.00048,1,1061388,1070094,-,8706
108,BUMA.1121.00050,1,3543282,3552012,-,8730
108,BUMA.1121.00015,1,1767409,1776088,+,8679
108,BUMA.1121.00086,1,773865,782583,+,8718
108,BUMA.1121.00085,1,1686831,1695549,-,8718
108,BUMA.1121.00040,1,2409423,2418117,-,8694
108,BUMA.1121.00020,1,2345991,2354697,-,8706
108,BUMA.1121.00044,1,1546636,1555342,-,8706
108,BUMA.1121.00002,1,118101,126807,-,8706
108,BUMA.1121.00087,1,2534182,2542900,-,8718
108,BUMA.1121.00042,1,1478822,1487516,+,8694
108,BUMA.1121.00046,1,2753083,2761813,+,8730
108,BUMA.1121.00036,1,2017349,2026055,-,8706
108,BUMA.1121.00038,1,1268874,1277580,-,8706
108,BUMA.1121.00081,1,1268935,1277641,-,8706
108,BUMA.1121.00034,1,2318516,2327222,-,8706
108,BUMA.1121.00013,1,1911449,1920167,+,8718
108,BUMA.1121.00032,1,348001,356707,-,8706
108,BUMA.1121.00004,1,2281023,2289729,-,8706
108,BUMA.1121.00006,1,1268857,1277563,-,8706
108,BUMA.1121.00017,1,2216151,2224857,-,8706
108,BUMA.1121.00008,1,2294124,2302830,-,8706
108,BUMA.1121.00028,1,2281132,2289838,-,8706
108,BUMA.1121.00026,1,2903954,2912648,+,8694
108,BUMA.1121.00010,1,94090,102796,-,8706
108,BUMA.1121.00030,1,2216214,2224920,-,8706
108,BUMA.1121.00019,1,2246045,2254751,-,8706
109,BUMA.1121.00022,1,2514388,2544115,+,29727
109,BUMA.1121.00024,1,2250373,2279947,-,29574
109,BUMA.1121.00052,1,2058994,2088675,-,29681
109,BUMA.1121.00050,1,3512363,3542072,-,29709
109,BUMA.1121.00015,1,1777298,1806832,+,29534
109,BUMA.1121.00086,1,783793,813466,+,29673
109,BUMA.1121.00085,1,1655940,1685621,-,29681
109,BUMA.1121.00040,1,2378632,2408213,-,29581
109,BUMA.1121.00020,1,2315207,2344781,-,29574
109,BUMA.1121.00044,1,1515861,1545426,-,29565
109,BUMA.1121.00002,1,3199831,3229391,+,29560
109,BUMA.1121.00087,1,2503317,2532972,-,29655
109,BUMA.1121.00042,1,1488726,1518297,+,29571
109,BUMA.1121.00036,1,1986547,2016139,-,29592
109,BUMA.1121.00034,1,2287741,2317306,-,29565
109,BUMA.1121.00013,1,1921377,1951184,+,29807
109,BUMA.1121.00032,1,317244,346791,-,29547
109,BUMA.1121.00004,1,2250232,2279813,-,29581
109,BUMA.1121.00017,1,2185368,2214941,-,29573
109,BUMA.1121.00008,1,2263341,2292914,-,29573
109,BUMA.1121.00028,1,2250348,2279922,-,29574
109,BUMA.1121.00026,1,2913858,2943544,+,29686
109,BUMA.1121.00010,1,3177424,3206982,+,29558
109,BUMA.1121.00030,1,2185440,2215004,-,29564
110,BUMA.1121.00022,1,2544116,2548447,+,4331
110,BUMA.1121.00024,1,2246041,2250371,-,4330
110,BUMA.1121.00052,1,2046064,2050391,-,4327
110,BUMA.1121.00050,1,3499421,3503756,-,4335
110,BUMA.1121.00015,1,1815432,1819767,+,4335
110,BUMA.1121.00086,1,813467,817798,+,4331
110,BUMA.1121.00085,1,1643010,1647337,-,4327
110,BUMA.1121.00040,1,2365716,2370043,-,4327
110,BUMA.1121.00020,1,2310875,2315205,-,4330
110,BUMA.1121.00044,1,1511529,1515859,-,4330
110,BUMA.1121.00002,1,3229392,3233723,+,4331
110,BUMA.1121.00087,1,2498985,2503315,-,4330
110,BUMA.1121.00042,1,1526921,1531256,+,4335
110,BUMA.1121.00036,1,1982215,1986545,-,4330
110,BUMA.1121.00034,1,2283409,2287739,-,4330
110,BUMA.1121.00013,1,1959787,1964114,+,4327
110,BUMA.1121.00032,1,312912,317242,-,4330
110,BUMA.1121.00004,1,2245901,2250230,-,4329
110,BUMA.1121.00017,1,2181036,2185366,-,4330
110,BUMA.1121.00008,1,2259010,2263339,-,4329
110,BUMA.1121.00028,1,2246016,2250346,-,4330
110,BUMA.1121.00026,1,2952184,2956519,+,4335
110,BUMA.1121.00010,1,3206983,3211314,+,4331
110,BUMA.1121.00030,1,2181109,2185438,-,4329
111,BUMA.1121.00022,1,2549706,2656047,+,106341
111,BUMA.1121.00024,1,2138389,2244766,-,106377
111,BUMA.1121.00054,1,2875537,2981843,+,106306
111,BUMA.1121.00052,1,1938437,2044789,-,106352
111,BUMA.1121.00048,1,953864,1060177,-,106313
111,BUMA.1121.00050,1,3391944,3498146,-,106202
111,BUMA.1121.00015,1,1821026,1927280,+,106254
111,BUMA.1121.00086,1,819057,925309,+,106252
111,BUMA.1121.00085,1,1535382,1641735,-,106353
111,BUMA.1121.00040,1,2258106,2364441,-,106335
111,BUMA.1121.00020,1,2203335,2309600,-,106265
111,BUMA.1121.00044,1,1403981,1510254,-,106273
111,BUMA.1121.00002,1,3234981,3341256,+,106275
111,BUMA.1121.00087,1,2391473,2497726,-,106253
111,BUMA.1121.00042,1,1532515,1638770,+,106255
111,BUMA.1121.00046,1,2763039,2869257,+,106218
111,BUMA.1121.00036,1,1874601,1980954,-,106353
111,BUMA.1121.00038,1,1161340,1267663,-,106323
111,BUMA.1121.00081,1,1161409,1267724,-,106315
111,BUMA.1121.00034,1,2175869,2282134,-,106265
111,BUMA.1121.00013,1,1965388,2071501,+,106113
111,BUMA.1121.00032,1,205281,311637,-,106356
111,BUMA.1121.00004,1,2138387,2244626,-,106239
111,BUMA.1121.00006,1,1161332,1267646,-,106314
111,BUMA.1121.00017,1,2073488,2179761,-,106273
111,BUMA.1121.00008,1,2151470,2257735,-,106265
111,BUMA.1121.00028,1,2138436,2244741,-,106305
111,BUMA.1121.00026,1,2957778,3064043,+,106265
111,BUMA.1121.00010,1,3212573,3318816,+,106243
111,BUMA.1121.00030,1,2073561,2179834,-,106273
111,BUMA.1121.00019,1,2138529,2244834,-,106305
112,BUMA.1121.00022,1,2657440,2685685,+,28245
112,BUMA.1121.00024,1,2108913,2137148,-,28235
112,BUMA.1121.00054,1,2983236,3011485,+,28249
112,BUMA.1121.00052,1,1908807,1937045,-,28238
112,BUMA.1121.00048,1,924223,952472,-,28249
112,BUMA.1121.00050,1,3362303,3390552,-,28249
112,BUMA.1121.00015,1,1928673,1956922,+,28249
112,BUMA.1121.00086,1,926702,954961,+,28259
112,BUMA.1121.00085,1,1505752,1533990,-,28238
112,BUMA.1121.00040,1,2228498,2256729,-,28231
112,BUMA.1121.00020,1,2173859,2202094,-,28235
112,BUMA.1121.00044,1,1374505,1402740,-,28235
112,BUMA.1121.00002,1,3342649,3370875,+,28226
112,BUMA.1121.00087,1,2361823,2390081,-,28258
112,BUMA.1121.00042,1,2331833,2360091,-,28258
112,BUMA.1121.00046,1,2870650,2898899,+,28249
112,BUMA.1121.00036,1,1844969,1873228,-,28259
112,BUMA.1121.00038,1,1131699,1159948,-,28249
112,BUMA.1121.00081,1,1131768,1160017,-,28249
112,BUMA.1121.00034,1,2146393,2174628,-,28235
112,BUMA.1121.00013,1,2072894,2101132,+,28238
112,BUMA.1121.00032,1,175805,204040,-,28235
112,BUMA.1121.00004,1,2108911,2137146,-,28235
112,BUMA.1121.00006,1,1131691,1159940,-,28249
112,BUMA.1121.00017,1,2044012,2072247,-,28235
112,BUMA.1121.00008,1,2121994,2150229,-,28235
112,BUMA.1121.00028,1,2108960,2137195,-,28235
112,BUMA.1121.00026,1,3414896,3443161,-,28265
112,BUMA.1121.00010,1,3320194,3348420,+,28226
112,BUMA.1121.00030,1,2044085,2072320,-,28235
112,BUMA.1121.00019,1,2109053,2137288,-,28235
113,BUMA.1121.00022,1,2692879,2708182,+,15303
113,BUMA.1121.00024,1,2086143,2101449,-,15306
113,BUMA.1121.00054,1,3020188,3035493,+,15305
113,BUMA.1121.00052,1,1884797,1900103,-,15306
113,BUMA.1121.00048,1,900216,915521,-,15305
113,BUMA.1121.00050,1,3338293,3353599,-,15306
113,BUMA.1121.00015,1,1965626,1980930,+,15304
113,BUMA.1121.00086,1,962155,977458,+,15303
113,BUMA.1121.00085,1,1481742,1497048,-,15306
113,BUMA.1121.00040,1,2205713,2221034,-,15321
113,BUMA.1121.00020,1,2151089,2166395,-,15306
113,BUMA.1121.00044,1,1351735,1367041,-,15306
113,BUMA.1121.00002,1,3378337,3393642,+,15305
113,BUMA.1121.00087,1,2339325,2354631,-,15306
113,BUMA.1121.00042,1,1779383,1794690,-,15307
113,BUMA.1121.00046,1,2907603,2922908,+,15305
113,BUMA.1121.00036,1,1822475,1837781,-,15306
113,BUMA.1121.00038,1,1107690,1122996,-,15306
113,BUMA.1121.00081,1,1107759,1123065,-,15306
113,BUMA.1121.00034,1,2123623,2138929,-,15306
113,BUMA.1121.00013,1,2109836,2125141,+,15305
113,BUMA.1121.00032,1,153035,168341,-,15306
113,BUMA.1121.00004,1,2086141,2101447,-,15306
113,BUMA.1121.00006,1,1107682,1122988,-,15306
113,BUMA.1121.00017,1,2021242,2036548,-,15306
113,BUMA.1121.00008,1,2099224,2114530,-,15306
113,BUMA.1121.00028,1,2086190,2101496,-,15306
113,BUMA.1121.00026,1,3204591,3219843,-,15252
113,BUMA.1121.00010,1,3355884,3371189,+,15305
113,BUMA.1121.00030,1,2021315,2036621,-,15306
113,BUMA.1121.00019,1,2086283,2101589,-,15306
114,BUMA.1121.00022,1,2708184,2728896,+,20712
114,BUMA.1121.00024,1,2065430,2086142,-,20712
114,BUMA.1121.00054,1,3035495,3056216,+,20721
114,BUMA.1121.00052,1,1864075,1884796,-,20721
114,BUMA.1121.00048,1,879494,900215,-,20721
114,BUMA.1121.00050,1,3317571,3338292,-,20721
114,BUMA.1121.00015,1,1980932,2001653,+,20721
114,BUMA.1121.00086,1,977460,998172,+,20712
114,BUMA.1121.00085,1,1461020,1481741,-,20721
114,BUMA.1121.00040,1,2183409,2204129,-,20720
114,BUMA.1121.00020,1,2130376,2151088,-,20712
114,BUMA.1121.00044,1,1331022,1351734,-,20712
114,BUMA.1121.00002,1,3393644,3414365,+,20721
114,BUMA.1121.00087,1,2318612,2339324,-,20712
114,BUMA.1121.00042,1,1758652,1779382,-,20730
114,BUMA.1121.00046,1,2922910,2943631,+,20721
114,BUMA.1121.00036,1,1801753,1822474,-,20721
114,BUMA.1121.00038,1,1086968,1107689,-,20721
114,BUMA.1121.00081,1,1087037,1107758,-,20721
114,BUMA.1121.00034,1,2102910,2123622,-,20712
114,BUMA.1121.00013,1,2125143,2145864,+,20721
114,BUMA.1121.00032,1,132322,153034,-,20712
114,BUMA.1121.00004,1,2065428,2086140,-,20712
114,BUMA.1121.00006,1,1086960,1107681,-,20721
114,BUMA.1121.00017,1,2000529,2021241,-,20712
114,BUMA.1121.00008,1,2078511,2099223,-,20712
114,BUMA.1121.00028,1,2065477,2086189,-,20712
114,BUMA.1121.00026,1,3183869,3204590,-,20721
114,BUMA.1121.00010,1,3371191,3391912,+,20721
114,BUMA.1121.00030,1,2000602,2021314,-,20712
114,BUMA.1121.00019,1,2065570,2086282,-,20712
115,BUMA.1121.00022,1,2729654,2733521,+,3867
115,BUMA.1121.00024,1,2060802,2064672,-,3870
115,BUMA.1121.00054,1,3058443,3062311,-,3868
115,BUMA.1121.00052,1,1857978,1861847,+,3869
115,BUMA.1121.00048,1,873398,877266,+,3868
115,BUMA.1121.00050,1,3311477,3315343,+,3866
115,BUMA.1121.00015,1,2003880,2007750,-,3870
115,BUMA.1121.00086,1,998930,1002797,+,3867
115,BUMA.1121.00085,1,1454923,1458792,+,3869
115,BUMA.1121.00040,1,2177315,2181181,+,3866
115,BUMA.1121.00020,1,2125748,2129618,-,3870
115,BUMA.1121.00044,1,1326395,1330264,-,3869
115,BUMA.1121.00002,1,3416114,3419983,-,3869
115,BUMA.1121.00087,1,2313986,2317854,-,3868
115,BUMA.1121.00042,1,1720149,1724021,+,3872
115,BUMA.1121.00046,1,2945858,2949726,-,3868
115,BUMA.1121.00036,1,1796135,1800003,+,3868
115,BUMA.1121.00038,1,1080872,1084740,+,3868
115,BUMA.1121.00081,1,1080941,1084809,+,3868
115,BUMA.1121.00034,1,2098282,2102152,-,3870
115,BUMA.1121.00013,1,2148091,2151960,-,3869
115,BUMA.1121.00032,1,127695,131564,-,3869
115,BUMA.1121.00004,1,2060800,2064670,-,3870
115,BUMA.1121.00006,1,1080864,1084732,+,3868
115,BUMA.1121.00017,1,1995901,1999771,-,3870
115,BUMA.1121.00008,1,2073884,2077753,-,3869
115,BUMA.1121.00028,1,2060849,2064719,-,3870
115,BUMA.1121.00026,1,3145401,3149271,+,3870
115,BUMA.1121.00010,1,3393661,3397530,-,3869
115,BUMA.1121.00030,1,1995975,1999844,-,3869
115,BUMA.1121.00019,1,2060942,2064812,-,3870
116,BUMA.1121.00022,1,2736067,2743451,+,7384
116,BUMA.1121.00024,1,2319107,2326476,+,7369
116,BUMA.1121.00054,1,2827758,2835126,-,7368
116,BUMA.1121.00052,1,2127838,2135217,+,7379
116,BUMA.1121.00048,1,1100586,1107970,+,7384
116,BUMA.1121.00050,1,29133,36502,+,7369
116,BUMA.1121.00015,1,1729801,1737170,-,7369
116,BUMA.1121.00086,1,1005343,1012712,+,7369
116,BUMA.1121.00085,1,1724784,1732163,+,7379
116,BUMA.1121.00040,1,2039747,2047114,-,7367
116,BUMA.1121.00020,1,2383941,2391310,+,7369
116,BUMA.1121.00044,1,1584586,1591955,+,7369
116,BUMA.1121.00002,1,3421538,3430145,+,8607
116,BUMA.1121.00087,1,2304071,2311440,-,7369
116,BUMA.1121.00042,1,1442846,1450228,-,7382
116,BUMA.1121.00046,1,2715229,2722598,-,7369
116,BUMA.1121.00036,1,1787209,1794578,-,7369
116,BUMA.1121.00038,1,1308073,1315441,+,7368
116,BUMA.1121.00081,1,1308134,1315502,+,7368
116,BUMA.1121.00034,1,2356466,2363835,+,7369
116,BUMA.1121.00013,1,2409255,2416618,+,7363
116,BUMA.1121.00032,1,385951,393320,+,7369
116,BUMA.1121.00004,1,2318972,2326341,+,7369
116,BUMA.1121.00006,1,1308056,1315424,+,7368
116,BUMA.1121.00017,1,2254101,2261470,+,7369
116,BUMA.1121.00008,1,2332074,2339443,+,7369
116,BUMA.1121.00028,1,2319082,2326451,+,7369
116,BUMA.1121.00026,1,2867987,2875370,-,7383
116,BUMA.1121.00010,1,3399084,3407706,+,8622
116,BUMA.1121.00030,1,2254164,2261533,+,7369
116,BUMA.1121.00019,1,2283995,2291364,+,7369
117,BUMA.1121.00022,1,2748568,2775279,+,26711
117,BUMA.1121.00024,1,2330187,2356893,+,26706
117,BUMA.1121.00054,1,2795901,2822617,-,26716
117,BUMA.1121.00052,1,2141583,2168281,+,26698
117,BUMA.1121.00048,1,1113096,1139812,+,26716
117,BUMA.1121.00050,1,41643,68371,+,26728
117,BUMA.1121.00015,1,1697912,1724661,-,26749
117,BUMA.1121.00086,1,1017855,1044557,+,26702
117,BUMA.1121.00085,1,1738529,1765227,+,26698
117,BUMA.1121.00040,1,2007831,2034605,-,26774
117,BUMA.1121.00020,1,2396451,2423143,+,26692
117,BUMA.1121.00044,1,1597096,1623788,+,26692
117,BUMA.1121.00002,1,3435288,3461947,+,26659
117,BUMA.1121.00087,1,2272228,2298929,-,26701
117,BUMA.1121.00042,1,1410960,1437720,-,26760
117,BUMA.1121.00046,1,2683361,2710089,-,26728
117,BUMA.1121.00036,1,1755335,1782069,-,26734
117,BUMA.1121.00038,1,1320583,1347299,+,26716
117,BUMA.1121.00081,1,1320644,1347360,+,26716
117,BUMA.1121.00034,1,2368976,2395668,+,26692
117,BUMA.1121.00013,1,2421760,2448465,+,26705
117,BUMA.1121.00032,1,398461,425146,+,26685
117,BUMA.1121.00004,1,2331482,2358181,+,26699
117,BUMA.1121.00006,1,1320566,1347282,+,26716
117,BUMA.1121.00017,1,2266611,2293303,+,26692
117,BUMA.1121.00008,1,2344584,2371276,+,26692
117,BUMA.1121.00028,1,2331592,2358284,+,26692
117,BUMA.1121.00026,1,2836102,2862862,-,26760
117,BUMA.1121.00010,1,3412832,3439506,+,26674
117,BUMA.1121.00030,1,2266674,2293365,+,26691
117,BUMA.1121.00019,1,2296505,2323197,+,26692
118,BUMA.1121.00022,1,2777840,2845155,+,67315
118,BUMA.1121.00024,1,2359454,2426844,+,67390
118,BUMA.1121.00054,1,2726149,2793355,-,67206
118,BUMA.1121.00052,1,2170827,2238062,+,67235
118,BUMA.1121.00048,1,1142358,1209563,+,67205
118,BUMA.1121.00050,1,70917,138225,+,67308
118,BUMA.1121.00015,1,1628110,1695366,-,67256
118,BUMA.1121.00086,1,1047102,1114433,+,67331
118,BUMA.1121.00085,1,1767773,1835008,+,67235
118,BUMA.1121.00040,1,1937981,2005285,-,67304
118,BUMA.1121.00020,1,2425704,2493050,+,67346
118,BUMA.1121.00044,1,1626349,1693685,+,67336
118,BUMA.1121.00002,1,3464508,3531732,+,67224
118,BUMA.1121.00087,1,2202354,2269683,-,67329
118,BUMA.1121.00042,1,1797534,1864730,+,67196
118,BUMA.1121.00046,1,2613511,2680815,-,67304
118,BUMA.1121.00036,1,1685505,1752793,-,67288
118,BUMA.1121.00038,1,1349845,1417050,+,67205
118,BUMA.1121.00081,1,1349906,1417111,+,67205
118,BUMA.1121.00034,1,2398229,2465572,+,67343
118,BUMA.1121.00013,1,2451011,2518260,+,67249
118,BUMA.1121.00032,1,427707,495022,+,67315
118,BUMA.1121.00004,1,2360742,2428085,+,67343
118,BUMA.1121.00006,1,1349828,1417033,+,67205
118,BUMA.1121.00017,1,2295864,2363219,+,67355
118,BUMA.1121.00008,1,2372516,2439844,+,67328
118,BUMA.1121.00028,1,2360845,2428163,+,67318
118,BUMA.1121.00026,1,3222686,3289965,+,67279
118,BUMA.1121.00010,1,3442051,3509259,+,67208
118,BUMA.1121.00030,1,2295926,2363253,+,67327
118,BUMA.1121.00019,1,2325758,2393113,+,67355
119,BUMA.1121.00022,1,2845157,2861880,+,16723
119,BUMA.1121.00024,1,2426846,2443569,+,16723
119,BUMA.1121.00054,1,2709403,2726148,-,16745
119,BUMA.1121.00052,1,2238064,2254787,+,16723
119,BUMA.1121.00048,1,1209565,1226288,+,16723
119,BUMA.1121.00050,1,138227,154950,+,16723
119,BUMA.1121.00015,1,1611364,1628109,-,16745
119,BUMA.1121.00086,1,1114435,1131158,+,16723
119,BUMA.1121.00085,1,1835010,1851733,+,16723
119,BUMA.1121.00040,1,1921225,1937980,-,16755
119,BUMA.1121.00020,1,2493052,2509775,+,16723
119,BUMA.1121.00044,1,1693687,1710410,+,16723
119,BUMA.1121.00002,1,1,16709,+,16708
119,BUMA.1121.00087,1,2185608,2202353,-,16745
119,BUMA.1121.00042,1,1864732,1881455,+,16723
119,BUMA.1121.00046,1,2596765,2613510,-,16745
119,BUMA.1121.00036,1,1668759,1685504,-,16745
119,BUMA.1121.00038,1,1417052,1433775,+,16723
119,BUMA.1121.00081,1,1417113,1433838,+,16725
119,BUMA.1121.00034,1,2465574,2482297,+,16723
119,BUMA.1121.00013,1,2518262,2534985,+,16723
119,BUMA.1121.00032,1,495024,511747,+,16723
119,BUMA.1121.00004,1,2428087,2444810,+,16723
119,BUMA.1121.00006,1,1417035,1433758,+,16723
119,BUMA.1121.00017,1,2363221,2379944,+,16723
119,BUMA.1121.00008,1,2439846,2456569,+,16723
119,BUMA.1121.00028,1,2428165,2444888,+,16723
119,BUMA.1121.00026,1,3289967,3306689,+,16722
119,BUMA.1121.00010,1,3509261,3525984,+,16723
119,BUMA.1121.00030,1,2363255,2379978,+,16723
119,BUMA.1121.00019,1,2393115,2409838,+,16723
120,BUMA.1121.00022,1,2861933,2869214,+,7281
120,BUMA.1121.00024,1,2443622,2450903,+,7281
120,BUMA.1121.00054,1,2702090,2709372,-,7282
120,BUMA.1121.00052,1,2254840,2262121,+,7281
120,BUMA.1121.00048,1,1226341,1233622,+,7281
120,BUMA.1121.00050,1,155003,162284,+,7281
120,BUMA.1121.00015,1,1604051,1611333,-,7282
120,BUMA.1121.00086,1,1131211,1138492,+,7281
120,BUMA.1121.00085,1,1851786,1859067,+,7281
120,BUMA.1121.00040,1,1913912,1921194,-,7282
120,BUMA.1121.00020,1,2509828,2517109,+,7281
120,BUMA.1121.00044,1,1710463,1717744,+,7281
120,BUMA.1121.00002,1,16762,24043,+,7281
120,BUMA.1121.00087,1,2178295,2185577,-,7282
120,BUMA.1121.00042,1,1883096,1890377,+,7281
120,BUMA.1121.00046,1,2589452,2596734,-,7282
120,BUMA.1121.00036,1,1661446,1668728,-,7282
120,BUMA.1121.00038,1,1433828,1441109,+,7281
120,BUMA.1121.00081,1,1433891,1441172,+,7281
120,BUMA.1121.00034,1,2482350,2489631,+,7281
120,BUMA.1121.00013,1,2535038,2542319,+,7281
120,BUMA.1121.00032,1,511800,519081,+,7281
120,BUMA.1121.00004,1,2444863,2452144,+,7281
120,BUMA.1121.00006,1,1433811,1441092,+,7281
120,BUMA.1121.00017,1,2379997,2387278,+,7281
120,BUMA.1121.00008,1,2456622,2463903,+,7281
120,BUMA.1121.00028,1,2444941,2452222,+,7281
120,BUMA.1121.00026,1,3308334,3315615,+,7281
120,BUMA.1121.00010,1,3526037,3533325,+,7288
120,BUMA.1121.00030,1,2380031,2387312,+,7281
120,BUMA.1121.00019,1,2409891,2417172,+,7281
121,BUMA.1121.00022,1,2869216,2894148,+,24932
121,BUMA.1121.00024,1,2450905,2475837,+,24932
121,BUMA.1121.00054,1,2677157,2702089,-,24932
121,BUMA.1121.00052,1,2262123,2287055,+,24932
121,BUMA.1121.00048,1,1233624,1258556,+,24932
121,BUMA.1121.00050,1,162286,187218,+,24932
121,BUMA.1121.00015,1,1579118,1604050,-,24932
121,BUMA.1121.00086,1,1138494,1163426,+,24932
121,BUMA.1121.00085,1,1859069,1884001,+,24932
121,BUMA.1121.00040,1,1888988,1913911,-,24923
121,BUMA.1121.00020,1,2517111,2542043,+,24932
121,BUMA.1121.00044,1,1717746,1742678,+,24932
121,BUMA.1121.00002,1,24045,48975,+,24930
121,BUMA.1121.00087,1,2153362,2178294,-,24932
121,BUMA.1121.00042,1,1890379,1915298,+,24919
121,BUMA.1121.00046,1,2564519,2589451,-,24932
121,BUMA.1121.00036,1,1636513,1661445,-,24932
121,BUMA.1121.00038,1,1441111,1466043,+,24932
121,BUMA.1121.00081,1,1441174,1466106,+,24932
121,BUMA.1121.00034,1,2489633,2514565,+,24932
121,BUMA.1121.00013,1,2542321,2567253,+,24932
121,BUMA.1121.00032,1,519083,544015,+,24932
121,BUMA.1121.00004,1,2452146,2477078,+,24932
121,BUMA.1121.00006,1,1441094,1466026,+,24932
121,BUMA.1121.00017,1,2387280,2412212,+,24932
121,BUMA.1121.00008,1,2463905,2488837,+,24932
121,BUMA.1121.00028,1,2452224,2477156,+,24932
121,BUMA.1121.00026,1,3315617,3340536,+,24919
121,BUMA.1121.00010,1,1,24925,+,24924
121,BUMA.1121.00030,1,2387314,2412244,+,24930
121,BUMA.1121.00019,1,2417174,2442106,+,24932
122,BUMA.1121.00022,1,2896063,2961050,+,64987
122,BUMA.1121.00024,1,2477737,2542702,+,64965
122,BUMA.1121.00054,1,2610183,2675232,-,65049
122,BUMA.1121.00052,1,2288882,2353947,+,65065
122,BUMA.1121.00048,1,1260480,1325530,+,65050
122,BUMA.1121.00050,1,3164388,3229456,-,65068
122,BUMA.1121.00015,1,1512165,1577209,-,65044
122,BUMA.1121.00086,1,1165349,1230370,+,65021
122,BUMA.1121.00085,1,1885828,1950893,+,65065
122,BUMA.1121.00040,1,2489025,2554065,+,65040
122,BUMA.1121.00020,1,2543943,2608908,+,64965
122,BUMA.1121.00044,1,1744578,1809543,+,64965
122,BUMA.1121.00002,1,51874,116892,+,65018
122,BUMA.1121.00087,1,2086418,2151438,-,65020
122,BUMA.1121.00042,1,1916556,1981564,+,65008
122,BUMA.1121.00046,1,3031753,3096822,+,65069
122,BUMA.1121.00036,1,1568523,1633530,-,65007
122,BUMA.1121.00038,1,1467967,1533017,+,65050
122,BUMA.1121.00081,1,1468030,1533080,+,65050
122,BUMA.1121.00034,1,2516465,2581430,+,64965
122,BUMA.1121.00013,1,2569193,2634258,+,65065
122,BUMA.1121.00032,1,545915,610880,+,64965
122,BUMA.1121.00004,1,2478978,2543951,+,64973
122,BUMA.1121.00006,1,1467950,1533000,+,65050
122,BUMA.1121.00017,1,2414112,2479077,+,64965
122,BUMA.1121.00008,1,2490737,2555702,+,64965
122,BUMA.1121.00028,1,2479056,2544021,+,64965
122,BUMA.1121.00026,1,3342785,3407763,+,64978
122,BUMA.1121.00010,1,27824,92880,+,65056
122,BUMA.1121.00030,1,2414144,2479109,+,64965
122,BUMA.1121.00019,1,2444006,2508971,+,64965
123,BUMA.1121.00022,1,2962261,2986377,+,24116
123,BUMA.1121.00024,1,2543913,2568109,+,24196
123,BUMA.1121.00054,1,2584855,2608972,-,24117
123,BUMA.1121.00052,1,2355158,2379291,+,24133
123,BUMA.1121.00048,1,1326741,1350857,+,24116
123,BUMA.1121.00050,1,3139044,3163177,-,24133
123,BUMA.1121.00015,1,1486814,1510954,-,24140
123,BUMA.1121.00086,1,1231581,1255837,+,24256
123,BUMA.1121.00085,1,1952104,1976237,+,24133
123,BUMA.1121.00040,1,2555276,2579402,+,24126
123,BUMA.1121.00020,1,2610119,2634329,+,24210
123,BUMA.1121.00044,1,1810754,1834971,+,24217
123,BUMA.1121.00002,1,140124,164246,+,24122
123,BUMA.1121.00087,1,2060972,2085207,-,24235
123,BUMA.1121.00042,1,1982788,2006886,+,24098
123,BUMA.1121.00046,1,3098033,3122147,+,24114
123,BUMA.1121.00036,1,1543147,1567312,-,24165
123,BUMA.1121.00038,1,1534228,1558344,+,24116
123,BUMA.1121.00081,1,1534291,1558407,+,24116
123,BUMA.1121.00034,1,2582641,2606858,+,24217
123,BUMA.1121.00013,1,2635469,2659595,+,24126
123,BUMA.1121.00032,1,612091,636315,+,24224
123,BUMA.1121.00004,1,2545162,2569372,+,24210
123,BUMA.1121.00006,1,1534211,1558327,+,24116
123,BUMA.1121.00017,1,2480288,2504512,+,24224
123,BUMA.1121.00008,1,2556913,2581123,+,24210
123,BUMA.1121.00028,1,2545232,2569428,+,24196
123,BUMA.1121.00026,1,2810821,2834891,-,24070
123,BUMA.1121.00010,1,116128,140235,+,24107
123,BUMA.1121.00030,1,2480320,2504537,+,24217
123,BUMA.1121.00019,1,2510182,2534392,+,24210
124,BUMA.1121.00022,1,2991585,3023904,+,32319
124,BUMA.1121.00024,1,2573328,2605641,+,32313
124,BUMA.1121.00054,1,2545732,2578039,-,32307
124,BUMA.1121.00052,1,2384488,2416807,+,32319
124,BUMA.1121.00048,1,1357675,1389982,+,32307
124,BUMA.1121.00050,1,3099907,3132208,-,32301
124,BUMA.1121.00015,1,1447686,1480011,-,32325
124,BUMA.1121.00086,1,1261045,1293358,+,32313
124,BUMA.1121.00085,1,1981434,2013753,+,32319
124,BUMA.1121.00040,1,2584599,2616911,+,32312
124,BUMA.1121.00020,1,2639548,2671861,+,32313
124,BUMA.1121.00044,1,1840190,1872509,+,32319
124,BUMA.1121.00002,1,169454,201736,+,32282
124,BUMA.1121.00087,1,2023451,2055764,-,32313
124,BUMA.1121.00042,1,2013323,2045648,+,32325
124,BUMA.1121.00046,1,3128983,3161284,+,32301
124,BUMA.1121.00036,1,1505626,1537939,-,32313
124,BUMA.1121.00038,1,1565161,1597468,+,32307
124,BUMA.1121.00081,1,1565224,1597531,+,32307
124,BUMA.1121.00034,1,2612077,2644390,+,32313
124,BUMA.1121.00013,1,2664792,2697123,+,32331
124,BUMA.1121.00032,1,641534,673841,+,32307
124,BUMA.1121.00004,1,2574591,2606904,+,32313
124,BUMA.1121.00006,1,1565144,1597451,+,32307
124,BUMA.1121.00017,1,2509731,2542044,+,32313
124,BUMA.1121.00008,1,2586342,2618655,+,32313
124,BUMA.1121.00028,1,2574647,2606960,+,32313
124,BUMA.1121.00026,1,2772090,2804385,-,32295
124,BUMA.1121.00010,1,145437,177717,+,32280
124,BUMA.1121.00030,1,2509756,2542075,+,32319
124,BUMA.1121.00019,1,2539611,2571924,+,32313
125,BUMA.1121.00022,1,3023905,3065867,+,41962
125,BUMA.1121.00024,1,2605642,2647607,+,41965
125,BUMA.1121.00054,1,2503774,2545730,-,41956
125,BUMA.1121.00052,1,2416808,2458770,+,41962
125,BUMA.1121.00048,1,1389983,1431939,+,41956
125,BUMA.1121.00050,1,3057949,3099905,-,41956
125,BUMA.1121.00015,1,1405728,1447684,-,41956
125,BUMA.1121.00086,1,1293359,1335321,+,41962
125,BUMA.1121.00085,1,2013754,2055716,+,41962
125,BUMA.1121.00040,1,2616912,2658874,+,41962
125,BUMA.1121.00020,1,2671862,2713824,+,41962
125,BUMA.1121.00044,1,1872510,1914472,+,41962
125,BUMA.1121.00002,1,202972,244947,+,41975
125,BUMA.1121.00087,1,1981487,2023449,-,41962
125,BUMA.1121.00042,1,2045649,2087634,+,41985
125,BUMA.1121.00046,1,3161285,3203241,+,41956
125,BUMA.1121.00036,1,1463662,1505624,-,41962
125,BUMA.1121.00038,1,1597469,1639425,+,41956
125,BUMA.1121.00081,1,1597532,1639488,+,41956
125,BUMA.1121.00034,1,2644391,2686353,+,41962
125,BUMA.1121.00013,1,2697124,2739086,+,41962
125,BUMA.1121.00032,1,673842,715804,+,41962
125,BUMA.1121.00004,1,2606905,2648867,+,41962
125,BUMA.1121.00006,1,1597452,1639408,+,41956
125,BUMA.1121.00017,1,2542045,2584007,+,41962
125,BUMA.1121.00008,1,2618656,2660618,+,41962
125,BUMA.1121.00028,1,2606961,2648926,+,41965
125,BUMA.1121.00026,1,2730103,2772088,-,41985
125,BUMA.1121.00010,1,178952,220927,+,41975
125,BUMA.1121.00030,1,2542076,2584038,+,41962
125,BUMA.1121.00019,1,2571925,2613887,+,41962
126,BUMA.1121.00022,1,3066491,3075161,+,8670
126,BUMA.1121.00024,1,2648231,2656925,+,8694
126,BUMA.1121.00054,1,2494486,2503150,-,8664
126,BUMA.1121.00052,1,2459394,2468130,+,8736
126,BUMA.1121.00048,1,1432563,1441227,+,8664
126,BUMA.1121.00050,1,3048634,3057325,-,8691
126,BUMA.1121.00015,1,1396437,1405104,-,8667
126,BUMA.1121.00086,1,1335945,1344615,+,8670
126,BUMA.1121.00085,1,2056340,2065076,+,8736
126,BUMA.1121.00040,1,2659498,2668264,+,8766
126,BUMA.1121.00020,1,2714448,2723142,+,8694
126,BUMA.1121.00044,1,1915096,1923784,+,8688
126,BUMA.1121.00002,1,245571,254283,+,8712
126,BUMA.1121.00087,1,1972193,1980863,-,8670
126,BUMA.1121.00042,1,2088258,2097009,+,8751
126,BUMA.1121.00046,1,3203865,3212556,+,8691
126,BUMA.1121.00036,1,1454362,1463038,-,8676
126,BUMA.1121.00038,1,1640049,1648713,+,8664
126,BUMA.1121.00081,1,1640112,1648776,+,8664
126,BUMA.1121.00034,1,2686977,2695665,+,8688
126,BUMA.1121.00013,1,2739710,2748437,+,8727
126,BUMA.1121.00032,1,716428,725182,+,8754
126,BUMA.1121.00004,1,2649491,2658179,+,8688
126,BUMA.1121.00006,1,1640032,1648696,+,8664
126,BUMA.1121.00017,1,2584631,2593319,+,8688
126,BUMA.1121.00008,1,2661242,2669936,+,8694
126,BUMA.1121.00028,1,2649550,2658244,+,8694
126,BUMA.1121.00026,1,2720578,2729479,-,8901
126,BUMA.1121.00010,1,221551,230263,+,8712
126,BUMA.1121.00030,1,2584662,2593350,+,8688
126,BUMA.1121.00019,1,2614511,2623205,+,8694
127,BUMA.1121.00022,1,3077353,3112623,+,35270
127,BUMA.1121.00024,1,2659117,2694184,+,35067
127,BUMA.1121.00054,1,2457035,2492294,-,35259
127,BUMA.1121.00052,1,2470307,2505364,+,35057
127,BUMA.1121.00048,1,1443402,1478683,+,35281
127,BUMA.1121.00050,1,3011405,3046458,-,35053
127,BUMA.1121.00015,1,1359238,1394260,-,35022
127,BUMA.1121.00086,1,1346807,1381878,+,35071
127,BUMA.1121.00085,1,2067253,2102310,+,35057
127,BUMA.1121.00040,1,2670441,2705557,+,35116
127,BUMA.1121.00020,1,2725334,2760412,+,35078
127,BUMA.1121.00044,1,1925976,1961040,+,35064
127,BUMA.1121.00002,1,257718,292745,+,35027
127,BUMA.1121.00087,1,1935000,1970001,-,35001
127,BUMA.1121.00042,1,2099186,2134049,+,34863
127,BUMA.1121.00046,1,3214733,3249785,+,35052
127,BUMA.1121.00036,1,1417119,1452170,-,35051
127,BUMA.1121.00038,1,1650905,1686136,+,35231
127,BUMA.1121.00081,1,1650968,1686220,+,35252
127,BUMA.1121.00034,1,2697857,2732942,+,35085
127,BUMA.1121.00013,1,2750614,2785732,+,35118
127,BUMA.1121.00032,1,727374,762592,+,35218
127,BUMA.1121.00004,1,2660371,2695426,+,35055
127,BUMA.1121.00006,1,1650888,1686147,+,35259
127,BUMA.1121.00017,1,2595511,2630568,+,35057
127,BUMA.1121.00008,1,2672128,2707199,+,35071
127,BUMA.1121.00028,1,2660436,2695507,+,35071
127,BUMA.1121.00026,1,2683411,2718400,-,34989
127,BUMA.1121.00010,1,232436,267436,+,35000
127,BUMA.1121.00030,1,2595542,2630606,+,35064
127,BUMA.1121.00019,1,2625397,2660475,+,35078
