block,genome,chr/contig,start,end,orientation,length
758,BUMA.1121.00112,1,348576,354775,+,6199
758,BUMA.1121.00014,1,166988,173158,+,6170
757,BUMA.1121.00112,1,336102,345004,+,8902
757,BUMA.1121.00014,1,152698,161606,+,8908
756,BUMA.1121.00112,1,321863,326094,+,4231
756,BUMA.1121.00014,1,134876,139086,+,4210
755,BUMA.1121.00112,1,312914,321604,+,8690
755,BUMA.1121.00014,1,125956,134617,+,8661
754,BUMA.1121.00112,1,298158,306626,+,8468
754,BUMA.1121.00014,1,111465,119925,+,8460
753,BUMA.1121.00067,2,1686487,1689503,+,3016
753,BUMA.1121.00080,2,2295648,2298663,-,3015
752,BUMA.1121.00083,1,2672246,2675273,+,3027
752,BUMA.1121.00082,1,3104086,3107113,-,3027
751,BUMA.1121.00083,1,1902095,1905720,+,3625
751,BUMA.1121.00082,1,3873650,3877275,-,3625
750,BUMA.1121.00083,1,1065240,1102343,+,37103
750,BUMA.1121.00082,1,602484,639587,-,37103
749,BUMA.1121.00083,1,832517,845929,+,13412
749,BUMA.1121.00082,1,858891,872302,-,13411
748,BUMA.1121.00091,1,1401467,1409651,+,8184
748,BUMA.1121.00095,1,2599894,2608073,+,8179
748,BUMA.1121.00041,1,338484,346668,-,8184
748,BUMA.1121.00005,1,1819319,1827503,-,8184
747,BUMA.1121.00091,1,1396013,1401465,+,5452
747,BUMA.1121.00095,1,2592985,2598439,+,5454
747,BUMA.1121.00041,1,346669,352121,-,5452
747,BUMA.1121.00005,1,1827504,1832956,-,5452
746,BUMA.1121.00091,1,1386799,1391925,+,5126
746,BUMA.1121.00095,1,2583782,2588898,+,5116
746,BUMA.1121.00041,1,356208,361335,-,5127
746,BUMA.1121.00005,1,1837043,1842170,-,5127
745,BUMA.1121.00099,1,844707,880986,+,36279
745,BUMA.1121.00098,1,2293538,2329805,+,36267
745,BUMA.1121.00005,1,181304,218161,-,36857
744,BUMA.1121.00098,2,727717,731721,+,4004
744,BUMA.1121.00100,2,1633585,1637589,+,4004
743,BUMA.1121.00068,1,2910993,2914757,+,3764
743,BUMA.1121.00041,2,1417685,1421460,+,3775
742,BUMA.1121.00068,1,1344464,1351029,+,6565
742,BUMA.1121.00107,1,2497865,2504441,+,6576
741,BUMA.1121.00101,1,2673220,2677455,+,4235
741,BUMA.1121.00068,1,2612701,2616936,-,4235
740,BUMA.1121.00101,1,2590846,2594073,+,3227
740,BUMA.1121.00068,1,2711072,2714323,-,3251
740,BUMA.1121.00098,1,2562876,2566115,-,3239
740,BUMA.1121.00103,2,3359943,3363206,-,3263
740,BUMA.1121.00083,1,1805300,1808551,+,3251
740,BUMA.1121.00070,1,3739127,3742378,-,3251
740,BUMA.1121.00066,1,3751898,3755149,-,3251
740,BUMA.1121.00082,1,3970819,3974070,-,3251
739,BUMA.1121.00101,1,1695113,1701982,+,6869
739,BUMA.1121.00107,1,628484,635355,-,6871
738,BUMA.1121.00108,2,2612454,2621247,+,8793
738,BUMA.1121.00078,2,766158,774951,-,8793
738,BUMA.1121.00075,2,469908,478701,-,8793
738,BUMA.1121.00076,2,118767,127560,+,8793
738,BUMA.1121.00068,2,954661,963454,+,8793
738,BUMA.1121.00100,2,394331,403124,+,8793
738,BUMA.1121.00012,2,2563853,2572636,-,8783
737,BUMA.1121.00108,2,2604001,2612452,+,8451
737,BUMA.1121.00012,2,2572637,2581090,-,8453
736,BUMA.1121.00105,1,643974,649941,+,5967
736,BUMA.1121.00112,1,2514168,2520123,+,5955
735,BUMA.1121.00016,2,2846838,2849861,+,3023
735,BUMA.1121.00035,2,441426,445502,+,4076
734,BUMA.1121.00031,1,1942478,1951302,+,8824
734,BUMA.1121.00014,1,2268808,2277632,-,8824
733,BUMA.1121.00031,1,1932477,1939849,+,7372
733,BUMA.1121.00014,1,2278990,2286362,-,7372
732,BUMA.1121.00031,1,1921406,1928373,+,6967
732,BUMA.1121.00014,1,2290466,2297585,-,7119
731,BUMA.1121.00031,1,1908934,1920240,+,11306
731,BUMA.1121.00014,1,2298750,2308571,-,9821
730,BUMA.1121.00055,1,2019344,2022513,+,3169
730,BUMA.1121.00112,1,1627167,1630632,+,3465
730,BUMA.1121.00057,1,3498543,3501725,+,3182
729,BUMA.1121.00055,1,792281,796143,+,3862
729,BUMA.1121.00041,1,2509405,2513269,+,3864
728,BUMA.1121.00047,1,1837502,1843623,+,6121
728,BUMA.1121.00088,1,2016062,2022183,-,6121
727,BUMA.1121.00103,1,3201623,3205172,+,3549
727,BUMA.1121.00011,1,381196,384745,+,3549
726,BUMA.1121.00103,1,728954,733124,+,4170
726,BUMA.1121.00091,1,874020,878191,+,4171
725,BUMA.1121.00103,1,718819,728953,+,10134
725,BUMA.1121.00091,1,863885,874019,+,10134
725,BUMA.1121.00107,1,3589364,3599507,-,10143
724,BUMA.1121.00067,1,3835506,3841840,+,6334
724,BUMA.1121.00074,1,3311792,3318126,+,6334
723,BUMA.1121.00067,1,3819479,3834338,+,14859
723,BUMA.1121.00074,1,3295765,3310624,+,14859
722,BUMA.1121.00067,1,2902444,2906830,+,4386
722,BUMA.1121.00064,1,1511030,1515416,-,4386
722,BUMA.1121.00074,1,2344822,2349208,+,4386
721,BUMA.1121.00067,1,2895148,2898377,+,3229
721,BUMA.1121.00064,1,1518149,1521372,-,3223
721,BUMA.1121.00074,1,2338867,2342089,+,3222
720,BUMA.1121.00091,2,3161405,3166721,+,5316
720,BUMA.1121.00053,2,753871,757853,-,3982
720,BUMA.1121.00078,2,2699118,2703099,+,3981
720,BUMA.1121.00099,2,724198,728180,-,3982
719,BUMA.1121.00007,1,2998888,3007432,+,8544
719,BUMA.1121.00103,1,3192752,3201474,+,8722
719,BUMA.1121.00055,1,796538,805065,-,8527
719,BUMA.1121.00098,1,3944822,3953165,-,8343
719,BUMA.1121.00083,1,370899,379232,+,8333
719,BUMA.1121.00041,1,2515026,2523589,-,8563
719,BUMA.1121.00082,1,1325594,1333927,-,8333
719,BUMA.1121.00011,1,372704,381047,+,8343
718,BUMA.1121.00007,1,573711,577890,+,4179
718,BUMA.1121.00103,1,881679,885855,+,4176
717,BUMA.1121.00007,1,564232,568331,+,4099
717,BUMA.1121.00031,1,818051,822149,-,4098
716,BUMA.1121.00058,1,1968088,1972893,+,4805
716,BUMA.1121.00112,1,375382,380055,+,4673
716,BUMA.1121.00014,1,195090,199767,+,4677
715,BUMA.1121.00058,1,1945185,1951123,+,5938
715,BUMA.1121.00112,1,356131,362059,+,5928
715,BUMA.1121.00014,1,175455,181386,+,5931
714,BUMA.1121.00058,1,1923394,1939149,+,15755
714,BUMA.1121.00014,1,94940,110696,+,15756
713,BUMA.1121.00058,1,1314799,1318944,+,4145
713,BUMA.1121.00059,1,2426280,2430426,-,4146
712,BUMA.1121.00058,1,1305935,1310529,+,4594
712,BUMA.1121.00059,1,2434696,2439290,-,4594
712,BUMA.1121.00005,1,1940601,1946603,+,6002
711,BUMA.1121.00058,1,1301058,1304551,+,3493
711,BUMA.1121.00059,1,2440673,2444166,-,3493
710,BUMA.1121.00093,2,2418377,2426154,+,7777
710,BUMA.1121.00092,2,518743,526520,-,7777
709,BUMA.1121.00093,2,2409772,2417208,+,7436
709,BUMA.1121.00092,2,527689,535125,-,7436
336,BUMA.1121.00027,1,937480,948446,+,10966
336,BUMA.1121.00025,1,4009991,4020911,-,10920
336,BUMA.1121.00021,1,3396128,3407015,+,10887
336,BUMA.1121.00023,1,1116470,1127421,+,10951
336,BUMA.1121.00024,1,2976210,2987000,-,10790
336,BUMA.1121.00033,1,985120,995989,+,10869
336,BUMA.1121.00034,1,3084818,3095608,-,10790
336,BUMA.1121.00036,1,1054393,1065183,+,10790
336,BUMA.1121.00009,1,2774039,2784824,-,10785
336,BUMA.1121.00008,1,3059023,3069813,-,10790
336,BUMA.1121.00003,1,1284645,1295527,+,10882
336,BUMA.1121.00109,1,3105897,3116814,-,10917
336,BUMA.1121.00053,1,2557298,2568161,+,10863
336,BUMA.1121.00110,1,2014059,2024815,-,10756
336,BUMA.1121.00104,1,2442992,2453778,-,10786
336,BUMA.1121.00086,1,1733818,1744602,-,10784
336,BUMA.1121.00092,1,974698,985612,-,10914
336,BUMA.1121.00096,1,472094,482977,-,10883
336,BUMA.1121.00054,1,21613,32436,-,10823
336,BUMA.1121.00097,1,1122320,1133157,-,10837
336,BUMA.1121.00093,1,3640379,3651279,+,10900
336,BUMA.1121.00106,1,2537501,2548387,+,10886
336,BUMA.1121.00035,1,3950352,3961263,+,10911
336,BUMA.1121.00108,1,3835036,3845965,+,10929
336,BUMA.1121.00028,1,3047417,3058207,-,10790
336,BUMA.1121.00094,1,2781645,2792480,+,10835
336,BUMA.1121.00102,1,2484990,2495841,-,10851
336,BUMA.1121.00111,1,2966613,2977556,+,10943
336,BUMA.1121.00089,1,2752682,2763523,+,10841
336,BUMA.1121.00084,1,3162915,3173790,+,10875
336,BUMA.1121.00029,1,2163226,2174129,-,10903
336,BUMA.1121.00012,1,1550039,1560885,+,10846
336,BUMA.1121.00087,1,1572268,1583052,+,10784
336,BUMA.1121.00043,1,2881770,2892627,+,10857
336,BUMA.1121.00046,1,2090355,2101159,+,10804
336,BUMA.1121.00037,1,1400366,1411243,+,10877
336,BUMA.1121.00080,1,2796510,2807303,+,10793
336,BUMA.1121.00079,1,2830912,2841730,+,10818
336,BUMA.1121.00045,1,1256688,1267578,-,10890
336,BUMA.1121.00071,1,2724318,2735068,+,10750
336,BUMA.1121.00056,1,1163323,1174164,-,10841
336,BUMA.1121.00065,1,2852894,2863821,+,10927
336,BUMA.1121.00058,1,1721512,1732362,-,10850
336,BUMA.1121.00007,1,1256277,1267213,-,10936
336,BUMA.1121.00067,1,1613553,1624428,-,10875
336,BUMA.1121.00090,1,873055,883971,+,10916
336,BUMA.1121.00051,1,2764725,2775523,+,10798
336,BUMA.1121.00020,1,3112230,3123020,-,10790
336,BUMA.1121.00103,1,1605261,1616067,-,10806
336,BUMA.1121.00048,1,393156,403979,+,10823
336,BUMA.1121.00047,1,145310,156192,-,10882
336,BUMA.1121.00042,1,1255195,1266018,-,10823
336,BUMA.1121.00055,1,2476984,2487777,+,10793
336,BUMA.1121.00031,1,126542,137408,+,10866
336,BUMA.1121.00040,1,3059435,3070227,-,10792
336,BUMA.1121.00044,1,2312988,2323778,-,10790
336,BUMA.1121.00088,1,3708659,3719597,+,10938
336,BUMA.1121.00069,1,2704794,2715625,+,10831
336,BUMA.1121.00064,1,2804335,2815163,+,10828
336,BUMA.1121.00105,1,2395904,2406797,-,10893
336,BUMA.1121.00015,1,2580373,2591177,+,10804
336,BUMA.1121.00059,1,2025497,2036337,+,10840
336,BUMA.1121.00022,1,3465758,3476548,-,10790
336,BUMA.1121.00101,1,3642807,3653671,-,10864
336,BUMA.1121.00001,1,1278910,1289857,-,10947
336,BUMA.1121.00038,1,600631,611454,+,10823
336,BUMA.1121.00068,1,1568480,1579377,+,10897
336,BUMA.1121.00099,1,3608835,3619853,-,11018
336,BUMA.1121.00091,1,1713631,1724525,-,10894
336,BUMA.1121.00098,1,1457772,1468696,+,10924
336,BUMA.1121.00013,1,3110736,3121480,+,10744
336,BUMA.1121.00049,1,3026510,3037332,-,10822
336,BUMA.1121.00072,1,2706288,2717172,+,10884
336,BUMA.1121.00076,1,2512892,2523741,-,10849
336,BUMA.1121.00083,1,2875593,2886493,-,10900
336,BUMA.1121.00078,1,3204233,3215060,-,10827
336,BUMA.1121.00095,1,2911850,2922729,-,10879
336,BUMA.1121.00077,1,1458407,1469162,+,10755
336,BUMA.1121.00063,1,2732231,2743114,+,10883
336,BUMA.1121.00061,1,2735437,2746269,+,10832
336,BUMA.1121.00050,1,650539,661343,-,10804
336,BUMA.1121.00081,1,600700,611523,+,10823
336,BUMA.1121.00074,1,1059198,1070080,-,10882
336,BUMA.1121.00062,1,1757936,1768768,-,10832
336,BUMA.1121.00060,1,3501899,3512789,-,10890
336,BUMA.1121.00070,1,2706533,2717392,+,10859
336,BUMA.1121.00075,1,2288560,2299409,+,10849
336,BUMA.1121.00041,1,4105101,4115914,+,10813
336,BUMA.1121.00073,1,2733624,2744505,+,10881
336,BUMA.1121.00017,1,2982483,2993273,-,10790
336,BUMA.1121.00066,1,2709103,2719983,+,10880
336,BUMA.1121.00107,1,2738168,2748996,+,10828
336,BUMA.1121.00030,1,2982553,2993343,-,10790
336,BUMA.1121.00112,1,35545,46362,-,10817
336,BUMA.1121.00082,1,2892867,2903767,+,10900
336,BUMA.1121.00014,1,4113437,4124332,-,10895
336,BUMA.1121.00011,1,2858784,2869598,-,10814
336,BUMA.1121.00019,1,2998750,3009540,-,10790
336,BUMA.1121.00057,1,3908276,3919101,+,10825
336,BUMA.1121.00018,1,3388948,3399868,+,10920
336,BUMA.1121.00039,1,2936480,2947391,+,10911
336,BUMA.1121.00016,1,909835,920754,+,10919
336,BUMA.1121.00004,1,3127658,3138447,-,10789
336,BUMA.1121.00005,1,1500859,1511741,+,10882
336,BUMA.1121.00100,1,2567448,2578377,-,10929
336,BUMA.1121.00006,1,600630,611453,+,10823
335,BUMA.1121.00027,1,922229,932078,+,9849
335,BUMA.1121.00025,1,4026304,4036079,-,9775
335,BUMA.1121.00021,1,3380757,3390649,+,9892
335,BUMA.1121.00023,1,1100968,1110843,+,9875
335,BUMA.1121.00033,1,969747,979637,+,9890
335,BUMA.1121.00034,1,3068959,3078776,+,9817
335,BUMA.1121.00036,1,1071227,1080956,-,9729
335,BUMA.1121.00032,1,1098642,1108459,+,9817
335,BUMA.1121.00009,1,2791438,2801256,-,9818
335,BUMA.1121.00008,1,3043164,3052981,+,9817
335,BUMA.1121.00003,1,1269321,1279185,+,9864
335,BUMA.1121.00109,1,3123482,3133243,-,9761
335,BUMA.1121.00053,1,2541692,2551618,+,9926
335,BUMA.1121.00110,1,2030179,2039933,-,9754
335,BUMA.1121.00104,1,2459262,2469089,-,9827
335,BUMA.1121.00086,1,1717965,1727775,+,9810
335,BUMA.1121.00092,1,991076,1000865,-,9789
335,BUMA.1121.00096,1,488431,498217,-,9786
335,BUMA.1121.00054,1,5494,15323,+,9829
335,BUMA.1121.00054,1,3515607,3525438,+,9831
335,BUMA.1121.00097,1,1138456,1148251,-,9795
335,BUMA.1121.00093,1,3625199,3635069,+,9870
335,BUMA.1121.00106,1,2522249,2532129,+,9880
335,BUMA.1121.00010,1,2108226,2117976,-,9750
335,BUMA.1121.00035,1,3934841,3944759,+,9918
335,BUMA.1121.00108,1,3819854,3829718,+,9864
335,BUMA.1121.00028,1,3031558,3041375,+,9817
335,BUMA.1121.00094,1,2766232,2776172,+,9940
335,BUMA.1121.00102,1,2501629,2511494,-,9865
335,BUMA.1121.00111,1,2951249,2961139,+,9890
335,BUMA.1121.00089,1,2737269,2747209,+,9940
335,BUMA.1121.00084,1,3147619,3157608,+,9989
335,BUMA.1121.00029,1,2179395,2189204,-,9809
335,BUMA.1121.00012,1,1534584,1544481,+,9897
335,BUMA.1121.00087,1,1589095,1598824,-,9729
335,BUMA.1121.00043,1,2866237,2876127,+,9890
335,BUMA.1121.00046,1,2107201,2116958,-,9757
335,BUMA.1121.00037,1,1383595,1393513,+,9918
335,BUMA.1121.00080,1,2781027,2790995,+,9968
335,BUMA.1121.00079,1,2815430,2825383,+,9953
335,BUMA.1121.00045,1,1272900,1282653,-,9753
335,BUMA.1121.00071,1,2709145,2719001,+,9856
335,BUMA.1121.00056,1,1179490,1189328,-,9838
335,BUMA.1121.00065,1,2837653,2847551,+,9898
335,BUMA.1121.00058,1,1737664,1747432,-,9768
335,BUMA.1121.00007,1,1272577,1282475,-,9898
335,BUMA.1121.00067,1,1629963,1639829,-,9866
335,BUMA.1121.00090,1,857821,867690,+,9869
335,BUMA.1121.00051,1,2749222,2759266,+,10044
335,BUMA.1121.00020,1,3096371,3106188,+,9817
335,BUMA.1121.00103,1,1621412,1631192,-,9780
335,BUMA.1121.00048,1,410270,420020,-,9750
335,BUMA.1121.00047,1,161603,171552,-,9949
335,BUMA.1121.00042,1,1270482,1280295,-,9813
335,BUMA.1121.00055,1,2461763,2471618,+,9855
335,BUMA.1121.00031,1,111166,121036,+,9870
335,BUMA.1121.00040,1,3043555,3053393,+,9838
335,BUMA.1121.00044,1,2297129,2306946,+,9817
335,BUMA.1121.00088,1,3693167,3703077,+,9910
335,BUMA.1121.00069,1,2689621,2699477,+,9856
335,BUMA.1121.00064,1,2789125,2798949,+,9824
335,BUMA.1121.00105,1,2412090,2421872,-,9782
335,BUMA.1121.00015,1,2597219,2606969,-,9750
335,BUMA.1121.00059,1,2010157,2020034,+,9877
335,BUMA.1121.00026,1,2334054,2343825,-,9771
335,BUMA.1121.00022,1,3449906,3459716,+,9810
335,BUMA.1121.00052,1,2816301,2826139,+,9838
335,BUMA.1121.00101,1,3659029,3668805,-,9776
335,BUMA.1121.00001,1,1295123,1304911,-,9788
335,BUMA.1121.00038,1,617745,627495,-,9750
335,BUMA.1121.00068,1,1551930,1561780,+,9850
335,BUMA.1121.00099,1,3625393,3635195,-,9802
335,BUMA.1121.00091,1,1729948,1739800,-,9852
335,BUMA.1121.00098,1,1442510,1452414,+,9904
335,BUMA.1121.00013,1,3096427,3106272,+,9845
335,BUMA.1121.00049,1,3042858,3052669,-,9811
335,BUMA.1121.00072,1,2691114,2700970,+,9856
335,BUMA.1121.00076,1,2529302,2539280,-,9978
335,BUMA.1121.00083,1,2891811,2901586,-,9775
335,BUMA.1121.00078,1,3220481,3230253,-,9772
335,BUMA.1121.00095,1,2928146,2937881,-,9735
335,BUMA.1121.00077,1,1443217,1453052,+,9835
335,BUMA.1121.00063,1,2717058,2726914,+,9856
335,BUMA.1121.00061,1,2720265,2730121,+,9856
335,BUMA.1121.00050,1,634659,644497,+,9838
335,BUMA.1121.00081,1,617814,627564,-,9750
335,BUMA.1121.00074,1,1075459,1085297,-,9838
335,BUMA.1121.00062,1,1774294,1784055,-,9761
335,BUMA.1121.00060,1,3518153,3527906,-,9753
335,BUMA.1121.00070,1,2691359,2701215,+,9856
335,BUMA.1121.00075,1,2273122,2283104,+,9982
335,BUMA.1121.00041,1,4089885,4099768,+,9883
335,BUMA.1121.00073,1,2718450,2728306,+,9856
335,BUMA.1121.00017,1,2966624,2976441,+,9817
335,BUMA.1121.00066,1,2693931,2703787,+,9856
335,BUMA.1121.00107,1,2722867,2732757,+,9890
335,BUMA.1121.00085,1,2413247,2423085,+,9838
335,BUMA.1121.00030,1,2966694,2976511,+,9817
335,BUMA.1121.00112,1,51658,61447,-,9789
335,BUMA.1121.00002,1,2135085,2144835,-,9750
335,BUMA.1121.00082,1,2877693,2887549,+,9856
335,BUMA.1121.00014,1,4129947,4139737,-,9790
335,BUMA.1121.00011,1,2874905,2884686,-,9781
335,BUMA.1121.00019,1,2982891,2992708,+,9817
335,BUMA.1121.00057,1,3893018,3902895,+,9877
335,BUMA.1121.00018,1,3373592,3383455,+,9863
335,BUMA.1121.00039,1,2921120,2931003,+,9883
335,BUMA.1121.00016,1,894340,904300,+,9960
335,BUMA.1121.00004,1,3011683,3021500,+,9817
335,BUMA.1121.00004,1,3061739,3071556,+,9817
335,BUMA.1121.00004,1,3111795,3121616,+,9821
335,BUMA.1121.00005,1,1485384,1495337,+,9953
335,BUMA.1121.00100,1,2584108,2593903,-,9795
335,BUMA.1121.00006,1,617744,627494,-,9750
334,BUMA.1121.00027,1,902951,916447,+,13496
334,BUMA.1121.00025,1,4041950,4055458,-,13508
334,BUMA.1121.00021,1,3361448,3374956,+,13508
334,BUMA.1121.00023,1,1081659,1095179,+,13520
334,BUMA.1121.00033,1,950438,963946,+,13508
334,BUMA.1121.00034,1,3049865,3063159,+,13294
334,BUMA.1121.00036,1,1086841,1100131,-,13290
334,BUMA.1121.00032,1,1079548,1092842,+,13294
334,BUMA.1121.00009,1,2807150,2820649,-,13499
334,BUMA.1121.00008,1,3024070,3037364,+,13294
334,BUMA.1121.00003,1,1250027,1263515,+,13488
334,BUMA.1121.00109,1,3139102,3152601,-,13499
334,BUMA.1121.00053,1,2522431,2535918,+,13487
334,BUMA.1121.00110,1,2045703,2059202,-,13499
334,BUMA.1121.00104,1,2474967,2488466,-,13499
334,BUMA.1121.00086,1,1698883,1712173,+,13290
334,BUMA.1121.00092,1,1006736,1020226,-,13490
334,BUMA.1121.00096,1,504115,517609,-,13494
334,BUMA.1121.00054,1,3496513,3509807,+,13294
334,BUMA.1121.00097,1,1154137,1167634,-,13497
334,BUMA.1121.00093,1,3605919,3619409,+,13490
334,BUMA.1121.00106,1,2502958,2516468,+,13510
334,BUMA.1121.00010,1,2123857,2137151,-,13294
334,BUMA.1121.00035,1,3915532,3929040,+,13508
334,BUMA.1121.00108,1,3800578,3814073,+,13495
334,BUMA.1121.00028,1,3012464,3025758,+,13294
334,BUMA.1121.00094,1,2746935,2760431,+,13496
334,BUMA.1121.00102,1,2518686,2532185,-,13499
334,BUMA.1121.00111,1,2931928,2945448,+,13520
334,BUMA.1121.00089,1,2717972,2731468,+,13496
334,BUMA.1121.00084,1,3128338,3141849,+,13511
334,BUMA.1121.00029,1,2195086,2208594,-,13508
334,BUMA.1121.00012,1,1515303,1528811,+,13508
334,BUMA.1121.00087,1,1604697,1617987,-,13290
334,BUMA.1121.00043,1,2846912,2860420,+,13508
334,BUMA.1121.00046,1,2122847,2136141,-,13294
334,BUMA.1121.00037,1,1364285,1377794,+,13509
334,BUMA.1121.00080,1,2761730,2775226,+,13496
334,BUMA.1121.00079,1,2796133,2809629,+,13496
334,BUMA.1121.00045,1,1288539,1302035,-,13496
334,BUMA.1121.00071,1,2689864,2703363,+,13499
334,BUMA.1121.00056,1,1195210,1208706,-,13496
334,BUMA.1121.00065,1,2818401,2831891,+,13490
334,BUMA.1121.00058,1,1753303,1766816,-,13513
334,BUMA.1121.00007,1,1288358,1301871,-,13513
334,BUMA.1121.00067,1,1645711,1659221,-,13510
334,BUMA.1121.00090,1,838528,852036,+,13508
334,BUMA.1121.00051,1,2729925,2743421,+,13496
334,BUMA.1121.00020,1,3077277,3090571,+,13294
334,BUMA.1121.00103,1,1637086,1650582,-,13496
334,BUMA.1121.00048,1,425901,439195,-,13294
334,BUMA.1121.00047,1,177434,190930,-,13496
334,BUMA.1121.00042,1,1286176,1299669,-,13493
334,BUMA.1121.00055,1,2442480,2455993,+,13513
334,BUMA.1121.00031,1,91851,105366,+,13515
334,BUMA.1121.00040,1,3024453,3037747,+,13294
334,BUMA.1121.00044,1,2278035,2291329,+,13294
334,BUMA.1121.00088,1,3673870,3687366,+,13496
334,BUMA.1121.00069,1,2670340,2683839,+,13499
334,BUMA.1121.00064,1,2769760,2783254,+,13494
334,BUMA.1121.00105,1,2427746,2441254,-,13508
334,BUMA.1121.00015,1,2612850,2626144,-,13294
334,BUMA.1121.00059,1,1990874,2004387,+,13513
334,BUMA.1121.00026,1,2349694,2363189,-,13495
334,BUMA.1121.00022,1,3430826,3444116,+,13290
334,BUMA.1121.00052,1,2797207,2810501,+,13294
334,BUMA.1121.00101,1,3674703,3688198,-,13495
334,BUMA.1121.00001,1,1310792,1324300,-,13508
334,BUMA.1121.00038,1,633376,646670,-,13294
334,BUMA.1121.00068,1,1532668,1546153,+,13485
334,BUMA.1121.00099,1,3641089,3654585,-,13496
334,BUMA.1121.00091,1,1745686,1759182,-,13496
334,BUMA.1121.00098,1,1423233,1436727,+,13494
334,BUMA.1121.00013,1,3077333,3090627,+,13294
334,BUMA.1121.00049,1,3058563,3072062,-,13499
334,BUMA.1121.00072,1,2671833,2685332,+,13499
334,BUMA.1121.00076,1,2545123,2558622,-,13499
334,BUMA.1121.00083,1,2907449,2920948,-,13499
334,BUMA.1121.00078,1,3236139,3249640,-,13501
334,BUMA.1121.00095,1,2943756,2957251,-,13495
334,BUMA.1121.00077,1,1424029,1437528,+,13499
334,BUMA.1121.00063,1,2697777,2711276,+,13499
334,BUMA.1121.00061,1,2700984,2714483,+,13499
334,BUMA.1121.00050,1,615557,628851,+,13294
334,BUMA.1121.00081,1,633445,646739,-,13294
334,BUMA.1121.00074,1,1091168,1104678,-,13510
334,BUMA.1121.00062,1,1789918,1803431,-,13513
334,BUMA.1121.00060,1,3533792,3547288,-,13496
334,BUMA.1121.00070,1,2672078,2685577,+,13499
334,BUMA.1121.00075,1,2253861,2267360,+,13499
334,BUMA.1121.00041,1,4070589,4084076,+,13487
334,BUMA.1121.00073,1,2699169,2712668,+,13499
334,BUMA.1121.00017,1,2947530,2960824,+,13294
334,BUMA.1121.00066,1,2674650,2688149,+,13499
334,BUMA.1121.00107,1,2703570,2717066,+,13496
334,BUMA.1121.00085,1,2394153,2407447,+,13294
334,BUMA.1121.00030,1,2947600,2960894,+,13294
334,BUMA.1121.00112,1,67317,80804,-,13487
334,BUMA.1121.00002,1,2150716,2164010,-,13294
334,BUMA.1121.00082,1,2858412,2871911,+,13499
334,BUMA.1121.00014,1,4145619,4159134,-,13515
334,BUMA.1121.00011,1,2890572,2904059,-,13487
334,BUMA.1121.00019,1,2963797,2977091,+,13294
334,BUMA.1121.00057,1,3873737,3887236,+,13499
334,BUMA.1121.00018,1,3354294,3367802,+,13508
334,BUMA.1121.00039,1,2901832,2915330,+,13498
334,BUMA.1121.00016,1,875031,888539,+,13508
334,BUMA.1121.00004,1,2992589,3005883,+,13294
334,BUMA.1121.00004,1,3042645,3055939,+,13294
334,BUMA.1121.00004,1,3092701,3105995,+,13294
334,BUMA.1121.00005,1,1466091,1479605,+,13514
334,BUMA.1121.00100,1,2599785,2613281,-,13496
334,BUMA.1121.00006,1,633375,646669,-,13294
333,BUMA.1121.00027,1,886199,902947,+,16748
333,BUMA.1121.00025,1,4055462,4072217,-,16755
333,BUMA.1121.00021,1,3344689,3361444,+,16755
333,BUMA.1121.00023,1,1064889,1081655,+,16766
333,BUMA.1121.00033,1,933708,950434,+,16726
333,BUMA.1121.00034,1,3033228,3049861,+,16633
333,BUMA.1121.00036,1,1100135,1116768,-,16633
333,BUMA.1121.00032,1,1062911,1079544,+,16633
333,BUMA.1121.00009,1,2820653,2837335,-,16682
333,BUMA.1121.00008,1,3007433,3024066,+,16633
333,BUMA.1121.00003,1,1233309,1250023,+,16714
333,BUMA.1121.00109,1,3152605,3169279,-,16674
333,BUMA.1121.00053,1,2504404,2521070,+,16666
333,BUMA.1121.00110,1,2059206,2075938,-,16732
333,BUMA.1121.00104,1,2488470,2505196,-,16726
333,BUMA.1121.00086,1,1682266,1698879,+,16613
333,BUMA.1121.00092,1,1020230,1036915,-,16685
333,BUMA.1121.00096,1,517613,534316,-,16703
333,BUMA.1121.00054,1,3479878,3496509,+,16631
333,BUMA.1121.00097,1,1167638,1184281,-,16643
333,BUMA.1121.00093,1,3589230,3605915,+,16685
333,BUMA.1121.00106,1,2486227,2502954,+,16727
333,BUMA.1121.00010,1,2137155,2153788,-,16633
333,BUMA.1121.00035,1,3898792,3915528,+,16736
333,BUMA.1121.00108,1,3783850,3800574,+,16724
333,BUMA.1121.00028,1,2995827,3012460,+,16633
333,BUMA.1121.00094,1,2730203,2746931,+,16728
333,BUMA.1121.00102,1,2532189,2548855,-,16666
333,BUMA.1121.00111,1,2915216,2931924,+,16708
333,BUMA.1121.00089,1,2701229,2717968,+,16739
333,BUMA.1121.00084,1,3111667,3128334,+,16667
333,BUMA.1121.00029,1,2208598,2225308,-,16710
333,BUMA.1121.00012,1,1498551,1515299,+,16748
333,BUMA.1121.00087,1,1617991,1634604,-,16613
333,BUMA.1121.00043,1,2830169,2846908,+,16739
333,BUMA.1121.00046,1,2136145,2152778,-,16633
333,BUMA.1121.00037,1,1347550,1364281,+,16731
333,BUMA.1121.00080,1,2745020,2761726,+,16706
333,BUMA.1121.00079,1,2779455,2796129,+,16674
333,BUMA.1121.00045,1,1302039,1318705,-,16666
333,BUMA.1121.00071,1,2673211,2689860,+,16649
333,BUMA.1121.00056,1,1208710,1225464,-,16754
333,BUMA.1121.00065,1,2801692,2818388,+,16696
333,BUMA.1121.00058,1,1766820,1783483,-,16663
333,BUMA.1121.00007,1,1301875,1318535,-,16660
333,BUMA.1121.00067,1,1659225,1675913,-,16688
333,BUMA.1121.00090,1,821777,838524,+,16747
333,BUMA.1121.00051,1,2713199,2729921,+,16722
333,BUMA.1121.00020,1,3060640,3077273,+,16633
333,BUMA.1121.00103,1,1650586,1667237,-,16651
333,BUMA.1121.00048,1,439199,455830,-,16631
333,BUMA.1121.00047,1,190934,207625,-,16691
333,BUMA.1121.00042,1,1299673,1316306,-,16633
333,BUMA.1121.00055,1,2425766,2442476,+,16710
333,BUMA.1121.00031,1,75080,91847,+,16767
333,BUMA.1121.00040,1,3007816,3024449,+,16633
333,BUMA.1121.00044,1,2261398,2278031,+,16633
333,BUMA.1121.00088,1,3657176,3673866,+,16690
333,BUMA.1121.00069,1,2653687,2670336,+,16649
333,BUMA.1121.00064,1,2753086,2769756,+,16670
333,BUMA.1121.00105,1,2441258,2457915,-,16657
333,BUMA.1121.00015,1,2626148,2642781,-,16633
333,BUMA.1121.00059,1,1974179,1990870,+,16691
333,BUMA.1121.00026,1,2363193,2379826,-,16633
333,BUMA.1121.00022,1,3412949,3429503,+,16554
333,BUMA.1121.00052,1,2780570,2797203,+,16633
333,BUMA.1121.00101,1,3688202,3704861,-,16659
333,BUMA.1121.00001,1,1324304,1340983,-,16679
333,BUMA.1121.00038,1,646674,663305,-,16631
333,BUMA.1121.00068,1,1515956,1532655,+,16699
333,BUMA.1121.00099,1,3654589,3671300,-,16711
333,BUMA.1121.00091,1,1759186,1775873,-,16687
333,BUMA.1121.00098,1,1406569,1423229,+,16660
333,BUMA.1121.00013,1,3060696,3077329,+,16633
333,BUMA.1121.00049,1,3072066,3088785,-,16719
333,BUMA.1121.00072,1,2655178,2671829,+,16651
333,BUMA.1121.00076,1,2558626,2575342,-,16716
333,BUMA.1121.00083,1,2920952,2937604,-,16652
333,BUMA.1121.00078,1,3249653,3266294,-,16641
333,BUMA.1121.00095,1,2957255,2974029,-,16774
333,BUMA.1121.00077,1,1407293,1424025,+,16732
333,BUMA.1121.00063,1,2681124,2697773,+,16649
333,BUMA.1121.00061,1,2684329,2700980,+,16651
333,BUMA.1121.00050,1,598920,615553,+,16633
333,BUMA.1121.00081,1,646743,663374,-,16631
333,BUMA.1121.00074,1,1104682,1121386,-,16704
333,BUMA.1121.00062,1,1803435,1820130,-,16695
333,BUMA.1121.00060,1,3547292,3563966,-,16674
333,BUMA.1121.00070,1,2655431,2672074,+,16643
333,BUMA.1121.00075,1,2237119,2253857,+,16738
333,BUMA.1121.00041,1,4053856,4070576,+,16720
333,BUMA.1121.00073,1,2682515,2699165,+,16650
333,BUMA.1121.00017,1,2930893,2947526,+,16633
333,BUMA.1121.00066,1,2657995,2674646,+,16651
333,BUMA.1121.00107,1,2686896,2703566,+,16670
333,BUMA.1121.00085,1,2377516,2394149,+,16633
333,BUMA.1121.00030,1,2930963,2947596,+,16633
333,BUMA.1121.00112,1,80817,97516,-,16699
333,BUMA.1121.00002,1,2164014,2180647,-,16633
333,BUMA.1121.00082,1,2841757,2858408,+,16651
333,BUMA.1121.00014,1,4159138,4175921,-,16783
333,BUMA.1121.00011,1,2904072,2920721,-,16649
333,BUMA.1121.00019,1,2947160,2963793,+,16633
333,BUMA.1121.00057,1,3857041,3873733,+,16692
333,BUMA.1121.00018,1,3337535,3354290,+,16755
333,BUMA.1121.00039,1,2885061,2901828,+,16767
333,BUMA.1121.00016,1,858305,875027,+,16722
333,BUMA.1121.00004,1,2975961,2992585,+,16624
333,BUMA.1121.00004,1,3026010,3042641,+,16631
333,BUMA.1121.00004,1,3076066,3092697,+,16631
333,BUMA.1121.00005,1,1449401,1466087,+,16686
333,BUMA.1121.00100,1,2613285,2629987,-,16702
333,BUMA.1121.00006,1,646673,663304,-,16631
332,BUMA.1121.00027,1,879199,886197,+,6998
332,BUMA.1121.00025,1,4072218,4079203,-,6985
332,BUMA.1121.00021,1,3337715,3344687,+,6972
332,BUMA.1121.00023,1,1057899,1064887,+,6988
332,BUMA.1121.00033,1,926698,933706,+,7008
332,BUMA.1121.00034,1,3026219,3033226,+,7007
332,BUMA.1121.00036,1,1116769,1123771,-,7002
332,BUMA.1121.00032,1,1055902,1062909,+,7007
332,BUMA.1121.00009,1,2837336,2844227,-,6891
332,BUMA.1121.00008,1,3000424,3007431,+,7007
332,BUMA.1121.00003,1,1226304,1233307,+,7003
332,BUMA.1121.00109,1,3169280,3176272,-,6992
332,BUMA.1121.00053,1,2497401,2504402,+,7001
332,BUMA.1121.00110,1,2075939,2082928,-,6989
332,BUMA.1121.00104,1,2505197,2512205,-,7008
332,BUMA.1121.00086,1,1675257,1682264,+,7007
332,BUMA.1121.00092,1,1036916,1043920,-,7004
332,BUMA.1121.00096,1,534317,541370,-,7053
332,BUMA.1121.00054,1,3472869,3479876,+,7007
332,BUMA.1121.00097,1,1184282,1191280,-,6998
332,BUMA.1121.00093,1,3582225,3589228,+,7003
332,BUMA.1121.00106,1,2479224,2486225,+,7001
332,BUMA.1121.00010,1,2153789,2160797,-,7008
332,BUMA.1121.00035,1,3891818,3898790,+,6972
332,BUMA.1121.00108,1,3776835,3783848,+,7013
332,BUMA.1121.00028,1,2988818,2995825,+,7007
332,BUMA.1121.00094,1,2723198,2730201,+,7003
332,BUMA.1121.00102,1,2548856,2555902,-,7046
332,BUMA.1121.00111,1,2908242,2915214,+,6972
332,BUMA.1121.00089,1,2694224,2701227,+,7003
332,BUMA.1121.00084,1,3104675,3111665,+,6990
332,BUMA.1121.00029,1,2225309,2232281,-,6972
332,BUMA.1121.00012,1,1491572,1498549,+,6977
332,BUMA.1121.00087,1,1634605,1641613,-,7008
332,BUMA.1121.00043,1,2823174,2830167,+,6993
332,BUMA.1121.00046,1,2152779,2159793,-,7014
332,BUMA.1121.00037,1,1340576,1347548,+,6972
332,BUMA.1121.00080,1,2738015,2745018,+,7003
332,BUMA.1121.00079,1,2772475,2779453,+,6978
332,BUMA.1121.00045,1,1318706,1325721,-,7015
332,BUMA.1121.00071,1,2666211,2673209,+,6998
332,BUMA.1121.00056,1,1225465,1232468,-,7003
332,BUMA.1121.00065,1,2794686,2801690,+,7004
332,BUMA.1121.00058,1,1783484,1790451,-,6967
332,BUMA.1121.00007,1,1318536,1325573,-,7037
332,BUMA.1121.00067,1,1675914,1682887,-,6973
332,BUMA.1121.00090,1,814797,821775,+,6978
332,BUMA.1121.00051,1,2706194,2713197,+,7003
332,BUMA.1121.00020,1,3053631,3060638,+,7007
332,BUMA.1121.00103,1,1667238,1674247,-,7009
332,BUMA.1121.00048,1,455831,462839,-,7008
332,BUMA.1121.00047,1,207626,214630,-,7004
332,BUMA.1121.00042,1,1316307,1323309,-,7002
332,BUMA.1121.00055,1,2418787,2425764,+,6977
332,BUMA.1121.00031,1,68112,75078,+,6966
332,BUMA.1121.00040,1,3000807,3007814,+,7007
332,BUMA.1121.00044,1,2254389,2261396,+,7007
332,BUMA.1121.00088,1,3650203,3657174,+,6971
332,BUMA.1121.00069,1,2646683,2653685,+,7002
332,BUMA.1121.00064,1,2746092,2753084,+,6992
332,BUMA.1121.00105,1,2457916,2464906,-,6990
332,BUMA.1121.00015,1,2642782,2649790,-,7008
332,BUMA.1121.00059,1,1967198,1974177,+,6979
332,BUMA.1121.00026,1,2379827,2386841,-,7014
332,BUMA.1121.00022,1,3405922,3412947,+,7025
332,BUMA.1121.00052,1,2773555,2780568,+,7013
332,BUMA.1121.00101,1,3704862,3711859,-,6997
332,BUMA.1121.00001,1,1340984,1347956,-,6972
332,BUMA.1121.00038,1,663306,670314,-,7008
332,BUMA.1121.00068,1,1508968,1515954,+,6986
332,BUMA.1121.00099,1,3671301,3678186,-,6885
332,BUMA.1121.00091,1,1775874,1782865,-,6991
332,BUMA.1121.00098,1,1399686,1406567,+,6881
332,BUMA.1121.00013,1,3053681,3060694,+,7013
332,BUMA.1121.00049,1,3088786,3095799,-,7013
332,BUMA.1121.00072,1,2648175,2655176,+,7001
332,BUMA.1121.00076,1,2575343,2582355,-,7012
332,BUMA.1121.00083,1,2937605,2944608,-,7003
332,BUMA.1121.00078,1,3266295,3273309,-,7014
332,BUMA.1121.00095,1,2974030,2981062,-,7032
332,BUMA.1121.00077,1,1400303,1407291,+,6988
332,BUMA.1121.00063,1,2674121,2681122,+,7001
332,BUMA.1121.00061,1,2677327,2684327,+,7000
332,BUMA.1121.00050,1,591905,598918,+,7013
332,BUMA.1121.00081,1,663375,670383,-,7008
332,BUMA.1121.00074,1,1121387,1128366,-,6979
332,BUMA.1121.00062,1,1820131,1827111,-,6980
332,BUMA.1121.00060,1,3563967,3570982,-,7015
332,BUMA.1121.00070,1,2648446,2655429,+,6983
332,BUMA.1121.00075,1,2230100,2237117,+,7017
332,BUMA.1121.00041,1,4046821,4053854,+,7033
332,BUMA.1121.00073,1,2675530,2682513,+,6983
332,BUMA.1121.00017,1,2923884,2930891,+,7007
332,BUMA.1121.00066,1,2650991,2657993,+,7002
332,BUMA.1121.00107,1,2680011,2686894,+,6883
332,BUMA.1121.00085,1,2370501,2377514,+,7013
332,BUMA.1121.00030,1,2923954,2930961,+,7007
332,BUMA.1121.00112,1,97517,104508,-,6991
332,BUMA.1121.00002,1,2180648,2187656,-,7008
332,BUMA.1121.00082,1,2834753,2841755,+,7002
332,BUMA.1121.00014,1,4175922,4182889,-,6967
332,BUMA.1121.00011,1,2920722,2927739,-,7017
332,BUMA.1121.00019,1,2940151,2947158,+,7007
332,BUMA.1121.00057,1,3850042,3857039,+,6997
332,BUMA.1121.00018,1,3330549,3337533,+,6984
332,BUMA.1121.00039,1,2878061,2885059,+,6998
332,BUMA.1121.00016,1,851313,858303,+,6990
332,BUMA.1121.00005,1,1442398,1449399,+,7001
332,BUMA.1121.00100,1,2629988,2636875,-,6887
332,BUMA.1121.00006,1,663305,670313,-,7008
331,BUMA.1121.00027,1,869023,878829,+,9806
331,BUMA.1121.00025,1,4079572,4089378,-,9806
331,BUMA.1121.00021,1,3327539,3337345,+,9806
331,BUMA.1121.00023,1,1047723,1057529,+,9806
331,BUMA.1121.00033,1,916524,926328,+,9804
331,BUMA.1121.00034,1,3016032,3025849,+,9817
331,BUMA.1121.00036,1,1124140,1133957,-,9817
331,BUMA.1121.00032,1,1045715,1055532,+,9817
331,BUMA.1121.00009,1,2844596,2854402,-,9806
331,BUMA.1121.00008,1,2990237,3000054,+,9817
331,BUMA.1121.00003,1,1216117,1225934,+,9817
331,BUMA.1121.00109,1,3176641,3186448,-,9807
331,BUMA.1121.00053,1,2487225,2497031,+,9806
331,BUMA.1121.00110,1,2083297,2093104,-,9807
331,BUMA.1121.00104,1,2512574,2522402,-,9828
331,BUMA.1121.00086,1,1665070,1674887,+,9817
331,BUMA.1121.00092,1,1044289,1054095,-,9806
331,BUMA.1121.00096,1,541739,551545,-,9806
331,BUMA.1121.00054,1,3462682,3472499,+,9817
331,BUMA.1121.00097,1,1191649,1201478,-,9829
331,BUMA.1121.00093,1,3572049,3581855,+,9806
331,BUMA.1121.00106,1,2469048,2478854,+,9806
331,BUMA.1121.00010,1,2161166,2170983,-,9817
331,BUMA.1121.00035,1,3881642,3891448,+,9806
331,BUMA.1121.00108,1,3766648,3776465,+,9817
331,BUMA.1121.00028,1,2978631,2988448,+,9817
331,BUMA.1121.00094,1,2711664,2721471,+,9807
331,BUMA.1121.00102,1,2556271,2566088,-,9817
331,BUMA.1121.00111,1,2898066,2907872,+,9806
331,BUMA.1121.00089,1,2682691,2692497,+,9806
331,BUMA.1121.00084,1,3094499,3104305,+,9806
331,BUMA.1121.00029,1,2232650,2242456,-,9806
331,BUMA.1121.00012,1,1481396,1491202,+,9806
331,BUMA.1121.00087,1,1641982,1651799,-,9817
331,BUMA.1121.00043,1,2813000,2822804,+,9804
331,BUMA.1121.00046,1,2160162,2169979,-,9817
331,BUMA.1121.00037,1,1330400,1340206,+,9806
331,BUMA.1121.00080,1,2726482,2736288,+,9806
331,BUMA.1121.00079,1,2760942,2770748,+,9806
331,BUMA.1121.00045,1,1326090,1335896,-,9806
331,BUMA.1121.00071,1,2656035,2665841,+,9806
331,BUMA.1121.00056,1,1234194,1244000,-,9806
331,BUMA.1121.00065,1,2784510,2794316,+,9806
331,BUMA.1121.00058,1,1790820,1800626,-,9806
331,BUMA.1121.00007,1,1325942,1335748,-,9806
331,BUMA.1121.00067,1,1683256,1693062,-,9806
331,BUMA.1121.00090,1,804621,814427,+,9806
331,BUMA.1121.00051,1,2694661,2704467,+,9806
331,BUMA.1121.00020,1,3043444,3053261,+,9817
331,BUMA.1121.00103,1,1674616,1684430,-,9814
331,BUMA.1121.00048,1,463208,473025,-,9817
331,BUMA.1121.00047,1,216356,226162,-,9806
331,BUMA.1121.00042,1,1323678,1333495,-,9817
331,BUMA.1121.00055,1,2408589,2418417,+,9828
331,BUMA.1121.00031,1,57936,67742,+,9806
331,BUMA.1121.00040,1,2990620,3000437,+,9817
331,BUMA.1121.00044,1,2244202,2254019,+,9817
331,BUMA.1121.00088,1,3640027,3649833,+,9806
331,BUMA.1121.00069,1,2636507,2646313,+,9806
331,BUMA.1121.00064,1,2735916,2745722,+,9806
331,BUMA.1121.00105,1,2465275,2475081,-,9806
331,BUMA.1121.00015,1,2650159,2659976,-,9817
331,BUMA.1121.00059,1,1957011,1966828,+,9817
331,BUMA.1121.00026,1,2387210,2397011,-,9801
331,BUMA.1121.00022,1,3395735,3405552,+,9817
331,BUMA.1121.00052,1,2763368,2773185,+,9817
331,BUMA.1121.00101,1,3712228,3722045,-,9817
331,BUMA.1121.00001,1,1348324,1358130,-,9806
331,BUMA.1121.00038,1,670683,680500,-,9817
331,BUMA.1121.00068,1,1498783,1508598,+,9815
331,BUMA.1121.00099,1,3678555,3688361,-,9806
331,BUMA.1121.00091,1,1783234,1793051,-,9817
331,BUMA.1121.00098,1,1389510,1399316,+,9806
331,BUMA.1121.00013,1,3043494,3053311,+,9817
331,BUMA.1121.00049,1,3096168,3105974,-,9806
331,BUMA.1121.00072,1,2637999,2647805,+,9806
331,BUMA.1121.00076,1,2582724,2592530,-,9806
331,BUMA.1121.00083,1,2944977,2954783,-,9806
331,BUMA.1121.00078,1,3273678,3283517,-,9839
331,BUMA.1121.00095,1,2981431,2991237,-,9806
331,BUMA.1121.00077,1,1390126,1399933,+,9807
331,BUMA.1121.00063,1,2663945,2673751,+,9806
331,BUMA.1121.00061,1,2667151,2676957,+,9806
331,BUMA.1121.00050,1,581718,591535,+,9817
331,BUMA.1121.00081,1,670752,680569,-,9817
331,BUMA.1121.00074,1,1128735,1138541,-,9806
331,BUMA.1121.00062,1,1827480,1837286,-,9806
331,BUMA.1121.00060,1,3571351,3581157,-,9806
331,BUMA.1121.00070,1,2638264,2648070,+,9806
331,BUMA.1121.00075,1,2219925,2229730,+,9805
331,BUMA.1121.00041,1,4036634,4046451,+,9817
331,BUMA.1121.00073,1,2665348,2675154,+,9806
331,BUMA.1121.00017,1,2913697,2923514,+,9817
331,BUMA.1121.00066,1,2640815,2650621,+,9806
331,BUMA.1121.00107,1,2669836,2679641,+,9805
331,BUMA.1121.00085,1,2360314,2370131,+,9817
331,BUMA.1121.00030,1,2913767,2923584,+,9817
331,BUMA.1121.00112,1,104877,114684,-,9807
331,BUMA.1121.00002,1,2188025,2197842,-,9817
331,BUMA.1121.00082,1,2824577,2834383,+,9806
331,BUMA.1121.00014,1,4183258,4193064,-,9806
331,BUMA.1121.00011,1,2928108,2937914,-,9806
331,BUMA.1121.00019,1,2929964,2939781,+,9817
331,BUMA.1121.00057,1,3839866,3849672,+,9806
331,BUMA.1121.00018,1,3320373,3330179,+,9806
331,BUMA.1121.00039,1,2867887,2877691,+,9804
331,BUMA.1121.00016,1,841139,850943,+,9804
331,BUMA.1121.00005,1,1432211,1442028,+,9817
331,BUMA.1121.00100,1,2637244,2647046,-,9802
331,BUMA.1121.00006,1,670682,680499,-,9817
330,BUMA.1121.00027,1,859570,862956,+,3386
330,BUMA.1121.00025,1,4096323,4099632,-,3309
330,BUMA.1121.00021,1,3316684,3320098,+,3414
330,BUMA.1121.00023,1,1035586,1038992,+,3406
330,BUMA.1121.00024,1,2850609,2853934,+,3325
330,BUMA.1121.00033,1,905616,909085,+,3469
330,BUMA.1121.00034,1,2889372,2892697,+,3325
330,BUMA.1121.00036,1,1257364,1260680,-,3316
330,BUMA.1121.00032,1,919017,922342,+,3325
330,BUMA.1121.00009,1,2859762,2863071,-,3309
330,BUMA.1121.00008,1,2863623,2866948,+,3325
330,BUMA.1121.00003,1,1207386,1210698,+,3312
330,BUMA.1121.00109,1,3192345,3195648,-,3303
330,BUMA.1121.00053,1,2477714,2481157,+,3443
330,BUMA.1121.00110,1,2100718,2104021,-,3303
330,BUMA.1121.00104,1,2528471,2531781,-,3310
330,BUMA.1121.00086,1,1538302,1541627,+,3325
330,BUMA.1121.00092,1,1059454,1062770,-,3316
330,BUMA.1121.00096,1,557567,560880,-,3313
330,BUMA.1121.00054,1,2295709,2299025,-,3316
330,BUMA.1121.00097,1,1208502,1211811,-,3309
330,BUMA.1121.00093,1,3563375,3566691,+,3316
330,BUMA.1121.00106,1,2459573,2462980,+,3407
330,BUMA.1121.00010,1,2384087,2387397,-,3310
330,BUMA.1121.00035,1,3869556,3872908,+,3352
330,BUMA.1121.00108,1,3757081,3760520,+,3439
330,BUMA.1121.00028,1,2851932,2855257,+,3325
330,BUMA.1121.00094,1,2701597,2705024,+,3427
330,BUMA.1121.00102,1,2571472,2574786,-,3314
330,BUMA.1121.00111,1,2887318,2890625,+,3307
330,BUMA.1121.00089,1,2672624,2676051,+,3427
330,BUMA.1121.00084,1,3085099,3088431,+,3332
330,BUMA.1121.00029,1,2251191,2254500,-,3309
330,BUMA.1121.00012,1,1449421,1452829,+,3408
330,BUMA.1121.00087,1,1775252,1778568,-,3316
330,BUMA.1121.00043,1,2789645,2793136,+,3491
330,BUMA.1121.00046,1,3406184,3409500,+,3316
330,BUMA.1121.00037,1,1319598,1322959,+,3361
330,BUMA.1121.00080,1,2717650,2721100,+,3450
330,BUMA.1121.00079,1,2752093,2755560,+,3467
330,BUMA.1121.00045,1,1341325,1344632,-,3307
330,BUMA.1121.00071,1,2648179,2651503,+,3324
330,BUMA.1121.00056,1,1250641,1253944,-,3303
330,BUMA.1121.00065,1,2775782,2779127,+,3345
330,BUMA.1121.00058,1,1806010,1809319,-,3309
330,BUMA.1121.00007,1,1341131,1344440,-,3309
330,BUMA.1121.00067,1,1699703,1703012,-,3309
330,BUMA.1121.00090,1,793783,797180,+,3397
330,BUMA.1121.00051,1,2685841,2689279,+,3438
330,BUMA.1121.00020,1,2916829,2920154,+,3325
330,BUMA.1121.00103,1,1690559,1693866,-,3307
330,BUMA.1121.00048,1,1636683,1640008,+,3325
330,BUMA.1121.00047,1,232803,236106,-,3303
330,BUMA.1121.00042,1,2292012,2295355,+,3343
330,BUMA.1121.00055,1,2396572,2399936,+,3364
330,BUMA.1121.00031,1,47125,50495,+,3370
330,BUMA.1121.00040,1,2861963,2865288,+,3325
330,BUMA.1121.00044,1,2117470,2120795,+,3325
330,BUMA.1121.00088,1,3630636,3633959,+,3323
330,BUMA.1121.00069,1,2628710,2632068,+,3358
330,BUMA.1121.00064,1,2725744,2729276,+,3532
330,BUMA.1121.00105,1,2480465,2483774,-,3309
330,BUMA.1121.00015,1,1199498,1202814,-,3316
330,BUMA.1121.00059,1,1948322,1951628,+,3306
330,BUMA.1121.00026,1,2522110,2525426,-,3316
330,BUMA.1121.00022,1,3269054,3272379,+,3325
330,BUMA.1121.00052,1,2663378,2666712,+,3334
330,BUMA.1121.00101,1,3727345,3730646,-,3301
330,BUMA.1121.00001,1,1366865,1370156,-,3291
330,BUMA.1121.00038,1,1844138,1847463,+,3325
330,BUMA.1121.00068,1,1490094,1493409,+,3315
330,BUMA.1121.00099,1,3693722,3697035,-,3313
330,BUMA.1121.00091,1,1797735,1801037,-,3302
330,BUMA.1121.00098,1,1380875,1384206,+,3331
330,BUMA.1121.00013,1,2943420,2946754,+,3334
330,BUMA.1121.00049,1,3112043,3115352,-,3309
330,BUMA.1121.00072,1,2631148,2634502,+,3354
330,BUMA.1121.00076,1,2597914,2601222,-,3308
330,BUMA.1121.00083,1,2960852,2964162,-,3310
330,BUMA.1121.00078,1,3288901,3292213,-,3312
330,BUMA.1121.00095,1,2996535,2999856,-,3321
330,BUMA.1121.00077,1,1379141,1382514,+,3373
330,BUMA.1121.00063,1,2656178,2659504,+,3326
330,BUMA.1121.00061,1,2659271,2662624,+,3353
330,BUMA.1121.00050,1,2851690,2855006,-,3316
330,BUMA.1121.00081,1,1844222,1847547,+,3325
330,BUMA.1121.00074,1,1145182,1148491,-,3309
330,BUMA.1121.00062,1,1842669,1845978,-,3309
330,BUMA.1121.00060,1,3586586,3589893,-,3307
330,BUMA.1121.00070,1,2630379,2633731,+,3352
330,BUMA.1121.00075,1,2211213,2214542,+,3329
330,BUMA.1121.00041,1,4004402,4007852,+,3450
330,BUMA.1121.00073,1,2657464,2660816,+,3352
330,BUMA.1121.00017,1,2786965,2790290,+,3325
330,BUMA.1121.00066,1,2632963,2636290,+,3327
330,BUMA.1121.00107,1,2659483,2662883,+,3400
330,BUMA.1121.00085,1,2260324,2263658,+,3334
330,BUMA.1121.00030,1,2787035,2790360,+,3325
330,BUMA.1121.00112,1,120105,123412,-,3307
330,BUMA.1121.00002,1,2410988,2414298,-,3310
330,BUMA.1121.00082,1,2815150,2818509,+,3359
330,BUMA.1121.00014,1,4200506,4203815,-,3309
330,BUMA.1121.00011,1,2943343,2946653,-,3310
330,BUMA.1121.00019,1,2816892,2820217,+,3325
330,BUMA.1121.00057,1,3830448,3833798,+,3350
330,BUMA.1121.00018,1,3309879,3313429,+,3550
330,BUMA.1121.00039,1,2855642,2859111,+,3469
330,BUMA.1121.00016,1,830888,834194,+,3306
330,BUMA.1121.00004,1,2851850,2855175,+,3325
330,BUMA.1121.00005,1,1422991,1426388,+,3397
330,BUMA.1121.00100,1,2652783,2656098,-,3315
330,BUMA.1121.00006,1,1844149,1847474,+,3325
329,BUMA.1121.00027,1,843847,859568,+,15721
329,BUMA.1121.00025,1,4099802,4115590,-,15788
329,BUMA.1121.00021,1,3300977,3316682,+,15705
329,BUMA.1121.00023,1,1019878,1035584,+,15706
329,BUMA.1121.00024,1,2834867,2850607,+,15740
329,BUMA.1121.00033,1,889911,905614,+,15703
329,BUMA.1121.00034,1,2873630,2889370,+,15740
329,BUMA.1121.00036,1,1260681,1276430,-,15749
329,BUMA.1121.00032,1,903275,919015,+,15740
329,BUMA.1121.00009,1,2863160,2878929,-,15769
329,BUMA.1121.00008,1,2847882,2863621,+,15739
329,BUMA.1121.00003,1,1191618,1207384,+,15766
329,BUMA.1121.00109,1,3195656,3211407,-,15751
329,BUMA.1121.00053,1,2462000,2477712,+,15712
329,BUMA.1121.00110,1,2104038,2119825,-,15787
329,BUMA.1121.00104,1,2531861,2547620,-,15759
329,BUMA.1121.00086,1,1522560,1538300,+,15740
329,BUMA.1121.00092,1,1062771,1078497,-,15726
329,BUMA.1121.00096,1,560881,576625,-,15744
329,BUMA.1121.00054,1,2299026,2314791,-,15765
329,BUMA.1121.00097,1,1211828,1227623,-,15795
329,BUMA.1121.00093,1,3547648,3563373,+,15725
329,BUMA.1121.00106,1,2443839,2459571,+,15732
329,BUMA.1121.00010,1,2387398,2403138,-,15740
329,BUMA.1121.00035,1,3853826,3869554,+,15728
329,BUMA.1121.00108,1,3741367,3757079,+,15712
329,BUMA.1121.00028,1,2836190,2851930,+,15740
329,BUMA.1121.00094,1,2685874,2701595,+,15721
329,BUMA.1121.00102,1,2574830,2590674,-,15844
329,BUMA.1121.00111,1,2871612,2887316,+,15704
329,BUMA.1121.00089,1,2656901,2672622,+,15721
329,BUMA.1121.00084,1,3069376,3085097,+,15721
329,BUMA.1121.00029,1,2254508,2270262,-,15754
329,BUMA.1121.00012,1,1433714,1449419,+,15705
329,BUMA.1121.00087,1,1778569,1794318,-,15749
329,BUMA.1121.00043,1,2773932,2789643,+,15711
329,BUMA.1121.00046,1,3390443,3406182,+,15739
329,BUMA.1121.00037,1,1303891,1319596,+,15705
329,BUMA.1121.00080,1,2701933,2717648,+,15715
329,BUMA.1121.00079,1,2736377,2752091,+,15714
329,BUMA.1121.00045,1,1344633,1360385,-,15752
329,BUMA.1121.00071,1,2632448,2648177,+,15729
329,BUMA.1121.00056,1,1254006,1269703,-,15697
329,BUMA.1121.00065,1,2760040,2775780,+,15740
329,BUMA.1121.00058,1,1809327,1825073,-,15746
329,BUMA.1121.00007,1,1344451,1360182,-,15731
329,BUMA.1121.00067,1,1703110,1718859,-,15749
329,BUMA.1121.00090,1,778076,793781,+,15705
329,BUMA.1121.00051,1,2670125,2685839,+,15714
329,BUMA.1121.00020,1,2901087,2916827,+,15740
329,BUMA.1121.00103,1,1693867,1709638,-,15771
329,BUMA.1121.00048,1,1620926,1636681,+,15755
329,BUMA.1121.00047,1,236186,251961,-,15775
329,BUMA.1121.00042,1,2276264,2292010,+,15746
329,BUMA.1121.00055,1,2380828,2396570,+,15742
329,BUMA.1121.00031,1,31419,47123,+,15704
329,BUMA.1121.00040,1,2846221,2861961,+,15740
329,BUMA.1121.00044,1,2101728,2117468,+,15740
329,BUMA.1121.00088,1,3614927,3630634,+,15707
329,BUMA.1121.00069,1,2612999,2628708,+,15709
329,BUMA.1121.00064,1,2710027,2725742,+,15715
329,BUMA.1121.00105,1,2483794,2499520,-,15726
329,BUMA.1121.00015,1,1202815,1218564,-,15749
329,BUMA.1121.00059,1,1932594,1948320,+,15726
329,BUMA.1121.00026,1,2525427,2541192,-,15765
329,BUMA.1121.00022,1,3253312,3269052,+,15740
329,BUMA.1121.00052,1,2647621,2663376,+,15755
329,BUMA.1121.00101,1,3730647,3746404,-,15757
329,BUMA.1121.00001,1,1371476,1387239,-,15763
329,BUMA.1121.00038,1,1828381,1844136,+,15755
329,BUMA.1121.00068,1,1474359,1490092,+,15733
329,BUMA.1121.00099,1,3697036,3712790,-,15754
329,BUMA.1121.00091,1,1801038,1816770,-,15732
329,BUMA.1121.00098,1,1365124,1380873,+,15749
329,BUMA.1121.00013,1,2927663,2943418,+,15755
329,BUMA.1121.00049,1,3115378,3131081,-,15703
329,BUMA.1121.00072,1,2615463,2631146,+,15683
329,BUMA.1121.00076,1,2601233,2616988,-,15755
329,BUMA.1121.00083,1,2964200,2979935,-,15735
329,BUMA.1121.00078,1,3292214,3307920,-,15706
329,BUMA.1121.00095,1,2999972,3015745,-,15773
329,BUMA.1121.00077,1,1363409,1379139,+,15730
329,BUMA.1121.00063,1,2640457,2656176,+,15719
329,BUMA.1121.00061,1,2643552,2659269,+,15717
329,BUMA.1121.00050,1,2855007,2870746,-,15739
329,BUMA.1121.00081,1,1828465,1844220,+,15755
329,BUMA.1121.00074,1,1148589,1164375,-,15786
329,BUMA.1121.00062,1,1845998,1861689,-,15691
329,BUMA.1121.00060,1,3589894,3605646,-,15752
329,BUMA.1121.00070,1,2614660,2630377,+,15717
329,BUMA.1121.00075,1,2195485,2211211,+,15726
329,BUMA.1121.00041,1,3988709,4004400,+,15691
329,BUMA.1121.00073,1,2641745,2657462,+,15717
329,BUMA.1121.00017,1,2771223,2786963,+,15740
329,BUMA.1121.00066,1,2617238,2632961,+,15723
329,BUMA.1121.00107,1,2643796,2659481,+,15685
329,BUMA.1121.00085,1,2244567,2260322,+,15755
329,BUMA.1121.00030,1,2771294,2787033,+,15739
329,BUMA.1121.00112,1,123413,139148,-,15735
329,BUMA.1121.00002,1,2414299,2430039,-,15740
329,BUMA.1121.00082,1,2799425,2815148,+,15723
329,BUMA.1121.00014,1,4203913,4219664,-,15751
329,BUMA.1121.00011,1,2946654,2962426,-,15772
329,BUMA.1121.00019,1,2801150,2816890,+,15740
329,BUMA.1121.00057,1,3814723,3830446,+,15723
329,BUMA.1121.00018,1,3294180,3309877,+,15697
329,BUMA.1121.00039,1,2839942,2855640,+,15698
329,BUMA.1121.00016,1,815182,830886,+,15704
329,BUMA.1121.00004,1,2836109,2851848,+,15739
329,BUMA.1121.00005,1,1407320,1422989,+,15669
329,BUMA.1121.00100,1,2656196,2672010,-,15814
329,BUMA.1121.00006,1,1828392,1844147,+,15755
328,BUMA.1121.00027,1,833668,838578,+,4910
328,BUMA.1121.00025,1,4162280,4167197,-,4917
328,BUMA.1121.00021,1,3290799,3295716,+,4917
328,BUMA.1121.00023,1,1009700,1014617,+,4917
328,BUMA.1121.00024,1,2823096,2828007,+,4911
328,BUMA.1121.00033,1,879734,884651,+,4917
328,BUMA.1121.00034,1,2861859,2866770,+,4911
328,BUMA.1121.00036,1,1283290,1288202,-,4912
328,BUMA.1121.00032,1,891504,896415,+,4911
328,BUMA.1121.00009,1,2884192,2889109,-,4917
328,BUMA.1121.00008,1,2836111,2841022,+,4911
328,BUMA.1121.00003,1,1181439,1186356,+,4917
328,BUMA.1121.00109,1,3216646,3221563,-,4917
328,BUMA.1121.00053,1,2451822,2456733,+,4911
328,BUMA.1121.00110,1,2125087,2130004,-,4917
328,BUMA.1121.00104,1,2552883,2557747,-,4864
328,BUMA.1121.00086,1,1510789,1515700,+,4911
328,BUMA.1121.00092,1,1083760,1088677,-,4917
328,BUMA.1121.00096,1,581887,586804,-,4917
328,BUMA.1121.00054,1,2323228,2328140,-,4912
328,BUMA.1121.00097,1,1232886,1237809,-,4923
328,BUMA.1121.00093,1,3537469,3542386,+,4917
328,BUMA.1121.00106,1,2433659,2438576,+,4917
328,BUMA.1121.00010,1,2409997,2414909,-,4912
328,BUMA.1121.00035,1,3843648,3848565,+,4917
328,BUMA.1121.00108,1,3731189,3736106,+,4917
328,BUMA.1121.00028,1,2824419,2829330,+,4911
328,BUMA.1121.00094,1,2675695,2680613,+,4918
328,BUMA.1121.00102,1,2595943,2600855,-,4912
328,BUMA.1121.00111,1,2861434,2866351,+,4917
328,BUMA.1121.00089,1,2646723,2651640,+,4917
328,BUMA.1121.00084,1,3059186,3064115,+,4929
328,BUMA.1121.00029,1,2275524,2280441,-,4917
328,BUMA.1121.00012,1,1423536,1428453,+,4917
328,BUMA.1121.00087,1,1801178,1806090,-,4912
328,BUMA.1121.00043,1,2763754,2768671,+,4917
328,BUMA.1121.00046,1,3378672,3383583,+,4911
328,BUMA.1121.00037,1,1293713,1298630,+,4917
328,BUMA.1121.00080,1,2691755,2696672,+,4917
328,BUMA.1121.00079,1,2726199,2731116,+,4917
328,BUMA.1121.00045,1,1365647,1370564,-,4917
328,BUMA.1121.00071,1,2622268,2627185,+,4917
328,BUMA.1121.00056,1,1274965,1279882,-,4917
328,BUMA.1121.00065,1,2749861,2754778,+,4917
328,BUMA.1121.00058,1,1830312,1835229,-,4917
328,BUMA.1121.00007,1,1365445,1370362,-,4917
328,BUMA.1121.00067,1,1724128,1729040,-,4912
328,BUMA.1121.00090,1,767898,772815,+,4917
328,BUMA.1121.00051,1,2659948,2664865,+,4917
328,BUMA.1121.00020,1,2889316,2894227,+,4911
328,BUMA.1121.00103,1,1714901,1719818,-,4917
328,BUMA.1121.00048,1,1607577,1612488,+,4911
328,BUMA.1121.00047,1,257223,262140,-,4917
328,BUMA.1121.00042,1,2262924,2267835,+,4911
328,BUMA.1121.00055,1,2370649,2375566,+,4917
328,BUMA.1121.00031,1,21241,26158,+,4917
328,BUMA.1121.00040,1,2834450,2839361,+,4911
328,BUMA.1121.00044,1,2089957,2094868,+,4911
328,BUMA.1121.00088,1,3604736,3609665,+,4929
328,BUMA.1121.00069,1,2602819,2607730,+,4911
328,BUMA.1121.00064,1,2699848,2704765,+,4917
328,BUMA.1121.00105,1,2504782,2509699,-,4917
328,BUMA.1121.00015,1,1225424,1230336,-,4912
328,BUMA.1121.00059,1,1922415,1927332,+,4917
328,BUMA.1121.00026,1,2549631,2554543,-,4912
328,BUMA.1121.00022,1,3241542,3246453,+,4911
328,BUMA.1121.00052,1,2634273,2639184,+,4911
328,BUMA.1121.00101,1,3751667,3756584,-,4917
328,BUMA.1121.00001,1,1392501,1397418,-,4917
328,BUMA.1121.00038,1,1815032,1819943,+,4911
328,BUMA.1121.00068,1,1464181,1469098,+,4917
328,BUMA.1121.00099,1,3718053,3722970,-,4917
328,BUMA.1121.00091,1,1822032,1826949,-,4917
328,BUMA.1121.00098,1,1354945,1359862,+,4917
328,BUMA.1121.00013,1,2914315,2919226,+,4911
328,BUMA.1121.00049,1,3136345,3141262,-,4917
328,BUMA.1121.00072,1,2605283,2610200,+,4917
328,BUMA.1121.00076,1,2623829,2628746,-,4917
328,BUMA.1121.00083,1,2985204,2990116,-,4912
328,BUMA.1121.00078,1,3313183,3318100,-,4917
328,BUMA.1121.00095,1,3021014,3025926,-,4912
328,BUMA.1121.00077,1,1353231,1358148,+,4917
328,BUMA.1121.00063,1,2630278,2635195,+,4917
328,BUMA.1121.00061,1,2633373,2638290,+,4917
328,BUMA.1121.00050,1,2877606,2882518,-,4912
328,BUMA.1121.00081,1,1815116,1820027,+,4911
328,BUMA.1121.00074,1,1169638,1174555,-,4917
328,BUMA.1121.00062,1,1866951,1871868,-,4917
328,BUMA.1121.00060,1,3610908,3615825,-,4917
328,BUMA.1121.00070,1,2604481,2609398,+,4917
328,BUMA.1121.00075,1,2185310,2190225,+,4915
328,BUMA.1121.00041,1,3978530,3983441,+,4911
328,BUMA.1121.00073,1,2631566,2636483,+,4917
328,BUMA.1121.00017,1,2759452,2764363,+,4911
328,BUMA.1121.00066,1,2607059,2611976,+,4917
328,BUMA.1121.00107,1,2617210,2622127,+,4917
328,BUMA.1121.00085,1,2231219,2236130,+,4911
328,BUMA.1121.00030,1,2759523,2764434,+,4911
328,BUMA.1121.00112,1,144405,149322,-,4917
328,BUMA.1121.00002,1,2436899,2441811,-,4912
328,BUMA.1121.00082,1,2789245,2794156,+,4911
328,BUMA.1121.00014,1,38,4955,-,4917
328,BUMA.1121.00011,1,2967688,2972605,-,4917
328,BUMA.1121.00019,1,2789379,2794290,+,4911
328,BUMA.1121.00057,1,3804543,3809454,+,4911
328,BUMA.1121.00018,1,3284002,3288919,+,4917
328,BUMA.1121.00039,1,2829764,2834681,+,4917
328,BUMA.1121.00016,1,805005,809922,+,4917
328,BUMA.1121.00004,1,2824338,2829249,+,4911
328,BUMA.1121.00005,1,1397147,1402059,+,4912
328,BUMA.1121.00100,1,2677273,2682190,-,4917
328,BUMA.1121.00006,1,1815043,1819954,+,4911
327,BUMA.1121.00027,1,827102,830461,+,3359
327,BUMA.1121.00025,1,4170403,4173763,-,3360
327,BUMA.1121.00021,1,3284233,3287592,+,3359
327,BUMA.1121.00023,1,1003134,1006493,+,3359
327,BUMA.1121.00024,1,2816530,2819889,+,3359
327,BUMA.1121.00033,1,873168,876527,+,3359
327,BUMA.1121.00034,1,2855293,2858652,+,3359
327,BUMA.1121.00036,1,1291408,1294768,-,3360
327,BUMA.1121.00032,1,884938,888297,+,3359
327,BUMA.1121.00009,1,2892315,2895675,-,3360
327,BUMA.1121.00008,1,2829545,2832904,+,3359
327,BUMA.1121.00003,1,1174873,1178232,+,3359
327,BUMA.1121.00109,1,3224769,3228133,-,3364
327,BUMA.1121.00053,1,2445256,2448615,+,3359
327,BUMA.1121.00110,1,2133210,2136574,-,3364
327,BUMA.1121.00104,1,2559218,2562578,-,3360
327,BUMA.1121.00086,1,1504223,1507582,+,3359
327,BUMA.1121.00092,1,1091883,1095242,-,3359
327,BUMA.1121.00096,1,590010,593370,-,3360
327,BUMA.1121.00054,1,2331346,2334706,-,3360
327,BUMA.1121.00097,1,1241015,1244375,-,3360
327,BUMA.1121.00093,1,3530904,3534262,+,3358
327,BUMA.1121.00106,1,2427093,2430452,+,3359
327,BUMA.1121.00010,1,2418115,2421475,-,3360
327,BUMA.1121.00035,1,3837082,3840441,+,3359
327,BUMA.1121.00108,1,3724623,3727982,+,3359
327,BUMA.1121.00028,1,2817853,2821212,+,3359
327,BUMA.1121.00094,1,2669129,2672488,+,3359
327,BUMA.1121.00102,1,2604061,2607421,-,3360
327,BUMA.1121.00111,1,2854869,2858228,+,3359
327,BUMA.1121.00089,1,2640157,2643516,+,3359
327,BUMA.1121.00084,1,3052620,3055979,+,3359
327,BUMA.1121.00029,1,2283647,2287007,-,3360
327,BUMA.1121.00012,1,1416970,1420329,+,3359
327,BUMA.1121.00087,1,1809296,1812656,-,3360
327,BUMA.1121.00043,1,2757188,2760547,+,3359
327,BUMA.1121.00046,1,3372106,3375465,+,3359
327,BUMA.1121.00037,1,1287147,1290506,+,3359
327,BUMA.1121.00080,1,2685189,2688548,+,3359
327,BUMA.1121.00079,1,2719633,2722992,+,3359
327,BUMA.1121.00045,1,1373770,1377130,-,3360
327,BUMA.1121.00071,1,2615702,2619061,+,3359
327,BUMA.1121.00056,1,1283088,1286448,-,3360
327,BUMA.1121.00065,1,2743295,2746654,+,3359
327,BUMA.1121.00058,1,1838435,1841795,-,3360
327,BUMA.1121.00007,1,1373568,1376932,-,3364
327,BUMA.1121.00067,1,1732246,1735606,-,3360
327,BUMA.1121.00090,1,761332,764691,+,3359
327,BUMA.1121.00051,1,2653382,2656741,+,3359
327,BUMA.1121.00020,1,2882750,2886109,+,3359
327,BUMA.1121.00103,1,1723024,1726383,-,3359
327,BUMA.1121.00048,1,1601011,1604370,+,3359
327,BUMA.1121.00047,1,265346,268706,-,3360
327,BUMA.1121.00042,1,2256358,2259717,+,3359
327,BUMA.1121.00055,1,2364083,2367442,+,3359
327,BUMA.1121.00031,1,14675,18034,+,3359
327,BUMA.1121.00040,1,2827884,2831243,+,3359
327,BUMA.1121.00044,1,2083391,2086750,+,3359
327,BUMA.1121.00088,1,3598170,3601529,+,3359
327,BUMA.1121.00069,1,2596253,2599612,+,3359
327,BUMA.1121.00064,1,2693282,2696641,+,3359
327,BUMA.1121.00105,1,2512905,2516265,-,3360
327,BUMA.1121.00015,1,1233542,1236902,-,3360
327,BUMA.1121.00059,1,1915849,1919208,+,3359
327,BUMA.1121.00026,1,2557749,2561109,-,3360
327,BUMA.1121.00022,1,3234976,3238335,+,3359
327,BUMA.1121.00052,1,2627707,2631066,+,3359
327,BUMA.1121.00101,1,3759790,3763150,-,3360
327,BUMA.1121.00001,1,1400624,1403984,-,3360
327,BUMA.1121.00038,1,1808466,1811825,+,3359
327,BUMA.1121.00068,1,1457616,1460974,+,3358
327,BUMA.1121.00099,1,3726176,3729536,-,3360
327,BUMA.1121.00091,1,1830155,1833515,-,3360
327,BUMA.1121.00098,1,1348379,1351738,+,3359
327,BUMA.1121.00013,1,2907749,2911108,+,3359
327,BUMA.1121.00049,1,3144468,3147827,-,3359
327,BUMA.1121.00072,1,2598717,2602076,+,3359
327,BUMA.1121.00076,1,2631952,2635312,-,3360
327,BUMA.1121.00083,1,2993322,2996682,-,3360
327,BUMA.1121.00078,1,3321306,3324666,-,3360
327,BUMA.1121.00095,1,3029132,3032492,-,3360
327,BUMA.1121.00077,1,1346661,1350024,+,3363
327,BUMA.1121.00063,1,2623712,2627071,+,3359
327,BUMA.1121.00061,1,2626807,2630166,+,3359
327,BUMA.1121.00050,1,2885724,2889084,-,3360
327,BUMA.1121.00081,1,1808550,1811909,+,3359
327,BUMA.1121.00074,1,1177761,1181121,-,3360
327,BUMA.1121.00062,1,1875074,1878433,-,3359
327,BUMA.1121.00060,1,3619031,3622391,-,3360
327,BUMA.1121.00070,1,2597915,2601274,+,3359
327,BUMA.1121.00075,1,2178744,2182103,+,3359
327,BUMA.1121.00041,1,3971964,3975323,+,3359
327,BUMA.1121.00073,1,2625000,2628359,+,3359
327,BUMA.1121.00017,1,2752886,2756245,+,3359
327,BUMA.1121.00066,1,2600493,2603852,+,3359
327,BUMA.1121.00107,1,2610644,2614003,+,3359
327,BUMA.1121.00085,1,2224653,2228012,+,3359
327,BUMA.1121.00030,1,2752957,2756316,+,3359
327,BUMA.1121.00112,1,152528,155888,-,3360
327,BUMA.1121.00002,1,2445017,2448377,-,3360
327,BUMA.1121.00082,1,2782679,2786038,+,3359
327,BUMA.1121.00014,1,8161,11521,-,3360
327,BUMA.1121.00011,1,2975811,2979171,-,3360
327,BUMA.1121.00019,1,2782813,2786172,+,3359
327,BUMA.1121.00057,1,3797977,3801336,+,3359
327,BUMA.1121.00018,1,3277436,3280795,+,3359
327,BUMA.1121.00039,1,2823198,2826557,+,3359
327,BUMA.1121.00016,1,798439,801798,+,3359
327,BUMA.1121.00004,1,2817772,2821131,+,3359
327,BUMA.1121.00005,1,1390581,1393940,+,3359
327,BUMA.1121.00100,1,2685396,2688756,-,3360
327,BUMA.1121.00006,1,1808477,1811836,+,3359
326,BUMA.1121.00027,1,812428,826939,+,14511
326,BUMA.1121.00025,1,4173898,4188481,-,14583
326,BUMA.1121.00021,1,3269449,3284050,+,14601
326,BUMA.1121.00023,1,988461,1003013,+,14552
326,BUMA.1121.00024,1,2802042,2816455,+,14413
326,BUMA.1121.00033,1,858544,873082,+,14538
326,BUMA.1121.00034,1,2840805,2855218,+,14413
326,BUMA.1121.00036,1,1294843,1309247,-,14404
326,BUMA.1121.00032,1,870450,884863,+,14413
326,BUMA.1121.00009,1,2895803,2910385,-,14582
326,BUMA.1121.00008,1,2815057,2829470,+,14413
326,BUMA.1121.00003,1,1160243,1174717,+,14474
326,BUMA.1121.00109,1,3228296,3242796,-,14500
326,BUMA.1121.00053,1,2430537,2445128,+,14591
326,BUMA.1121.00110,1,2136723,2151085,-,14362
326,BUMA.1121.00104,1,2562734,2577277,-,14543
326,BUMA.1121.00086,1,1489743,1504148,+,14405
326,BUMA.1121.00092,1,1095370,1109905,-,14535
326,BUMA.1121.00096,1,593445,607990,-,14545
326,BUMA.1121.00054,1,2334781,2349185,-,14404
326,BUMA.1121.00097,1,1244480,1259088,-,14608
326,BUMA.1121.00093,1,3516247,3530783,+,14536
326,BUMA.1121.00106,1,2412415,2426993,+,14578
326,BUMA.1121.00010,1,2421550,2435954,-,14404
326,BUMA.1121.00035,1,3822450,3836968,+,14518
326,BUMA.1121.00108,1,3710046,3724495,+,14449
326,BUMA.1121.00028,1,2803365,2817778,+,14413
326,BUMA.1121.00094,1,2654489,2669015,+,14526
326,BUMA.1121.00102,1,2607549,2622221,-,14672
326,BUMA.1121.00111,1,2840201,2854748,+,14547
326,BUMA.1121.00089,1,2625517,2640043,+,14526
326,BUMA.1121.00084,1,3038005,3052513,+,14508
326,BUMA.1121.00029,1,2287156,2301713,-,14557
326,BUMA.1121.00012,1,1402310,1416870,+,14560
326,BUMA.1121.00087,1,1812731,1827135,-,14404
326,BUMA.1121.00043,1,2742452,2757018,+,14566
326,BUMA.1121.00046,1,3357634,3372031,+,14397
326,BUMA.1121.00037,1,1272396,1286984,+,14588
326,BUMA.1121.00080,1,2670513,2685054,+,14541
326,BUMA.1121.00079,1,2704927,2719449,+,14522
326,BUMA.1121.00045,1,1377251,1391674,-,14423
326,BUMA.1121.00071,1,2600994,2615525,+,14531
326,BUMA.1121.00056,1,1286562,1301082,-,14520
326,BUMA.1121.00065,1,2728669,2743174,+,14505
326,BUMA.1121.00058,1,1841875,1856375,-,14500
326,BUMA.1121.00007,1,1377067,1391579,-,14512
326,BUMA.1121.00067,1,1735741,1750219,-,14478
326,BUMA.1121.00090,1,746570,761169,+,14599
326,BUMA.1121.00051,1,2638648,2653212,+,14564
326,BUMA.1121.00020,1,2868270,2882675,+,14405
326,BUMA.1121.00103,1,1726458,1740939,-,14481
326,BUMA.1121.00048,1,1586531,1600936,+,14405
326,BUMA.1121.00047,1,268834,283391,-,14557
326,BUMA.1121.00042,1,2241886,2256283,+,14397
326,BUMA.1121.00055,1,2349184,2363941,+,14757
326,BUMA.1121.00031,1,31,14589,+,14558
326,BUMA.1121.00040,1,2813372,2827809,+,14437
326,BUMA.1121.00044,1,2068903,2083316,+,14413
326,BUMA.1121.00088,1,3583541,3598063,+,14522
326,BUMA.1121.00069,1,2581545,2596076,+,14531
326,BUMA.1121.00064,1,2678560,2693154,+,14594
326,BUMA.1121.00105,1,2516386,2530924,-,14538
326,BUMA.1121.00015,1,1236977,1251381,-,14404
326,BUMA.1121.00059,1,1901181,1915735,+,14554
326,BUMA.1121.00026,1,2561184,2575580,-,14396
326,BUMA.1121.00022,1,3220488,3234901,+,14413
326,BUMA.1121.00052,1,2613204,2627628,+,14424
326,BUMA.1121.00101,1,3763271,3777854,-,14583
326,BUMA.1121.00001,1,1404119,1418646,-,14527
326,BUMA.1121.00038,1,1793986,1808391,+,14405
326,BUMA.1121.00068,1,1442981,1457467,+,14486
326,BUMA.1121.00099,1,3729657,3744155,-,14498
326,BUMA.1121.00091,1,1833622,1848183,-,14561
326,BUMA.1121.00098,1,1333713,1348230,+,14517
326,BUMA.1121.00013,1,2893577,2907670,+,14093
326,BUMA.1121.00049,1,3147913,3162431,-,14518
326,BUMA.1121.00072,1,2584009,2598547,+,14538
326,BUMA.1121.00076,1,2635447,2650113,-,14666
326,BUMA.1121.00083,1,2996859,3011389,-,14530
326,BUMA.1121.00078,1,3324788,3339270,-,14482
326,BUMA.1121.00095,1,3032567,3046950,-,14383
326,BUMA.1121.00077,1,1332148,1346512,+,14364
326,BUMA.1121.00063,1,2609020,2623535,+,14515
326,BUMA.1121.00061,1,2612124,2626630,+,14506
326,BUMA.1121.00050,1,2889159,2903555,-,14396
326,BUMA.1121.00081,1,1794070,1808475,+,14405
326,BUMA.1121.00074,1,1181221,1195831,-,14610
326,BUMA.1121.00062,1,1878547,1893062,-,14515
326,BUMA.1121.00060,1,3622505,3636928,-,14423
326,BUMA.1121.00070,1,2583232,2597738,+,14506
326,BUMA.1121.00075,1,2163927,2178602,+,14675
326,BUMA.1121.00041,1,3955805,3970283,+,14478
326,BUMA.1121.00073,1,2610311,2624823,+,14512
326,BUMA.1121.00017,1,2738398,2752811,+,14413
326,BUMA.1121.00066,1,2585785,2600323,+,14538
326,BUMA.1121.00107,1,2595933,2610481,+,14548
326,BUMA.1121.00085,1,2210150,2224574,+,14424
326,BUMA.1121.00030,1,2738469,2752882,+,14413
326,BUMA.1121.00112,1,155995,170500,-,14505
326,BUMA.1121.00002,1,2448452,2462856,-,14404
326,BUMA.1121.00082,1,2767971,2782502,+,14531
326,BUMA.1121.00014,1,11684,26247,-,14563
326,BUMA.1121.00011,1,2979362,2993840,-,14478
326,BUMA.1121.00019,1,2768333,2782738,+,14405
326,BUMA.1121.00057,1,3783273,3797786,+,14513
326,BUMA.1121.00018,1,3262710,3277294,+,14584
326,BUMA.1121.00039,1,2808450,2823098,+,14648
326,BUMA.1121.00016,1,783785,798332,+,14547
326,BUMA.1121.00004,1,2803284,2817697,+,14413
326,BUMA.1121.00005,1,1375916,1390481,+,14565
326,BUMA.1121.00100,1,2688891,2703438,-,14547
326,BUMA.1121.00006,1,1793997,1808402,+,14405
325,BUMA.1121.00027,1,759694,806876,+,47182
325,BUMA.1121.00025,1,4076,51254,-,47178
325,BUMA.1121.00021,1,3216736,3263930,+,47194
325,BUMA.1121.00023,1,937352,984515,+,47163
325,BUMA.1121.00024,1,2747732,2794944,+,47212
325,BUMA.1121.00033,1,805826,853018,+,47192
325,BUMA.1121.00034,1,2786495,2833707,+,47212
325,BUMA.1121.00036,1,1316347,1363564,-,47217
325,BUMA.1121.00032,1,816140,863352,+,47212
325,BUMA.1121.00009,1,2914303,2961473,-,47170
325,BUMA.1121.00008,1,2760747,2807959,+,47212
325,BUMA.1121.00003,1,1107555,1154733,+,47178
325,BUMA.1121.00109,1,3248306,3295580,-,47274
325,BUMA.1121.00053,1,2377820,2425028,+,47208
325,BUMA.1121.00110,1,2155002,2202185,-,47183
325,BUMA.1121.00104,1,2581195,2628373,-,47178
325,BUMA.1121.00086,1,1435426,1482644,+,47218
325,BUMA.1121.00092,1,1115423,1162580,-,47157
325,BUMA.1121.00096,1,611908,659107,-,47199
325,BUMA.1121.00054,1,2356285,2403487,-,47202
325,BUMA.1121.00097,1,1264669,1311955,-,47286
325,BUMA.1121.00093,1,3463573,3510730,+,47157
325,BUMA.1121.00106,1,2361351,2408490,+,47139
325,BUMA.1121.00010,1,322296,369505,+,47209
325,BUMA.1121.00035,1,3768164,3815345,+,47181
325,BUMA.1121.00108,1,3658984,3706073,+,47089
325,BUMA.1121.00028,1,2749055,2796267,+,47212
325,BUMA.1121.00094,1,2601699,2648966,+,47267
325,BUMA.1121.00102,1,2627732,2674919,-,47187
325,BUMA.1121.00111,1,2787513,2834690,+,47177
325,BUMA.1121.00089,1,2572745,2619993,+,47248
325,BUMA.1121.00084,1,2985273,3032488,+,47215
325,BUMA.1121.00029,1,2308819,2356005,-,47186
325,BUMA.1121.00012,1,1349936,1398357,+,48421
325,BUMA.1121.00087,1,1834235,1881452,-,47217
325,BUMA.1121.00043,1,2691350,2738528,+,47178
325,BUMA.1121.00046,1,3303333,3350536,+,47203
325,BUMA.1121.00037,1,1219702,1266885,+,47183
325,BUMA.1121.00080,1,2616178,2663380,+,47202
325,BUMA.1121.00079,1,2652222,2699417,+,47195
325,BUMA.1121.00045,1,1395654,1442856,-,47202
325,BUMA.1121.00071,1,2548427,2595553,+,47126
325,BUMA.1121.00056,1,1306607,1353854,-,47247
325,BUMA.1121.00065,1,2677547,2724724,+,47177
325,BUMA.1121.00058,1,1860300,1907468,-,47168
325,BUMA.1121.00007,1,1397103,1444262,-,47159
325,BUMA.1121.00067,1,1754137,1801327,-,47190
325,BUMA.1121.00090,1,693868,741058,+,47190
325,BUMA.1121.00051,1,2585913,2633117,+,47204
325,BUMA.1121.00020,1,2813960,2861172,+,47212
325,BUMA.1121.00103,1,1744856,1792080,-,47224
325,BUMA.1121.00048,1,1532231,1579434,+,47203
325,BUMA.1121.00047,1,288923,336153,-,47230
325,BUMA.1121.00042,1,2187600,2234785,+,47185
325,BUMA.1121.00055,1,2298023,2345266,+,47243
325,BUMA.1121.00031,1,4024975,4072183,+,47208
325,BUMA.1121.00040,1,2759105,2806274,+,47169
325,BUMA.1121.00044,1,2014593,2061805,+,47212
325,BUMA.1121.00088,1,3530873,3578031,+,47158
325,BUMA.1121.00069,1,2528883,2576019,+,47136
325,BUMA.1121.00064,1,2627444,2674642,+,47198
325,BUMA.1121.00105,1,2536442,2583601,-,47159
325,BUMA.1121.00015,1,1258481,1305683,-,47202
325,BUMA.1121.00059,1,1850103,1897263,+,47160
325,BUMA.1121.00026,1,2582683,2629867,-,47184
325,BUMA.1121.00022,1,3166171,3213389,+,47218
325,BUMA.1121.00052,1,2558902,2606105,+,47203
325,BUMA.1121.00101,1,3783449,3830624,-,47175
325,BUMA.1121.00001,1,1425751,1472941,-,47190
325,BUMA.1121.00038,1,1739684,1786887,+,47203
325,BUMA.1121.00068,1,1390253,1437441,+,47188
325,BUMA.1121.00099,1,3751292,3798469,-,47177
325,BUMA.1121.00091,1,1853701,1900905,-,47204
325,BUMA.1121.00098,1,1279345,1326567,+,47222
325,BUMA.1121.00013,1,2839275,2886478,+,47203
325,BUMA.1121.00049,1,3166349,3213513,-,47164
325,BUMA.1121.00072,1,2531349,2578504,+,47155
325,BUMA.1121.00076,1,2654094,2701268,-,47174
325,BUMA.1121.00083,1,3016942,3064131,-,47189
325,BUMA.1121.00078,1,3346368,3393583,-,47215
325,BUMA.1121.00095,1,3052486,3099669,-,47183
325,BUMA.1121.00077,1,1281049,1328231,+,47182
325,BUMA.1121.00063,1,2556407,2603538,+,47131
325,BUMA.1121.00061,1,2559466,2606598,+,47132
325,BUMA.1121.00050,1,2910655,2957857,-,47202
325,BUMA.1121.00081,1,1739768,1786971,+,47203
325,BUMA.1121.00074,1,1199749,1246944,-,47195
325,BUMA.1121.00062,1,1898580,1945785,-,47205
325,BUMA.1121.00060,1,3640908,3688110,-,47202
325,BUMA.1121.00070,1,2530532,2577722,+,47190
325,BUMA.1121.00075,1,2112800,2159953,+,47153
325,BUMA.1121.00041,1,3903103,3950297,+,47194
325,BUMA.1121.00073,1,2557638,2604787,+,47149
325,BUMA.1121.00017,1,2684121,2731300,+,47179
325,BUMA.1121.00066,1,2533131,2580268,+,47137
325,BUMA.1121.00107,1,2543182,2590396,+,47214
325,BUMA.1121.00085,1,2155848,2203051,+,47203
325,BUMA.1121.00030,1,2684159,2731371,+,47212
325,BUMA.1121.00112,1,176075,223302,-,47227
325,BUMA.1121.00002,1,347606,394798,+,47192
325,BUMA.1121.00082,1,2715229,2762419,+,47190
325,BUMA.1121.00014,1,31772,78979,-,47207
325,BUMA.1121.00011,1,2997750,3045068,-,47318
325,BUMA.1121.00019,1,2714023,2761235,+,47212
325,BUMA.1121.00057,1,3730534,3777721,+,47187
325,BUMA.1121.00018,1,3208427,3255606,+,47179
325,BUMA.1121.00039,1,2754183,2801348,+,47165
325,BUMA.1121.00016,1,731098,778274,+,47176
325,BUMA.1121.00004,1,2748974,2796186,+,47212
325,BUMA.1121.00005,1,1321965,1369092,+,47127
325,BUMA.1121.00100,1,2707356,2754484,-,47128
325,BUMA.1121.00006,1,1739695,1786898,+,47203
324,BUMA.1121.00027,1,744630,759693,+,15063
324,BUMA.1121.00025,1,51256,66306,-,15050
324,BUMA.1121.00021,1,3201695,3216735,+,15040
324,BUMA.1121.00023,1,922302,937351,+,15049
324,BUMA.1121.00024,1,2732677,2747731,+,15054
324,BUMA.1121.00033,1,779027,794091,+,15064
324,BUMA.1121.00034,1,2771435,2786494,+,15059
324,BUMA.1121.00036,1,1363566,1378619,-,15053
324,BUMA.1121.00032,1,801085,816139,+,15054
324,BUMA.1121.00009,1,2963878,2978923,-,15045
324,BUMA.1121.00008,1,2745692,2760746,+,15054
324,BUMA.1121.00003,1,1092512,1107554,+,15042
324,BUMA.1121.00109,1,3295582,3310626,-,15044
324,BUMA.1121.00053,1,2362773,2377819,+,15046
324,BUMA.1121.00110,1,2202187,2217229,-,15042
324,BUMA.1121.00104,1,2628375,2643454,-,15079
324,BUMA.1121.00086,1,1420371,1435425,+,15054
324,BUMA.1121.00092,1,1205958,1221020,-,15062
324,BUMA.1121.00096,1,659109,674151,-,15042
324,BUMA.1121.00054,1,2403489,2418542,-,15053
324,BUMA.1121.00097,1,1327083,1342134,-,15051
324,BUMA.1121.00093,1,3405132,3420195,+,15063
324,BUMA.1121.00106,1,2346290,2361350,+,15060
324,BUMA.1121.00010,1,307239,322295,+,15056
324,BUMA.1121.00035,1,3753111,3768163,+,15052
324,BUMA.1121.00108,1,3595931,3610986,+,15055
324,BUMA.1121.00028,1,2734000,2749054,+,15054
324,BUMA.1121.00094,1,2586639,2601698,+,15059
324,BUMA.1121.00102,1,2674921,2689976,-,15055
324,BUMA.1121.00111,1,2758710,2773771,+,15061
324,BUMA.1121.00089,1,2556343,2572744,+,16401
324,BUMA.1121.00084,1,2970198,2985272,+,15074
324,BUMA.1121.00029,1,2356007,2371058,-,15051
324,BUMA.1121.00012,1,1321121,1336193,+,15072
324,BUMA.1121.00087,1,1881454,1896507,-,15053
324,BUMA.1121.00043,1,2664583,2679632,+,15049
324,BUMA.1121.00046,1,3288278,3303332,+,15054
324,BUMA.1121.00037,1,1204627,1219701,+,15074
324,BUMA.1121.00080,1,2599776,2616177,+,16401
324,BUMA.1121.00079,1,2595471,2611836,+,16365
324,BUMA.1121.00045,1,1442858,1457905,-,15047
324,BUMA.1121.00071,1,2533378,2548426,+,15048
324,BUMA.1121.00056,1,1353856,1370256,-,16400
324,BUMA.1121.00065,1,2662461,2677546,+,15085
324,BUMA.1121.00058,1,1907470,1922514,-,15044
324,BUMA.1121.00007,1,1488929,1503992,-,15063
324,BUMA.1121.00067,1,1801329,1816379,-,15050
324,BUMA.1121.00090,1,678810,693867,+,15057
324,BUMA.1121.00051,1,2569517,2585912,+,16395
324,BUMA.1121.00020,1,2798905,2813959,+,15054
324,BUMA.1121.00103,1,1835879,1850921,-,15042
324,BUMA.1121.00048,1,1517176,1532230,+,15054
324,BUMA.1121.00047,1,336155,352555,-,16400
324,BUMA.1121.00042,1,2172536,2187599,+,15063
324,BUMA.1121.00055,1,2239084,2254131,+,15047
324,BUMA.1121.00031,1,4009911,4024974,+,15063
324,BUMA.1121.00040,1,2744050,2759104,+,15054
324,BUMA.1121.00044,1,1999533,2014592,+,15059
324,BUMA.1121.00088,1,3515794,3530872,+,15078
324,BUMA.1121.00069,1,2513833,2528882,+,15049
324,BUMA.1121.00064,1,2612376,2627443,+,15067
324,BUMA.1121.00105,1,2633784,2648830,-,15046
324,BUMA.1121.00015,1,1305685,1320738,-,15053
324,BUMA.1121.00059,1,1788665,1803722,+,15057
324,BUMA.1121.00026,1,2629869,2644931,-,15062
324,BUMA.1121.00022,1,3151116,3166170,+,15054
324,BUMA.1121.00052,1,2543847,2558901,+,15054
324,BUMA.1121.00101,1,3830626,3845699,-,15073
324,BUMA.1121.00001,1,1472943,1487993,-,15050
324,BUMA.1121.00038,1,1724629,1739683,+,15054
324,BUMA.1121.00068,1,1329387,1344463,+,15076
324,BUMA.1121.00099,1,3844274,3859313,-,15039
324,BUMA.1121.00091,1,1900907,1915970,-,15063
324,BUMA.1121.00098,1,1214871,1229928,+,15057
324,BUMA.1121.00013,1,2824220,2839274,+,15054
324,BUMA.1121.00049,1,3259966,3275045,-,15079
324,BUMA.1121.00072,1,2516302,2531348,+,15046
324,BUMA.1121.00076,1,2749139,2764175,-,15036
324,BUMA.1121.00083,1,3064133,3079181,-,15048
324,BUMA.1121.00078,1,3442960,3458667,-,15707
324,BUMA.1121.00095,1,3099671,3114746,-,15075
324,BUMA.1121.00077,1,1266005,1281048,+,15043
324,BUMA.1121.00063,1,2541357,2556406,+,15049
324,BUMA.1121.00061,1,2544416,2559465,+,15049
324,BUMA.1121.00050,1,2957859,2972912,-,15053
324,BUMA.1121.00081,1,1724713,1739767,+,15054
324,BUMA.1121.00074,1,1246946,1262003,-,15057
324,BUMA.1121.00062,1,1990192,2005250,-,15058
324,BUMA.1121.00060,1,3688112,3703159,-,15047
324,BUMA.1121.00070,1,2515482,2530531,+,15049
324,BUMA.1121.00075,1,2049892,2064929,+,15037
324,BUMA.1121.00041,1,3888057,3903102,+,15045
324,BUMA.1121.00073,1,2542588,2557637,+,15049
324,BUMA.1121.00017,1,2669061,2684120,+,15059
324,BUMA.1121.00066,1,2518090,2533129,+,15039
324,BUMA.1121.00107,1,2482810,2497864,+,15054
324,BUMA.1121.00085,1,2140793,2155847,+,15054
324,BUMA.1121.00030,1,2669099,2684158,+,15059
324,BUMA.1121.00112,1,270760,285805,-,15045
324,BUMA.1121.00002,1,332549,347605,+,15056
324,BUMA.1121.00082,1,2700179,2715228,+,15049
324,BUMA.1121.00014,1,78981,94038,-,15057
324,BUMA.1121.00011,1,3045070,3060118,-,15048
324,BUMA.1121.00019,1,2698968,2714022,+,15054
324,BUMA.1121.00057,1,3715470,3730533,+,15063
324,BUMA.1121.00018,1,3193375,3208426,+,15051
324,BUMA.1121.00039,1,2739119,2754182,+,15063
324,BUMA.1121.00016,1,704335,719381,+,15046
324,BUMA.1121.00004,1,2733919,2748973,+,15054
324,BUMA.1121.00005,1,1306914,1321964,+,15050
324,BUMA.1121.00100,1,2754486,2769540,-,15054
324,BUMA.1121.00006,1,1724640,1739694,+,15054
323,BUMA.1121.00027,1,707228,744629,+,37401
323,BUMA.1121.00025,1,66308,103704,-,37396
323,BUMA.1121.00021,1,3164398,3201694,+,37296
323,BUMA.1121.00023,1,884790,922301,+,37511
323,BUMA.1121.00024,1,2695393,2732676,+,37283
323,BUMA.1121.00033,1,741579,779026,+,37447
323,BUMA.1121.00034,1,2734151,2771434,+,37283
323,BUMA.1121.00036,1,1378621,1415860,-,37239
323,BUMA.1121.00032,1,763801,801084,+,37283
323,BUMA.1121.00009,1,2978925,3016404,-,37479
323,BUMA.1121.00008,1,2708408,2745691,+,37283
323,BUMA.1121.00003,1,1055162,1092511,+,37349
323,BUMA.1121.00109,1,3310628,3347970,-,37342
323,BUMA.1121.00053,1,2275634,2313122,+,37488
323,BUMA.1121.00110,1,2217231,2254606,-,37375
323,BUMA.1121.00104,1,2643456,2680759,-,37303
323,BUMA.1121.00086,1,1383087,1420370,+,37283
323,BUMA.1121.00092,1,1221022,1258471,-,37449
323,BUMA.1121.00096,1,674153,711540,-,37387
323,BUMA.1121.00054,1,2418544,2455776,-,37232
323,BUMA.1121.00097,1,1342136,1379466,-,37330
323,BUMA.1121.00093,1,3367797,3405131,+,37334
323,BUMA.1121.00106,1,2308924,2346289,+,37365
323,BUMA.1121.00010,1,268645,305893,+,37248
323,BUMA.1121.00035,1,3715759,3753110,+,37351
323,BUMA.1121.00108,1,3558488,3595930,+,37442
323,BUMA.1121.00028,1,2696716,2733999,+,37283
323,BUMA.1121.00094,1,2549176,2586638,+,37462
323,BUMA.1121.00102,1,2740968,2778407,-,37439
323,BUMA.1121.00111,1,2721322,2758709,+,37387
323,BUMA.1121.00089,1,2518863,2556342,+,37479
323,BUMA.1121.00084,1,2932848,2970197,+,37349
323,BUMA.1121.00029,1,2371060,2408384,-,37324
323,BUMA.1121.00012,1,1283704,1321120,+,37416
323,BUMA.1121.00087,1,1896509,1933741,-,37232
323,BUMA.1121.00043,1,2627019,2664582,+,37563
323,BUMA.1121.00046,1,3250994,3288277,+,37283
323,BUMA.1121.00037,1,1167333,1204626,+,37293
323,BUMA.1121.00080,1,2562307,2599775,+,37468
323,BUMA.1121.00079,1,2557993,2595470,+,37477
323,BUMA.1121.00045,1,1457907,1495216,-,37309
323,BUMA.1121.00071,1,2495981,2533377,+,37396
323,BUMA.1121.00056,1,1370258,1407686,-,37428
323,BUMA.1121.00065,1,2625145,2662460,+,37315
323,BUMA.1121.00058,1,1977646,2014980,-,37334
323,BUMA.1121.00007,1,1503994,1541289,-,37295
323,BUMA.1121.00067,1,1816381,1853680,-,37299
323,BUMA.1121.00090,1,641355,678803,+,37448
323,BUMA.1121.00051,1,2532049,2569516,+,37467
323,BUMA.1121.00020,1,2761621,2798904,+,37283
323,BUMA.1121.00103,1,1850923,1888332,-,37409
323,BUMA.1121.00048,1,1479892,1517175,+,37283
323,BUMA.1121.00047,1,352557,390065,-,37508
323,BUMA.1121.00042,1,2135245,2172535,+,37290
323,BUMA.1121.00055,1,2201679,2239083,+,37404
323,BUMA.1121.00031,1,3972459,4009910,+,37451
323,BUMA.1121.00040,1,2706766,2744049,+,37283
323,BUMA.1121.00044,1,1962249,1999532,+,37283
323,BUMA.1121.00088,1,3478442,3515793,+,37351
323,BUMA.1121.00069,1,2476458,2513832,+,37374
323,BUMA.1121.00064,1,2575044,2612375,+,37331
323,BUMA.1121.00105,1,2648832,2686284,-,37452
323,BUMA.1121.00015,1,1320740,1357979,-,37239
323,BUMA.1121.00059,1,1751242,1788664,+,37422
323,BUMA.1121.00026,1,2644933,2682216,-,37283
323,BUMA.1121.00022,1,3113832,3151115,+,37283
323,BUMA.1121.00052,1,2506573,2543846,+,37273
323,BUMA.1121.00101,1,3845701,3883186,-,37485
323,BUMA.1121.00001,1,1487995,1525308,-,37313
323,BUMA.1121.00038,1,1687345,1724628,+,37283
323,BUMA.1121.00068,1,1292097,1329386,+,37289
323,BUMA.1121.00099,1,3859315,3896541,-,37226
323,BUMA.1121.00091,1,1915972,1953237,-,37265
323,BUMA.1121.00098,1,1177479,1214870,+,37391
323,BUMA.1121.00013,1,2786941,2824219,+,37278
323,BUMA.1121.00049,1,3275047,3312345,-,37298
323,BUMA.1121.00072,1,2478901,2516301,+,37400
323,BUMA.1121.00076,1,2764177,2801528,-,37351
323,BUMA.1121.00083,1,3079183,3116534,-,37351
323,BUMA.1121.00078,1,3458669,3496014,-,37345
323,BUMA.1121.00095,1,3114748,3152195,-,37447
323,BUMA.1121.00077,1,1228578,1266004,+,37426
323,BUMA.1121.00063,1,2503954,2541356,+,37402
323,BUMA.1121.00061,1,2507050,2544415,+,37365
323,BUMA.1121.00050,1,2972914,3010146,-,37232
323,BUMA.1121.00081,1,1687429,1724712,+,37283
323,BUMA.1121.00074,1,1262005,1299301,-,37296
323,BUMA.1121.00062,1,2005252,2042581,-,37329
323,BUMA.1121.00060,1,3703161,3740470,-,37309
323,BUMA.1121.00070,1,2478079,2515481,+,37402
323,BUMA.1121.00075,1,2012544,2049891,+,37347
323,BUMA.1121.00041,1,3850600,3888056,+,37456
323,BUMA.1121.00073,1,2505185,2542587,+,37402
323,BUMA.1121.00017,1,2631777,2669060,+,37283
323,BUMA.1121.00066,1,2480689,2518089,+,37400
323,BUMA.1121.00107,1,2435605,2473125,+,37520
323,BUMA.1121.00085,1,2103519,2140792,+,37273
323,BUMA.1121.00030,1,2631815,2669098,+,37283
323,BUMA.1121.00112,1,387469,424851,-,37382
323,BUMA.1121.00002,1,293954,331202,+,37248
323,BUMA.1121.00082,1,2662776,2700178,+,37402
323,BUMA.1121.00014,1,206607,244049,-,37442
323,BUMA.1121.00011,1,3060120,3097540,-,37420
323,BUMA.1121.00019,1,2661684,2698967,+,37283
323,BUMA.1121.00057,1,3678067,3715469,+,37402
323,BUMA.1121.00018,1,3155978,3193374,+,37396
323,BUMA.1121.00039,1,2701649,2739118,+,37469
323,BUMA.1121.00016,1,666885,704328,+,37443
323,BUMA.1121.00004,1,2696635,2733918,+,37283
323,BUMA.1121.00005,1,1269592,1306913,+,37321
323,BUMA.1121.00100,1,2769542,2806976,-,37434
323,BUMA.1121.00006,1,1687356,1724639,+,37283
322,BUMA.1121.00027,1,701987,705634,+,3647
322,BUMA.1121.00025,1,105285,108927,-,3642
322,BUMA.1121.00021,1,3159211,3162817,+,3606
322,BUMA.1121.00023,1,879597,883209,+,3612
322,BUMA.1121.00024,1,2690193,2693799,+,3606
322,BUMA.1121.00033,1,736349,739998,+,3649
322,BUMA.1121.00034,1,2728951,2732557,+,3606
322,BUMA.1121.00036,1,1417505,1421111,-,3606
322,BUMA.1121.00032,1,758601,762207,+,3606
322,BUMA.1121.00009,1,3017985,3021660,-,3675
322,BUMA.1121.00008,1,2703208,2706814,+,3606
322,BUMA.1121.00003,1,1049920,1053568,+,3648
322,BUMA.1121.00109,1,3349615,3353287,-,3672
322,BUMA.1121.00053,1,2270416,2274040,+,3624
322,BUMA.1121.00110,1,2256264,2259911,-,3647
322,BUMA.1121.00104,1,2682404,2686034,-,3630
322,BUMA.1121.00086,1,1377881,1381493,+,3612
322,BUMA.1121.00092,1,1260065,1263701,-,3636
322,BUMA.1121.00096,1,713185,716815,-,3630
322,BUMA.1121.00054,1,2457421,2461021,-,3600
322,BUMA.1121.00097,1,1381060,1384690,-,3630
322,BUMA.1121.00097,1,1749039,1752583,+,3544
322,BUMA.1121.00093,1,3362567,3366203,+,3636
322,BUMA.1121.00106,1,2303694,2307330,+,3636
322,BUMA.1121.00010,1,263445,267051,+,3606
322,BUMA.1121.00035,1,3710535,3714178,+,3643
322,BUMA.1121.00108,1,3553237,3556894,+,3657
322,BUMA.1121.00028,1,2691516,2695122,+,3606
322,BUMA.1121.00094,1,2543940,2547582,+,3642
322,BUMA.1121.00102,1,2779988,2783636,-,3648
322,BUMA.1121.00111,1,2716105,2719741,+,3636
322,BUMA.1121.00089,1,2513645,2517269,+,3624
322,BUMA.1121.00084,1,2927630,2931254,+,3624
322,BUMA.1121.00029,1,2409965,2413608,-,3643
322,BUMA.1121.00012,1,1278493,1282123,+,3630
322,BUMA.1121.00087,1,1935386,1938998,-,3612
322,BUMA.1121.00043,1,2621793,2625425,+,3632
322,BUMA.1121.00046,1,3245806,3249400,+,3594
322,BUMA.1121.00037,1,1162109,1165739,+,3630
322,BUMA.1121.00080,1,2557061,2560713,+,3652
322,BUMA.1121.00079,1,2552735,2556399,+,3664
322,BUMA.1121.00045,1,1496861,1500492,-,3631
322,BUMA.1121.00071,1,2490781,2494387,+,3606
322,BUMA.1121.00056,1,1409331,1412955,-,3624
322,BUMA.1121.00065,1,2619920,2623551,+,3631
322,BUMA.1121.00058,1,2016574,2020228,-,3654
322,BUMA.1121.00007,1,1542934,1546546,-,3612
322,BUMA.1121.00067,1,1855325,1858961,-,3636
322,BUMA.1121.00090,1,636138,639774,+,3636
322,BUMA.1121.00051,1,2526837,2530455,+,3618
322,BUMA.1121.00020,1,2756421,2760027,+,3606
322,BUMA.1121.00103,1,1889977,1893605,-,3628
322,BUMA.1121.00048,1,1474698,1478298,+,3600
322,BUMA.1121.00047,1,391646,395252,-,3606
322,BUMA.1121.00042,1,2130052,2133664,+,3612
322,BUMA.1121.00055,1,2196437,2200085,+,3648
322,BUMA.1121.00031,1,3967248,3970878,+,3630
322,BUMA.1121.00040,1,2701578,2705172,+,3594
322,BUMA.1121.00044,1,1957049,1960655,+,3606
322,BUMA.1121.00088,1,3473218,3476848,+,3630
322,BUMA.1121.00069,1,2471231,2474837,+,3606
322,BUMA.1121.00064,1,2569819,2573450,+,3631
322,BUMA.1121.00105,1,2687878,2691491,-,3613
322,BUMA.1121.00015,1,1359624,1363218,-,3594
322,BUMA.1121.00059,1,1746000,1749648,+,3648
322,BUMA.1121.00026,1,2683797,2687397,-,3600
322,BUMA.1121.00022,1,3108632,3112238,+,3606
322,BUMA.1121.00052,1,2501385,2504979,+,3594
322,BUMA.1121.00101,1,3884832,3888462,-,3630
322,BUMA.1121.00001,1,1526889,1530539,-,3650
322,BUMA.1121.00038,1,1682151,1685751,+,3600
322,BUMA.1121.00068,1,1286842,1290503,+,3661
322,BUMA.1121.00099,1,3898186,3901847,-,3661
322,BUMA.1121.00091,1,1954882,1958524,-,3642
322,BUMA.1121.00098,1,1172240,1175858,+,3618
322,BUMA.1121.00013,1,2781753,2785347,+,3594
322,BUMA.1121.00049,1,3313990,3317614,-,3624
322,BUMA.1121.00072,1,2473701,2477307,+,3606
322,BUMA.1121.00076,1,2803109,2806739,-,3630
322,BUMA.1121.00083,1,3118179,3121785,-,3606
322,BUMA.1121.00078,1,3497657,3501287,-,3630
322,BUMA.1121.00095,1,3153788,3157433,-,3645
322,BUMA.1121.00077,1,1223323,1226970,+,3647
322,BUMA.1121.00063,1,2498754,2502360,+,3606
322,BUMA.1121.00061,1,2501850,2505456,+,3606
322,BUMA.1121.00050,1,3011791,3015385,-,3594
322,BUMA.1121.00081,1,1682235,1685835,+,3600
322,BUMA.1121.00074,1,1300946,1304570,-,3624
322,BUMA.1121.00062,1,2044175,2047811,-,3636
322,BUMA.1121.00060,1,3742115,3745746,-,3631
322,BUMA.1121.00070,1,2472879,2476485,+,3606
322,BUMA.1121.00075,1,2007333,2010963,+,3630
322,BUMA.1121.00041,1,3845363,3849019,+,3656
322,BUMA.1121.00073,1,2499985,2503591,+,3606
322,BUMA.1121.00017,1,2626577,2630183,+,3606
322,BUMA.1121.00066,1,2475489,2479095,+,3606
322,BUMA.1121.00107,1,2430362,2434011,+,3649
322,BUMA.1121.00085,1,2098331,2101925,+,3594
322,BUMA.1121.00030,1,2626615,2630221,+,3606
322,BUMA.1121.00112,1,426445,430077,-,3632
322,BUMA.1121.00002,1,288754,292360,+,3606
322,BUMA.1121.00082,1,2657576,2661182,+,3606
322,BUMA.1121.00014,1,245630,249260,-,3630
322,BUMA.1121.00011,1,3099185,3102804,-,3619
322,BUMA.1121.00019,1,2656484,2660090,+,3606
322,BUMA.1121.00057,1,3672831,3676473,+,3642
322,BUMA.1121.00018,1,3150755,3154397,+,3642
322,BUMA.1121.00039,1,2696377,2700055,+,3678
322,BUMA.1121.00016,1,661662,665304,+,3642
322,BUMA.1121.00004,1,2691435,2695041,+,3606
322,BUMA.1121.00005,1,1264363,1267998,+,3635
322,BUMA.1121.00100,1,2808621,2812294,-,3673
322,BUMA.1121.00006,1,1682162,1685762,+,3600
321,BUMA.1121.00027,1,692375,701579,+,9204
321,BUMA.1121.00025,1,109335,118530,-,9195
321,BUMA.1121.00021,1,3149608,3158803,+,9195
321,BUMA.1121.00023,1,869936,879189,+,9253
321,BUMA.1121.00024,1,2680552,2689785,+,9233
321,BUMA.1121.00033,1,726688,735941,+,9253
321,BUMA.1121.00034,1,2719310,2728543,+,9233
321,BUMA.1121.00036,1,1421519,1430753,-,9234
321,BUMA.1121.00032,1,748960,758193,+,9233
321,BUMA.1121.00009,1,3022068,3031305,-,9237
321,BUMA.1121.00008,1,2693567,2702800,+,9233
321,BUMA.1121.00003,1,1040260,1049512,+,9252
321,BUMA.1121.00109,1,3353695,3362949,-,9254
321,BUMA.1121.00053,1,2260798,2270008,+,9210
321,BUMA.1121.00110,1,2260319,2269572,-,9253
321,BUMA.1121.00104,1,2686442,2695696,-,9254
321,BUMA.1121.00086,1,1368239,1377473,+,9234
321,BUMA.1121.00092,1,1264109,1273362,-,9253
321,BUMA.1121.00096,1,717223,726476,-,9253
321,BUMA.1121.00054,1,2461429,2470663,-,9234
321,BUMA.1121.00097,1,1385110,1394339,-,9229
321,BUMA.1121.00093,1,3352906,3362159,+,9253
321,BUMA.1121.00106,1,2294018,2303286,+,9268
321,BUMA.1121.00010,1,253804,263037,+,9233
321,BUMA.1121.00035,1,3700932,3710127,+,9195
321,BUMA.1121.00108,1,3543595,3552829,+,9234
321,BUMA.1121.00028,1,2681875,2691108,+,9233
321,BUMA.1121.00094,1,2534261,2543532,+,9271
321,BUMA.1121.00102,1,2784044,2793306,-,9262
321,BUMA.1121.00111,1,2706502,2715697,+,9195
321,BUMA.1121.00089,1,2503966,2513237,+,9271
321,BUMA.1121.00084,1,2917959,2927222,+,9263
321,BUMA.1121.00029,1,2414016,2423211,-,9195
321,BUMA.1121.00012,1,1268832,1278085,+,9253
321,BUMA.1121.00087,1,1939406,1948640,-,9234
321,BUMA.1121.00043,1,2612190,2621385,+,9195
321,BUMA.1121.00046,1,3236171,3245398,+,9227
321,BUMA.1121.00037,1,1152506,1161701,+,9195
321,BUMA.1121.00080,1,2547399,2556653,+,9254
321,BUMA.1121.00079,1,2543075,2552327,+,9252
321,BUMA.1121.00045,1,1500900,1510141,-,9241
321,BUMA.1121.00071,1,2481168,2490373,+,9205
321,BUMA.1121.00056,1,1413363,1422634,-,9271
321,BUMA.1121.00065,1,2610258,2619512,+,9254
321,BUMA.1121.00058,1,2020636,2029915,-,9279
321,BUMA.1121.00007,1,1546954,1556184,-,9230
321,BUMA.1121.00067,1,1859369,1868617,-,9248
321,BUMA.1121.00090,1,626534,635730,+,9196
321,BUMA.1121.00051,1,2517175,2526429,+,9254
321,BUMA.1121.00020,1,2746780,2756013,+,9233
321,BUMA.1121.00103,1,1894025,1903246,-,9221
321,BUMA.1121.00048,1,1465056,1474290,+,9234
321,BUMA.1121.00047,1,395660,404929,-,9269
321,BUMA.1121.00042,1,2120689,2129644,+,8955
321,BUMA.1121.00055,1,2186791,2196017,+,9226
321,BUMA.1121.00031,1,3957645,3966840,+,9195
321,BUMA.1121.00040,1,2691937,2701170,+,9233
321,BUMA.1121.00044,1,1947408,1956641,+,9233
321,BUMA.1121.00088,1,3463564,3472810,+,9246
321,BUMA.1121.00069,1,2461616,2470823,+,9207
321,BUMA.1121.00064,1,2560158,2569411,+,9253
321,BUMA.1121.00105,1,2691899,2701151,-,9252
321,BUMA.1121.00015,1,1363626,1372860,-,9234
321,BUMA.1121.00059,1,1736321,1745592,+,9271
321,BUMA.1121.00026,1,2687805,2696760,-,8955
321,BUMA.1121.00022,1,3098990,3108224,+,9234
321,BUMA.1121.00052,1,2491743,2500977,+,9234
321,BUMA.1121.00101,1,3888882,3898006,-,9124
321,BUMA.1121.00001,1,1530947,1540142,-,9195
321,BUMA.1121.00038,1,1672509,1681743,+,9234
321,BUMA.1121.00068,1,1277193,1286434,+,9241
321,BUMA.1121.00099,1,3902255,3911506,-,9251
321,BUMA.1121.00091,1,1958932,1968185,-,9253
321,BUMA.1121.00098,1,1162615,1171832,+,9217
321,BUMA.1121.00013,1,2772111,2781345,+,9234
321,BUMA.1121.00049,1,3318022,3327290,-,9268
321,BUMA.1121.00072,1,2464122,2473293,+,9171
321,BUMA.1121.00076,1,2807147,2816432,-,9285
321,BUMA.1121.00083,1,3122193,3131400,-,9207
321,BUMA.1121.00078,1,3501695,3510945,-,9250
321,BUMA.1121.00095,1,3157841,3167092,-,9251
321,BUMA.1121.00077,1,1213662,1222915,+,9253
321,BUMA.1121.00063,1,2489139,2498346,+,9207
321,BUMA.1121.00061,1,2492235,2501442,+,9207
321,BUMA.1121.00050,1,3015793,3025020,-,9227
321,BUMA.1121.00081,1,1672593,1681827,+,9234
321,BUMA.1121.00074,1,1304978,1314231,-,9253
321,BUMA.1121.00062,1,2048219,2057473,-,9254
321,BUMA.1121.00060,1,3746154,3755395,-,9241
321,BUMA.1121.00070,1,2463264,2472471,+,9207
321,BUMA.1121.00075,1,1997640,2006925,+,9285
321,BUMA.1121.00041,1,3835708,3844955,+,9247
321,BUMA.1121.00073,1,2490370,2499577,+,9207
321,BUMA.1121.00017,1,2616936,2626169,+,9233
321,BUMA.1121.00066,1,2465874,2475081,+,9207
321,BUMA.1121.00107,1,2420701,2429954,+,9253
321,BUMA.1121.00085,1,2088689,2097923,+,9234
321,BUMA.1121.00030,1,2616974,2626207,+,9233
321,BUMA.1121.00112,1,430485,439679,-,9194
321,BUMA.1121.00002,1,279113,288346,+,9233
321,BUMA.1121.00082,1,2647961,2657168,+,9207
321,BUMA.1121.00014,1,249668,258863,-,9195
321,BUMA.1121.00011,1,3103212,3112432,-,9220
321,BUMA.1121.00019,1,2646843,2656076,+,9233
321,BUMA.1121.00057,1,3663170,3672423,+,9253
321,BUMA.1121.00018,1,3141151,3150347,+,9196
321,BUMA.1121.00039,1,2686777,2695969,+,9192
321,BUMA.1121.00016,1,652001,661254,+,9253
321,BUMA.1121.00004,1,2681794,2691027,+,9233
321,BUMA.1121.00005,1,1254765,1263955,+,9190
321,BUMA.1121.00100,1,2812702,2821954,-,9252
321,BUMA.1121.00006,1,1672520,1681754,+,9234
320,BUMA.1121.00027,1,686681,690648,+,3967
320,BUMA.1121.00025,1,120255,124222,-,3967
320,BUMA.1121.00021,1,3143915,3147882,+,3967
320,BUMA.1121.00023,1,864243,868210,+,3967
320,BUMA.1121.00024,1,2674858,2678825,+,3967
320,BUMA.1121.00033,1,720995,724962,+,3967
320,BUMA.1121.00034,1,2713616,2717583,+,3967
320,BUMA.1121.00036,1,1432479,1436446,-,3967
320,BUMA.1121.00032,1,743266,747233,+,3967
320,BUMA.1121.00009,1,3033030,3036991,-,3961
320,BUMA.1121.00008,1,2687873,2691840,+,3967
320,BUMA.1121.00003,1,1034567,1038534,+,3967
320,BUMA.1121.00109,1,3364674,3368641,-,3967
320,BUMA.1121.00053,1,2255105,2259072,+,3967
320,BUMA.1121.00110,1,2271297,2275264,-,3967
320,BUMA.1121.00104,1,2697421,2701388,-,3967
320,BUMA.1121.00086,1,1362545,1366512,+,3967
320,BUMA.1121.00092,1,1275087,1279054,-,3967
320,BUMA.1121.00096,1,728201,732168,-,3967
320,BUMA.1121.00054,1,2472389,2476356,-,3967
320,BUMA.1121.00097,1,1396064,1400031,-,3967
320,BUMA.1121.00093,1,3347213,3351180,+,3967
320,BUMA.1121.00106,1,2288325,2292292,+,3967
320,BUMA.1121.00010,1,248110,252077,+,3967
320,BUMA.1121.00035,1,3695239,3699206,+,3967
320,BUMA.1121.00108,1,3537902,3541869,+,3967
320,BUMA.1121.00028,1,2676181,2680148,+,3967
320,BUMA.1121.00094,1,2528568,2532535,+,3967
320,BUMA.1121.00102,1,2795031,2798998,-,3967
320,BUMA.1121.00111,1,2700809,2704776,+,3967
320,BUMA.1121.00089,1,2498273,2502240,+,3967
320,BUMA.1121.00084,1,2912265,2916232,+,3967
320,BUMA.1121.00029,1,2424936,2428903,-,3967
320,BUMA.1121.00012,1,1263146,1267106,+,3960
320,BUMA.1121.00087,1,1950366,1954333,-,3967
320,BUMA.1121.00043,1,2606497,2610464,+,3967
320,BUMA.1121.00046,1,3230477,3234444,+,3967
320,BUMA.1121.00037,1,1146813,1150780,+,3967
320,BUMA.1121.00080,1,2541706,2545673,+,3967
320,BUMA.1121.00079,1,2537383,2541350,+,3967
320,BUMA.1121.00045,1,1511866,1515815,-,3949
320,BUMA.1121.00071,1,2475474,2479441,+,3967
320,BUMA.1121.00056,1,1424359,1428326,-,3967
320,BUMA.1121.00065,1,2604565,2608532,+,3967
320,BUMA.1121.00058,1,2031641,2035608,-,3967
320,BUMA.1121.00007,1,1557909,1561876,-,3967
320,BUMA.1121.00067,1,1870342,1874309,-,3967
320,BUMA.1121.00090,1,620841,624808,+,3967
320,BUMA.1121.00051,1,2511482,2515449,+,3967
320,BUMA.1121.00020,1,2741086,2745053,+,3967
320,BUMA.1121.00103,1,1904971,1908895,-,3924
320,BUMA.1121.00048,1,1459362,1463329,+,3967
320,BUMA.1121.00047,1,406654,410621,-,3967
320,BUMA.1121.00042,1,2114995,2118962,+,3967
320,BUMA.1121.00055,1,2181097,2185064,+,3967
320,BUMA.1121.00031,1,3951952,3955919,+,3967
320,BUMA.1121.00040,1,2686243,2690210,+,3967
320,BUMA.1121.00044,1,1941714,1945681,+,3967
320,BUMA.1121.00088,1,3457870,3461837,+,3967
320,BUMA.1121.00069,1,2455922,2459889,+,3967
320,BUMA.1121.00064,1,2554465,2558432,+,3967
320,BUMA.1121.00105,1,2702876,2706843,-,3967
320,BUMA.1121.00015,1,1374586,1378553,-,3967
320,BUMA.1121.00059,1,1730628,1734595,+,3967
320,BUMA.1121.00026,1,2698486,2702453,-,3967
320,BUMA.1121.00022,1,3093296,3097263,+,3967
320,BUMA.1121.00052,1,2486049,2490016,+,3967
320,BUMA.1121.00101,1,3901370,3905337,-,3967
320,BUMA.1121.00001,1,1541867,1545834,-,3967
320,BUMA.1121.00038,1,1666815,1670782,+,3967
320,BUMA.1121.00068,1,1271500,1275467,+,3967
320,BUMA.1121.00099,1,3913231,3917198,-,3967
320,BUMA.1121.00091,1,1969911,1973878,-,3967
320,BUMA.1121.00098,1,1156922,1160889,+,3967
320,BUMA.1121.00013,1,2766417,2770384,+,3967
320,BUMA.1121.00049,1,3329015,3332982,-,3967
320,BUMA.1121.00072,1,2458428,2462395,+,3967
320,BUMA.1121.00076,1,2818158,2822125,-,3967
320,BUMA.1121.00083,1,3133126,3137093,-,3967
320,BUMA.1121.00078,1,3512670,3516636,-,3966
320,BUMA.1121.00095,1,3168817,3172784,-,3967
320,BUMA.1121.00077,1,1207969,1211936,+,3967
320,BUMA.1121.00063,1,2483445,2487412,+,3967
320,BUMA.1121.00061,1,2486541,2490508,+,3967
320,BUMA.1121.00050,1,3026746,3030713,-,3967
320,BUMA.1121.00081,1,1666899,1670866,+,3967
320,BUMA.1121.00074,1,1315956,1319923,-,3967
320,BUMA.1121.00062,1,2059198,2063165,-,3967
320,BUMA.1121.00060,1,3757120,3761069,-,3949
320,BUMA.1121.00070,1,2457570,2461537,+,3967
320,BUMA.1121.00075,1,1991946,1995913,+,3967
320,BUMA.1121.00041,1,3830014,3833981,+,3967
320,BUMA.1121.00073,1,2484676,2488643,+,3967
320,BUMA.1121.00017,1,2611242,2615209,+,3967
320,BUMA.1121.00066,1,2460180,2464147,+,3967
320,BUMA.1121.00107,1,2415008,2418975,+,3967
320,BUMA.1121.00085,1,2082995,2086962,+,3967
320,BUMA.1121.00030,1,2611280,2615247,+,3967
320,BUMA.1121.00112,1,441404,445371,-,3967
320,BUMA.1121.00002,1,273419,277386,+,3967
320,BUMA.1121.00082,1,2642267,2646234,+,3967
320,BUMA.1121.00014,1,260588,264555,-,3967
320,BUMA.1121.00011,1,3114157,3118124,-,3967
320,BUMA.1121.00019,1,2641149,2645116,+,3967
320,BUMA.1121.00057,1,3657476,3661443,+,3967
320,BUMA.1121.00018,1,3135458,3139425,+,3967
320,BUMA.1121.00039,1,2681084,2685051,+,3967
320,BUMA.1121.00016,1,646309,650275,+,3966
320,BUMA.1121.00004,1,2676100,2680067,+,3967
320,BUMA.1121.00005,1,1249072,1253039,+,3967
320,BUMA.1121.00100,1,2823679,2827646,-,3967
320,BUMA.1121.00006,1,1666826,1670793,+,3967
319,BUMA.1121.00027,1,682265,685602,+,3337
319,BUMA.1121.00025,1,125301,128688,-,3387
319,BUMA.1121.00021,1,3139484,3142836,+,3352
319,BUMA.1121.00023,1,859812,863164,+,3352
319,BUMA.1121.00024,1,2670439,2673779,+,3340
319,BUMA.1121.00033,1,716523,719916,+,3393
319,BUMA.1121.00034,1,2709197,2712537,+,3340
319,BUMA.1121.00036,1,1437525,1440866,-,3341
319,BUMA.1121.00032,1,738847,742187,+,3340
319,BUMA.1121.00009,1,3038070,3041410,-,3340
319,BUMA.1121.00008,1,2683454,2686794,+,3340
319,BUMA.1121.00003,1,1030144,1033488,+,3344
319,BUMA.1121.00109,1,3369720,3373135,-,3415
319,BUMA.1121.00053,1,2250663,2254026,+,3363
319,BUMA.1121.00110,1,2276343,2279786,-,3443
319,BUMA.1121.00104,1,2702467,2705808,-,3341
319,BUMA.1121.00086,1,1358126,1361466,+,3340
319,BUMA.1121.00092,1,1280133,1283519,-,3386
319,BUMA.1121.00096,1,733247,736587,-,3340
319,BUMA.1121.00054,1,2477435,2480770,-,3335
319,BUMA.1121.00097,1,1401110,1404519,-,3409
319,BUMA.1121.00093,1,3342749,3346134,+,3385
319,BUMA.1121.00106,1,2283900,2287246,+,3346
319,BUMA.1121.00010,1,243691,247031,+,3340
319,BUMA.1121.00035,1,3690778,3694160,+,3382
319,BUMA.1121.00108,1,3533395,3536823,+,3428
319,BUMA.1121.00028,1,2671762,2675102,+,3340
319,BUMA.1121.00094,1,2524150,2527489,+,3339
319,BUMA.1121.00102,1,2800077,2803422,-,3345
319,BUMA.1121.00111,1,2696366,2699730,+,3364
319,BUMA.1121.00089,1,2493855,2497194,+,3339
319,BUMA.1121.00084,1,2907760,2911186,+,3426
319,BUMA.1121.00029,1,2429982,2433353,-,3371
319,BUMA.1121.00012,1,1258709,1262067,+,3358
319,BUMA.1121.00087,1,1955412,1958753,-,3341
319,BUMA.1121.00043,1,2602055,2605418,+,3363
319,BUMA.1121.00046,1,3226064,3229398,+,3334
319,BUMA.1121.00037,1,1142377,1145734,+,3357
319,BUMA.1121.00080,1,2537195,2540627,+,3432
319,BUMA.1121.00079,1,2532871,2536304,+,3433
319,BUMA.1121.00045,1,1516894,1520281,-,3387
319,BUMA.1121.00071,1,2471058,2474395,+,3337
319,BUMA.1121.00056,1,1429405,1432745,-,3340
319,BUMA.1121.00065,1,2600143,2603486,+,3343
319,BUMA.1121.00058,1,2036687,2040068,-,3381
319,BUMA.1121.00007,1,1562955,1566301,-,3346
319,BUMA.1121.00067,1,1875388,1878841,-,3453
319,BUMA.1121.00090,1,616392,619762,+,3370
319,BUMA.1121.00051,1,2506970,2510403,+,3433
319,BUMA.1121.00020,1,2736667,2740007,+,3340
319,BUMA.1121.00103,1,1909974,1913322,-,3348
319,BUMA.1121.00048,1,1454949,1458283,+,3334
319,BUMA.1121.00047,1,411700,415040,-,3340
319,BUMA.1121.00042,1,2110564,2113916,+,3352
319,BUMA.1121.00055,1,2176673,2180018,+,3345
319,BUMA.1121.00031,1,3947495,3950873,+,3378
319,BUMA.1121.00040,1,2681830,2685164,+,3334
319,BUMA.1121.00044,1,1937295,1940635,+,3340
319,BUMA.1121.00088,1,3453371,3456791,+,3420
319,BUMA.1121.00069,1,2451506,2454843,+,3337
319,BUMA.1121.00064,1,2549928,2553386,+,3458
319,BUMA.1121.00105,1,2707922,2711321,-,3399
319,BUMA.1121.00015,1,1379632,1382967,-,3335
319,BUMA.1121.00059,1,1726167,1729549,+,3382
319,BUMA.1121.00026,1,2703532,2706891,-,3359
319,BUMA.1121.00022,1,3088871,3092217,+,3346
319,BUMA.1121.00052,1,2481636,2484970,+,3334
319,BUMA.1121.00101,1,3906416,3909762,-,3346
319,BUMA.1121.00001,1,1546913,1550278,-,3365
319,BUMA.1121.00038,1,1662402,1665736,+,3334
319,BUMA.1121.00068,1,1266987,1270421,+,3434
319,BUMA.1121.00099,1,3918277,3921694,-,3417
319,BUMA.1121.00091,1,1974957,1978360,-,3403
319,BUMA.1121.00098,1,1152511,1155843,+,3332
319,BUMA.1121.00013,1,2762004,2765338,+,3334
319,BUMA.1121.00049,1,3334061,3337402,-,3341
319,BUMA.1121.00072,1,2454012,2457349,+,3337
319,BUMA.1121.00076,1,2823204,2826545,-,3341
319,BUMA.1121.00083,1,3138172,3141510,-,3338
319,BUMA.1121.00078,1,3517715,3521140,-,3425
319,BUMA.1121.00095,1,3173863,3177292,-,3429
319,BUMA.1121.00077,1,1203446,1206890,+,3444
319,BUMA.1121.00063,1,2479029,2482366,+,3337
319,BUMA.1121.00061,1,2482125,2485462,+,3337
319,BUMA.1121.00050,1,3031792,3035127,-,3335
319,BUMA.1121.00081,1,1662486,1665820,+,3334
319,BUMA.1121.00074,1,1321002,1324468,-,3466
319,BUMA.1121.00062,1,2064244,2067699,-,3455
319,BUMA.1121.00060,1,3762148,3765535,-,3387
319,BUMA.1121.00070,1,2453154,2456491,+,3337
319,BUMA.1121.00075,1,1987529,1990867,+,3338
319,BUMA.1121.00041,1,3825572,3828935,+,3363
319,BUMA.1121.00073,1,2480260,2483597,+,3337
319,BUMA.1121.00017,1,2606823,2610163,+,3340
319,BUMA.1121.00066,1,2455764,2459101,+,3337
319,BUMA.1121.00107,1,2410597,2413929,+,3332
319,BUMA.1121.00085,1,2078582,2081916,+,3334
319,BUMA.1121.00030,1,2606861,2610201,+,3340
319,BUMA.1121.00112,1,446450,449758,-,3308
319,BUMA.1121.00002,1,269000,272340,+,3340
319,BUMA.1121.00082,1,2637851,2641188,+,3337
319,BUMA.1121.00014,1,265634,269013,-,3379
319,BUMA.1121.00011,1,3119203,3122570,-,3367
319,BUMA.1121.00019,1,2636730,2640070,+,3340
319,BUMA.1121.00057,1,3653060,3656397,+,3337
319,BUMA.1121.00018,1,3130993,3134379,+,3386
319,BUMA.1121.00039,1,2676641,2680005,+,3364
319,BUMA.1121.00016,1,641824,645230,+,3406
319,BUMA.1121.00004,1,2671681,2675021,+,3340
319,BUMA.1121.00005,1,1244666,1247993,+,3327
319,BUMA.1121.00100,1,2828725,2832058,-,3333
319,BUMA.1121.00006,1,1662413,1665747,+,3334
318,BUMA.1121.00027,1,677163,680603,+,3440
318,BUMA.1121.00025,1,130350,133741,-,3391
318,BUMA.1121.00021,1,3134423,3137822,+,3399
318,BUMA.1121.00023,1,854742,858150,+,3408
318,BUMA.1121.00024,1,2665643,2669071,+,3428
318,BUMA.1121.00033,1,711507,714861,+,3354
318,BUMA.1121.00034,1,2704401,2707829,+,3428
318,BUMA.1121.00036,1,1442234,1445662,-,3428
318,BUMA.1121.00032,1,734065,737479,+,3414
318,BUMA.1121.00009,1,3043072,3046516,-,3444
318,BUMA.1121.00008,1,2678658,2682086,+,3428
318,BUMA.1121.00003,1,1025002,1028482,+,3480
318,BUMA.1121.00109,1,3374797,3378197,-,3400
318,BUMA.1121.00053,1,2245544,2249001,+,3457
318,BUMA.1121.00110,1,2281448,2284834,-,3386
318,BUMA.1121.00104,1,2707470,2710869,-,3399
318,BUMA.1121.00086,1,1353330,1356758,+,3428
318,BUMA.1121.00092,1,1285183,1288640,-,3457
318,BUMA.1121.00096,1,738249,741785,-,3536
318,BUMA.1121.00054,1,2482138,2485584,-,3446
318,BUMA.1121.00097,1,1406181,1409565,-,3384
318,BUMA.1121.00093,1,3337628,3341085,+,3457
318,BUMA.1121.00106,1,2278839,2282238,+,3399
318,BUMA.1121.00010,1,238904,242323,+,3419
318,BUMA.1121.00035,1,3685717,3689116,+,3399
318,BUMA.1121.00108,1,3528306,3531733,+,3427
318,BUMA.1121.00028,1,2666966,2670394,+,3428
318,BUMA.1121.00094,1,2519057,2522488,+,3431
318,BUMA.1121.00102,1,2805084,2808533,-,3449
318,BUMA.1121.00111,1,2691305,2694704,+,3399
318,BUMA.1121.00089,1,2488762,2492193,+,3431
318,BUMA.1121.00084,1,2902671,2906098,+,3427
318,BUMA.1121.00029,1,2435015,2438414,-,3399
318,BUMA.1121.00012,1,1253648,1257047,+,3399
318,BUMA.1121.00087,1,1960121,1963549,-,3428
318,BUMA.1121.00043,1,2597053,2600393,+,3340
318,BUMA.1121.00046,1,3221250,3224696,+,3446
318,BUMA.1121.00037,1,1137332,1140715,+,3383
318,BUMA.1121.00080,1,2532103,2535533,+,3430
318,BUMA.1121.00079,1,2527779,2531209,+,3430
318,BUMA.1121.00045,1,1521943,1525352,-,3409
318,BUMA.1121.00071,1,2465957,2469396,+,3439
318,BUMA.1121.00056,1,1434407,1437838,-,3431
318,BUMA.1121.00065,1,2595074,2598481,+,3407
318,BUMA.1121.00058,1,2041730,2045160,-,3430
318,BUMA.1121.00007,1,1568000,1571390,-,3390
318,BUMA.1121.00067,1,1880505,1883951,-,3446
318,BUMA.1121.00090,1,611322,614730,+,3408
318,BUMA.1121.00051,1,2501878,2505308,+,3430
318,BUMA.1121.00020,1,2731871,2735299,+,3428
318,BUMA.1121.00103,1,1914984,1918411,-,3427
318,BUMA.1121.00048,1,1450135,1453581,+,3446
318,BUMA.1121.00047,1,416702,420133,-,3431
318,BUMA.1121.00042,1,2105777,2109196,+,3419
318,BUMA.1121.00055,1,2171572,2175011,+,3439
318,BUMA.1121.00031,1,3942434,3945833,+,3399
318,BUMA.1121.00040,1,2677007,2680462,+,3455
318,BUMA.1121.00044,1,1932499,1935927,+,3428
318,BUMA.1121.00088,1,3448292,3451709,+,3417
318,BUMA.1121.00069,1,2446404,2449844,+,3440
318,BUMA.1121.00064,1,2544857,2548266,+,3409
318,BUMA.1121.00105,1,2712985,2716430,-,3445
318,BUMA.1121.00015,1,1384335,1387799,-,3464
318,BUMA.1121.00059,1,1721076,1724503,+,3427
318,BUMA.1121.00026,1,2708259,2711687,-,3428
318,BUMA.1121.00022,1,3084066,3087503,+,3437
318,BUMA.1121.00052,1,2476831,2480268,+,3437
318,BUMA.1121.00101,1,3911424,3914840,-,3416
318,BUMA.1121.00001,1,1551940,1555339,-,3399
318,BUMA.1121.00038,1,1657588,1661034,+,3446
318,BUMA.1121.00068,1,1261989,1265325,+,3336
318,BUMA.1121.00099,1,3923356,3926746,-,3390
318,BUMA.1121.00091,1,1980022,1983431,-,3409
318,BUMA.1121.00098,1,1147355,1150849,+,3494
318,BUMA.1121.00013,1,2757208,2760636,+,3428
318,BUMA.1121.00049,1,3339064,3342472,-,3408
318,BUMA.1121.00072,1,2448919,2452350,+,3431
318,BUMA.1121.00076,1,2828207,2831606,-,3399
318,BUMA.1121.00083,1,3143172,3146612,-,3440
318,BUMA.1121.00078,1,3522802,3526270,-,3468
318,BUMA.1121.00095,1,3178953,3182366,-,3413
318,BUMA.1121.00077,1,1198399,1201785,+,3386
318,BUMA.1121.00063,1,2473946,2477367,+,3421
318,BUMA.1121.00061,1,2477023,2480463,+,3440
318,BUMA.1121.00050,1,3036495,3039941,-,3446
318,BUMA.1121.00081,1,1657672,1661118,+,3446
318,BUMA.1121.00074,1,1326132,1329560,-,3428
318,BUMA.1121.00062,1,2069363,2072808,-,3445
318,BUMA.1121.00060,1,3767197,3770606,-,3409
318,BUMA.1121.00070,1,2448052,2451492,+,3440
318,BUMA.1121.00075,1,1982468,1985867,+,3399
318,BUMA.1121.00041,1,3820510,3823910,+,3400
318,BUMA.1121.00073,1,2475158,2478598,+,3440
318,BUMA.1121.00017,1,2602027,2605455,+,3428
318,BUMA.1121.00066,1,2450663,2454102,+,3439
318,BUMA.1121.00107,1,2405448,2408935,+,3487
318,BUMA.1121.00085,1,2073777,2077214,+,3437
318,BUMA.1121.00030,1,2602065,2605493,+,3428
318,BUMA.1121.00112,1,451457,454873,-,3416
318,BUMA.1121.00002,1,264213,267632,+,3419
318,BUMA.1121.00082,1,2632749,2636189,+,3440
318,BUMA.1121.00014,1,270675,274074,-,3399
318,BUMA.1121.00011,1,3124232,3127649,-,3417
318,BUMA.1121.00019,1,2631934,2635362,+,3428
318,BUMA.1121.00057,1,3647958,3651398,+,3440
318,BUMA.1121.00018,1,3125940,3129331,+,3391
318,BUMA.1121.00039,1,2671553,2674927,+,3374
318,BUMA.1121.00016,1,636825,640162,+,3337
318,BUMA.1121.00004,1,2666885,2670313,+,3428
318,BUMA.1121.00005,1,1239530,1243004,+,3474
318,BUMA.1121.00100,1,2833720,2837166,-,3446
318,BUMA.1121.00006,1,1657599,1661045,+,3446
317,BUMA.1121.00027,1,670695,676685,+,5990
317,BUMA.1121.00025,1,134204,140195,-,5991
317,BUMA.1121.00021,1,3128018,3134009,+,5991
317,BUMA.1121.00023,1,848350,854342,+,5992
317,BUMA.1121.00024,1,2659116,2665106,+,5990
317,BUMA.1121.00033,1,705093,711084,+,5991
317,BUMA.1121.00034,1,2697856,2703846,+,5990
317,BUMA.1121.00036,1,1446182,1452171,-,5989
317,BUMA.1121.00032,1,727373,733363,+,5990
317,BUMA.1121.00009,1,3046880,3052872,-,5992
317,BUMA.1121.00008,1,2672127,2678117,+,5990
317,BUMA.1121.00003,1,1018621,1024599,+,5978
317,BUMA.1121.00109,1,3378626,3384617,-,5991
317,BUMA.1121.00053,1,2239145,2245137,+,5992
317,BUMA.1121.00110,1,2285263,2291255,-,5992
317,BUMA.1121.00104,1,2711277,2717268,-,5991
317,BUMA.1121.00086,1,1346806,1352796,+,5990
317,BUMA.1121.00092,1,1289152,1295143,-,5991
317,BUMA.1121.00096,1,742285,748276,-,5991
317,BUMA.1121.00054,1,2486307,2492295,-,5988
317,BUMA.1121.00097,1,1409966,1415956,-,5990
317,BUMA.1121.00093,1,3331139,3337130,+,5991
317,BUMA.1121.00106,1,2272356,2278347,+,5991
317,BUMA.1121.00010,1,232450,238440,+,5990
317,BUMA.1121.00035,1,3679311,3685303,+,5992
317,BUMA.1121.00108,1,3521906,3527899,+,5993
317,BUMA.1121.00028,1,2660435,2666425,+,5990
317,BUMA.1121.00094,1,2512580,2518571,+,5991
317,BUMA.1121.00102,1,2809555,2815547,-,5992
317,BUMA.1121.00111,1,2684872,2690863,+,5991
317,BUMA.1121.00089,1,2482285,2488276,+,5991
317,BUMA.1121.00084,1,2896294,2902285,+,5991
317,BUMA.1121.00029,1,2438835,2444827,-,5992
317,BUMA.1121.00012,1,1247242,1253234,+,5992
317,BUMA.1121.00087,1,1964013,1970002,-,5989
317,BUMA.1121.00043,1,2590646,2596637,+,5991
317,BUMA.1121.00046,1,3214747,3220737,+,5990
317,BUMA.1121.00037,1,1130927,1136918,+,5991
317,BUMA.1121.00080,1,2525586,2531577,+,5991
317,BUMA.1121.00079,1,2521374,2527365,+,5991
317,BUMA.1121.00045,1,1525788,1531778,-,5990
317,BUMA.1121.00071,1,2459537,2465528,+,5991
317,BUMA.1121.00056,1,1438345,1444336,-,5991
317,BUMA.1121.00065,1,2588683,2594674,+,5991
317,BUMA.1121.00058,1,2045561,2051552,-,5991
317,BUMA.1121.00007,1,1571784,1577775,-,5991
317,BUMA.1121.00067,1,1884415,1890406,-,5991
317,BUMA.1121.00090,1,604910,610901,+,5991
317,BUMA.1121.00051,1,2495354,2501345,+,5991
317,BUMA.1121.00020,1,2725333,2731323,+,5990
317,BUMA.1121.00103,1,1918820,1924812,-,5992
317,BUMA.1121.00048,1,1443416,1449405,+,5989
317,BUMA.1121.00047,1,420682,426673,-,5991
317,BUMA.1121.00042,1,2099200,2105208,+,6008
317,BUMA.1121.00055,1,2165167,2171158,+,5991
317,BUMA.1121.00031,1,3935973,3941964,+,5991
317,BUMA.1121.00040,1,2670455,2676445,+,5990
317,BUMA.1121.00044,1,1925975,1931965,+,5990
317,BUMA.1121.00088,1,3441900,3447891,+,5991
317,BUMA.1121.00069,1,2439984,2445975,+,5991
317,BUMA.1121.00064,1,2538374,2544365,+,5991
317,BUMA.1121.00105,1,2716831,2722822,-,5991
317,BUMA.1121.00015,1,1388256,1394245,-,5989
317,BUMA.1121.00059,1,1714600,1720591,+,5991
317,BUMA.1121.00026,1,2712396,2718385,-,5989
317,BUMA.1121.00022,1,3077352,3083342,+,5990
317,BUMA.1121.00052,1,2470321,2476311,+,5990
317,BUMA.1121.00101,1,3915263,3921255,-,5992
317,BUMA.1121.00001,1,1555781,1561772,-,5991
317,BUMA.1121.00038,1,1650904,1656893,+,5989
317,BUMA.1121.00068,1,1255562,1261554,+,5992
317,BUMA.1121.00099,1,3927190,3933183,-,5993
317,BUMA.1121.00091,1,1983909,1989900,-,5991
317,BUMA.1121.00098,1,1140921,1146912,+,5991
317,BUMA.1121.00013,1,2750628,2756618,+,5990
317,BUMA.1121.00049,1,3342936,3348929,-,5993
317,BUMA.1121.00072,1,2442499,2448490,+,5991
317,BUMA.1121.00076,1,2832084,2838075,-,5991
317,BUMA.1121.00083,1,3147041,3153032,-,5991
317,BUMA.1121.00078,1,3526776,3532768,-,5992
317,BUMA.1121.00095,1,3182761,3188752,-,5991
317,BUMA.1121.00077,1,1191978,1197970,+,5992
317,BUMA.1121.00063,1,2467526,2473517,+,5991
317,BUMA.1121.00061,1,2470603,2476594,+,5991
317,BUMA.1121.00050,1,3040454,3046443,-,5989
317,BUMA.1121.00081,1,1650967,1656956,+,5989
317,BUMA.1121.00074,1,1330003,1335994,-,5991
317,BUMA.1121.00062,1,2073270,2079261,-,5991
317,BUMA.1121.00060,1,3771035,3777025,-,5990
317,BUMA.1121.00070,1,2441632,2447623,+,5991
317,BUMA.1121.00075,1,1975999,1981990,+,5991
317,BUMA.1121.00041,1,3814095,3820088,+,5993
317,BUMA.1121.00073,1,2468738,2474729,+,5991
317,BUMA.1121.00017,1,2595510,2601500,+,5990
317,BUMA.1121.00066,1,2444243,2450234,+,5991
317,BUMA.1121.00107,1,2399071,2405063,+,5992
317,BUMA.1121.00085,1,2067267,2073257,+,5990
317,BUMA.1121.00030,1,2595541,2601531,+,5990
317,BUMA.1121.00112,1,455344,461334,-,5990
317,BUMA.1121.00002,1,257717,263707,+,5990
317,BUMA.1121.00082,1,2626329,2632320,+,5991
317,BUMA.1121.00014,1,274446,280437,-,5991
317,BUMA.1121.00011,1,3128045,3134038,-,5993
317,BUMA.1121.00019,1,2625396,2631386,+,5990
317,BUMA.1121.00057,1,3641559,3647550,+,5991
317,BUMA.1121.00018,1,3119507,3125498,+,5991
317,BUMA.1121.00039,1,2665120,2671111,+,5991
317,BUMA.1121.00016,1,630397,636388,+,5991
317,BUMA.1121.00004,1,2660370,2666360,+,5990
317,BUMA.1121.00005,1,1233179,1239171,+,5992
317,BUMA.1121.00100,1,2837600,2843580,-,5980
317,BUMA.1121.00006,1,1650887,1656876,+,5989
316,BUMA.1121.00027,1,636976,670097,+,33121
316,BUMA.1121.00025,1,140792,173977,-,33185
316,BUMA.1121.00021,1,3094238,3127420,+,33182
316,BUMA.1121.00023,1,814549,847752,+,33203
316,BUMA.1121.00024,1,2623860,2656924,+,33064
316,BUMA.1121.00033,1,671338,704496,+,33158
316,BUMA.1121.00034,1,2662606,2695664,+,33058
316,BUMA.1121.00036,1,1454363,1487409,-,33046
316,BUMA.1121.00032,1,692057,725181,+,33124
316,BUMA.1121.00009,1,3053469,3086759,-,33290
316,BUMA.1121.00008,1,2636871,2669935,+,33064
316,BUMA.1121.00003,1,984859,1018015,+,33156
316,BUMA.1121.00109,1,3385220,3418373,-,33153
316,BUMA.1121.00053,1,2205311,2238547,+,33236
316,BUMA.1121.00110,1,2291852,2324971,-,33119
316,BUMA.1121.00104,1,2717865,2751087,-,33222
316,BUMA.1121.00086,1,1311574,1344614,+,33040
316,BUMA.1121.00092,1,1295740,1329044,-,33304
316,BUMA.1121.00096,1,748873,781957,-,33084
316,BUMA.1121.00054,1,2494487,2527515,-,33028
316,BUMA.1121.00097,1,1416553,1449772,-,33219
316,BUMA.1121.00093,1,3297237,3330541,+,33304
316,BUMA.1121.00106,1,2238576,2271758,+,33182
316,BUMA.1121.00010,1,197180,230262,+,33082
316,BUMA.1121.00035,1,3645513,3678713,+,33200
316,BUMA.1121.00108,1,3488084,3521308,+,33224
316,BUMA.1121.00028,1,2625179,2658243,+,33064
316,BUMA.1121.00094,1,2478822,2511982,+,33160
316,BUMA.1121.00102,1,2816144,2849412,-,33268
316,BUMA.1121.00111,1,2651059,2684274,+,33215
316,BUMA.1121.00089,1,2448515,2481687,+,33172
316,BUMA.1121.00084,1,2862393,2895696,+,33303
316,BUMA.1121.00029,1,2445424,2478708,-,33284
316,BUMA.1121.00012,1,1213479,1246644,+,33165
316,BUMA.1121.00087,1,1972194,2005234,-,33040
316,BUMA.1121.00043,1,2556800,2590048,+,33248
316,BUMA.1121.00046,1,3179500,3212555,+,33055
316,BUMA.1121.00037,1,1097075,1130329,+,33254
316,BUMA.1121.00080,1,2491731,2524988,+,33257
316,BUMA.1121.00079,1,2487535,2520776,+,33241
316,BUMA.1121.00045,1,1532375,1565532,-,33157
316,BUMA.1121.00071,1,2425818,2458939,+,33121
316,BUMA.1121.00056,1,1444933,1478105,-,33172
316,BUMA.1121.00065,1,2555064,2588085,+,33021
316,BUMA.1121.00058,1,2052149,2085434,-,33285
316,BUMA.1121.00007,1,1578372,1611650,-,33278
316,BUMA.1121.00067,1,1891003,1924233,-,33230
316,BUMA.1121.00090,1,571106,604312,+,33206
316,BUMA.1121.00051,1,2461522,2494756,+,33234
316,BUMA.1121.00020,1,2690077,2723141,+,33064
316,BUMA.1121.00103,1,1925409,1958669,-,33260
316,BUMA.1121.00048,1,1408198,1441226,+,33028
316,BUMA.1121.00047,1,427270,460462,-,33192
316,BUMA.1121.00042,1,2063863,2097008,+,33145
316,BUMA.1121.00055,1,2131552,2164569,+,33017
316,BUMA.1121.00031,1,3902175,3935375,+,33200
316,BUMA.1121.00040,1,2635127,2668263,+,33136
316,BUMA.1121.00044,1,1890725,1923783,+,33058
316,BUMA.1121.00088,1,3408057,3441302,+,33245
316,BUMA.1121.00069,1,2406234,2439386,+,33152
316,BUMA.1121.00064,1,2504582,2537776,+,33194
316,BUMA.1121.00105,1,2723419,2756589,-,33170
316,BUMA.1121.00015,1,1396438,1429469,-,33031
316,BUMA.1121.00059,1,1680845,1714002,+,33157
316,BUMA.1121.00026,1,2720579,2753874,-,33295
316,BUMA.1121.00022,1,3042120,3075160,+,33040
316,BUMA.1121.00052,1,2435023,2468129,+,33106
316,BUMA.1121.00101,1,3921852,3955091,-,33239
316,BUMA.1121.00001,1,1562369,1595592,-,33223
316,BUMA.1121.00038,1,1615684,1648712,+,33028
316,BUMA.1121.00068,1,1221777,1254964,+,33187
316,BUMA.1121.00099,1,3933780,3966935,-,33155
316,BUMA.1121.00091,1,1990497,2023548,-,33051
316,BUMA.1121.00098,1,1107073,1140323,+,33250
316,BUMA.1121.00013,1,2715339,2748436,+,33097
316,BUMA.1121.00049,1,3349526,3382688,-,33162
316,BUMA.1121.00072,1,2408750,2441901,+,33151
316,BUMA.1121.00076,1,2838672,2871739,-,33067
316,BUMA.1121.00083,1,3153629,3186792,-,33163
316,BUMA.1121.00078,1,3533365,3566630,-,33265
316,BUMA.1121.00095,1,3189349,3222483,-,33134
316,BUMA.1121.00077,1,1158262,1191380,+,33118
316,BUMA.1121.00063,1,2433793,2466928,+,33135
316,BUMA.1121.00061,1,2436875,2470005,+,33130
316,BUMA.1121.00050,1,3048635,3081690,-,33055
316,BUMA.1121.00081,1,1615747,1648775,+,33028
316,BUMA.1121.00074,1,1336591,1369833,-,33242
316,BUMA.1121.00062,1,2079858,2113073,-,33215
316,BUMA.1121.00060,1,3777622,3810791,-,33169
316,BUMA.1121.00070,1,2407871,2441034,+,33163
316,BUMA.1121.00075,1,1942313,1975402,+,33089
316,BUMA.1121.00041,1,3780231,3813497,+,33266
316,BUMA.1121.00073,1,2434979,2468140,+,33161
316,BUMA.1121.00017,1,2560260,2593318,+,33058
316,BUMA.1121.00066,1,2410482,2443645,+,33163
316,BUMA.1121.00107,1,2365400,2398473,+,33073
316,BUMA.1121.00085,1,2031969,2065075,+,33106
316,BUMA.1121.00030,1,2560291,2593349,+,33058
316,BUMA.1121.00112,1,461931,495234,-,33303
316,BUMA.1121.00002,1,221200,254282,+,33082
316,BUMA.1121.00082,1,2592568,2625731,+,33163
316,BUMA.1121.00014,1,281034,314308,-,33274
316,BUMA.1121.00011,1,3134635,3167812,-,33177
316,BUMA.1121.00019,1,2590140,2623204,+,33064
316,BUMA.1121.00057,1,3607768,3640961,+,33193
316,BUMA.1121.00018,1,3085724,3118909,+,33185
316,BUMA.1121.00039,1,2631274,2664522,+,33248
316,BUMA.1121.00016,1,596524,629799,+,33275
316,BUMA.1121.00004,1,2625120,2658178,+,33058
316,BUMA.1121.00005,1,1199496,1232581,+,33085
316,BUMA.1121.00100,1,2844189,2877382,-,33193
316,BUMA.1121.00006,1,1615667,1648695,+,33028
315,BUMA.1121.00027,1,618781,636975,+,18194
315,BUMA.1121.00025,1,173979,192169,-,18190
315,BUMA.1121.00021,1,3076046,3094237,+,18191
315,BUMA.1121.00023,1,796357,814548,+,18191
315,BUMA.1121.00024,1,2605663,2623859,+,18196
315,BUMA.1121.00033,1,653148,671337,+,18189
315,BUMA.1121.00034,1,2644412,2662605,+,18193
315,BUMA.1121.00036,1,1487411,1505603,-,18192
315,BUMA.1121.00032,1,673863,692056,+,18193
315,BUMA.1121.00009,1,3086761,3104964,-,18203
315,BUMA.1121.00008,1,2618677,2636870,+,18193
315,BUMA.1121.00003,1,966666,984858,+,18192
315,BUMA.1121.00109,1,3418375,3436573,-,18198
315,BUMA.1121.00053,1,2187111,2205310,+,18199
315,BUMA.1121.00110,1,2324973,2343171,-,18198
315,BUMA.1121.00104,1,2751089,2769287,-,18198
315,BUMA.1121.00086,1,1293380,1311573,+,18193
315,BUMA.1121.00092,1,1329046,1347239,-,18193
315,BUMA.1121.00096,1,781959,800157,-,18198
315,BUMA.1121.00054,1,2527517,2545709,-,18192
315,BUMA.1121.00097,1,1449774,1467966,-,18192
315,BUMA.1121.00093,1,3279042,3297236,+,18194
315,BUMA.1121.00106,1,2220376,2238575,+,18199
315,BUMA.1121.00010,1,178971,197179,+,18208
315,BUMA.1121.00035,1,3627308,3645512,+,18204
315,BUMA.1121.00108,1,3469876,3488083,+,18207
315,BUMA.1121.00028,1,2606982,2625178,+,18196
315,BUMA.1121.00094,1,2460625,2478821,+,18196
315,BUMA.1121.00102,1,2849414,2867612,-,18198
315,BUMA.1121.00111,1,2632867,2651058,+,18191
315,BUMA.1121.00089,1,2430318,2448514,+,18196
315,BUMA.1121.00084,1,2844193,2862392,+,18199
315,BUMA.1121.00029,1,2478710,2496913,-,18203
315,BUMA.1121.00012,1,1195287,1213478,+,18191
315,BUMA.1121.00087,1,2005236,2023428,-,18192
315,BUMA.1121.00043,1,2538605,2556799,+,18194
315,BUMA.1121.00046,1,3161306,3179499,+,18193
315,BUMA.1121.00037,1,1078883,1097074,+,18191
315,BUMA.1121.00080,1,2473534,2491730,+,18196
315,BUMA.1121.00079,1,2469340,2487534,+,18194
315,BUMA.1121.00045,1,1565534,1583726,-,18192
315,BUMA.1121.00071,1,2407623,2425817,+,18194
315,BUMA.1121.00056,1,1478107,1496302,-,18195
315,BUMA.1121.00065,1,2536864,2555063,+,18199
315,BUMA.1121.00058,1,2085436,2103634,-,18198
315,BUMA.1121.00007,1,1611652,1629854,-,18202
315,BUMA.1121.00067,1,1924235,1942433,-,18198
315,BUMA.1121.00090,1,552914,571105,+,18191
315,BUMA.1121.00051,1,2443325,2461521,+,18196
315,BUMA.1121.00020,1,2671883,2690076,+,18193
315,BUMA.1121.00103,1,1958671,1976873,-,18202
315,BUMA.1121.00048,1,1390004,1408197,+,18193
315,BUMA.1121.00047,1,460464,478659,-,18195
315,BUMA.1121.00042,1,2045670,2063862,+,18192
315,BUMA.1121.00055,1,2113391,2131551,+,18160
315,BUMA.1121.00031,1,3883983,3902174,+,18191
315,BUMA.1121.00040,1,2616933,2635126,+,18193
315,BUMA.1121.00044,1,1872531,1890724,+,18193
315,BUMA.1121.00088,1,3389862,3408056,+,18194
315,BUMA.1121.00069,1,2388039,2406233,+,18194
315,BUMA.1121.00064,1,2486382,2504581,+,18199
315,BUMA.1121.00105,1,2756591,2774789,-,18198
315,BUMA.1121.00015,1,1429471,1447663,-,18192
315,BUMA.1121.00059,1,1662640,1680844,+,18204
315,BUMA.1121.00026,1,2753876,2772067,-,18191
315,BUMA.1121.00022,1,3023926,3042119,+,18193
315,BUMA.1121.00052,1,2416829,2435022,+,18193
315,BUMA.1121.00101,1,1,18136,-,18135
315,BUMA.1121.00001,1,1595594,1613797,-,18203
315,BUMA.1121.00038,1,1597490,1615683,+,18193
315,BUMA.1121.00068,1,1203582,1221776,+,18194
315,BUMA.1121.00099,1,3966937,3985130,-,18193
315,BUMA.1121.00091,1,2023550,2041740,-,18190
315,BUMA.1121.00098,1,1088881,1107072,+,18191
315,BUMA.1121.00013,1,2697145,2715338,+,18193
315,BUMA.1121.00049,1,3382690,3400888,-,18198
315,BUMA.1121.00072,1,2390555,2408749,+,18194
315,BUMA.1121.00076,1,2871741,2889941,-,18200
315,BUMA.1121.00083,1,3186794,3204987,-,18193
315,BUMA.1121.00078,1,3566632,3584822,-,18190
315,BUMA.1121.00095,1,3222485,3240681,-,18196
315,BUMA.1121.00077,1,1140062,1158261,+,18199
315,BUMA.1121.00063,1,2415598,2433792,+,18194
315,BUMA.1121.00061,1,2418680,2436874,+,18194
315,BUMA.1121.00050,1,3081692,3099884,-,18192
315,BUMA.1121.00081,1,1597553,1615746,+,18193
315,BUMA.1121.00074,1,1369835,1388033,-,18198
315,BUMA.1121.00062,1,2113075,2131268,-,18193
315,BUMA.1121.00060,1,3810793,3828985,-,18192
315,BUMA.1121.00070,1,2389676,2407870,+,18194
315,BUMA.1121.00075,1,1924111,1942312,+,18201
315,BUMA.1121.00041,1,3762036,3780230,+,18194
315,BUMA.1121.00073,1,2416784,2434978,+,18194
315,BUMA.1121.00017,1,2542066,2560259,+,18193
315,BUMA.1121.00066,1,2392288,2410481,+,18193
315,BUMA.1121.00107,1,2347196,2365399,+,18203
315,BUMA.1121.00085,1,2013775,2031968,+,18193
315,BUMA.1121.00030,1,2542097,2560290,+,18193
315,BUMA.1121.00112,1,495236,513437,-,18201
315,BUMA.1121.00002,1,202991,221199,+,18208
315,BUMA.1121.00082,1,2574373,2592567,+,18194
315,BUMA.1121.00014,1,314310,332500,-,18190
315,BUMA.1121.00011,1,3167814,3186012,-,18198
315,BUMA.1121.00019,1,2571946,2590139,+,18193
315,BUMA.1121.00057,1,3589573,3607767,+,18194
315,BUMA.1121.00018,1,3067532,3085723,+,18191
315,BUMA.1121.00039,1,2613082,2631273,+,18191
315,BUMA.1121.00016,1,578332,596523,+,18191
315,BUMA.1121.00004,1,2606926,2625119,+,18193
315,BUMA.1121.00005,1,1181299,1199495,+,18196
315,BUMA.1121.00100,1,2877384,2895577,-,18193
315,BUMA.1121.00006,1,1597473,1615666,+,18193
314,BUMA.1121.00027,1,611091,618780,+,7689
314,BUMA.1121.00025,1,192171,199826,-,7655
314,BUMA.1121.00021,1,3068418,3076045,+,7627
314,BUMA.1121.00023,1,788807,796356,+,7549
314,BUMA.1121.00024,1,2598058,2605662,+,7604
314,BUMA.1121.00033,1,645560,653147,+,7587
314,BUMA.1121.00034,1,2636807,2644411,+,7604
314,BUMA.1121.00036,1,1505605,1513208,-,7603
314,BUMA.1121.00032,1,666264,673862,+,7598
314,BUMA.1121.00009,1,3104966,3112567,-,7601
314,BUMA.1121.00008,1,2611072,2618676,+,7604
314,BUMA.1121.00003,1,959044,966665,+,7621
314,BUMA.1121.00109,1,3436575,3444261,-,7686
314,BUMA.1121.00053,1,2179494,2187110,+,7616
314,BUMA.1121.00110,1,2343173,2350807,-,7634
314,BUMA.1121.00104,1,2769289,2776958,-,7669
314,BUMA.1121.00086,1,1285775,1293379,+,7604
314,BUMA.1121.00092,1,1347241,1354806,-,7565
314,BUMA.1121.00096,1,800159,807799,-,7640
314,BUMA.1121.00054,1,2545711,2553308,-,7597
314,BUMA.1121.00097,1,1467968,1475581,-,7613
314,BUMA.1121.00093,1,3271475,3279041,+,7566
314,BUMA.1121.00106,1,2212744,2220375,+,7631
314,BUMA.1121.00010,1,170165,177717,+,7552
314,BUMA.1121.00035,1,3619634,3627307,+,7673
314,BUMA.1121.00108,1,3462298,3469875,+,7577
314,BUMA.1121.00028,1,2599377,2606981,+,7604
314,BUMA.1121.00094,1,2453015,2460624,+,7609
314,BUMA.1121.00102,1,2867614,2875229,-,7615
314,BUMA.1121.00111,1,2625256,2632866,+,7610
314,BUMA.1121.00089,1,2422721,2430317,+,7596
314,BUMA.1121.00084,1,2836522,2844192,+,7670
314,BUMA.1121.00029,1,2496915,2504605,-,7690
314,BUMA.1121.00012,1,1187637,1195286,+,7649
314,BUMA.1121.00087,1,2023430,2031033,-,7603
314,BUMA.1121.00043,1,2530957,2538603,+,7646
314,BUMA.1121.00046,1,3153713,3161305,+,7592
314,BUMA.1121.00037,1,1071335,1078882,+,7547
314,BUMA.1121.00080,1,2465967,2473533,+,7566
314,BUMA.1121.00079,1,2461755,2469339,+,7584
314,BUMA.1121.00045,1,1583728,1591364,-,7636
314,BUMA.1121.00071,1,2399961,2407622,+,7661
314,BUMA.1121.00056,1,1496304,1503899,-,7595
314,BUMA.1121.00065,1,2529222,2536863,+,7641
314,BUMA.1121.00058,1,2103636,2111288,-,7652
314,BUMA.1121.00007,1,1629856,1637424,-,7568
314,BUMA.1121.00067,1,1942435,1950092,-,7657
314,BUMA.1121.00090,1,545334,552913,+,7579
314,BUMA.1121.00051,1,2435728,2443324,+,7596
314,BUMA.1121.00020,1,2664278,2671882,+,7604
314,BUMA.1121.00103,1,1976875,1984547,-,7672
314,BUMA.1121.00048,1,1382405,1390003,+,7598
314,BUMA.1121.00047,1,478661,486274,-,7613
314,BUMA.1121.00042,1,2038047,2045669,+,7622
314,BUMA.1121.00055,1,2105745,2113390,+,7645
314,BUMA.1121.00031,1,3876391,3883982,+,7591
314,BUMA.1121.00040,1,2609329,2616932,+,7603
314,BUMA.1121.00044,1,1864920,1872530,+,7610
314,BUMA.1121.00088,1,3382197,3389861,+,7664
314,BUMA.1121.00069,1,2380390,2388038,+,7648
314,BUMA.1121.00064,1,2478714,2486381,+,7667
314,BUMA.1121.00105,1,2774791,2782455,-,7664
314,BUMA.1121.00015,1,1447665,1455280,-,7615
314,BUMA.1121.00059,1,1655008,1662639,+,7631
314,BUMA.1121.00026,1,2772069,2779660,-,7591
314,BUMA.1121.00022,1,3016315,3023925,+,7610
314,BUMA.1121.00052,1,2409218,2416828,+,7610
314,BUMA.1121.00101,1,18138,25741,-,7603
314,BUMA.1121.00001,1,1613799,1621471,-,7672
314,BUMA.1121.00038,1,1589891,1597489,+,7598
314,BUMA.1121.00068,1,1195906,1203581,+,7675
314,BUMA.1121.00099,1,3985132,3992750,-,7618
314,BUMA.1121.00091,1,2041742,2049409,-,7667
314,BUMA.1121.00098,1,1081247,1088880,+,7633
314,BUMA.1121.00013,1,2689522,2697144,+,7622
314,BUMA.1121.00049,1,3400890,3408586,-,7696
314,BUMA.1121.00072,1,2382893,2390554,+,7661
314,BUMA.1121.00076,1,2889943,2897585,-,7642
314,BUMA.1121.00083,1,3204989,3212649,-,7660
314,BUMA.1121.00078,1,3584824,3592409,-,7585
314,BUMA.1121.00095,1,3240683,3248366,-,7683
314,BUMA.1121.00077,1,1132427,1140061,+,7634
314,BUMA.1121.00063,1,2407936,2415597,+,7661
314,BUMA.1121.00061,1,2411034,2418679,+,7645
314,BUMA.1121.00050,1,3099886,3107477,-,7591
314,BUMA.1121.00081,1,1589954,1597552,+,7598
314,BUMA.1121.00074,1,1388035,1395653,-,7618
314,BUMA.1121.00062,1,2131270,2138930,-,7660
314,BUMA.1121.00060,1,3828987,3836623,-,7636
314,BUMA.1121.00070,1,2382041,2389675,+,7634
314,BUMA.1121.00075,1,1916467,1924110,+,7643
314,BUMA.1121.00041,1,3754413,3762035,+,7622
314,BUMA.1121.00073,1,2409137,2416783,+,7646
314,BUMA.1121.00017,1,2534461,2542065,+,7604
314,BUMA.1121.00066,1,2384626,2392287,+,7661
314,BUMA.1121.00107,1,2339583,2347195,+,7612
314,BUMA.1121.00085,1,2006164,2013774,+,7610
314,BUMA.1121.00030,1,2534486,2542096,+,7610
314,BUMA.1121.00112,1,513439,521080,-,7641
314,BUMA.1121.00002,1,194184,201736,+,7552
314,BUMA.1121.00082,1,2566711,2574372,+,7661
314,BUMA.1121.00014,1,332502,340100,-,7598
314,BUMA.1121.00011,1,3186014,3193578,-,7564
314,BUMA.1121.00019,1,2564341,2571945,+,7604
314,BUMA.1121.00057,1,3581895,3589572,+,7677
314,BUMA.1121.00018,1,3059881,3067531,+,7650
314,BUMA.1121.00039,1,2605463,2613081,+,7618
314,BUMA.1121.00016,1,570662,578331,+,7669
314,BUMA.1121.00004,1,2599321,2606925,+,7604
314,BUMA.1121.00005,1,1173592,1181298,+,7706
314,BUMA.1121.00100,1,2895579,2903173,-,7594
314,BUMA.1121.00006,1,1589874,1597472,+,7598
313,BUMA.1121.00027,1,606204,611090,+,4886
313,BUMA.1121.00025,1,199828,204707,-,4879
313,BUMA.1121.00021,1,3063523,3068417,+,4894
313,BUMA.1121.00023,1,783920,788806,+,4886
313,BUMA.1121.00024,1,2593172,2598057,+,4885
313,BUMA.1121.00033,1,639077,643956,+,4879
313,BUMA.1121.00034,1,2631921,2636806,+,4885
313,BUMA.1121.00036,1,1513210,1518095,-,4885
313,BUMA.1121.00032,1,661378,666263,+,4885
313,BUMA.1121.00009,1,3112569,3117441,-,4872
313,BUMA.1121.00008,1,2606186,2611071,+,4885
313,BUMA.1121.00003,1,954134,959043,+,4909
313,BUMA.1121.00109,1,3444263,3449150,-,4887
313,BUMA.1121.00053,1,2174621,2179493,+,4872
313,BUMA.1121.00110,1,2350809,2355724,-,4915
313,BUMA.1121.00104,1,2776960,2781853,-,4893
313,BUMA.1121.00086,1,1280889,1285774,+,4885
313,BUMA.1121.00092,1,1354808,1359694,-,4886
313,BUMA.1121.00096,1,807801,812686,-,4885
313,BUMA.1121.00054,1,2553310,2558195,-,4885
313,BUMA.1121.00097,1,1475583,1480470,-,4887
313,BUMA.1121.00093,1,3266588,3271474,+,4886
313,BUMA.1121.00106,1,2207850,2212743,+,4893
313,BUMA.1121.00010,1,165279,170164,+,4885
313,BUMA.1121.00035,1,3614747,3619633,+,4886
313,BUMA.1121.00108,1,3457410,3462297,+,4887
313,BUMA.1121.00028,1,2594491,2599376,+,4885
313,BUMA.1121.00094,1,2448143,2453014,+,4871
313,BUMA.1121.00102,1,2875231,2880103,-,4872
313,BUMA.1121.00111,1,2620361,2625255,+,4894
313,BUMA.1121.00089,1,2417827,2422720,+,4893
313,BUMA.1121.00084,1,2831628,2836521,+,4893
313,BUMA.1121.00029,1,2504607,2509486,-,4879
313,BUMA.1121.00012,1,1182709,1187636,+,4927
313,BUMA.1121.00087,1,2031035,2035920,-,4885
313,BUMA.1121.00043,1,2526066,2530956,+,4890
313,BUMA.1121.00046,1,3148827,3153712,+,4885
313,BUMA.1121.00037,1,1066407,1071334,+,4927
313,BUMA.1121.00080,1,2461095,2465966,+,4871
313,BUMA.1121.00079,1,2456883,2461754,+,4871
313,BUMA.1121.00045,1,1591366,1596274,-,4908
313,BUMA.1121.00071,1,2395064,2399960,+,4896
313,BUMA.1121.00056,1,1503901,1508794,-,4893
313,BUMA.1121.00065,1,2524349,2529221,+,4872
313,BUMA.1121.00058,1,2111290,2116183,-,4893
313,BUMA.1121.00007,1,1637426,1642313,-,4887
313,BUMA.1121.00067,1,1950094,1954987,-,4893
313,BUMA.1121.00090,1,540417,545333,+,4916
313,BUMA.1121.00051,1,2430856,2435727,+,4871
313,BUMA.1121.00020,1,2659392,2664277,+,4885
313,BUMA.1121.00103,1,1984549,1989466,-,4917
313,BUMA.1121.00048,1,1377519,1382404,+,4885
313,BUMA.1121.00047,1,486276,491147,-,4871
313,BUMA.1121.00042,1,2033161,2038046,+,4885
313,BUMA.1121.00055,1,2100878,2105743,+,4865
313,BUMA.1121.00031,1,3871504,3876390,+,4886
313,BUMA.1121.00040,1,2604443,2609328,+,4885
313,BUMA.1121.00044,1,1860034,1864919,+,4885
313,BUMA.1121.00088,1,3377303,3382196,+,4893
313,BUMA.1121.00069,1,2375488,2380389,+,4901
313,BUMA.1121.00064,1,2473820,2478713,+,4893
313,BUMA.1121.00105,1,2782457,2787328,-,4871
313,BUMA.1121.00015,1,1455282,1460167,-,4885
313,BUMA.1121.00059,1,1650114,1655007,+,4893
313,BUMA.1121.00026,1,2779662,2784547,-,4885
313,BUMA.1121.00022,1,3011429,3016314,+,4885
313,BUMA.1121.00052,1,2404332,2409217,+,4885
313,BUMA.1121.00101,1,25743,30637,-,4894
313,BUMA.1121.00001,1,1621473,1626359,-,4886
313,BUMA.1121.00038,1,1585005,1589890,+,4885
313,BUMA.1121.00068,1,1191060,1195905,+,4845
313,BUMA.1121.00099,1,3992752,3997653,-,4901
313,BUMA.1121.00091,1,2049411,2054327,-,4916
313,BUMA.1121.00098,1,1076352,1081246,+,4894
313,BUMA.1121.00013,1,2684636,2689521,+,4885
313,BUMA.1121.00049,1,3408588,3413481,-,4893
313,BUMA.1121.00072,1,2377996,2382892,+,4896
313,BUMA.1121.00076,1,2897587,2902474,-,4887
313,BUMA.1121.00083,1,3212651,3217552,-,4901
313,BUMA.1121.00078,1,3592411,3597283,-,4872
313,BUMA.1121.00095,1,3248368,3253255,-,4887
313,BUMA.1121.00077,1,1127511,1132426,+,4915
313,BUMA.1121.00063,1,2403038,2407935,+,4897
313,BUMA.1121.00061,1,2406137,2411033,+,4896
313,BUMA.1121.00050,1,3107479,3112364,-,4885
313,BUMA.1121.00081,1,1585068,1589953,+,4885
313,BUMA.1121.00074,1,1395655,1400548,-,4893
313,BUMA.1121.00062,1,2138932,2143803,-,4871
313,BUMA.1121.00060,1,3836625,3841533,-,4908
313,BUMA.1121.00070,1,2377145,2382040,+,4895
313,BUMA.1121.00075,1,1911579,1916466,+,4887
313,BUMA.1121.00041,1,3749498,3754412,+,4914
313,BUMA.1121.00073,1,2404240,2409136,+,4896
313,BUMA.1121.00017,1,2529575,2534460,+,4885
313,BUMA.1121.00066,1,2379730,2384625,+,4895
313,BUMA.1121.00107,1,2334688,2339582,+,4894
313,BUMA.1121.00085,1,2001278,2006163,+,4885
313,BUMA.1121.00030,1,2529600,2534485,+,4885
313,BUMA.1121.00112,1,521082,525975,-,4893
313,BUMA.1121.00002,1,189298,194183,+,4885
313,BUMA.1121.00082,1,2561809,2566710,+,4901
313,BUMA.1121.00014,1,340102,344989,-,4887
313,BUMA.1121.00011,1,3193580,3198481,-,4901
313,BUMA.1121.00019,1,2559455,2564340,+,4885
313,BUMA.1121.00057,1,3577008,3581894,+,4886
313,BUMA.1121.00018,1,3055001,3059880,+,4879
313,BUMA.1121.00039,1,2598991,2603859,+,4868
313,BUMA.1121.00016,1,565756,570661,+,4905
313,BUMA.1121.00004,1,2594435,2599320,+,4885
313,BUMA.1121.00005,1,1168712,1173591,+,4879
313,BUMA.1121.00100,1,2903175,2908083,-,4908
313,BUMA.1121.00006,1,1584988,1589873,+,4885
312,BUMA.1121.00027,1,599805,605022,+,5217
312,BUMA.1121.00025,1,206184,211401,-,5217
312,BUMA.1121.00021,1,3056830,3062047,+,5217
312,BUMA.1121.00023,1,777226,782443,+,5217
312,BUMA.1121.00024,1,2586478,2591696,+,5218
312,BUMA.1121.00033,1,632383,637601,+,5218
312,BUMA.1121.00034,1,2625227,2630445,+,5218
312,BUMA.1121.00036,1,1519571,1524789,-,5218
312,BUMA.1121.00032,1,654684,659902,+,5218
312,BUMA.1121.00009,1,3118918,3124136,-,5218
312,BUMA.1121.00008,1,2599492,2604710,+,5218
312,BUMA.1121.00003,1,948920,954132,+,5212
312,BUMA.1121.00109,1,3450627,3455839,-,5212
312,BUMA.1121.00053,1,2167927,2173145,+,5218
312,BUMA.1121.00110,1,2357201,2362420,-,5219
312,BUMA.1121.00104,1,2783330,2788546,-,5216
312,BUMA.1121.00086,1,1274195,1279413,+,5218
312,BUMA.1121.00092,1,1361171,1366387,-,5216
312,BUMA.1121.00096,1,814163,819381,-,5218
312,BUMA.1121.00054,1,2559671,2564889,-,5218
312,BUMA.1121.00097,1,1481947,1487165,-,5218
312,BUMA.1121.00093,1,3259895,3265111,+,5216
312,BUMA.1121.00106,1,2201157,2206373,+,5216
312,BUMA.1121.00010,1,158585,163803,+,5218
312,BUMA.1121.00035,1,3608053,3613270,+,5217
312,BUMA.1121.00108,1,3450715,3455933,+,5218
312,BUMA.1121.00028,1,2587797,2593015,+,5218
312,BUMA.1121.00094,1,2441449,2446666,+,5217
312,BUMA.1121.00102,1,2881468,2886685,-,5217
312,BUMA.1121.00111,1,2613666,2618884,+,5218
312,BUMA.1121.00089,1,2411134,2416350,+,5216
312,BUMA.1121.00084,1,2824935,2830151,+,5216
312,BUMA.1121.00029,1,2510963,2516181,-,5218
312,BUMA.1121.00012,1,1176014,1181232,+,5218
312,BUMA.1121.00087,1,2037396,2042614,-,5218
312,BUMA.1121.00043,1,2519371,2524589,+,5218
312,BUMA.1121.00046,1,3142133,3147351,+,5218
312,BUMA.1121.00037,1,1059708,1064925,+,5217
312,BUMA.1121.00080,1,2454401,2459618,+,5217
312,BUMA.1121.00079,1,2450191,2455406,+,5215
312,BUMA.1121.00045,1,1597751,1602968,-,5217
312,BUMA.1121.00071,1,2388665,2393882,+,5217
312,BUMA.1121.00056,1,1510271,1515487,-,5216
312,BUMA.1121.00065,1,2517655,2522872,+,5217
312,BUMA.1121.00058,1,2117660,2122877,-,5217
312,BUMA.1121.00007,1,1643790,1649015,-,5225
312,BUMA.1121.00067,1,1956464,1961681,-,5217
312,BUMA.1121.00090,1,533723,538941,+,5218
312,BUMA.1121.00051,1,2424163,2429379,+,5216
312,BUMA.1121.00020,1,2652698,2657916,+,5218
312,BUMA.1121.00103,1,1990943,1996160,-,5217
312,BUMA.1121.00048,1,1370825,1376043,+,5218
312,BUMA.1121.00047,1,492624,497841,-,5217
312,BUMA.1121.00042,1,2026473,2031685,+,5212
312,BUMA.1121.00055,1,2094184,2099401,+,5217
312,BUMA.1121.00031,1,3864805,3870022,+,5217
312,BUMA.1121.00040,1,2597749,2602967,+,5218
312,BUMA.1121.00044,1,1853340,1858558,+,5218
312,BUMA.1121.00088,1,3370610,3375826,+,5216
312,BUMA.1121.00069,1,2369088,2374305,+,5217
312,BUMA.1121.00064,1,2467420,2472637,+,5217
312,BUMA.1121.00105,1,2788805,2794023,-,5218
312,BUMA.1121.00015,1,1461643,1466861,-,5218
312,BUMA.1121.00059,1,1643421,1648637,+,5216
312,BUMA.1121.00026,1,2786023,2791235,-,5212
312,BUMA.1121.00022,1,3004735,3009953,+,5218
312,BUMA.1121.00052,1,2397638,2402856,+,5218
312,BUMA.1121.00101,1,32114,37332,-,5218
312,BUMA.1121.00001,1,1627836,1633053,-,5217
312,BUMA.1121.00038,1,1578311,1583529,+,5218
312,BUMA.1121.00068,1,1184366,1189583,+,5217
312,BUMA.1121.00099,1,3999130,4004348,-,5218
312,BUMA.1121.00091,1,2055804,2060950,-,5146
312,BUMA.1121.00098,1,1069658,1074875,+,5217
312,BUMA.1121.00013,1,2677942,2683160,+,5218
312,BUMA.1121.00049,1,3414958,3420174,-,5216
312,BUMA.1121.00072,1,2371597,2376814,+,5217
312,BUMA.1121.00076,1,2903951,2909167,-,5216
312,BUMA.1121.00083,1,3218735,3223952,-,5217
312,BUMA.1121.00078,1,3598760,3603975,-,5215
312,BUMA.1121.00095,1,3254732,3259949,-,5217
312,BUMA.1121.00077,1,1120816,1126034,+,5218
312,BUMA.1121.00063,1,2396639,2401856,+,5217
312,BUMA.1121.00061,1,2399737,2404954,+,5217
312,BUMA.1121.00050,1,3113840,3119058,-,5218
312,BUMA.1121.00081,1,1578374,1583592,+,5218
312,BUMA.1121.00074,1,1401731,1406948,-,5217
312,BUMA.1121.00062,1,2145280,2150498,-,5218
312,BUMA.1121.00060,1,3843010,3848227,-,5217
312,BUMA.1121.00070,1,2370745,2375962,+,5217
312,BUMA.1121.00075,1,1904886,1910102,+,5216
312,BUMA.1121.00041,1,3742804,3748021,+,5217
312,BUMA.1121.00073,1,2397841,2403058,+,5217
312,BUMA.1121.00017,1,2522881,2528099,+,5218
312,BUMA.1121.00066,1,2373330,2378547,+,5217
312,BUMA.1121.00107,1,2327994,2333211,+,5217
312,BUMA.1121.00085,1,1994584,1999802,+,5218
312,BUMA.1121.00030,1,2522906,2528124,+,5218
312,BUMA.1121.00112,1,527452,532668,-,5216
312,BUMA.1121.00002,1,182604,187822,+,5218
312,BUMA.1121.00082,1,2555409,2560626,+,5217
312,BUMA.1121.00014,1,346471,351688,-,5217
312,BUMA.1121.00011,1,3199958,3205165,-,5207
312,BUMA.1121.00019,1,2552761,2557979,+,5218
312,BUMA.1121.00057,1,3570609,3575826,+,5217
312,BUMA.1121.00018,1,3048307,3053524,+,5217
312,BUMA.1121.00039,1,2592298,2597515,+,5217
312,BUMA.1121.00016,1,559061,564279,+,5218
312,BUMA.1121.00004,1,2587741,2592959,+,5218
312,BUMA.1121.00005,1,1162020,1167238,+,5218
312,BUMA.1121.00100,1,2909560,2914778,-,5218
312,BUMA.1121.00006,1,1578294,1583512,+,5218
311,BUMA.1121.00027,1,588298,598170,+,9872
311,BUMA.1121.00025,1,220054,229872,-,9818
311,BUMA.1121.00021,1,3039674,3049511,+,9837
311,BUMA.1121.00023,1,749343,759178,+,9835
311,BUMA.1121.00024,1,2573685,2584842,+,11157
311,BUMA.1121.00033,1,614684,624516,+,9832
311,BUMA.1121.00034,1,2612434,2623591,+,11157
311,BUMA.1121.00036,1,1526424,1537582,-,11158
311,BUMA.1121.00032,1,641891,653048,+,11157
311,BUMA.1121.00009,1,3125770,3135614,-,9844
311,BUMA.1121.00008,1,2586699,2597856,+,11157
311,BUMA.1121.00003,1,937452,947281,+,9829
311,BUMA.1121.00109,1,3457475,3467339,-,9864
311,BUMA.1121.00053,1,2141222,2151110,+,9888
311,BUMA.1121.00110,1,2369355,2379232,-,9877
311,BUMA.1121.00104,1,2799938,2809812,-,9874
311,BUMA.1121.00086,1,1261402,1272559,+,11157
311,BUMA.1121.00092,1,1373326,1383209,-,9883
311,BUMA.1121.00096,1,821014,830900,-,9886
311,BUMA.1121.00054,1,2566524,2577682,-,11158
311,BUMA.1121.00097,1,1488800,1498672,-,9872
311,BUMA.1121.00093,1,3243073,3252955,+,9882
311,BUMA.1121.00106,1,2178696,2188560,+,9864
311,BUMA.1121.00010,1,145794,156949,+,11155
311,BUMA.1121.00035,1,3555551,3565386,+,9835
311,BUMA.1121.00108,1,3439224,3449085,+,9861
311,BUMA.1121.00028,1,2575004,2586161,+,11157
311,BUMA.1121.00094,1,2420191,2430055,+,9864
311,BUMA.1121.00102,1,2893619,2903519,-,9900
311,BUMA.1121.00111,1,2592462,2602298,+,9836
311,BUMA.1121.00089,1,2389876,2399740,+,9864
311,BUMA.1121.00084,1,2803650,2813541,+,9891
311,BUMA.1121.00029,1,2523118,2532954,-,9836
311,BUMA.1121.00012,1,1154701,1164518,+,9817
311,BUMA.1121.00087,1,2044249,2055407,-,11158
311,BUMA.1121.00043,1,2498588,2509738,+,11150
311,BUMA.1121.00046,1,3129340,3140497,+,11157
311,BUMA.1121.00037,1,1042554,1052389,+,9835
311,BUMA.1121.00080,1,2433134,2443007,+,9873
311,BUMA.1121.00079,1,2428934,2438798,+,9864
311,BUMA.1121.00045,1,1614361,1624226,-,9865
311,BUMA.1121.00071,1,2377151,2387030,+,9879
311,BUMA.1121.00056,1,1526880,1536745,-,9865
311,BUMA.1121.00065,1,2506146,2516019,+,9873
311,BUMA.1121.00058,1,2129816,2139690,-,9874
311,BUMA.1121.00007,1,1660409,1670265,-,9856
311,BUMA.1121.00067,1,1973065,1982930,-,9865
311,BUMA.1121.00090,1,516949,526784,+,9835
311,BUMA.1121.00051,1,2402905,2412769,+,9864
311,BUMA.1121.00020,1,2639905,2651062,+,11157
311,BUMA.1121.00103,1,1997796,2007642,-,9846
311,BUMA.1121.00048,1,1358032,1369189,+,11157
311,BUMA.1121.00047,1,509234,519099,-,9865
311,BUMA.1121.00042,1,2013680,2024837,+,11157
311,BUMA.1121.00055,1,2082710,2092547,+,9837
311,BUMA.1121.00031,1,3837715,3847550,+,9835
311,BUMA.1121.00040,1,2584956,2596113,+,11157
311,BUMA.1121.00044,1,1840547,1851704,+,11157
311,BUMA.1121.00088,1,3349325,3359216,+,9891
311,BUMA.1121.00069,1,2357579,2367453,+,9874
311,BUMA.1121.00064,1,2446171,2456035,+,9864
311,BUMA.1121.00105,1,2795656,2805542,-,9886
311,BUMA.1121.00015,1,1468496,1479654,-,11158
311,BUMA.1121.00059,1,1622137,1632032,+,9895
311,BUMA.1121.00026,1,2792870,2804028,-,11158
311,BUMA.1121.00022,1,2991942,3003099,+,11157
311,BUMA.1121.00052,1,2384845,2396002,+,11157
311,BUMA.1121.00101,1,44269,54132,-,9863
311,BUMA.1121.00001,1,1641323,1651159,-,9836
311,BUMA.1121.00038,1,1565518,1576675,+,11157
311,BUMA.1121.00068,1,1172830,1182736,+,9906
311,BUMA.1121.00099,1,4005983,4015811,-,9828
311,BUMA.1121.00091,1,2074933,2084807,-,9874
311,BUMA.1121.00098,1,1058122,1068022,+,9900
311,BUMA.1121.00013,1,2665149,2676306,+,11157
311,BUMA.1121.00049,1,3433874,3443757,-,9883
311,BUMA.1121.00072,1,2360085,2369962,+,9877
311,BUMA.1121.00076,1,2920551,2930434,-,9883
311,BUMA.1121.00083,1,3225586,3235469,-,9883
311,BUMA.1121.00078,1,3610913,3620758,-,9845
311,BUMA.1121.00095,1,3266882,3276741,-,9859
311,BUMA.1121.00077,1,1104004,1113881,+,9877
311,BUMA.1121.00063,1,2385131,2395010,+,9879
311,BUMA.1121.00061,1,2388220,2398108,+,9888
311,BUMA.1121.00050,1,3120693,3131851,-,11158
311,BUMA.1121.00081,1,1565581,1576738,+,11157
311,BUMA.1121.00074,1,1418332,1428197,-,9865
311,BUMA.1121.00062,1,2152131,2162008,-,9877
311,BUMA.1121.00060,1,3859620,3869485,-,9865
311,BUMA.1121.00070,1,2359228,2369116,+,9888
311,BUMA.1121.00075,1,1883620,1893501,+,9881
311,BUMA.1121.00041,1,3726018,3735864,+,9846
311,BUMA.1121.00073,1,2386324,2396212,+,9888
311,BUMA.1121.00017,1,2510088,2521245,+,11157
311,BUMA.1121.00066,1,2361816,2371695,+,9879
311,BUMA.1121.00107,1,2306754,2316600,+,9846
311,BUMA.1121.00085,1,1981791,1992948,+,11157
311,BUMA.1121.00030,1,2510113,2521270,+,11157
311,BUMA.1121.00112,1,544061,553926,-,9865
311,BUMA.1121.00002,1,169811,180968,+,11157
311,BUMA.1121.00082,1,2543892,2553774,+,9882
311,BUMA.1121.00014,1,369717,379553,-,9836
311,BUMA.1121.00011,1,3216555,3226422,-,9867
311,BUMA.1121.00019,1,2539968,2551125,+,11157
311,BUMA.1121.00057,1,3559101,3568974,+,9873
311,BUMA.1121.00018,1,3029837,3039653,+,9816
311,BUMA.1121.00039,1,2537028,2546863,+,9835
311,BUMA.1121.00016,1,542305,552122,+,9817
311,BUMA.1121.00004,1,2574948,2586105,+,11157
311,BUMA.1121.00005,1,1145244,1155087,+,9843
311,BUMA.1121.00100,1,2916414,2926290,-,9876
311,BUMA.1121.00006,1,1565501,1576658,+,11157
310,BUMA.1121.00027,1,579709,583527,+,3818
310,BUMA.1121.00025,1,234664,238536,-,3872
310,BUMA.1121.00021,1,3031028,3034883,+,3855
310,BUMA.1121.00023,1,740677,744563,+,3886
310,BUMA.1121.00033,1,605962,609883,+,3921
310,BUMA.1121.00009,1,3140361,3144224,-,3863
310,BUMA.1121.00003,1,928845,932681,+,3836
310,BUMA.1121.00109,1,3472076,3475915,-,3839
310,BUMA.1121.00053,1,2132606,2136449,+,3843
310,BUMA.1121.00110,1,2383969,2387774,-,3805
310,BUMA.1121.00104,1,2814592,2819715,-,5123
310,BUMA.1121.00092,1,1388000,1391819,-,3819
310,BUMA.1121.00096,1,835668,839486,-,3818
310,BUMA.1121.00097,1,1503465,1507287,-,3822
310,BUMA.1121.00093,1,3234462,3238282,+,3820
310,BUMA.1121.00106,1,2170076,2173916,+,3840
310,BUMA.1121.00035,1,3546905,3550760,+,3855
310,BUMA.1121.00108,1,3430688,3434487,+,3799
310,BUMA.1121.00094,1,2411607,2415418,+,3811
310,BUMA.1121.00102,1,2908300,2912142,-,3842
310,BUMA.1121.00111,1,2583827,2587682,+,3855
310,BUMA.1121.00089,1,2381292,2385103,+,3811
310,BUMA.1121.00084,1,2795064,2798877,+,3813
310,BUMA.1121.00029,1,2537766,2541596,-,3830
310,BUMA.1121.00012,1,1146051,1149911,+,3860
310,BUMA.1121.00043,1,2489951,2493808,+,3857
310,BUMA.1121.00037,1,1033907,1037785,+,3878
310,BUMA.1121.00080,1,2424549,2428361,+,3812
310,BUMA.1121.00079,1,2420339,2424161,+,3822
310,BUMA.1121.00045,1,1628986,1632834,-,3848
310,BUMA.1121.00071,1,2368557,2372379,+,3822
310,BUMA.1121.00056,1,1541518,1545328,-,3810
310,BUMA.1121.00065,1,2497525,2501365,+,3840
310,BUMA.1121.00058,1,2144472,2148281,-,3809
310,BUMA.1121.00007,1,1675028,1678911,-,3883
310,BUMA.1121.00067,1,1987711,1991560,-,3849
310,BUMA.1121.00090,1,508313,512180,+,3867
310,BUMA.1121.00051,1,2394328,2398132,+,3804
310,BUMA.1121.00103,1,2012380,2016226,-,3846
310,BUMA.1121.00047,1,523872,527682,-,3810
310,BUMA.1121.00055,1,2074130,2077913,+,3783
310,BUMA.1121.00031,1,3829027,3832942,+,3915
310,BUMA.1121.00088,1,3340751,3344552,+,3801
310,BUMA.1121.00069,1,2348986,2352805,+,3819
310,BUMA.1121.00064,1,2437569,2441401,+,3832
310,BUMA.1121.00105,1,2810327,2814211,-,3884
310,BUMA.1121.00059,1,1613553,1617364,+,3811
310,BUMA.1121.00101,1,58915,62770,-,3855
310,BUMA.1121.00001,1,1655972,1659838,-,3866
310,BUMA.1121.00068,1,1164182,1168064,+,3882
310,BUMA.1121.00099,1,4020580,4024421,-,3841
310,BUMA.1121.00091,1,2089581,2093418,-,3837
310,BUMA.1121.00098,1,1049488,1053353,+,3865
310,BUMA.1121.00049,1,3448537,3453683,-,5146
310,BUMA.1121.00072,1,2351479,2355311,+,3832
310,BUMA.1121.00076,1,2935214,2939006,-,3792
310,BUMA.1121.00083,1,3240243,3244075,-,3832
310,BUMA.1121.00078,1,3627125,3630922,-,3797
310,BUMA.1121.00095,1,3281521,3285314,-,3793
310,BUMA.1121.00077,1,1095461,1099267,+,3806
310,BUMA.1121.00063,1,2376542,2380357,+,3815
310,BUMA.1121.00061,1,2379616,2383446,+,3830
310,BUMA.1121.00074,1,1432978,1436791,-,3813
310,BUMA.1121.00062,1,2168370,2172203,-,3833
310,BUMA.1121.00060,1,3874245,3878087,-,3842
310,BUMA.1121.00070,1,2350622,2354454,+,3832
310,BUMA.1121.00075,1,1875051,1878841,+,3790
310,BUMA.1121.00041,1,3716001,3719752,+,3751
310,BUMA.1121.00073,1,2377718,2381550,+,3832
310,BUMA.1121.00066,1,2353215,2357045,+,3830
310,BUMA.1121.00107,1,2298117,2301940,+,3823
310,BUMA.1121.00112,1,558708,562517,-,3809
310,BUMA.1121.00082,1,2535285,2539118,+,3833
310,BUMA.1121.00014,1,384326,388216,-,3890
310,BUMA.1121.00011,1,3231158,3234974,-,3816
310,BUMA.1121.00057,1,3550500,3554327,+,3827
310,BUMA.1121.00018,1,3021167,3025046,+,3879
310,BUMA.1121.00039,1,2528381,2532248,+,3867
310,BUMA.1121.00016,1,533640,537459,+,3819
310,BUMA.1121.00005,1,1136688,1140426,+,3738
310,BUMA.1121.00100,1,2931083,2934943,-,3860
309,BUMA.1121.00027,1,567600,572156,+,4556
309,BUMA.1121.00025,1,246090,250660,-,4570
309,BUMA.1121.00021,1,3018904,3023475,+,4571
309,BUMA.1121.00023,1,728553,733125,+,4572
309,BUMA.1121.00024,1,2558311,2562883,+,4572
309,BUMA.1121.00033,1,593842,598413,+,4571
309,BUMA.1121.00034,1,2597060,2601632,+,4572
309,BUMA.1121.00036,1,1548373,1552945,-,4572
309,BUMA.1121.00032,1,626517,631089,+,4572
309,BUMA.1121.00009,1,3151779,3156296,-,4517
309,BUMA.1121.00008,1,2571325,2575897,+,4572
309,BUMA.1121.00003,1,916733,921303,+,4570
309,BUMA.1121.00109,1,3483468,3488030,-,4562
309,BUMA.1121.00053,1,2120485,2125054,+,4569
309,BUMA.1121.00110,1,2395325,2399895,-,4570
309,BUMA.1121.00104,1,2827265,2831835,-,4570
309,BUMA.1121.00086,1,1246039,1250611,+,4572
309,BUMA.1121.00092,1,1399373,1403936,-,4563
309,BUMA.1121.00096,1,847024,851595,-,4571
309,BUMA.1121.00054,1,2590079,2594651,-,4572
309,BUMA.1121.00097,1,1514841,1519410,-,4569
309,BUMA.1121.00093,1,3222346,3226909,+,4563
309,BUMA.1121.00106,1,2157955,2162524,+,4569
309,BUMA.1121.00010,1,130437,135009,+,4572
309,BUMA.1121.00035,1,3534783,3539353,+,4570
309,BUMA.1121.00108,1,3418569,3423139,+,4570
309,BUMA.1121.00028,1,2559630,2564202,+,4572
309,BUMA.1121.00094,1,2399495,2404055,+,4560
309,BUMA.1121.00102,1,2919695,2924267,-,4572
309,BUMA.1121.00111,1,2571708,2576278,+,4570
309,BUMA.1121.00089,1,2369180,2373740,+,4560
309,BUMA.1121.00084,1,2782952,2787512,+,4560
309,BUMA.1121.00029,1,2549149,2553719,-,4570
309,BUMA.1121.00012,1,1133929,1138499,+,4570
309,BUMA.1121.00087,1,2066198,2070770,-,4572
309,BUMA.1121.00043,1,2477829,2482399,+,4570
309,BUMA.1121.00046,1,3112349,3116921,+,4572
309,BUMA.1121.00037,1,1021784,1026355,+,4571
309,BUMA.1121.00080,1,2412437,2416997,+,4560
309,BUMA.1121.00079,1,2408227,2412787,+,4560
309,BUMA.1121.00045,1,1641845,1646407,-,4562
309,BUMA.1121.00071,1,2356448,2361004,+,4556
309,BUMA.1121.00056,1,1552881,1557441,-,4560
309,BUMA.1121.00065,1,2485402,2489973,+,4571
309,BUMA.1121.00058,1,2155835,2160388,-,4553
309,BUMA.1121.00007,1,1686448,1691012,-,4564
309,BUMA.1121.00067,1,1999113,2003684,-,4571
309,BUMA.1121.00090,1,496191,500761,+,4570
309,BUMA.1121.00051,1,2382216,2386776,+,4560
309,BUMA.1121.00020,1,2624531,2629103,+,4572
309,BUMA.1121.00103,1,2023781,2028343,-,4562
309,BUMA.1121.00048,1,1341062,1345634,+,4572
309,BUMA.1121.00047,1,535235,539795,-,4560
309,BUMA.1121.00042,1,1997088,2001660,+,4572
309,BUMA.1121.00055,1,2059094,2063658,+,4564
309,BUMA.1121.00031,1,3816903,3821475,+,4572
309,BUMA.1121.00040,1,2569604,2574176,+,4572
309,BUMA.1121.00044,1,1825173,1829745,+,4572
309,BUMA.1121.00088,1,3328624,3333184,+,4560
309,BUMA.1121.00069,1,2336877,2341433,+,4556
309,BUMA.1121.00064,1,2425448,2430017,+,4569
309,BUMA.1121.00105,1,2821764,2826326,-,4562
309,BUMA.1121.00015,1,1492040,1496612,-,4572
309,BUMA.1121.00059,1,1601429,1606001,+,4572
309,BUMA.1121.00026,1,2816047,2820619,-,4572
309,BUMA.1121.00022,1,2976579,2981151,+,4572
309,BUMA.1121.00052,1,2369493,2374065,+,4572
309,BUMA.1121.00101,1,70323,74887,-,4564
309,BUMA.1121.00001,1,1667391,1671961,-,4570
309,BUMA.1121.00038,1,1548549,1553121,+,4572
309,BUMA.1121.00068,1,1152056,1156628,+,4572
309,BUMA.1121.00099,1,4031975,4036545,-,4570
309,BUMA.1121.00091,1,2100968,2105537,-,4569
309,BUMA.1121.00098,1,1037370,1041940,+,4570
309,BUMA.1121.00013,1,2649797,2654369,+,4572
309,BUMA.1121.00049,1,3461236,3465805,-,4569
309,BUMA.1121.00072,1,2339370,2343926,+,4556
309,BUMA.1121.00076,1,2948150,2952719,-,4569
309,BUMA.1121.00083,1,3251629,3256185,-,4556
309,BUMA.1121.00078,1,3638475,3643045,-,4570
309,BUMA.1121.00095,1,3292868,3297439,-,4571
309,BUMA.1121.00077,1,1083344,1087914,+,4570
309,BUMA.1121.00063,1,2364434,2368989,+,4555
309,BUMA.1121.00061,1,2367509,2372063,+,4554
309,BUMA.1121.00050,1,3144270,3148842,-,4572
309,BUMA.1121.00081,1,1548612,1553184,+,4572
309,BUMA.1121.00074,1,1444344,1448915,-,4571
309,BUMA.1121.00062,1,2179751,2184305,-,4554
309,BUMA.1121.00060,1,3887098,3891660,-,4562
309,BUMA.1121.00070,1,2338513,2343069,+,4556
309,BUMA.1121.00075,1,1861344,1865913,+,4569
309,BUMA.1121.00041,1,3703897,3708452,+,4555
309,BUMA.1121.00073,1,2365609,2370165,+,4556
309,BUMA.1121.00017,1,2494714,2499286,+,4572
309,BUMA.1121.00066,1,2341107,2345662,+,4555
309,BUMA.1121.00107,1,2286050,2290621,+,4571
309,BUMA.1121.00085,1,1966439,1971011,+,4572
309,BUMA.1121.00030,1,2494739,2499311,+,4572
309,BUMA.1121.00112,1,570079,574648,-,4569
309,BUMA.1121.00002,1,154448,159020,+,4572
309,BUMA.1121.00082,1,2523176,2527732,+,4556
309,BUMA.1121.00014,1,395769,400341,-,4572
309,BUMA.1121.00011,1,3244118,3248688,-,4570
309,BUMA.1121.00019,1,2524594,2529166,+,4572
309,BUMA.1121.00057,1,3538391,3542947,+,4556
309,BUMA.1121.00018,1,3009045,3013615,+,4570
309,BUMA.1121.00039,1,2516258,2520829,+,4571
309,BUMA.1121.00016,1,521518,526088,+,4570
309,BUMA.1121.00004,1,2559574,2564146,+,4572
309,BUMA.1121.00005,1,1124587,1129140,+,4553
309,BUMA.1121.00100,1,2942454,2947033,-,4579
309,BUMA.1121.00006,1,1548532,1553104,+,4572
308,BUMA.1121.00027,1,553879,567384,+,13505
308,BUMA.1121.00025,1,250912,264317,-,13405
308,BUMA.1121.00021,1,3004026,3018823,+,14797
308,BUMA.1121.00023,1,714908,728358,+,13450
308,BUMA.1121.00024,1,2544580,2558067,+,13487
308,BUMA.1121.00033,1,580215,593703,+,13488
308,BUMA.1121.00034,1,2583308,2596809,+,13501
308,BUMA.1121.00036,1,1553263,1566645,-,13382
308,BUMA.1121.00032,1,612758,626252,+,13494
308,BUMA.1121.00009,1,3156432,3169825,-,13393
308,BUMA.1121.00008,1,2557580,2571074,+,13494
308,BUMA.1121.00003,1,903190,916622,+,13432
308,BUMA.1121.00109,1,3488233,3501641,-,13408
308,BUMA.1121.00053,1,2106776,2120268,+,13492
308,BUMA.1121.00110,1,2400073,2413478,-,13405
308,BUMA.1121.00104,1,2832062,2845459,-,13397
308,BUMA.1121.00086,1,1232248,1245767,+,13519
308,BUMA.1121.00092,1,1404118,1417521,-,13403
308,BUMA.1121.00096,1,851819,865232,-,13413
308,BUMA.1121.00054,1,2594913,2608305,-,13392
308,BUMA.1121.00097,1,1519761,1533158,-,13397
308,BUMA.1121.00093,1,3208761,3222207,+,13446
308,BUMA.1121.00106,1,2144412,2157836,+,13424
308,BUMA.1121.00010,1,116780,130235,+,13455
308,BUMA.1121.00035,1,3521224,3534672,+,13448
308,BUMA.1121.00108,1,3404990,3418444,+,13454
308,BUMA.1121.00028,1,2545899,2559379,+,13480
308,BUMA.1121.00094,1,2385883,2399328,+,13445
308,BUMA.1121.00102,1,2924508,2937901,-,13393
308,BUMA.1121.00111,1,2558079,2571562,+,13483
308,BUMA.1121.00089,1,2355568,2369013,+,13445
308,BUMA.1121.00084,1,2769187,2782631,+,13444
308,BUMA.1121.00029,1,2553921,2567358,-,13437
308,BUMA.1121.00012,1,1120223,1133699,+,13476
308,BUMA.1121.00087,1,2071158,2084540,-,13382
308,BUMA.1121.00043,1,2462494,2476139,+,13645
308,BUMA.1121.00046,1,3098700,3112166,+,13466
308,BUMA.1121.00037,1,1008232,1021673,+,13441
308,BUMA.1121.00080,1,2398797,2412249,+,13452
308,BUMA.1121.00079,1,2394603,2408060,+,13457
308,BUMA.1121.00045,1,1646613,1660013,-,13400
308,BUMA.1121.00071,1,2342807,2356245,+,13438
308,BUMA.1121.00056,1,1557616,1571018,-,13402
308,BUMA.1121.00065,1,2471814,2485263,+,13449
308,BUMA.1121.00058,1,2160650,2174060,-,13410
308,BUMA.1121.00007,1,1691286,1704696,-,13410
308,BUMA.1121.00067,1,2003922,2017304,-,13382
308,BUMA.1121.00090,1,482562,496045,+,13483
308,BUMA.1121.00051,1,2368556,2382000,+,13444
308,BUMA.1121.00020,1,2610786,2624280,+,13494
308,BUMA.1121.00103,1,2028556,2041958,-,13402
308,BUMA.1121.00048,1,1327408,1340874,+,13466
308,BUMA.1121.00047,1,539998,553400,-,13402
308,BUMA.1121.00042,1,1983455,1996914,+,13459
308,BUMA.1121.00055,1,2045396,2058906,+,13510
308,BUMA.1121.00031,1,3803272,3816757,+,13485
308,BUMA.1121.00040,1,2555943,2569409,+,13466
308,BUMA.1121.00044,1,1811421,1824922,+,13501
308,BUMA.1121.00088,1,3315013,3328457,+,13444
308,BUMA.1121.00069,1,2323197,2336689,+,13492
308,BUMA.1121.00064,1,2411884,2425295,+,13411
308,BUMA.1121.00105,1,2826536,2839950,-,13414
308,BUMA.1121.00015,1,1496895,1510287,-,13392
308,BUMA.1121.00059,1,1587924,1601338,+,13414
308,BUMA.1121.00026,1,2820832,2834224,-,13392
308,BUMA.1121.00022,1,2962928,2976398,+,13470
308,BUMA.1121.00052,1,2355825,2369298,+,13473
308,BUMA.1121.00101,1,75084,88494,-,13410
308,BUMA.1121.00001,1,1672241,1685645,-,13404
308,BUMA.1121.00038,1,1534895,1548361,+,13466
308,BUMA.1121.00068,1,1138388,1151854,+,13466
308,BUMA.1121.00099,1,4036867,4050277,-,13410
308,BUMA.1121.00091,1,2105771,2119182,-,13411
308,BUMA.1121.00098,1,1023865,1037289,+,13424
308,BUMA.1121.00013,1,2636136,2649602,+,13466
308,BUMA.1121.00049,1,3465911,3479321,-,13410
308,BUMA.1121.00072,1,2325697,2339175,+,13478
308,BUMA.1121.00076,1,2953065,2966459,-,13394
308,BUMA.1121.00083,1,3256451,3269865,-,13414
308,BUMA.1121.00078,1,3643251,3656656,-,13405
308,BUMA.1121.00095,1,3297750,3311156,-,13406
308,BUMA.1121.00077,1,1069754,1083263,+,13509
308,BUMA.1121.00063,1,2350760,2364231,+,13471
308,BUMA.1121.00061,1,2353851,2367315,+,13464
308,BUMA.1121.00050,1,3149118,3162510,-,13392
308,BUMA.1121.00081,1,1534958,1548424,+,13466
308,BUMA.1121.00074,1,1449139,1462524,-,13385
308,BUMA.1121.00062,1,2184574,2197983,-,13409
308,BUMA.1121.00060,1,3891866,3905265,-,13399
308,BUMA.1121.00070,1,2324833,2338276,+,13443
308,BUMA.1121.00075,1,1847611,1861093,+,13482
308,BUMA.1121.00041,1,3690241,3703689,+,13448
308,BUMA.1121.00073,1,2351929,2365372,+,13443
308,BUMA.1121.00017,1,2480955,2494456,+,13501
308,BUMA.1121.00066,1,2327437,2340870,+,13433
308,BUMA.1121.00107,1,2272512,2285967,+,13455
308,BUMA.1121.00085,1,1952771,1966244,+,13473
308,BUMA.1121.00030,1,2480987,2494488,+,13501
308,BUMA.1121.00112,1,574847,588249,-,13402
308,BUMA.1121.00002,1,140791,154246,+,13455
308,BUMA.1121.00082,1,2509496,2522960,+,13464
308,BUMA.1121.00014,1,400582,414001,-,13419
308,BUMA.1121.00011,1,3248884,3262288,-,13404
308,BUMA.1121.00019,1,2510849,2524343,+,13494
308,BUMA.1121.00057,1,3524669,3538140,+,13471
308,BUMA.1121.00018,1,2995375,3008850,+,13475
308,BUMA.1121.00039,1,2502470,2515946,+,13476
308,BUMA.1121.00016,1,507985,521437,+,13452
308,BUMA.1121.00004,1,2545829,2559323,+,13494
308,BUMA.1121.00005,1,1111019,1124416,+,13397
308,BUMA.1121.00100,1,2947123,2960527,-,13404
308,BUMA.1121.00006,1,1534878,1548344,+,13466
307,BUMA.1121.00027,1,530805,548473,+,17668
307,BUMA.1121.00025,1,270458,288112,-,17654
307,BUMA.1121.00021,1,2980959,2998615,+,17656
307,BUMA.1121.00023,1,690507,708162,+,17655
307,BUMA.1121.00024,1,2525103,2542687,+,17584
307,BUMA.1121.00033,1,498738,516392,+,17654
307,BUMA.1121.00034,1,2563831,2581415,+,17584
307,BUMA.1121.00036,1,1568538,1586132,-,17594
307,BUMA.1121.00032,1,593281,610865,+,17584
307,BUMA.1121.00009,1,3175252,3192896,-,17644
307,BUMA.1121.00008,1,2538103,2555687,+,17584
307,BUMA.1121.00003,1,880153,897758,+,17605
307,BUMA.1121.00109,1,3507045,3524660,-,17615
307,BUMA.1121.00053,1,2083709,2101362,+,17653
307,BUMA.1121.00110,1,2418882,2436548,-,17666
307,BUMA.1121.00104,1,2852081,2869737,-,17656
307,BUMA.1121.00086,1,1212748,1230355,+,17607
307,BUMA.1121.00092,1,1424142,1441673,-,17531
307,BUMA.1121.00096,1,870656,888310,-,17654
307,BUMA.1121.00054,1,2610198,2627787,-,17589
307,BUMA.1121.00097,1,1538581,1556246,-,17665
307,BUMA.1121.00093,1,3184609,3202141,+,17532
307,BUMA.1121.00106,1,2120133,2137790,+,17657
307,BUMA.1121.00010,1,75276,92865,+,17589
307,BUMA.1121.00035,1,3498158,3515813,+,17655
307,BUMA.1121.00108,1,3381918,3399576,+,17658
307,BUMA.1121.00028,1,2526422,2544006,+,17584
307,BUMA.1121.00094,1,2362813,2380473,+,17660
307,BUMA.1121.00102,1,2943328,2960980,-,17652
307,BUMA.1121.00111,1,2535012,2552667,+,17655
307,BUMA.1121.00089,1,2332494,2350154,+,17660
307,BUMA.1121.00084,1,2746109,2763761,+,17652
307,BUMA.1121.00029,1,2572769,2590418,-,17649
307,BUMA.1121.00012,1,1097157,1114812,+,17655
307,BUMA.1121.00087,1,2086433,2104039,-,17606
307,BUMA.1121.00043,1,2439426,2457083,+,17657
307,BUMA.1121.00046,1,3079206,3096807,+,17601
307,BUMA.1121.00037,1,985164,1002822,+,17658
307,BUMA.1121.00080,1,2375723,2393383,+,17660
307,BUMA.1121.00079,1,2371531,2389182,+,17651
307,BUMA.1121.00045,1,1665436,1683104,-,17668
307,BUMA.1121.00071,1,1479059,1496648,-,17589
307,BUMA.1121.00056,1,1576432,1594091,-,17659
307,BUMA.1121.00065,1,2448728,2466387,+,17659
307,BUMA.1121.00058,1,2179472,2197135,-,17663
307,BUMA.1121.00007,1,1710112,1727776,-,17664
307,BUMA.1121.00067,1,2022714,2040378,-,17664
307,BUMA.1121.00090,1,459496,477151,+,17655
307,BUMA.1121.00051,1,2345483,2363142,+,17659
307,BUMA.1121.00020,1,2591309,2608893,+,17584
307,BUMA.1121.00103,1,2047382,2065034,-,17652
307,BUMA.1121.00048,1,1307925,1325515,+,17590
307,BUMA.1121.00047,1,597930,615589,-,17659
307,BUMA.1121.00042,1,1963962,1981563,+,17601
307,BUMA.1121.00055,1,1974355,1992016,+,17661
307,BUMA.1121.00031,1,3780199,3797861,+,17662
307,BUMA.1121.00040,1,2536460,2554050,+,17590
307,BUMA.1121.00044,1,1791944,1809528,+,17584
307,BUMA.1121.00088,1,3290620,3308274,+,17654
307,BUMA.1121.00069,1,1441767,1459433,-,17666
307,BUMA.1121.00064,1,2388807,2406474,+,17667
307,BUMA.1121.00105,1,2845130,2862797,-,17667
307,BUMA.1121.00015,1,1512180,1529780,-,17600
307,BUMA.1121.00059,1,1564841,1582498,+,17657
307,BUMA.1121.00026,1,3390174,3407764,+,17590
307,BUMA.1121.00022,1,2943429,2961035,+,17606
307,BUMA.1121.00052,1,2336343,2353932,+,17589
307,BUMA.1121.00101,1,93917,111587,-,17670
307,BUMA.1121.00001,1,1691056,1708710,-,17654
307,BUMA.1121.00038,1,1515412,1533002,+,17590
307,BUMA.1121.00068,1,1115327,1132972,+,17645
307,BUMA.1121.00099,1,4055687,4073333,-,17646
307,BUMA.1121.00091,1,2124609,2142269,-,17660
307,BUMA.1121.00098,1,1000796,1018450,+,17654
307,BUMA.1121.00013,1,2616654,2634243,+,17589
307,BUMA.1121.00049,1,3484737,3502404,-,17667
307,BUMA.1121.00072,1,1461512,1479180,-,17668
307,BUMA.1121.00076,1,2971651,2989305,-,17654
307,BUMA.1121.00083,1,3275271,3292940,-,17669
307,BUMA.1121.00078,1,3662071,3679740,-,17669
307,BUMA.1121.00095,1,3316393,3334050,-,17657
307,BUMA.1121.00077,1,1046686,1064350,+,17664
307,BUMA.1121.00063,1,1486057,1503726,-,17669
307,BUMA.1121.00061,1,1488970,1506639,-,17669
307,BUMA.1121.00050,1,3164403,3182003,-,17600
307,BUMA.1121.00081,1,1515475,1533065,+,17590
307,BUMA.1121.00074,1,1467934,1485600,-,17666
307,BUMA.1121.00062,1,2203392,2221056,-,17664
307,BUMA.1121.00060,1,3910688,3928356,-,17668
307,BUMA.1121.00070,1,1459963,1477628,-,17665
307,BUMA.1121.00075,1,1824765,1842419,+,17654
307,BUMA.1121.00041,1,3667185,3684827,+,17642
307,BUMA.1121.00073,1,1487214,1504883,-,17669
307,BUMA.1121.00017,1,2461478,2479062,+,17584
307,BUMA.1121.00066,1,1463129,1480718,-,17589
307,BUMA.1121.00107,1,2249452,2267104,+,17652
307,BUMA.1121.00085,1,1933289,1950878,+,17589
307,BUMA.1121.00030,1,2461510,2479094,+,17584
307,BUMA.1121.00112,1,593679,611324,-,17645
307,BUMA.1121.00002,1,99287,116877,+,17590
307,BUMA.1121.00082,1,1619693,1637362,-,17669
307,BUMA.1121.00014,1,419412,437074,-,17662
307,BUMA.1121.00011,1,3267697,3285365,-,17668
307,BUMA.1121.00019,1,2491372,2508956,+,17584
307,BUMA.1121.00057,1,3455172,3472842,+,17670
307,BUMA.1121.00018,1,2971579,2989234,+,17655
307,BUMA.1121.00039,1,2479405,2497060,+,17655
307,BUMA.1121.00016,1,483539,501194,+,17655
307,BUMA.1121.00004,1,2526352,2543936,+,17584
307,BUMA.1121.00005,1,1087928,1105592,+,17664
307,BUMA.1121.00100,1,2965944,2983509,-,17565
307,BUMA.1121.00006,1,1515395,1532985,+,17590
306,BUMA.1121.00027,1,525391,528868,+,3477
306,BUMA.1121.00025,1,290042,293532,-,3490
306,BUMA.1121.00021,1,2975529,2979030,+,3501
306,BUMA.1121.00023,1,685085,688578,+,3493
306,BUMA.1121.00024,1,2519725,2523166,+,3441
306,BUMA.1121.00033,1,493278,496805,+,3527
306,BUMA.1121.00034,1,2558453,2561894,+,3441
306,BUMA.1121.00036,1,1588070,1591519,-,3449
306,BUMA.1121.00032,1,587903,591344,+,3441
306,BUMA.1121.00009,1,3194835,3198416,-,3581
306,BUMA.1121.00008,1,2532725,2536166,+,3441
306,BUMA.1121.00003,1,874715,878217,+,3502
306,BUMA.1121.00109,1,3528036,3531485,-,3449
306,BUMA.1121.00053,1,2078195,2081784,+,3589
306,BUMA.1121.00110,1,2439922,2443390,-,3468
306,BUMA.1121.00104,1,2873128,2876665,-,3537
306,BUMA.1121.00086,1,1207346,1210811,+,3465
306,BUMA.1121.00092,1,1443609,1447035,-,3426
306,BUMA.1121.00096,1,890246,893702,-,3456
306,BUMA.1121.00054,1,2629725,2633198,-,3473
306,BUMA.1121.00097,1,1558187,1561673,-,3486
306,BUMA.1121.00093,1,3179248,3182674,+,3426
306,BUMA.1121.00106,1,2113190,2116743,+,3553
306,BUMA.1121.00010,1,69866,73339,+,3473
306,BUMA.1121.00035,1,3492753,3496229,+,3476
306,BUMA.1121.00108,1,3376509,3379979,+,3470
306,BUMA.1121.00028,1,2521044,2524485,+,3441
306,BUMA.1121.00094,1,2357284,2360875,+,3591
306,BUMA.1121.00102,1,2962903,2966421,-,3518
306,BUMA.1121.00111,1,2529557,2533083,+,3526
306,BUMA.1121.00089,1,2326963,2330556,+,3593
306,BUMA.1121.00084,1,2740694,2744171,+,3477
306,BUMA.1121.00029,1,2592348,2595912,-,3564
306,BUMA.1121.00012,1,1091766,1095227,+,3461
306,BUMA.1121.00087,1,2105977,2109442,-,3465
306,BUMA.1121.00043,1,2433982,2437491,+,3509
306,BUMA.1121.00046,1,3073804,3077269,+,3465
306,BUMA.1121.00037,1,979740,983235,+,3495
306,BUMA.1121.00080,1,2370192,2373785,+,3593
306,BUMA.1121.00079,1,2366025,2369594,+,3569
306,BUMA.1121.00045,1,1685041,1688504,-,3463
306,BUMA.1121.00071,1,1498574,1502059,-,3485
306,BUMA.1121.00056,1,1596030,1599607,-,3577
306,BUMA.1121.00065,1,2443316,2446793,+,3477
306,BUMA.1121.00058,1,2199059,2202552,-,3493
306,BUMA.1121.00007,1,1729681,1733138,-,3457
306,BUMA.1121.00067,1,2042317,2045754,-,3437
306,BUMA.1121.00090,1,454113,457567,+,3454
306,BUMA.1121.00051,1,2339960,2343545,+,3585
306,BUMA.1121.00020,1,2585931,2589372,+,3441
306,BUMA.1121.00103,1,2066969,2070626,-,3657
306,BUMA.1121.00048,1,1302515,1305988,+,3473
306,BUMA.1121.00047,1,617528,621049,-,3521
306,BUMA.1121.00042,1,1958584,1962025,+,3441
306,BUMA.1121.00055,1,1968707,1972432,+,3725
306,BUMA.1121.00031,1,3774759,3778270,+,3511
306,BUMA.1121.00040,1,2531082,2534523,+,3441
306,BUMA.1121.00044,1,1786566,1790007,+,3441
306,BUMA.1121.00088,1,3285199,3288684,+,3485
306,BUMA.1121.00069,1,1461363,1464845,-,3482
306,BUMA.1121.00064,1,2381933,2385414,+,3481
306,BUMA.1121.00105,1,2866188,2869717,-,3529
306,BUMA.1121.00015,1,1531718,1535135,-,3417
306,BUMA.1121.00059,1,1557882,1561451,+,3569
306,BUMA.1121.00026,1,3384828,3388237,+,3409
306,BUMA.1121.00022,1,2938043,2941492,+,3449
306,BUMA.1121.00052,1,2330909,2334406,+,3497
306,BUMA.1121.00101,1,113519,116995,-,3476
306,BUMA.1121.00001,1,1710640,1714109,-,3469
306,BUMA.1121.00038,1,1510002,1513475,+,3473
306,BUMA.1121.00068,1,1109876,1113389,+,3513
306,BUMA.1121.00099,1,4075267,4078739,-,3472
306,BUMA.1121.00091,1,2144218,2147658,-,3440
306,BUMA.1121.00098,1,995341,998859,+,3518
306,BUMA.1121.00013,1,2611220,2614717,+,3497
306,BUMA.1121.00049,1,3505797,3509358,-,3561
306,BUMA.1121.00072,1,1481132,1484586,-,3454
306,BUMA.1121.00076,1,2991242,2994743,-,3501
306,BUMA.1121.00083,1,3294879,3298364,-,3485
306,BUMA.1121.00078,1,3681666,3685175,-,3509
306,BUMA.1121.00095,1,3335987,3339533,-,3546
306,BUMA.1121.00077,1,1039843,1043311,+,3468
306,BUMA.1121.00063,1,1505651,1509136,-,3485
306,BUMA.1121.00061,1,1508565,1512050,-,3485
306,BUMA.1121.00050,1,3183941,3187406,-,3465
306,BUMA.1121.00081,1,1510065,1513538,+,3473
306,BUMA.1121.00074,1,1487542,1491071,-,3529
306,BUMA.1121.00062,1,2222993,2226526,-,3533
306,BUMA.1121.00060,1,3930293,3933716,-,3423
306,BUMA.1121.00070,1,1479558,1483043,-,3485
306,BUMA.1121.00075,1,1819328,1822829,+,3501
306,BUMA.1121.00041,1,3661841,3665260,+,3419
306,BUMA.1121.00073,1,1506810,1510295,-,3485
306,BUMA.1121.00017,1,2456100,2459541,+,3441
306,BUMA.1121.00066,1,1482643,1486128,-,3485
306,BUMA.1121.00107,1,2244065,2247527,+,3462
306,BUMA.1121.00085,1,1927855,1931352,+,3497
306,BUMA.1121.00030,1,2456132,2459573,+,3441
306,BUMA.1121.00112,1,613261,616705,-,3444
306,BUMA.1121.00002,1,93877,97350,+,3473
306,BUMA.1121.00082,1,1639301,1642786,-,3485
306,BUMA.1121.00014,1,439004,442514,-,3510
306,BUMA.1121.00011,1,3287304,3290740,-,3436
306,BUMA.1121.00019,1,2485994,2489435,+,3441
306,BUMA.1121.00057,1,3449757,3453234,+,3477
306,BUMA.1121.00018,1,2966162,2969650,+,3488
306,BUMA.1121.00039,1,2474022,2477475,+,3453
306,BUMA.1121.00016,1,478134,481603,+,3469
306,BUMA.1121.00004,1,2520966,2524415,+,3449
306,BUMA.1121.00005,1,1082558,1085993,+,3435
306,BUMA.1121.00100,1,2985432,2989007,-,3575
306,BUMA.1121.00006,1,1509985,1513458,+,3473
305,BUMA.1121.00027,1,515362,525389,+,10027
305,BUMA.1121.00025,1,293533,303696,-,10163
305,BUMA.1121.00021,1,2965700,2975527,+,9827
305,BUMA.1121.00023,1,675176,685083,+,9907
305,BUMA.1121.00024,1,2509896,2519723,+,9827
305,BUMA.1121.00033,1,483353,493276,+,9923
305,BUMA.1121.00034,1,2548624,2558451,+,9827
305,BUMA.1121.00036,1,1591520,1601371,-,9851
305,BUMA.1121.00032,1,578074,587901,+,9827
305,BUMA.1121.00009,1,3198417,3208318,-,9901
305,BUMA.1121.00008,1,2522896,2532723,+,9827
305,BUMA.1121.00003,1,864677,874713,+,10036
305,BUMA.1121.00109,1,3531486,3541338,-,9852
305,BUMA.1121.00053,1,2068295,2078193,+,9898
305,BUMA.1121.00110,1,2443391,2453242,-,9851
305,BUMA.1121.00104,1,2876666,2886574,-,9908
305,BUMA.1121.00086,1,1197517,1207344,+,9827
305,BUMA.1121.00092,1,1447036,1456863,-,9827
305,BUMA.1121.00096,1,893703,903674,-,9971
305,BUMA.1121.00054,1,2633199,2643073,-,9874
305,BUMA.1121.00097,1,1561674,1571492,-,9818
305,BUMA.1121.00093,1,3169419,3179246,+,9827
305,BUMA.1121.00106,1,2103320,2113188,+,9868
305,BUMA.1121.00010,1,59982,69864,+,9882
305,BUMA.1121.00035,1,3482788,3492751,+,9963
305,BUMA.1121.00108,1,3366703,3376507,+,9804
305,BUMA.1121.00028,1,2511215,2521042,+,9827
305,BUMA.1121.00094,1,2347342,2357282,+,9940
305,BUMA.1121.00102,1,2966422,2976339,-,9917
305,BUMA.1121.00111,1,2519626,2529555,+,9929
305,BUMA.1121.00089,1,2317021,2326961,+,9940
305,BUMA.1121.00084,1,2730713,2740692,+,9979
305,BUMA.1121.00029,1,2595913,2605868,-,9955
305,BUMA.1121.00012,1,1081841,1091764,+,9923
305,BUMA.1121.00087,1,2109443,2119270,-,9827
305,BUMA.1121.00043,1,2424081,2433980,+,9899
305,BUMA.1121.00046,1,3063912,3073802,+,9890
305,BUMA.1121.00037,1,969807,979738,+,9931
305,BUMA.1121.00080,1,2360003,2370190,+,10187
305,BUMA.1121.00079,1,2355947,2366023,+,10076
305,BUMA.1121.00045,1,1688505,1698412,-,9907
305,BUMA.1121.00071,1,1502060,1512039,-,9979
305,BUMA.1121.00056,1,1599608,1609548,-,9940
305,BUMA.1121.00065,1,2433349,2443314,+,9965
305,BUMA.1121.00058,1,2202553,2212422,-,9869
305,BUMA.1121.00007,1,1733139,1743032,-,9893
305,BUMA.1121.00067,1,2045755,2055622,-,9867
305,BUMA.1121.00090,1,444107,454111,+,10004
305,BUMA.1121.00051,1,2329826,2339958,+,10132
305,BUMA.1121.00020,1,2576102,2585929,+,9827
305,BUMA.1121.00103,1,2070627,2080470,-,9843
305,BUMA.1121.00048,1,1292639,1302513,+,9874
305,BUMA.1121.00047,1,621050,631150,-,10100
305,BUMA.1121.00042,1,1948715,1958582,+,9867
305,BUMA.1121.00055,1,1958812,1968705,+,9893
305,BUMA.1121.00031,1,3764594,3774757,+,10163
305,BUMA.1121.00040,1,2521182,2531080,+,9898
305,BUMA.1121.00044,1,1776737,1786564,+,9827
305,BUMA.1121.00088,1,3275291,3285197,+,9906
305,BUMA.1121.00069,1,1464846,1474825,-,9979
305,BUMA.1121.00064,1,2372063,2381931,+,9868
305,BUMA.1121.00105,1,2869718,2879657,-,9939
305,BUMA.1121.00015,1,1535136,1545050,-,9914
305,BUMA.1121.00059,1,1548037,1557880,+,9843
305,BUMA.1121.00026,1,3374943,3384826,+,9883
305,BUMA.1121.00022,1,2928222,2938041,+,9819
305,BUMA.1121.00052,1,2321041,2330907,+,9866
305,BUMA.1121.00101,1,116996,126888,-,9892
305,BUMA.1121.00001,1,1714110,1724057,-,9947
305,BUMA.1121.00038,1,1500126,1510000,+,9874
305,BUMA.1121.00068,1,1099945,1109874,+,9929
305,BUMA.1121.00099,1,4078740,4088575,-,9835
305,BUMA.1121.00091,1,2147659,2157655,-,9996
305,BUMA.1121.00098,1,985535,995339,+,9804
305,BUMA.1121.00013,1,2601352,2611218,+,9866
305,BUMA.1121.00049,1,3509359,3519227,-,9868
305,BUMA.1121.00072,1,1484587,1494566,-,9979
305,BUMA.1121.00076,1,2994744,3004653,-,9909
305,BUMA.1121.00083,1,3298365,3308344,-,9979
305,BUMA.1121.00078,1,3685176,3695128,-,9952
305,BUMA.1121.00095,1,3339534,3349354,-,9820
305,BUMA.1121.00077,1,1029990,1039841,+,9851
305,BUMA.1121.00063,1,1509137,1519116,-,9979
305,BUMA.1121.00061,1,1512051,1522014,-,9963
305,BUMA.1121.00050,1,3187407,3197297,-,9890
305,BUMA.1121.00081,1,1500189,1510063,+,9874
305,BUMA.1121.00074,1,1491072,1500932,-,9860
305,BUMA.1121.00062,1,2226527,2236362,-,9835
305,BUMA.1121.00060,1,3935335,3945257,-,9922
305,BUMA.1121.00070,1,1483044,1492926,-,9882
305,BUMA.1121.00075,1,1809418,1819326,+,9908
305,BUMA.1121.00041,1,3651876,3661839,+,9963
305,BUMA.1121.00073,1,1510296,1520178,-,9882
305,BUMA.1121.00017,1,2446271,2456098,+,9827
305,BUMA.1121.00066,1,1486129,1496108,-,9979
305,BUMA.1121.00107,1,2234251,2244063,+,9812
305,BUMA.1121.00085,1,1917987,1927853,+,9866
305,BUMA.1121.00030,1,2446303,2456130,+,9827
305,BUMA.1121.00112,1,616706,626503,-,9797
305,BUMA.1121.00002,1,84033,93875,+,9842
305,BUMA.1121.00082,1,1642787,1652766,-,9979
305,BUMA.1121.00014,1,442515,452566,-,10051
305,BUMA.1121.00011,1,3290741,3300610,-,9869
305,BUMA.1121.00019,1,2476165,2485992,+,9827
305,BUMA.1121.00057,1,3439880,3449755,+,9875
305,BUMA.1121.00018,1,2955989,2966160,+,10171
305,BUMA.1121.00039,1,2464025,2474020,+,9995
305,BUMA.1121.00016,1,468200,478132,+,9932
305,BUMA.1121.00004,1,2511137,2520964,+,9827
305,BUMA.1121.00005,1,1072705,1082556,+,9851
305,BUMA.1121.00100,1,2989008,2998948,-,9940
305,BUMA.1121.00006,1,1500109,1509983,+,9874
304,BUMA.1121.00027,1,498702,515054,+,16352
304,BUMA.1121.00025,1,304005,320362,-,16357
304,BUMA.1121.00021,1,2949042,2965392,+,16350
304,BUMA.1121.00023,1,658510,674868,+,16358
304,BUMA.1121.00024,1,2493223,2509588,+,16365
304,BUMA.1121.00033,1,466685,483045,+,16360
304,BUMA.1121.00034,1,2531951,2548316,+,16365
304,BUMA.1121.00036,1,1601680,1618044,-,16364
304,BUMA.1121.00032,1,561401,577766,+,16365
304,BUMA.1121.00009,1,3208627,3224994,-,16367
304,BUMA.1121.00008,1,2506223,2522588,+,16365
304,BUMA.1121.00003,1,847989,864369,+,16380
304,BUMA.1121.00109,1,3541647,3558063,-,16416
304,BUMA.1121.00053,1,2051627,2067987,+,16360
304,BUMA.1121.00110,1,2453551,2469928,-,16377
304,BUMA.1121.00104,1,2886883,2903250,-,16367
304,BUMA.1121.00086,1,1180835,1197209,+,16374
304,BUMA.1121.00092,1,1457172,1473529,-,16357
304,BUMA.1121.00096,1,903983,920363,-,16380
304,BUMA.1121.00054,1,2643382,2659746,-,16364
304,BUMA.1121.00097,1,1571801,1588195,-,16394
304,BUMA.1121.00093,1,3152753,3169111,+,16358
304,BUMA.1121.00106,1,2086652,2103012,+,16360
304,BUMA.1121.00010,1,43309,59674,+,16365
304,BUMA.1121.00035,1,3466112,3482480,+,16368
304,BUMA.1121.00108,1,3350032,3366395,+,16363
304,BUMA.1121.00028,1,2494542,2510907,+,16365
304,BUMA.1121.00094,1,2330667,2347034,+,16367
304,BUMA.1121.00102,1,2976648,2992889,-,16241
304,BUMA.1121.00111,1,2502949,2519318,+,16369
304,BUMA.1121.00089,1,2300346,2316713,+,16367
304,BUMA.1121.00084,1,2714039,2730405,+,16366
304,BUMA.1121.00029,1,2606177,2622533,-,16356
304,BUMA.1121.00012,1,1065175,1081533,+,16358
304,BUMA.1121.00087,1,2119579,2135952,-,16373
304,BUMA.1121.00043,1,2407413,2423773,+,16360
304,BUMA.1121.00046,1,3047239,3063604,+,16365
304,BUMA.1121.00037,1,953132,969499,+,16367
304,BUMA.1121.00080,1,2343328,2359695,+,16367
304,BUMA.1121.00079,1,2339273,2355639,+,16366
304,BUMA.1121.00045,1,1698721,1715089,-,16368
304,BUMA.1121.00071,1,1512348,1528702,-,16354
304,BUMA.1121.00056,1,1609857,1626223,-,16366
304,BUMA.1121.00065,1,2416674,2433041,+,16367
304,BUMA.1121.00058,1,2212731,2229089,-,16358
304,BUMA.1121.00007,1,1743341,1759720,-,16379
304,BUMA.1121.00067,1,2055931,2072214,-,16283
304,BUMA.1121.00090,1,427439,443799,+,16360
304,BUMA.1121.00051,1,2313152,2329518,+,16366
304,BUMA.1121.00020,1,2559429,2575794,+,16365
304,BUMA.1121.00103,1,2080779,2097146,-,16367
304,BUMA.1121.00048,1,1275966,1292331,+,16365
304,BUMA.1121.00047,1,631459,647825,-,16366
304,BUMA.1121.00042,1,1932042,1948407,+,16365
304,BUMA.1121.00055,1,1942153,1958504,+,16351
304,BUMA.1121.00031,1,3747929,3764286,+,16357
304,BUMA.1121.00040,1,2504510,2520874,+,16364
304,BUMA.1121.00044,1,1760064,1776429,+,16365
304,BUMA.1121.00088,1,3258820,3274983,+,16163
304,BUMA.1121.00069,1,1475134,1491485,-,16351
304,BUMA.1121.00064,1,2355395,2371755,+,16360
304,BUMA.1121.00105,1,2879966,2896311,-,16345
304,BUMA.1121.00015,1,1545359,1561723,-,16364
304,BUMA.1121.00059,1,1531375,1547729,+,16354
304,BUMA.1121.00026,1,3358270,3374635,+,16365
304,BUMA.1121.00022,1,2911549,2927914,+,16365
304,BUMA.1121.00052,1,2304368,2320733,+,16365
304,BUMA.1121.00101,1,127197,143586,-,16389
304,BUMA.1121.00001,1,1724366,1740733,-,16367
304,BUMA.1121.00038,1,1483453,1499818,+,16365
304,BUMA.1121.00068,1,1083244,1099637,+,16393
304,BUMA.1121.00099,1,1,16393,-,16392
304,BUMA.1121.00091,1,2157964,2174338,-,16374
304,BUMA.1121.00098,1,968863,985227,+,16364
304,BUMA.1121.00013,1,2584679,2601044,+,16365
304,BUMA.1121.00049,1,3519536,3535895,-,16359
304,BUMA.1121.00072,1,1494875,1511228,-,16353
304,BUMA.1121.00076,1,3004962,3021328,-,16366
304,BUMA.1121.00083,1,3308653,3325007,-,16354
304,BUMA.1121.00078,1,3695437,3711810,-,16373
304,BUMA.1121.00095,1,3349663,3366064,-,16401
304,BUMA.1121.00077,1,1013304,1029682,+,16378
304,BUMA.1121.00063,1,1519425,1535775,-,16350
304,BUMA.1121.00061,1,1522323,1538677,-,16354
304,BUMA.1121.00050,1,3197606,3213970,-,16364
304,BUMA.1121.00081,1,1483516,1499881,+,16365
304,BUMA.1121.00074,1,1501241,1517524,-,16283
304,BUMA.1121.00062,1,2236671,2253027,-,16356
304,BUMA.1121.00060,1,3945566,3961934,-,16368
304,BUMA.1121.00070,1,1493235,1509589,-,16354
304,BUMA.1121.00075,1,1792743,1809110,+,16367
304,BUMA.1121.00041,1,3635212,3651568,+,16356
304,BUMA.1121.00073,1,1520487,1536841,-,16354
304,BUMA.1121.00017,1,2429598,2445963,+,16365
304,BUMA.1121.00066,1,1496417,1512771,-,16354
304,BUMA.1121.00107,1,2217572,2233943,+,16371
304,BUMA.1121.00085,1,1901314,1917679,+,16365
304,BUMA.1121.00030,1,2429630,2445995,+,16365
304,BUMA.1121.00112,1,626812,643234,-,16422
304,BUMA.1121.00002,1,67360,83725,+,16365
304,BUMA.1121.00082,1,1653075,1669429,-,16354
304,BUMA.1121.00014,1,452875,469232,-,16357
304,BUMA.1121.00011,1,3300919,3317293,-,16374
304,BUMA.1121.00019,1,2459492,2475857,+,16365
304,BUMA.1121.00057,1,3423217,3439572,+,16355
304,BUMA.1121.00018,1,2939323,2955681,+,16358
304,BUMA.1121.00039,1,2447359,2463717,+,16358
304,BUMA.1121.00016,1,451525,467892,+,16367
304,BUMA.1121.00004,1,2494464,2510829,+,16365
304,BUMA.1121.00005,1,1056010,1072397,+,16387
304,BUMA.1121.00100,1,2999257,3015619,-,16362
304,BUMA.1121.00006,1,1483436,1499801,+,16365
303,BUMA.1121.00027,1,483948,496817,+,12869
303,BUMA.1121.00025,1,322248,335121,-,12873
303,BUMA.1121.00021,1,2934167,2947157,+,12990
303,BUMA.1121.00023,1,643751,656625,+,12874
303,BUMA.1121.00024,1,2478476,2491338,+,12862
303,BUMA.1121.00033,1,451927,464800,+,12873
303,BUMA.1121.00034,1,2517204,2530066,+,12862
303,BUMA.1121.00036,1,1619930,1632791,-,12861
303,BUMA.1121.00032,1,546654,559516,+,12862
303,BUMA.1121.00009,1,3226880,3239767,-,12887
303,BUMA.1121.00008,1,2491476,2504338,+,12862
303,BUMA.1121.00003,1,833219,846104,+,12885
303,BUMA.1121.00109,1,3559949,3572835,-,12886
303,BUMA.1121.00053,1,2036853,2049742,+,12889
303,BUMA.1121.00110,1,2471814,2484717,-,12903
303,BUMA.1121.00104,1,2905136,2918122,-,12986
303,BUMA.1121.00086,1,1166088,1178950,+,12862
303,BUMA.1121.00092,1,1475415,1488303,-,12888
303,BUMA.1121.00096,1,922249,935138,-,12889
303,BUMA.1121.00054,1,2661632,2674493,-,12861
303,BUMA.1121.00097,1,1590081,1603014,-,12933
303,BUMA.1121.00093,1,3137979,3150868,+,12889
303,BUMA.1121.00106,1,2071877,2084767,+,12890
303,BUMA.1121.00010,1,28563,41424,+,12861
303,BUMA.1121.00035,1,3451353,3464227,+,12874
303,BUMA.1121.00108,1,3335226,3348147,+,12921
303,BUMA.1121.00028,1,2479795,2492657,+,12862
303,BUMA.1121.00094,1,2315884,2328782,+,12898
303,BUMA.1121.00102,1,2994775,3007663,-,12888
303,BUMA.1121.00111,1,2488190,2501064,+,12874
303,BUMA.1121.00089,1,2285554,2298461,+,12907
303,BUMA.1121.00084,1,2699264,2712154,+,12890
303,BUMA.1121.00029,1,2624419,2637292,-,12873
303,BUMA.1121.00012,1,1050416,1063290,+,12874
303,BUMA.1121.00087,1,2137838,2150699,-,12861
303,BUMA.1121.00043,1,2392560,2405528,+,12968
303,BUMA.1121.00046,1,3032492,3045354,+,12862
303,BUMA.1121.00037,1,938373,951247,+,12874
303,BUMA.1121.00080,1,2328555,2341443,+,12888
303,BUMA.1121.00079,1,2324500,2337388,+,12888
303,BUMA.1121.00045,1,1716975,1729888,-,12913
303,BUMA.1121.00071,1,1530588,1543462,-,12874
303,BUMA.1121.00056,1,1628109,1641015,-,12906
303,BUMA.1121.00065,1,2401899,2414789,+,12890
303,BUMA.1121.00058,1,2230975,2243854,-,12879
303,BUMA.1121.00007,1,1761606,1774483,-,12877
303,BUMA.1121.00067,1,2074100,2086989,-,12889
303,BUMA.1121.00090,1,412688,425554,+,12866
303,BUMA.1121.00051,1,2298378,2311267,+,12889
303,BUMA.1121.00020,1,2544682,2557544,+,12862
303,BUMA.1121.00103,1,2099032,2111908,-,12876
303,BUMA.1121.00048,1,1261219,1274081,+,12862
303,BUMA.1121.00047,1,649711,662599,-,12888
303,BUMA.1121.00042,1,1917295,1930157,+,12862
303,BUMA.1121.00055,1,1927372,1940268,+,12896
303,BUMA.1121.00031,1,3733143,3746044,+,12901
303,BUMA.1121.00040,1,2489764,2502625,+,12861
303,BUMA.1121.00044,1,1745317,1758179,+,12862
303,BUMA.1121.00088,1,3244045,3256935,+,12890
303,BUMA.1121.00069,1,1493371,1506245,-,12874
303,BUMA.1121.00064,1,2340625,2353510,+,12885
303,BUMA.1121.00105,1,2898197,2911073,-,12876
303,BUMA.1121.00015,1,1563609,1576470,-,12861
303,BUMA.1121.00059,1,1516604,1529490,+,12886
303,BUMA.1121.00026,1,3343524,3356385,+,12861
303,BUMA.1121.00022,1,2896787,2909664,+,12877
303,BUMA.1121.00052,1,2289621,2302483,+,12862
303,BUMA.1121.00101,1,145472,158363,-,12891
303,BUMA.1121.00001,1,1742619,1755491,-,12872
303,BUMA.1121.00038,1,1468706,1481568,+,12862
303,BUMA.1121.00068,1,1068473,1081359,+,12886
303,BUMA.1121.00099,1,18279,31168,-,12889
303,BUMA.1121.00091,1,2176224,2189140,-,12916
303,BUMA.1121.00098,1,954103,966978,+,12875
303,BUMA.1121.00013,1,2569932,2582794,+,12862
303,BUMA.1121.00049,1,3537781,3550659,-,12878
303,BUMA.1121.00072,1,1513114,1525988,-,12874
303,BUMA.1121.00076,1,3023214,3036093,-,12879
303,BUMA.1121.00083,1,3326893,3339767,-,12874
303,BUMA.1121.00078,1,3713696,3726580,-,12884
303,BUMA.1121.00095,1,3367950,3380836,-,12886
303,BUMA.1121.00077,1,998515,1011419,+,12904
303,BUMA.1121.00063,1,1537661,1550535,-,12874
303,BUMA.1121.00061,1,1540563,1553379,-,12816
303,BUMA.1121.00050,1,3215856,3228717,-,12861
303,BUMA.1121.00081,1,1468769,1481631,+,12862
303,BUMA.1121.00074,1,1519410,1532299,-,12889
303,BUMA.1121.00062,1,2254913,2267804,-,12891
303,BUMA.1121.00060,1,3963820,3976733,-,12913
303,BUMA.1121.00070,1,1511475,1524316,-,12841
303,BUMA.1121.00075,1,1777980,1790858,+,12878
303,BUMA.1121.00041,1,3620442,3633327,+,12885
303,BUMA.1121.00073,1,1538727,1551592,-,12865
303,BUMA.1121.00017,1,2414851,2427713,+,12862
303,BUMA.1121.00066,1,1514657,1527531,-,12874
303,BUMA.1121.00107,1,2202798,2215680,+,12882
303,BUMA.1121.00085,1,1886567,1899429,+,12862
303,BUMA.1121.00030,1,2414883,2427745,+,12862
303,BUMA.1121.00112,1,645127,657994,-,12867
303,BUMA.1121.00002,1,52613,65475,+,12862
303,BUMA.1121.00082,1,1671315,1684189,-,12874
303,BUMA.1121.00014,1,471118,483991,-,12873
303,BUMA.1121.00011,1,3319179,3332052,-,12873
303,BUMA.1121.00019,1,2444745,2457607,+,12862
303,BUMA.1121.00057,1,3408457,3421332,+,12875
303,BUMA.1121.00018,1,2924564,2937438,+,12874
303,BUMA.1121.00039,1,2432600,2445474,+,12874
303,BUMA.1121.00016,1,436775,449640,+,12865
303,BUMA.1121.00004,1,2479717,2492579,+,12862
303,BUMA.1121.00005,1,1041245,1054137,+,12892
303,BUMA.1121.00100,1,3017505,3030393,-,12888
303,BUMA.1121.00006,1,1468689,1481551,+,12862
302,BUMA.1121.00027,1,477063,483246,+,6183
302,BUMA.1121.00025,1,335823,341919,-,6096
302,BUMA.1121.00021,1,2927329,2933465,+,6136
302,BUMA.1121.00023,1,636945,643049,+,6104
302,BUMA.1121.00033,1,445096,451225,+,6129
302,BUMA.1121.00009,1,3240469,3246571,-,6102
302,BUMA.1121.00003,1,826390,832517,+,6127
302,BUMA.1121.00109,1,3573537,3579627,-,6090
302,BUMA.1121.00053,1,2030063,2036151,+,6088
302,BUMA.1121.00110,1,2485419,2491509,-,6090
302,BUMA.1121.00104,1,2918824,2924926,-,6102
302,BUMA.1121.00092,1,1489005,1495107,-,6102
302,BUMA.1121.00096,1,935840,941942,-,6102
302,BUMA.1121.00097,1,1603716,1609805,-,6089
302,BUMA.1121.00093,1,3131120,3137277,+,6157
302,BUMA.1121.00106,1,2065050,2071175,+,6125
302,BUMA.1121.00035,1,3444491,3450651,+,6160
302,BUMA.1121.00108,1,3328377,3334524,+,6147
302,BUMA.1121.00094,1,2309065,2315182,+,6117
302,BUMA.1121.00102,1,3008365,3014441,-,6076
302,BUMA.1121.00111,1,2481352,2487488,+,6136
302,BUMA.1121.00089,1,2278591,2284852,+,6261
302,BUMA.1121.00084,1,2692442,2698562,+,6120
302,BUMA.1121.00029,1,2637994,2644083,-,6089
302,BUMA.1121.00012,1,1043594,1049714,+,6120
302,BUMA.1121.00043,1,2385618,2391858,+,6240
302,BUMA.1121.00037,1,931583,937671,+,6088
302,BUMA.1121.00080,1,2321692,2327853,+,6161
302,BUMA.1121.00079,1,2317581,2323798,+,6217
302,BUMA.1121.00045,1,1730590,1736653,-,6063
302,BUMA.1121.00071,1,1544164,1550253,-,6089
302,BUMA.1121.00056,1,1641717,1647819,-,6102
302,BUMA.1121.00065,1,2395069,2401197,+,6128
302,BUMA.1121.00058,1,2244556,2250645,-,6089
302,BUMA.1121.00007,1,1775185,1781277,-,6092
302,BUMA.1121.00067,1,2087691,2093793,-,6102
302,BUMA.1121.00090,1,405850,411986,+,6136
302,BUMA.1121.00051,1,2291443,2297676,+,6233
302,BUMA.1121.00103,1,2112610,2118700,-,6090
302,BUMA.1121.00047,1,663301,669391,-,6090
302,BUMA.1121.00055,1,1920526,1926670,+,6144
302,BUMA.1121.00031,1,3726233,3732441,+,6208
302,BUMA.1121.00088,1,3237231,3243343,+,6112
302,BUMA.1121.00069,1,1506947,1513036,-,6089
302,BUMA.1121.00064,1,2333782,2339923,+,6141
302,BUMA.1121.00105,1,2911775,2917863,-,6088
302,BUMA.1121.00059,1,1509813,1515902,+,6089
302,BUMA.1121.00101,1,159065,165154,-,6089
302,BUMA.1121.00001,1,1756193,1762282,-,6089
302,BUMA.1121.00068,1,1061650,1067771,+,6121
302,BUMA.1121.00099,1,31870,37960,-,6090
302,BUMA.1121.00091,1,2189842,2195931,-,6089
302,BUMA.1121.00098,1,947302,953401,+,6099
302,BUMA.1121.00049,1,3551361,3557463,-,6102
302,BUMA.1121.00072,1,1526690,1532779,-,6089
302,BUMA.1121.00076,1,3036795,3042884,-,6089
302,BUMA.1121.00083,1,3340469,3346558,-,6089
302,BUMA.1121.00078,1,3727282,3733372,-,6090
302,BUMA.1121.00095,1,3381538,3387626,-,6088
302,BUMA.1121.00077,1,991660,997813,+,6153
302,BUMA.1121.00063,1,1551237,1557326,-,6089
302,BUMA.1121.00061,1,1554081,1560170,-,6089
302,BUMA.1121.00074,1,1533001,1539103,-,6102
302,BUMA.1121.00062,1,2268506,2274608,-,6102
302,BUMA.1121.00060,1,3977435,3983498,-,6063
302,BUMA.1121.00070,1,1525018,1531107,-,6089
302,BUMA.1121.00075,1,1771190,1777278,+,6088
302,BUMA.1121.00041,1,3613614,3619740,+,6126
302,BUMA.1121.00073,1,1552294,1558383,-,6089
302,BUMA.1121.00066,1,1528233,1534322,-,6089
302,BUMA.1121.00107,1,2195951,2202096,+,6145
302,BUMA.1121.00112,1,658696,664784,-,6088
302,BUMA.1121.00082,1,1684891,1690980,-,6089
302,BUMA.1121.00014,1,484693,490774,-,6081
302,BUMA.1121.00011,1,3332754,3338837,-,6083
302,BUMA.1121.00057,1,3401524,3407755,+,6231
302,BUMA.1121.00018,1,2917711,2923862,+,6151
302,BUMA.1121.00039,1,2425738,2431898,+,6160
302,BUMA.1121.00016,1,429865,436073,+,6208
302,BUMA.1121.00005,1,1034423,1040543,+,6120
302,BUMA.1121.00100,1,3031095,3037185,-,6090
301,BUMA.1121.00027,1,452104,474760,+,22656
301,BUMA.1121.00025,1,344269,366928,-,22659
301,BUMA.1121.00021,1,2902408,2925050,+,22642
301,BUMA.1121.00023,1,612044,634666,+,22622
301,BUMA.1121.00024,1,2450990,2473622,+,22632
301,BUMA.1121.00033,1,420194,442820,+,22626
301,BUMA.1121.00034,1,2489718,2512350,+,22632
301,BUMA.1121.00036,1,1638727,1661360,-,22633
301,BUMA.1121.00032,1,519168,541800,+,22632
301,BUMA.1121.00009,1,3248873,3271486,-,22613
301,BUMA.1121.00008,1,2463990,2486622,+,22632
301,BUMA.1121.00003,1,801356,824101,+,22745
301,BUMA.1121.00109,1,3581959,3604631,-,22672
301,BUMA.1121.00053,1,2004999,2027784,+,22785
301,BUMA.1121.00110,1,2493873,2516506,-,22633
301,BUMA.1121.00104,1,2927294,2950027,-,22733
301,BUMA.1121.00086,1,1138579,1161211,+,22632
301,BUMA.1121.00092,1,1497456,1520074,-,22618
301,BUMA.1121.00096,1,944339,966959,-,22620
301,BUMA.1121.00054,1,2679371,2702004,-,22633
301,BUMA.1121.00097,1,1612112,1634732,-,22620
301,BUMA.1121.00093,1,3106209,3128826,+,22617
301,BUMA.1121.00106,1,2040021,2062762,+,22741
301,BUMA.1121.00010,1,80,22712,+,22632
301,BUMA.1121.00035,1,3419577,3442212,+,22635
301,BUMA.1121.00108,1,3303487,3326091,+,22604
301,BUMA.1121.00028,1,2452309,2474941,+,22632
301,BUMA.1121.00094,1,2284036,2306768,+,22732
301,BUMA.1121.00102,1,3016760,3039450,-,22690
301,BUMA.1121.00111,1,2456455,2479073,+,22618
301,BUMA.1121.00089,1,2253562,2276294,+,22732
301,BUMA.1121.00084,1,2667411,2690153,+,22742
301,BUMA.1121.00029,1,2646457,2669093,-,22636
301,BUMA.1121.00012,1,1018697,1041315,+,22618
301,BUMA.1121.00087,1,2155576,2178209,-,22633
301,BUMA.1121.00043,1,2360712,2383339,+,22627
301,BUMA.1121.00046,1,2566733,2589366,-,22633
301,BUMA.1121.00037,1,906678,929304,+,22626
301,BUMA.1121.00080,1,2296664,2319395,+,22731
301,BUMA.1121.00079,1,2292560,2315284,+,22724
301,BUMA.1121.00045,1,1738947,1761590,-,22643
301,BUMA.1121.00071,1,1552548,1575290,-,22742
301,BUMA.1121.00056,1,1650259,1672992,-,22733
301,BUMA.1121.00065,1,2370149,2392781,+,22632
301,BUMA.1121.00058,1,2252946,2275679,-,22733
301,BUMA.1121.00007,1,1783662,1806341,-,22679
301,BUMA.1121.00067,1,2096233,2118971,-,22738
301,BUMA.1121.00090,1,380944,403571,+,22627
301,BUMA.1121.00051,1,2266395,2289125,+,22730
301,BUMA.1121.00020,1,2517196,2539828,+,22632
301,BUMA.1121.00103,1,2121003,2143660,-,22657
301,BUMA.1121.00048,1,1233709,1256341,+,22632
301,BUMA.1121.00047,1,671815,694547,-,22732
301,BUMA.1121.00042,1,1890464,1913083,+,22619
301,BUMA.1121.00055,1,1895563,1918238,+,22675
301,BUMA.1121.00031,1,3701322,3723954,+,22632
301,BUMA.1121.00040,1,1891202,1913826,-,22624
301,BUMA.1121.00044,1,1717831,1740463,+,22632
301,BUMA.1121.00088,1,3212202,3234934,+,22732
301,BUMA.1121.00069,1,1515331,1538084,-,22753
301,BUMA.1121.00064,1,2308756,2331493,+,22737
301,BUMA.1121.00105,1,2920205,2942833,-,22628
301,BUMA.1121.00015,1,1581332,1603965,-,22633
301,BUMA.1121.00059,1,1484795,1507526,+,22731
301,BUMA.1121.00026,1,3315702,3338321,+,22619
301,BUMA.1121.00022,1,2869301,2891933,+,22632
301,BUMA.1121.00052,1,2262208,2284840,+,22632
301,BUMA.1121.00101,1,167463,190086,-,22623
301,BUMA.1121.00001,1,1764672,1787298,-,22626
301,BUMA.1121.00038,1,1441196,1463828,+,22632
301,BUMA.1121.00068,1,1035399,1058043,+,22644
301,BUMA.1121.00099,1,40310,62926,-,22616
301,BUMA.1121.00091,1,2198289,2220933,-,22644
301,BUMA.1121.00098,1,922386,945013,+,22627
301,BUMA.1121.00013,1,2542406,2565038,+,22632
301,BUMA.1121.00049,1,3559759,3582507,-,22748
301,BUMA.1121.00072,1,1535074,1557782,-,22708
301,BUMA.1121.00076,1,3045179,3067828,-,22649
301,BUMA.1121.00083,1,3348853,3371637,-,22784
301,BUMA.1121.00078,1,3735759,3758350,-,22591
301,BUMA.1121.00095,1,3390007,3412663,-,22656
301,BUMA.1121.00077,1,966729,989359,+,22630
301,BUMA.1121.00063,1,1559621,1582374,-,22753
301,BUMA.1121.00061,1,1562465,1585218,-,22753
301,BUMA.1121.00050,1,162371,185003,+,22632
301,BUMA.1121.00081,1,1441259,1463891,+,22632
301,BUMA.1121.00074,1,1541390,1564143,-,22753
301,BUMA.1121.00062,1,2276895,2299511,-,22616
301,BUMA.1121.00060,1,3985792,4008435,-,22643
301,BUMA.1121.00070,1,1533402,1556151,-,22749
301,BUMA.1121.00075,1,1746249,1768896,+,22647
301,BUMA.1121.00041,1,3588645,3611294,+,22649
301,BUMA.1121.00073,1,1560678,1583451,-,22773
301,BUMA.1121.00017,1,2387365,2409997,+,22632
301,BUMA.1121.00066,1,1536617,1559370,-,22753
301,BUMA.1121.00107,1,2171056,2193656,+,22600
301,BUMA.1121.00085,1,1859154,1881786,+,22632
301,BUMA.1121.00030,1,2387399,2410029,+,22630
301,BUMA.1121.00112,1,667163,689774,-,22611
301,BUMA.1121.00002,1,24130,46762,+,22632
301,BUMA.1121.00082,1,1693275,1716059,-,22784
301,BUMA.1121.00014,1,493052,515678,-,22626
301,BUMA.1121.00011,1,3341311,3363954,-,22643
301,BUMA.1121.00019,1,2417259,2439891,+,22632
301,BUMA.1121.00057,1,3376582,3399237,+,22655
301,BUMA.1121.00018,1,2892744,2915432,+,22688
301,BUMA.1121.00039,1,2400825,2423466,+,22641
301,BUMA.1121.00016,1,404974,427586,+,22612
301,BUMA.1121.00004,1,2452231,2474863,+,22632
301,BUMA.1121.00005,1,1009486,1032143,+,22657
301,BUMA.1121.00100,1,3039566,3062163,-,22597
301,BUMA.1121.00006,1,1441179,1463811,+,22632
300,BUMA.1121.00027,1,448549,451857,+,3308
300,BUMA.1121.00025,1,367163,370477,-,3314
300,BUMA.1121.00021,1,2898846,2902161,+,3315
300,BUMA.1121.00023,1,608477,611791,+,3314
300,BUMA.1121.00024,1,2447466,2450774,+,3308
300,BUMA.1121.00033,1,416640,419954,+,3314
300,BUMA.1121.00034,1,2486194,2489502,+,3308
300,BUMA.1121.00036,1,1661576,1664883,-,3307
300,BUMA.1121.00032,1,515644,518952,+,3308
300,BUMA.1121.00009,1,3271744,3275057,-,3313
300,BUMA.1121.00008,1,2460466,2463774,+,3308
300,BUMA.1121.00003,1,797795,801108,+,3313
300,BUMA.1121.00109,1,3604896,3608209,-,3313
300,BUMA.1121.00053,1,2001472,2004767,+,3295
300,BUMA.1121.00110,1,2516724,2520037,-,3313
300,BUMA.1121.00104,1,2950283,2953580,-,3297
300,BUMA.1121.00086,1,1135055,1138363,+,3308
300,BUMA.1121.00092,1,1520333,1523646,-,3313
300,BUMA.1121.00096,1,967194,970507,-,3313
300,BUMA.1121.00054,1,2702220,2705527,-,3307
300,BUMA.1121.00097,1,1634961,1638274,-,3313
300,BUMA.1121.00093,1,3102636,3105950,+,3314
300,BUMA.1121.00106,1,2036463,2039771,+,3308
300,BUMA.1121.00010,1,3529881,3533189,+,3308
300,BUMA.1121.00035,1,3416015,3419329,+,3314
300,BUMA.1121.00108,1,3299915,3303229,+,3314
300,BUMA.1121.00028,1,2448785,2452093,+,3308
300,BUMA.1121.00094,1,2280484,2283792,+,3308
300,BUMA.1121.00102,1,3039706,3042997,-,3291
300,BUMA.1121.00111,1,2452880,2456196,+,3316
300,BUMA.1121.00089,1,2250010,2253318,+,3308
300,BUMA.1121.00084,1,2663866,2667164,+,3298
300,BUMA.1121.00029,1,2669341,2672654,-,3313
300,BUMA.1121.00012,1,1015136,1018450,+,3314
300,BUMA.1121.00087,1,2178425,2181732,-,3307
300,BUMA.1121.00043,1,2357157,2360471,+,3314
300,BUMA.1121.00046,1,2589582,2592889,-,3307
300,BUMA.1121.00037,1,903111,906425,+,3314
300,BUMA.1121.00080,1,2293106,2296414,+,3308
300,BUMA.1121.00079,1,2289000,2292314,+,3314
300,BUMA.1121.00045,1,1761843,1765156,-,3313
300,BUMA.1121.00071,1,1575543,1578841,-,3298
300,BUMA.1121.00056,1,1673236,1676543,-,3307
300,BUMA.1121.00065,1,2366619,2369921,+,3302
300,BUMA.1121.00058,1,2275932,2279245,-,3313
300,BUMA.1121.00007,1,1806594,1809902,-,3308
300,BUMA.1121.00067,1,2119218,2122525,-,3307
300,BUMA.1121.00090,1,377383,380697,+,3314
300,BUMA.1121.00051,1,2262837,2266145,+,3308
300,BUMA.1121.00020,1,2513672,2516980,+,3308
300,BUMA.1121.00103,1,2143919,2147232,-,3313
300,BUMA.1121.00048,1,1230185,1233493,+,3308
300,BUMA.1121.00047,1,694791,698098,-,3307
300,BUMA.1121.00042,1,1886940,1890248,+,3308
300,BUMA.1121.00055,1,1891985,1895283,+,3298
300,BUMA.1121.00031,1,3697761,3701075,+,3314
300,BUMA.1121.00040,1,1914042,1917349,-,3307
300,BUMA.1121.00044,1,1714307,1717615,+,3308
300,BUMA.1121.00088,1,3208663,3211961,+,3298
300,BUMA.1121.00069,1,1538340,1541635,-,3295
300,BUMA.1121.00064,1,2305201,2308509,+,3308
300,BUMA.1121.00105,1,2943098,2946395,-,3297
300,BUMA.1121.00015,1,1604181,1607488,-,3307
300,BUMA.1121.00059,1,1481243,1484539,+,3296
300,BUMA.1121.00026,1,3312178,3315486,+,3308
300,BUMA.1121.00022,1,2865777,2869085,+,3308
300,BUMA.1121.00052,1,2258684,2261992,+,3308
300,BUMA.1121.00101,1,190356,193680,-,3324
300,BUMA.1121.00001,1,1787546,1790859,-,3313
300,BUMA.1121.00038,1,1437672,1440980,+,3308
300,BUMA.1121.00068,1,1031790,1035110,+,3320
300,BUMA.1121.00099,1,63161,66463,-,3302
300,BUMA.1121.00091,1,2221177,2224474,-,3297
300,BUMA.1121.00098,1,918832,922146,+,3314
300,BUMA.1121.00013,1,2538882,2542190,+,3308
300,BUMA.1121.00049,1,3582751,3586058,-,3307
300,BUMA.1121.00072,1,1558035,1561333,-,3298
300,BUMA.1121.00076,1,3068093,3071391,-,3298
300,BUMA.1121.00083,1,3371890,3375188,-,3298
300,BUMA.1121.00078,1,3758600,3761898,-,3298
300,BUMA.1121.00095,1,3412916,3416226,-,3310
300,BUMA.1121.00077,1,963196,966511,+,3315
300,BUMA.1121.00063,1,1582627,1585925,-,3298
300,BUMA.1121.00061,1,1585471,1588769,-,3298
300,BUMA.1121.00050,1,158847,162155,+,3308
300,BUMA.1121.00081,1,1437735,1441043,+,3308
300,BUMA.1121.00074,1,1564390,1567697,-,3307
300,BUMA.1121.00062,1,2299770,2303077,-,3307
300,BUMA.1121.00060,1,4008688,4012001,-,3313
300,BUMA.1121.00070,1,1556399,1559697,-,3298
300,BUMA.1121.00075,1,1742685,1745984,+,3299
300,BUMA.1121.00041,1,3585080,3588386,+,3306
300,BUMA.1121.00073,1,1583704,1587002,-,3298
300,BUMA.1121.00017,1,2383841,2387149,+,3308
300,BUMA.1121.00066,1,1559623,1562921,-,3298
300,BUMA.1121.00107,1,2167501,2170815,+,3314
300,BUMA.1121.00085,1,1855630,1858938,+,3308
300,BUMA.1121.00030,1,2383875,2387183,+,3308
300,BUMA.1121.00112,1,690021,693334,-,3313
300,BUMA.1121.00002,1,20606,23914,+,3308
300,BUMA.1121.00082,1,1716312,1719610,-,3298
300,BUMA.1121.00014,1,515925,519238,-,3313
300,BUMA.1121.00011,1,3364201,3367512,-,3311
300,BUMA.1121.00019,1,2413735,2417043,+,3308
300,BUMA.1121.00057,1,3373037,3376335,+,3298
300,BUMA.1121.00018,1,2889195,2892510,+,3315
300,BUMA.1121.00039,1,2397276,2400590,+,3314
300,BUMA.1121.00016,1,401426,404728,+,3302
300,BUMA.1121.00004,1,2448707,2452015,+,3308
300,BUMA.1121.00005,1,1005956,1009254,+,3298
300,BUMA.1121.00100,1,3062374,3065687,-,3313
300,BUMA.1121.00006,1,1437655,1440963,+,3308
299,BUMA.1121.00027,1,441075,444652,+,3577
299,BUMA.1121.00025,1,374353,377963,-,3610
299,BUMA.1121.00021,1,2891359,2894948,+,3589
299,BUMA.1121.00023,1,600991,604580,+,3589
299,BUMA.1121.00024,1,2439999,2443569,+,3570
299,BUMA.1121.00033,1,409154,412743,+,3589
299,BUMA.1121.00034,1,2478727,2482297,+,3570
299,BUMA.1121.00036,1,1668759,1672350,-,3591
299,BUMA.1121.00032,1,508177,511747,+,3570
299,BUMA.1121.00009,1,3278933,3282534,-,3601
299,BUMA.1121.00008,1,2452999,2456569,+,3570
299,BUMA.1121.00003,1,790310,793898,+,3588
299,BUMA.1121.00109,1,3612085,3615702,-,3617
299,BUMA.1121.00053,1,1994005,1997575,+,3570
299,BUMA.1121.00110,1,2523913,2527538,-,3625
299,BUMA.1121.00104,1,2958801,2962391,-,3590
299,BUMA.1121.00086,1,1127588,1131158,+,3570
299,BUMA.1121.00092,1,1529113,1532730,-,3617
299,BUMA.1121.00096,1,974384,977995,-,3611
299,BUMA.1121.00054,1,2709403,2712994,-,3591
299,BUMA.1121.00097,1,1642150,1645762,-,3612
299,BUMA.1121.00093,1,3093552,3097148,+,3596
299,BUMA.1121.00106,1,2028970,2032566,+,3596
299,BUMA.1121.00010,1,3522414,3525984,+,3570
299,BUMA.1121.00035,1,3408521,3412118,+,3597
299,BUMA.1121.00108,1,3292440,3296019,+,3579
299,BUMA.1121.00028,1,2441318,2444888,+,3570
299,BUMA.1121.00094,1,2273007,2276587,+,3580
299,BUMA.1121.00102,1,3046873,3050474,-,3601
299,BUMA.1121.00111,1,2445394,2448983,+,3589
299,BUMA.1121.00089,1,2242533,2246113,+,3580
299,BUMA.1121.00084,1,2656378,2659969,+,3591
299,BUMA.1121.00029,1,2676530,2680148,-,3618
299,BUMA.1121.00012,1,1007650,1011239,+,3589
299,BUMA.1121.00087,1,2185608,2189199,-,3591
299,BUMA.1121.00043,1,2349671,2353260,+,3589
299,BUMA.1121.00046,1,2596765,2600356,-,3591
299,BUMA.1121.00037,1,895625,899214,+,3589
299,BUMA.1121.00080,1,2285629,2289209,+,3580
299,BUMA.1121.00079,1,2281508,2285104,+,3596
299,BUMA.1121.00045,1,1769032,1772642,-,3610
299,BUMA.1121.00071,1,1582717,1586322,-,3605
299,BUMA.1121.00056,1,1680419,1684020,-,3601
299,BUMA.1121.00065,1,2359125,2362722,+,3597
299,BUMA.1121.00058,1,2283143,2286733,-,3590
299,BUMA.1121.00007,1,1813778,1817387,-,3609
299,BUMA.1121.00067,1,2126423,2130013,-,3590
299,BUMA.1121.00090,1,369897,373486,+,3589
299,BUMA.1121.00051,1,2255360,2258940,+,3580
299,BUMA.1121.00020,1,2506205,2509775,+,3570
299,BUMA.1121.00103,1,2151130,2154713,-,3583
299,BUMA.1121.00048,1,1222718,1226288,+,3570
299,BUMA.1121.00047,1,701974,705579,-,3605
299,BUMA.1121.00042,1,1877885,1881455,+,3570
299,BUMA.1121.00055,1,1884490,1888088,+,3598
299,BUMA.1121.00031,1,3690275,3693864,+,3589
299,BUMA.1121.00040,1,1921225,1924826,-,3601
299,BUMA.1121.00044,1,1706840,1710410,+,3570
299,BUMA.1121.00088,1,3201186,3204766,+,3580
299,BUMA.1121.00069,1,1545511,1549116,-,3605
299,BUMA.1121.00064,1,2297713,2301304,+,3591
299,BUMA.1121.00105,1,2950271,2953872,-,3601
299,BUMA.1121.00015,1,1611364,1614955,-,3591
299,BUMA.1121.00059,1,1473762,1477346,+,3584
299,BUMA.1121.00026,1,3303119,3306689,+,3570
299,BUMA.1121.00022,1,2858310,2861880,+,3570
299,BUMA.1121.00052,1,2251217,2254787,+,3570
299,BUMA.1121.00101,1,197578,201159,-,3581
299,BUMA.1121.00001,1,1794735,1798353,-,3618
299,BUMA.1121.00038,1,1430205,1433775,+,3570
299,BUMA.1121.00068,1,1024297,1027893,+,3596
299,BUMA.1121.00099,1,70339,73953,-,3614
299,BUMA.1121.00091,1,2228350,2231951,-,3601
299,BUMA.1121.00098,1,911347,914936,+,3589
299,BUMA.1121.00013,1,2531415,2534985,+,3570
299,BUMA.1121.00049,1,3589934,3593535,-,3601
299,BUMA.1121.00072,1,1565209,1568814,-,3605
299,BUMA.1121.00076,1,3075289,3078863,-,3574
299,BUMA.1121.00083,1,3379064,3382669,-,3605
299,BUMA.1121.00078,1,3765774,3769383,-,3609
299,BUMA.1121.00095,1,3420102,3423711,-,3609
299,BUMA.1121.00077,1,955695,959299,+,3604
299,BUMA.1121.00063,1,1589801,1593406,-,3605
299,BUMA.1121.00061,1,1592645,1596247,-,3602
299,BUMA.1121.00050,1,151380,154950,+,3570
299,BUMA.1121.00081,1,1430266,1433838,+,3572
299,BUMA.1121.00074,1,1571595,1575185,-,3590
299,BUMA.1121.00062,1,2306975,2310565,-,3590
299,BUMA.1121.00060,1,4015877,4019503,-,3626
299,BUMA.1121.00070,1,1563573,1567178,-,3605
299,BUMA.1121.00075,1,1735213,1738788,+,3575
299,BUMA.1121.00041,1,3577603,3581183,+,3580
299,BUMA.1121.00073,1,1590878,1594483,-,3605
299,BUMA.1121.00017,1,2376374,2379944,+,3570
299,BUMA.1121.00066,1,1566797,1570402,-,3605
299,BUMA.1121.00107,1,2159988,2163604,+,3616
299,BUMA.1121.00085,1,1848163,1851733,+,3570
299,BUMA.1121.00030,1,2376408,2379978,+,3570
299,BUMA.1121.00112,1,697210,700819,-,3609
299,BUMA.1121.00002,1,13139,16709,+,3570
299,BUMA.1121.00082,1,1723486,1727091,-,3605
299,BUMA.1121.00014,1,523114,526724,-,3610
299,BUMA.1121.00011,1,3371388,3375010,-,3622
299,BUMA.1121.00019,1,2406268,2409838,+,3570
299,BUMA.1121.00057,1,3365546,3369140,+,3594
299,BUMA.1121.00018,1,2881709,2885298,+,3589
299,BUMA.1121.00039,1,2389790,2393379,+,3589
299,BUMA.1121.00016,1,393940,397529,+,3589
299,BUMA.1121.00004,1,2441240,2444810,+,3570
299,BUMA.1121.00005,1,998483,1002059,+,3576
299,BUMA.1121.00100,1,3069584,3073173,-,3589
299,BUMA.1121.00006,1,1430188,1433758,+,3570
298,BUMA.1121.00027,1,428130,441074,+,12944
298,BUMA.1121.00025,1,377965,390906,-,12941
298,BUMA.1121.00021,1,2878417,2891358,+,12941
298,BUMA.1121.00023,1,588049,600990,+,12941
298,BUMA.1121.00024,1,2427048,2439998,+,12950
298,BUMA.1121.00033,1,396212,409153,+,12941
298,BUMA.1121.00034,1,2465776,2478726,+,12950
298,BUMA.1121.00036,1,1672352,1685302,-,12950
298,BUMA.1121.00032,1,495226,508176,+,12950
298,BUMA.1121.00009,1,3282536,3295487,-,12951
298,BUMA.1121.00008,1,2440048,2452998,+,12950
298,BUMA.1121.00003,1,777357,790309,+,12952
298,BUMA.1121.00109,1,3615704,3628660,-,12956
298,BUMA.1121.00053,1,1981060,1994004,+,12944
298,BUMA.1121.00110,1,2527540,2540481,-,12941
298,BUMA.1121.00104,1,2962393,2975346,-,12953
298,BUMA.1121.00086,1,1114637,1127587,+,12950
298,BUMA.1121.00092,1,1532732,1546998,-,14266
298,BUMA.1121.00096,1,977997,990935,-,12938
298,BUMA.1121.00054,1,2712996,2725946,-,12950
298,BUMA.1121.00097,1,1645764,1658715,-,12951
298,BUMA.1121.00093,1,3079285,3093551,+,14266
298,BUMA.1121.00106,1,2016016,2028969,+,12953
298,BUMA.1121.00010,1,3509463,3522413,+,12950
298,BUMA.1121.00035,1,3395579,3408520,+,12941
298,BUMA.1121.00108,1,3279467,3292439,+,12972
298,BUMA.1121.00028,1,2428367,2441317,+,12950
298,BUMA.1121.00094,1,2260056,2273006,+,12950
298,BUMA.1121.00102,1,3050476,3063417,-,12941
298,BUMA.1121.00111,1,2431139,2445393,+,14254
298,BUMA.1121.00089,1,2229582,2242532,+,12950
298,BUMA.1121.00084,1,2643432,2656377,+,12945
298,BUMA.1121.00029,1,2680150,2693092,-,12942
298,BUMA.1121.00012,1,994708,1007649,+,12941
298,BUMA.1121.00087,1,2189201,2202151,-,12950
298,BUMA.1121.00043,1,2336729,2349670,+,12941
298,BUMA.1121.00046,1,2600358,2613308,-,12950
298,BUMA.1121.00037,1,882683,895624,+,12941
298,BUMA.1121.00080,1,2272678,2285628,+,12950
298,BUMA.1121.00079,1,2268557,2281507,+,12950
298,BUMA.1121.00045,1,1772644,1785595,-,12951
298,BUMA.1121.00071,1,1586324,1599268,-,12944
298,BUMA.1121.00056,1,1684022,1696974,-,12952
298,BUMA.1121.00065,1,2346177,2359124,+,12947
298,BUMA.1121.00058,1,2286735,2299688,-,12953
298,BUMA.1121.00007,1,1817389,1830331,-,12942
298,BUMA.1121.00067,1,2130015,2142968,-,12953
298,BUMA.1121.00090,1,356955,369896,+,12941
298,BUMA.1121.00051,1,2242410,2255359,+,12949
298,BUMA.1121.00020,1,2493254,2506204,+,12950
298,BUMA.1121.00103,1,2154715,2167702,-,12987
298,BUMA.1121.00048,1,1209767,1222717,+,12950
298,BUMA.1121.00047,1,705581,718531,-,12950
298,BUMA.1121.00042,1,1864934,1877884,+,12950
298,BUMA.1121.00055,1,1870229,1884489,+,14260
298,BUMA.1121.00031,1,3677333,3690274,+,12941
298,BUMA.1121.00040,1,1924828,1937778,-,12950
298,BUMA.1121.00044,1,1693889,1706839,+,12950
298,BUMA.1121.00088,1,3188241,3201185,+,12944
298,BUMA.1121.00069,1,1549118,1562070,-,12952
298,BUMA.1121.00064,1,2284759,2297712,+,12953
298,BUMA.1121.00105,1,2953874,2966830,-,12956
298,BUMA.1121.00015,1,1614957,1627907,-,12950
298,BUMA.1121.00059,1,1460817,1473761,+,12944
298,BUMA.1121.00026,1,3290169,3303118,+,12949
298,BUMA.1121.00022,1,2845359,2858309,+,12950
298,BUMA.1121.00052,1,2238266,2251216,+,12950
298,BUMA.1121.00101,1,201161,214102,-,12941
298,BUMA.1121.00001,1,1798355,1811296,-,12941
298,BUMA.1121.00038,1,1417254,1430204,+,12950
298,BUMA.1121.00068,1,1011345,1024296,+,12951
298,BUMA.1121.00099,1,73955,86854,-,12899
298,BUMA.1121.00091,1,2231953,2244893,-,12940
298,BUMA.1121.00098,1,898395,911346,+,12951
298,BUMA.1121.00013,1,2518464,2531414,+,12950
298,BUMA.1121.00049,1,3593537,3606487,-,12950
298,BUMA.1121.00072,1,1568816,1581730,-,12914
298,BUMA.1121.00076,1,3078865,3091809,-,12944
298,BUMA.1121.00083,1,3382671,3395624,-,12953
298,BUMA.1121.00078,1,3769385,3782335,-,12950
298,BUMA.1121.00095,1,3423713,3436670,-,12957
298,BUMA.1121.00077,1,942753,955694,+,12941
298,BUMA.1121.00063,1,1593408,1606360,-,12952
298,BUMA.1121.00061,1,1596249,1609201,-,12952
298,BUMA.1121.00050,1,138429,151379,+,12950
298,BUMA.1121.00081,1,1417315,1430265,+,12950
298,BUMA.1121.00074,1,1575187,1588140,-,12953
298,BUMA.1121.00062,1,2310567,2324833,-,14266
298,BUMA.1121.00060,1,1,12893,-,12892
298,BUMA.1121.00070,1,1567180,1580132,-,12952
298,BUMA.1121.00075,1,1722268,1735212,+,12944
298,BUMA.1121.00041,1,3564661,3577602,+,12941
298,BUMA.1121.00073,1,1594485,1607437,-,12952
298,BUMA.1121.00017,1,2363423,2376373,+,12950
298,BUMA.1121.00066,1,1570404,1583357,-,12953
298,BUMA.1121.00107,1,2147043,2159987,+,12944
298,BUMA.1121.00085,1,1835212,1848162,+,12950
298,BUMA.1121.00030,1,2363457,2376407,+,12950
298,BUMA.1121.00112,1,700821,713762,-,12941
298,BUMA.1121.00002,1,188,13138,+,12950
298,BUMA.1121.00082,1,1727093,1740046,-,12953
298,BUMA.1121.00014,1,526726,539668,-,12942
298,BUMA.1121.00011,1,3375012,3387965,-,12953
298,BUMA.1121.00019,1,2393317,2406267,+,12950
298,BUMA.1121.00057,1,3352601,3365545,+,12944
298,BUMA.1121.00018,1,2868767,2881708,+,12941
298,BUMA.1121.00039,1,2376848,2389789,+,12941
298,BUMA.1121.00016,1,380998,393939,+,12941
298,BUMA.1121.00004,1,2428289,2441239,+,12950
298,BUMA.1121.00005,1,985538,998482,+,12944
298,BUMA.1121.00100,1,3073175,3087411,-,14236
298,BUMA.1121.00006,1,1417237,1430187,+,12950
297,BUMA.1121.00027,1,400747,427684,+,26937
297,BUMA.1121.00025,1,391352,418302,-,26950
297,BUMA.1121.00021,1,2851034,2877971,+,26937
297,BUMA.1121.00023,1,560666,587603,+,26937
297,BUMA.1121.00024,1,2399682,2426602,+,26920
297,BUMA.1121.00033,1,368831,395766,+,26935
297,BUMA.1121.00034,1,2438410,2465330,+,26920
297,BUMA.1121.00036,1,1685748,1712668,-,26920
297,BUMA.1121.00032,1,467860,494780,+,26920
297,BUMA.1121.00009,1,3295933,3322896,-,26963
297,BUMA.1121.00008,1,2412682,2439602,+,26920
297,BUMA.1121.00003,1,749943,776911,+,26968
297,BUMA.1121.00109,1,3629106,3656073,-,26967
297,BUMA.1121.00053,1,1953674,1980614,+,26940
297,BUMA.1121.00110,1,2540943,2567875,-,26932
297,BUMA.1121.00104,1,2975792,3002759,-,26967
297,BUMA.1121.00086,1,1087271,1114191,+,26920
297,BUMA.1121.00092,1,1547444,1574386,-,26942
297,BUMA.1121.00096,1,991381,1018340,-,26959
297,BUMA.1121.00054,1,2726392,2753312,-,26920
297,BUMA.1121.00097,1,1659168,1687434,-,28266
297,BUMA.1121.00093,1,3051897,3078839,+,26942
297,BUMA.1121.00106,1,1988613,2015570,+,26957
297,BUMA.1121.00010,1,3482115,3509017,+,26902
297,BUMA.1121.00035,1,3368196,3395133,+,26937
297,BUMA.1121.00108,1,3252083,3279021,+,26938
297,BUMA.1121.00028,1,2401001,2427921,+,26920
297,BUMA.1121.00094,1,2232657,2259610,+,26953
297,BUMA.1121.00102,1,3063863,3090807,-,26944
297,BUMA.1121.00111,1,2403740,2430693,+,26953
297,BUMA.1121.00089,1,2202182,2229136,+,26954
297,BUMA.1121.00084,1,2614735,2642986,+,28251
297,BUMA.1121.00029,1,2693538,2720475,-,26937
297,BUMA.1121.00012,1,967322,994262,+,26940
297,BUMA.1121.00087,1,2202597,2229517,-,26920
297,BUMA.1121.00043,1,2308033,2336283,+,28250
297,BUMA.1121.00046,1,2613754,2640689,-,26935
297,BUMA.1121.00037,1,855300,882237,+,26937
297,BUMA.1121.00080,1,2245294,2272232,+,26938
297,BUMA.1121.00079,1,2241173,2268111,+,26938
297,BUMA.1121.00045,1,1786041,1813011,-,26970
297,BUMA.1121.00071,1,1599714,1626637,-,26923
297,BUMA.1121.00056,1,1697420,1724373,-,26953
297,BUMA.1121.00065,1,2318753,2345731,+,26978
297,BUMA.1121.00058,1,2300134,2328410,-,28276
297,BUMA.1121.00007,1,1830784,1857750,-,26966
297,BUMA.1121.00067,1,2143414,2171665,-,28251
297,BUMA.1121.00090,1,329572,356509,+,26937
297,BUMA.1121.00051,1,2215025,2241964,+,26939
297,BUMA.1121.00020,1,2465889,2492808,+,26919
297,BUMA.1121.00103,1,2168148,2195055,-,26907
297,BUMA.1121.00048,1,1182401,1209321,+,26920
297,BUMA.1121.00047,1,718977,745931,-,26954
297,BUMA.1121.00042,1,1837568,1864488,+,26920
297,BUMA.1121.00055,1,1842848,1869783,+,26935
297,BUMA.1121.00031,1,3649948,3676887,+,26939
297,BUMA.1121.00040,1,1938224,1965144,-,26920
297,BUMA.1121.00044,1,1666523,1693443,+,26920
297,BUMA.1121.00088,1,3159544,3187795,+,28251
297,BUMA.1121.00069,1,1562516,1589439,-,26923
297,BUMA.1121.00064,1,2257380,2284313,+,26933
297,BUMA.1121.00105,1,2967276,2994250,-,26974
297,BUMA.1121.00015,1,1628353,1655272,-,26919
297,BUMA.1121.00059,1,1432106,1460371,+,28265
297,BUMA.1121.00026,1,3262803,3289723,+,26920
297,BUMA.1121.00022,1,2817993,2844913,+,26920
297,BUMA.1121.00052,1,2210900,2237820,+,26920
297,BUMA.1121.00101,1,214548,241506,-,26958
297,BUMA.1121.00001,1,1811742,1838679,-,26937
297,BUMA.1121.00038,1,1389888,1416808,+,26920
297,BUMA.1121.00068,1,983958,1010899,+,26941
297,BUMA.1121.00099,1,87300,114228,-,26928
297,BUMA.1121.00091,1,2245339,2272276,-,26937
297,BUMA.1121.00098,1,869676,897949,+,28273
297,BUMA.1121.00013,1,2491098,2518018,+,26920
297,BUMA.1121.00049,1,3606933,3633889,-,26956
297,BUMA.1121.00072,1,1582176,1609098,-,26922
297,BUMA.1121.00076,1,3092255,3119162,-,26907
297,BUMA.1121.00083,1,3396070,3422993,-,26923
297,BUMA.1121.00078,1,3782781,3809728,-,26947
297,BUMA.1121.00095,1,3437116,3464086,-,26970
297,BUMA.1121.00077,1,915360,942291,+,26931
297,BUMA.1121.00063,1,1606806,1633728,-,26922
297,BUMA.1121.00061,1,1609647,1636570,-,26923
297,BUMA.1121.00050,1,111048,137983,+,26935
297,BUMA.1121.00081,1,1389949,1416869,+,26920
297,BUMA.1121.00074,1,1588586,1615519,-,26933
297,BUMA.1121.00062,1,2325279,2352237,-,26958
297,BUMA.1121.00060,1,13339,40309,-,26970
297,BUMA.1121.00070,1,1580578,1607501,-,26923
297,BUMA.1121.00075,1,1694918,1721822,+,26904
297,BUMA.1121.00041,1,3537281,3564215,+,26934
297,BUMA.1121.00073,1,1607883,1634806,-,26923
297,BUMA.1121.00017,1,2336057,2362977,+,26920
297,BUMA.1121.00066,1,1583803,1610726,-,26923
297,BUMA.1121.00107,1,2119667,2146597,+,26930
297,BUMA.1121.00085,1,1807846,1834766,+,26920
297,BUMA.1121.00030,1,2336091,2363011,+,26920
297,BUMA.1121.00112,1,714208,741189,-,26981
297,BUMA.1121.00002,1,3504572,3531474,+,26902
297,BUMA.1121.00082,1,1740492,1767415,-,26923
297,BUMA.1121.00014,1,540114,567054,-,26940
297,BUMA.1121.00011,1,3388411,3415380,-,26969
297,BUMA.1121.00019,1,2365951,2392871,+,26920
297,BUMA.1121.00057,1,3325232,3352155,+,26923
297,BUMA.1121.00018,1,2841371,2868321,+,26950
297,BUMA.1121.00039,1,2349465,2376402,+,26937
297,BUMA.1121.00016,1,353610,380552,+,26942
297,BUMA.1121.00004,1,2400923,2427843,+,26920
297,BUMA.1121.00005,1,958173,985092,+,26919
297,BUMA.1121.00100,1,3087857,3114809,-,26952
297,BUMA.1121.00006,1,1389871,1416791,+,26920
296,BUMA.1121.00027,1,378792,400558,+,21766
296,BUMA.1121.00025,1,420084,441944,-,21860
296,BUMA.1121.00021,1,2827406,2849252,+,21846
296,BUMA.1121.00023,1,537129,558884,+,21755
296,BUMA.1121.00024,1,2377767,2399493,+,21726
296,BUMA.1121.00033,1,345315,367049,+,21734
296,BUMA.1121.00034,1,2416495,2438221,+,21726
296,BUMA.1121.00036,1,1712857,1734583,-,21726
296,BUMA.1121.00032,1,445945,467671,+,21726
296,BUMA.1121.00009,1,3323085,3344832,-,21747
296,BUMA.1121.00008,1,2390767,2412493,+,21726
296,BUMA.1121.00003,1,728027,749757,+,21730
296,BUMA.1121.00109,1,3656260,3678086,-,21826
296,BUMA.1121.00053,1,1931752,1953485,+,21733
296,BUMA.1121.00110,1,2568064,2589748,-,21684
296,BUMA.1121.00104,1,3005854,3027674,-,21820
296,BUMA.1121.00086,1,1065356,1087082,+,21726
296,BUMA.1121.00092,1,1574575,1596306,-,21731
296,BUMA.1121.00096,1,1018529,1040311,-,21782
296,BUMA.1121.00054,1,2753501,2775227,-,21726
296,BUMA.1121.00097,1,1687623,1709398,-,21775
296,BUMA.1121.00093,1,3029977,3051708,+,21731
296,BUMA.1121.00106,1,1965391,1987111,+,21720
296,BUMA.1121.00010,1,3460200,3481926,+,21726
296,BUMA.1121.00035,1,3344648,3366414,+,21766
296,BUMA.1121.00108,1,3228590,3250301,+,21711
296,BUMA.1121.00028,1,2379086,2400812,+,21726
296,BUMA.1121.00094,1,2210706,2232468,+,21762
296,BUMA.1121.00102,1,3090996,3112872,-,21876
296,BUMA.1121.00111,1,2381805,2403524,+,21719
296,BUMA.1121.00089,1,2180231,2201993,+,21762
296,BUMA.1121.00084,1,2592758,2614548,+,21790
296,BUMA.1121.00029,1,2722257,2744003,-,21746
296,BUMA.1121.00012,1,945352,967133,+,21781
296,BUMA.1121.00087,1,2229706,2251432,-,21726
296,BUMA.1121.00043,1,2284429,2306251,+,21822
296,BUMA.1121.00046,1,2640878,2662604,-,21726
296,BUMA.1121.00037,1,831756,853518,+,21762
296,BUMA.1121.00080,1,2223291,2245105,+,21814
296,BUMA.1121.00079,1,2219198,2240984,+,21786
296,BUMA.1121.00045,1,1813201,1834950,-,21749
296,BUMA.1121.00071,1,1626826,1648593,-,21767
296,BUMA.1121.00056,1,1724562,1746324,-,21762
296,BUMA.1121.00065,1,2295506,2317251,+,21745
296,BUMA.1121.00058,1,2328599,2350382,-,21783
296,BUMA.1121.00007,1,1857939,1879676,-,21737
296,BUMA.1121.00067,1,2173167,2194934,-,21767
296,BUMA.1121.00090,1,305910,327789,+,21879
296,BUMA.1121.00051,1,2193086,2214836,+,21750
296,BUMA.1121.00020,1,2443974,2465700,+,21726
296,BUMA.1121.00103,1,2196843,2218564,-,21721
296,BUMA.1121.00048,1,1160486,1182212,+,21726
296,BUMA.1121.00047,1,746120,767935,-,21815
296,BUMA.1121.00042,1,1815647,1837379,+,21732
296,BUMA.1121.00055,1,1820904,1842659,+,21755
296,BUMA.1121.00031,1,3626450,3648166,+,21716
296,BUMA.1121.00040,1,1965333,1987059,-,21726
296,BUMA.1121.00044,1,1644608,1666334,+,21726
296,BUMA.1121.00088,1,3137570,3159355,+,21785
296,BUMA.1121.00069,1,1589628,1611351,-,21723
296,BUMA.1121.00064,1,2234150,2255878,+,21728
296,BUMA.1121.00105,1,2994439,3016252,-,21813
296,BUMA.1121.00015,1,1655461,1677187,-,21726
296,BUMA.1121.00059,1,1410164,1431917,+,21753
296,BUMA.1121.00026,1,3240882,3262614,+,21732
296,BUMA.1121.00022,1,2796078,2817804,+,21726
296,BUMA.1121.00052,1,2189021,2210711,+,21690
296,BUMA.1121.00101,1,241695,263498,-,21803
296,BUMA.1121.00001,1,1840461,1862246,-,21785
296,BUMA.1121.00038,1,1367973,1389699,+,21726
296,BUMA.1121.00068,1,961962,983769,+,21807
296,BUMA.1121.00099,1,114417,136188,-,21771
296,BUMA.1121.00091,1,2272465,2294215,-,21750
296,BUMA.1121.00098,1,847679,869487,+,21808
296,BUMA.1121.00013,1,2469219,2490909,+,21690
296,BUMA.1121.00049,1,3634076,3655865,-,21789
296,BUMA.1121.00072,1,1609287,1631055,-,21768
296,BUMA.1121.00076,1,3120831,3142560,-,21729
296,BUMA.1121.00083,1,3423182,3444950,-,21768
296,BUMA.1121.00078,1,3809915,3831684,-,21769
296,BUMA.1121.00095,1,3464275,3486065,-,21790
296,BUMA.1121.00077,1,893488,915172,+,21684
296,BUMA.1121.00063,1,1633917,1655648,-,21731
296,BUMA.1121.00061,1,1636759,1658491,-,21732
296,BUMA.1121.00050,1,89133,110859,+,21726
296,BUMA.1121.00081,1,1368034,1389760,+,21726
296,BUMA.1121.00074,1,1617021,1638827,-,21806
296,BUMA.1121.00062,1,2352426,2374176,-,21750
296,BUMA.1121.00060,1,40499,62248,-,21749
296,BUMA.1121.00070,1,1607690,1629429,-,21739
296,BUMA.1121.00075,1,1671522,1693250,+,21728
296,BUMA.1121.00041,1,3515297,3537092,+,21795
296,BUMA.1121.00073,1,1634995,1656695,-,21700
296,BUMA.1121.00017,1,2314142,2335868,+,21726
296,BUMA.1121.00066,1,1610915,1632676,-,21761
296,BUMA.1121.00107,1,2097594,2119478,+,21884
296,BUMA.1121.00085,1,1785967,1807657,+,21690
296,BUMA.1121.00030,1,2314176,2335902,+,21726
296,BUMA.1121.00112,1,741378,763117,-,21739
296,BUMA.1121.00002,1,3482657,3504383,+,21726
296,BUMA.1121.00082,1,1767604,1789372,-,21768
296,BUMA.1121.00014,1,568836,590558,-,21722
296,BUMA.1121.00011,1,3415569,3437349,-,21780
296,BUMA.1121.00019,1,2344036,2365762,+,21726
296,BUMA.1121.00057,1,3303290,3325043,+,21753
296,BUMA.1121.00018,1,2817742,2839589,+,21847
296,BUMA.1121.00039,1,2325866,2347683,+,21817
296,BUMA.1121.00016,1,331700,353394,+,21694
296,BUMA.1121.00004,1,2379008,2400734,+,21726
296,BUMA.1121.00005,1,936265,957984,+,21719
296,BUMA.1121.00100,1,3114998,3136806,-,21808
296,BUMA.1121.00006,1,1367956,1389682,+,21726
295,BUMA.1121.00027,1,371687,377222,+,5535
295,BUMA.1121.00025,1,443666,449209,-,5543
295,BUMA.1121.00021,1,2820336,2825879,+,5543
295,BUMA.1121.00023,1,529753,535288,+,5535
295,BUMA.1121.00024,1,2370497,2376033,+,5536
295,BUMA.1121.00033,1,338289,343806,+,5517
295,BUMA.1121.00034,1,2409274,2414810,+,5536
295,BUMA.1121.00036,1,1736205,1741748,-,5543
295,BUMA.1121.00032,1,438752,444288,+,5536
295,BUMA.1121.00009,1,3346527,3352065,-,5538
295,BUMA.1121.00008,1,2383546,2389082,+,5536
295,BUMA.1121.00003,1,720939,726481,+,5542
295,BUMA.1121.00109,1,3679665,3685207,-,5542
295,BUMA.1121.00053,1,1924641,1930177,+,5536
295,BUMA.1121.00110,1,2591285,2596803,-,5518
295,BUMA.1121.00104,1,3029379,3034921,-,5542
295,BUMA.1121.00086,1,1058147,1063683,+,5536
295,BUMA.1121.00092,1,1597847,1603389,-,5542
295,BUMA.1121.00096,1,1041767,1047309,-,5542
295,BUMA.1121.00054,1,2776767,2782310,-,5543
295,BUMA.1121.00097,1,1711136,1716661,-,5525
295,BUMA.1121.00093,1,3022895,3028430,+,5535
295,BUMA.1121.00106,1,1958204,1963721,+,5517
295,BUMA.1121.00010,1,3453096,3458632,+,5536
295,BUMA.1121.00035,1,3336213,3341755,+,5542
295,BUMA.1121.00108,1,3221575,3227117,+,5542
295,BUMA.1121.00028,1,2371888,2377424,+,5536
295,BUMA.1121.00094,1,2203459,2208993,+,5534
295,BUMA.1121.00102,1,3114517,3120060,-,5543
295,BUMA.1121.00111,1,2374726,2380268,+,5542
295,BUMA.1121.00089,1,2173030,2178547,+,5517
295,BUMA.1121.00084,1,2585654,2591192,+,5538
295,BUMA.1121.00029,1,2745526,2751068,-,5542
295,BUMA.1121.00012,1,938308,943843,+,5535
295,BUMA.1121.00087,1,2253095,2258638,-,5543
295,BUMA.1121.00043,1,2277138,2282673,+,5535
295,BUMA.1121.00046,1,2664234,2669777,-,5543
295,BUMA.1121.00037,1,824552,830087,+,5535
295,BUMA.1121.00080,1,2216043,2221578,+,5535
295,BUMA.1121.00079,1,2212049,2217584,+,5535
295,BUMA.1121.00045,1,1836514,1842038,-,5524
295,BUMA.1121.00071,1,1650242,1655759,-,5517
295,BUMA.1121.00056,1,1748013,1753537,-,5524
295,BUMA.1121.00065,1,2288311,2293829,+,5518
295,BUMA.1121.00058,1,2351950,2357474,-,5524
295,BUMA.1121.00007,1,1881329,1886853,-,5524
295,BUMA.1121.00067,1,2196467,2202009,-,5542
295,BUMA.1121.00090,1,298901,304443,+,5542
295,BUMA.1121.00051,1,2185912,2191447,+,5535
295,BUMA.1121.00020,1,2436754,2442290,+,5536
295,BUMA.1121.00103,1,2220059,2225595,-,5536
295,BUMA.1121.00048,1,1153403,1158939,+,5536
295,BUMA.1121.00047,1,769622,775164,-,5542
295,BUMA.1121.00042,1,1808586,1814122,+,5536
295,BUMA.1121.00055,1,1813818,1819361,+,5543
295,BUMA.1121.00031,1,3619378,3624920,+,5542
295,BUMA.1121.00040,1,1988697,1994240,-,5543
295,BUMA.1121.00044,1,1637394,1642930,+,5536
295,BUMA.1121.00088,1,3130476,3136012,+,5536
295,BUMA.1121.00069,1,1612983,1618491,-,5508
295,BUMA.1121.00064,1,2226972,2232507,+,5535
295,BUMA.1121.00105,1,3017850,3023322,-,5472
295,BUMA.1121.00015,1,1678778,1684321,-,5543
295,BUMA.1121.00059,1,1403015,1408558,+,5543
295,BUMA.1121.00026,1,3233738,3239274,+,5536
295,BUMA.1121.00022,1,2788885,2794421,+,5536
295,BUMA.1121.00052,1,2181872,2187408,+,5536
295,BUMA.1121.00101,1,265056,270581,-,5525
295,BUMA.1121.00001,1,1863762,1869304,-,5542
295,BUMA.1121.00038,1,1360890,1366426,+,5536
295,BUMA.1121.00068,1,954796,960333,+,5537
295,BUMA.1121.00099,1,137746,143288,-,5542
295,BUMA.1121.00091,1,2295740,2301260,-,5520
295,BUMA.1121.00098,1,840604,846121,+,5517
295,BUMA.1121.00013,1,2462056,2467592,+,5536
295,BUMA.1121.00049,1,3657534,3663058,-,5524
295,BUMA.1121.00072,1,1632561,1638083,-,5522
295,BUMA.1121.00076,1,3144187,3149703,-,5516
295,BUMA.1121.00083,1,3446640,3452165,-,5525
295,BUMA.1121.00078,1,3833361,3838903,-,5542
295,BUMA.1121.00095,1,3487633,3493148,-,5515
295,BUMA.1121.00077,1,886342,891866,+,5524
295,BUMA.1121.00063,1,1657144,1662646,-,5502
295,BUMA.1121.00061,1,1660103,1665628,-,5525
295,BUMA.1121.00050,1,81955,87491,+,5536
295,BUMA.1121.00081,1,1360951,1366487,+,5536
295,BUMA.1121.00074,1,1640519,1646061,-,5542
295,BUMA.1121.00062,1,2375836,2381361,-,5525
295,BUMA.1121.00060,1,63833,69357,-,5524
295,BUMA.1121.00070,1,1631015,1636534,-,5519
295,BUMA.1121.00075,1,1664376,1669885,+,5509
295,BUMA.1121.00041,1,3508160,3513703,+,5543
295,BUMA.1121.00073,1,1658365,1663892,-,5527
295,BUMA.1121.00017,1,2306909,2312445,+,5536
295,BUMA.1121.00066,1,1634315,1639831,-,5516
295,BUMA.1121.00107,1,2090493,2096035,+,5542
295,BUMA.1121.00085,1,1778818,1784354,+,5536
295,BUMA.1121.00030,1,2306971,2312507,+,5536
295,BUMA.1121.00112,1,764673,770198,-,5525
295,BUMA.1121.00002,1,3475553,3481089,+,5536
295,BUMA.1121.00082,1,1791062,1796587,-,5525
295,BUMA.1121.00014,1,592123,597665,-,5542
295,BUMA.1121.00011,1,3438846,3444382,-,5536
295,BUMA.1121.00019,1,2336808,2342344,+,5536
295,BUMA.1121.00057,1,3296208,3301733,+,5525
295,BUMA.1121.00018,1,2810486,2816021,+,5535
295,BUMA.1121.00039,1,2318818,2324353,+,5535
295,BUMA.1121.00016,1,324635,330170,+,5535
295,BUMA.1121.00004,1,2371787,2377323,+,5536
295,BUMA.1121.00005,1,929265,934797,+,5532
295,BUMA.1121.00100,1,3139801,3145343,-,5542
295,BUMA.1121.00006,1,1360873,1366409,+,5536
294,BUMA.1121.00027,1,363482,370956,+,7474
294,BUMA.1121.00025,1,449940,457414,-,7474
294,BUMA.1121.00021,1,2812130,2819605,+,7475
294,BUMA.1121.00023,1,521547,529022,+,7475
294,BUMA.1121.00024,1,2362291,2369766,+,7475
294,BUMA.1121.00033,1,330085,337558,+,7473
294,BUMA.1121.00034,1,2401068,2408543,+,7475
294,BUMA.1121.00036,1,1742479,1749953,-,7474
294,BUMA.1121.00032,1,430546,438021,+,7475
294,BUMA.1121.00009,1,3352796,3360247,-,7451
294,BUMA.1121.00008,1,2375340,2382815,+,7475
294,BUMA.1121.00003,1,696766,704207,+,7441
294,BUMA.1121.00109,1,3685938,3693405,-,7467
294,BUMA.1121.00053,1,1916435,1923910,+,7475
294,BUMA.1121.00110,1,2597534,2605015,-,7481
294,BUMA.1121.00104,1,3035652,3043127,-,7475
294,BUMA.1121.00086,1,1049941,1057416,+,7475
294,BUMA.1121.00092,1,1604120,1611600,-,7480
294,BUMA.1121.00096,1,1048040,1055521,-,7481
294,BUMA.1121.00054,1,2783041,2790515,-,7474
294,BUMA.1121.00097,1,1717392,1724849,-,7457
294,BUMA.1121.00093,1,3014683,3022164,+,7481
294,BUMA.1121.00106,1,1949998,1957473,+,7475
294,BUMA.1121.00010,1,3444890,3452365,+,7475
294,BUMA.1121.00035,1,3328015,3335482,+,7467
294,BUMA.1121.00108,1,3213369,3220844,+,7475
294,BUMA.1121.00028,1,2363682,2371157,+,7475
294,BUMA.1121.00094,1,2195252,2202728,+,7476
294,BUMA.1121.00102,1,3120791,3128265,-,7474
294,BUMA.1121.00111,1,2366520,2373995,+,7475
294,BUMA.1121.00089,1,2164823,2172299,+,7476
294,BUMA.1121.00084,1,2577434,2584923,+,7489
294,BUMA.1121.00029,1,2751799,2759265,-,7466
294,BUMA.1121.00012,1,930103,937577,+,7474
294,BUMA.1121.00087,1,2259369,2266843,-,7474
294,BUMA.1121.00043,1,2268933,2276407,+,7474
294,BUMA.1121.00046,1,2670508,2677975,-,7467
294,BUMA.1121.00037,1,816340,823821,+,7481
294,BUMA.1121.00080,1,2207837,2215312,+,7475
294,BUMA.1121.00079,1,2203851,2211318,+,7467
294,BUMA.1121.00045,1,1842769,1850250,-,7481
294,BUMA.1121.00071,1,1656490,1663971,-,7481
294,BUMA.1121.00056,1,1754268,1761743,-,7475
294,BUMA.1121.00065,1,2280110,2287580,+,7470
294,BUMA.1121.00058,1,2358205,2365686,-,7481
294,BUMA.1121.00007,1,1887584,1895034,-,7450
294,BUMA.1121.00067,1,2202740,2210210,-,7470
294,BUMA.1121.00090,1,290695,298170,+,7475
294,BUMA.1121.00051,1,2177706,2185181,+,7475
294,BUMA.1121.00020,1,2428548,2436023,+,7475
294,BUMA.1121.00103,1,2226326,2233792,-,7466
294,BUMA.1121.00048,1,1145197,1152672,+,7475
294,BUMA.1121.00047,1,775895,783369,-,7474
294,BUMA.1121.00042,1,1800373,1807855,+,7482
294,BUMA.1121.00055,1,1805619,1813087,+,7468
294,BUMA.1121.00031,1,3611172,3618647,+,7475
294,BUMA.1121.00040,1,1994971,2002445,-,7474
294,BUMA.1121.00044,1,1629188,1636663,+,7475
294,BUMA.1121.00088,1,3122262,3129745,+,7483
294,BUMA.1121.00069,1,1619222,1626702,-,7480
294,BUMA.1121.00064,1,2218767,2226241,+,7474
294,BUMA.1121.00105,1,3024123,3031611,-,7488
294,BUMA.1121.00015,1,1685052,1692526,-,7474
294,BUMA.1121.00059,1,1394802,1402284,+,7482
294,BUMA.1121.00026,1,3225525,3233007,+,7482
294,BUMA.1121.00022,1,2780679,2788154,+,7475
294,BUMA.1121.00052,1,2173666,2181141,+,7475
294,BUMA.1121.00101,1,271312,278787,-,7475
294,BUMA.1121.00001,1,1870035,1877501,-,7466
294,BUMA.1121.00038,1,1352684,1360159,+,7475
294,BUMA.1121.00068,1,946590,954065,+,7475
294,BUMA.1121.00099,1,144019,151505,-,7486
294,BUMA.1121.00091,1,2301991,2309457,-,7466
294,BUMA.1121.00098,1,814043,821509,+,7466
294,BUMA.1121.00013,1,2453850,2461325,+,7475
294,BUMA.1121.00049,1,3677568,3685041,-,7473
294,BUMA.1121.00072,1,1638814,1646294,-,7480
294,BUMA.1121.00076,1,3150434,3157908,-,7474
294,BUMA.1121.00083,1,3452896,3460377,-,7481
294,BUMA.1121.00078,1,3839634,3847108,-,7474
294,BUMA.1121.00095,1,3493879,3501336,-,7457
294,BUMA.1121.00077,1,878129,885611,+,7482
294,BUMA.1121.00063,1,1663377,1670857,-,7480
294,BUMA.1121.00061,1,1666359,1673837,-,7478
294,BUMA.1121.00050,1,73756,81224,+,7468
294,BUMA.1121.00081,1,1352745,1360220,+,7475
294,BUMA.1121.00074,1,1646792,1654266,-,7474
294,BUMA.1121.00062,1,2382092,2389573,-,7481
294,BUMA.1121.00060,1,70088,77569,-,7481
294,BUMA.1121.00070,1,1637265,1644743,-,7478
294,BUMA.1121.00075,1,1656172,1663645,+,7473
294,BUMA.1121.00041,1,3499954,3507429,+,7475
294,BUMA.1121.00073,1,1664623,1672104,-,7481
294,BUMA.1121.00017,1,2298703,2306178,+,7475
294,BUMA.1121.00066,1,1640562,1648042,-,7480
294,BUMA.1121.00107,1,2082309,2089762,+,7453
294,BUMA.1121.00085,1,1770612,1778087,+,7475
294,BUMA.1121.00030,1,2298765,2306240,+,7475
294,BUMA.1121.00112,1,770929,778387,-,7458
294,BUMA.1121.00002,1,3467347,3474822,+,7475
294,BUMA.1121.00082,1,1797318,1804799,-,7481
294,BUMA.1121.00014,1,598396,605870,-,7474
294,BUMA.1121.00011,1,3445113,3452563,-,7450
294,BUMA.1121.00019,1,2328602,2336077,+,7475
294,BUMA.1121.00057,1,3287995,3295477,+,7482
294,BUMA.1121.00018,1,2802280,2809755,+,7475
294,BUMA.1121.00039,1,2310613,2318087,+,7474
294,BUMA.1121.00016,1,316437,323904,+,7467
294,BUMA.1121.00004,1,2363581,2371056,+,7475
294,BUMA.1121.00005,1,921052,928534,+,7482
294,BUMA.1121.00100,1,3146074,3153557,-,7483
294,BUMA.1121.00006,1,1352667,1360142,+,7475
293,BUMA.1121.00027,1,354520,359163,+,4643
293,BUMA.1121.00025,1,461733,466378,-,4645
293,BUMA.1121.00021,1,2803167,2807811,+,4644
293,BUMA.1121.00023,1,512584,517228,+,4644
293,BUMA.1121.00033,1,321124,325767,+,4643
293,BUMA.1121.00009,1,3364563,3369214,-,4651
293,BUMA.1121.00003,1,687821,692448,+,4627
293,BUMA.1121.00109,1,3697721,3702366,-,4645
293,BUMA.1121.00053,1,1907486,1912130,+,4644
293,BUMA.1121.00110,1,2609331,2613976,-,4645
293,BUMA.1121.00104,1,3047446,3052091,-,4645
293,BUMA.1121.00092,1,1615919,1620564,-,4645
293,BUMA.1121.00096,1,1059840,1064485,-,4645
293,BUMA.1121.00097,1,1729168,1733813,-,4645
293,BUMA.1121.00093,1,3005720,3010364,+,4644
293,BUMA.1121.00106,1,1941035,1945679,+,4644
293,BUMA.1121.00035,1,3319052,3323696,+,4644
293,BUMA.1121.00108,1,3204403,3209047,+,4644
293,BUMA.1121.00094,1,2186282,2190932,+,4650
293,BUMA.1121.00102,1,3132581,3137226,-,4645
293,BUMA.1121.00111,1,2357557,2362201,+,4644
293,BUMA.1121.00089,1,2155854,2160504,+,4650
293,BUMA.1121.00084,1,2568471,2573115,+,4644
293,BUMA.1121.00029,1,2763584,2768229,-,4645
293,BUMA.1121.00012,1,921140,925784,+,4644
293,BUMA.1121.00043,1,2259970,2264614,+,4644
293,BUMA.1121.00037,1,807377,812021,+,4644
293,BUMA.1121.00080,1,2198868,2203518,+,4650
293,BUMA.1121.00079,1,2194882,2199532,+,4650
293,BUMA.1121.00045,1,1854566,1859211,-,4645
293,BUMA.1121.00071,1,1668287,1672932,-,4645
293,BUMA.1121.00056,1,1766062,1770713,-,4651
293,BUMA.1121.00065,1,2271147,2275791,+,4644
293,BUMA.1121.00058,1,2369999,2374644,-,4645
293,BUMA.1121.00007,1,1899353,1903998,-,4645
293,BUMA.1121.00067,1,2214526,2219171,-,4645
293,BUMA.1121.00090,1,281732,286376,+,4644
293,BUMA.1121.00051,1,2168737,2173387,+,4650
293,BUMA.1121.00103,1,2238111,2242756,-,4645
293,BUMA.1121.00047,1,787688,792339,-,4651
293,BUMA.1121.00055,1,1796656,1801300,+,4644
293,BUMA.1121.00031,1,3602209,3606853,+,4644
293,BUMA.1121.00088,1,3113302,3117946,+,4644
293,BUMA.1121.00069,1,1631019,1635664,-,4645
293,BUMA.1121.00064,1,2209804,2214448,+,4644
293,BUMA.1121.00105,1,3035927,3040572,-,4645
293,BUMA.1121.00059,1,1385842,1390486,+,4644
293,BUMA.1121.00101,1,283095,287740,-,4645
293,BUMA.1121.00001,1,1881819,1886464,-,4645
293,BUMA.1121.00068,1,937639,942283,+,4644
293,BUMA.1121.00099,1,155824,160475,-,4651
293,BUMA.1121.00091,1,2313776,2318421,-,4645
293,BUMA.1121.00098,1,805082,809726,+,4644
293,BUMA.1121.00049,1,3689360,3694005,-,4645
293,BUMA.1121.00072,1,1650609,1655250,-,4641
293,BUMA.1121.00076,1,3162227,3166872,-,4645
293,BUMA.1121.00083,1,3464696,3469341,-,4645
293,BUMA.1121.00078,1,3851413,3856058,-,4645
293,BUMA.1121.00095,1,3505655,3510300,-,4645
293,BUMA.1121.00077,1,869169,873813,+,4644
293,BUMA.1121.00063,1,1675176,1679821,-,4645
293,BUMA.1121.00061,1,1678156,1682801,-,4645
293,BUMA.1121.00074,1,1658585,1663230,-,4645
293,BUMA.1121.00062,1,2393892,2398537,-,4645
293,BUMA.1121.00060,1,81885,86530,-,4645
293,BUMA.1121.00070,1,1649062,1653707,-,4645
293,BUMA.1121.00075,1,1647209,1651853,+,4644
293,BUMA.1121.00041,1,3490994,3495638,+,4644
293,BUMA.1121.00073,1,1676423,1681068,-,4645
293,BUMA.1121.00066,1,1652359,1657004,-,4645
293,BUMA.1121.00107,1,2073346,2077990,+,4644
293,BUMA.1121.00112,1,782706,787351,-,4645
293,BUMA.1121.00082,1,1809118,1813763,-,4645
293,BUMA.1121.00014,1,610189,614834,-,4645
293,BUMA.1121.00011,1,3456885,3461536,-,4651
293,BUMA.1121.00057,1,3279032,3283676,+,4644
293,BUMA.1121.00018,1,2793317,2797961,+,4644
293,BUMA.1121.00039,1,2301650,2306294,+,4644
293,BUMA.1121.00016,1,307463,312107,+,4644
293,BUMA.1121.00005,1,912095,916739,+,4644
293,BUMA.1121.00100,1,3157866,3162511,-,4645
292,BUMA.1121.00027,1,329311,348964,+,19653
292,BUMA.1121.00025,1,471947,491605,-,19658
292,BUMA.1121.00021,1,2777896,2797609,+,19713
292,BUMA.1121.00023,1,487407,507026,+,19619
292,BUMA.1121.00033,1,296058,315566,+,19508
292,BUMA.1121.00009,1,3379734,3399283,-,19549
292,BUMA.1121.00003,1,657704,677275,+,19571
292,BUMA.1121.00109,1,3707909,3727562,-,19653
292,BUMA.1121.00053,1,1882287,1901917,+,19630
292,BUMA.1121.00110,1,2619535,2639024,-,19489
292,BUMA.1121.00104,1,3057644,3077158,-,19514
292,BUMA.1121.00092,1,1626125,1645639,-,19514
292,BUMA.1121.00096,1,1070046,1089612,-,19566
292,BUMA.1121.00054,1,3120846,3140392,+,19546
292,BUMA.1121.00097,1,1769556,1789083,-,19527
292,BUMA.1121.00093,1,2980645,3000158,+,19513
292,BUMA.1121.00106,1,1915977,1935490,+,19513
292,BUMA.1121.00010,1,3083588,3103113,-,19525
292,BUMA.1121.00035,1,3293890,3313494,+,19604
292,BUMA.1121.00108,1,3179289,3198847,+,19558
292,BUMA.1121.00094,1,2161140,2180704,+,19564
292,BUMA.1121.00102,1,3142781,3162443,-,19662
292,BUMA.1121.00111,1,2332464,2351999,+,19535
292,BUMA.1121.00089,1,2130713,2150276,+,19563
292,BUMA.1121.00084,1,2543297,2562907,+,19610
292,BUMA.1121.00029,1,2773785,2793422,-,19637
292,BUMA.1121.00012,1,896007,915582,+,19575
292,BUMA.1121.00043,1,2234863,2254412,+,19549
292,BUMA.1121.00046,1,3008284,3027830,+,19546
292,BUMA.1121.00037,1,782172,801819,+,19647
292,BUMA.1121.00080,1,2173729,2193291,+,19562
292,BUMA.1121.00079,1,2169765,2189305,+,19540
292,BUMA.1121.00045,1,1864768,1884257,-,19489
292,BUMA.1121.00071,1,1678482,1697988,-,19506
292,BUMA.1121.00056,1,1776290,1795854,-,19564
292,BUMA.1121.00065,1,2246037,2265593,+,19556
292,BUMA.1121.00058,1,2380197,2399701,-,19504
292,BUMA.1121.00007,1,1909550,1929094,-,19544
292,BUMA.1121.00067,1,2224726,2244295,-,19569
292,BUMA.1121.00090,1,256567,276174,+,19607
292,BUMA.1121.00051,1,2143587,2163160,+,19573
292,BUMA.1121.00103,1,2248305,2267891,-,19586
292,BUMA.1121.00048,1,795316,814863,-,19547
292,BUMA.1121.00047,1,797916,817513,-,19597
292,BUMA.1121.00042,1,1642157,1661638,-,19481
292,BUMA.1121.00055,1,1771519,1791082,+,19563
292,BUMA.1121.00031,1,3577025,3596650,+,19625
292,BUMA.1121.00040,1,2110215,2129740,-,19525
292,BUMA.1121.00088,1,3088145,3107746,+,19601
292,BUMA.1121.00069,1,1641219,1660905,-,19686
292,BUMA.1121.00064,1,2184699,2204245,+,19546
292,BUMA.1121.00105,1,3046130,3065697,-,19567
292,BUMA.1121.00015,1,2066313,2085826,+,19513
292,BUMA.1121.00059,1,1360782,1380283,+,19501
292,BUMA.1121.00026,1,3067430,3086911,-,19481
292,BUMA.1121.00022,1,2398479,2417973,-,19494
292,BUMA.1121.00101,1,293298,312788,-,19490
292,BUMA.1121.00001,1,1892021,1911625,-,19604
292,BUMA.1121.00038,1,1002790,1022337,-,19547
292,BUMA.1121.00068,1,912540,932071,+,19531
292,BUMA.1121.00099,1,171011,190550,-,19539
292,BUMA.1121.00091,1,2323982,2343615,-,19633
292,BUMA.1121.00098,1,773741,793304,+,19563
292,BUMA.1121.00013,1,2210242,2229755,+,19513
292,BUMA.1121.00049,1,3699558,3719072,-,19514
292,BUMA.1121.00072,1,1660805,1680491,-,19686
292,BUMA.1121.00076,1,3172433,3191914,-,19481
292,BUMA.1121.00083,1,3474896,3494571,-,19675
292,BUMA.1121.00078,1,3861599,3881305,-,19706
292,BUMA.1121.00095,1,3515857,3535414,-,19557
292,BUMA.1121.00077,1,844123,863609,+,19486
292,BUMA.1121.00063,1,1685376,1705062,-,19686
292,BUMA.1121.00061,1,1688356,1708034,-,19678
292,BUMA.1121.00050,1,3233379,3252926,-,19547
292,BUMA.1121.00081,1,1002859,1022406,-,19547
292,BUMA.1121.00074,1,1668788,1688302,-,19514
292,BUMA.1121.00062,1,2404095,2423653,-,19558
292,BUMA.1121.00060,1,92087,111576,-,19489
292,BUMA.1121.00070,1,1659257,1678943,-,19686
292,BUMA.1121.00075,1,1622168,1641647,+,19479
292,BUMA.1121.00041,1,3465750,3485425,+,19675
292,BUMA.1121.00073,1,1686623,1706308,-,19685
292,BUMA.1121.00066,1,1662559,1682058,-,19499
292,BUMA.1121.00107,1,2048146,2067780,+,19634
292,BUMA.1121.00112,1,792930,812450,-,19520
292,BUMA.1121.00002,1,3106014,3125539,-,19525
292,BUMA.1121.00082,1,1819318,1839004,-,19686
292,BUMA.1121.00014,1,620392,640073,-,19681
292,BUMA.1121.00011,1,3472056,3491547,-,19491
292,BUMA.1121.00057,1,3253819,3273476,+,19657
292,BUMA.1121.00018,1,2768080,2787747,+,19667
292,BUMA.1121.00039,1,2276434,2296092,+,19658
292,BUMA.1121.00016,1,282344,301906,+,19562
292,BUMA.1121.00005,1,886957,906541,+,19584
292,BUMA.1121.00100,1,3168066,3187608,-,19542
292,BUMA.1121.00006,1,1002782,1022329,-,19547
291,BUMA.1121.00027,1,297629,322204,+,24575
291,BUMA.1121.00025,1,498352,523076,-,24724
291,BUMA.1121.00021,1,2746758,2771092,+,24334
291,BUMA.1121.00023,1,455994,480652,+,24658
291,BUMA.1121.00033,1,264621,289270,+,24649
291,BUMA.1121.00009,1,3408100,3432779,-,24679
291,BUMA.1121.00003,1,621298,646000,+,24702
291,BUMA.1121.00109,1,3736371,3760922,-,24551
291,BUMA.1121.00053,1,1849452,1874101,+,24649
291,BUMA.1121.00110,1,2645751,2670397,-,24646
291,BUMA.1121.00104,1,3085978,3110502,-,24524
291,BUMA.1121.00092,1,1654440,1679065,-,24625
291,BUMA.1121.00096,1,1096332,1120875,-,24543
291,BUMA.1121.00054,1,3089522,3114118,+,24596
291,BUMA.1121.00097,1,1797101,1821684,-,24583
291,BUMA.1121.00093,1,2947219,2971843,+,24624
291,BUMA.1121.00106,1,1882369,1907135,+,24766
291,BUMA.1121.00010,1,3109840,3134468,-,24628
291,BUMA.1121.00035,1,3262423,3287126,+,24703
291,BUMA.1121.00108,1,3145840,3170478,+,24638
291,BUMA.1121.00094,1,2129630,2154282,+,24652
291,BUMA.1121.00102,1,3170622,3195280,-,24658
291,BUMA.1121.00111,1,2301017,2325695,+,24678
291,BUMA.1121.00089,1,2099203,2123863,+,24660
291,BUMA.1121.00084,1,2512031,2536557,+,24526
291,BUMA.1121.00029,1,2800255,2824958,-,24703
291,BUMA.1121.00012,1,864606,889183,+,24577
291,BUMA.1121.00043,1,2203372,2227973,+,24601
291,BUMA.1121.00046,1,2976932,3001556,+,24624
291,BUMA.1121.00037,1,750753,775420,+,24667
291,BUMA.1121.00080,1,2142082,2166873,+,24791
291,BUMA.1121.00079,1,2138313,2162944,+,24631
291,BUMA.1121.00045,1,1891013,1915621,-,24608
291,BUMA.1121.00071,1,1704703,1729358,-,24655
291,BUMA.1121.00056,1,1802703,1827364,-,24661
291,BUMA.1121.00065,1,2214679,2239315,+,24636
291,BUMA.1121.00058,1,2408508,2433148,-,24640
291,BUMA.1121.00007,1,1937896,1962540,-,24644
291,BUMA.1121.00067,1,2251095,2275736,-,24641
291,BUMA.1121.00090,1,225074,249805,+,24731
291,BUMA.1121.00051,1,2112093,2136758,+,24665
291,BUMA.1121.00103,1,2274053,2298725,-,24672
291,BUMA.1121.00048,1,821590,846187,-,24597
291,BUMA.1121.00047,1,824355,848998,-,24643
291,BUMA.1121.00042,1,1668365,1692928,-,24563
291,BUMA.1121.00055,1,1738004,1762672,+,24668
291,BUMA.1121.00031,1,3545427,3570222,+,24795
291,BUMA.1121.00040,1,2136467,2161057,-,24590
291,BUMA.1121.00088,1,3056842,3081417,+,24575
291,BUMA.1121.00069,1,1667657,1692309,-,24652
291,BUMA.1121.00064,1,2153328,2177955,+,24627
291,BUMA.1121.00105,1,3074510,3099276,-,24766
291,BUMA.1121.00015,1,2034961,2059585,+,24624
291,BUMA.1121.00059,1,1327256,1351965,+,24709
291,BUMA.1121.00026,1,3093638,3118180,-,24542
291,BUMA.1121.00022,1,2424700,2449391,-,24691
291,BUMA.1121.00101,1,321574,346269,-,24695
291,BUMA.1121.00001,1,1918437,1943196,-,24759
291,BUMA.1121.00038,1,1029064,1053661,-,24597
291,BUMA.1121.00068,1,880936,905746,+,24810
291,BUMA.1121.00099,1,197314,221894,-,24580
291,BUMA.1121.00091,1,2350511,2375165,-,24654
291,BUMA.1121.00098,1,742307,766995,+,24688
291,BUMA.1121.00013,1,2178919,2203529,+,24610
291,BUMA.1121.00049,1,3727924,3752659,-,24735
291,BUMA.1121.00072,1,1687193,1711844,-,24651
291,BUMA.1121.00076,1,3198665,3223477,-,24812
291,BUMA.1121.00083,1,3501527,3526193,-,24666
291,BUMA.1121.00078,1,3888047,3912644,-,24597
291,BUMA.1121.00095,1,3542150,3566693,-,24543
291,BUMA.1121.00077,1,812752,837395,+,24643
291,BUMA.1121.00063,1,1711815,1736469,-,24654
291,BUMA.1121.00061,1,1714786,1739434,-,24648
291,BUMA.1121.00050,1,3259653,3284271,-,24618
291,BUMA.1121.00081,1,1029133,1053730,-,24597
291,BUMA.1121.00074,1,1695027,1719601,-,24574
291,BUMA.1121.00062,1,2432464,2457105,-,24641
291,BUMA.1121.00060,1,118332,142940,-,24608
291,BUMA.1121.00070,1,1685704,1710364,-,24660
291,BUMA.1121.00075,1,1590610,1615410,+,24800
291,BUMA.1121.00041,1,3434897,3459492,+,24595
291,BUMA.1121.00073,1,1713068,1737730,-,24662
291,BUMA.1121.00066,1,1688781,1713436,-,24655
291,BUMA.1121.00107,1,2016714,2041412,+,24698
291,BUMA.1121.00112,1,819199,843894,-,24695
291,BUMA.1121.00002,1,3132266,3156985,-,24719
291,BUMA.1121.00082,1,1845953,1870619,-,24666
291,BUMA.1121.00014,1,646917,671688,-,24771
291,BUMA.1121.00011,1,3500349,3525026,-,24677
291,BUMA.1121.00057,1,3222110,3246897,+,24787
291,BUMA.1121.00018,1,2736595,2761332,+,24737
291,BUMA.1121.00039,1,2245066,2269685,+,24619
291,BUMA.1121.00016,1,250953,275601,+,24648
291,BUMA.1121.00005,1,853523,878172,+,24649
291,BUMA.1121.00100,1,3194350,3219053,-,24703
291,BUMA.1121.00006,1,1029056,1053653,-,24597
290,BUMA.1121.00027,1,285684,296645,+,10961
290,BUMA.1121.00025,1,524042,535014,-,10972
290,BUMA.1121.00021,1,2734826,2745792,+,10966
290,BUMA.1121.00023,1,444079,455028,+,10949
290,BUMA.1121.00033,1,252681,263646,+,10965
290,BUMA.1121.00009,1,3433751,3444706,-,10955
290,BUMA.1121.00003,1,609318,620320,+,11002
290,BUMA.1121.00109,1,3761882,3772875,-,10993
290,BUMA.1121.00053,1,1837502,1848480,+,10978
290,BUMA.1121.00110,1,2671387,2682368,-,10981
290,BUMA.1121.00104,1,3111468,3122436,-,10968
290,BUMA.1121.00092,1,1680055,1691027,-,10972
290,BUMA.1121.00096,1,1121847,1132760,-,10913
290,BUMA.1121.00054,1,3077573,3088544,+,10971
290,BUMA.1121.00097,1,1822650,1833635,-,10985
290,BUMA.1121.00093,1,2935257,2946229,+,10972
290,BUMA.1121.00106,1,1870416,1881391,+,10975
290,BUMA.1121.00010,1,3135440,3146411,-,10971
290,BUMA.1121.00035,1,3250486,3261457,+,10971
290,BUMA.1121.00108,1,3133886,3144874,+,10988
290,BUMA.1121.00094,1,2117674,2128658,+,10984
290,BUMA.1121.00102,1,3196264,3207256,-,10992
290,BUMA.1121.00111,1,2289094,2300057,+,10963
290,BUMA.1121.00089,1,2087247,2098231,+,10984
290,BUMA.1121.00084,1,2500077,2511059,+,10982
290,BUMA.1121.00029,1,2825924,2836890,-,10966
290,BUMA.1121.00012,1,852659,863640,+,10981
290,BUMA.1121.00043,1,2191435,2202406,+,10971
290,BUMA.1121.00046,1,2964988,2975954,+,10966
290,BUMA.1121.00037,1,738830,749787,+,10957
290,BUMA.1121.00080,1,2130122,2141110,+,10988
290,BUMA.1121.00079,1,2126359,2137341,+,10982
290,BUMA.1121.00045,1,1916599,1927568,-,10969
290,BUMA.1121.00071,1,1730341,1741289,-,10948
290,BUMA.1121.00056,1,1828336,1839320,-,10984
290,BUMA.1121.00065,1,2202739,2213689,+,10950
290,BUMA.1121.00058,1,2434132,2445101,-,10969
290,BUMA.1121.00007,1,1963500,1974467,-,10967
290,BUMA.1121.00067,1,2276720,2287702,-,10982
290,BUMA.1121.00090,1,213137,224108,+,10971
290,BUMA.1121.00051,1,2100138,2111121,+,10983
290,BUMA.1121.00103,1,2299691,2310662,-,10971
290,BUMA.1121.00048,1,847165,858136,-,10971
290,BUMA.1121.00047,1,849970,860953,-,10983
290,BUMA.1121.00042,1,1693912,1704878,-,10966
290,BUMA.1121.00055,1,1726050,1737014,+,10964
290,BUMA.1121.00031,1,3533499,3544461,+,10962
290,BUMA.1121.00040,1,2162035,2172996,-,10961
290,BUMA.1121.00088,1,3044869,3055846,+,10977
290,BUMA.1121.00069,1,1693292,1704252,-,10960
290,BUMA.1121.00064,1,2141369,2152356,+,10987
290,BUMA.1121.00105,1,3100266,3111243,-,10977
290,BUMA.1121.00015,1,2023012,2033983,+,10971
290,BUMA.1121.00059,1,1315299,1326278,+,10979
290,BUMA.1121.00026,1,3119164,3130130,-,10966
290,BUMA.1121.00022,1,2450369,2461340,-,10971
290,BUMA.1121.00101,1,347235,358116,-,10881
290,BUMA.1121.00001,1,1944162,1955133,-,10971
290,BUMA.1121.00038,1,1054639,1065610,-,10971
290,BUMA.1121.00068,1,869005,879969,+,10964
290,BUMA.1121.00099,1,222866,233841,-,10975
290,BUMA.1121.00091,1,2376131,2387103,-,10972
290,BUMA.1121.00098,1,730370,741335,+,10965
290,BUMA.1121.00013,1,2166970,2177941,+,10971
290,BUMA.1121.00049,1,3753619,3764596,-,10977
290,BUMA.1121.00072,1,1712827,1723787,-,10960
290,BUMA.1121.00076,1,3224443,3235385,-,10942
290,BUMA.1121.00083,1,3527177,3538138,-,10961
290,BUMA.1121.00078,1,3913640,3924595,-,10955
290,BUMA.1121.00095,1,3567659,3578602,-,10943
290,BUMA.1121.00077,1,800783,811762,+,10979
290,BUMA.1121.00063,1,1737453,1748414,-,10961
290,BUMA.1121.00061,1,1740411,1751371,-,10960
290,BUMA.1121.00050,1,3285249,3296215,-,10966
290,BUMA.1121.00081,1,1054708,1065679,-,10971
290,BUMA.1121.00074,1,1720585,1731577,-,10992
290,BUMA.1121.00062,1,2458089,2469071,-,10982
290,BUMA.1121.00060,1,143918,154887,-,10969
290,BUMA.1121.00070,1,1711348,1722308,-,10960
290,BUMA.1121.00075,1,1578697,1589644,+,10947
290,BUMA.1121.00041,1,3422944,3433907,+,10963
290,BUMA.1121.00073,1,1738709,1749670,-,10961
290,BUMA.1121.00066,1,1714413,1725373,-,10960
290,BUMA.1121.00107,1,2004767,2015701,+,10934
290,BUMA.1121.00112,1,844860,855838,-,10978
290,BUMA.1121.00002,1,3157957,3168928,-,10971
290,BUMA.1121.00082,1,1871603,1882564,-,10961
290,BUMA.1121.00014,1,672654,683651,-,10997
290,BUMA.1121.00011,1,3526010,3536989,-,10979
290,BUMA.1121.00057,1,3210165,3221126,+,10961
290,BUMA.1121.00018,1,2724657,2735629,+,10972
290,BUMA.1121.00039,1,2233129,2244100,+,10971
290,BUMA.1121.00016,1,239031,249987,+,10956
290,BUMA.1121.00005,1,841574,852557,+,10983
290,BUMA.1121.00100,1,3220031,3231012,-,10981
290,BUMA.1121.00006,1,1054631,1065602,-,10971
289,BUMA.1121.00027,1,277391,282832,+,5441
289,BUMA.1121.00025,1,537877,543322,-,5445
289,BUMA.1121.00021,1,2726510,2731912,+,5402
289,BUMA.1121.00023,1,435776,441170,+,5394
289,BUMA.1121.00033,1,244373,249767,+,5394
289,BUMA.1121.00009,1,3447563,3453013,-,5450
289,BUMA.1121.00003,1,600983,606396,+,5413
289,BUMA.1121.00109,1,3775747,3781189,-,5442
289,BUMA.1121.00053,1,1829208,1834599,+,5391
289,BUMA.1121.00110,1,2685239,2690688,-,5449
289,BUMA.1121.00104,1,3125287,3130729,-,5442
289,BUMA.1121.00092,1,1693878,1699320,-,5442
289,BUMA.1121.00096,1,1135611,1141071,-,5460
289,BUMA.1121.00054,1,3067959,3073409,+,5450
289,BUMA.1121.00097,1,1836487,1841941,-,5454
289,BUMA.1121.00093,1,2926964,2932355,+,5391
289,BUMA.1121.00106,1,1862122,1867513,+,5391
289,BUMA.1121.00010,1,3150574,3156024,-,5450
289,BUMA.1121.00035,1,3242178,3247578,+,5400
289,BUMA.1121.00108,1,3125580,3130984,+,5404
289,BUMA.1121.00094,1,2109367,2114770,+,5403
289,BUMA.1121.00102,1,3210108,3215550,-,5442
289,BUMA.1121.00111,1,2280778,2286180,+,5402
289,BUMA.1121.00089,1,2078940,2084343,+,5403
289,BUMA.1121.00084,1,2491775,2497174,+,5399
289,BUMA.1121.00029,1,2839746,2845197,-,5451
289,BUMA.1121.00012,1,844347,849750,+,5403
289,BUMA.1121.00043,1,2183125,2188519,+,5394
289,BUMA.1121.00046,1,2955374,2960824,+,5450
289,BUMA.1121.00037,1,730514,735916,+,5402
289,BUMA.1121.00080,1,2121816,2127219,+,5403
289,BUMA.1121.00079,1,2118055,2123457,+,5402
289,BUMA.1121.00045,1,1930417,1935868,-,5451
289,BUMA.1121.00071,1,1744141,1749583,-,5442
289,BUMA.1121.00056,1,1842173,1847627,-,5454
289,BUMA.1121.00065,1,2194446,2199837,+,5391
289,BUMA.1121.00058,1,2447954,2453404,-,5450
289,BUMA.1121.00007,1,1977319,1982773,-,5454
289,BUMA.1121.00067,1,2290553,2295995,-,5442
289,BUMA.1121.00090,1,204832,210223,+,5391
289,BUMA.1121.00051,1,2091833,2097235,+,5402
289,BUMA.1121.00103,1,2313515,2318966,-,5451
289,BUMA.1121.00048,1,862300,867750,-,5450
289,BUMA.1121.00047,1,863805,869259,-,5454
289,BUMA.1121.00042,1,1709043,1714460,-,5417
289,BUMA.1121.00055,1,1717755,1723146,+,5391
289,BUMA.1121.00031,1,3525183,3530585,+,5402
289,BUMA.1121.00088,1,3035390,3040781,+,5391
289,BUMA.1121.00069,1,1707104,1712554,-,5450
289,BUMA.1121.00064,1,2133076,2138467,+,5391
289,BUMA.1121.00105,1,3114095,3119545,-,5450
289,BUMA.1121.00015,1,2013398,2018848,+,5450
289,BUMA.1121.00059,1,1307006,1312397,+,5391
289,BUMA.1121.00026,1,3134295,3139712,-,5417
289,BUMA.1121.00022,1,2465504,2470954,-,5450
289,BUMA.1121.00101,1,360969,366362,-,5393
289,BUMA.1121.00001,1,1957990,1963441,-,5451
289,BUMA.1121.00038,1,1069774,1075224,-,5450
289,BUMA.1121.00068,1,860702,866103,+,5401
289,BUMA.1121.00099,1,236693,242135,-,5442
289,BUMA.1121.00091,1,2389955,2395402,-,5447
289,BUMA.1121.00098,1,722073,727469,+,5396
289,BUMA.1121.00013,1,2157356,2162806,+,5450
289,BUMA.1121.00049,1,3767447,3772900,-,5453
289,BUMA.1121.00072,1,1726639,1732089,-,5450
289,BUMA.1121.00083,1,3540990,3546432,-,5442
289,BUMA.1121.00078,1,3927447,3932898,-,5451
289,BUMA.1121.00095,1,3581425,3586879,-,5454
289,BUMA.1121.00077,1,792463,797861,+,5398
289,BUMA.1121.00063,1,1751266,1756716,-,5450
289,BUMA.1121.00061,1,1754223,1759673,-,5450
289,BUMA.1121.00050,1,3300379,3305829,-,5450
289,BUMA.1121.00081,1,1069843,1075293,-,5450
289,BUMA.1121.00074,1,1734428,1739870,-,5442
289,BUMA.1121.00062,1,2471924,2477366,-,5442
289,BUMA.1121.00060,1,157736,163187,-,5451
289,BUMA.1121.00070,1,1725160,1730602,-,5442
289,BUMA.1121.00041,1,3414650,3420041,+,5391
289,BUMA.1121.00073,1,1752522,1757964,-,5442
289,BUMA.1121.00066,1,1728225,1733667,-,5442
289,BUMA.1121.00107,1,1996462,2001916,+,5454
289,BUMA.1121.00112,1,858690,864132,-,5442
289,BUMA.1121.00002,1,3173092,3178542,-,5450
289,BUMA.1121.00082,1,1885416,1890858,-,5442
289,BUMA.1121.00014,1,686514,691958,-,5444
289,BUMA.1121.00011,1,3539842,3545284,-,5442
289,BUMA.1121.00057,1,3201871,3207313,+,5442
289,BUMA.1121.00018,1,2716349,2721743,+,5394
289,BUMA.1121.00039,1,2224812,2230215,+,5403
289,BUMA.1121.00016,1,230727,236121,+,5394
289,BUMA.1121.00005,1,833267,838671,+,5404
289,BUMA.1121.00100,1,3233883,3239333,-,5450
289,BUMA.1121.00006,1,1069766,1075216,-,5450
288,BUMA.1121.00027,1,272118,275677,+,3559
288,BUMA.1121.00025,1,545012,548743,-,3731
288,BUMA.1121.00021,1,2721171,2724744,+,3573
288,BUMA.1121.00023,1,431018,434590,+,3572
288,BUMA.1121.00033,1,238943,242515,+,3572
288,BUMA.1121.00009,1,3454542,3458265,-,3723
288,BUMA.1121.00003,1,596245,599805,+,3560
288,BUMA.1121.00109,1,3782585,3786325,-,3740
288,BUMA.1121.00053,1,1823862,1827434,+,3572
288,BUMA.1121.00110,1,2692099,2695835,-,3736
288,BUMA.1121.00104,1,3132442,3135979,-,3537
288,BUMA.1121.00092,1,1701033,1704570,-,3537
288,BUMA.1121.00096,1,1141955,1145685,-,3730
288,BUMA.1121.00054,1,3063114,3066673,+,3559
288,BUMA.1121.00097,1,1843268,1846991,-,3723
288,BUMA.1121.00093,1,2921714,2925250,+,3536
288,BUMA.1121.00106,1,1856872,1860408,+,3536
288,BUMA.1121.00010,1,3157286,3161037,-,3751
288,BUMA.1121.00035,1,3236832,3240404,+,3572
288,BUMA.1121.00108,1,3120839,3124378,+,3539
288,BUMA.1121.00094,1,2104934,2108459,+,3525
288,BUMA.1121.00102,1,3217240,3220980,-,3740
288,BUMA.1121.00111,1,2275893,2279408,+,3515
288,BUMA.1121.00089,1,2073533,2077058,+,3525
288,BUMA.1121.00084,1,2486782,2490321,+,3539
288,BUMA.1121.00029,1,2846803,2850543,-,3740
288,BUMA.1121.00012,1,839421,842993,+,3572
288,BUMA.1121.00043,1,2177947,2181519,+,3572
288,BUMA.1121.00046,1,2950529,2954088,+,3559
288,BUMA.1121.00037,1,725343,728892,+,3549
288,BUMA.1121.00080,1,2116577,2120102,+,3525
288,BUMA.1121.00079,1,2112637,2116173,+,3536
288,BUMA.1121.00045,1,1937581,1941130,-,3549
288,BUMA.1121.00071,1,1750822,1754552,-,3730
288,BUMA.1121.00056,1,1849088,1852614,-,3526
288,BUMA.1121.00065,1,2189837,2193378,+,3541
288,BUMA.1121.00058,1,2454666,2458404,-,3738
288,BUMA.1121.00007,1,1983974,1987700,-,3726
288,BUMA.1121.00067,1,2297708,2301245,-,3537
288,BUMA.1121.00090,1,199654,203226,+,3572
288,BUMA.1121.00051,1,2086426,2089951,+,3525
288,BUMA.1121.00103,1,2319984,2323717,-,3733
288,BUMA.1121.00048,1,868844,872595,-,3751
288,BUMA.1121.00047,1,871140,874666,-,3526
288,BUMA.1121.00042,1,1715596,1719347,-,3751
288,BUMA.1121.00055,1,1712608,1716167,+,3559
288,BUMA.1121.00031,1,3519929,3523477,+,3548
288,BUMA.1121.00088,1,3030128,3033676,+,3548
288,BUMA.1121.00069,1,1713984,1717715,-,3731
288,BUMA.1121.00064,1,2127826,2131362,+,3536
288,BUMA.1121.00105,1,3121292,3124841,-,3549
288,BUMA.1121.00015,1,2008553,2012112,+,3559
288,BUMA.1121.00059,1,1301756,1305292,+,3536
288,BUMA.1121.00026,1,3140848,3144599,-,3751
288,BUMA.1121.00022,1,2472216,2475967,-,3751
288,BUMA.1121.00101,1,367899,371613,-,3714
288,BUMA.1121.00001,1,1965047,1968787,-,3740
288,BUMA.1121.00038,1,1076318,1080069,-,3751
288,BUMA.1121.00068,1,855687,859240,+,3553
288,BUMA.1121.00099,1,243672,247401,-,3729
288,BUMA.1121.00091,1,2396420,2400160,-,3740
288,BUMA.1121.00098,1,716936,720485,+,3549
288,BUMA.1121.00013,1,2152763,2156322,+,3559
288,BUMA.1121.00049,1,3774563,3778100,-,3537
288,BUMA.1121.00072,1,1733519,1737250,-,3731
288,BUMA.1121.00083,1,3547870,3551601,-,3731
288,BUMA.1121.00078,1,3933664,3937415,-,3751
288,BUMA.1121.00095,1,3588275,3592002,-,3727
288,BUMA.1121.00077,1,787190,790749,+,3559
288,BUMA.1121.00063,1,1758146,1761877,-,3731
288,BUMA.1121.00061,1,1761103,1764834,-,3731
288,BUMA.1121.00050,1,3306923,3310674,-,3751
288,BUMA.1121.00081,1,1076387,1080138,-,3751
288,BUMA.1121.00074,1,1741583,1745120,-,3537
288,BUMA.1121.00062,1,2478701,2482238,-,3537
288,BUMA.1121.00060,1,164900,168449,-,3549
288,BUMA.1121.00070,1,1732040,1735771,-,3731
288,BUMA.1121.00041,1,3409537,3413062,+,3525
288,BUMA.1121.00073,1,1759402,1763133,-,3731
288,BUMA.1121.00066,1,1735105,1738836,-,3731
288,BUMA.1121.00107,1,1991470,1995000,+,3530
288,BUMA.1121.00112,1,865401,869141,-,3740
288,BUMA.1121.00002,1,3179678,3183429,-,3751
288,BUMA.1121.00082,1,1892296,1896027,-,3731
288,BUMA.1121.00014,1,693489,697221,-,3732
288,BUMA.1121.00011,1,3546821,3550546,-,3725
288,BUMA.1121.00057,1,3196598,3200157,+,3559
288,BUMA.1121.00018,1,2710928,2714491,+,3563
288,BUMA.1121.00039,1,2219382,2222954,+,3572
288,BUMA.1121.00016,1,225297,228869,+,3572
288,BUMA.1121.00005,1,828139,831687,+,3548
288,BUMA.1121.00100,1,3240981,3244710,-,3729
288,BUMA.1121.00006,1,1076310,1080061,-,3751
287,BUMA.1121.00027,1,267708,272116,+,4408
287,BUMA.1121.00025,1,548744,553153,-,4409
287,BUMA.1121.00021,1,2716745,2721169,+,4424
287,BUMA.1121.00023,1,426608,431016,+,4408
287,BUMA.1121.00033,1,234533,238941,+,4408
287,BUMA.1121.00009,1,3458266,3462647,-,4381
287,BUMA.1121.00003,1,591819,596243,+,4424
287,BUMA.1121.00109,1,3786326,3790705,-,4379
287,BUMA.1121.00053,1,1819483,1823860,+,4377
287,BUMA.1121.00110,1,2695836,2700262,-,4426
287,BUMA.1121.00104,1,3135980,3140389,-,4409
287,BUMA.1121.00092,1,1704571,1708996,-,4425
287,BUMA.1121.00096,1,1145686,1150113,-,4427
287,BUMA.1121.00097,1,1846992,1851355,-,4363
287,BUMA.1121.00093,1,2917288,2921712,+,4424
287,BUMA.1121.00106,1,1852462,1856870,+,4408
287,BUMA.1121.00035,1,3232422,3236830,+,4408
287,BUMA.1121.00108,1,3116423,3120837,+,4414
287,BUMA.1121.00094,1,2100508,2104932,+,4424
287,BUMA.1121.00102,1,3220981,3225359,-,4378
287,BUMA.1121.00111,1,2271467,2275891,+,4424
287,BUMA.1121.00089,1,2069107,2073531,+,4424
287,BUMA.1121.00084,1,2482372,2486780,+,4408
287,BUMA.1121.00029,1,2850544,2854953,-,4409
287,BUMA.1121.00012,1,834995,839419,+,4424
287,BUMA.1121.00043,1,2173521,2177945,+,4424
287,BUMA.1121.00037,1,720917,725341,+,4424
287,BUMA.1121.00080,1,2112151,2116575,+,4424
287,BUMA.1121.00079,1,2108211,2112635,+,4424
287,BUMA.1121.00045,1,1941131,1945556,-,4425
287,BUMA.1121.00071,1,1754553,1758931,-,4378
287,BUMA.1121.00056,1,1852615,1857040,-,4425
287,BUMA.1121.00065,1,2185411,2189835,+,4424
287,BUMA.1121.00058,1,2458405,2462830,-,4425
287,BUMA.1121.00007,1,1987701,1992110,-,4409
287,BUMA.1121.00067,1,2301246,2305655,-,4409
287,BUMA.1121.00090,1,195244,199652,+,4408
287,BUMA.1121.00051,1,2082000,2086424,+,4424
287,BUMA.1121.00103,1,2323718,2328127,-,4409
287,BUMA.1121.00047,1,874667,879092,-,4425
287,BUMA.1121.00055,1,1708198,1712606,+,4408
287,BUMA.1121.00031,1,3515513,3519927,+,4414
287,BUMA.1121.00088,1,3025702,3030126,+,4424
287,BUMA.1121.00069,1,1717716,1722141,-,4425
287,BUMA.1121.00064,1,2123416,2127824,+,4408
287,BUMA.1121.00105,1,3124842,3129267,-,4425
287,BUMA.1121.00059,1,1297346,1301754,+,4408
287,BUMA.1121.00101,1,371614,376023,-,4409
287,BUMA.1121.00001,1,1968788,1973197,-,4409
287,BUMA.1121.00068,1,851287,855685,+,4398
287,BUMA.1121.00099,1,247402,251813,-,4411
287,BUMA.1121.00091,1,2400161,2404570,-,4409
287,BUMA.1121.00098,1,712556,716934,+,4378
287,BUMA.1121.00049,1,3778101,3782510,-,4409
287,BUMA.1121.00072,1,1737251,1741676,-,4425
287,BUMA.1121.00083,1,3551602,3556027,-,4425
287,BUMA.1121.00078,1,3937416,3941825,-,4409
287,BUMA.1121.00095,1,3592003,3596382,-,4379
287,BUMA.1121.00077,1,782763,787188,+,4425
287,BUMA.1121.00063,1,1761878,1766303,-,4425
287,BUMA.1121.00061,1,1764835,1769260,-,4425
287,BUMA.1121.00074,1,1745121,1749530,-,4409
287,BUMA.1121.00062,1,2482239,2486648,-,4409
287,BUMA.1121.00060,1,168450,172875,-,4425
287,BUMA.1121.00070,1,1735772,1740197,-,4425
287,BUMA.1121.00041,1,3405111,3409535,+,4424
287,BUMA.1121.00073,1,1763134,1767559,-,4425
287,BUMA.1121.00066,1,1738837,1743262,-,4425
287,BUMA.1121.00107,1,1987044,1991468,+,4424
287,BUMA.1121.00112,1,869142,873551,-,4409
287,BUMA.1121.00082,1,1896028,1900453,-,4425
287,BUMA.1121.00014,1,697222,701637,-,4415
287,BUMA.1121.00011,1,3550547,3554910,-,4363
287,BUMA.1121.00057,1,3192172,3196596,+,4424
287,BUMA.1121.00018,1,2706518,2710926,+,4408
287,BUMA.1121.00039,1,2214972,2219380,+,4408
287,BUMA.1121.00016,1,220887,225295,+,4408
287,BUMA.1121.00005,1,823713,828137,+,4424
287,BUMA.1121.00100,1,3244711,3249136,-,4425
286,BUMA.1121.00027,1,248960,262357,+,13397
286,BUMA.1121.00009,1,3468453,3481848,-,13395
286,BUMA.1121.00109,1,3809598,3822975,-,13377
286,BUMA.1121.00053,1,1800559,1813953,+,13394
286,BUMA.1121.00110,1,2706063,2719458,-,13395
286,BUMA.1121.00104,1,3146183,3159566,-,13383
286,BUMA.1121.00092,1,1714529,1727924,-,13395
286,BUMA.1121.00096,1,1155462,1168857,-,13395
286,BUMA.1121.00097,1,1856707,1870105,-,13398
286,BUMA.1121.00093,1,2898360,2911754,+,13394
286,BUMA.1121.00106,1,1833285,1846667,+,13382
286,BUMA.1121.00108,1,3097936,3111330,+,13394
286,BUMA.1121.00102,1,3230888,3244287,-,13399
286,BUMA.1121.00084,1,2463168,2476564,+,13396
286,BUMA.1121.00045,1,1951362,1964755,-,13393
286,BUMA.1121.00071,1,1764271,1777669,-,13398
286,BUMA.1121.00065,1,2166924,2180320,+,13396
286,BUMA.1121.00007,1,1997477,2010872,-,13395
286,BUMA.1121.00067,1,2311003,2324402,-,13399
286,BUMA.1121.00090,1,176305,189697,+,13392
286,BUMA.1121.00103,1,2335149,2348559,-,13410
286,BUMA.1121.00055,1,1689263,1702655,+,13392
286,BUMA.1121.00088,1,3006502,3019900,+,13398
286,BUMA.1121.00069,1,1727485,1740884,-,13399
286,BUMA.1121.00064,1,2104669,2118067,+,13398
286,BUMA.1121.00105,1,3134615,3148013,-,13398
286,BUMA.1121.00059,1,1278149,1291547,+,13398
286,BUMA.1121.00101,1,381831,395226,-,13395
286,BUMA.1121.00068,1,832092,845490,+,13398
286,BUMA.1121.00099,1,257168,270562,-,13394
286,BUMA.1121.00091,1,2409921,2422516,-,12595
286,BUMA.1121.00098,1,693376,706768,+,13392
286,BUMA.1121.00049,1,3788304,3801691,-,13387
286,BUMA.1121.00072,1,1747020,1760419,-,13399
286,BUMA.1121.00083,1,3561371,3574770,-,13399
286,BUMA.1121.00078,1,3947628,3961023,-,13395
286,BUMA.1121.00095,1,3602187,3615578,-,13391
286,BUMA.1121.00077,1,763567,776961,+,13394
286,BUMA.1121.00063,1,1771647,1785046,-,13399
286,BUMA.1121.00061,1,1774604,1788002,-,13398
286,BUMA.1121.00074,1,1754878,1768277,-,13399
286,BUMA.1121.00060,1,178681,192074,-,13393
286,BUMA.1121.00070,1,1745541,1758940,-,13399
286,BUMA.1121.00041,1,3386345,3399743,+,13398
286,BUMA.1121.00073,1,1772903,1786302,-,13399
286,BUMA.1121.00066,1,1748606,1762005,-,13399
286,BUMA.1121.00107,1,1967858,1981255,+,13397
286,BUMA.1121.00112,1,878907,892300,-,13393
286,BUMA.1121.00082,1,1905797,1919196,-,13399
286,BUMA.1121.00011,1,3560693,3574088,-,13395
286,BUMA.1121.00057,1,3173259,3186641,+,13382
286,BUMA.1121.00100,1,3255846,3268730,-,12884
285,BUMA.1121.00027,1,242594,247371,+,4777
285,BUMA.1121.00025,1,560244,565024,-,4780
285,BUMA.1121.00021,1,2706198,2710977,+,4779
285,BUMA.1121.00023,1,416045,420840,+,4795
285,BUMA.1121.00033,1,223986,228780,+,4794
285,BUMA.1121.00009,1,3483437,3488216,-,4779
285,BUMA.1121.00109,1,3824559,3829343,-,4784
285,BUMA.1121.00053,1,1794191,1798969,+,4778
285,BUMA.1121.00110,1,2721042,2725826,-,4784
285,BUMA.1121.00104,1,3161155,3165934,-,4779
285,BUMA.1121.00092,1,1729514,1734293,-,4779
285,BUMA.1121.00096,1,1170446,1175225,-,4779
285,BUMA.1121.00097,1,1871697,1876491,-,4794
285,BUMA.1121.00093,1,2891991,2896769,+,4778
285,BUMA.1121.00106,1,1826917,1831695,+,4778
285,BUMA.1121.00035,1,3221874,3226667,+,4793
285,BUMA.1121.00108,1,3091567,3096346,+,4779
285,BUMA.1121.00094,1,2090054,2094832,+,4778
285,BUMA.1121.00102,1,3247116,3251895,-,4779
285,BUMA.1121.00111,1,2260921,2265700,+,4779
285,BUMA.1121.00089,1,2058653,2063431,+,4778
285,BUMA.1121.00084,1,2456799,2461577,+,4778
285,BUMA.1121.00029,1,2860707,2865500,-,4793
285,BUMA.1121.00012,1,824433,829228,+,4795
285,BUMA.1121.00043,1,2161602,2166382,+,4780
285,BUMA.1121.00037,1,710356,715150,+,4794
285,BUMA.1121.00080,1,2101697,2106475,+,4778
285,BUMA.1121.00079,1,2097757,2102535,+,4778
285,BUMA.1121.00045,1,1966345,1971124,-,4779
285,BUMA.1121.00071,1,1780498,1785277,-,4779
285,BUMA.1121.00056,1,1862715,1867494,-,4779
285,BUMA.1121.00065,1,2160555,2165333,+,4778
285,BUMA.1121.00058,1,2469479,2474258,-,4779
285,BUMA.1121.00007,1,2012461,2017240,-,4779
285,BUMA.1121.00067,1,2325991,2330770,-,4779
285,BUMA.1121.00090,1,168696,173474,+,4778
285,BUMA.1121.00051,1,2071546,2076324,+,4778
285,BUMA.1121.00103,1,2350149,2354928,-,4779
285,BUMA.1121.00047,1,884767,889546,-,4779
285,BUMA.1121.00055,1,1682894,1687672,+,4778
285,BUMA.1121.00031,1,3504964,3509758,+,4794
285,BUMA.1121.00088,1,3000133,3004912,+,4779
285,BUMA.1121.00069,1,1743714,1748493,-,4779
285,BUMA.1121.00064,1,2098301,2103079,+,4778
285,BUMA.1121.00105,1,3149603,3154382,-,4779
285,BUMA.1121.00059,1,1271780,1276558,+,4778
285,BUMA.1121.00101,1,396814,401593,-,4779
285,BUMA.1121.00001,1,1978951,1983745,-,4794
285,BUMA.1121.00068,1,825722,830502,+,4780
285,BUMA.1121.00099,1,272152,276931,-,4779
285,BUMA.1121.00091,1,2425346,2430127,-,4781
285,BUMA.1121.00098,1,687007,691785,+,4778
285,BUMA.1121.00049,1,3803280,3808059,-,4779
285,BUMA.1121.00072,1,1763246,1768025,-,4779
285,BUMA.1121.00076,1,3240663,3245442,-,4779
285,BUMA.1121.00083,1,3577600,3582379,-,4779
285,BUMA.1121.00078,1,3963853,3968632,-,4779
285,BUMA.1121.00095,1,3617167,3621947,-,4780
285,BUMA.1121.00077,1,757200,761983,+,4783
285,BUMA.1121.00063,1,1787876,1792652,-,4776
285,BUMA.1121.00061,1,1790832,1795611,-,4779
285,BUMA.1121.00074,1,1769866,1774645,-,4779
285,BUMA.1121.00062,1,2493292,2498071,-,4779
285,BUMA.1121.00060,1,193664,198443,-,4779
285,BUMA.1121.00070,1,1761770,1766549,-,4779
285,BUMA.1121.00075,1,1568640,1573418,+,4778
285,BUMA.1121.00041,1,3377375,3382152,+,4777
285,BUMA.1121.00073,1,1789132,1793911,-,4779
285,BUMA.1121.00066,1,1764835,1769614,-,4779
285,BUMA.1121.00107,1,1961488,1966267,+,4779
285,BUMA.1121.00112,1,893890,898669,-,4779
285,BUMA.1121.00082,1,1922026,1926805,-,4779
285,BUMA.1121.00014,1,707391,712170,-,4779
285,BUMA.1121.00011,1,3575677,3580471,-,4794
285,BUMA.1121.00057,1,3166888,3171668,+,4780
285,BUMA.1121.00018,1,2694648,2699427,+,4779
285,BUMA.1121.00039,1,2204410,2209204,+,4794
285,BUMA.1121.00016,1,210325,215119,+,4794
285,BUMA.1121.00005,1,812278,817058,+,4780
284,BUMA.1121.00027,1,222092,239713,+,17621
284,BUMA.1121.00025,1,567905,585529,-,17624
284,BUMA.1121.00021,1,2682431,2701409,+,18978
284,BUMA.1121.00023,1,395540,413165,+,17625
284,BUMA.1121.00033,1,203483,221107,+,17624
284,BUMA.1121.00009,1,3490143,3507768,-,17625
284,BUMA.1121.00109,1,3832224,3849849,-,17625
284,BUMA.1121.00053,1,1774641,1792264,+,17623
284,BUMA.1121.00110,1,2728707,2746330,-,17623
284,BUMA.1121.00104,1,3168815,3186440,-,17625
284,BUMA.1121.00092,1,1737174,1754799,-,17625
284,BUMA.1121.00096,1,1178106,1195729,-,17623
284,BUMA.1121.00097,1,1878418,1896041,-,17623
284,BUMA.1121.00093,1,2871485,2889110,+,17625
284,BUMA.1121.00106,1,1806411,1824036,+,17625
284,BUMA.1121.00035,1,3201369,3218993,+,17624
284,BUMA.1121.00108,1,3072018,3089641,+,17623
284,BUMA.1121.00094,1,2069548,2087173,+,17625
284,BUMA.1121.00102,1,3254776,3272399,-,17623
284,BUMA.1121.00111,1,2240415,2258040,+,17625
284,BUMA.1121.00089,1,2038147,2055772,+,17625
284,BUMA.1121.00084,1,2437247,2454872,+,17625
284,BUMA.1121.00029,1,2868381,2886005,-,17624
284,BUMA.1121.00012,1,803928,821553,+,17625
284,BUMA.1121.00043,1,2141097,2158722,+,17625
284,BUMA.1121.00037,1,689850,707475,+,17625
284,BUMA.1121.00080,1,2082145,2099770,+,17625
284,BUMA.1121.00079,1,2077251,2094876,+,17625
284,BUMA.1121.00045,1,1974005,1991630,-,17625
284,BUMA.1121.00071,1,1788158,1805781,-,17623
284,BUMA.1121.00056,1,1870375,1888000,-,17625
284,BUMA.1121.00065,1,2140052,2157674,+,17622
284,BUMA.1121.00058,1,2477139,2494764,-,17625
284,BUMA.1121.00007,1,2020121,2037746,-,17625
284,BUMA.1121.00067,1,2333651,2351276,-,17625
284,BUMA.1121.00090,1,148190,165815,+,17625
284,BUMA.1121.00051,1,2051041,2068665,+,17624
284,BUMA.1121.00103,1,2357809,2375434,-,17625
284,BUMA.1121.00047,1,892427,910052,-,17625
284,BUMA.1121.00055,1,1662388,1680013,+,17625
284,BUMA.1121.00031,1,3484457,3502083,+,17626
284,BUMA.1121.00088,1,2979628,2997253,+,17625
284,BUMA.1121.00069,1,1751374,1768997,-,17623
284,BUMA.1121.00064,1,2077795,2095420,+,17625
284,BUMA.1121.00105,1,3157263,3174888,-,17625
284,BUMA.1121.00059,1,1251274,1268899,+,17625
284,BUMA.1121.00101,1,404474,422099,-,17625
284,BUMA.1121.00001,1,1986626,2004249,-,17623
284,BUMA.1121.00068,1,805217,822841,+,17624
284,BUMA.1121.00099,1,279812,297453,-,17641
284,BUMA.1121.00091,1,2433008,2450635,-,17627
284,BUMA.1121.00098,1,666503,684126,+,17623
284,BUMA.1121.00049,1,3810940,3828565,-,17625
284,BUMA.1121.00072,1,1770906,1788529,-,17623
284,BUMA.1121.00076,1,3248323,3265948,-,17625
284,BUMA.1121.00083,1,3585260,3602883,-,17623
284,BUMA.1121.00078,1,3971513,3989136,-,17623
284,BUMA.1121.00095,1,3624828,3642451,-,17623
284,BUMA.1121.00077,1,736697,754319,+,17622
284,BUMA.1121.00063,1,1795471,1813094,-,17623
284,BUMA.1121.00061,1,1798492,1816115,-,17623
284,BUMA.1121.00074,1,1777526,1795151,-,17625
284,BUMA.1121.00062,1,2500952,2518577,-,17625
284,BUMA.1121.00060,1,201324,218949,-,17625
284,BUMA.1121.00070,1,1769430,1787053,-,17623
284,BUMA.1121.00075,1,1548134,1565759,+,17625
284,BUMA.1121.00041,1,3356871,3374494,+,17623
284,BUMA.1121.00073,1,1796792,1814415,-,17623
284,BUMA.1121.00066,1,1772495,1790118,-,17623
284,BUMA.1121.00107,1,1940983,1958608,+,17625
284,BUMA.1121.00112,1,901550,919175,-,17625
284,BUMA.1121.00082,1,1929686,1947309,-,17623
284,BUMA.1121.00014,1,715051,732676,-,17625
284,BUMA.1121.00011,1,3582398,3600021,-,17623
284,BUMA.1121.00057,1,3146382,3164007,+,17625
284,BUMA.1121.00018,1,2674143,2691767,+,17624
284,BUMA.1121.00039,1,2183905,2201530,+,17625
284,BUMA.1121.00016,1,189821,207445,+,17624
284,BUMA.1121.00005,1,791774,809397,+,17623
283,BUMA.1121.00027,1,212577,215667,+,3090
283,BUMA.1121.00009,1,3514196,3517274,-,3078
283,BUMA.1121.00109,1,3857730,3860808,-,3078
283,BUMA.1121.00053,1,1765137,1768215,+,3078
283,BUMA.1121.00110,1,2752760,2755833,-,3073
283,BUMA.1121.00104,1,3192868,3195964,-,3096
283,BUMA.1121.00092,1,1761223,1764325,-,3102
283,BUMA.1121.00096,1,1202160,1205238,-,3078
283,BUMA.1121.00097,1,1903326,1906404,-,3078
283,BUMA.1121.00093,1,2861958,2865060,+,3102
283,BUMA.1121.00106,1,1796890,1799986,+,3096
283,BUMA.1121.00108,1,3062677,3065767,+,3090
283,BUMA.1121.00094,1,2060045,2063123,+,3078
283,BUMA.1121.00102,1,3278823,3281901,-,3078
283,BUMA.1121.00089,1,2028656,2031734,+,3078
283,BUMA.1121.00084,1,2427739,2430817,+,3078
283,BUMA.1121.00080,1,2072642,2075720,+,3078
283,BUMA.1121.00079,1,2067748,2070826,+,3078
283,BUMA.1121.00045,1,1998058,2001136,-,3078
283,BUMA.1121.00071,1,1812206,1815294,-,3088
283,BUMA.1121.00056,1,1894412,1897490,-,3078
283,BUMA.1121.00065,1,2130549,2133627,+,3078
283,BUMA.1121.00058,1,2501191,2504269,-,3078
283,BUMA.1121.00067,1,2357700,2360778,-,3078
283,BUMA.1121.00090,1,138692,141770,+,3078
283,BUMA.1121.00051,1,2040182,2043260,+,3078
283,BUMA.1121.00047,1,916476,919554,-,3078
283,BUMA.1121.00055,1,1652885,1655963,+,3078
283,BUMA.1121.00088,1,2970107,2973203,+,3096
283,BUMA.1121.00069,1,1775422,1778510,-,3088
283,BUMA.1121.00064,1,2068288,2071366,+,3078
283,BUMA.1121.00105,1,3181141,3184219,-,3078
283,BUMA.1121.00059,1,1241753,1244849,+,3096
283,BUMA.1121.00101,1,428526,431604,-,3078
283,BUMA.1121.00068,1,795709,798787,+,3078
283,BUMA.1121.00099,1,303702,306780,-,3078
283,BUMA.1121.00091,1,2484919,2488021,-,3102
283,BUMA.1121.00098,1,656998,660076,+,3078
283,BUMA.1121.00049,1,3834989,3838067,-,3078
283,BUMA.1121.00072,1,1794954,1798044,-,3090
283,BUMA.1121.00076,1,3272372,3275450,-,3078
283,BUMA.1121.00083,1,3609308,3612398,-,3090
283,BUMA.1121.00078,1,3995556,3998650,-,3094
283,BUMA.1121.00095,1,3648875,3651975,-,3100
283,BUMA.1121.00077,1,727192,730265,+,3073
283,BUMA.1121.00063,1,1819519,1822608,-,3089
283,BUMA.1121.00061,1,1822540,1825630,-,3090
283,BUMA.1121.00074,1,1801575,1804653,-,3078
283,BUMA.1121.00062,1,2525002,2528080,-,3078
283,BUMA.1121.00060,1,225377,228455,-,3078
283,BUMA.1121.00070,1,1793478,1796567,-,3089
283,BUMA.1121.00075,1,1537391,1540469,+,3078
283,BUMA.1121.00073,1,1820840,1823930,-,3090
283,BUMA.1121.00066,1,1796543,1799632,-,3089
283,BUMA.1121.00107,1,1931481,1934559,+,3078
283,BUMA.1121.00112,1,925616,928700,-,3084
283,BUMA.1121.00082,1,1953734,1956824,-,3090
283,BUMA.1121.00011,1,3606267,3609345,-,3078
283,BUMA.1121.00057,1,3136868,3139958,+,3090
283,BUMA.1121.00005,1,780744,783822,+,3078
282,BUMA.1121.00027,1,207525,212576,+,5051
282,BUMA.1121.00009,1,3517276,3522327,-,5051
282,BUMA.1121.00109,1,3860810,3865861,-,5051
282,BUMA.1121.00053,1,1760085,1765136,+,5051
282,BUMA.1121.00110,1,2755835,2760886,-,5051
282,BUMA.1121.00104,1,3195966,3201017,-,5051
282,BUMA.1121.00092,1,1764327,1769378,-,5051
282,BUMA.1121.00096,1,1205240,1210291,-,5051
282,BUMA.1121.00097,1,1906406,1911457,-,5051
282,BUMA.1121.00093,1,2856906,2861957,+,5051
282,BUMA.1121.00106,1,1791838,1796889,+,5051
282,BUMA.1121.00108,1,3057625,3062676,+,5051
282,BUMA.1121.00094,1,2054993,2060044,+,5051
282,BUMA.1121.00102,1,3281903,3286954,-,5051
282,BUMA.1121.00089,1,2023604,2028655,+,5051
282,BUMA.1121.00084,1,2422687,2427738,+,5051
282,BUMA.1121.00080,1,2067590,2072641,+,5051
282,BUMA.1121.00079,1,2062696,2067747,+,5051
282,BUMA.1121.00045,1,2001138,2006189,-,5051
282,BUMA.1121.00071,1,1815296,1820347,-,5051
282,BUMA.1121.00056,1,1897492,1902543,-,5051
282,BUMA.1121.00065,1,2125497,2130548,+,5051
282,BUMA.1121.00058,1,2504271,2509321,-,5050
282,BUMA.1121.00067,1,2360780,2365831,-,5051
282,BUMA.1121.00090,1,133640,138691,+,5051
282,BUMA.1121.00051,1,2035130,2040181,+,5051
282,BUMA.1121.00047,1,919556,924607,-,5051
282,BUMA.1121.00055,1,1647833,1652884,+,5051
282,BUMA.1121.00088,1,2965055,2970106,+,5051
282,BUMA.1121.00069,1,1778512,1783563,-,5051
282,BUMA.1121.00064,1,2063236,2068287,+,5051
282,BUMA.1121.00105,1,3184221,3189272,-,5051
282,BUMA.1121.00059,1,1236701,1241752,+,5051
282,BUMA.1121.00101,1,431606,436657,-,5051
282,BUMA.1121.00068,1,790657,795708,+,5051
282,BUMA.1121.00099,1,306782,311833,-,5051
282,BUMA.1121.00091,1,2488023,2493074,-,5051
282,BUMA.1121.00098,1,651946,656997,+,5051
282,BUMA.1121.00049,1,3838069,3843120,-,5051
282,BUMA.1121.00072,1,1798046,1803097,-,5051
282,BUMA.1121.00076,1,3275452,3280503,-,5051
282,BUMA.1121.00083,1,3612400,3617451,-,5051
282,BUMA.1121.00078,1,3998670,4003671,+,5001
282,BUMA.1121.00095,1,3651977,3657028,-,5051
282,BUMA.1121.00077,1,722140,727191,+,5051
282,BUMA.1121.00063,1,1822610,1827661,-,5051
282,BUMA.1121.00061,1,1825632,1830683,-,5051
282,BUMA.1121.00074,1,1804655,1809706,-,5051
282,BUMA.1121.00062,1,2528082,2533133,-,5051
282,BUMA.1121.00060,1,228457,233508,-,5051
282,BUMA.1121.00070,1,1796569,1801620,-,5051
282,BUMA.1121.00075,1,1532339,1537390,+,5051
282,BUMA.1121.00073,1,1823932,1828983,-,5051
282,BUMA.1121.00066,1,1799634,1804685,-,5051
282,BUMA.1121.00107,1,1926429,1931480,+,5051
282,BUMA.1121.00112,1,928702,933753,-,5051
282,BUMA.1121.00082,1,1956826,1961877,-,5051
282,BUMA.1121.00011,1,3609347,3614398,-,5051
282,BUMA.1121.00057,1,3131816,3136867,+,5051
282,BUMA.1121.00005,1,775692,780743,+,5051
281,BUMA.1121.00027,1,198409,203718,+,5309
281,BUMA.1121.00025,1,590793,596101,-,5308
281,BUMA.1121.00021,1,2670834,2676142,+,5308
281,BUMA.1121.00023,1,382712,388022,+,5310
281,BUMA.1121.00033,1,191885,197193,+,5308
281,BUMA.1121.00009,1,3526099,3531413,-,5314
281,BUMA.1121.00109,1,3869633,3874947,-,5314
281,BUMA.1121.00053,1,1750998,1756313,+,5315
281,BUMA.1121.00110,1,2764658,2769972,-,5314
281,BUMA.1121.00104,1,3204824,3210132,-,5308
281,BUMA.1121.00092,1,1773150,1778457,-,5307
281,BUMA.1121.00096,1,1214063,1219377,-,5314
281,BUMA.1121.00097,1,1915229,1920539,-,5310
281,BUMA.1121.00093,1,2847827,2853134,+,5307
281,BUMA.1121.00106,1,1782757,1788066,+,5309
281,BUMA.1121.00035,1,3189771,3195079,+,5308
281,BUMA.1121.00108,1,3048539,3053853,+,5314
281,BUMA.1121.00094,1,2045914,2051221,+,5307
281,BUMA.1121.00102,1,3290726,3296036,-,5310
281,BUMA.1121.00111,1,2228816,2234124,+,5308
281,BUMA.1121.00089,1,2014525,2019832,+,5307
281,BUMA.1121.00084,1,2413608,2418915,+,5307
281,BUMA.1121.00029,1,2892295,2897602,-,5307
281,BUMA.1121.00012,1,792330,797638,+,5308
281,BUMA.1121.00043,1,2129501,2134809,+,5308
281,BUMA.1121.00037,1,678254,683562,+,5308
281,BUMA.1121.00080,1,2058511,2063818,+,5307
281,BUMA.1121.00079,1,2053618,2058925,+,5307
281,BUMA.1121.00045,1,2009961,2015275,-,5314
281,BUMA.1121.00071,1,1824119,1829433,-,5314
281,BUMA.1121.00056,1,1906315,1911622,-,5307
281,BUMA.1121.00065,1,2116410,2121725,+,5315
281,BUMA.1121.00058,1,2513093,2518402,-,5309
281,BUMA.1121.00007,1,2041648,2046963,-,5315
281,BUMA.1121.00067,1,2369638,2374948,-,5310
281,BUMA.1121.00090,1,124558,129868,+,5310
281,BUMA.1121.00051,1,2026051,2031358,+,5307
281,BUMA.1121.00103,1,2385397,2390706,-,5309
281,BUMA.1121.00047,1,928379,933686,-,5307
281,BUMA.1121.00055,1,1638746,1644061,+,5315
281,BUMA.1121.00031,1,3471527,3476835,+,5308
281,BUMA.1121.00088,1,2955974,2961283,+,5309
281,BUMA.1121.00069,1,1787335,1792649,-,5314
281,BUMA.1121.00064,1,2054119,2059429,+,5310
281,BUMA.1121.00105,1,3193044,3198351,-,5307
281,BUMA.1121.00059,1,1227620,1232929,+,5309
281,BUMA.1121.00101,1,440429,445744,-,5315
281,BUMA.1121.00001,1,2010538,2015846,-,5308
281,BUMA.1121.00068,1,781571,786885,+,5314
281,BUMA.1121.00099,1,315605,320919,-,5314
281,BUMA.1121.00091,1,2496845,2502155,-,5310
281,BUMA.1121.00098,1,642865,648174,+,5309
281,BUMA.1121.00049,1,3846891,3852198,-,5307
281,BUMA.1121.00072,1,1806869,1812183,-,5314
281,BUMA.1121.00076,1,3284275,3289584,-,5309
281,BUMA.1121.00083,1,3621223,3626537,-,5314
281,BUMA.1121.00078,1,4007459,4012774,-,5315
281,BUMA.1121.00095,1,3660800,3666117,-,5317
281,BUMA.1121.00077,1,713054,718368,+,5314
281,BUMA.1121.00063,1,1831433,1836747,-,5314
281,BUMA.1121.00061,1,1834455,1839769,-,5314
281,BUMA.1121.00074,1,1813513,1818822,-,5309
281,BUMA.1121.00062,1,2536905,2542212,-,5307
281,BUMA.1121.00060,1,237280,242584,-,5304
281,BUMA.1121.00070,1,1805392,1810706,-,5314
281,BUMA.1121.00075,1,1523258,1528567,+,5309
281,BUMA.1121.00041,1,3342264,3347526,+,5262
281,BUMA.1121.00073,1,1832755,1838069,-,5314
281,BUMA.1121.00066,1,1808457,1813771,-,5314
281,BUMA.1121.00107,1,1917342,1922657,+,5315
281,BUMA.1121.00112,1,937525,942840,-,5315
281,BUMA.1121.00082,1,1965649,1970963,-,5314
281,BUMA.1121.00014,1,740299,745607,-,5308
281,BUMA.1121.00011,1,3618170,3623485,-,5315
281,BUMA.1121.00057,1,3122694,3128009,+,5315
281,BUMA.1121.00018,1,2663571,2668879,+,5308
281,BUMA.1121.00039,1,2170974,2176282,+,5308
281,BUMA.1121.00016,1,178224,183532,+,5308
281,BUMA.1121.00005,1,766612,771920,+,5308
281,BUMA.1121.00100,1,3305698,3311001,-,5303
280,BUMA.1121.00027,1,172380,193665,+,21285
280,BUMA.1121.00025,1,600522,621801,-,21279
280,BUMA.1121.00021,1,2645127,2666406,+,21279
280,BUMA.1121.00023,1,357001,378286,+,21285
280,BUMA.1121.00033,1,166160,187457,+,21297
280,BUMA.1121.00009,1,3557684,3578960,-,21276
280,BUMA.1121.00003,1,561279,582555,+,21276
280,BUMA.1121.00109,1,3879679,3900954,-,21275
280,BUMA.1121.00053,1,1724898,1746189,+,21291
280,BUMA.1121.00110,1,2788661,2809940,-,21279
280,BUMA.1121.00104,1,3214873,3236146,-,21273
280,BUMA.1121.00092,1,1805456,1826741,-,21285
280,BUMA.1121.00096,1,1260492,1281796,-,21304
280,BUMA.1121.00097,1,1925261,1946528,-,21267
280,BUMA.1121.00093,1,2799542,2820827,+,21285
280,BUMA.1121.00106,1,1756742,1778015,+,21273
280,BUMA.1121.00035,1,3164063,3185348,+,21285
280,BUMA.1121.00108,1,2965378,2986651,+,21273
280,BUMA.1121.00094,1,2019671,2040950,+,21279
280,BUMA.1121.00102,1,3300865,3322138,-,21273
280,BUMA.1121.00111,1,2203104,2224388,+,21284
280,BUMA.1121.00089,1,1988282,2009561,+,21279
280,BUMA.1121.00084,1,2365323,2386608,+,21285
280,BUMA.1121.00029,1,2902024,2923309,-,21285
280,BUMA.1121.00012,1,766618,787903,+,21285
280,BUMA.1121.00043,1,2103793,2125072,+,21279
280,BUMA.1121.00037,1,652541,673826,+,21285
280,BUMA.1121.00080,1,2018328,2039606,+,21278
280,BUMA.1121.00079,1,2013600,2034878,+,21278
280,BUMA.1121.00045,1,2041821,2063103,-,21282
280,BUMA.1121.00071,1,1834078,1855355,-,21277
280,BUMA.1121.00056,1,1916585,1937864,-,21279
280,BUMA.1121.00065,1,2090167,2111452,+,21285
280,BUMA.1121.00058,1,2545401,2566692,-,21291
280,BUMA.1121.00007,1,2051799,2073060,-,21261
280,BUMA.1121.00067,1,2379685,2400958,-,21273
280,BUMA.1121.00090,1,76316,97601,+,21285
280,BUMA.1121.00051,1,1999814,2021087,+,21273
280,BUMA.1121.00103,1,2395668,2416941,-,21273
280,BUMA.1121.00047,1,938649,959928,-,21279
280,BUMA.1121.00042,1,1724488,1745724,-,21236
280,BUMA.1121.00055,1,1576536,1597809,+,21273
280,BUMA.1121.00031,1,3445814,3467099,+,21285
280,BUMA.1121.00088,1,2907703,2928976,+,21273
280,BUMA.1121.00069,1,1816943,1838228,-,21285
280,BUMA.1121.00064,1,2014288,2035573,+,21285
280,BUMA.1121.00105,1,3203094,3224379,-,21285
280,BUMA.1121.00059,1,1201609,1222882,+,21273
280,BUMA.1121.00026,1,3149738,3170934,-,21196
280,BUMA.1121.00101,1,472286,493568,-,21282
280,BUMA.1121.00001,1,2020268,2041548,-,21280
280,BUMA.1121.00068,1,755486,776766,+,21280
280,BUMA.1121.00099,1,325649,346922,-,21273
280,BUMA.1121.00091,1,2531777,2553050,-,21273
280,BUMA.1121.00098,1,581934,603207,+,21273
280,BUMA.1121.00049,1,3857038,3878311,-,21273
280,BUMA.1121.00072,1,1816947,1838232,-,21285
280,BUMA.1121.00076,1,3294317,3315590,-,21273
280,BUMA.1121.00083,1,3653530,3674815,-,21285
280,BUMA.1121.00078,1,4017616,4038888,-,21272
280,BUMA.1121.00095,1,3670758,3691994,-,21236
280,BUMA.1121.00077,1,673076,694364,+,21288
280,BUMA.1121.00063,1,1841538,1862823,-,21285
280,BUMA.1121.00061,1,1844430,1865715,-,21285
280,BUMA.1121.00074,1,1824777,1846050,-,21273
280,BUMA.1121.00062,1,2547175,2568460,-,21285
280,BUMA.1121.00060,1,269130,290412,-,21282
280,BUMA.1121.00070,1,1815457,1836742,-,21285
280,BUMA.1121.00075,1,1497252,1518525,+,21273
280,BUMA.1121.00041,1,3316155,3337422,+,21267
280,BUMA.1121.00073,1,1842473,1863758,-,21285
280,BUMA.1121.00066,1,1818375,1839656,-,21281
280,BUMA.1121.00107,1,1891269,1912545,+,21276
280,BUMA.1121.00112,1,983963,1005218,-,21255
280,BUMA.1121.00082,1,1997956,2019241,-,21285
280,BUMA.1121.00014,1,750034,771319,-,21285
280,BUMA.1121.00011,1,3650350,3671623,-,21273
280,BUMA.1121.00057,1,3074415,3095700,+,21285
280,BUMA.1121.00018,1,2637870,2659149,+,21279
280,BUMA.1121.00039,1,2145279,2166546,+,21267
280,BUMA.1121.00016,1,152516,173801,+,21285
280,BUMA.1121.00005,1,718573,739844,+,21271
280,BUMA.1121.00100,1,3317029,3338293,-,21264
279,BUMA.1121.00027,1,161112,170561,+,9449
279,BUMA.1121.00025,1,623612,633063,-,9451
279,BUMA.1121.00021,1,2633858,2643308,+,9450
279,BUMA.1121.00023,1,345732,355182,+,9450
279,BUMA.1121.00033,1,154899,164349,+,9450
279,BUMA.1121.00009,1,3580779,3590230,-,9451
279,BUMA.1121.00003,1,550010,559460,+,9450
279,BUMA.1121.00109,1,3902757,3912208,-,9451
279,BUMA.1121.00053,1,1713629,1723079,+,9450
279,BUMA.1121.00110,1,2811767,2821218,-,9451
279,BUMA.1121.00104,1,3237965,3247416,-,9451
279,BUMA.1121.00092,1,1828560,1838011,-,9451
279,BUMA.1121.00096,1,1283615,1293066,-,9451
279,BUMA.1121.00097,1,1948347,1957798,-,9451
279,BUMA.1121.00093,1,2788273,2797723,+,9450
279,BUMA.1121.00106,1,1745473,1754923,+,9450
279,BUMA.1121.00035,1,3152800,3162250,+,9450
279,BUMA.1121.00108,1,2954117,2963567,+,9450
279,BUMA.1121.00094,1,2008402,2017852,+,9450
279,BUMA.1121.00102,1,3323957,3333408,-,9451
279,BUMA.1121.00111,1,2191835,2201285,+,9450
279,BUMA.1121.00089,1,1977013,1986463,+,9450
279,BUMA.1121.00084,1,2354054,2363504,+,9450
279,BUMA.1121.00029,1,2925128,2934579,-,9451
279,BUMA.1121.00012,1,755349,764799,+,9450
279,BUMA.1121.00043,1,2092524,2101974,+,9450
279,BUMA.1121.00037,1,641272,650722,+,9450
279,BUMA.1121.00080,1,2007059,2016509,+,9450
279,BUMA.1121.00079,1,2002331,2011781,+,9450
279,BUMA.1121.00045,1,2064922,2074373,-,9451
279,BUMA.1121.00071,1,1857174,1866625,-,9451
279,BUMA.1121.00056,1,1939683,1949134,-,9451
279,BUMA.1121.00065,1,2078898,2088348,+,9450
279,BUMA.1121.00058,1,2568511,2577962,-,9451
279,BUMA.1121.00007,1,2074879,2084330,-,9451
279,BUMA.1121.00067,1,2402777,2412228,-,9451
279,BUMA.1121.00090,1,65047,74497,+,9450
279,BUMA.1121.00051,1,1988545,1997995,+,9450
279,BUMA.1121.00103,1,2418760,2428209,-,9449
279,BUMA.1121.00047,1,961747,971198,-,9451
279,BUMA.1121.00042,1,1747496,1756927,-,9431
279,BUMA.1121.00055,1,1565267,1574717,+,9450
279,BUMA.1121.00031,1,3434545,3443995,+,9450
279,BUMA.1121.00088,1,2896434,2905884,+,9450
279,BUMA.1121.00069,1,1840047,1849498,-,9451
279,BUMA.1121.00064,1,2003019,2012469,+,9450
279,BUMA.1121.00105,1,3226198,3235649,-,9451
279,BUMA.1121.00059,1,1190340,1199790,+,9450
279,BUMA.1121.00026,1,3172714,3182145,-,9431
279,BUMA.1121.00101,1,495384,504835,-,9451
279,BUMA.1121.00001,1,2043367,2052818,-,9451
279,BUMA.1121.00068,1,744219,753667,+,9448
279,BUMA.1121.00099,1,348741,358192,-,9451
279,BUMA.1121.00091,1,2554869,2564320,-,9451
279,BUMA.1121.00098,1,570665,580115,+,9450
279,BUMA.1121.00049,1,3880130,3889581,-,9451
279,BUMA.1121.00072,1,1840051,1849502,-,9451
279,BUMA.1121.00076,1,3317409,3326860,-,9451
279,BUMA.1121.00083,1,3676634,3686085,-,9451
279,BUMA.1121.00078,1,4040707,4050158,-,9451
279,BUMA.1121.00095,1,3693810,3703261,-,9451
279,BUMA.1121.00077,1,661803,671253,+,9450
279,BUMA.1121.00063,1,1864642,1874093,-,9451
279,BUMA.1121.00061,1,1867534,1876985,-,9451
279,BUMA.1121.00074,1,1847869,1857320,-,9451
279,BUMA.1121.00062,1,2570279,2579730,-,9451
279,BUMA.1121.00060,1,292231,301682,-,9451
279,BUMA.1121.00070,1,1838561,1848012,-,9451
279,BUMA.1121.00075,1,1485983,1495433,+,9450
279,BUMA.1121.00041,1,3304886,3314336,+,9450
279,BUMA.1121.00073,1,1865577,1875028,-,9451
279,BUMA.1121.00066,1,1841475,1850926,-,9451
279,BUMA.1121.00107,1,1880001,1889451,+,9450
279,BUMA.1121.00112,1,1007037,1016488,-,9451
279,BUMA.1121.00082,1,2021060,2030511,-,9451
279,BUMA.1121.00014,1,773138,782589,-,9451
279,BUMA.1121.00011,1,3673442,3682902,-,9460
279,BUMA.1121.00057,1,3063146,3072596,+,9450
279,BUMA.1121.00018,1,2626609,2636059,+,9450
279,BUMA.1121.00039,1,2134010,2143460,+,9450
279,BUMA.1121.00016,1,141258,150708,+,9450
279,BUMA.1121.00005,1,707320,716758,+,9438
279,BUMA.1121.00100,1,3340112,3349563,-,9451
278,BUMA.1121.00027,1,154377,159744,+,5367
278,BUMA.1121.00025,1,634431,639760,-,5329
278,BUMA.1121.00021,1,2627173,2632490,+,5317
278,BUMA.1121.00023,1,339050,344364,+,5314
278,BUMA.1121.00024,1,2139622,2144996,-,5374
278,BUMA.1121.00033,1,148161,153531,+,5370
278,BUMA.1121.00034,1,2177102,2182476,-,5374
278,BUMA.1121.00036,1,1875849,1881222,-,5373
278,BUMA.1121.00032,1,206514,211887,-,5373
278,BUMA.1121.00009,1,3591598,3596958,-,5360
278,BUMA.1121.00008,1,2152703,2158077,-,5374
278,BUMA.1121.00003,1,543283,548642,+,5359
278,BUMA.1121.00109,1,3913576,3918862,-,5286
278,BUMA.1121.00053,1,1706900,1712261,+,5361
278,BUMA.1121.00110,1,2822586,2827900,-,5314
278,BUMA.1121.00104,1,3248784,3254116,-,5332
278,BUMA.1121.00086,1,918704,924077,+,5373
278,BUMA.1121.00092,1,1839379,1844736,-,5357
278,BUMA.1121.00096,1,1294434,1299788,-,5354
278,BUMA.1121.00054,1,2975238,2980611,+,5373
278,BUMA.1121.00097,1,1959166,1964532,-,5366
278,BUMA.1121.00093,1,2781548,2786905,+,5357
278,BUMA.1121.00106,1,1738773,1744105,+,5332
278,BUMA.1121.00010,1,3312196,3317569,+,5373
278,BUMA.1121.00035,1,3146072,3151432,+,5360
278,BUMA.1121.00108,1,2947401,2952749,+,5348
278,BUMA.1121.00028,1,2139669,2145043,-,5374
278,BUMA.1121.00094,1,2001721,2007034,+,5313
278,BUMA.1121.00102,1,3334776,3340136,-,5360
278,BUMA.1121.00111,1,2185095,2190467,+,5372
278,BUMA.1121.00089,1,1970313,1975645,+,5332
278,BUMA.1121.00084,1,2347363,2352686,+,5323
278,BUMA.1121.00029,1,2937290,2942599,-,5309
278,BUMA.1121.00012,1,748659,753981,+,5322
278,BUMA.1121.00087,1,2392706,2398079,-,5373
278,BUMA.1121.00043,1,2085833,2091156,+,5323
278,BUMA.1121.00046,1,2862652,2868025,+,5373
278,BUMA.1121.00037,1,634575,639904,+,5329
278,BUMA.1121.00080,1,2000378,2005691,+,5313
278,BUMA.1121.00079,1,1995646,2000963,+,5317
278,BUMA.1121.00045,1,2075741,2081076,-,5335
278,BUMA.1121.00071,1,1867993,1873312,-,5319
278,BUMA.1121.00056,1,1950502,1955834,-,5332
278,BUMA.1121.00065,1,2072206,2077530,+,5324
278,BUMA.1121.00058,1,2579330,2584659,-,5329
278,BUMA.1121.00007,1,2085698,2091014,-,5316
278,BUMA.1121.00067,1,2413596,2418913,-,5317
278,BUMA.1121.00090,1,58356,63679,+,5323
278,BUMA.1121.00051,1,1981864,1987177,+,5313
278,BUMA.1121.00020,1,2204568,2209942,-,5374
278,BUMA.1121.00103,1,2429577,2434931,-,5354
278,BUMA.1121.00048,1,955097,960470,-,5373
278,BUMA.1121.00047,1,972566,977879,-,5313
278,BUMA.1121.00042,1,1632150,1637522,+,5372
278,BUMA.1121.00055,1,1558571,1563899,+,5328
278,BUMA.1121.00031,1,3427803,3433177,+,5374
278,BUMA.1121.00040,1,2259354,2264726,-,5372
278,BUMA.1121.00044,1,1405214,1410588,-,5374
278,BUMA.1121.00088,1,2889696,2895066,+,5370
278,BUMA.1121.00069,1,1850866,1856183,-,5317
278,BUMA.1121.00064,1,1996322,2001651,+,5329
278,BUMA.1121.00105,1,3237017,3242343,-,5326
278,BUMA.1121.00015,1,1920675,1926048,+,5373
278,BUMA.1121.00059,1,1183625,1188972,+,5347
278,BUMA.1121.00026,1,3057422,3062795,+,5373
278,BUMA.1121.00022,1,2649488,2654815,+,5327
278,BUMA.1121.00052,1,1939670,1945043,-,5373
278,BUMA.1121.00101,1,506203,511535,-,5332
278,BUMA.1121.00001,1,2054186,2059546,-,5360
278,BUMA.1121.00038,1,1162573,1167946,-,5373
278,BUMA.1121.00068,1,737471,742851,+,5380
278,BUMA.1121.00099,1,359563,364935,-,5372
278,BUMA.1121.00091,1,2565688,2571005,-,5317
278,BUMA.1121.00098,1,563958,569297,+,5339
278,BUMA.1121.00013,1,2064895,2070269,+,5374
278,BUMA.1121.00049,1,3890949,3896281,-,5332
278,BUMA.1121.00072,1,1850870,1856195,-,5325
278,BUMA.1121.00076,1,3328228,3333551,-,5323
278,BUMA.1121.00083,1,3687453,3692781,-,5328
278,BUMA.1121.00078,1,4051526,4056837,-,5311
278,BUMA.1121.00095,1,3704629,3709994,-,5365
278,BUMA.1121.00077,1,655121,660435,+,5314
278,BUMA.1121.00063,1,1875461,1880779,-,5318
278,BUMA.1121.00061,1,1878353,1883670,-,5317
278,BUMA.1121.00050,1,3393177,3398550,-,5373
278,BUMA.1121.00081,1,1162642,1168015,-,5373
278,BUMA.1121.00074,1,1858688,1864005,-,5317
278,BUMA.1121.00062,1,2581098,2586458,-,5360
278,BUMA.1121.00060,1,303050,308385,-,5335
278,BUMA.1121.00070,1,1849380,1854699,-,5319
278,BUMA.1121.00075,1,1479292,1484615,+,5323
278,BUMA.1121.00041,1,3298159,3303518,+,5359
278,BUMA.1121.00073,1,1876396,1881713,-,5317
278,BUMA.1121.00017,1,2074721,2080095,-,5374
278,BUMA.1121.00066,1,1852294,1857622,-,5328
278,BUMA.1121.00107,1,1873318,1878633,+,5315
278,BUMA.1121.00085,1,1536615,1541989,-,5374
278,BUMA.1121.00030,1,2074794,2080168,-,5374
278,BUMA.1121.00112,1,1017856,1023227,-,5371
278,BUMA.1121.00002,1,3334652,3340024,+,5372
278,BUMA.1121.00082,1,2031879,2037207,-,5328
278,BUMA.1121.00014,1,783957,789332,-,5375
278,BUMA.1121.00011,1,3684270,3689563,-,5293
278,BUMA.1121.00019,1,2139762,2145136,-,5374
278,BUMA.1121.00057,1,3056408,3061778,+,5370
278,BUMA.1121.00018,1,2619912,2625241,+,5329
278,BUMA.1121.00039,1,2127277,2132642,+,5365
278,BUMA.1121.00016,1,134563,139890,+,5327
278,BUMA.1121.00004,1,2139620,2144994,-,5374
278,BUMA.1121.00005,1,700589,705952,+,5363
278,BUMA.1121.00100,1,3350931,3356288,-,5357
278,BUMA.1121.00006,1,1162565,1167938,-,5373
277,BUMA.1121.00027,1,119918,151950,+,32032
277,BUMA.1121.00025,1,642187,674211,-,32024
277,BUMA.1121.00021,1,2592786,2624746,+,31960
277,BUMA.1121.00023,1,304679,336637,+,31958
277,BUMA.1121.00024,1,2147423,2179571,-,32148
277,BUMA.1121.00033,1,113823,145734,+,31911
277,BUMA.1121.00034,1,2184903,2216939,-,32036
277,BUMA.1121.00036,1,1883649,1915736,-,32087
277,BUMA.1121.00032,1,214314,246414,-,32100
277,BUMA.1121.00009,1,3599385,3631337,-,31952
277,BUMA.1121.00008,1,2160504,2192540,-,32036
277,BUMA.1121.00003,1,508886,540870,+,31984
277,BUMA.1121.00109,1,3921296,3953210,-,31914
277,BUMA.1121.00053,1,1672987,1704466,+,31479
277,BUMA.1121.00110,1,2827905,2859347,-,31442
277,BUMA.1121.00104,1,3256543,3288082,-,31539
277,BUMA.1121.00086,1,884293,916277,+,31984
277,BUMA.1121.00092,1,1847160,1879230,-,32070
277,BUMA.1121.00096,1,1302222,1334133,-,31911
277,BUMA.1121.00054,1,2940597,2972811,+,32214
277,BUMA.1121.00097,1,1966959,1998822,-,31863
277,BUMA.1121.00093,1,2747075,2779125,+,32050
277,BUMA.1121.00106,1,1704776,1736346,+,31570
277,BUMA.1121.00010,1,3277820,3309769,+,31949
277,BUMA.1121.00035,1,3111647,3143645,+,31998
277,BUMA.1121.00108,1,2913060,2944977,+,31917
277,BUMA.1121.00028,1,2147470,2179546,-,32076
277,BUMA.1121.00094,1,1967612,1999287,+,31675
277,BUMA.1121.00102,1,3342552,3374849,-,32297
277,BUMA.1121.00111,1,2150722,2182668,+,31946
277,BUMA.1121.00089,1,1936212,1967886,+,31674
277,BUMA.1121.00084,1,2313410,2344929,+,31519
277,BUMA.1121.00029,1,2945026,2977055,-,32029
277,BUMA.1121.00012,1,714282,746232,+,31950
277,BUMA.1121.00087,1,2400506,2432489,-,31983
277,BUMA.1121.00043,1,2051435,2083449,+,32014
277,BUMA.1121.00046,1,2828111,2860225,+,32114
277,BUMA.1121.00037,1,600293,632148,+,31855
277,BUMA.1121.00080,1,1966300,1997944,+,31644
277,BUMA.1121.00079,1,1961481,1993219,+,31738
277,BUMA.1121.00045,1,2083507,2115389,-,31882
277,BUMA.1121.00071,1,1875739,1907764,-,32025
277,BUMA.1121.00056,1,1958261,1989926,-,31665
277,BUMA.1121.00065,1,2038163,2069775,+,31612
277,BUMA.1121.00058,1,2587083,2619034,-,31951
277,BUMA.1121.00007,1,2093441,2125469,-,32028
277,BUMA.1121.00067,1,2421340,2452939,-,31599
277,BUMA.1121.00090,1,23968,55929,+,31961
277,BUMA.1121.00051,1,1947717,1979430,+,31713
277,BUMA.1121.00020,1,2212369,2244405,-,32036
277,BUMA.1121.00103,1,2437358,2469285,-,31927
277,BUMA.1121.00048,1,962897,995116,-,32219
277,BUMA.1121.00047,1,980313,1012062,-,31749
277,BUMA.1121.00042,1,1597706,1629723,+,32017
277,BUMA.1121.00055,1,1524018,1556147,+,32129
277,BUMA.1121.00031,1,3393964,3426011,+,32047
277,BUMA.1121.00040,1,2267153,2299220,-,32067
277,BUMA.1121.00044,1,1413015,1445059,-,32044
277,BUMA.1121.00088,1,2855715,2887269,+,31554
277,BUMA.1121.00069,1,1858610,1890201,-,31591
277,BUMA.1121.00064,1,1961889,1993895,+,32006
277,BUMA.1121.00105,1,3244777,3276719,-,31942
277,BUMA.1121.00015,1,1886113,1918248,+,32135
277,BUMA.1121.00059,1,1149272,1181198,+,31926
277,BUMA.1121.00026,1,3022994,3054995,+,32001
277,BUMA.1121.00022,1,2614949,2647061,+,32112
277,BUMA.1121.00052,1,1947470,1979674,-,32204
277,BUMA.1121.00101,1,513959,545902,-,31943
277,BUMA.1121.00001,1,2061973,2094041,-,32068
277,BUMA.1121.00038,1,1170373,1202602,-,32229
277,BUMA.1121.00068,1,702963,735037,+,32074
277,BUMA.1121.00099,1,367362,399321,-,31959
277,BUMA.1121.00091,1,2573436,2605475,-,32039
277,BUMA.1121.00098,1,529516,561528,+,32012
277,BUMA.1121.00013,1,2030503,2062468,+,31965
277,BUMA.1121.00049,1,3898708,3930199,-,31491
277,BUMA.1121.00072,1,1858622,1890661,-,32039
277,BUMA.1121.00076,1,3335978,3368042,-,32064
277,BUMA.1121.00083,1,3695208,3727254,-,32046
277,BUMA.1121.00078,1,4059264,4091331,-,32067
277,BUMA.1121.00095,1,3712418,3744378,-,31960
277,BUMA.1121.00077,1,623629,655116,+,31487
277,BUMA.1121.00063,1,1883206,1915245,-,32039
277,BUMA.1121.00061,1,1886097,1918142,-,32045
277,BUMA.1121.00050,1,3400977,3433074,-,32097
277,BUMA.1121.00081,1,1170442,1202663,-,32221
277,BUMA.1121.00074,1,1866432,1897973,-,31541
277,BUMA.1121.00062,1,2588882,2620901,-,32019
277,BUMA.1121.00060,1,310816,342714,-,31898
277,BUMA.1121.00070,1,1857126,1889171,-,32045
277,BUMA.1121.00075,1,1444877,1476867,+,31990
277,BUMA.1121.00041,1,3263692,3295735,+,32043
277,BUMA.1121.00073,1,1884140,1916186,-,32046
277,BUMA.1121.00017,1,2082522,2114566,-,32044
277,BUMA.1121.00066,1,1860049,1892091,-,32042
277,BUMA.1121.00107,1,1839309,1870905,+,31596
277,BUMA.1121.00085,1,1544416,1576620,-,32204
277,BUMA.1121.00030,1,2082595,2114639,-,32044
277,BUMA.1121.00112,1,1025658,1057694,-,32036
277,BUMA.1121.00002,1,3300228,3332225,+,31997
277,BUMA.1121.00082,1,2039634,2071680,-,32046
277,BUMA.1121.00014,1,791124,823186,-,32062
277,BUMA.1121.00011,1,3691989,3723877,-,31888
277,BUMA.1121.00019,1,2147563,2179623,-,32060
277,BUMA.1121.00057,1,3021925,3053981,+,32056
277,BUMA.1121.00018,1,2585548,2617485,+,31937
277,BUMA.1121.00039,1,2092895,2124850,+,31955
277,BUMA.1121.00016,1,100036,132136,+,32100
277,BUMA.1121.00004,1,2147421,2179431,-,32010
277,BUMA.1121.00005,1,666099,698162,+,32063
277,BUMA.1121.00100,1,3358715,3390737,-,32022
277,BUMA.1121.00006,1,1170365,1202586,-,32221
276,BUMA.1121.00027,1,111102,117940,+,6838
276,BUMA.1121.00025,1,676205,683044,-,6839
276,BUMA.1121.00021,1,2583969,2590807,+,6838
276,BUMA.1121.00023,1,295862,302700,+,6838
276,BUMA.1121.00024,1,2181550,2188388,-,6838
276,BUMA.1121.00033,1,105015,111829,+,6814
276,BUMA.1121.00034,1,2218918,2225756,-,6838
276,BUMA.1121.00036,1,1917715,1924553,-,6838
276,BUMA.1121.00032,1,248393,255231,-,6838
276,BUMA.1121.00009,1,3633316,3640155,-,6839
276,BUMA.1121.00008,1,2194519,2201357,-,6838
276,BUMA.1121.00003,1,500069,506907,+,6838
276,BUMA.1121.00109,1,3955179,3962034,-,6855
276,BUMA.1121.00053,1,1664155,1670993,+,6838
276,BUMA.1121.00110,1,2861326,2868165,-,6839
276,BUMA.1121.00104,1,3290076,3296894,-,6818
276,BUMA.1121.00086,1,875477,882314,+,6837
276,BUMA.1121.00092,1,1881209,1888048,-,6839
276,BUMA.1121.00096,1,1336112,1342951,-,6839
276,BUMA.1121.00054,1,2931787,2938618,+,6831
276,BUMA.1121.00097,1,2000791,2007637,-,6846
276,BUMA.1121.00093,1,2738258,2745096,+,6838
276,BUMA.1121.00106,1,1695944,1702782,+,6838
276,BUMA.1121.00010,1,3269004,3275841,+,6837
276,BUMA.1121.00035,1,3102815,3109653,+,6838
276,BUMA.1121.00108,1,2904228,2911081,+,6853
276,BUMA.1121.00028,1,2181525,2188363,-,6838
276,BUMA.1121.00094,1,1958817,1965633,+,6816
276,BUMA.1121.00102,1,3376828,3383667,-,6839
276,BUMA.1121.00111,1,2141890,2148728,+,6838
276,BUMA.1121.00089,1,1927416,1934233,+,6817
276,BUMA.1121.00084,1,2304593,2311431,+,6838
276,BUMA.1121.00029,1,2979049,2985888,-,6839
276,BUMA.1121.00012,1,705450,712288,+,6838
276,BUMA.1121.00087,1,2434468,2441306,-,6838
276,BUMA.1121.00043,1,2042618,2049456,+,6838
276,BUMA.1121.00046,1,2819295,2826132,+,6837
276,BUMA.1121.00037,1,591476,598314,+,6838
276,BUMA.1121.00080,1,1957505,1964321,+,6816
276,BUMA.1121.00079,1,1952688,1959502,+,6814
276,BUMA.1121.00045,1,2117368,2124183,-,6815
276,BUMA.1121.00071,1,1909758,1916597,-,6839
276,BUMA.1121.00056,1,1991905,1998723,-,6818
276,BUMA.1121.00065,1,2029367,2036184,+,6817
276,BUMA.1121.00058,1,2621013,2627831,-,6818
276,BUMA.1121.00007,1,2127438,2134287,-,6849
276,BUMA.1121.00067,1,2454918,2461736,-,6818
276,BUMA.1121.00090,1,15151,21989,+,6838
276,BUMA.1121.00051,1,1938923,1945739,+,6816
276,BUMA.1121.00020,1,2246384,2253222,-,6838
276,BUMA.1121.00103,1,2471264,2478104,-,6840
276,BUMA.1121.00048,1,997095,1003927,-,6832
276,BUMA.1121.00047,1,1014041,1020858,-,6817
276,BUMA.1121.00042,1,1588890,1595727,+,6837
276,BUMA.1121.00055,1,1515201,1522039,+,6838
276,BUMA.1121.00031,1,3385160,3391985,+,6825
276,BUMA.1121.00040,1,2301199,2308037,-,6838
276,BUMA.1121.00044,1,1447038,1453876,-,6838
276,BUMA.1121.00088,1,2846892,2853736,+,6844
276,BUMA.1121.00069,1,1892180,1899019,-,6839
276,BUMA.1121.00064,1,1953093,1959919,+,6826
276,BUMA.1121.00105,1,3278698,3285536,-,6838
276,BUMA.1121.00015,1,1877297,1884134,+,6837
276,BUMA.1121.00059,1,1140455,1147293,+,6838
276,BUMA.1121.00026,1,3014178,3021015,+,6837
276,BUMA.1121.00022,1,2606133,2612970,+,6837
276,BUMA.1121.00052,1,1981653,1988491,-,6838
276,BUMA.1121.00101,1,547881,554734,-,6853
276,BUMA.1121.00001,1,2096035,2102874,-,6839
276,BUMA.1121.00038,1,1204581,1211413,-,6832
276,BUMA.1121.00068,1,694161,700984,+,6823
276,BUMA.1121.00099,1,401300,408136,-,6836
276,BUMA.1121.00091,1,2607469,2614308,-,6839
276,BUMA.1121.00098,1,520699,527537,+,6838
276,BUMA.1121.00013,1,2021687,2028524,+,6837
276,BUMA.1121.00049,1,3932178,3938973,-,6795
276,BUMA.1121.00072,1,1892640,1899479,-,6839
276,BUMA.1121.00076,1,3370036,3376888,-,6852
276,BUMA.1121.00083,1,3729233,3736072,-,6839
276,BUMA.1121.00078,1,4093311,4100161,-,6850
276,BUMA.1121.00095,1,3746357,3753211,-,6854
276,BUMA.1121.00077,1,614812,621650,+,6838
276,BUMA.1121.00063,1,1917224,1924063,-,6839
276,BUMA.1121.00061,1,1920121,1926960,-,6839
276,BUMA.1121.00050,1,3435053,3441891,-,6838
276,BUMA.1121.00081,1,1204642,1211474,-,6832
276,BUMA.1121.00074,1,1899952,1906770,-,6818
276,BUMA.1121.00062,1,2622880,2629698,-,6818
276,BUMA.1121.00060,1,344693,351508,-,6815
276,BUMA.1121.00070,1,1891150,1897989,-,6839
276,BUMA.1121.00075,1,1436036,1442884,+,6848
276,BUMA.1121.00041,1,3254876,3261713,+,6837
276,BUMA.1121.00073,1,1918165,1925004,-,6839
276,BUMA.1121.00017,1,2116545,2123383,-,6838
276,BUMA.1121.00066,1,1894070,1900909,-,6839
276,BUMA.1121.00107,1,1830496,1837331,+,6835
276,BUMA.1121.00085,1,1578599,1585437,-,6838
276,BUMA.1121.00030,1,2116618,2123456,-,6838
276,BUMA.1121.00112,1,1059673,1066510,-,6837
276,BUMA.1121.00002,1,3291412,3298249,+,6837
276,BUMA.1121.00082,1,2073659,2080498,-,6839
276,BUMA.1121.00014,1,825165,832004,-,6839
276,BUMA.1121.00011,1,3725846,3732674,-,6828
276,BUMA.1121.00019,1,2181602,2188440,-,6838
276,BUMA.1121.00057,1,3013108,3019946,+,6838
276,BUMA.1121.00018,1,2576716,2583554,+,6838
276,BUMA.1121.00039,1,2084086,2090901,+,6815
276,BUMA.1121.00016,1,91220,98057,+,6837
276,BUMA.1121.00004,1,2181410,2188248,-,6838
276,BUMA.1121.00005,1,657309,664124,+,6815
276,BUMA.1121.00100,1,3392716,3399553,-,6837
276,BUMA.1121.00006,1,1204565,1211397,-,6832
275,BUMA.1121.00027,1,106792,110377,+,3585
275,BUMA.1121.00025,1,683769,687374,-,3605
275,BUMA.1121.00021,1,2579663,2583255,+,3592
275,BUMA.1121.00023,1,291568,295160,+,3592
275,BUMA.1121.00024,1,2189077,2192663,-,3586
275,BUMA.1121.00033,1,100721,104301,+,3580
275,BUMA.1121.00034,1,2226445,2230031,-,3586
275,BUMA.1121.00036,1,1925242,1928828,-,3586
275,BUMA.1121.00032,1,255920,259506,-,3586
275,BUMA.1121.00009,1,3640844,3644448,-,3604
275,BUMA.1121.00008,1,2202046,2205632,-,3586
275,BUMA.1121.00003,1,495748,499380,+,3632
275,BUMA.1121.00109,1,3962747,3966363,-,3616
275,BUMA.1121.00053,1,1649168,1652754,+,3586
275,BUMA.1121.00110,1,2868854,2872452,-,3598
275,BUMA.1121.00104,1,3297583,3301181,-,3598
275,BUMA.1121.00086,1,871201,874788,+,3587
275,BUMA.1121.00092,1,1888725,1892323,-,3598
275,BUMA.1121.00096,1,1343640,1347257,-,3617
275,BUMA.1121.00054,1,2927553,2931098,+,3545
275,BUMA.1121.00097,1,2008313,2011924,-,3611
275,BUMA.1121.00093,1,2733982,2737568,+,3586
275,BUMA.1121.00106,1,1691684,1695242,+,3558
275,BUMA.1121.00010,1,3264728,3268315,+,3587
275,BUMA.1121.00035,1,3098509,3102101,+,3592
275,BUMA.1121.00108,1,2899907,2903526,+,3619
275,BUMA.1121.00028,1,2189052,2192638,-,3586
275,BUMA.1121.00094,1,1954535,1958128,+,3593
275,BUMA.1121.00102,1,3395078,3398576,-,3498
275,BUMA.1121.00111,1,2126783,2130375,+,3592
275,BUMA.1121.00089,1,1923156,1926714,+,3558
275,BUMA.1121.00084,1,2289865,2293457,+,3592
275,BUMA.1121.00029,1,2986589,2990193,-,3604
275,BUMA.1121.00012,1,701144,704724,+,3580
275,BUMA.1121.00087,1,2441995,2445581,-,3586
275,BUMA.1121.00043,1,2038318,2041904,+,3586
275,BUMA.1121.00046,1,2815019,2818606,+,3587
275,BUMA.1121.00037,1,587176,590762,+,3586
275,BUMA.1121.00080,1,1953223,1956816,+,3593
275,BUMA.1121.00079,1,1948406,1951999,+,3593
275,BUMA.1121.00045,1,2124872,2128482,-,3610
275,BUMA.1121.00071,1,1917328,1920914,-,3586
275,BUMA.1121.00056,1,1999412,2002982,-,3570
275,BUMA.1121.00065,1,2025107,2028665,+,3558
275,BUMA.1121.00058,1,2628508,2632078,-,3570
275,BUMA.1121.00007,1,2134976,2138610,-,3634
275,BUMA.1121.00067,1,2462425,2465995,-,3570
275,BUMA.1121.00090,1,29,3636,+,3607
275,BUMA.1121.00051,1,1934641,1938234,+,3593
275,BUMA.1121.00020,1,2253911,2257497,-,3586
275,BUMA.1121.00103,1,2478793,2482391,-,3598
275,BUMA.1121.00048,1,1004616,1008160,-,3544
275,BUMA.1121.00047,1,1021547,1025139,-,3592
275,BUMA.1121.00042,1,1584614,1588201,+,3587
275,BUMA.1121.00055,1,1510887,1514500,+,3613
275,BUMA.1121.00031,1,3380848,3384434,+,3586
275,BUMA.1121.00040,1,2308726,2312312,-,3586
275,BUMA.1121.00044,1,1454565,1458151,-,3586
275,BUMA.1121.00088,1,2832149,2835719,+,3570
275,BUMA.1121.00069,1,1899738,1903324,-,3586
275,BUMA.1121.00064,1,1948833,1952391,+,3558
275,BUMA.1121.00105,1,3296658,3300262,-,3604
275,BUMA.1121.00015,1,1873021,1876608,+,3587
275,BUMA.1121.00059,1,1136179,1139765,+,3586
275,BUMA.1121.00026,1,3009902,3013489,+,3587
275,BUMA.1121.00022,1,2601857,2605444,+,3587
275,BUMA.1121.00052,1,1989180,1992766,-,3586
275,BUMA.1121.00101,1,555422,559026,-,3604
275,BUMA.1121.00001,1,2103575,2107179,-,3604
275,BUMA.1121.00038,1,1212102,1215646,-,3544
275,BUMA.1121.00068,1,689874,693460,+,3586
275,BUMA.1121.00099,1,408824,412431,-,3607
275,BUMA.1121.00091,1,2615077,2618675,-,3598
275,BUMA.1121.00098,1,516360,519997,+,3637
275,BUMA.1121.00013,1,2017411,2020998,+,3587
275,BUMA.1121.00049,1,3950372,3954000,-,3628
275,BUMA.1121.00072,1,1900167,1903791,-,3624
275,BUMA.1121.00076,1,3388011,3391615,-,3604
275,BUMA.1121.00083,1,3736808,3740406,-,3598
275,BUMA.1121.00078,1,4100850,4104430,-,3580
275,BUMA.1121.00095,1,3753900,3757504,-,3604
275,BUMA.1121.00077,1,610524,614110,+,3586
275,BUMA.1121.00063,1,1924751,1928370,-,3619
275,BUMA.1121.00061,1,1927648,1931255,-,3607
275,BUMA.1121.00050,1,3442580,3446166,-,3586
275,BUMA.1121.00081,1,1212163,1215707,-,3544
275,BUMA.1121.00074,1,1907459,1911029,-,3570
275,BUMA.1121.00062,1,2630375,2633973,-,3598
275,BUMA.1121.00060,1,352197,355807,-,3610
275,BUMA.1121.00070,1,1898677,1902310,-,3633
275,BUMA.1121.00075,1,1421308,1424900,+,3592
275,BUMA.1121.00041,1,3239884,3243476,+,3592
275,BUMA.1121.00073,1,1925692,1929321,-,3629
275,BUMA.1121.00017,1,2124072,2127658,-,3586
275,BUMA.1121.00066,1,1901597,1905218,-,3621
275,BUMA.1121.00107,1,1826202,1829794,+,3592
275,BUMA.1121.00085,1,1586126,1589712,-,3586
275,BUMA.1121.00030,1,2124145,2127731,-,3586
275,BUMA.1121.00112,1,1077898,1081508,-,3610
275,BUMA.1121.00002,1,3287136,3290723,+,3587
275,BUMA.1121.00082,1,2081234,2084832,-,3598
275,BUMA.1121.00014,1,832717,836315,-,3598
275,BUMA.1121.00011,1,3733363,3736979,-,3616
275,BUMA.1121.00019,1,2189129,2192715,-,3586
275,BUMA.1121.00057,1,3008826,3012419,+,3593
275,BUMA.1121.00018,1,2572385,2575978,+,3593
275,BUMA.1121.00039,1,2068979,2072571,+,3592
275,BUMA.1121.00016,1,86915,90494,+,3579
275,BUMA.1121.00004,1,2188937,2192523,-,3586
275,BUMA.1121.00005,1,642495,646123,+,3628
275,BUMA.1121.00100,1,3400242,3403855,-,3613
275,BUMA.1121.00006,1,1212086,1215630,-,3544
274,BUMA.1121.00027,1,89379,101287,+,11908
274,BUMA.1121.00025,1,692880,704843,-,11963
274,BUMA.1121.00021,1,2562242,2574157,+,11915
274,BUMA.1121.00023,1,274128,286062,+,11934
274,BUMA.1121.00024,1,2197984,2209882,-,11898
274,BUMA.1121.00033,1,83289,95215,+,11926
274,BUMA.1121.00034,1,2235352,2247250,-,11898
274,BUMA.1121.00036,1,1934149,1946047,-,11898
274,BUMA.1121.00032,1,264827,276725,-,11898
274,BUMA.1121.00009,1,3649954,3661863,-,11909
274,BUMA.1121.00008,1,2210953,2222851,-,11898
274,BUMA.1121.00003,1,478378,490242,+,11864
274,BUMA.1121.00109,1,2479,14389,-,11910
274,BUMA.1121.00053,1,1631669,1643662,+,11993
274,BUMA.1121.00110,1,2877958,2889847,-,11889
274,BUMA.1121.00104,1,3306687,3318599,-,11912
274,BUMA.1121.00086,1,853984,865880,+,11896
274,BUMA.1121.00092,1,1897829,1909714,-,11885
274,BUMA.1121.00096,1,1352763,1364662,-,11899
274,BUMA.1121.00054,1,2910332,2922230,+,11898
274,BUMA.1121.00097,1,2017430,2029345,-,11915
274,BUMA.1121.00093,1,2716591,2728476,+,11885
274,BUMA.1121.00106,1,1674208,1686178,+,11970
274,BUMA.1121.00010,1,3247507,3259405,+,11898
274,BUMA.1121.00035,1,3081041,3093003,+,11962
274,BUMA.1121.00108,1,2882467,2894401,+,11934
274,BUMA.1121.00028,1,2197959,2209857,-,11898
274,BUMA.1121.00094,1,1937135,1949029,+,11894
274,BUMA.1121.00102,1,3404082,3416035,-,11953
274,BUMA.1121.00111,1,2109342,2121277,+,11935
274,BUMA.1121.00089,1,1905765,1917650,+,11885
274,BUMA.1121.00084,1,2272460,2284359,+,11899
274,BUMA.1121.00029,1,2995699,3007616,-,11917
274,BUMA.1121.00012,1,683733,695638,+,11905
274,BUMA.1121.00087,1,2450902,2462798,-,11896
274,BUMA.1121.00043,1,2020886,2032812,+,11926
274,BUMA.1121.00046,1,2797798,2809696,+,11898
274,BUMA.1121.00037,1,569699,581670,+,11971
274,BUMA.1121.00080,1,1935823,1947717,+,11894
274,BUMA.1121.00079,1,1931008,1942900,+,11892
274,BUMA.1121.00045,1,2133988,2145897,-,11909
274,BUMA.1121.00071,1,1926420,1938328,-,11908
274,BUMA.1121.00056,1,2008488,2020373,-,11885
274,BUMA.1121.00065,1,2007689,2019601,+,11912
274,BUMA.1121.00058,1,2637584,2649502,-,11918
274,BUMA.1121.00007,1,2144116,2156024,-,11908
274,BUMA.1121.00067,1,2471501,2483431,-,11930
274,BUMA.1121.00090,1,4104258,4116190,+,11932
274,BUMA.1121.00051,1,1917241,1929135,+,11894
274,BUMA.1121.00020,1,2262818,2274716,-,11898
274,BUMA.1121.00103,1,2487897,2499809,-,11912
274,BUMA.1121.00048,1,1013483,1025381,-,11898
274,BUMA.1121.00047,1,1030645,1042539,-,11894
274,BUMA.1121.00042,1,1567377,1579291,+,11914
274,BUMA.1121.00055,1,1493424,1505381,+,11957
274,BUMA.1121.00031,1,3363362,3375342,+,11980
274,BUMA.1121.00040,1,2317635,2329533,-,11898
274,BUMA.1121.00044,1,1463472,1475370,-,11898
274,BUMA.1121.00088,1,2814744,2826643,+,11899
274,BUMA.1121.00069,1,1908830,1920737,-,11907
274,BUMA.1121.00064,1,1931379,1943326,+,11947
274,BUMA.1121.00105,1,3305768,3317685,-,11917
274,BUMA.1121.00015,1,1855800,1867698,+,11898
274,BUMA.1121.00059,1,1118779,1130673,+,11894
274,BUMA.1121.00026,1,2992656,3004579,+,11923
274,BUMA.1121.00022,1,2584640,2596536,+,11896
274,BUMA.1121.00052,1,1998089,2009990,-,11901
274,BUMA.1121.00101,1,564532,576406,-,11874
274,BUMA.1121.00001,1,2112685,2124611,-,11926
274,BUMA.1121.00038,1,1220969,1232867,-,11898
274,BUMA.1121.00068,1,672429,684369,+,11940
274,BUMA.1121.00099,1,417937,429864,-,11927
274,BUMA.1121.00091,1,2624181,2636102,-,11921
274,BUMA.1121.00098,1,498882,510854,+,11972
274,BUMA.1121.00013,1,2000187,2012088,+,11901
274,BUMA.1121.00049,1,3959506,3971413,-,11907
274,BUMA.1121.00072,1,1909297,1921205,-,11908
274,BUMA.1121.00076,1,3397121,3409014,-,11893
274,BUMA.1121.00083,1,3745912,3757820,-,11908
274,BUMA.1121.00078,1,4109936,4121848,-,11912
274,BUMA.1121.00095,1,3763009,3774874,-,11865
274,BUMA.1121.00077,1,593134,605018,+,11884
274,BUMA.1121.00063,1,1933876,1945784,-,11908
274,BUMA.1121.00061,1,1936761,1948669,-,11908
274,BUMA.1121.00050,1,3451489,3463387,-,11898
274,BUMA.1121.00081,1,1221030,1232928,-,11898
274,BUMA.1121.00074,1,1916535,1928429,-,11894
274,BUMA.1121.00062,1,2639479,2651439,-,11960
274,BUMA.1121.00060,1,361313,373222,-,11909
274,BUMA.1121.00070,1,1907816,1919724,-,11908
274,BUMA.1121.00075,1,1403911,1415802,+,11891
274,BUMA.1121.00041,1,3222473,3234378,+,11905
274,BUMA.1121.00073,1,1934827,1946735,-,11908
274,BUMA.1121.00017,1,2132979,2144877,-,11898
274,BUMA.1121.00066,1,1910724,1922632,-,11908
274,BUMA.1121.00107,1,1808821,1820696,+,11875
274,BUMA.1121.00085,1,1595035,1606936,-,11901
274,BUMA.1121.00030,1,2133052,2144950,-,11898
274,BUMA.1121.00112,1,1087014,1098935,-,11921
274,BUMA.1121.00002,1,3269915,3281813,+,11898
274,BUMA.1121.00082,1,2090338,2102246,-,11908
274,BUMA.1121.00014,1,841821,853747,-,11926
274,BUMA.1121.00011,1,3742485,3754394,-,11909
274,BUMA.1121.00019,1,2198036,2209934,-,11898
274,BUMA.1121.00057,1,2991403,3003320,+,11917
274,BUMA.1121.00018,1,2554925,2566879,+,11954
274,BUMA.1121.00039,1,2051547,2063473,+,11926
274,BUMA.1121.00016,1,69447,81409,+,11962
274,BUMA.1121.00004,1,2197844,2209742,-,11898
274,BUMA.1121.00005,1,625033,636990,+,11957
274,BUMA.1121.00100,1,3409361,3421282,-,11921
274,BUMA.1121.00006,1,1220953,1232852,-,11899
273,BUMA.1121.00027,1,71435,78606,+,7171
273,BUMA.1121.00025,1,715618,722530,-,6912
273,BUMA.1121.00021,1,2544251,2551449,+,7198
273,BUMA.1121.00023,1,256219,263335,+,7116
273,BUMA.1121.00024,1,2220627,2227813,-,7186
273,BUMA.1121.00033,1,65366,72507,+,7141
273,BUMA.1121.00034,1,2257995,2265181,-,7186
273,BUMA.1121.00036,1,1956792,1963978,-,7186
273,BUMA.1121.00032,1,287470,294684,-,7214
273,BUMA.1121.00009,1,3672586,3679716,-,7130
273,BUMA.1121.00008,1,2233596,2240782,-,7186
273,BUMA.1121.00003,1,460474,467633,+,7159
273,BUMA.1121.00109,1,25137,32210,-,7073
273,BUMA.1121.00053,1,1613796,1620924,+,7128
273,BUMA.1121.00110,1,2900604,2907663,-,7059
273,BUMA.1121.00104,1,3329338,3336443,-,7105
273,BUMA.1121.00086,1,836033,843239,+,7206
273,BUMA.1121.00092,1,1920438,1927575,-,7137
273,BUMA.1121.00096,1,1375419,1382464,-,7045
273,BUMA.1121.00054,1,2892484,2899578,+,7094
273,BUMA.1121.00097,1,2040093,2047219,-,7126
273,BUMA.1121.00093,1,2698731,2705867,+,7136
273,BUMA.1121.00106,1,1656341,1663484,+,7143
273,BUMA.1121.00010,1,3229535,3236762,+,7227
273,BUMA.1121.00035,1,3063171,3070275,+,7104
273,BUMA.1121.00108,1,2864559,2871683,+,7124
273,BUMA.1121.00028,1,2220602,2227788,-,7186
273,BUMA.1121.00094,1,1919299,1926399,+,7100
273,BUMA.1121.00102,1,3426783,3433938,-,7155
273,BUMA.1121.00111,1,2091444,2098558,+,7114
273,BUMA.1121.00089,1,1887932,1895032,+,7100
273,BUMA.1121.00084,1,2254586,2261715,+,7129
273,BUMA.1121.00029,1,3018381,3025486,-,7105
273,BUMA.1121.00012,1,665828,672949,+,7121
273,BUMA.1121.00087,1,2473543,2480750,-,7207
273,BUMA.1121.00043,1,2002981,2010102,+,7121
273,BUMA.1121.00046,1,2779959,2787053,+,7094
273,BUMA.1121.00037,1,551766,558915,+,7149
273,BUMA.1121.00080,1,1917990,1925088,+,7098
273,BUMA.1121.00079,1,1913187,1920285,+,7098
273,BUMA.1121.00045,1,2156666,2163794,-,7128
273,BUMA.1121.00071,1,1949070,1956185,-,7115
273,BUMA.1121.00056,1,2031108,2038209,-,7101
273,BUMA.1121.00065,1,1989807,1996911,+,7104
273,BUMA.1121.00058,1,2660241,2667342,-,7101
273,BUMA.1121.00007,1,2166784,2173933,-,7149
273,BUMA.1121.00067,1,2494182,2501285,-,7103
273,BUMA.1121.00090,1,4086321,4093474,+,7153
273,BUMA.1121.00051,1,1899397,1906497,+,7100
273,BUMA.1121.00020,1,2285461,2292647,-,7186
273,BUMA.1121.00103,1,2510572,2517690,-,7118
273,BUMA.1121.00048,1,1036135,1043230,-,7095
273,BUMA.1121.00047,1,1053275,1060376,-,7101
273,BUMA.1121.00042,1,1549484,1556641,+,7157
273,BUMA.1121.00055,1,1475537,1482655,+,7118
273,BUMA.1121.00031,1,3345458,3352579,+,7121
273,BUMA.1121.00040,1,2340286,2347479,-,7193
273,BUMA.1121.00044,1,1486115,1493301,-,7186
273,BUMA.1121.00088,1,2796873,2803999,+,7126
273,BUMA.1121.00069,1,1931479,1938602,-,7123
273,BUMA.1121.00064,1,1913507,1920646,+,7139
273,BUMA.1121.00105,1,3328439,3335616,-,7177
273,BUMA.1121.00015,1,1837961,1845055,+,7094
273,BUMA.1121.00059,1,1100886,1108025,+,7139
273,BUMA.1121.00026,1,2974740,2981911,+,7171
273,BUMA.1121.00022,1,2566682,2573895,+,7213
273,BUMA.1121.00052,1,2020741,2027836,-,7095
273,BUMA.1121.00101,1,587178,594312,-,7134
273,BUMA.1121.00001,1,2135377,2142503,-,7126
273,BUMA.1121.00038,1,1243621,1250716,-,7095
273,BUMA.1121.00068,1,654494,661645,+,7151
273,BUMA.1121.00099,1,440633,447773,-,7140
273,BUMA.1121.00091,1,2646856,2653952,-,7096
273,BUMA.1121.00098,1,481024,488113,+,7089
273,BUMA.1121.00013,1,1982342,1989436,+,7094
273,BUMA.1121.00049,1,3982182,3989290,-,7108
273,BUMA.1121.00072,1,1931946,1939069,-,7123
273,BUMA.1121.00076,1,3419768,3426917,-,7149
273,BUMA.1121.00083,1,3768574,3775697,-,7123
273,BUMA.1121.00078,1,4132592,4139714,-,7122
273,BUMA.1121.00095,1,3785658,3792844,-,7186
273,BUMA.1121.00077,1,575319,582377,+,7058
273,BUMA.1121.00063,1,1956517,1963629,-,7112
273,BUMA.1121.00061,1,1959423,1966546,-,7123
273,BUMA.1121.00050,1,3474132,3481227,-,7095
273,BUMA.1121.00081,1,1243682,1250777,-,7095
273,BUMA.1121.00074,1,1939174,1946318,-,7144
273,BUMA.1121.00062,1,2662169,2669275,-,7106
273,BUMA.1121.00060,1,383991,391119,-,7128
273,BUMA.1121.00070,1,1930475,1937597,-,7122
273,BUMA.1121.00075,1,1386010,1393158,+,7148
273,BUMA.1121.00041,1,3204622,3211725,+,7103
273,BUMA.1121.00073,1,1957487,1964610,-,7123
273,BUMA.1121.00017,1,2155622,2162808,-,7186
273,BUMA.1121.00066,1,1933373,1940496,-,7123
273,BUMA.1121.00107,1,1790907,1798052,+,7145
273,BUMA.1121.00085,1,1617687,1624782,-,7095
273,BUMA.1121.00030,1,2155695,2162881,-,7186
273,BUMA.1121.00112,1,1109716,1116842,-,7126
273,BUMA.1121.00002,1,3251943,3259170,+,7227
273,BUMA.1121.00082,1,2113000,2120123,-,7123
273,BUMA.1121.00014,1,864522,871629,-,7107
273,BUMA.1121.00011,1,3765163,3772285,-,7122
273,BUMA.1121.00019,1,2220679,2227865,-,7186
273,BUMA.1121.00057,1,2973486,2980649,+,7163
273,BUMA.1121.00018,1,2537239,2544150,+,6911
273,BUMA.1121.00039,1,2033621,2040763,+,7142
273,BUMA.1121.00016,1,51643,58673,+,7030
273,BUMA.1121.00004,1,2220487,2227673,-,7186
273,BUMA.1121.00005,1,607142,614279,+,7137
273,BUMA.1121.00100,1,3432005,3439148,-,7143
273,BUMA.1121.00006,1,1243606,1250699,-,7093
272,BUMA.1121.00027,1,66565,69929,+,3364
272,BUMA.1121.00025,1,724033,727417,-,3384
272,BUMA.1121.00021,1,2539375,2542745,+,3370
272,BUMA.1121.00023,1,251343,254713,+,3370
272,BUMA.1121.00024,1,2229318,2232682,-,3364
272,BUMA.1121.00033,1,60475,63860,+,3385
272,BUMA.1121.00034,1,2266686,2270050,-,3364
272,BUMA.1121.00036,1,1965483,1968847,-,3364
272,BUMA.1121.00032,1,296189,299553,-,3364
272,BUMA.1121.00009,1,3681221,3684585,-,3364
272,BUMA.1121.00008,1,2242287,2245651,-,3364
272,BUMA.1121.00003,1,455604,458968,+,3364
272,BUMA.1121.00109,1,33715,37079,-,3364
272,BUMA.1121.00053,1,1608920,1612290,+,3370
272,BUMA.1121.00110,1,2909168,2912532,-,3364
272,BUMA.1121.00104,1,3337948,3341312,-,3364
272,BUMA.1121.00086,1,831163,834527,+,3364
272,BUMA.1121.00092,1,1929080,1932444,-,3364
272,BUMA.1121.00096,1,1383969,1387333,-,3364
272,BUMA.1121.00054,1,2887602,2890978,+,3376
272,BUMA.1121.00097,1,2048724,2052088,-,3364
272,BUMA.1121.00093,1,2693852,2697216,+,3364
272,BUMA.1121.00106,1,1651471,1654835,+,3364
272,BUMA.1121.00010,1,3224665,3228029,+,3364
272,BUMA.1121.00035,1,3058295,3061665,+,3370
272,BUMA.1121.00108,1,2859689,2863053,+,3364
272,BUMA.1121.00028,1,2229293,2232657,-,3364
272,BUMA.1121.00094,1,1914429,1917793,+,3364
272,BUMA.1121.00102,1,3435443,3438807,-,3364
272,BUMA.1121.00111,1,2086568,2089938,+,3370
272,BUMA.1121.00089,1,1883062,1886426,+,3364
272,BUMA.1121.00084,1,2249710,2253080,+,3370
272,BUMA.1121.00029,1,3026991,3030361,-,3370
272,BUMA.1121.00012,1,660952,664322,+,3370
272,BUMA.1121.00087,1,2482255,2485619,-,3364
272,BUMA.1121.00043,1,1998111,2001475,+,3364
272,BUMA.1121.00046,1,2775089,2778453,+,3364
272,BUMA.1121.00037,1,546890,550260,+,3370
272,BUMA.1121.00080,1,1913120,1916484,+,3364
272,BUMA.1121.00079,1,1908317,1911681,+,3364
272,BUMA.1121.00045,1,2165299,2168663,-,3364
272,BUMA.1121.00071,1,1957690,1961054,-,3364
272,BUMA.1121.00056,1,2039714,2043078,-,3364
272,BUMA.1121.00065,1,1984925,1988301,+,3376
272,BUMA.1121.00058,1,2668847,2672211,-,3364
272,BUMA.1121.00007,1,2175438,2178808,-,3370
272,BUMA.1121.00067,1,2502790,2506154,-,3364
272,BUMA.1121.00090,1,4081445,4084815,+,3370
272,BUMA.1121.00051,1,1894527,1897891,+,3364
272,BUMA.1121.00020,1,2294152,2297516,-,3364
272,BUMA.1121.00103,1,2519195,2522565,-,3370
272,BUMA.1121.00048,1,1044735,1048111,-,3376
272,BUMA.1121.00047,1,1061881,1065245,-,3364
272,BUMA.1121.00042,1,1544614,1547978,+,3364
272,BUMA.1121.00055,1,1470661,1474031,+,3370
272,BUMA.1121.00031,1,3340582,3343952,+,3370
272,BUMA.1121.00040,1,2348984,2352343,-,3359
272,BUMA.1121.00044,1,1494806,1498170,-,3364
272,BUMA.1121.00088,1,2792003,2795367,+,3364
272,BUMA.1121.00069,1,1940107,1943471,-,3364
272,BUMA.1121.00064,1,1908637,1912001,+,3364
272,BUMA.1121.00105,1,3337121,3340485,-,3364
272,BUMA.1121.00015,1,1833091,1836455,+,3364
272,BUMA.1121.00059,1,1096016,1099380,+,3364
272,BUMA.1121.00026,1,2969870,2973234,+,3364
272,BUMA.1121.00022,1,2561812,2565176,+,3364
272,BUMA.1121.00052,1,2029341,2032705,-,3364
272,BUMA.1121.00101,1,595826,599196,-,3370
272,BUMA.1121.00001,1,2144008,2147378,-,3370
272,BUMA.1121.00038,1,1252221,1255597,-,3376
272,BUMA.1121.00068,1,649624,652988,+,3364
272,BUMA.1121.00099,1,449278,452642,-,3364
272,BUMA.1121.00091,1,2655457,2658821,-,3364
272,BUMA.1121.00098,1,476154,479530,+,3376
272,BUMA.1121.00013,1,1977472,1980836,+,3364
272,BUMA.1121.00049,1,3990795,3994159,-,3364
272,BUMA.1121.00072,1,1940574,1943938,-,3364
272,BUMA.1121.00076,1,3428422,3431786,-,3364
272,BUMA.1121.00083,1,3777202,3780566,-,3364
272,BUMA.1121.00078,1,4141219,4144582,-,3363
272,BUMA.1121.00095,1,3794349,3797713,-,3364
272,BUMA.1121.00077,1,570445,573813,+,3368
272,BUMA.1121.00063,1,1965134,1968498,-,3364
272,BUMA.1121.00061,1,1968051,1971415,-,3364
272,BUMA.1121.00050,1,3482732,3486096,-,3364
272,BUMA.1121.00081,1,1252282,1255658,-,3376
272,BUMA.1121.00074,1,1947823,1951187,-,3364
272,BUMA.1121.00062,1,2670780,2674150,-,3370
272,BUMA.1121.00060,1,392624,395988,-,3364
272,BUMA.1121.00070,1,1939102,1942466,-,3364
272,BUMA.1121.00075,1,1381142,1384504,+,3362
272,BUMA.1121.00041,1,3199752,3203116,+,3364
272,BUMA.1121.00073,1,1966115,1969479,-,3364
272,BUMA.1121.00017,1,2164313,2167677,-,3364
272,BUMA.1121.00066,1,1942001,1945365,-,3364
272,BUMA.1121.00107,1,1786031,1789401,+,3370
272,BUMA.1121.00085,1,1626287,1629651,-,3364
272,BUMA.1121.00030,1,2164386,2167750,-,3364
272,BUMA.1121.00112,1,1118347,1121711,-,3364
272,BUMA.1121.00002,1,3247073,3250437,+,3364
272,BUMA.1121.00082,1,2121628,2124992,-,3364
272,BUMA.1121.00014,1,873134,876504,-,3370
272,BUMA.1121.00011,1,3773790,3777154,-,3364
272,BUMA.1121.00019,1,2229370,2232734,-,3364
272,BUMA.1121.00057,1,2968616,2971980,+,3364
272,BUMA.1121.00018,1,2532351,2535736,+,3385
272,BUMA.1121.00039,1,2028745,2032115,+,3370
272,BUMA.1121.00016,1,46767,50137,+,3370
272,BUMA.1121.00004,1,2229178,2232542,-,3364
272,BUMA.1121.00005,1,602272,605636,+,3364
272,BUMA.1121.00100,1,3440653,3444017,-,3364
272,BUMA.1121.00006,1,1252204,1255580,-,3376
271,BUMA.1121.00027,1,54488,65579,+,11091
271,BUMA.1121.00025,1,728404,739495,-,11091
271,BUMA.1121.00021,1,2527307,2538398,+,11091
271,BUMA.1121.00023,1,239248,250357,+,11109
271,BUMA.1121.00024,1,2233649,2244770,-,11121
271,BUMA.1121.00033,1,37767,48857,+,11090
271,BUMA.1121.00034,1,2271017,2282138,-,11121
271,BUMA.1121.00036,1,1969821,1980942,-,11121
271,BUMA.1121.00032,1,300520,311641,-,11121
271,BUMA.1121.00009,1,3685567,3696703,-,11136
271,BUMA.1121.00008,1,2246618,2257739,-,11121
271,BUMA.1121.00003,1,443477,454598,+,11121
271,BUMA.1121.00109,1,38065,49192,-,11127
271,BUMA.1121.00053,1,1596785,1607921,+,11136
271,BUMA.1121.00110,1,2913487,2924614,-,11127
271,BUMA.1121.00104,1,3342291,3353415,-,11124
271,BUMA.1121.00086,1,819069,830190,+,11121
271,BUMA.1121.00092,1,1933423,1944535,-,11112
271,BUMA.1121.00096,1,1388316,1399434,-,11118
271,BUMA.1121.00054,1,2875549,2886629,+,11080
271,BUMA.1121.00097,1,2053067,2064179,-,11112
271,BUMA.1121.00093,1,2681762,2692874,+,11112
271,BUMA.1121.00106,1,1639381,1650493,+,11112
271,BUMA.1121.00010,1,3212585,3223706,+,11121
271,BUMA.1121.00035,1,3046215,3057309,+,11094
271,BUMA.1121.00108,1,2847580,2858704,+,11124
271,BUMA.1121.00028,1,2233624,2244745,-,11121
271,BUMA.1121.00094,1,1902337,1913449,+,11112
271,BUMA.1121.00102,1,3439794,3450915,-,11121
271,BUMA.1121.00111,1,2074490,2085581,+,11091
271,BUMA.1121.00089,1,1870970,1882082,+,11112
271,BUMA.1121.00084,1,2237611,2248723,+,11112
271,BUMA.1121.00029,1,3031348,3042363,-,11015
271,BUMA.1121.00012,1,648872,659966,+,11094
271,BUMA.1121.00087,1,2486593,2497714,-,11121
271,BUMA.1121.00043,1,1986034,1997125,+,11091
271,BUMA.1121.00046,1,2763036,2774116,+,11080
271,BUMA.1121.00037,1,534813,545904,+,11091
271,BUMA.1121.00080,1,1901028,1912140,+,11112
271,BUMA.1121.00079,1,1896225,1907337,+,11112
271,BUMA.1121.00045,1,2169609,2180745,-,11136
271,BUMA.1121.00071,1,1962040,1973133,-,11093
271,BUMA.1121.00056,1,2044059,2055171,-,11112
271,BUMA.1121.00065,1,1972844,1983947,+,11103
271,BUMA.1121.00058,1,2673197,2684306,-,11109
271,BUMA.1121.00007,1,2179809,2190935,-,11126
271,BUMA.1121.00067,1,2507140,2518252,-,11112
271,BUMA.1121.00090,1,4069368,4080459,+,11091
271,BUMA.1121.00051,1,1882431,1893542,+,11111
271,BUMA.1121.00020,1,2298483,2309604,-,11121
271,BUMA.1121.00103,1,2523551,2534678,-,11127
271,BUMA.1121.00048,1,1049085,1060165,-,11080
271,BUMA.1121.00047,1,1066226,1077338,-,11112
271,BUMA.1121.00042,1,1532527,1543648,+,11121
271,BUMA.1121.00055,1,1458564,1469676,+,11112
271,BUMA.1121.00031,1,3328507,3339596,+,11089
271,BUMA.1121.00040,1,2353324,2364442,-,11118
271,BUMA.1121.00044,1,1499137,1510258,-,11121
271,BUMA.1121.00088,1,2779913,2791025,+,11112
271,BUMA.1121.00069,1,1944456,1955530,-,11074
271,BUMA.1121.00064,1,1896552,1907655,+,11103
271,BUMA.1121.00105,1,3341464,3352576,-,11112
271,BUMA.1121.00015,1,1821038,1832118,+,11080
271,BUMA.1121.00059,1,1083927,1095039,+,11112
271,BUMA.1121.00026,1,2957790,2968911,+,11121
271,BUMA.1121.00022,1,2549718,2560839,+,11121
271,BUMA.1121.00052,1,2033672,2044793,-,11121
271,BUMA.1121.00101,1,600175,611302,-,11127
271,BUMA.1121.00001,1,2148365,2159459,-,11094
271,BUMA.1121.00038,1,1256571,1267651,-,11080
271,BUMA.1121.00068,1,637481,648617,+,11136
271,BUMA.1121.00099,1,453630,464766,-,11136
271,BUMA.1121.00091,1,2659776,2670897,-,11121
271,BUMA.1121.00098,1,464060,475193,+,11133
271,BUMA.1121.00013,1,1965385,1976506,+,11121
271,BUMA.1121.00049,1,3995136,4006248,-,11112
271,BUMA.1121.00072,1,1944911,1956004,-,11093
271,BUMA.1121.00076,1,3432765,3443877,-,11112
271,BUMA.1121.00083,1,3781553,3792646,-,11093
271,BUMA.1121.00078,1,4145559,4156674,-,11115
271,BUMA.1121.00095,1,3798661,3809788,-,11127
271,BUMA.1121.00077,1,558364,569489,+,11125
271,BUMA.1121.00063,1,1969477,1980570,-,11093
271,BUMA.1121.00061,1,1972400,1983492,-,11092
271,BUMA.1121.00050,1,3487070,3498150,-,11080
271,BUMA.1121.00081,1,1256632,1267712,-,11080
271,BUMA.1121.00074,1,1952166,1963278,-,11112
271,BUMA.1121.00062,1,2675118,2686230,-,11112
271,BUMA.1121.00060,1,396934,408070,-,11136
271,BUMA.1121.00070,1,1943449,1954537,-,11088
271,BUMA.1121.00075,1,1369052,1380164,+,11112
271,BUMA.1121.00041,1,3187668,3198738,+,11070
271,BUMA.1121.00073,1,1970465,1981558,-,11093
271,BUMA.1121.00017,1,2168644,2179765,-,11121
271,BUMA.1121.00066,1,1946352,1957444,-,11092
271,BUMA.1121.00107,1,1773932,1785044,+,11112
271,BUMA.1121.00085,1,1630618,1641739,-,11121
271,BUMA.1121.00030,1,2168717,2179838,-,11121
271,BUMA.1121.00112,1,1122688,1133785,-,11097
271,BUMA.1121.00002,1,3234993,3246114,+,11121
271,BUMA.1121.00082,1,2125979,2137072,-,11093
271,BUMA.1121.00014,1,877491,888582,-,11091
271,BUMA.1121.00011,1,3778108,3789226,-,11118
271,BUMA.1121.00019,1,2233701,2244822,-,11121
271,BUMA.1121.00057,1,2956537,2967630,+,11093
271,BUMA.1121.00018,1,2520274,2531365,+,11091
271,BUMA.1121.00039,1,2016668,2027759,+,11091
271,BUMA.1121.00016,1,34684,45781,+,11097
271,BUMA.1121.00004,1,2233509,2244630,-,11121
271,BUMA.1121.00005,1,590234,601305,+,11071
271,BUMA.1121.00100,1,3445002,3456105,-,11103
271,BUMA.1121.00006,1,1256554,1267634,-,11080
270,BUMA.1121.00027,1,50046,54457,+,4411
270,BUMA.1121.00025,1,739526,743889,-,4363
270,BUMA.1121.00021,1,2522856,2527276,+,4420
270,BUMA.1121.00023,1,234813,239217,+,4404
270,BUMA.1121.00024,1,2246041,2250372,-,4331
270,BUMA.1121.00033,1,33333,37736,+,4403
270,BUMA.1121.00034,1,2283409,2287740,-,4331
270,BUMA.1121.00036,1,1982215,1986546,-,4331
270,BUMA.1121.00032,1,312912,317243,-,4331
270,BUMA.1121.00009,1,3696734,3701084,-,4350
270,BUMA.1121.00008,1,2259010,2263340,-,4330
270,BUMA.1121.00003,1,439114,443446,+,4332
270,BUMA.1121.00109,1,49223,53561,-,4338
270,BUMA.1121.00053,1,1592324,1596754,+,4430
270,BUMA.1121.00110,1,2924645,2928983,-,4338
270,BUMA.1121.00104,1,3353446,3357849,-,4403
270,BUMA.1121.00086,1,813466,817798,+,4332
270,BUMA.1121.00092,1,1944566,1948949,-,4383
270,BUMA.1121.00096,1,1399465,1403798,-,4333
270,BUMA.1121.00097,1,2064210,2068541,-,4331
270,BUMA.1121.00093,1,2677348,2681731,+,4383
270,BUMA.1121.00106,1,1634904,1639350,+,4446
270,BUMA.1121.00010,1,3206982,3211314,+,4332
270,BUMA.1121.00035,1,3041829,3046184,+,4355
270,BUMA.1121.00108,1,2843186,2847549,+,4363
270,BUMA.1121.00028,1,2246016,2250347,-,4331
270,BUMA.1121.00094,1,1897892,1902306,+,4414
270,BUMA.1121.00102,1,3450946,3455280,-,4334
270,BUMA.1121.00111,1,2070072,2074459,+,4387
270,BUMA.1121.00089,1,1866502,1870939,+,4437
270,BUMA.1121.00084,1,2233215,2237580,+,4365
270,BUMA.1121.00029,1,3042394,3046749,-,4355
270,BUMA.1121.00012,1,644406,648841,+,4435
270,BUMA.1121.00087,1,2498985,2503316,-,4331
270,BUMA.1121.00043,1,1981640,1986003,+,4363
270,BUMA.1121.00037,1,530363,534782,+,4419
270,BUMA.1121.00080,1,1896571,1900997,+,4426
270,BUMA.1121.00079,1,1891830,1896194,+,4364
270,BUMA.1121.00045,1,2180776,2185115,-,4339
270,BUMA.1121.00071,1,1973164,1977536,-,4372
270,BUMA.1121.00056,1,2055202,2059634,-,4432
270,BUMA.1121.00065,1,1968445,1972813,+,4368
270,BUMA.1121.00058,1,2684337,2688774,-,4437
270,BUMA.1121.00007,1,2190966,2195404,-,4438
270,BUMA.1121.00067,1,2518283,2522648,-,4365
270,BUMA.1121.00090,1,4064934,4069337,+,4403
270,BUMA.1121.00051,1,1877990,1882400,+,4410
270,BUMA.1121.00020,1,2310875,2315206,-,4331
270,BUMA.1121.00103,1,2534709,2539035,-,4326
270,BUMA.1121.00047,1,1077369,1081779,-,4410
270,BUMA.1121.00042,1,1526918,1531256,+,4338
270,BUMA.1121.00055,1,1454122,1458533,+,4411
270,BUMA.1121.00031,1,3324073,3328476,+,4403
270,BUMA.1121.00040,1,2365716,2370046,-,4330
270,BUMA.1121.00044,1,1511529,1515860,-,4331
270,BUMA.1121.00088,1,2775505,2779882,+,4377
270,BUMA.1121.00069,1,1955561,1959933,-,4372
270,BUMA.1121.00064,1,1892153,1896521,+,4368
270,BUMA.1121.00105,1,3352607,3356994,-,4387
270,BUMA.1121.00015,1,1815429,1819767,+,4338
270,BUMA.1121.00059,1,1079466,1083896,+,4430
270,BUMA.1121.00026,1,2952181,2956519,+,4338
270,BUMA.1121.00022,1,2544115,2548447,+,4332
270,BUMA.1121.00052,1,2046064,2050394,-,4330
270,BUMA.1121.00101,1,611333,615712,-,4379
270,BUMA.1121.00001,1,2159490,2163837,-,4347
270,BUMA.1121.00068,1,633112,637450,+,4338
270,BUMA.1121.00099,1,464797,469147,-,4350
270,BUMA.1121.00091,1,2670928,2675307,-,4379
270,BUMA.1121.00098,1,459674,464029,+,4355
270,BUMA.1121.00013,1,1959784,1964114,+,4330
270,BUMA.1121.00049,1,4006279,4010652,-,4373
270,BUMA.1121.00072,1,1956035,1960406,-,4371
270,BUMA.1121.00076,1,3443908,3448279,-,4371
270,BUMA.1121.00083,1,3792677,3797054,-,4377
270,BUMA.1121.00078,1,4156705,4161095,-,4390
270,BUMA.1121.00095,1,3809819,3814206,-,4387
270,BUMA.1121.00077,1,553995,558333,+,4338
270,BUMA.1121.00063,1,1980601,1984978,-,4377
270,BUMA.1121.00061,1,1983523,1987899,-,4376
270,BUMA.1121.00050,1,3499421,3503759,-,4338
270,BUMA.1121.00074,1,1963309,1967701,-,4392
270,BUMA.1121.00062,1,2686261,2690701,-,4440
270,BUMA.1121.00060,1,408101,412440,-,4339
270,BUMA.1121.00070,1,1954568,1958945,-,4377
270,BUMA.1121.00075,1,1364651,1369021,+,4370
270,BUMA.1121.00041,1,3183299,3187637,+,4338
270,BUMA.1121.00073,1,1981589,1985966,-,4377
270,BUMA.1121.00017,1,2181036,2185367,-,4331
270,BUMA.1121.00066,1,1957475,1961851,-,4376
270,BUMA.1121.00107,1,1769554,1773901,+,4347
270,BUMA.1121.00085,1,1643010,1647340,-,4330
270,BUMA.1121.00030,1,2181109,2185439,-,4330
270,BUMA.1121.00112,1,1133816,1138174,-,4358
270,BUMA.1121.00002,1,3229391,3233723,+,4332
270,BUMA.1121.00082,1,2137103,2141480,-,4377
270,BUMA.1121.00014,1,888613,893024,-,4411
270,BUMA.1121.00011,1,3789257,3793597,-,4340
270,BUMA.1121.00057,1,2952129,2956506,+,4377
270,BUMA.1121.00018,1,2515880,2520243,+,4363
270,BUMA.1121.00039,1,2012186,2016637,+,4451
270,BUMA.1121.00016,1,30331,34653,+,4322
270,BUMA.1121.00004,1,2245901,2250231,-,4330
270,BUMA.1121.00005,1,585768,590203,+,4435
270,BUMA.1121.00100,1,3456136,3460551,-,4415
269,BUMA.1121.00027,1,45002,50044,+,5042
269,BUMA.1121.00025,1,743890,748961,-,5071
269,BUMA.1121.00021,1,2517771,2522854,+,5083
269,BUMA.1121.00023,1,229771,234811,+,5040
269,BUMA.1121.00033,1,28271,33331,+,5060
269,BUMA.1121.00009,1,3701085,3706187,-,5102
269,BUMA.1121.00003,1,434057,439112,+,5055
269,BUMA.1121.00109,1,53562,58677,-,5115
269,BUMA.1121.00053,1,1587264,1592322,+,5058
269,BUMA.1121.00110,1,2928984,2934038,-,5054
269,BUMA.1121.00104,1,3357850,3362940,-,5090
269,BUMA.1121.00092,1,1948950,1954019,-,5069
269,BUMA.1121.00096,1,1403799,1408933,-,5134
269,BUMA.1121.00097,1,2068543,2073606,-,5063
269,BUMA.1121.00093,1,2672278,2677346,+,5068
269,BUMA.1121.00106,1,1629854,1634902,+,5048
269,BUMA.1121.00035,1,3036751,3041827,+,5076
269,BUMA.1121.00108,1,2838131,2843184,+,5053
269,BUMA.1121.00094,1,1892814,1897890,+,5076
269,BUMA.1121.00102,1,3455281,3460392,-,5111
269,BUMA.1121.00111,1,2064978,2070070,+,5092
269,BUMA.1121.00089,1,1861403,1866500,+,5097
269,BUMA.1121.00084,1,2228139,2233213,+,5074
269,BUMA.1121.00029,1,3046750,3051840,-,5090
269,BUMA.1121.00012,1,639273,644404,+,5131
269,BUMA.1121.00043,1,1976561,1981638,+,5077
269,BUMA.1121.00037,1,525237,530361,+,5124
269,BUMA.1121.00080,1,1891507,1896569,+,5062
269,BUMA.1121.00079,1,1886780,1891828,+,5048
269,BUMA.1121.00045,1,2185116,2190192,-,5076
269,BUMA.1121.00071,1,1977537,1982585,-,5048
269,BUMA.1121.00056,1,2059635,2064733,-,5098
269,BUMA.1121.00065,1,1963390,1968443,+,5053
269,BUMA.1121.00058,1,2688775,2693838,-,5063
269,BUMA.1121.00007,1,2195406,2200547,-,5141
269,BUMA.1121.00067,1,2522649,2527678,-,5029
269,BUMA.1121.00090,1,4059842,4064932,+,5090
269,BUMA.1121.00051,1,1872919,1877988,+,5069
269,BUMA.1121.00103,1,2539036,2544057,-,5021
269,BUMA.1121.00047,1,1081780,1086843,-,5063
269,BUMA.1121.00042,1,1521959,1526916,+,4957
269,BUMA.1121.00055,1,1449067,1454120,+,5053
269,BUMA.1121.00031,1,3318999,3324071,+,5072
269,BUMA.1121.00040,1,2370047,2374970,-,4923
269,BUMA.1121.00088,1,2770457,2775503,+,5046
269,BUMA.1121.00069,1,1959934,1964992,-,5058
269,BUMA.1121.00064,1,1887098,1892151,+,5053
269,BUMA.1121.00105,1,3356995,3362044,-,5049
269,BUMA.1121.00015,1,1810494,1815427,+,4933
269,BUMA.1121.00059,1,1074399,1079464,+,5065
269,BUMA.1121.00026,1,2947206,2952179,+,4973
269,BUMA.1121.00052,1,2050395,2055332,-,4937
269,BUMA.1121.00101,1,615713,620788,-,5075
269,BUMA.1121.00001,1,2163838,2168949,-,5111
269,BUMA.1121.00068,1,628069,633110,+,5041
269,BUMA.1121.00099,1,469148,474227,-,5079
269,BUMA.1121.00091,1,2675308,2680332,-,5024
269,BUMA.1121.00098,1,454527,459672,+,5145
269,BUMA.1121.00013,1,1954846,1959782,+,4936
269,BUMA.1121.00049,1,4010653,4015714,-,5061
269,BUMA.1121.00072,1,1960407,1965463,-,5056
269,BUMA.1121.00076,1,3448280,3453370,-,5090
269,BUMA.1121.00083,1,3797055,3802124,-,5069
269,BUMA.1121.00078,1,4161096,4166120,-,5024
269,BUMA.1121.00095,1,3814207,3819275,-,5068
269,BUMA.1121.00077,1,548940,553993,+,5053
269,BUMA.1121.00063,1,1984979,1990037,-,5058
269,BUMA.1121.00061,1,1987900,1992968,-,5068
269,BUMA.1121.00050,1,3503760,3508701,-,4941
269,BUMA.1121.00074,1,1967702,1972773,-,5071
269,BUMA.1121.00062,1,2690702,2695853,-,5151
269,BUMA.1121.00060,1,412441,417510,-,5069
269,BUMA.1121.00070,1,1958946,1964014,-,5068
269,BUMA.1121.00075,1,1359525,1364649,+,5124
269,BUMA.1121.00041,1,3178266,3183297,+,5031
269,BUMA.1121.00073,1,1985967,1991035,-,5068
269,BUMA.1121.00066,1,1961852,1966917,-,5065
269,BUMA.1121.00107,1,1764501,1769552,+,5051
269,BUMA.1121.00085,1,1647341,1652278,-,4937
269,BUMA.1121.00112,1,1138175,1143225,-,5050
269,BUMA.1121.00082,1,2141481,2146550,-,5069
269,BUMA.1121.00014,1,893025,898084,-,5059
269,BUMA.1121.00011,1,3793599,3798677,-,5078
269,BUMA.1121.00057,1,2947071,2952127,+,5056
269,BUMA.1121.00018,1,2510808,2515878,+,5070
269,BUMA.1121.00039,1,2007073,2012184,+,5111
269,BUMA.1121.00016,1,25275,30329,+,5054
269,BUMA.1121.00005,1,580714,585766,+,5052
269,BUMA.1121.00100,1,3460552,3465551,-,4999
268,BUMA.1121.00027,1,41351,44565,+,3214
268,BUMA.1121.00025,1,749398,752612,-,3214
268,BUMA.1121.00021,1,2514120,2517334,+,3214
268,BUMA.1121.00023,1,226120,229334,+,3214
268,BUMA.1121.00033,1,24620,27834,+,3214
268,BUMA.1121.00009,1,3706624,3709838,-,3214
268,BUMA.1121.00003,1,430406,433620,+,3214
268,BUMA.1121.00109,1,59114,62328,-,3214
268,BUMA.1121.00053,1,1583613,1586827,+,3214
268,BUMA.1121.00110,1,2934475,2937689,-,3214
268,BUMA.1121.00104,1,3363377,3366591,-,3214
268,BUMA.1121.00092,1,1954456,1957670,-,3214
268,BUMA.1121.00096,1,1409370,1412584,-,3214
268,BUMA.1121.00097,1,2074043,2077254,-,3211
268,BUMA.1121.00093,1,2668629,2671841,+,3212
268,BUMA.1121.00106,1,1626203,1629417,+,3214
268,BUMA.1121.00035,1,3033100,3036314,+,3214
268,BUMA.1121.00108,1,2834480,2837694,+,3214
268,BUMA.1121.00094,1,1889163,1892377,+,3214
268,BUMA.1121.00102,1,3460829,3464043,-,3214
268,BUMA.1121.00111,1,2061327,2064541,+,3214
268,BUMA.1121.00089,1,1857752,1860966,+,3214
268,BUMA.1121.00084,1,2224488,2227702,+,3214
268,BUMA.1121.00029,1,3052277,3055491,-,3214
268,BUMA.1121.00012,1,635622,638836,+,3214
268,BUMA.1121.00043,1,1972910,1976124,+,3214
268,BUMA.1121.00037,1,521586,524800,+,3214
268,BUMA.1121.00080,1,1887856,1891070,+,3214
268,BUMA.1121.00079,1,1883129,1886343,+,3214
268,BUMA.1121.00045,1,2190629,2193843,-,3214
268,BUMA.1121.00071,1,1983022,1986236,-,3214
268,BUMA.1121.00056,1,2065170,2068382,-,3212
268,BUMA.1121.00065,1,1959739,1962953,+,3214
268,BUMA.1121.00058,1,2694275,2697489,-,3214
268,BUMA.1121.00007,1,2200984,2204198,-,3214
268,BUMA.1121.00067,1,2528115,2531329,-,3214
268,BUMA.1121.00090,1,4056191,4059405,+,3214
268,BUMA.1121.00051,1,1869268,1872482,+,3214
268,BUMA.1121.00103,1,2544494,2547707,-,3213
268,BUMA.1121.00047,1,1087280,1090494,-,3214
268,BUMA.1121.00042,1,1518314,1521522,+,3208
268,BUMA.1121.00055,1,1445416,1448630,+,3214
268,BUMA.1121.00031,1,3315348,3318562,+,3214
268,BUMA.1121.00040,1,2375407,2378615,-,3208
268,BUMA.1121.00088,1,2766806,2770020,+,3214
268,BUMA.1121.00069,1,1965429,1968643,-,3214
268,BUMA.1121.00064,1,1883447,1886661,+,3214
268,BUMA.1121.00105,1,3362481,3365695,-,3214
268,BUMA.1121.00015,1,1806849,1810057,+,3208
268,BUMA.1121.00059,1,1070748,1073962,+,3214
268,BUMA.1121.00026,1,2943561,2946769,+,3208
268,BUMA.1121.00052,1,2055769,2058977,-,3208
268,BUMA.1121.00101,1,621225,624439,-,3214
268,BUMA.1121.00001,1,2169386,2172600,-,3214
268,BUMA.1121.00068,1,624421,627632,+,3211
268,BUMA.1121.00099,1,474664,477878,-,3214
268,BUMA.1121.00091,1,2680769,2683983,-,3214
268,BUMA.1121.00098,1,450876,454090,+,3214
268,BUMA.1121.00013,1,1951201,1954409,+,3208
268,BUMA.1121.00049,1,4016151,4019365,-,3214
268,BUMA.1121.00072,1,1965900,1969114,-,3214
268,BUMA.1121.00076,1,3453807,3457021,-,3214
268,BUMA.1121.00083,1,3802561,3805775,-,3214
268,BUMA.1121.00078,1,162,3382,-,3220
268,BUMA.1121.00095,1,3819712,3822923,-,3211
268,BUMA.1121.00077,1,545289,548503,+,3214
268,BUMA.1121.00063,1,1990474,1993688,-,3214
268,BUMA.1121.00061,1,1993405,1996619,-,3214
268,BUMA.1121.00050,1,3509138,3512346,-,3208
268,BUMA.1121.00074,1,1973210,1976424,-,3214
268,BUMA.1121.00062,1,2696290,2699504,-,3214
268,BUMA.1121.00060,1,417947,421161,-,3214
268,BUMA.1121.00070,1,1964451,1967665,-,3214
268,BUMA.1121.00075,1,1355874,1359088,+,3214
268,BUMA.1121.00041,1,3174615,3177829,+,3214
268,BUMA.1121.00073,1,1991472,1994686,-,3214
268,BUMA.1121.00066,1,1967354,1970568,-,3214
268,BUMA.1121.00107,1,1760850,1764064,+,3214
268,BUMA.1121.00085,1,1652715,1655923,-,3208
268,BUMA.1121.00112,1,1143662,1146876,-,3214
268,BUMA.1121.00082,1,2146987,2150201,-,3214
268,BUMA.1121.00014,1,898521,901736,-,3215
268,BUMA.1121.00011,1,3799114,3802337,-,3223
268,BUMA.1121.00057,1,2943420,2946634,+,3214
268,BUMA.1121.00018,1,2507157,2510371,+,3214
268,BUMA.1121.00039,1,2003422,2006636,+,3214
268,BUMA.1121.00016,1,21624,24838,+,3214
268,BUMA.1121.00005,1,577063,580277,+,3214
268,BUMA.1121.00100,1,3465988,3469202,-,3214
267,BUMA.1121.00027,1,29956,37049,+,7093
267,BUMA.1121.00025,1,756914,764005,-,7091
267,BUMA.1121.00021,1,2502725,2509818,+,7093
267,BUMA.1121.00023,1,214735,221818,+,7083
267,BUMA.1121.00024,1,2254635,2261709,-,7074
267,BUMA.1121.00033,1,13250,20318,+,7068
267,BUMA.1121.00034,1,2292003,2299077,-,7074
267,BUMA.1121.00036,1,1990809,1997868,-,7059
267,BUMA.1121.00032,1,321506,328580,-,7074
267,BUMA.1121.00009,1,3714137,3721275,-,7138
267,BUMA.1121.00008,1,2267603,2274677,-,7074
267,BUMA.1121.00003,1,419082,426101,+,7019
267,BUMA.1121.00109,1,66652,73742,-,7090
267,BUMA.1121.00053,1,1572191,1579311,+,7120
267,BUMA.1121.00110,1,2941977,2949052,-,7075
267,BUMA.1121.00104,1,3370861,3377951,-,7090
267,BUMA.1121.00086,1,802144,809204,+,7060
267,BUMA.1121.00092,1,1961983,1969075,-,7092
267,BUMA.1121.00096,1,1416886,1423969,-,7083
267,BUMA.1121.00097,1,2081553,2088674,-,7121
267,BUMA.1121.00093,1,2657221,2664314,+,7093
267,BUMA.1121.00106,1,1614776,1621904,+,7128
267,BUMA.1121.00010,1,3195661,3202721,+,7060
267,BUMA.1121.00035,1,3021688,3028798,+,7110
267,BUMA.1121.00108,1,2823085,2830178,+,7093
267,BUMA.1121.00028,1,2254610,2261684,-,7074
267,BUMA.1121.00094,1,1877751,1884864,+,7113
267,BUMA.1121.00102,1,3468353,3475450,-,7097
267,BUMA.1121.00111,1,2049948,2057025,+,7077
267,BUMA.1121.00089,1,1846334,1853453,+,7119
267,BUMA.1121.00084,1,2213056,2220189,+,7133
267,BUMA.1121.00029,1,3059793,3066902,-,7109
267,BUMA.1121.00012,1,624268,631350,+,7082
267,BUMA.1121.00087,1,2507579,2514638,-,7059
267,BUMA.1121.00043,1,1961466,1968608,+,7142
267,BUMA.1121.00037,1,510183,517284,+,7101
267,BUMA.1121.00080,1,1876473,1883557,+,7084
267,BUMA.1121.00079,1,1871658,1878830,+,7172
267,BUMA.1121.00045,1,2198143,2205197,-,7054
267,BUMA.1121.00071,1,1990538,1997630,-,7092
267,BUMA.1121.00056,1,2072681,2079799,-,7118
267,BUMA.1121.00065,1,1948358,1955429,+,7071
267,BUMA.1121.00058,1,2701799,2708881,-,7082
267,BUMA.1121.00007,1,2208497,2215583,-,7086
267,BUMA.1121.00067,1,2535628,2542728,-,7100
267,BUMA.1121.00090,1,4044761,4051889,+,7128
267,BUMA.1121.00051,1,1857884,1864970,+,7086
267,BUMA.1121.00020,1,2319469,2326543,-,7074
267,BUMA.1121.00103,1,2552020,2559103,-,7083
267,BUMA.1121.00047,1,1094793,1101860,-,7067
267,BUMA.1121.00042,1,1506963,1514023,+,7060
267,BUMA.1121.00055,1,1434021,1441114,+,7093
267,BUMA.1121.00031,1,3303927,3311046,+,7119
267,BUMA.1121.00040,1,2382892,2389966,-,7074
267,BUMA.1121.00044,1,1520123,1527197,-,7074
267,BUMA.1121.00088,1,2755388,2762507,+,7119
267,BUMA.1121.00069,1,1972945,1980037,-,7092
267,BUMA.1121.00064,1,1872068,1879156,+,7088
267,BUMA.1121.00105,1,3369994,3377079,-,7085
267,BUMA.1121.00015,1,1795509,1802569,+,7060
267,BUMA.1121.00059,1,1059367,1066449,+,7082
267,BUMA.1121.00026,1,2932212,2939270,+,7058
267,BUMA.1121.00022,1,2532793,2539853,+,7060
267,BUMA.1121.00052,1,2063255,2070329,-,7074
267,BUMA.1121.00101,1,628727,635914,-,7187
267,BUMA.1121.00001,1,2176902,2184002,-,7100
267,BUMA.1121.00068,1,613005,620102,+,7097
267,BUMA.1121.00099,1,482180,489279,-,7099
267,BUMA.1121.00091,1,2688271,2695398,-,7127
267,BUMA.1121.00098,1,439484,446572,+,7088
267,BUMA.1121.00013,1,1939848,1946923,+,7075
267,BUMA.1121.00049,1,4023664,4030782,-,7118
267,BUMA.1121.00072,1,1973416,1980508,-,7092
267,BUMA.1121.00076,1,3461331,3468421,-,7090
267,BUMA.1121.00083,1,3810077,3817169,-,7092
267,BUMA.1121.00078,1,7684,14770,-,7086
267,BUMA.1121.00095,1,3827225,3834285,-,7060
267,BUMA.1121.00077,1,533925,541001,+,7076
267,BUMA.1121.00063,1,1997990,2005082,-,7092
267,BUMA.1121.00061,1,2000921,2008012,-,7091
267,BUMA.1121.00050,1,3516626,3523685,-,7059
267,BUMA.1121.00074,1,1980723,1987886,-,7163
267,BUMA.1121.00062,1,2703803,2710920,-,7117
267,BUMA.1121.00060,1,423887,430941,-,7054
267,BUMA.1121.00070,1,1971967,1979059,-,7092
267,BUMA.1121.00075,1,1344474,1351564,+,7090
267,BUMA.1121.00041,1,3163198,3170313,+,7115
267,BUMA.1121.00073,1,1998988,2006080,-,7092
267,BUMA.1121.00017,1,2189630,2196704,-,7074
267,BUMA.1121.00066,1,1974870,1981962,-,7092
267,BUMA.1121.00107,1,1749494,1756551,+,7057
267,BUMA.1121.00085,1,1660201,1667275,-,7074
267,BUMA.1121.00030,1,2189702,2196776,-,7074
267,BUMA.1121.00112,1,1151164,1158237,-,7073
267,BUMA.1121.00002,1,3218070,3225130,+,7060
267,BUMA.1121.00082,1,2154503,2161595,-,7092
267,BUMA.1121.00014,1,906038,913138,-,7100
267,BUMA.1121.00011,1,3806647,3813726,-,7079
267,BUMA.1121.00057,1,2932025,2939118,+,7093
267,BUMA.1121.00018,1,2495763,2502855,+,7092
267,BUMA.1121.00039,1,1992019,1999120,+,7101
267,BUMA.1121.00016,1,10272,17333,+,7061
267,BUMA.1121.00004,1,2254494,2261567,-,7073
267,BUMA.1121.00005,1,565641,572775,+,7134
267,BUMA.1121.00100,1,3473504,3480489,-,6985
266,BUMA.1121.00027,1,19622,27116,+,7494
266,BUMA.1121.00025,1,766849,774297,-,7448
266,BUMA.1121.00021,1,2492493,2499881,+,7388
266,BUMA.1121.00023,1,204392,211891,+,7499
266,BUMA.1121.00024,1,2264541,2271962,-,7421
266,BUMA.1121.00033,1,2977,10407,+,7430
266,BUMA.1121.00034,1,2301909,2309321,-,7412
266,BUMA.1121.00036,1,2000700,2008154,-,7454
266,BUMA.1121.00032,1,331412,338806,-,7394
266,BUMA.1121.00009,1,3724116,3731561,-,7445
266,BUMA.1121.00008,1,2277508,2284929,-,7421
266,BUMA.1121.00003,1,408845,416241,+,7396
266,BUMA.1121.00109,1,76577,84010,-,7433
266,BUMA.1121.00053,1,1561839,1569350,+,7511
266,BUMA.1121.00110,1,2951893,2959380,-,7487
266,BUMA.1121.00104,1,3380777,3388212,-,7435
266,BUMA.1121.00086,1,791777,799312,+,7535
266,BUMA.1121.00092,1,1971916,1979406,-,7490
266,BUMA.1121.00096,1,1426801,1434193,-,7392
266,BUMA.1121.00097,1,2091510,2099042,-,7532
266,BUMA.1121.00093,1,2646890,2654380,+,7490
266,BUMA.1121.00106,1,1604540,1611936,+,7396
266,BUMA.1121.00010,1,3185408,3192829,+,7421
266,BUMA.1121.00035,1,3011420,3018844,+,7424
266,BUMA.1121.00108,1,2812863,2820244,+,7381
266,BUMA.1121.00028,1,2264516,2271937,-,7421
266,BUMA.1121.00094,1,1867475,1874918,+,7443
266,BUMA.1121.00102,1,3478291,3485929,-,7638
266,BUMA.1121.00111,1,2038503,2047104,+,8601
266,BUMA.1121.00089,1,1836067,1843493,+,7426
266,BUMA.1121.00084,1,2202723,2210221,+,7498
266,BUMA.1121.00029,1,3069746,3077206,-,7460
266,BUMA.1121.00012,1,612597,621424,+,8827
266,BUMA.1121.00087,1,2517470,2524987,-,7517
266,BUMA.1121.00043,1,1951006,1958622,+,7616
266,BUMA.1121.00037,1,499849,507339,+,7490
266,BUMA.1121.00080,1,1866176,1873650,+,7474
266,BUMA.1121.00079,1,1861270,1868836,+,7566
266,BUMA.1121.00045,1,2208029,2215467,-,7438
266,BUMA.1121.00071,1,2000471,2007992,-,7521
266,BUMA.1121.00056,1,2082635,2090061,-,7426
266,BUMA.1121.00065,1,1938163,1945517,+,7354
266,BUMA.1121.00058,1,2711713,2719188,-,7475
266,BUMA.1121.00007,1,2218399,2225889,-,7490
266,BUMA.1121.00067,1,2545552,2552993,-,7441
266,BUMA.1121.00090,1,4034446,4041918,+,7472
266,BUMA.1121.00051,1,1847443,1855062,+,7619
266,BUMA.1121.00020,1,2329375,2336796,-,7421
266,BUMA.1121.00103,1,2561944,2569448,-,7504
266,BUMA.1121.00047,1,1104701,1112225,-,7524
266,BUMA.1121.00042,1,1496710,1504122,+,7412
266,BUMA.1121.00055,1,1423762,1431180,+,7418
266,BUMA.1121.00031,1,3293578,3301071,+,7493
266,BUMA.1121.00040,1,2392798,2400228,-,7430
266,BUMA.1121.00044,1,1530029,1537441,-,7412
266,BUMA.1121.00088,1,2745166,2752553,+,7387
266,BUMA.1121.00069,1,1982878,1990399,-,7521
266,BUMA.1121.00064,1,1861804,1869227,+,7423
266,BUMA.1121.00105,1,3379911,3387343,-,7432
266,BUMA.1121.00015,1,1785283,1792677,+,7394
266,BUMA.1121.00059,1,1049058,1056526,+,7468
266,BUMA.1121.00026,1,2921842,2929371,+,7529
266,BUMA.1121.00022,1,2522372,2529961,+,7589
266,BUMA.1121.00052,1,2073161,2080690,-,7529
266,BUMA.1121.00101,1,638765,646276,-,7511
266,BUMA.1121.00001,1,2186846,2194288,-,7442
266,BUMA.1121.00068,1,602727,610164,+,7437
266,BUMA.1121.00099,1,492120,499570,-,7450
266,BUMA.1121.00091,1,2698233,2705725,-,7492
266,BUMA.1121.00098,1,429250,436643,+,7393
266,BUMA.1121.00013,1,1929361,1937016,+,7655
266,BUMA.1121.00049,1,584,7962,-,7378
266,BUMA.1121.00072,1,1983349,1990821,-,7472
266,BUMA.1121.00076,1,3471262,3478706,-,7444
266,BUMA.1121.00083,1,3820010,3827531,-,7521
266,BUMA.1121.00078,1,17606,24942,-,7336
266,BUMA.1121.00095,1,3837124,3844542,-,7418
266,BUMA.1121.00077,1,523534,531084,+,7550
266,BUMA.1121.00063,1,2007917,2015437,-,7520
266,BUMA.1121.00061,1,2010853,2018373,-,7520
266,BUMA.1121.00050,1,3526516,3534087,-,7571
266,BUMA.1121.00074,1,1990721,1998226,-,7505
266,BUMA.1121.00062,1,2713761,2721238,-,7477
266,BUMA.1121.00060,1,433773,441211,-,7438
266,BUMA.1121.00070,1,1981900,1989418,-,7518
266,BUMA.1121.00075,1,1334198,1341633,+,7435
266,BUMA.1121.00041,1,3152851,3160357,+,7506
266,BUMA.1121.00073,1,2008921,2016439,-,7518
266,BUMA.1121.00017,1,2199535,2206956,-,7421
266,BUMA.1121.00066,1,1984803,1992161,-,7358
266,BUMA.1121.00107,1,1739203,1746656,+,7453
266,BUMA.1121.00085,1,1670107,1677636,-,7529
266,BUMA.1121.00030,1,2199607,2207019,-,7412
266,BUMA.1121.00112,1,1161069,1168504,-,7435
266,BUMA.1121.00002,1,3207799,3215238,+,7439
266,BUMA.1121.00082,1,2164436,2171957,-,7521
266,BUMA.1121.00014,1,915994,923373,-,7379
266,BUMA.1121.00011,1,3816567,3824021,-,7454
266,BUMA.1121.00057,1,2921735,2929184,+,7449
266,BUMA.1121.00018,1,2485444,2492919,+,7475
266,BUMA.1121.00039,1,1981676,1989175,+,7499
266,BUMA.1121.00016,1,1,7437,+,7436
266,BUMA.1121.00004,1,2264398,2271828,-,7430
266,BUMA.1121.00005,1,554016,562805,+,8789
266,BUMA.1121.00100,1,3483330,3490777,-,7447
265,BUMA.1121.00027,1,11689,16693,+,5004
265,BUMA.1121.00025,1,777221,782225,-,5004
265,BUMA.1121.00021,1,2484561,2489565,+,5004
265,BUMA.1121.00023,1,196485,201489,+,5004
265,BUMA.1121.00024,1,2274887,2279896,-,5009
265,BUMA.1121.00033,1,4186480,4191431,+,4951
265,BUMA.1121.00034,1,2312246,2317255,-,5009
265,BUMA.1121.00036,1,2011079,2016088,-,5009
265,BUMA.1121.00032,1,341731,346740,-,5009
265,BUMA.1121.00009,1,3734486,3739490,-,5004
265,BUMA.1121.00008,1,2287854,2292863,-,5009
265,BUMA.1121.00003,1,400917,405921,+,5004
265,BUMA.1121.00109,1,86940,91944,-,5004
265,BUMA.1121.00053,1,1553911,1558915,+,5004
265,BUMA.1121.00110,1,2962315,2967319,-,5004
265,BUMA.1121.00104,1,3391137,3396141,-,5004
265,BUMA.1121.00086,1,783844,788853,+,5009
265,BUMA.1121.00092,1,1982351,1987355,-,5004
265,BUMA.1121.00096,1,1437118,1442122,-,5004
265,BUMA.1121.00097,1,2101967,2106971,-,5004
265,BUMA.1121.00093,1,2638942,2643946,+,5004
265,BUMA.1121.00106,1,1596612,1601616,+,5004
265,BUMA.1121.00010,1,3177475,3182484,+,5009
265,BUMA.1121.00035,1,3003488,3008492,+,5004
265,BUMA.1121.00108,1,2804935,2809939,+,5004
265,BUMA.1121.00028,1,2274862,2279871,-,5009
265,BUMA.1121.00094,1,1859537,1864541,+,5004
265,BUMA.1121.00102,1,3488854,3493858,-,5004
265,BUMA.1121.00111,1,2030561,2035565,+,5004
265,BUMA.1121.00089,1,1828182,1833186,+,5004
265,BUMA.1121.00084,1,2194795,2199799,+,5004
265,BUMA.1121.00029,1,3080135,3085138,-,5003
265,BUMA.1121.00012,1,604665,609669,+,5004
265,BUMA.1121.00087,1,2527912,2532921,-,5009
265,BUMA.1121.00043,1,1943074,1948078,+,5004
265,BUMA.1121.00037,1,491921,496925,+,5004
265,BUMA.1121.00080,1,1858238,1863242,+,5004
265,BUMA.1121.00079,1,1853335,1858337,+,5002
265,BUMA.1121.00045,1,2218392,2223396,-,5004
265,BUMA.1121.00071,1,2010917,2015921,-,5004
265,BUMA.1121.00056,1,2092943,2097947,-,5004
265,BUMA.1121.00065,1,1930276,1935280,+,5004
265,BUMA.1121.00058,1,2722128,2727132,-,5004
265,BUMA.1121.00007,1,2228814,2233818,-,5004
265,BUMA.1121.00067,1,2555918,2560922,-,5004
265,BUMA.1121.00090,1,4026518,4031522,+,5004
265,BUMA.1121.00051,1,1839505,1844509,+,5004
265,BUMA.1121.00020,1,2339721,2344730,-,5009
265,BUMA.1121.00103,1,2572373,2577377,-,5004
265,BUMA.1121.00047,1,1115107,1120111,-,5004
265,BUMA.1121.00042,1,1488777,1493786,+,5009
265,BUMA.1121.00055,1,1415814,1420818,+,5004
265,BUMA.1121.00031,1,3285647,3290650,+,5003
265,BUMA.1121.00040,1,2403153,2408162,-,5009
265,BUMA.1121.00044,1,1540366,1545375,-,5009
265,BUMA.1121.00088,1,2737238,2742242,+,5004
265,BUMA.1121.00069,1,1993329,1998333,-,5004
265,BUMA.1121.00064,1,1853876,1858880,+,5004
265,BUMA.1121.00105,1,3390278,3395282,-,5004
265,BUMA.1121.00015,1,1777349,1782359,+,5010
265,BUMA.1121.00059,1,1041110,1046114,+,5004
265,BUMA.1121.00026,1,2913909,2918918,+,5009
265,BUMA.1121.00022,1,2514439,2519448,+,5009
265,BUMA.1121.00052,1,2083615,2088624,-,5009
265,BUMA.1121.00101,1,649201,654205,-,5004
265,BUMA.1121.00001,1,2197217,2202221,-,5004
265,BUMA.1121.00068,1,594799,599803,+,5004
265,BUMA.1121.00099,1,502445,507448,-,5003
265,BUMA.1121.00091,1,2708609,2713613,-,5004
265,BUMA.1121.00098,1,421322,426326,+,5004
265,BUMA.1121.00013,1,1921428,1926437,+,5009
265,BUMA.1121.00049,1,10887,15891,-,5004
265,BUMA.1121.00072,1,1993751,1998755,-,5004
265,BUMA.1121.00076,1,3481631,3486635,-,5004
265,BUMA.1121.00083,1,3830461,3835465,-,5004
265,BUMA.1121.00078,1,27824,32828,-,5004
265,BUMA.1121.00095,1,3847472,3852475,-,5003
265,BUMA.1121.00077,1,515596,520600,+,5004
265,BUMA.1121.00063,1,2018367,2023371,-,5004
265,BUMA.1121.00061,1,2021303,2026307,-,5004
265,BUMA.1121.00050,1,3537012,3542021,-,5009
265,BUMA.1121.00074,1,2001151,2006155,-,5004
265,BUMA.1121.00062,1,2724163,2729167,-,5004
265,BUMA.1121.00060,1,444136,449140,-,5004
265,BUMA.1121.00070,1,1992348,1997352,-,5004
265,BUMA.1121.00075,1,1326270,1331274,+,5004
265,BUMA.1121.00041,1,3144923,3149927,+,5004
265,BUMA.1121.00073,1,2019369,2024373,-,5004
265,BUMA.1121.00017,1,2209881,2214890,-,5009
265,BUMA.1121.00066,1,1995091,2000095,-,5004
265,BUMA.1121.00107,1,1731276,1736280,+,5004
265,BUMA.1121.00085,1,1680561,1685570,-,5009
265,BUMA.1121.00030,1,2209944,2214953,-,5009
265,BUMA.1121.00112,1,1171439,1176443,-,5004
265,BUMA.1121.00002,1,3199867,3204875,+,5008
265,BUMA.1121.00082,1,2174887,2179891,-,5004
265,BUMA.1121.00014,1,926302,931306,-,5004
265,BUMA.1121.00011,1,3826946,3831950,-,5004
265,BUMA.1121.00057,1,2913802,2918806,+,5004
265,BUMA.1121.00018,1,2477517,2482521,+,5004
265,BUMA.1121.00039,1,1973744,1978748,+,5004
265,BUMA.1121.00016,1,4048483,4053487,+,5004
265,BUMA.1121.00004,1,2274753,2279762,-,5009
265,BUMA.1121.00005,1,546084,551087,+,5003
265,BUMA.1121.00100,1,3493702,3498706,-,5004
264,BUMA.1121.00027,1,2964,11687,+,8723
264,BUMA.1121.00025,1,782226,790903,-,8677
264,BUMA.1121.00021,1,2475854,2484559,+,8705
264,BUMA.1121.00023,1,187792,196483,+,8691
264,BUMA.1121.00033,1,4177774,4186478,+,8704
264,BUMA.1121.00009,1,3739491,3748141,-,8650
264,BUMA.1121.00003,1,392250,400915,+,8665
264,BUMA.1121.00109,1,91945,100603,-,8658
264,BUMA.1121.00053,1,1545229,1553909,+,8680
264,BUMA.1121.00110,1,2967320,2975987,-,8667
264,BUMA.1121.00104,1,3396142,3404808,-,8666
264,BUMA.1121.00092,1,1987356,1996037,-,8681
264,BUMA.1121.00096,1,1442123,1450804,-,8681
264,BUMA.1121.00097,1,2106972,2115591,-,8619
264,BUMA.1121.00093,1,2630259,2638940,+,8681
264,BUMA.1121.00106,1,1587958,1596610,+,8652
264,BUMA.1121.00035,1,2994806,3003486,+,8680
264,BUMA.1121.00108,1,2796244,2804933,+,8689
264,BUMA.1121.00094,1,1850886,1859535,+,8649
264,BUMA.1121.00102,1,3493859,3502550,-,8691
264,BUMA.1121.00111,1,2021896,2030559,+,8663
264,BUMA.1121.00089,1,1819531,1828180,+,8649
264,BUMA.1121.00084,1,2186141,2194793,+,8652
264,BUMA.1121.00029,1,3085139,3093819,-,8680
264,BUMA.1121.00012,1,595986,604663,+,8677
264,BUMA.1121.00043,1,1934381,1943072,+,8691
264,BUMA.1121.00037,1,483254,491919,+,8665
264,BUMA.1121.00080,1,1849588,1858236,+,8648
264,BUMA.1121.00079,1,1844686,1853333,+,8647
264,BUMA.1121.00045,1,2223397,2232064,-,8667
264,BUMA.1121.00071,1,2015922,2024614,-,8692
264,BUMA.1121.00056,1,2097948,2106597,-,8649
264,BUMA.1121.00065,1,1921606,1930274,+,8668
264,BUMA.1121.00058,1,2727133,2735812,-,8679
264,BUMA.1121.00007,1,2233819,2242491,-,8672
264,BUMA.1121.00067,1,2560923,2569614,-,8691
264,BUMA.1121.00090,1,4017825,4026516,+,8691
264,BUMA.1121.00051,1,1830857,1839503,+,8646
264,BUMA.1121.00103,1,2577378,2586045,-,8667
264,BUMA.1121.00047,1,1120112,1128775,-,8663
264,BUMA.1121.00055,1,1407128,1415812,+,8684
264,BUMA.1121.00031,1,3276968,3285645,+,8677
264,BUMA.1121.00088,1,2728584,2737236,+,8652
264,BUMA.1121.00069,1,1998334,2007026,-,8692
264,BUMA.1121.00064,1,1845222,1853874,+,8652
264,BUMA.1121.00105,1,3395283,3404005,-,8722
264,BUMA.1121.00059,1,1032428,1041108,+,8680
264,BUMA.1121.00101,1,654206,662873,-,8667
264,BUMA.1121.00001,1,2202222,2210902,-,8680
264,BUMA.1121.00068,1,586151,594797,+,8646
264,BUMA.1121.00099,1,507449,516114,-,8665
264,BUMA.1121.00091,1,2713614,2722364,-,8750
264,BUMA.1121.00098,1,412643,421320,+,8677
264,BUMA.1121.00049,1,15892,24643,-,8751
264,BUMA.1121.00072,1,1998756,2007448,-,8692
264,BUMA.1121.00076,1,3486636,3495285,-,8649
264,BUMA.1121.00083,1,3835466,3844158,-,8692
264,BUMA.1121.00078,1,32829,41522,-,8693
264,BUMA.1121.00095,1,3852476,3861128,-,8652
264,BUMA.1121.00077,1,506927,515594,+,8667
264,BUMA.1121.00063,1,2023372,2032064,-,8692
264,BUMA.1121.00061,1,2026308,2035000,-,8692
264,BUMA.1121.00074,1,2006156,2014850,-,8694
264,BUMA.1121.00062,1,2729168,2737836,-,8668
264,BUMA.1121.00060,1,449141,457808,-,8667
264,BUMA.1121.00070,1,1997353,2006045,-,8692
264,BUMA.1121.00075,1,1317623,1326268,+,8645
264,BUMA.1121.00041,1,3136171,3144921,+,8750
264,BUMA.1121.00073,1,2024374,2033066,-,8692
264,BUMA.1121.00066,1,2000096,2008788,-,8692
264,BUMA.1121.00107,1,1722565,1731274,+,8709
264,BUMA.1121.00112,1,1176444,1185111,-,8667
264,BUMA.1121.00082,1,2179892,2188584,-,8692
264,BUMA.1121.00014,1,931307,939984,-,8677
264,BUMA.1121.00011,1,3831951,3840678,-,8727
264,BUMA.1121.00057,1,2905052,2913800,+,8748
264,BUMA.1121.00018,1,2468838,2477515,+,8677
264,BUMA.1121.00039,1,1965079,1973742,+,8663
264,BUMA.1121.00016,1,4039790,4048481,+,8691
264,BUMA.1121.00005,1,537430,546082,+,8652
264,BUMA.1121.00100,1,3498707,3507372,-,8665
263,BUMA.1121.00109,2,3183539,3186934,+,3395
263,BUMA.1121.00059,2,2104158,2107553,+,3395
263,BUMA.1121.00088,2,1494401,1497796,-,3395
263,BUMA.1121.00105,2,932082,935477,+,3395
263,BUMA.1121.00062,2,191877,195272,+,3395
263,BUMA.1121.00058,2,2101004,2104399,-,3395
263,BUMA.1121.00084,2,197926,201321,-,3395
263,BUMA.1121.00106,2,261692,265087,+,3395
262,BUMA.1121.00109,2,3152856,3173736,+,20880
262,BUMA.1121.00059,2,2073415,2094355,+,20940
262,BUMA.1121.00088,2,1508548,1529487,-,20939
262,BUMA.1121.00105,2,901335,922279,+,20944
262,BUMA.1121.00062,2,161129,182074,+,20945
262,BUMA.1121.00058,2,2114201,2135141,-,20940
262,BUMA.1121.00084,2,212073,233012,-,20939
262,BUMA.1121.00106,2,205535,226476,-,20941
261,BUMA.1121.00109,2,3148374,3151914,+,3540
261,BUMA.1121.00059,2,2069261,2072802,+,3541
261,BUMA.1121.00088,2,1531678,1535218,-,3540
261,BUMA.1121.00105,2,895599,899144,+,3545
261,BUMA.1121.00062,2,156112,159653,+,3541
261,BUMA.1121.00058,2,2136589,2140130,-,3541
261,BUMA.1121.00084,2,235203,238743,-,3540
261,BUMA.1121.00106,2,229879,233420,-,3541
260,BUMA.1121.00109,2,3129900,3148373,+,18473
260,BUMA.1121.00059,2,2050787,2069260,+,18473
260,BUMA.1121.00088,2,1535220,1553692,-,18472
260,BUMA.1121.00105,2,875917,894390,+,18473
260,BUMA.1121.00062,2,137638,156111,+,18473
260,BUMA.1121.00058,2,2140132,2158603,-,18471
260,BUMA.1121.00084,2,238745,257217,-,18472
260,BUMA.1121.00106,2,233422,251889,-,18467
259,BUMA.1121.00109,2,3123395,3129899,+,6504
259,BUMA.1121.00109,2,3173738,3180242,-,6504
259,BUMA.1121.00059,2,2044282,2050786,+,6504
259,BUMA.1121.00059,2,2094357,2100861,-,6504
259,BUMA.1121.00088,2,1502043,1508547,+,6504
259,BUMA.1121.00088,2,1553694,1560198,-,6504
259,BUMA.1121.00105,2,869412,875916,+,6504
259,BUMA.1121.00105,2,922281,928785,-,6504
259,BUMA.1121.00062,2,131134,137637,+,6503
259,BUMA.1121.00062,2,182076,188580,-,6504
259,BUMA.1121.00058,2,2107696,2114200,+,6504
259,BUMA.1121.00058,2,2158605,2165109,-,6504
259,BUMA.1121.00084,2,205568,212072,+,6504
259,BUMA.1121.00084,2,257219,263723,-,6504
259,BUMA.1121.00106,2,199030,205534,+,6504
259,BUMA.1121.00106,2,251891,258395,-,6504
258,BUMA.1121.00109,2,2407982,2421085,+,13103
258,BUMA.1121.00095,2,1076766,1089867,-,13101
258,BUMA.1121.00047,1,577538,590643,+,13105
258,BUMA.1121.00003,2,459936,473040,-,13104
258,BUMA.1121.00065,2,2286570,2299675,-,13105
257,BUMA.1121.00109,2,2396823,2406741,+,9918
257,BUMA.1121.00095,2,1089868,1099784,-,9916
257,BUMA.1121.00047,1,567597,577536,+,9939
257,BUMA.1121.00003,2,473041,482981,-,9940
257,BUMA.1121.00065,2,2299676,2309616,-,9940
256,BUMA.1121.00109,2,2387287,2391329,+,4042
256,BUMA.1121.00095,2,1105581,1109381,-,3800
256,BUMA.1121.00003,2,488196,492287,-,4091
256,BUMA.1121.00065,2,2314142,2318185,-,4043
255,BUMA.1121.00109,2,941218,974407,+,33189
255,BUMA.1121.00027,1,3517448,3550693,-,33245
255,BUMA.1121.00025,1,1308178,1341398,+,33220
255,BUMA.1121.00021,1,1964499,1997737,-,33238
255,BUMA.1121.00023,1,3738784,3772017,-,33233
255,BUMA.1121.00033,1,3547321,3580572,-,33251
255,BUMA.1121.00009,1,237888,271138,+,33250
255,BUMA.1121.00003,1,3795540,3828804,-,33264
255,BUMA.1121.00053,1,1049513,1082736,-,33223
255,BUMA.1121.00110,1,3443171,3476378,+,33207
255,BUMA.1121.00104,1,3891662,3924900,+,33238
255,BUMA.1121.00092,1,2522761,2555992,+,33231
255,BUMA.1121.00096,1,1919885,1953111,+,33226
255,BUMA.1121.00097,1,2655793,2688989,+,33196
255,BUMA.1121.00093,1,2070423,2103652,-,33229
255,BUMA.1121.00106,1,1065223,1098601,-,33378
255,BUMA.1121.00035,1,2478707,2512012,-,33305
255,BUMA.1121.00108,1,2298222,2331425,-,33203
255,BUMA.1121.00094,1,1343329,1376646,-,33317
255,BUMA.1121.00102,1,4058755,4092015,+,33260
255,BUMA.1121.00111,1,1475438,1508718,-,33280
255,BUMA.1121.00089,1,1311993,1345274,-,33281
255,BUMA.1121.00084,1,1550688,1583895,-,33207
255,BUMA.1121.00029,1,3573799,3607049,+,33250
255,BUMA.1121.00012,1,4146338,4179585,-,33247
255,BUMA.1121.00043,1,1379759,1413032,-,33273
255,BUMA.1121.00037,1,3975524,4008812,-,33288
255,BUMA.1121.00080,1,1341952,1375265,-,33313
255,BUMA.1121.00079,1,1337105,1370412,-,33307
255,BUMA.1121.00045,1,2700682,2733869,+,33187
255,BUMA.1121.00071,1,1297297,1330547,-,33250
255,BUMA.1121.00056,1,2580625,2613907,+,33282
255,BUMA.1121.00065,1,1424167,1457415,-,33248
255,BUMA.1121.00058,1,3209193,3242439,+,33246
255,BUMA.1121.00007,1,2762317,2795545,+,33228
255,BUMA.1121.00067,1,3065418,3098652,+,33234
255,BUMA.1121.00090,1,3479113,3512402,-,33289
255,BUMA.1121.00051,1,1314815,1348100,-,33285
255,BUMA.1121.00103,1,3055973,3089159,+,33186
255,BUMA.1121.00047,1,1602392,1635659,+,33267
255,BUMA.1121.00055,1,910996,944247,-,33251
255,BUMA.1121.00031,1,2758399,2791672,-,33273
255,BUMA.1121.00088,1,2221106,2254387,-,33281
255,BUMA.1121.00069,1,1260402,1293653,-,33251
255,BUMA.1121.00064,1,1331046,1364290,-,33244
255,BUMA.1121.00105,1,3879768,3913090,+,33322
255,BUMA.1121.00059,1,533320,566589,-,33269
255,BUMA.1121.00101,1,1135733,1168960,+,33227
255,BUMA.1121.00001,1,2698516,2731738,+,33222
255,BUMA.1121.00068,1,66347,99569,-,33222
255,BUMA.1121.00099,1,1036749,1070002,+,33253
255,BUMA.1121.00091,1,3195628,3228877,+,33249
255,BUMA.1121.00098,1,4088505,4121737,-,33232
255,BUMA.1121.00049,1,526683,559909,+,33226
255,BUMA.1121.00072,1,1279914,1313150,-,33236
255,BUMA.1121.00076,1,27115,60484,+,33369
255,BUMA.1121.00083,1,233769,267052,+,33283
255,BUMA.1121.00078,1,603283,636499,+,33216
255,BUMA.1121.00095,1,327516,360774,+,33258
255,BUMA.1121.00077,1,6405,39612,-,33207
255,BUMA.1121.00063,1,1304322,1337572,-,33250
255,BUMA.1121.00061,1,1307249,1340497,-,33248
255,BUMA.1121.00074,1,2496109,2529363,+,33254
255,BUMA.1121.00062,1,3219006,3252366,+,33360
255,BUMA.1121.00060,1,926416,959603,+,33187
255,BUMA.1121.00070,1,1278216,1311466,-,33250
255,BUMA.1121.00075,1,819161,852526,-,33365
255,BUMA.1121.00041,1,2629315,2662541,-,33226
255,BUMA.1121.00073,1,1305427,1338678,-,33251
255,BUMA.1121.00066,1,1281376,1314626,-,33250
255,BUMA.1121.00107,1,1227144,1260341,-,33197
255,BUMA.1121.00112,1,1702061,1735325,+,33264
255,BUMA.1121.00082,1,1437781,1471063,-,33282
255,BUMA.1121.00014,1,1425382,1458629,+,33247
255,BUMA.1121.00011,1,235357,268567,+,33210
255,BUMA.1121.00057,1,2405586,2438880,-,33294
255,BUMA.1121.00018,1,1918476,1951694,-,33218
255,BUMA.1121.00039,1,1460320,1493527,-,33207
255,BUMA.1121.00016,1,3483823,3517094,-,33271
255,BUMA.1121.00005,1,4566,37783,-,33217
255,BUMA.1121.00100,1,3974944,4008175,+,33231
254,BUMA.1121.00109,2,925767,941217,+,15450
254,BUMA.1121.00027,1,3550695,3566157,-,15462
254,BUMA.1121.00025,1,1292696,1308177,+,15481
254,BUMA.1121.00021,1,1997739,2013208,-,15469
254,BUMA.1121.00023,1,3772019,3787475,-,15456
254,BUMA.1121.00024,1,1754238,1769682,-,15444
254,BUMA.1121.00033,1,3580574,3596067,-,15493
254,BUMA.1121.00034,1,1791693,1807137,-,15444
254,BUMA.1121.00036,1,2343720,2359162,+,15442
254,BUMA.1121.00032,1,3284765,3300209,-,15444
254,BUMA.1121.00009,1,222438,237887,+,15449
254,BUMA.1121.00008,1,1767338,1782782,-,15444
254,BUMA.1121.00003,1,3828806,3844238,-,15432
254,BUMA.1121.00053,1,1082738,1098176,-,15438
254,BUMA.1121.00110,1,3427719,3443170,+,15451
254,BUMA.1121.00104,1,3876284,3891661,+,15377
254,BUMA.1121.00086,1,440620,456063,-,15443
254,BUMA.1121.00092,1,2507316,2522760,+,15444
254,BUMA.1121.00096,1,1904409,1919884,+,15475
254,BUMA.1121.00054,1,2261636,2277087,-,15451
254,BUMA.1121.00097,1,2640321,2655792,+,15471
254,BUMA.1121.00093,1,2103654,2119098,-,15444
254,BUMA.1121.00106,1,1098603,1114065,-,15462
254,BUMA.1121.00010,1,2876601,2892046,-,15445
254,BUMA.1121.00035,1,2512014,2527488,-,15474
254,BUMA.1121.00108,1,2331427,2346928,-,15501
254,BUMA.1121.00028,1,1754273,1769717,-,15444
254,BUMA.1121.00094,1,1376648,1392106,-,15458
254,BUMA.1121.00102,1,4043306,4058754,+,15448
254,BUMA.1121.00111,1,1508720,1524179,-,15459
254,BUMA.1121.00089,1,1345276,1360734,-,15458
254,BUMA.1121.00084,1,1583897,1599360,-,15463
254,BUMA.1121.00029,1,3558325,3573798,+,15473
254,BUMA.1121.00012,1,4179587,4195070,-,15483
254,BUMA.1121.00087,1,2860709,2876151,+,15442
254,BUMA.1121.00043,1,1413034,1428484,-,15450
254,BUMA.1121.00046,1,3427740,3443209,+,15469
254,BUMA.1121.00037,1,4008814,4024296,-,15482
254,BUMA.1121.00080,1,1375267,1390706,-,15439
254,BUMA.1121.00079,1,1370414,1385861,-,15447
254,BUMA.1121.00045,1,2685243,2700681,+,15438
254,BUMA.1121.00071,1,1330549,1346001,-,15452
254,BUMA.1121.00056,1,2565166,2580624,+,15458
254,BUMA.1121.00065,1,1457417,1472860,-,15443
254,BUMA.1121.00058,1,3193723,3209192,+,15469
254,BUMA.1121.00007,1,2746839,2762316,+,15477
254,BUMA.1121.00067,1,3049977,3065417,+,15440
254,BUMA.1121.00090,1,3512404,3527876,-,15472
254,BUMA.1121.00051,1,1348102,1363552,-,15450
254,BUMA.1121.00020,1,1819223,1834667,-,15444
254,BUMA.1121.00103,1,3040496,3055972,+,15476
254,BUMA.1121.00048,1,1658651,1674101,+,15450
254,BUMA.1121.00047,1,1586951,1602391,+,15440
254,BUMA.1121.00042,1,2593320,2608764,+,15444
254,BUMA.1121.00055,1,944249,959710,-,15461
254,BUMA.1121.00031,1,2791674,2807122,-,15448
254,BUMA.1121.00040,1,1683283,1698726,-,15443
254,BUMA.1121.00044,1,1019791,1035235,-,15444
254,BUMA.1121.00088,1,2254389,2269853,-,15464
254,BUMA.1121.00069,1,1293655,1309107,-,15452
254,BUMA.1121.00064,1,1364292,1379742,-,15450
254,BUMA.1121.00105,1,3864308,3879767,+,15459
254,BUMA.1121.00015,1,1165424,1180894,-,15470
254,BUMA.1121.00059,1,566591,582033,-,15442
254,BUMA.1121.00026,1,183120,198564,+,15444
254,BUMA.1121.00022,1,2089894,2105337,-,15443
254,BUMA.1121.00052,1,1553909,1569353,-,15444
254,BUMA.1121.00101,1,1120262,1135732,+,15470
254,BUMA.1121.00001,1,2683016,2698515,+,15499
254,BUMA.1121.00038,1,1866072,1881522,+,15450
254,BUMA.1121.00068,1,99571,115069,-,15498
254,BUMA.1121.00099,1,1021263,1036748,+,15485
254,BUMA.1121.00091,1,3180188,3195627,+,15439
254,BUMA.1121.00098,1,4121739,4137200,-,15461
254,BUMA.1121.00013,1,1754805,1770249,-,15444
254,BUMA.1121.00049,1,511235,526682,+,15447
254,BUMA.1121.00072,1,1313152,1328603,-,15451
254,BUMA.1121.00076,1,11655,27114,+,15459
254,BUMA.1121.00083,1,218315,233768,+,15453
254,BUMA.1121.00078,1,587847,603282,+,15435
254,BUMA.1121.00095,1,312067,327515,+,15448
254,BUMA.1121.00077,1,39614,55065,-,15451
254,BUMA.1121.00063,1,1337574,1353026,-,15452
254,BUMA.1121.00061,1,1340499,1355952,-,15453
254,BUMA.1121.00050,1,2817642,2833112,-,15470
254,BUMA.1121.00081,1,1866191,1881641,+,15450
254,BUMA.1121.00074,1,2480671,2496108,+,15437
254,BUMA.1121.00062,1,3203546,3219005,+,15459
254,BUMA.1121.00060,1,910977,926415,+,15438
254,BUMA.1121.00070,1,1311468,1326921,-,15453
254,BUMA.1121.00075,1,852528,867986,-,15458
254,BUMA.1121.00041,1,2662543,2677974,-,15431
254,BUMA.1121.00073,1,1338680,1354133,-,15453
254,BUMA.1121.00017,1,1689322,1704766,-,15444
254,BUMA.1121.00066,1,1314628,1330081,-,15453
254,BUMA.1121.00107,1,1260343,1275807,-,15464
254,BUMA.1121.00085,1,1150823,1166267,-,15444
254,BUMA.1121.00030,1,1689375,1704819,-,15444
254,BUMA.1121.00112,1,1686598,1702060,+,15462
254,BUMA.1121.00002,1,2898766,2914211,-,15445
254,BUMA.1121.00082,1,1471065,1486518,-,15453
254,BUMA.1121.00014,1,1409933,1425381,+,15448
254,BUMA.1121.00011,1,219895,235356,+,15461
254,BUMA.1121.00019,1,1754363,1769807,-,15444
254,BUMA.1121.00057,1,2438882,2454345,-,15463
254,BUMA.1121.00018,1,1951696,1967177,-,15481
254,BUMA.1121.00039,1,1493529,1508983,-,15454
254,BUMA.1121.00016,1,3517096,3532539,-,15443
254,BUMA.1121.00004,1,1755497,1770941,-,15444
254,BUMA.1121.00005,1,37785,53227,-,15442
254,BUMA.1121.00100,1,3959479,3974943,+,15464
254,BUMA.1121.00006,1,1865978,1881428,+,15450
253,BUMA.1121.00109,2,915304,922231,+,6927
253,BUMA.1121.00027,1,3569784,3576758,-,6974
253,BUMA.1121.00025,1,1282192,1289167,+,6975
253,BUMA.1121.00021,1,2016758,2023733,-,6975
253,BUMA.1121.00023,1,3790983,3797958,-,6975
253,BUMA.1121.00024,1,1773358,1780333,-,6975
253,BUMA.1121.00033,1,3599568,3606484,-,6916
253,BUMA.1121.00034,1,1810820,1817795,-,6975
253,BUMA.1121.00036,1,2333153,2340128,+,6975
253,BUMA.1121.00032,1,3303801,3310776,-,6975
253,BUMA.1121.00009,1,211850,218825,+,6975
253,BUMA.1121.00008,1,1786409,1793384,-,6975
253,BUMA.1121.00003,1,3847760,3854714,-,6954
253,BUMA.1121.00053,1,1101768,1108743,-,6975
253,BUMA.1121.00110,1,3417264,3424239,+,6975
253,BUMA.1121.00104,1,3865808,3872783,+,6975
253,BUMA.1121.00086,1,459844,466819,-,6975
253,BUMA.1121.00092,1,2496763,2503738,+,6975
253,BUMA.1121.00096,1,1893982,1900957,+,6975
253,BUMA.1121.00054,1,2280952,2287927,-,6975
253,BUMA.1121.00097,1,2629950,2636925,+,6975
253,BUMA.1121.00093,1,2122599,2129574,-,6975
253,BUMA.1121.00106,1,1117671,1124645,-,6974
253,BUMA.1121.00010,1,2895442,2902417,-,6975
253,BUMA.1121.00035,1,2531066,2538041,-,6975
253,BUMA.1121.00108,1,2350317,2357292,-,6975
253,BUMA.1121.00028,1,1773405,1780380,-,6975
253,BUMA.1121.00094,1,1395649,1402600,-,6951
253,BUMA.1121.00102,1,4032382,4039357,+,6975
253,BUMA.1121.00111,1,1527673,1534648,-,6975
253,BUMA.1121.00089,1,1364277,1371228,-,6951
253,BUMA.1121.00084,1,1602882,1609857,-,6975
253,BUMA.1121.00029,1,3547814,3554789,+,6975
253,BUMA.1121.00012,1,3437,10412,-,6975
253,BUMA.1121.00087,1,2849939,2856914,+,6975
253,BUMA.1121.00043,1,1432153,1439128,-,6975
253,BUMA.1121.00046,1,3417243,3424218,+,6975
253,BUMA.1121.00037,1,312,7287,-,6975
253,BUMA.1121.00080,1,1394263,1401213,-,6950
253,BUMA.1121.00079,1,1389334,1396309,-,6975
253,BUMA.1121.00045,1,2674808,2681735,+,6927
253,BUMA.1121.00071,1,1349502,1356477,-,6975
253,BUMA.1121.00056,1,2554672,2561623,+,6951
253,BUMA.1121.00065,1,1476375,1483350,-,6975
253,BUMA.1121.00058,1,3183303,3190278,+,6975
253,BUMA.1121.00007,1,2736370,2743345,+,6975
253,BUMA.1121.00067,1,3039455,3046406,+,6951
253,BUMA.1121.00090,1,3531419,3538394,-,6975
253,BUMA.1121.00051,1,1367074,1374024,-,6950
253,BUMA.1121.00020,1,1838217,1845192,-,6975
253,BUMA.1121.00103,1,3029896,3036871,+,6975
253,BUMA.1121.00048,1,1647791,1654766,+,6975
253,BUMA.1121.00047,1,1576366,1583317,+,6951
253,BUMA.1121.00042,1,2582890,2589812,+,6922
253,BUMA.1121.00055,1,963218,970193,-,6975
253,BUMA.1121.00031,1,2810728,2817703,-,6975
253,BUMA.1121.00040,1,1702471,1709446,-,6975
253,BUMA.1121.00044,1,1038946,1045921,-,6975
253,BUMA.1121.00088,1,2273368,2280343,-,6975
253,BUMA.1121.00069,1,1312608,1319583,-,6975
253,BUMA.1121.00064,1,1383222,1390197,-,6975
253,BUMA.1121.00105,1,3853776,3860751,+,6975
253,BUMA.1121.00015,1,1184740,1191715,-,6975
253,BUMA.1121.00059,1,585506,592480,-,6974
253,BUMA.1121.00026,1,172468,179443,+,6975
253,BUMA.1121.00022,1,2109314,2116289,-,6975
253,BUMA.1121.00052,1,1572984,1579959,-,6975
253,BUMA.1121.00101,1,1109770,1116746,+,6976
253,BUMA.1121.00001,1,2672435,2679410,+,6975
253,BUMA.1121.00038,1,1855246,1862221,+,6975
253,BUMA.1121.00068,1,118605,125580,-,6975
253,BUMA.1121.00099,1,1010618,1017593,+,6975
253,BUMA.1121.00091,1,3169789,3176764,+,6975
253,BUMA.1121.00098,1,4140957,4147932,-,6975
253,BUMA.1121.00013,1,1774023,1780998,-,6975
253,BUMA.1121.00049,1,500794,507769,+,6975
253,BUMA.1121.00072,1,1332104,1339044,-,6940
253,BUMA.1121.00076,1,1214,8189,+,6975
253,BUMA.1121.00083,1,207818,214793,+,6975
253,BUMA.1121.00078,1,577279,584234,+,6955
253,BUMA.1121.00095,1,301570,308524,+,6954
253,BUMA.1121.00077,1,58531,65509,-,6978
253,BUMA.1121.00063,1,1356527,1363502,-,6975
253,BUMA.1121.00061,1,1359453,1366428,-,6975
253,BUMA.1121.00050,1,2836972,2843947,-,6975
253,BUMA.1121.00081,1,1855330,1862305,+,6975
253,BUMA.1121.00074,1,2470160,2477135,+,6975
253,BUMA.1121.00062,1,3193042,3200017,+,6975
253,BUMA.1121.00060,1,900549,907476,+,6927
253,BUMA.1121.00070,1,1330422,1337397,-,6975
253,BUMA.1121.00075,1,871438,878413,-,6975
253,BUMA.1121.00041,1,2681454,2688407,-,6953
253,BUMA.1121.00073,1,1357634,1364609,-,6975
253,BUMA.1121.00017,1,1708470,1715445,-,6975
253,BUMA.1121.00066,1,1333582,1340557,-,6975
253,BUMA.1121.00107,1,1279294,1286270,-,6976
253,BUMA.1121.00085,1,1169929,1176904,-,6975
253,BUMA.1121.00030,1,1708526,1715501,-,6975
253,BUMA.1121.00112,1,1676150,1683125,+,6975
253,BUMA.1121.00002,1,2917719,2924694,-,6975
253,BUMA.1121.00082,1,1490019,1496994,-,6975
253,BUMA.1121.00014,1,1399261,1406236,+,6975
253,BUMA.1121.00011,1,209333,216303,+,6970
253,BUMA.1121.00019,1,1773462,1780437,-,6975
253,BUMA.1121.00057,1,2457825,2464800,-,6975
253,BUMA.1121.00018,1,1970587,1977562,-,6975
253,BUMA.1121.00039,1,1512757,1519732,-,6975
253,BUMA.1121.00016,1,3536075,3543050,-,6975
253,BUMA.1121.00004,1,1774622,1781596,-,6974
253,BUMA.1121.00005,1,56833,63808,-,6975
253,BUMA.1121.00100,1,3948947,3955922,+,6975
253,BUMA.1121.00006,1,1855257,1862232,+,6975
252,BUMA.1121.00109,2,901387,907890,+,6503
252,BUMA.1121.00027,1,3584219,3590817,-,6598
252,BUMA.1121.00025,1,1268233,1274765,+,6532
252,BUMA.1121.00021,1,2031155,2037679,-,6524
252,BUMA.1121.00023,1,3805370,3811880,-,6510
252,BUMA.1121.00024,1,1789025,1795522,-,6497
252,BUMA.1121.00033,1,3653088,3659619,-,6531
252,BUMA.1121.00034,1,1826487,1833005,-,6518
252,BUMA.1121.00036,1,2317977,2324453,+,6476
252,BUMA.1121.00032,1,3319460,3325985,-,6525
252,BUMA.1121.00009,1,197920,204438,+,6518
252,BUMA.1121.00008,1,1802068,1808593,-,6525
252,BUMA.1121.00003,1,3862272,3868776,-,6504
252,BUMA.1121.00053,1,1116178,1122694,-,6516
252,BUMA.1121.00110,1,3403311,3409827,+,6516
252,BUMA.1121.00104,1,3851973,3858511,+,6538
252,BUMA.1121.00086,1,475503,481986,-,6483
252,BUMA.1121.00092,1,2482776,2489346,+,6570
252,BUMA.1121.00096,1,1879801,1886378,+,6577
252,BUMA.1121.00054,1,959735,966240,-,6505
252,BUMA.1121.00097,1,2615770,2622452,+,6682
252,BUMA.1121.00093,1,2136991,2143561,-,6570
252,BUMA.1121.00106,1,1132027,1138621,-,6594
252,BUMA.1121.00010,1,2911093,2917581,-,6488
252,BUMA.1121.00035,1,2545460,2552001,-,6541
252,BUMA.1121.00108,1,2364760,2371385,-,6625
252,BUMA.1121.00028,1,1789072,1795569,-,6497
252,BUMA.1121.00094,1,1409911,1416435,-,6524
252,BUMA.1121.00102,1,4018246,4024825,+,6579
252,BUMA.1121.00111,1,1542049,1548564,-,6515
252,BUMA.1121.00089,1,1378563,1385080,-,6517
252,BUMA.1121.00084,1,1617281,1623862,-,6581
252,BUMA.1121.00029,1,3532505,3539048,+,6543
252,BUMA.1121.00012,1,17835,24354,-,6519
252,BUMA.1121.00087,1,2834772,2841255,+,6483
252,BUMA.1121.00043,1,1446717,1453243,-,6526
252,BUMA.1121.00046,1,2293477,2299982,-,6505
252,BUMA.1121.00037,1,14688,21217,-,6529
252,BUMA.1121.00080,1,1408556,1415087,-,6531
252,BUMA.1121.00079,1,1403767,1410290,-,6523
252,BUMA.1121.00045,1,2660929,2667405,+,6476
252,BUMA.1121.00071,1,1363902,1370436,-,6534
252,BUMA.1121.00056,1,2540820,2547337,+,6517
252,BUMA.1121.00065,1,1490655,1497171,-,6516
252,BUMA.1121.00058,1,3169361,3175911,+,6550
252,BUMA.1121.00007,1,2722411,2728927,+,6516
252,BUMA.1121.00067,1,3025544,3032084,+,6540
252,BUMA.1121.00090,1,3545813,3552335,-,6522
252,BUMA.1121.00051,1,1381367,1387891,-,6524
252,BUMA.1121.00020,1,1853884,1860402,-,6518
252,BUMA.1121.00103,1,3015925,3022411,+,6486
252,BUMA.1121.00048,1,2969549,2976054,+,6505
252,BUMA.1121.00047,1,1562508,1569015,+,6507
252,BUMA.1121.00042,1,2567725,2574223,+,6498
252,BUMA.1121.00055,1,977542,984085,-,6543
252,BUMA.1121.00031,1,2825096,2831632,-,6536
252,BUMA.1121.00040,1,1718138,1724650,-,6512
252,BUMA.1121.00044,1,1054613,1061131,-,6518
252,BUMA.1121.00088,1,2287759,2294443,-,6684
252,BUMA.1121.00069,1,1327012,1333561,-,6549
252,BUMA.1121.00064,1,1397568,1404078,-,6510
252,BUMA.1121.00105,1,3839796,3846363,+,6567
252,BUMA.1121.00015,1,2783472,2789970,-,6498
252,BUMA.1121.00059,1,599898,606525,-,6627
252,BUMA.1121.00026,1,157285,163809,+,6524
252,BUMA.1121.00022,1,2124973,2131442,-,6469
252,BUMA.1121.00052,1,1587508,1594041,-,6533
252,BUMA.1121.00101,1,1095767,1102305,+,6538
252,BUMA.1121.00001,1,2658438,2665008,+,6570
252,BUMA.1121.00038,1,3176865,3183370,+,6505
252,BUMA.1121.00068,1,132966,139799,-,6833
252,BUMA.1121.00099,1,996336,1002920,+,6584
252,BUMA.1121.00091,1,3155815,3162419,+,6604
252,BUMA.1121.00098,1,4155370,4161870,-,6500
252,BUMA.1121.00013,1,1788547,1795052,-,6505
252,BUMA.1121.00049,1,486930,493412,+,6482
252,BUMA.1121.00072,1,1346472,1353028,-,6556
252,BUMA.1121.00076,1,3920550,3927130,+,6580
252,BUMA.1121.00083,1,193824,200389,+,6565
252,BUMA.1121.00078,1,563337,569897,+,6560
252,BUMA.1121.00095,1,287699,294145,+,6446
252,BUMA.1121.00077,1,72946,79462,-,6516
252,BUMA.1121.00063,1,1370930,1377476,-,6546
252,BUMA.1121.00061,1,1373857,1380404,-,6547
252,BUMA.1121.00050,1,451727,458232,+,6505
252,BUMA.1121.00081,1,3177050,3183555,+,6505
252,BUMA.1121.00074,1,2456265,2462789,+,6524
252,BUMA.1121.00062,1,3178965,3185600,+,6635
252,BUMA.1121.00060,1,886670,893146,+,6476
252,BUMA.1121.00070,1,1344826,1351372,-,6546
252,BUMA.1121.00075,1,885814,892408,-,6594
252,BUMA.1121.00041,1,2695845,2702317,-,6472
252,BUMA.1121.00073,1,1372038,1378601,-,6563
252,BUMA.1121.00017,1,1724137,1730655,-,6518
252,BUMA.1121.00066,1,1347986,1354524,-,6538
252,BUMA.1121.00107,1,1294019,1300521,-,6502
252,BUMA.1121.00085,1,1184453,1190986,-,6533
252,BUMA.1121.00030,1,1724193,1730711,-,6518
252,BUMA.1121.00112,1,1662121,1668665,+,6544
252,BUMA.1121.00002,1,2933370,2939858,-,6488
252,BUMA.1121.00082,1,1504423,1510988,-,6565
252,BUMA.1121.00014,1,1385319,1391867,+,6548
252,BUMA.1121.00011,1,195457,201919,+,6462
252,BUMA.1121.00019,1,1789129,1795647,-,6518
252,BUMA.1121.00057,1,2472250,2478841,-,6591
252,BUMA.1121.00018,1,1984989,1991521,-,6532
252,BUMA.1121.00039,1,1527343,1533931,-,6588
252,BUMA.1121.00016,1,3550658,3557192,-,6534
252,BUMA.1121.00004,1,1790288,1796797,-,6509
252,BUMA.1121.00005,1,71222,77660,-,6438
252,BUMA.1121.00100,1,3935048,3941568,+,6520
252,BUMA.1121.00006,1,3176942,3183447,+,6505
251,BUMA.1121.00109,2,891782,899138,+,7356
251,BUMA.1121.00027,1,3593109,3600485,-,7376
251,BUMA.1121.00025,1,1258555,1265933,+,7378
251,BUMA.1121.00021,1,2039951,2047374,-,7423
251,BUMA.1121.00023,1,3814167,3821565,-,7398
251,BUMA.1121.00024,1,1797791,1805127,-,7336
251,BUMA.1121.00033,1,3661894,3669259,-,7365
251,BUMA.1121.00034,1,1835274,1842610,-,7336
251,BUMA.1121.00036,1,2308382,2315725,+,7343
251,BUMA.1121.00032,1,3328254,3335590,-,7336
251,BUMA.1121.00009,1,188217,195662,+,7445
251,BUMA.1121.00008,1,1810862,1818198,-,7336
251,BUMA.1121.00003,1,3869339,3876716,-,7377
251,BUMA.1121.00053,1,1124942,1132384,-,7442
251,BUMA.1121.00110,1,3393592,3401053,+,7461
251,BUMA.1121.00104,1,3842286,3849704,+,7418
251,BUMA.1121.00086,1,484243,491579,-,7336
251,BUMA.1121.00092,1,2473185,2480506,+,7321
251,BUMA.1121.00096,1,1870026,1877429,+,7403
251,BUMA.1121.00054,1,968485,975835,-,7350
251,BUMA.1121.00097,1,2606106,2613524,+,7418
251,BUMA.1121.00093,1,2145830,2153151,-,7321
251,BUMA.1121.00106,1,1140883,1148282,-,7399
251,BUMA.1121.00010,1,2919844,2927164,-,7320
251,BUMA.1121.00035,1,2554312,2561706,-,7394
251,BUMA.1121.00108,1,2373648,2381070,-,7422
251,BUMA.1121.00028,1,1797838,1805174,-,7336
251,BUMA.1121.00094,1,1418703,1426073,-,7370
251,BUMA.1121.00102,1,4008626,4015991,+,7365
251,BUMA.1121.00111,1,1550833,1558220,-,7387
251,BUMA.1121.00089,1,1387336,1394713,-,7377
251,BUMA.1121.00084,1,1626118,1633512,-,7394
251,BUMA.1121.00029,1,3522813,3530199,+,7386
251,BUMA.1121.00012,1,26635,34018,-,7383
251,BUMA.1121.00087,1,2825178,2832514,+,7336
251,BUMA.1121.00043,1,1455530,1462905,-,7375
251,BUMA.1121.00046,1,2302233,2309562,-,7329
251,BUMA.1121.00037,1,23534,30905,-,7371
251,BUMA.1121.00080,1,1417332,1424694,-,7362
251,BUMA.1121.00079,1,1412553,1419921,-,7368
251,BUMA.1121.00045,1,2651288,2658686,+,7398
251,BUMA.1121.00071,1,1372719,1380046,-,7327
251,BUMA.1121.00056,1,2531187,2538563,+,7376
251,BUMA.1121.00065,1,1499413,1506845,-,7432
251,BUMA.1121.00058,1,3159702,3167104,+,7402
251,BUMA.1121.00007,1,2712724,2720149,+,7425
251,BUMA.1121.00067,1,3015836,3023268,+,7432
251,BUMA.1121.00090,1,3554682,3562039,-,7357
251,BUMA.1121.00051,1,1390136,1397519,-,7383
251,BUMA.1121.00020,1,1862671,1870007,-,7336
251,BUMA.1121.00103,1,3006377,3013721,+,7344
251,BUMA.1121.00048,1,2959953,2967303,+,7350
251,BUMA.1121.00047,1,1552852,1560248,+,7396
251,BUMA.1121.00042,1,2558149,2565485,+,7336
251,BUMA.1121.00055,1,986339,993695,-,7356
251,BUMA.1121.00031,1,2833931,2841292,-,7361
251,BUMA.1121.00040,1,1726895,1734237,-,7342
251,BUMA.1121.00044,1,1063400,1070736,-,7336
251,BUMA.1121.00088,1,2296705,2304092,-,7387
251,BUMA.1121.00069,1,1335844,1343180,-,7336
251,BUMA.1121.00064,1,1406316,1413725,-,7409
251,BUMA.1121.00105,1,3830143,3837514,+,7371
251,BUMA.1121.00015,1,2792221,2799540,-,7319
251,BUMA.1121.00059,1,608549,615947,-,7398
251,BUMA.1121.00026,1,147654,155039,+,7385
251,BUMA.1121.00022,1,2133687,2141016,-,7329
251,BUMA.1121.00052,1,1596328,1603697,-,7369
251,BUMA.1121.00101,1,1086120,1093512,+,7392
251,BUMA.1121.00001,1,2648712,2656126,+,7414
251,BUMA.1121.00038,1,3167269,3174619,+,7350
251,BUMA.1121.00068,1,142086,149542,-,7456
251,BUMA.1121.00099,1,986664,994082,+,7418
251,BUMA.1121.00091,1,3146192,3153566,+,7374
251,BUMA.1121.00098,1,4164115,4171557,-,7442
251,BUMA.1121.00013,1,1797309,1804664,-,7355
251,BUMA.1121.00049,1,477283,484667,+,7384
251,BUMA.1121.00072,1,1355308,1362621,-,7313
251,BUMA.1121.00076,1,3910916,3918298,+,7382
251,BUMA.1121.00083,1,184196,191542,+,7346
251,BUMA.1121.00078,1,553721,561079,+,7358
251,BUMA.1121.00095,1,277999,285441,+,7442
251,BUMA.1121.00077,1,81718,89179,-,7461
251,BUMA.1121.00063,1,1379756,1387092,-,7336
251,BUMA.1121.00061,1,1382683,1390016,-,7333
251,BUMA.1121.00050,1,442152,449481,+,7329
251,BUMA.1121.00081,1,3167454,3174804,+,7350
251,BUMA.1121.00074,1,2446586,2453990,+,7404
251,BUMA.1121.00062,1,3169310,3176710,+,7400
251,BUMA.1121.00060,1,877029,884427,+,7398
251,BUMA.1121.00070,1,1353655,1360995,-,7340
251,BUMA.1121.00075,1,894659,902040,-,7381
251,BUMA.1121.00041,1,2704564,2711947,-,7383
251,BUMA.1121.00073,1,1380884,1388224,-,7340
251,BUMA.1121.00017,1,1732924,1740260,-,7336
251,BUMA.1121.00066,1,1356807,1364143,-,7336
251,BUMA.1121.00107,1,1302769,1310143,-,7374
251,BUMA.1121.00085,1,1193273,1200642,-,7369
251,BUMA.1121.00030,1,1732980,1740316,-,7336
251,BUMA.1121.00112,1,1652429,1659882,+,7453
251,BUMA.1121.00002,1,2942121,2949441,-,7320
251,BUMA.1121.00082,1,1513269,1520615,-,7346
251,BUMA.1121.00014,1,1375644,1383026,+,7382
251,BUMA.1121.00011,1,185675,193181,+,7506
251,BUMA.1121.00019,1,1797916,1805252,-,7336
251,BUMA.1121.00057,1,2481157,2488540,-,7383
251,BUMA.1121.00018,1,1993826,2001211,-,7385
251,BUMA.1121.00039,1,1536212,1544889,-,8677
251,BUMA.1121.00016,1,3559521,3566895,-,7374
251,BUMA.1121.00004,1,1799066,1806402,-,7336
251,BUMA.1121.00005,1,79911,87242,-,7331
251,BUMA.1121.00100,1,3925375,3932766,+,7391
251,BUMA.1121.00006,1,3167346,3174696,+,7350
250,BUMA.1121.00110,2,2736846,2742388,+,5542
250,BUMA.1121.00077,2,873524,879064,-,5540
250,BUMA.1121.00027,2,679737,685279,+,5542
250,BUMA.1121.00023,2,2911819,2917361,+,5542
250,BUMA.1121.00031,2,1956717,1962259,+,5542
250,BUMA.1121.00097,2,2607507,2613049,+,5542
250,BUMA.1121.00005,2,1149439,1154981,-,5542
250,BUMA.1121.00066,2,2732281,2737823,+,5542
250,BUMA.1121.00095,2,1639512,1645054,+,5542
250,BUMA.1121.00112,2,1588119,1593661,-,5542
250,BUMA.1121.00090,2,516830,522372,+,5542
250,BUMA.1121.00045,2,2658463,2664006,+,5543
250,BUMA.1121.00063,2,2741675,2747217,+,5542
250,BUMA.1121.00071,2,2748480,2754022,+,5542
250,BUMA.1121.00091,2,859170,864712,-,5542
250,BUMA.1121.00039,2,1186449,1191991,-,5542
250,BUMA.1121.00053,2,3057109,3062651,+,5542
250,BUMA.1121.00057,2,2466060,2471602,-,5542
250,BUMA.1121.00014,2,2891461,2896991,+,5530
250,BUMA.1121.00098,2,3028021,3033563,+,5542
250,BUMA.1121.00078,2,357657,363199,-,5542
250,BUMA.1121.00099,2,3022745,3028287,+,5542
250,BUMA.1121.00103,2,1435685,1441227,+,5542
250,BUMA.1121.00102,2,2804859,2810401,+,5542
250,BUMA.1121.00073,2,2748517,2754059,+,5542
250,BUMA.1121.00083,2,1424208,1429750,+,5542
250,BUMA.1121.00072,2,2725397,2730939,+,5542
250,BUMA.1121.00061,2,2731545,2737087,+,5542
250,BUMA.1121.00060,2,2601089,2606632,-,5543
250,BUMA.1121.00070,2,2727844,2733386,+,5542
250,BUMA.1121.00065,2,2849259,2854801,+,5542
250,BUMA.1121.00041,2,502908,508450,+,5542
250,BUMA.1121.00096,2,3088449,3093991,+,5542
250,BUMA.1121.00082,2,2800292,2805834,+,5542
249,BUMA.1121.00110,2,2732942,2736844,+,3902
249,BUMA.1121.00077,2,879065,882968,-,3903
249,BUMA.1121.00027,2,675837,679735,+,3898
249,BUMA.1121.00023,2,2907920,2911817,+,3897
249,BUMA.1121.00031,2,1952818,1956715,+,3897
249,BUMA.1121.00097,2,2603607,2607505,+,3898
249,BUMA.1121.00005,2,1154982,1158880,-,3898
249,BUMA.1121.00066,2,2728381,2732279,+,3898
249,BUMA.1121.00095,2,1635612,1639510,+,3898
249,BUMA.1121.00112,2,1593662,1597560,-,3898
249,BUMA.1121.00090,2,512931,516828,+,3897
249,BUMA.1121.00045,2,2654563,2658461,+,3898
249,BUMA.1121.00063,2,2737775,2741673,+,3898
249,BUMA.1121.00071,2,2744580,2748478,+,3898
249,BUMA.1121.00091,2,864713,868612,-,3899
249,BUMA.1121.00039,2,1191992,1195890,-,3898
249,BUMA.1121.00053,2,3053212,3057107,+,3895
249,BUMA.1121.00057,2,2471603,2475502,-,3899
249,BUMA.1121.00014,2,2886279,2890191,+,3912
249,BUMA.1121.00098,2,3024131,3028019,+,3888
249,BUMA.1121.00078,2,363200,367103,-,3903
249,BUMA.1121.00099,2,3018846,3022743,+,3897
249,BUMA.1121.00103,2,1431785,1435683,+,3898
249,BUMA.1121.00102,2,2800958,2804857,+,3899
249,BUMA.1121.00073,2,2744617,2748515,+,3898
249,BUMA.1121.00083,2,1420308,1424206,+,3898
249,BUMA.1121.00072,2,2721497,2725395,+,3898
249,BUMA.1121.00061,2,2727645,2731543,+,3898
249,BUMA.1121.00060,2,2606633,2610532,-,3899
249,BUMA.1121.00070,2,2723944,2727842,+,3898
249,BUMA.1121.00065,2,2845359,2849257,+,3898
249,BUMA.1121.00041,2,499004,502906,+,3902
249,BUMA.1121.00096,2,3084549,3088447,+,3898
249,BUMA.1121.00082,2,2796392,2800290,+,3898
248,BUMA.1121.00110,2,2204029,2210806,+,6777
248,BUMA.1121.00077,2,1405274,1412050,-,6776
247,BUMA.1121.00110,2,2188490,2198791,+,10301
247,BUMA.1121.00077,2,1417288,1427589,-,10301
246,BUMA.1121.00110,2,2168551,2179289,+,10738
246,BUMA.1121.00077,2,1436793,1447531,-,10738
246,BUMA.1121.00027,2,122827,133779,+,10952
246,BUMA.1121.00067,2,1715193,1726321,-,11128
246,BUMA.1121.00080,2,2259578,2270785,+,11207
245,BUMA.1121.00110,2,2154099,2165424,+,11325
245,BUMA.1121.00077,2,1450658,1461982,-,11324
245,BUMA.1121.00027,2,108966,119800,+,10834
245,BUMA.1121.00067,2,1729348,1740182,-,10834
245,BUMA.1121.00080,2,2245915,2256750,+,10835
244,BUMA.1121.00110,2,1437119,1448656,+,11537
244,BUMA.1121.00077,2,2730997,2742533,+,11536
244,BUMA.1121.00021,2,1460628,1472166,-,11538
244,BUMA.1121.00023,2,1037379,1048917,-,11538
244,BUMA.1121.00031,2,133746,145284,-,11538
244,BUMA.1121.00097,2,792247,803785,-,11538
244,BUMA.1121.00005,2,2381865,2393403,-,11538
244,BUMA.1121.00111,2,217548,229070,-,11522
244,BUMA.1121.00095,2,327801,339338,+,11537
244,BUMA.1121.00112,2,158377,169914,+,11537
244,BUMA.1121.00090,2,1932425,1943963,-,11538
244,BUMA.1121.00001,2,1254777,1266314,+,11537
244,BUMA.1121.00045,2,833786,845324,-,11538
244,BUMA.1121.00043,2,1414178,1425715,+,11537
244,BUMA.1121.00091,2,2672925,2684462,+,11537
244,BUMA.1121.00107,2,2892236,2903773,+,11537
244,BUMA.1121.00016,2,2752038,2763575,+,11537
244,BUMA.1121.00053,2,1229652,1241190,-,11538
244,BUMA.1121.00014,2,1067052,1078590,-,11538
244,BUMA.1121.00098,2,1199788,1211326,-,11538
244,BUMA.1121.00078,2,2216997,2228534,+,11537
244,BUMA.1121.00029,2,366385,379276,+,12891
244,BUMA.1121.00099,2,1204883,1216421,-,11538
244,BUMA.1121.00103,2,2857812,2869350,-,11538
244,BUMA.1121.00102,2,991421,1002959,-,11538
244,BUMA.1121.00035,2,344932,356469,+,11537
244,BUMA.1121.00033,2,1681818,1693340,-,11522
244,BUMA.1121.00060,2,1248541,1260078,+,11537
244,BUMA.1121.00037,2,1304802,1316340,-,11538
244,BUMA.1121.00065,2,989173,1000710,-,11537
244,BUMA.1121.00041,2,1885563,1897101,-,11538
244,BUMA.1121.00096,2,1158101,1169638,-,11537
244,BUMA.1121.00012,2,750460,761997,+,11537
243,BUMA.1121.00110,2,1430239,1436663,+,6424
243,BUMA.1121.00077,2,2724117,2730541,+,6424
243,BUMA.1121.00021,2,1472612,1479046,-,6434
243,BUMA.1121.00023,2,1049373,1055797,-,6424
243,BUMA.1121.00031,2,145740,152164,-,6424
243,BUMA.1121.00097,2,804241,810665,-,6424
243,BUMA.1121.00005,2,2393859,2400283,-,6424
243,BUMA.1121.00111,2,230371,236805,-,6434
243,BUMA.1121.00095,2,320921,327345,+,6424
243,BUMA.1121.00112,2,151497,157921,+,6424
243,BUMA.1121.00090,2,1944409,1950843,-,6434
243,BUMA.1121.00001,2,1247898,1254321,+,6423
243,BUMA.1121.00045,2,845780,852204,-,6424
243,BUMA.1121.00043,2,1407298,1413732,+,6434
243,BUMA.1121.00091,2,2666045,2672469,+,6424
243,BUMA.1121.00107,2,2885356,2891780,+,6424
243,BUMA.1121.00016,2,2745159,2751592,+,6433
243,BUMA.1121.00053,2,1241646,1248070,-,6424
243,BUMA.1121.00014,2,1079046,1085469,-,6423
243,BUMA.1121.00098,2,1211782,1218206,-,6424
243,BUMA.1121.00078,2,2210117,2216541,+,6424
243,BUMA.1121.00029,2,359506,365929,+,6423
243,BUMA.1121.00099,2,1216877,1223301,-,6424
243,BUMA.1121.00103,2,2869806,2876230,-,6424
243,BUMA.1121.00102,2,1003405,1009839,-,6434
243,BUMA.1121.00035,2,338052,344476,+,6424
243,BUMA.1121.00033,2,1693786,1700220,-,6434
243,BUMA.1121.00060,2,1241661,1248085,+,6424
243,BUMA.1121.00037,2,1316786,1323220,-,6434
243,BUMA.1121.00065,2,1001166,1007590,-,6424
243,BUMA.1121.00041,2,1897557,1903981,-,6424
243,BUMA.1121.00096,2,1170094,1176518,-,6424
243,BUMA.1121.00012,2,743580,750014,+,6434
242,BUMA.1121.00110,2,1420640,1427263,+,6623
242,BUMA.1121.00077,2,2714518,2721141,+,6623
242,BUMA.1121.00021,2,1482028,1488651,-,6623
242,BUMA.1121.00023,2,1058779,1065402,-,6623
242,BUMA.1121.00031,2,155146,161769,-,6623
242,BUMA.1121.00097,2,813646,820269,-,6623
242,BUMA.1121.00111,2,239781,246404,-,6623
242,BUMA.1121.00095,2,311321,317944,+,6623
242,BUMA.1121.00112,2,141891,148514,+,6623
242,BUMA.1121.00090,2,1953825,1960448,-,6623
242,BUMA.1121.00001,2,1238292,1244915,+,6623
242,BUMA.1121.00045,2,855185,861806,-,6621
242,BUMA.1121.00043,2,1397692,1404315,+,6623
242,BUMA.1121.00091,2,2656446,2663069,+,6623
242,BUMA.1121.00107,2,2875751,2882373,+,6622
242,BUMA.1121.00016,2,2735553,2742176,+,6623
242,BUMA.1121.00053,2,1251046,1257669,-,6623
242,BUMA.1121.00014,2,1088451,1095074,-,6623
242,BUMA.1121.00098,2,1221187,1227808,-,6621
242,BUMA.1121.00078,2,2200519,2207142,+,6623
242,BUMA.1121.00029,2,349900,356523,+,6623
242,BUMA.1121.00099,2,1226282,1232903,-,6621
242,BUMA.1121.00103,2,2879205,2885828,-,6623
242,BUMA.1121.00102,2,1014155,1020778,-,6623
242,BUMA.1121.00035,2,328446,335069,+,6623
242,BUMA.1121.00033,2,1703202,1709825,-,6623
242,BUMA.1121.00060,2,1232058,1238679,+,6621
242,BUMA.1121.00037,2,1326202,1332825,-,6623
242,BUMA.1121.00065,2,1010565,1017188,-,6623
242,BUMA.1121.00041,2,1906957,1913580,-,6623
242,BUMA.1121.00096,2,1179493,1186116,-,6623
242,BUMA.1121.00012,2,733974,740597,+,6623
241,BUMA.1121.00110,2,1417342,1420639,+,3297
241,BUMA.1121.00077,2,2711221,2714517,+,3296
241,BUMA.1121.00021,2,1488653,1491949,-,3296
241,BUMA.1121.00023,2,1065404,1068700,-,3296
241,BUMA.1121.00031,2,161771,165067,-,3296
241,BUMA.1121.00097,2,820271,823567,-,3296
241,BUMA.1121.00005,2,2404299,2407581,-,3282
241,BUMA.1121.00111,2,246406,249702,-,3296
241,BUMA.1121.00095,2,308023,311320,+,3297
241,BUMA.1121.00112,2,138593,141890,+,3297
241,BUMA.1121.00090,2,1960450,1963746,-,3296
241,BUMA.1121.00001,2,1234994,1238291,+,3297
241,BUMA.1121.00045,2,861808,865102,-,3294
241,BUMA.1121.00043,2,1394394,1397691,+,3297
241,BUMA.1121.00091,2,2653148,2656445,+,3297
241,BUMA.1121.00107,2,2872453,2875750,+,3297
241,BUMA.1121.00016,2,2732255,2735552,+,3297
241,BUMA.1121.00053,2,1257671,1260967,-,3296
241,BUMA.1121.00014,2,1095076,1098371,-,3295
241,BUMA.1121.00098,2,1227810,1231104,-,3294
241,BUMA.1121.00078,2,2197222,2200518,+,3296
241,BUMA.1121.00029,2,346602,349899,+,3297
241,BUMA.1121.00099,2,1232905,1236201,-,3296
241,BUMA.1121.00103,2,2885830,2889126,-,3296
241,BUMA.1121.00102,2,1020780,1024076,-,3296
241,BUMA.1121.00035,2,325148,328445,+,3297
241,BUMA.1121.00033,2,1709827,1713123,-,3296
241,BUMA.1121.00060,2,1228762,1232057,+,3295
241,BUMA.1121.00037,2,1332827,1336123,-,3296
241,BUMA.1121.00065,2,1017190,1020486,-,3296
241,BUMA.1121.00041,2,1913582,1916877,-,3295
241,BUMA.1121.00096,2,1186118,1189414,-,3296
241,BUMA.1121.00012,2,730676,733973,+,3297
240,BUMA.1121.00110,2,1413072,1417341,+,4269
240,BUMA.1121.00077,2,2706951,2711220,+,4269
240,BUMA.1121.00021,2,1491951,1496220,-,4269
240,BUMA.1121.00023,2,1070001,1074261,-,4260
240,BUMA.1121.00031,2,165069,169335,-,4266
240,BUMA.1121.00097,2,823569,827838,-,4269
240,BUMA.1121.00005,2,2407583,2411852,-,4269
240,BUMA.1121.00111,2,249704,253973,-,4269
240,BUMA.1121.00095,2,303753,308022,+,4269
240,BUMA.1121.00112,2,134323,138592,+,4269
240,BUMA.1121.00090,2,1963748,1968017,-,4269
240,BUMA.1121.00001,2,1230726,1234993,+,4267
240,BUMA.1121.00045,2,865104,869375,-,4271
240,BUMA.1121.00043,2,1390124,1394393,+,4269
240,BUMA.1121.00091,2,2648879,2653147,+,4268
240,BUMA.1121.00107,2,2868183,2872452,+,4269
240,BUMA.1121.00016,2,2727986,2732254,+,4268
240,BUMA.1121.00053,2,1260969,1265238,-,4269
240,BUMA.1121.00014,2,1098373,1102638,-,4265
240,BUMA.1121.00098,2,1231106,1235375,-,4269
240,BUMA.1121.00078,2,2192952,2197221,+,4269
240,BUMA.1121.00029,2,342333,346601,+,4268
240,BUMA.1121.00099,2,1236203,1240472,-,4269
240,BUMA.1121.00103,2,2889128,2893397,-,4269
240,BUMA.1121.00102,2,1024078,1028347,-,4269
240,BUMA.1121.00035,2,320878,325147,+,4269
240,BUMA.1121.00033,2,1713125,1717391,-,4266
240,BUMA.1121.00060,2,1224490,1228761,+,4271
240,BUMA.1121.00037,2,1336125,1340391,-,4266
240,BUMA.1121.00065,2,1020488,1024756,-,4268
240,BUMA.1121.00041,2,1916879,1921148,-,4269
240,BUMA.1121.00096,2,1189416,1193686,-,4270
240,BUMA.1121.00012,2,725071,730675,+,5604
239,BUMA.1121.00110,2,1399241,1407230,+,7989
239,BUMA.1121.00077,2,2693121,2701109,+,7988
239,BUMA.1121.00021,2,1502061,1510050,-,7989
239,BUMA.1121.00023,2,1076837,1086161,-,9324
239,BUMA.1121.00031,2,175176,183165,-,7989
239,BUMA.1121.00097,2,833679,841670,-,7991
239,BUMA.1121.00005,2,2417693,2425683,-,7990
239,BUMA.1121.00111,2,259814,267803,-,7989
239,BUMA.1121.00095,2,289920,297911,+,7991
239,BUMA.1121.00112,2,120492,128481,+,7989
239,BUMA.1121.00090,2,1973858,1981848,-,7990
239,BUMA.1121.00001,2,1216894,1224884,+,7990
239,BUMA.1121.00045,2,875216,883206,-,7990
239,BUMA.1121.00043,2,1376292,1384282,+,7990
239,BUMA.1121.00091,2,2635048,2643037,+,7989
239,BUMA.1121.00107,2,2854350,2862341,+,7991
239,BUMA.1121.00016,2,2714154,2722144,+,7990
239,BUMA.1121.00053,2,1271079,1279069,-,7990
239,BUMA.1121.00014,2,1108479,1116469,-,7990
239,BUMA.1121.00098,2,1241216,1249197,-,7981
239,BUMA.1121.00078,2,2179120,2187110,+,7990
239,BUMA.1121.00029,2,328501,336491,+,7990
239,BUMA.1121.00099,2,1246313,1254294,-,7981
239,BUMA.1121.00103,2,2899238,2907229,-,7991
239,BUMA.1121.00102,2,1034188,1042182,-,7994
239,BUMA.1121.00035,2,307046,315036,+,7990
239,BUMA.1121.00033,2,1723231,1731220,-,7989
239,BUMA.1121.00060,2,1210658,1218648,+,7990
239,BUMA.1121.00037,2,1346232,1354222,-,7990
239,BUMA.1121.00065,2,1030597,1038591,-,7994
239,BUMA.1121.00041,2,1926990,1934979,-,7989
239,BUMA.1121.00096,2,1199527,1207516,-,7989
239,BUMA.1121.00012,2,711239,719229,+,7990
238,BUMA.1121.00110,2,401588,406587,+,4999
238,BUMA.1121.00077,2,3210009,3215007,-,4998
238,BUMA.1121.00027,2,1584649,1589178,+,4529
238,BUMA.1121.00057,2,1559217,1563748,-,4531
238,BUMA.1121.00083,2,2329933,2334465,+,4532
238,BUMA.1121.00041,2,1424760,1429317,+,4557
238,BUMA.1121.00082,2,532976,537508,+,4532
237,BUMA.1121.00110,2,396441,401120,+,4679
237,BUMA.1121.00077,2,3215475,3220154,-,4679
237,BUMA.1121.00027,2,1579505,1584181,+,4676
237,BUMA.1121.00057,2,1564216,1568895,-,4679
237,BUMA.1121.00083,2,2324786,2329465,+,4679
237,BUMA.1121.00082,2,527829,532508,+,4679
236,BUMA.1121.00011,2,2396631,2399735,+,3104
236,BUMA.1121.00009,2,2427073,2430177,+,3104
235,BUMA.1121.00011,2,2350834,2354522,+,3688
235,BUMA.1121.00092,1,2373461,2377151,-,3690
235,BUMA.1121.00097,1,2507783,2511473,-,3690
235,BUMA.1121.00093,1,2249168,2252858,+,3690
235,BUMA.1121.00009,2,2380457,2384145,+,3688
235,BUMA.1121.00101,2,2925601,2929291,-,3690
235,BUMA.1121.00084,1,1776353,1780043,+,3690
235,BUMA.1121.00007,1,2613540,2617230,-,3690
235,BUMA.1121.00098,1,37626,41316,+,3690
235,BUMA.1121.00096,2,2079330,2083020,-,3690
234,BUMA.1121.00011,2,1970299,1976929,+,6630
234,BUMA.1121.00097,2,3194271,3200902,+,6631
234,BUMA.1121.00009,2,1999869,2006500,+,6631
234,BUMA.1121.00101,2,55788,62418,-,6630
234,BUMA.1121.00095,2,2211140,2217770,+,6630
234,BUMA.1121.00045,2,1,6632,+,6631
234,BUMA.1121.00003,2,1533954,1540583,+,6629
234,BUMA.1121.00108,2,391040,397670,+,6630
234,BUMA.1121.00103,2,2023869,2030501,+,6632
234,BUMA.1121.00060,2,1999847,2006478,-,6631
234,BUMA.1121.00058,2,715641,722271,+,6630
234,BUMA.1121.00096,2,312389,319021,+,6632
233,BUMA.1121.00011,2,1919204,1970298,+,51094
233,BUMA.1121.00097,2,3143200,3194270,+,51070
233,BUMA.1121.00009,2,1948792,1999868,+,51076
233,BUMA.1121.00101,2,62420,113493,-,51073
233,BUMA.1121.00095,2,2160074,2211139,+,51065
233,BUMA.1121.00045,2,3207693,3258775,+,51082
233,BUMA.1121.00003,2,1482887,1533953,+,51066
233,BUMA.1121.00108,2,339958,391039,+,51081
233,BUMA.1121.00103,2,1972785,2023868,+,51083
233,BUMA.1121.00060,2,2006480,2057561,-,51081
233,BUMA.1121.00058,2,664578,715640,+,51062
233,BUMA.1121.00096,2,261312,312388,+,51076
232,BUMA.1121.00011,2,1848273,1856497,+,8224
232,BUMA.1121.00110,2,3205091,3213326,+,8235
232,BUMA.1121.00077,2,402317,410552,-,8235
232,BUMA.1121.00027,2,1131279,1139514,+,8235
232,BUMA.1121.00023,2,133617,141852,+,8235
232,BUMA.1121.00005,2,671161,679396,-,8235
232,BUMA.1121.00009,2,1877961,1886197,+,8236
232,BUMA.1121.00101,2,176091,184327,-,8236
232,BUMA.1121.00066,2,79720,86645,+,6925
232,BUMA.1121.00095,2,2089096,2097329,+,8233
232,BUMA.1121.00090,2,981124,989359,+,8235
232,BUMA.1121.00001,2,2175504,2183739,-,8235
232,BUMA.1121.00003,2,1411724,1419960,+,8236
232,BUMA.1121.00053,2,305765,314000,+,8235
232,BUMA.1121.00057,2,2010363,2018598,-,8235
232,BUMA.1121.00078,2,3141194,3149429,-,8235
232,BUMA.1121.00029,2,1287473,1295708,-,8235
232,BUMA.1121.00073,2,79834,88069,+,8235
232,BUMA.1121.00083,2,1876807,1885042,+,8235
232,BUMA.1121.00035,2,1371026,1379261,-,8235
232,BUMA.1121.00033,2,740180,749750,+,9570
232,BUMA.1121.00069,2,79850,88085,+,8235
232,BUMA.1121.00070,2,79827,88062,+,8235
232,BUMA.1121.00068,2,1798745,1806971,+,8226
232,BUMA.1121.00065,2,79742,87977,+,8235
232,BUMA.1121.00041,2,969478,977713,+,8235
232,BUMA.1121.00100,2,1244822,1253048,+,8226
232,BUMA.1121.00012,2,1742541,1750776,-,8235
232,BUMA.1121.00082,2,79864,88099,+,8235
231,BUMA.1121.00055,2,2636138,2640793,+,4655
231,BUMA.1121.00011,2,1810907,1815562,-,4655
231,BUMA.1121.00021,2,505394,510049,-,4655
231,BUMA.1121.00023,2,95022,99677,-,4655
231,BUMA.1121.00025,2,1664502,1669157,-,4655
231,BUMA.1121.00031,2,2381244,2385899,-,4655
231,BUMA.1121.00007,2,53729,58384,-,4655
231,BUMA.1121.00005,2,712040,716695,+,4655
231,BUMA.1121.00111,2,2483598,2488253,-,4655
231,BUMA.1121.00101,2,216948,221603,+,4655
231,BUMA.1121.00090,2,943771,948426,-,4655
231,BUMA.1121.00001,2,2216427,2221081,+,4654
231,BUMA.1121.00043,2,2402970,2407619,+,4649
231,BUMA.1121.00039,2,763431,768086,+,4655
231,BUMA.1121.00016,2,558702,563355,+,4653
231,BUMA.1121.00105,2,2459887,2464542,+,4655
231,BUMA.1121.00014,2,47777,52431,-,4654
231,BUMA.1121.00078,2,3182026,3186681,+,4655
231,BUMA.1121.00029,2,1328403,1333057,+,4654
231,BUMA.1121.00035,2,1411952,1416607,+,4655
231,BUMA.1121.00033,2,702911,707564,-,4653
231,BUMA.1121.00037,2,295125,299774,-,4649
231,BUMA.1121.00012,2,1783467,1788122,+,4655
231,BUMA.1121.00018,2,663884,668538,+,4654
230,BUMA.1121.00049,2,3134802,3158067,+,23265
230,BUMA.1121.00055,2,1328856,1352198,-,23342
230,BUMA.1121.00011,2,3198777,3222344,+,23567
230,BUMA.1121.00110,2,1058106,1081524,-,23418
230,BUMA.1121.00109,2,69373,92867,-,23494
230,BUMA.1121.00077,2,2351760,2375178,-,23418
230,BUMA.1121.00027,2,2376993,2400521,+,23528
230,BUMA.1121.00021,2,1840963,1864289,+,23326
230,BUMA.1121.00023,2,1415631,1438970,+,23339
230,BUMA.1121.00022,2,250778,274193,+,23415
230,BUMA.1121.00034,2,741386,764753,+,23367
230,BUMA.1121.00025,2,2792135,2815609,-,23474
230,BUMA.1121.00031,2,511846,535190,+,23344
230,BUMA.1121.00007,2,1360746,1384335,+,23589
230,BUMA.1121.00097,2,1168042,1191592,+,23550
230,BUMA.1121.00059,2,2316332,2339648,-,23316
230,BUMA.1121.00002,2,1292736,1316115,+,23379
230,BUMA.1121.00005,2,2752635,2776027,+,23392
230,BUMA.1121.00111,2,596023,619401,+,23378
230,BUMA.1121.00006,2,1016113,1039450,+,23337
230,BUMA.1121.00009,2,3221402,3245027,+,23625
230,BUMA.1121.00094,2,1363695,1387023,+,23328
230,BUMA.1121.00101,2,2069958,2093304,-,23346
230,BUMA.1121.00066,2,1300822,1324287,+,23465
230,BUMA.1121.00095,2,3290611,3314118,-,23507
230,BUMA.1121.00112,2,3047017,3070414,-,23397
230,BUMA.1121.00042,2,857504,880823,-,23319
230,BUMA.1121.00032,2,1234009,1257352,+,23343
230,BUMA.1121.00090,2,2308508,2331968,+,23460
230,BUMA.1121.00089,2,1308550,1331821,+,23271
230,BUMA.1121.00051,2,1320644,1343930,+,23286
230,BUMA.1121.00001,2,866100,889399,-,23299
230,BUMA.1121.00045,2,1210397,1233869,+,23472
230,BUMA.1121.00043,2,1025058,1048403,-,23345
230,BUMA.1121.00063,2,1294099,1317563,+,23464
230,BUMA.1121.00079,2,1321073,1344450,+,23377
230,BUMA.1121.00071,2,1294646,1318139,+,23493
230,BUMA.1121.00086,2,1058180,1081586,+,23406
230,BUMA.1121.00024,2,861347,884714,+,23367
230,BUMA.1121.00010,2,51624,75003,+,23379
230,BUMA.1121.00040,2,1067289,1090626,+,23337
230,BUMA.1121.00093,2,1589505,1613028,-,23523
230,BUMA.1121.00091,2,2283531,2306940,-,23409
230,BUMA.1121.00107,2,2503672,2527158,-,23486
230,BUMA.1121.00088,2,1262382,1285769,+,23387
230,BUMA.1121.00047,2,2250451,2273818,+,23367
230,BUMA.1121.00087,2,1325677,1349083,+,23406
230,BUMA.1121.00039,2,2612766,2636125,-,23359
230,BUMA.1121.00030,2,1357034,1380401,-,23367
230,BUMA.1121.00016,2,2362245,2385570,-,23325
230,BUMA.1121.00092,2,1332169,1355690,+,23521
230,BUMA.1121.00085,2,183258,206559,-,23301
230,BUMA.1121.00046,2,1769802,1793100,+,23298
230,BUMA.1121.00003,2,2570289,2593821,-,23532
230,BUMA.1121.00054,2,816238,839575,+,23337
230,BUMA.1121.00015,2,1164357,1187649,-,23292
230,BUMA.1121.00105,2,1180676,1204066,-,23390
230,BUMA.1121.00052,2,871824,895125,-,23301
230,BUMA.1121.00053,2,1608224,1631472,+,23248
230,BUMA.1121.00057,2,749504,772981,-,23477
230,BUMA.1121.00108,2,1547143,1570690,+,23547
230,BUMA.1121.00050,2,1385996,1409294,+,23298
230,BUMA.1121.00104,2,1413163,1436453,+,23290
230,BUMA.1121.00014,2,1445334,1468684,+,23350
230,BUMA.1121.00036,2,309961,333400,+,23439
230,BUMA.1121.00098,2,1575553,1599127,+,23574
230,BUMA.1121.00078,2,1797852,1821412,-,23560
230,BUMA.1121.00029,2,3244472,3267789,-,23317
230,BUMA.1121.00099,2,1577135,1600703,+,23568
230,BUMA.1121.00103,2,3237235,3260634,+,23399
230,BUMA.1121.00102,2,1371645,1394985,+,23340
230,BUMA.1121.00028,2,767483,790850,+,23367
230,BUMA.1121.00075,2,1613862,1637374,+,23512
230,BUMA.1121.00044,2,792499,815866,+,23367
230,BUMA.1121.00076,2,2207854,2231335,+,23481
230,BUMA.1121.00074,2,3020389,3043864,-,23475
230,BUMA.1121.00073,2,1295313,1318813,+,23500
230,BUMA.1121.00083,2,3122449,3145950,+,23501
230,BUMA.1121.00035,2,3261750,3285076,-,23326
230,BUMA.1121.00072,2,1291496,1314937,+,23441
230,BUMA.1121.00056,2,2662200,2685472,-,23272
230,BUMA.1121.00081,2,1284089,1307426,-,23337
230,BUMA.1121.00033,2,2059472,2082756,+,23284
230,BUMA.1121.00061,2,1284959,1308453,+,23494
230,BUMA.1121.00062,2,439798,463206,-,23408
230,BUMA.1121.00064,2,1234979,1258420,+,23441
230,BUMA.1121.00060,2,860097,883533,-,23436
230,BUMA.1121.00069,2,1292904,1316388,+,23484
230,BUMA.1121.00070,2,1295357,1318857,+,23500
230,BUMA.1121.00068,2,3028559,3052090,+,23531
230,BUMA.1121.00067,2,2634755,2658388,-,23633
230,BUMA.1121.00037,2,1680787,1704141,+,23354
230,BUMA.1121.00065,2,1366419,1389798,+,23379
230,BUMA.1121.00058,2,1868586,1892033,+,23447
230,BUMA.1121.00041,2,2262856,2286243,+,23387
230,BUMA.1121.00084,2,3148124,3171432,+,23308
230,BUMA.1121.00096,2,1534577,1557959,+,23382
230,BUMA.1121.00080,2,1321852,1345211,+,23359
230,BUMA.1121.00100,2,2424917,2448416,+,23499
230,BUMA.1121.00012,2,356997,380311,-,23314
230,BUMA.1121.00018,2,2458237,2481702,-,23465
230,BUMA.1121.00048,2,2023442,2046779,-,23337
230,BUMA.1121.00106,2,475343,498638,-,23295
230,BUMA.1121.00017,2,741358,764725,+,23367
230,BUMA.1121.00082,2,1325492,1348993,+,23501
229,BUMA.1121.00049,2,3118207,3129702,+,11495
229,BUMA.1121.00055,2,1355843,1367355,-,11512
229,BUMA.1121.00011,2,3183669,3195149,+,11480
229,BUMA.1121.00110,2,1085173,1096678,-,11505
229,BUMA.1121.00109,2,96494,107990,-,11496
229,BUMA.1121.00077,2,2378827,2390332,-,11505
229,BUMA.1121.00027,2,2361820,2373330,+,11510
229,BUMA.1121.00021,2,1825844,1837315,+,11471
229,BUMA.1121.00023,2,1400524,1411971,+,11447
229,BUMA.1121.00022,2,234418,245818,+,11400
229,BUMA.1121.00034,2,725011,736427,+,11416
229,BUMA.1121.00025,2,2819244,2830708,-,11464
229,BUMA.1121.00031,2,496755,508210,+,11455
229,BUMA.1121.00007,2,1345608,1357086,+,11478
229,BUMA.1121.00097,2,1152894,1164384,+,11490
229,BUMA.1121.00059,2,2343289,2354752,-,11463
229,BUMA.1121.00002,2,1276361,1287777,+,11416
229,BUMA.1121.00005,2,2737501,2748987,+,11486
229,BUMA.1121.00111,2,580937,592387,+,11450
229,BUMA.1121.00006,2,999701,1011154,+,11453
229,BUMA.1121.00009,2,3206287,3217758,+,11471
229,BUMA.1121.00094,2,1347119,1358598,+,11479
229,BUMA.1121.00101,2,2096949,2108444,-,11495
229,BUMA.1121.00066,2,1285714,1297161,+,11447
229,BUMA.1121.00095,2,3317775,3329255,-,11480
229,BUMA.1121.00112,2,3074047,3085503,-,11456
229,BUMA.1121.00042,2,884468,895938,-,11470
229,BUMA.1121.00032,2,1217634,1229050,+,11416
229,BUMA.1121.00090,2,2293425,2304872,+,11447
229,BUMA.1121.00089,2,1291974,1303453,+,11479
229,BUMA.1121.00051,2,1304101,1315547,+,11446
229,BUMA.1121.00001,2,893034,904485,-,11451
229,BUMA.1121.00045,2,1195290,1206729,+,11439
229,BUMA.1121.00043,2,1052038,1063488,-,11450
229,BUMA.1121.00063,2,1278990,1290437,+,11447
229,BUMA.1121.00079,2,1304531,1315976,+,11445
229,BUMA.1121.00071,2,1279548,1290985,+,11437
229,BUMA.1121.00086,2,1041813,1053221,+,11408
229,BUMA.1121.00024,2,844972,856388,+,11416
229,BUMA.1121.00010,2,35250,46666,+,11416
229,BUMA.1121.00040,2,1050907,1062330,+,11423
229,BUMA.1121.00093,2,1616675,1628270,-,11595
229,BUMA.1121.00091,2,2310585,2322000,-,11415
229,BUMA.1121.00107,2,2530791,2542255,-,11464
229,BUMA.1121.00088,2,1247232,1258746,+,11514
229,BUMA.1121.00047,2,2233907,2245354,+,11447
229,BUMA.1121.00087,2,1309310,1320718,+,11408
229,BUMA.1121.00039,2,2639760,2651208,-,11448
229,BUMA.1121.00030,2,1385359,1396776,-,11417
229,BUMA.1121.00016,2,2389184,2400623,-,11439
229,BUMA.1121.00092,2,1316927,1328521,+,11594
229,BUMA.1121.00085,2,211517,222947,-,11430
229,BUMA.1121.00046,2,1753398,1764843,+,11445
229,BUMA.1121.00003,2,2597458,2609001,-,11543
229,BUMA.1121.00054,2,799826,811279,+,11453
229,BUMA.1121.00015,2,1192607,1204053,-,11446
229,BUMA.1121.00105,2,1207725,1219189,-,11464
229,BUMA.1121.00052,2,900083,911512,-,11429
229,BUMA.1121.00053,2,1593112,1604578,+,11466
229,BUMA.1121.00057,2,776644,788092,-,11448
229,BUMA.1121.00108,2,1532016,1543487,+,11471
229,BUMA.1121.00050,2,1369592,1381037,+,11445
229,BUMA.1121.00104,2,1398036,1409517,+,11481
229,BUMA.1121.00014,2,1430243,1441698,+,11455
229,BUMA.1121.00036,2,293586,305002,+,11416
229,BUMA.1121.00098,2,1560436,1571883,+,11447
229,BUMA.1121.00078,2,1825057,1836510,-,11453
229,BUMA.1121.00029,2,3653,15103,-,11450
229,BUMA.1121.00099,2,1561974,1573485,+,11511
229,BUMA.1121.00103,2,3222076,3233579,+,11503
229,BUMA.1121.00102,2,1356448,1367999,+,11551
229,BUMA.1121.00028,2,751108,762524,+,11416
229,BUMA.1121.00075,2,1597327,1608769,+,11442
229,BUMA.1121.00044,2,776125,787540,+,11415
229,BUMA.1121.00076,2,2191313,2202755,+,11442
229,BUMA.1121.00074,2,3047499,3059050,-,11551
229,BUMA.1121.00073,2,1280205,1291652,+,11447
229,BUMA.1121.00083,2,3107338,3118785,+,11447
229,BUMA.1121.00035,2,3288711,3300162,-,11451
229,BUMA.1121.00072,2,1276386,1287833,+,11447
229,BUMA.1121.00056,2,2690568,2702048,-,11480
229,BUMA.1121.00081,2,1312384,1323838,-,11454
229,BUMA.1121.00033,2,2044396,2055836,+,11440
229,BUMA.1121.00061,2,1269849,1281296,+,11447
229,BUMA.1121.00062,2,466855,478382,-,11527
229,BUMA.1121.00064,2,1219868,1231331,+,11463
229,BUMA.1121.00060,2,887200,898639,-,11439
229,BUMA.1121.00069,2,1277794,1289241,+,11447
229,BUMA.1121.00070,2,1280249,1291696,+,11447
229,BUMA.1121.00068,2,3013453,3024909,+,11456
229,BUMA.1121.00067,2,2662059,2673570,-,11511
229,BUMA.1121.00037,2,1665704,1677151,+,11447
229,BUMA.1121.00065,2,1351294,1362773,+,11479
229,BUMA.1121.00058,2,1853374,1864944,+,11570
229,BUMA.1121.00041,2,2247734,2259208,+,11474
229,BUMA.1121.00084,2,3131557,3143028,+,11471
229,BUMA.1121.00096,2,1519428,1530911,+,11483
229,BUMA.1121.00080,2,1305309,1316755,+,11446
229,BUMA.1121.00100,2,2409780,2421259,+,11479
229,BUMA.1121.00012,2,383946,395394,-,11448
229,BUMA.1121.00018,2,2485337,2496801,-,11464
229,BUMA.1121.00048,2,2051734,2063188,-,11454
229,BUMA.1121.00106,2,503738,515201,-,11463
229,BUMA.1121.00017,2,724983,736399,+,11416
229,BUMA.1121.00082,2,1310381,1321828,+,11447
228,BUMA.1121.00049,2,3111779,3116042,+,4263
228,BUMA.1121.00055,2,1369541,1373804,-,4263
228,BUMA.1121.00011,2,3177222,3181485,+,4263
228,BUMA.1121.00110,2,1098868,1103122,-,4254
228,BUMA.1121.00109,2,110189,114452,-,4263
228,BUMA.1121.00077,2,2392522,2396776,-,4254
228,BUMA.1121.00027,2,2355371,2359632,+,4261
228,BUMA.1121.00026,2,1358320,1362563,+,4243
228,BUMA.1121.00021,2,1819405,1823668,+,4263
228,BUMA.1121.00023,2,1393176,1397439,+,4263
228,BUMA.1121.00022,2,226763,231006,+,4243
228,BUMA.1121.00034,2,717356,721599,+,4243
228,BUMA.1121.00025,2,2832884,2837147,-,4263
228,BUMA.1121.00031,2,490314,494568,+,4254
228,BUMA.1121.00007,2,1339155,1343418,+,4263
228,BUMA.1121.00097,2,1146452,1150715,+,4263
228,BUMA.1121.00008,2,807280,811523,+,4243
228,BUMA.1121.00059,2,2356918,2361179,-,4261
228,BUMA.1121.00002,2,1268699,1272942,+,4243
228,BUMA.1121.00004,2,808000,812243,+,4243
228,BUMA.1121.00005,2,2731059,2735322,+,4263
228,BUMA.1121.00111,2,574498,578761,+,4263
228,BUMA.1121.00006,2,992039,996282,+,4243
228,BUMA.1121.00009,2,3199843,3204097,+,4254
228,BUMA.1121.00094,2,1340661,1344913,+,4252
228,BUMA.1121.00101,2,2110633,2114905,-,4272
228,BUMA.1121.00066,2,1279268,1283520,+,4252
228,BUMA.1121.00095,2,3331442,3335704,-,4262
228,BUMA.1121.00112,2,3087728,3091982,-,4254
228,BUMA.1121.00042,2,899350,903593,-,4243
228,BUMA.1121.00032,2,1209979,1214222,+,4243
228,BUMA.1121.00090,2,2286986,2291249,+,4263
228,BUMA.1121.00020,2,808021,812264,+,4243
228,BUMA.1121.00089,2,1285518,1289770,+,4252
228,BUMA.1121.00051,2,1297659,1301911,+,4252
228,BUMA.1121.00001,2,906661,910915,-,4254
228,BUMA.1121.00045,2,1188844,1193107,+,4263
228,BUMA.1121.00043,2,1065664,1069928,-,4264
228,BUMA.1121.00063,2,1272819,1277071,+,4252
228,BUMA.1121.00079,2,1298096,1302348,+,4252
228,BUMA.1121.00071,2,1273122,1277374,+,4252
228,BUMA.1121.00086,2,1034158,1038401,+,4243
228,BUMA.1121.00024,2,743383,747623,+,4240
228,BUMA.1121.00024,2,837318,841560,+,4242
228,BUMA.1121.00010,2,27588,31831,+,4243
228,BUMA.1121.00040,2,1043257,1047488,+,4231
228,BUMA.1121.00093,2,1630458,1634721,-,4263
228,BUMA.1121.00091,2,2324177,2328439,-,4262
228,BUMA.1121.00107,2,2544450,2548713,-,4263
228,BUMA.1121.00088,2,1240806,1245067,+,4261
228,BUMA.1121.00047,2,2227465,2231717,+,4252
228,BUMA.1121.00019,2,807985,812228,+,4243
228,BUMA.1121.00087,2,1301655,1305898,+,4243
228,BUMA.1121.00039,2,2653384,2657647,-,4263
228,BUMA.1121.00030,2,1400188,1404431,-,4243
228,BUMA.1121.00016,2,2402811,2407074,-,4263
228,BUMA.1121.00092,2,1310476,1314739,+,4263
228,BUMA.1121.00085,2,226359,230602,-,4243
228,BUMA.1121.00046,2,1745736,1749979,+,4243
228,BUMA.1121.00003,2,2611198,2615452,-,4254
228,BUMA.1121.00054,2,792164,796407,+,4243
228,BUMA.1121.00015,2,1207472,1211715,-,4243
228,BUMA.1121.00105,2,1221380,1225641,-,4261
228,BUMA.1121.00052,2,914924,919167,-,4243
228,BUMA.1121.00053,2,1586672,1590926,+,4254
228,BUMA.1121.00057,2,790289,794541,-,4252
228,BUMA.1121.00108,2,1525562,1529825,+,4263
228,BUMA.1121.00050,2,1361930,1366173,+,4243
228,BUMA.1121.00104,2,1391585,1395848,+,4263
228,BUMA.1121.00014,2,1423802,1428056,+,4254
228,BUMA.1121.00036,2,285931,290174,+,4243
228,BUMA.1121.00038,2,992051,996294,+,4243
228,BUMA.1121.00098,2,1553983,1558246,+,4263
228,BUMA.1121.00078,2,1838702,1842965,-,4263
228,BUMA.1121.00029,2,17279,21533,-,4254
228,BUMA.1121.00099,2,1555626,1559879,+,4253
228,BUMA.1121.00103,2,3215623,3219886,+,4263
228,BUMA.1121.00102,2,1350015,1354269,+,4254
228,BUMA.1121.00028,2,743453,747696,+,4243
228,BUMA.1121.00075,2,1590893,1595147,+,4254
228,BUMA.1121.00044,2,768470,772713,+,4243
228,BUMA.1121.00076,2,2184879,2189133,+,4254
228,BUMA.1121.00074,2,3061241,3065511,-,4270
228,BUMA.1121.00073,2,1273786,1278038,+,4252
228,BUMA.1121.00083,2,3100882,3105134,+,4252
228,BUMA.1121.00035,2,3302338,3306537,-,4199
228,BUMA.1121.00072,2,1269938,1274190,+,4252
228,BUMA.1121.00056,2,2704252,2708504,-,4252
228,BUMA.1121.00081,2,1327257,1331500,-,4243
228,BUMA.1121.00033,2,2037957,2042220,+,4263
228,BUMA.1121.00061,2,1263691,1267943,+,4252
228,BUMA.1121.00062,2,480573,484836,-,4263
228,BUMA.1121.00064,2,1213440,1217703,+,4263
228,BUMA.1121.00060,2,900823,905086,-,4263
228,BUMA.1121.00069,2,1271589,1275841,+,4252
228,BUMA.1121.00070,2,1273836,1278088,+,4252
228,BUMA.1121.00068,2,3006987,3011259,+,4272
228,BUMA.1121.00067,2,2675565,2679828,-,4263
228,BUMA.1121.00037,2,1659274,1663528,+,4254
228,BUMA.1121.00065,2,1344843,1349106,+,4263
228,BUMA.1121.00058,2,1846972,1851221,+,4249
228,BUMA.1121.00041,2,2241297,2245551,+,4254
228,BUMA.1121.00084,2,3125131,3129392,+,4261
228,BUMA.1121.00096,2,1512975,1517238,+,4263
228,BUMA.1121.00080,2,1298867,1303119,+,4252
228,BUMA.1121.00013,2,1521933,1526176,-,4243
228,BUMA.1121.00100,2,2403346,2407609,+,4263
228,BUMA.1121.00012,2,398477,402731,-,4254
228,BUMA.1121.00018,2,2498977,2503240,-,4263
228,BUMA.1121.00048,2,2066606,2070849,-,4243
228,BUMA.1121.00106,2,517367,521630,-,4263
228,BUMA.1121.00017,2,717328,721571,+,4243
228,BUMA.1121.00082,2,1303925,1308177,+,4252
227,BUMA.1121.00049,2,3107383,3111777,+,4394
227,BUMA.1121.00055,2,1373805,1378200,-,4395
227,BUMA.1121.00011,2,3172832,3177220,+,4388
227,BUMA.1121.00110,2,1103123,1107534,-,4411
227,BUMA.1121.00109,2,114453,118848,-,4395
227,BUMA.1121.00077,2,2396777,2401188,-,4411
227,BUMA.1121.00027,2,2350953,2355369,+,4416
227,BUMA.1121.00026,2,1353934,1358318,+,4384
227,BUMA.1121.00021,2,1815010,1819403,+,4393
227,BUMA.1121.00023,2,1388781,1393174,+,4393
227,BUMA.1121.00022,2,222377,226761,+,4384
227,BUMA.1121.00034,2,712970,717354,+,4384
227,BUMA.1121.00025,2,2837148,2841544,-,4396
227,BUMA.1121.00031,2,485930,490312,+,4382
227,BUMA.1121.00007,2,1334754,1339138,+,4384
227,BUMA.1121.00097,2,1142066,1146446,+,4380
227,BUMA.1121.00008,2,802894,807278,+,4384
227,BUMA.1121.00059,2,2361180,2365575,-,4395
227,BUMA.1121.00002,2,1264313,1268697,+,4384
227,BUMA.1121.00004,2,803614,807998,+,4384
227,BUMA.1121.00005,2,2726663,2731057,+,4394
227,BUMA.1121.00111,2,570097,574496,+,4399
227,BUMA.1121.00006,2,987653,992037,+,4384
227,BUMA.1121.00009,2,3195467,3199841,+,4374
227,BUMA.1121.00094,2,1336260,1340659,+,4399
227,BUMA.1121.00101,2,2114906,2119313,-,4407
227,BUMA.1121.00066,2,1274867,1279266,+,4399
227,BUMA.1121.00095,2,3335710,3340053,-,4343
227,BUMA.1121.00112,2,3091988,3096401,-,4413
227,BUMA.1121.00042,2,903594,907979,-,4385
227,BUMA.1121.00032,2,1205593,1209977,+,4384
227,BUMA.1121.00090,2,2282591,2286984,+,4393
227,BUMA.1121.00020,2,803635,808019,+,4384
227,BUMA.1121.00089,2,1281117,1285516,+,4399
227,BUMA.1121.00051,2,1293260,1297657,+,4397
227,BUMA.1121.00001,2,910921,915323,-,4402
227,BUMA.1121.00045,2,1184447,1188838,+,4391
227,BUMA.1121.00043,2,1069929,1074336,-,4407
227,BUMA.1121.00063,2,1268418,1272813,+,4395
227,BUMA.1121.00079,2,1293739,1298094,+,4355
227,BUMA.1121.00071,2,1268721,1273120,+,4399
227,BUMA.1121.00086,2,1029772,1034156,+,4384
227,BUMA.1121.00024,2,738997,743379,+,4382
227,BUMA.1121.00024,2,832932,837316,+,4384
227,BUMA.1121.00010,2,23202,27586,+,4384
227,BUMA.1121.00040,2,1038871,1043255,+,4384
227,BUMA.1121.00093,2,1634727,1639151,-,4424
227,BUMA.1121.00091,2,2328440,2332825,-,4385
227,BUMA.1121.00107,2,2548730,2553114,-,4384
227,BUMA.1121.00088,2,1236449,1240804,+,4355
227,BUMA.1121.00047,2,2223064,2227463,+,4399
227,BUMA.1121.00019,2,803599,807983,+,4384
227,BUMA.1121.00087,2,1297269,1301653,+,4384
227,BUMA.1121.00039,2,2657648,2662042,-,4394
227,BUMA.1121.00030,2,1404432,1408817,-,4385
227,BUMA.1121.00016,2,2407075,2411469,-,4394
227,BUMA.1121.00092,2,1306046,1310470,+,4424
227,BUMA.1121.00085,2,230603,234988,-,4385
227,BUMA.1121.00046,2,1741350,1745734,+,4384
227,BUMA.1121.00003,2,2615458,2619845,-,4387
227,BUMA.1121.00054,2,787778,792162,+,4384
227,BUMA.1121.00015,2,1211716,1216101,-,4385
227,BUMA.1121.00105,2,1225642,1229998,-,4356
227,BUMA.1121.00052,2,919168,923553,-,4385
227,BUMA.1121.00053,2,1582264,1586670,+,4406
227,BUMA.1121.00057,2,794542,798942,-,4400
227,BUMA.1121.00108,2,1521161,1525556,+,4395
227,BUMA.1121.00050,2,1357544,1361928,+,4384
227,BUMA.1121.00104,2,1387184,1391579,+,4395
227,BUMA.1121.00014,2,1419418,1423800,+,4382
227,BUMA.1121.00036,2,281545,285929,+,4384
227,BUMA.1121.00038,2,987665,992049,+,4384
227,BUMA.1121.00098,2,1549553,1553981,+,4428
227,BUMA.1121.00078,2,1842966,1847395,-,4429
227,BUMA.1121.00029,2,21539,25941,-,4402
227,BUMA.1121.00099,2,1551225,1555609,+,4384
227,BUMA.1121.00103,2,3211233,3215606,+,4373
227,BUMA.1121.00102,2,1345607,1350013,+,4406
227,BUMA.1121.00028,2,739067,743451,+,4384
227,BUMA.1121.00075,2,1586497,1590891,+,4394
227,BUMA.1121.00044,2,764084,768468,+,4384
227,BUMA.1121.00076,2,2180483,2184877,+,4394
227,BUMA.1121.00074,2,3065512,3069907,-,4395
227,BUMA.1121.00073,2,1269385,1273784,+,4399
227,BUMA.1121.00083,2,3096481,3100880,+,4399
227,BUMA.1121.00035,2,58,4460,-,4402
227,BUMA.1121.00072,2,1265537,1269936,+,4399
227,BUMA.1121.00056,2,2708505,2712905,-,4400
227,BUMA.1121.00081,2,1331501,1335885,-,4384
227,BUMA.1121.00033,2,2033553,2037955,+,4402
227,BUMA.1121.00061,2,1259290,1263689,+,4399
227,BUMA.1121.00062,2,484837,489222,-,4385
227,BUMA.1121.00064,2,1209044,1213438,+,4394
227,BUMA.1121.00060,2,905092,909483,-,4391
227,BUMA.1121.00069,2,1267188,1271587,+,4399
227,BUMA.1121.00070,2,1269435,1273834,+,4399
227,BUMA.1121.00068,2,3002592,3006985,+,4393
227,BUMA.1121.00067,2,2679829,2684247,-,4418
227,BUMA.1121.00037,2,1654872,1659272,+,4400
227,BUMA.1121.00065,2,1340435,1344841,+,4406
227,BUMA.1121.00058,2,1842576,1846970,+,4394
227,BUMA.1121.00041,2,2236889,2241295,+,4406
227,BUMA.1121.00084,2,3120735,3125129,+,4394
227,BUMA.1121.00096,2,1508578,1512973,+,4395
227,BUMA.1121.00080,2,1294466,1298865,+,4399
227,BUMA.1121.00013,2,1526177,1530562,-,4385
227,BUMA.1121.00100,2,2398945,2403344,+,4399
227,BUMA.1121.00012,2,402737,407132,-,4395
227,BUMA.1121.00018,2,2503241,2507637,-,4396
227,BUMA.1121.00048,2,2070850,2075235,-,4385
227,BUMA.1121.00106,2,521631,526026,-,4395
227,BUMA.1121.00017,2,712942,717326,+,4384
227,BUMA.1121.00082,2,1299524,1303923,+,4399
226,BUMA.1121.00049,2,3084192,3107308,+,23116
226,BUMA.1121.00055,2,1378272,1401389,-,23117
226,BUMA.1121.00011,2,3149658,3172760,+,23102
226,BUMA.1121.00110,2,1107606,1130715,-,23109
226,BUMA.1121.00109,2,118920,141991,-,23071
226,BUMA.1121.00077,2,2401260,2424367,-,23107
226,BUMA.1121.00027,2,2327742,2350878,+,23136
226,BUMA.1121.00026,2,1330780,1353859,+,23079
226,BUMA.1121.00021,2,1791810,1814935,+,23125
226,BUMA.1121.00023,2,1365585,1388706,+,23121
226,BUMA.1121.00022,2,199216,222302,+,23086
226,BUMA.1121.00034,2,689809,712895,+,23086
226,BUMA.1121.00025,2,2841616,2864739,-,23123
226,BUMA.1121.00031,2,462740,485855,+,23115
226,BUMA.1121.00007,2,1311617,1334682,+,23065
226,BUMA.1121.00097,2,1118903,1141994,+,23091
226,BUMA.1121.00008,2,779733,802819,+,23086
226,BUMA.1121.00059,2,2365647,2388722,-,23075
226,BUMA.1121.00002,2,1241162,1264238,+,23076
226,BUMA.1121.00004,2,780453,803539,+,23086
226,BUMA.1121.00005,2,2703527,2726591,+,23064
226,BUMA.1121.00111,2,546911,570022,+,23111
226,BUMA.1121.00006,2,964492,987578,+,23086
226,BUMA.1121.00009,2,3172216,3195395,+,23179
226,BUMA.1121.00094,2,1313058,1336185,+,23127
226,BUMA.1121.00101,2,2119385,2142513,-,23128
226,BUMA.1121.00066,2,1251708,1274795,+,23087
226,BUMA.1121.00095,2,115,23223,-,23108
226,BUMA.1121.00112,2,3096473,3119560,-,23087
226,BUMA.1121.00042,2,908054,931132,-,23078
226,BUMA.1121.00032,2,1182432,1205518,+,23086
226,BUMA.1121.00090,2,2259395,2282516,+,23121
226,BUMA.1121.00020,2,780474,803560,+,23086
226,BUMA.1121.00089,2,1257903,1281042,+,23139
226,BUMA.1121.00051,2,1270050,1293185,+,23135
226,BUMA.1121.00001,2,915395,938521,-,23126
226,BUMA.1121.00045,2,1161236,1184375,+,23139
226,BUMA.1121.00043,2,1074408,1097532,-,23124
226,BUMA.1121.00063,2,1245260,1268346,+,23086
226,BUMA.1121.00079,2,1270538,1293664,+,23126
226,BUMA.1121.00071,2,1245562,1268649,+,23087
226,BUMA.1121.00086,2,1006611,1029697,+,23086
226,BUMA.1121.00024,2,715836,738922,+,23086
226,BUMA.1121.00024,2,809771,832857,+,23086
226,BUMA.1121.00010,2,36,23127,+,23091
226,BUMA.1121.00040,2,1015702,1038796,+,23094
226,BUMA.1121.00093,2,1639223,1662353,-,23130
226,BUMA.1121.00091,2,2332897,2356018,-,23121
226,BUMA.1121.00107,2,2553186,2576303,-,23117
226,BUMA.1121.00088,2,1213219,1236374,+,23155
226,BUMA.1121.00047,2,2199868,2222989,+,23121
226,BUMA.1121.00019,2,780438,803524,+,23086
226,BUMA.1121.00087,2,1274108,1297194,+,23086
226,BUMA.1121.00039,2,2662117,2685239,-,23122
226,BUMA.1121.00030,2,1408892,1431977,-,23085
226,BUMA.1121.00016,2,2411544,2434664,-,23120
226,BUMA.1121.00092,2,1282843,1305974,+,23131
226,BUMA.1121.00085,2,235063,258148,-,23085
226,BUMA.1121.00046,2,1718189,1741275,+,23086
226,BUMA.1121.00003,2,2619917,2643064,-,23147
226,BUMA.1121.00054,2,764617,787703,+,23086
226,BUMA.1121.00015,2,1216176,1239261,-,23085
226,BUMA.1121.00105,2,1230070,1253198,-,23128
226,BUMA.1121.00052,2,923628,946713,-,23085
226,BUMA.1121.00053,2,1558999,1582189,+,23190
226,BUMA.1121.00057,2,799017,822145,-,23128
226,BUMA.1121.00108,2,1497934,1521089,+,23155
226,BUMA.1121.00050,2,1334383,1357469,+,23086
226,BUMA.1121.00104,2,1363967,1387109,+,23142
226,BUMA.1121.00014,2,1396228,1419343,+,23115
226,BUMA.1121.00036,2,258384,281470,+,23086
226,BUMA.1121.00038,2,964504,987590,+,23086
226,BUMA.1121.00098,2,1526400,1549481,+,23081
226,BUMA.1121.00078,2,1847467,1870611,-,23144
226,BUMA.1121.00029,2,26013,49138,-,23125
226,BUMA.1121.00099,2,1528088,1551153,+,23065
226,BUMA.1121.00103,2,3188048,3211161,+,23113
226,BUMA.1121.00102,2,1322470,1345532,+,23062
226,BUMA.1121.00028,2,715906,738992,+,23086
226,BUMA.1121.00075,2,1563280,1586425,+,23145
226,BUMA.1121.00044,2,740923,764009,+,23086
226,BUMA.1121.00076,2,2157264,2180411,+,23147
226,BUMA.1121.00074,2,3069982,3093106,-,23124
226,BUMA.1121.00073,2,1246230,1269313,+,23083
226,BUMA.1121.00083,2,3073322,3096406,+,23084
226,BUMA.1121.00035,2,4532,27658,-,23126
226,BUMA.1121.00072,2,1242380,1265465,+,23085
226,BUMA.1121.00056,2,2712980,2736118,-,23138
226,BUMA.1121.00081,2,1335960,1359045,-,23085
226,BUMA.1121.00033,2,2010358,2033481,+,23123
226,BUMA.1121.00061,2,1236138,1259218,+,23080
226,BUMA.1121.00062,2,489294,512413,-,23119
226,BUMA.1121.00064,2,1185852,1208969,+,23117
226,BUMA.1121.00060,2,909555,932709,-,23154
226,BUMA.1121.00069,2,1244036,1267116,+,23080
226,BUMA.1121.00070,2,1246283,1269363,+,23080
226,BUMA.1121.00068,2,2979484,3002520,+,23036
226,BUMA.1121.00067,2,2684319,2707424,-,23105
226,BUMA.1121.00037,2,1631681,1654797,+,23116
226,BUMA.1121.00065,2,1317266,1340363,+,23097
226,BUMA.1121.00058,2,1819474,1842501,+,23027
226,BUMA.1121.00041,2,2213690,2236817,+,23127
226,BUMA.1121.00084,2,3097541,3120663,+,23122
226,BUMA.1121.00096,2,1485375,1508506,+,23131
226,BUMA.1121.00080,2,1271260,1294391,+,23131
226,BUMA.1121.00013,2,1530637,1553722,-,23085
226,BUMA.1121.00100,2,2375811,2398873,+,23062
226,BUMA.1121.00012,2,407204,430322,-,23118
226,BUMA.1121.00018,2,2507709,2530833,-,23124
226,BUMA.1121.00048,2,2075310,2098395,-,23085
226,BUMA.1121.00106,2,526106,549234,-,23128
226,BUMA.1121.00017,2,689781,712867,+,23086
226,BUMA.1121.00082,2,1276365,1299449,+,23084
225,BUMA.1121.00049,2,3064159,3077346,+,13187
225,BUMA.1121.00055,2,1408236,1421424,-,13188
225,BUMA.1121.00011,2,3129625,3142813,+,13188
225,BUMA.1121.00110,2,1137565,1150745,-,13180
225,BUMA.1121.00109,2,148840,162020,-,13180
225,BUMA.1121.00077,2,2431217,2444397,-,13180
225,BUMA.1121.00027,2,2307709,2320896,+,13187
225,BUMA.1121.00026,2,1310753,1323934,+,13181
225,BUMA.1121.00021,2,1771777,1784964,+,13187
225,BUMA.1121.00023,2,1345551,1358738,+,13187
225,BUMA.1121.00022,2,179189,192370,+,13181
225,BUMA.1121.00034,2,669782,682963,+,13181
225,BUMA.1121.00025,2,2871587,2884773,-,13186
225,BUMA.1121.00031,2,442698,455894,+,13196
225,BUMA.1121.00007,2,1291618,1304770,+,13152
225,BUMA.1121.00097,2,1098924,1112057,+,13133
225,BUMA.1121.00008,2,759706,772887,+,13181
225,BUMA.1121.00059,2,2395569,2408755,-,13186
225,BUMA.1121.00002,2,1221147,1234316,+,13169
225,BUMA.1121.00004,2,760426,773607,+,13181
225,BUMA.1121.00005,2,2683489,2696680,+,13191
225,BUMA.1121.00111,2,526887,540065,+,13178
225,BUMA.1121.00006,2,944465,957646,+,13181
225,BUMA.1121.00009,2,3152190,3165368,+,13178
225,BUMA.1121.00094,2,1293025,1306212,+,13187
225,BUMA.1121.00101,2,2149360,2162451,-,13091
225,BUMA.1121.00066,2,1231681,1244863,+,13182
225,BUMA.1121.00095,2,30066,43246,-,13180
225,BUMA.1121.00112,2,3126414,3139474,-,13060
225,BUMA.1121.00042,2,937979,951159,-,13180
225,BUMA.1121.00032,2,1162405,1175586,+,13181
225,BUMA.1121.00090,2,2239362,2252549,+,13187
225,BUMA.1121.00020,2,760447,773628,+,13181
225,BUMA.1121.00089,2,1237870,1251057,+,13187
225,BUMA.1121.00051,2,1250018,1263205,+,13187
225,BUMA.1121.00001,2,945368,958557,-,13189
225,BUMA.1121.00045,2,1141193,1154383,+,13190
225,BUMA.1121.00043,2,1104380,1117557,-,13177
225,BUMA.1121.00063,2,1225228,1238415,+,13187
225,BUMA.1121.00079,2,1250497,1263684,+,13187
225,BUMA.1121.00071,2,1225527,1238714,+,13187
225,BUMA.1121.00086,2,986584,999765,+,13181
225,BUMA.1121.00024,2,695809,708990,+,13181
225,BUMA.1121.00024,2,789744,802925,+,13181
225,BUMA.1121.00010,2,2076942,2090111,+,13169
225,BUMA.1121.00040,2,995676,1008857,+,13181
225,BUMA.1121.00093,2,1669202,1682388,-,13186
225,BUMA.1121.00091,2,2362861,2376049,-,13188
225,BUMA.1121.00107,2,2583150,2596339,-,13189
225,BUMA.1121.00088,2,1193181,1206373,+,13192
225,BUMA.1121.00047,2,2179833,2193020,+,13187
225,BUMA.1121.00019,2,760411,773592,+,13181
225,BUMA.1121.00087,2,1254081,1267262,+,13181
225,BUMA.1121.00039,2,2692087,2705273,-,13186
225,BUMA.1121.00030,2,1438824,1452004,-,13180
225,BUMA.1121.00016,2,2441512,2454689,-,13177
225,BUMA.1121.00092,2,1262808,1275995,+,13187
225,BUMA.1121.00085,2,264995,278175,-,13180
225,BUMA.1121.00046,2,1698162,1711343,+,13181
225,BUMA.1121.00003,2,2649910,2663087,-,13177
225,BUMA.1121.00054,2,744590,757771,+,13181
225,BUMA.1121.00015,2,1246108,1259271,-,13163
225,BUMA.1121.00105,2,1260047,1273233,-,13186
225,BUMA.1121.00052,2,953560,966740,-,13180
225,BUMA.1121.00053,2,1538964,1552153,+,13189
225,BUMA.1121.00057,2,828994,842180,-,13186
225,BUMA.1121.00108,2,1478031,1491099,+,13068
225,BUMA.1121.00050,2,1314356,1327537,+,13181
225,BUMA.1121.00104,2,1344032,1357120,+,13088
225,BUMA.1121.00014,2,1376186,1389382,+,13196
225,BUMA.1121.00036,2,238357,251538,+,13181
225,BUMA.1121.00038,2,944477,957658,+,13181
225,BUMA.1121.00098,2,1506463,1519552,+,13089
225,BUMA.1121.00078,2,1912864,1926052,-,13188
225,BUMA.1121.00029,2,55985,69174,-,13189
225,BUMA.1121.00099,2,1508048,1521241,+,13193
225,BUMA.1121.00103,2,3166806,3179955,+,13149
225,BUMA.1121.00102,2,1302563,1315624,+,13061
225,BUMA.1121.00028,2,695879,709060,+,13181
225,BUMA.1121.00075,2,1543246,1556433,+,13187
225,BUMA.1121.00044,2,720896,734077,+,13181
225,BUMA.1121.00076,2,2137230,2150417,+,13187
225,BUMA.1121.00074,2,3099953,3113133,-,13180
225,BUMA.1121.00073,2,1226195,1239382,+,13187
225,BUMA.1121.00083,2,3053287,3066474,+,13187
225,BUMA.1121.00035,2,34505,47694,-,13189
225,BUMA.1121.00072,2,1222345,1235532,+,13187
225,BUMA.1121.00056,2,2742965,2756151,-,13186
225,BUMA.1121.00081,2,1365892,1379072,-,13180
225,BUMA.1121.00033,2,1990327,2003512,+,13185
225,BUMA.1121.00061,2,1216106,1229292,+,13186
225,BUMA.1121.00062,2,519262,532448,-,13186
225,BUMA.1121.00064,2,1165818,1179005,+,13187
225,BUMA.1121.00060,2,939547,952736,-,13189
225,BUMA.1121.00069,2,1224002,1237189,+,13187
225,BUMA.1121.00070,2,1226248,1239435,+,13187
225,BUMA.1121.00068,2,2959439,2972636,+,13197
225,BUMA.1121.00067,2,2714271,2727451,-,13180
225,BUMA.1121.00037,2,1611639,1624835,+,13196
225,BUMA.1121.00065,2,1297331,1310420,+,13089
225,BUMA.1121.00058,2,1799441,1812628,+,13187
225,BUMA.1121.00041,2,2193657,2206843,+,13186
225,BUMA.1121.00084,2,3077506,3090695,+,13189
225,BUMA.1121.00096,2,1465335,1478530,+,13195
225,BUMA.1121.00080,2,1251227,1264414,+,13187
225,BUMA.1121.00013,2,1560569,1573749,-,13180
225,BUMA.1121.00100,2,2355823,2369013,+,13190
225,BUMA.1121.00012,2,437169,450355,-,13186
225,BUMA.1121.00018,2,2537681,2550867,-,13186
225,BUMA.1121.00048,2,2105242,2118422,-,13180
225,BUMA.1121.00106,2,556081,569267,-,13186
225,BUMA.1121.00017,2,669754,682935,+,13181
225,BUMA.1121.00082,2,1256330,1269517,+,13187
224,BUMA.1121.00049,2,3052659,3063053,+,10394
224,BUMA.1121.00055,2,1422530,1432893,-,10363
224,BUMA.1121.00011,2,3118157,3128519,+,10362
224,BUMA.1121.00110,2,1151851,1162213,-,10362
224,BUMA.1121.00109,2,163135,173519,-,10384
224,BUMA.1121.00077,2,2445503,2455865,-,10362
224,BUMA.1121.00027,2,2296269,2306603,+,10334
224,BUMA.1121.00026,2,1299272,1309647,+,10375
224,BUMA.1121.00021,2,1760383,1770671,+,10288
224,BUMA.1121.00023,2,1334050,1344445,+,10395
224,BUMA.1121.00022,2,167708,178083,+,10375
224,BUMA.1121.00034,2,658301,668676,+,10375
224,BUMA.1121.00025,2,2885879,2896245,-,10366
224,BUMA.1121.00031,2,431219,441592,+,10373
224,BUMA.1121.00007,2,1280121,1290512,+,10391
224,BUMA.1121.00097,2,1087429,1097809,+,10380
224,BUMA.1121.00008,2,748225,758600,+,10375
224,BUMA.1121.00059,2,2409861,2420236,-,10375
224,BUMA.1121.00002,2,1209666,1220041,+,10375
224,BUMA.1121.00004,2,748945,759320,+,10375
224,BUMA.1121.00005,2,2672071,2682383,+,10312
224,BUMA.1121.00111,2,515394,525781,+,10387
224,BUMA.1121.00006,2,932984,943359,+,10375
224,BUMA.1121.00009,2,3140717,3151084,+,10367
224,BUMA.1121.00094,2,1281543,1291919,+,10376
224,BUMA.1121.00101,2,2163557,2173945,-,10388
224,BUMA.1121.00066,2,1220230,1230575,+,10345
224,BUMA.1121.00095,2,44353,54735,-,10382
224,BUMA.1121.00112,2,3140580,3150963,-,10383
224,BUMA.1121.00042,2,952265,962641,-,10376
224,BUMA.1121.00032,2,1150924,1161299,+,10375
224,BUMA.1121.00090,2,2227869,2238256,+,10387
224,BUMA.1121.00020,2,748966,759341,+,10375
224,BUMA.1121.00089,2,1226388,1236764,+,10376
224,BUMA.1121.00051,2,1238537,1248912,+,10375
224,BUMA.1121.00001,2,959663,970040,-,10377
224,BUMA.1121.00045,2,1129700,1140087,+,10387
224,BUMA.1121.00043,2,1118663,1129024,-,10361
224,BUMA.1121.00063,2,1213779,1224122,+,10343
224,BUMA.1121.00079,2,1239007,1249391,+,10384
224,BUMA.1121.00071,2,1214078,1224421,+,10343
224,BUMA.1121.00086,2,975103,985478,+,10375
224,BUMA.1121.00024,2,684328,694703,+,10375
224,BUMA.1121.00024,2,778263,788638,+,10375
224,BUMA.1121.00010,2,2065461,2075836,+,10375
224,BUMA.1121.00040,2,984195,994570,+,10375
224,BUMA.1121.00093,2,1683494,1693876,-,10382
224,BUMA.1121.00091,2,2377155,2387537,-,10382
224,BUMA.1121.00107,2,2597445,2607852,-,10407
224,BUMA.1121.00088,2,1181699,1192075,+,10376
224,BUMA.1121.00047,2,2168357,2178727,+,10370
224,BUMA.1121.00019,2,748930,759305,+,10375
224,BUMA.1121.00087,2,1242600,1252975,+,10375
224,BUMA.1121.00039,2,2706379,2716767,-,10388
224,BUMA.1121.00030,2,1453110,1463486,-,10376
224,BUMA.1121.00016,2,2455795,2466167,-,10372
224,BUMA.1121.00092,2,1251321,1261702,+,10381
224,BUMA.1121.00085,2,279281,289657,-,10376
224,BUMA.1121.00046,2,1686681,1697056,+,10375
224,BUMA.1121.00003,2,2664193,2674566,-,10373
224,BUMA.1121.00054,2,733109,743484,+,10375
224,BUMA.1121.00015,2,1260377,1270753,-,10376
224,BUMA.1121.00105,2,1274339,1284717,-,10378
224,BUMA.1121.00052,2,967846,978222,-,10376
224,BUMA.1121.00053,2,1527470,1537858,+,10388
224,BUMA.1121.00057,2,843286,853666,-,10380
224,BUMA.1121.00108,2,1466524,1476925,+,10401
224,BUMA.1121.00050,2,1302875,1313250,+,10375
224,BUMA.1121.00104,2,1332537,1342926,+,10389
224,BUMA.1121.00014,2,1364707,1375080,+,10373
224,BUMA.1121.00036,2,226876,237251,+,10375
224,BUMA.1121.00038,2,932996,943371,+,10375
224,BUMA.1121.00098,2,1494970,1505357,+,10387
224,BUMA.1121.00078,2,1927158,1937506,-,10348
224,BUMA.1121.00029,2,70280,80657,-,10377
224,BUMA.1121.00099,2,1496541,1506942,+,10401
224,BUMA.1121.00103,2,3155320,3165700,+,10380
224,BUMA.1121.00102,2,1291109,1301457,+,10348
224,BUMA.1121.00028,2,684398,694773,+,10375
224,BUMA.1121.00075,2,1531748,1542140,+,10392
224,BUMA.1121.00044,2,709415,719790,+,10375
224,BUMA.1121.00076,2,2125729,2136124,+,10395
224,BUMA.1121.00074,2,3114239,3124628,-,10389
224,BUMA.1121.00073,2,1214744,1225089,+,10345
224,BUMA.1121.00083,2,3041836,3052181,+,10345
224,BUMA.1121.00035,2,48800,59177,-,10377
224,BUMA.1121.00072,2,1210894,1221239,+,10345
224,BUMA.1121.00056,2,2757257,2767634,-,10377
224,BUMA.1121.00081,2,1380178,1390554,-,10376
224,BUMA.1121.00033,2,1978834,1989221,+,10387
224,BUMA.1121.00061,2,1204655,1215000,+,10345
224,BUMA.1121.00062,2,533554,543936,-,10382
224,BUMA.1121.00064,2,1154331,1164712,+,10381
224,BUMA.1121.00060,2,953842,964230,-,10388
224,BUMA.1121.00069,2,1212551,1222896,+,10345
224,BUMA.1121.00070,2,1214797,1225142,+,10345
224,BUMA.1121.00068,2,2947970,2958333,+,10363
224,BUMA.1121.00067,2,2728557,2738946,-,10389
224,BUMA.1121.00037,2,1600160,1610533,+,10373
224,BUMA.1121.00065,2,1285839,1296225,+,10386
224,BUMA.1121.00058,2,1787944,1798335,+,10391
224,BUMA.1121.00041,2,2182172,2192551,+,10379
224,BUMA.1121.00084,2,3066015,3076400,+,10385
224,BUMA.1121.00096,2,1453850,1464229,+,10379
224,BUMA.1121.00080,2,1239745,1250121,+,10376
224,BUMA.1121.00013,2,1574855,1585231,-,10376
224,BUMA.1121.00100,2,2344346,2354717,+,10371
224,BUMA.1121.00012,2,451461,461848,-,10387
224,BUMA.1121.00018,2,2551973,2562339,-,10366
224,BUMA.1121.00048,2,2119528,2129904,-,10376
224,BUMA.1121.00106,2,570373,580755,-,10382
224,BUMA.1121.00017,2,658273,668648,+,10375
224,BUMA.1121.00082,2,1244879,1255224,+,10345
223,BUMA.1121.00049,2,3030300,3052101,+,21801
223,BUMA.1121.00055,2,1433450,1455531,-,22081
223,BUMA.1121.00011,2,3095847,3117599,+,21752
223,BUMA.1121.00110,2,1162770,1184405,-,21635
223,BUMA.1121.00109,2,174076,195847,-,21771
223,BUMA.1121.00077,2,2456422,2478057,-,21635
223,BUMA.1121.00027,2,2274034,2295711,+,21677
223,BUMA.1121.00026,2,1277150,1298714,+,21564
223,BUMA.1121.00021,2,1738123,1759825,+,21702
223,BUMA.1121.00023,2,1311612,1333492,+,21880
223,BUMA.1121.00022,2,145618,167150,+,21532
223,BUMA.1121.00034,2,636163,657743,+,21580
223,BUMA.1121.00025,2,2896802,2918584,-,21782
223,BUMA.1121.00031,2,408847,430661,+,21814
223,BUMA.1121.00007,2,1257863,1279563,+,21700
223,BUMA.1121.00097,2,1065141,1086871,+,21730
223,BUMA.1121.00008,2,726087,747667,+,21580
223,BUMA.1121.00059,2,2420793,2442533,-,21740
223,BUMA.1121.00002,2,1187528,1209108,+,21580
223,BUMA.1121.00004,2,726807,748387,+,21580
223,BUMA.1121.00005,2,2649762,2671513,+,21751
223,BUMA.1121.00111,2,493048,514836,+,21788
223,BUMA.1121.00006,2,910830,932426,+,21596
223,BUMA.1121.00009,2,3118395,3140159,+,21764
223,BUMA.1121.00094,2,1259271,1280985,+,21714
223,BUMA.1121.00101,2,2174502,2196223,-,21721
223,BUMA.1121.00066,2,1197832,1219672,+,21840
223,BUMA.1121.00095,2,55292,76876,-,21584
223,BUMA.1121.00112,2,3151520,3173322,-,21802
223,BUMA.1121.00042,2,963198,984723,-,21525
223,BUMA.1121.00032,2,1128786,1150366,+,21580
223,BUMA.1121.00090,2,2205575,2227311,+,21736
223,BUMA.1121.00020,2,726828,748408,+,21580
223,BUMA.1121.00089,2,1204095,1225830,+,21735
223,BUMA.1121.00051,2,1216059,1237979,+,21920
223,BUMA.1121.00001,2,970597,992297,-,21700
223,BUMA.1121.00045,2,1107405,1129142,+,21737
223,BUMA.1121.00043,2,1129581,1151297,-,21716
223,BUMA.1121.00063,2,1191321,1213221,+,21900
223,BUMA.1121.00079,2,1216614,1238449,+,21835
223,BUMA.1121.00071,2,1191613,1213520,+,21907
223,BUMA.1121.00086,2,952965,974545,+,21580
223,BUMA.1121.00024,2,662201,683770,+,21569
223,BUMA.1121.00024,2,756125,777705,+,21580
223,BUMA.1121.00010,2,2043371,2064903,+,21532
223,BUMA.1121.00040,2,962057,983637,+,21580
223,BUMA.1121.00093,2,1694433,1716009,-,21576
223,BUMA.1121.00091,2,2388094,2409795,-,21701
223,BUMA.1121.00107,2,2608409,2630122,-,21713
223,BUMA.1121.00088,2,1159462,1181141,+,21679
223,BUMA.1121.00047,2,2145947,2167799,+,21852
223,BUMA.1121.00019,2,726792,748372,+,21580
223,BUMA.1121.00087,2,1220462,1242042,+,21580
223,BUMA.1121.00039,2,2717324,2738979,-,21655
223,BUMA.1121.00030,2,1464043,1485624,-,21581
223,BUMA.1121.00016,2,2466724,2488481,-,21757
223,BUMA.1121.00092,2,1229068,1250763,+,21695
223,BUMA.1121.00085,2,290214,311867,-,21653
223,BUMA.1121.00046,2,1664599,1686123,+,21524
223,BUMA.1121.00003,2,2675123,2696759,-,21636
223,BUMA.1121.00054,2,710955,732551,+,21596
223,BUMA.1121.00015,2,1271310,1292944,-,21634
223,BUMA.1121.00105,2,1285274,1306913,-,21639
223,BUMA.1121.00052,2,978779,1000424,-,21645
223,BUMA.1121.00053,2,1505121,1526912,+,21791
223,BUMA.1121.00057,2,854223,876144,-,21921
223,BUMA.1121.00108,2,1444189,1465966,+,21777
223,BUMA.1121.00050,2,1280793,1302317,+,21524
223,BUMA.1121.00104,2,1310102,1331979,+,21877
223,BUMA.1121.00014,2,1342327,1364149,+,21822
223,BUMA.1121.00036,2,204743,226318,+,21575
223,BUMA.1121.00038,2,910842,932438,+,21596
223,BUMA.1121.00098,2,1472634,1494412,+,21778
223,BUMA.1121.00078,2,1938063,1959862,-,21799
223,BUMA.1121.00029,2,81214,102976,-,21762
223,BUMA.1121.00099,2,1474339,1495983,+,21644
223,BUMA.1121.00103,2,3133122,3154762,+,21640
223,BUMA.1121.00102,2,1268793,1290551,+,21758
223,BUMA.1121.00028,2,662260,683840,+,21580
223,BUMA.1121.00075,2,1509458,1531190,+,21732
223,BUMA.1121.00044,2,687277,708857,+,21580
223,BUMA.1121.00076,2,2103453,2125171,+,21718
223,BUMA.1121.00074,2,3125185,3147033,-,21848
223,BUMA.1121.00073,2,1192275,1214186,+,21911
223,BUMA.1121.00083,2,3019366,3041278,+,21912
223,BUMA.1121.00035,2,59734,81474,-,21740
223,BUMA.1121.00072,2,1188433,1210336,+,21903
223,BUMA.1121.00056,2,2768191,2789927,-,21736
223,BUMA.1121.00081,2,1391111,1412708,-,21597
223,BUMA.1121.00033,2,1956469,1978276,+,21807
223,BUMA.1121.00061,2,1182249,1204097,+,21848
223,BUMA.1121.00062,2,544493,566183,-,21690
223,BUMA.1121.00064,2,1132047,1153773,+,21726
223,BUMA.1121.00060,2,964787,986509,-,21722
223,BUMA.1121.00069,2,1190082,1211993,+,21911
223,BUMA.1121.00070,2,1192328,1214239,+,21911
223,BUMA.1121.00068,2,2925497,2947412,+,21915
223,BUMA.1121.00067,2,2739503,2761338,-,21835
223,BUMA.1121.00037,2,1577721,1599602,+,21881
223,BUMA.1121.00065,2,1263564,1285281,+,21717
223,BUMA.1121.00058,2,1765752,1787386,+,21634
223,BUMA.1121.00041,2,2159793,2181614,+,21821
223,BUMA.1121.00084,2,3043609,3065457,+,21848
223,BUMA.1121.00096,2,1431550,1453292,+,21742
223,BUMA.1121.00080,2,1217286,1239187,+,21901
223,BUMA.1121.00013,2,1585788,1607416,-,21628
223,BUMA.1121.00100,2,2322180,2343788,+,21608
223,BUMA.1121.00012,2,462405,484053,-,21648
223,BUMA.1121.00018,2,2562896,2584686,-,21790
223,BUMA.1121.00048,2,2130461,2152058,-,21597
223,BUMA.1121.00106,2,581312,603122,-,21810
223,BUMA.1121.00017,2,636135,657715,+,21580
223,BUMA.1121.00082,2,1222409,1244321,+,21912
222,BUMA.1121.00049,2,3025016,3030298,+,5282
222,BUMA.1121.00055,2,1455532,1460831,-,5299
222,BUMA.1121.00011,2,3090563,3095845,+,5282
222,BUMA.1121.00110,2,1184406,1189687,-,5281
222,BUMA.1121.00109,2,195848,201131,-,5283
222,BUMA.1121.00077,2,2478058,2483338,-,5280
222,BUMA.1121.00027,2,2268717,2274032,+,5315
222,BUMA.1121.00026,2,1271849,1277148,+,5299
222,BUMA.1121.00021,2,1732814,1738121,+,5307
222,BUMA.1121.00023,2,1306329,1311610,+,5281
222,BUMA.1121.00022,2,140317,145616,+,5299
222,BUMA.1121.00034,2,630862,636161,+,5299
222,BUMA.1121.00025,2,2918585,2923892,-,5307
222,BUMA.1121.00031,2,403530,408845,+,5315
222,BUMA.1121.00007,2,1252578,1257861,+,5283
222,BUMA.1121.00097,2,1059841,1065139,+,5298
222,BUMA.1121.00008,2,720786,726085,+,5299
222,BUMA.1121.00059,2,2442534,2447824,-,5290
222,BUMA.1121.00002,2,1182227,1187526,+,5299
222,BUMA.1121.00004,2,721506,726805,+,5299
222,BUMA.1121.00005,2,2644461,2649760,+,5299
222,BUMA.1121.00111,2,487739,493046,+,5307
222,BUMA.1121.00009,2,3113096,3118393,+,5297
222,BUMA.1121.00094,2,1253987,1259269,+,5282
222,BUMA.1121.00101,2,2196224,2201521,-,5297
222,BUMA.1121.00066,2,1192548,1197830,+,5282
222,BUMA.1121.00095,2,76877,82166,-,5289
222,BUMA.1121.00112,2,3173323,3178621,-,5298
222,BUMA.1121.00042,2,984724,990038,-,5314
222,BUMA.1121.00032,2,1123485,1128784,+,5299
222,BUMA.1121.00090,2,2200258,2205573,+,5315
222,BUMA.1121.00020,2,721527,726826,+,5299
222,BUMA.1121.00089,2,1198811,1204093,+,5282
222,BUMA.1121.00051,2,1210775,1216057,+,5282
222,BUMA.1121.00001,2,992298,997605,-,5307
222,BUMA.1121.00045,2,1102114,1107403,+,5289
222,BUMA.1121.00043,2,1151298,1156579,-,5281
222,BUMA.1121.00063,2,1186037,1191319,+,5282
222,BUMA.1121.00079,2,1211330,1216612,+,5282
222,BUMA.1121.00071,2,1186329,1191611,+,5282
222,BUMA.1121.00086,2,947664,952963,+,5299
222,BUMA.1121.00024,2,656899,662199,+,5300
222,BUMA.1121.00024,2,750826,756123,+,5297
222,BUMA.1121.00010,2,2038070,2043369,+,5299
222,BUMA.1121.00093,2,1716010,1721293,-,5283
222,BUMA.1121.00091,2,2409796,2415095,-,5299
222,BUMA.1121.00107,2,2630123,2635422,-,5299
222,BUMA.1121.00088,2,1154178,1159460,+,5282
222,BUMA.1121.00047,2,2140663,2145945,+,5282
222,BUMA.1121.00019,2,721491,726790,+,5299
222,BUMA.1121.00087,2,1215161,1220460,+,5299
222,BUMA.1121.00039,2,2738980,2744287,-,5307
222,BUMA.1121.00030,2,1485625,1490924,-,5299
222,BUMA.1121.00016,2,2488482,2493789,-,5307
222,BUMA.1121.00092,2,1223783,1229066,+,5283
222,BUMA.1121.00003,2,2696760,2702041,-,5281
222,BUMA.1121.00105,2,1306914,1312196,-,5282
222,BUMA.1121.00053,2,1499820,1505119,+,5299
222,BUMA.1121.00057,2,876145,881460,-,5315
222,BUMA.1121.00108,2,1438917,1444187,+,5270
222,BUMA.1121.00104,2,1304818,1310100,+,5282
222,BUMA.1121.00014,2,1337018,1342325,+,5307
222,BUMA.1121.00036,2,199442,204741,+,5299
222,BUMA.1121.00098,2,1467351,1472632,+,5281
222,BUMA.1121.00078,2,1959863,1965144,-,5281
222,BUMA.1121.00029,2,102977,108268,-,5291
222,BUMA.1121.00099,2,1469007,1474337,+,5330
222,BUMA.1121.00103,2,3127838,3133120,+,5282
222,BUMA.1121.00102,2,1263492,1268791,+,5299
222,BUMA.1121.00028,2,656959,662258,+,5299
222,BUMA.1121.00075,2,1504174,1509456,+,5282
222,BUMA.1121.00044,2,681976,687275,+,5299
222,BUMA.1121.00076,2,2098169,2103451,+,5282
222,BUMA.1121.00074,2,3147034,3152316,-,5282
222,BUMA.1121.00073,2,1186991,1192273,+,5282
222,BUMA.1121.00083,2,3014082,3019364,+,5282
222,BUMA.1121.00035,2,81475,86782,-,5307
222,BUMA.1121.00072,2,1183149,1188431,+,5282
222,BUMA.1121.00056,2,2789928,2795210,-,5282
222,BUMA.1121.00033,2,1951185,1956467,+,5282
222,BUMA.1121.00061,2,1176965,1182247,+,5282
222,BUMA.1121.00062,2,566184,571466,-,5282
222,BUMA.1121.00064,2,1126762,1132045,+,5283
222,BUMA.1121.00060,2,986510,991799,-,5289
222,BUMA.1121.00069,2,1184798,1190080,+,5282
222,BUMA.1121.00070,2,1187044,1192326,+,5282
222,BUMA.1121.00068,2,2920214,2925495,+,5281
222,BUMA.1121.00067,2,2761339,2766621,-,5282
222,BUMA.1121.00037,2,1572404,1577719,+,5315
222,BUMA.1121.00065,2,1258279,1263562,+,5283
222,BUMA.1121.00058,2,1760468,1765750,+,5282
222,BUMA.1121.00041,2,2154493,2159791,+,5298
222,BUMA.1121.00084,2,3038325,3043607,+,5282
222,BUMA.1121.00096,2,1426251,1431548,+,5297
222,BUMA.1121.00080,2,1212002,1217284,+,5282
222,BUMA.1121.00100,2,2316893,2322178,+,5285
222,BUMA.1121.00012,2,484054,489361,-,5307
222,BUMA.1121.00018,2,2584687,2589994,-,5307
222,BUMA.1121.00106,2,603123,608405,-,5282
222,BUMA.1121.00017,2,630834,636133,+,5299
222,BUMA.1121.00082,2,1217125,1222407,+,5282
221,BUMA.1121.00049,2,3014982,3019710,+,4728
221,BUMA.1121.00055,2,1466127,1470851,-,4724
221,BUMA.1121.00011,2,3080536,3085278,+,4742
221,BUMA.1121.00110,2,1194997,1199739,-,4742
221,BUMA.1121.00109,2,206452,211170,-,4718
221,BUMA.1121.00077,2,2488648,2493390,-,4742
221,BUMA.1121.00027,2,2258683,2263411,+,4728
221,BUMA.1121.00026,2,63732,68470,-,4738
221,BUMA.1121.00021,2,1722791,1727519,+,4728
221,BUMA.1121.00023,2,1296306,1301034,+,4728
221,BUMA.1121.00022,2,131827,136565,+,4738
221,BUMA.1121.00034,2,622371,627110,+,4739
221,BUMA.1121.00025,2,2929200,2933928,-,4728
221,BUMA.1121.00031,2,393513,398235,+,4722
221,BUMA.1121.00007,2,1242543,1247271,+,4728
221,BUMA.1121.00097,2,1049811,1054539,+,4728
221,BUMA.1121.00008,2,712295,717034,+,4739
221,BUMA.1121.00059,2,2453131,2457873,-,4742
221,BUMA.1121.00002,2,1173737,1178475,+,4738
221,BUMA.1121.00004,2,713015,717754,+,4739
221,BUMA.1121.00005,2,2634425,2639167,+,4742
221,BUMA.1121.00111,2,477716,482444,+,4728
221,BUMA.1121.00006,2,902705,907443,+,4738
221,BUMA.1121.00009,2,3103060,3107788,+,4728
221,BUMA.1121.00094,2,1243953,1248681,+,4728
221,BUMA.1121.00101,2,2206816,2211534,-,4718
221,BUMA.1121.00066,2,1182513,1187241,+,4728
221,BUMA.1121.00095,2,87486,92224,-,4738
221,BUMA.1121.00112,2,3183893,3188631,-,4738
221,BUMA.1121.00042,2,189459,194197,+,4738
221,BUMA.1121.00032,2,1114994,1119733,+,4739
221,BUMA.1121.00090,2,2190235,2194963,+,4728
221,BUMA.1121.00020,2,713036,717775,+,4739
221,BUMA.1121.00089,2,1188777,1193505,+,4728
221,BUMA.1121.00051,2,1200742,1205470,+,4728
221,BUMA.1121.00001,2,1002901,1007629,-,4728
221,BUMA.1121.00045,2,1092072,1096814,+,4742
221,BUMA.1121.00043,2,1161874,1166602,-,4728
221,BUMA.1121.00063,2,1176002,1180730,+,4728
221,BUMA.1121.00079,2,1201297,1206025,+,4728
221,BUMA.1121.00071,2,1176294,1181022,+,4728
221,BUMA.1121.00086,2,939174,943912,+,4738
221,BUMA.1121.00024,2,648408,653147,+,4739
221,BUMA.1121.00010,2,2029580,2034318,+,4738
221,BUMA.1121.00040,2,1269196,1273934,-,4738
221,BUMA.1121.00093,2,1726588,1731312,-,4724
221,BUMA.1121.00091,2,2422689,2427417,-,4728
221,BUMA.1121.00107,2,2640755,2645493,-,4738
221,BUMA.1121.00088,2,1144141,1148883,+,4742
221,BUMA.1121.00047,2,2130630,2135358,+,4728
221,BUMA.1121.00019,2,713000,717739,+,4739
221,BUMA.1121.00087,2,1206671,1211409,+,4738
221,BUMA.1121.00039,2,2749609,2754337,-,4728
221,BUMA.1121.00030,2,1494677,1499416,-,4739
221,BUMA.1121.00016,2,2499085,2503813,-,4728
221,BUMA.1121.00092,2,1213765,1218489,+,4724
221,BUMA.1121.00085,2,315254,319992,-,4738
221,BUMA.1121.00046,2,1656474,1661212,+,4738
221,BUMA.1121.00003,2,2710176,2714918,-,4742
221,BUMA.1121.00054,2,702830,707568,+,4738
221,BUMA.1121.00015,2,1296331,1301069,-,4738
221,BUMA.1121.00105,2,1317492,1322220,-,4728
221,BUMA.1121.00052,2,1003811,1008549,-,4738
221,BUMA.1121.00053,2,1487512,1492239,+,4727
221,BUMA.1121.00057,2,886767,891495,-,4728
221,BUMA.1121.00108,2,1428897,1433625,+,4728
221,BUMA.1121.00050,2,1272668,1277406,+,4738
221,BUMA.1121.00104,2,1294784,1299512,+,4728
221,BUMA.1121.00014,2,1326994,1331722,+,4728
221,BUMA.1121.00036,2,190952,195690,+,4738
221,BUMA.1121.00038,2,902717,907455,+,4738
221,BUMA.1121.00098,2,1457353,1462081,+,4728
221,BUMA.1121.00078,2,1966227,1970610,-,4383
221,BUMA.1121.00029,2,113564,118292,-,4728
221,BUMA.1121.00099,2,1458974,1463712,+,4738
221,BUMA.1121.00103,2,3117802,3122544,+,4742
221,BUMA.1121.00102,2,1251170,1255898,+,4728
221,BUMA.1121.00028,2,648468,653207,+,4739
221,BUMA.1121.00075,2,1494138,1498880,+,4742
221,BUMA.1121.00044,2,673485,678224,+,4739
221,BUMA.1121.00076,2,2088133,2092875,+,4742
221,BUMA.1121.00074,2,3157624,3162352,-,4728
221,BUMA.1121.00073,2,1176956,1181684,+,4728
221,BUMA.1121.00083,2,3004047,3008775,+,4728
221,BUMA.1121.00035,2,92078,96806,-,4728
221,BUMA.1121.00072,2,1173118,1177842,+,4724
221,BUMA.1121.00056,2,2800517,2805245,-,4728
221,BUMA.1121.00081,2,1416095,1420833,-,4738
221,BUMA.1121.00033,2,1941163,1945890,+,4727
221,BUMA.1121.00061,2,1166930,1171658,+,4728
221,BUMA.1121.00062,2,576760,581488,-,4728
221,BUMA.1121.00064,2,1116744,1121468,+,4724
221,BUMA.1121.00060,2,997100,1001842,-,4742
221,BUMA.1121.00069,2,1174763,1179491,+,4728
221,BUMA.1121.00070,2,1177009,1181737,+,4728
221,BUMA.1121.00068,2,2910182,2914920,+,4738
221,BUMA.1121.00067,2,2771928,2776670,-,4742
221,BUMA.1121.00037,2,1562381,1567109,+,4728
221,BUMA.1121.00065,2,1248261,1252985,+,4724
221,BUMA.1121.00058,2,1750420,1755162,+,4742
221,BUMA.1121.00041,2,2144464,2149188,+,4724
221,BUMA.1121.00084,2,3028277,3033019,+,4742
221,BUMA.1121.00096,2,1416191,1420943,+,4752
221,BUMA.1121.00080,2,1201969,1206697,+,4728
221,BUMA.1121.00013,2,1610803,1615541,-,4738
221,BUMA.1121.00100,2,2306868,2311586,+,4718
221,BUMA.1121.00012,2,494656,499384,-,4728
221,BUMA.1121.00018,2,2595301,2600029,-,4728
221,BUMA.1121.00048,2,2155443,2160181,-,4738
221,BUMA.1121.00106,2,613712,618440,-,4728
221,BUMA.1121.00017,2,622343,627082,+,4739
221,BUMA.1121.00082,2,1207090,1211818,+,4728
220,BUMA.1121.00049,2,2981767,3014940,+,33173
220,BUMA.1121.00055,2,1470893,1504091,-,33198
220,BUMA.1121.00011,2,3047297,3080494,+,33197
220,BUMA.1121.00110,2,1199781,1233022,-,33241
220,BUMA.1121.00109,2,211212,244464,-,33252
220,BUMA.1121.00077,2,2493432,2526689,-,33257
220,BUMA.1121.00027,2,2225442,2258641,+,33199
220,BUMA.1121.00026,2,68512,101637,-,33125
220,BUMA.1121.00021,2,1689576,1722749,+,33173
220,BUMA.1121.00023,2,1263075,1296264,+,33189
220,BUMA.1121.00022,2,98592,131785,+,33193
220,BUMA.1121.00034,2,589143,622329,+,33186
220,BUMA.1121.00025,2,2933970,2967183,-,33213
220,BUMA.1121.00031,2,360274,393471,+,33197
220,BUMA.1121.00007,2,1209412,1242501,+,33089
220,BUMA.1121.00097,2,1016630,1049769,+,33139
220,BUMA.1121.00008,2,679067,712253,+,33186
220,BUMA.1121.00059,2,2457915,2491388,-,33473
220,BUMA.1121.00002,2,1140488,1173695,+,33207
220,BUMA.1121.00004,2,679794,712973,+,33179
220,BUMA.1121.00005,2,2601084,2634383,+,33299
220,BUMA.1121.00111,2,444515,477674,+,33159
220,BUMA.1121.00006,2,869400,902663,+,33263
220,BUMA.1121.00009,2,3069829,3103018,+,33189
220,BUMA.1121.00094,2,1210712,1243911,+,33199
220,BUMA.1121.00101,2,2211576,2244692,-,33116
220,BUMA.1121.00066,2,1149258,1182471,+,33213
220,BUMA.1121.00095,2,92266,125553,-,33287
220,BUMA.1121.00112,2,3188673,3221874,-,33201
220,BUMA.1121.00042,2,154958,188122,+,33164
220,BUMA.1121.00032,2,1081703,1114952,+,33249
220,BUMA.1121.00090,2,2156938,2190193,+,33255
220,BUMA.1121.00020,2,679801,712994,+,33193
220,BUMA.1121.00089,2,1155535,1188735,+,33200
220,BUMA.1121.00051,2,1167481,1200700,+,33219
220,BUMA.1121.00001,2,1007671,1040837,-,33166
220,BUMA.1121.00045,2,1058881,1092030,+,33149
220,BUMA.1121.00043,2,1166644,1199864,-,33220
220,BUMA.1121.00063,2,1142749,1175960,+,33211
220,BUMA.1121.00079,2,1168021,1201255,+,33234
220,BUMA.1121.00071,2,1143039,1176252,+,33213
220,BUMA.1121.00086,2,905855,939132,+,33277
220,BUMA.1121.00024,2,615145,648366,+,33221
220,BUMA.1121.00010,2,1996303,2029538,+,33235
220,BUMA.1121.00040,2,1273976,1307195,-,33219
220,BUMA.1121.00093,2,1731354,1764554,-,33200
220,BUMA.1121.00091,2,2427459,2460679,-,33220
220,BUMA.1121.00107,2,2645535,2678771,-,33236
220,BUMA.1121.00088,2,1110712,1144099,+,33387
220,BUMA.1121.00047,2,2097249,2130588,+,33339
220,BUMA.1121.00019,2,679772,712958,+,33186
220,BUMA.1121.00087,2,1173275,1206629,+,33354
220,BUMA.1121.00039,2,2754379,2787536,-,33157
220,BUMA.1121.00030,2,1499458,1532658,-,33200
220,BUMA.1121.00016,2,2503855,2537159,-,33304
220,BUMA.1121.00092,2,1180502,1213723,+,33221
220,BUMA.1121.00085,2,320034,353384,-,33350
220,BUMA.1121.00046,2,1622824,1656432,+,33608
220,BUMA.1121.00003,2,2714960,2748260,-,33300
220,BUMA.1121.00054,2,669548,702788,+,33240
220,BUMA.1121.00015,2,1301111,1334407,-,33296
220,BUMA.1121.00105,2,1322262,1355554,-,33292
220,BUMA.1121.00052,2,1008591,1041941,-,33350
220,BUMA.1121.00053,2,1454187,1487470,+,33283
220,BUMA.1121.00057,2,891537,924758,-,33221
220,BUMA.1121.00108,2,1395724,1428855,+,33131
220,BUMA.1121.00050,2,1239122,1272626,+,33504
220,BUMA.1121.00104,2,1261554,1294742,+,33188
220,BUMA.1121.00014,2,1293657,1326952,+,33295
220,BUMA.1121.00036,2,157696,190910,+,33214
220,BUMA.1121.00038,2,869435,902675,+,33240
220,BUMA.1121.00098,2,1424160,1457311,+,33151
220,BUMA.1121.00078,2,1970652,2003950,-,33298
220,BUMA.1121.00029,2,118334,151523,-,33189
220,BUMA.1121.00099,2,1425867,1458932,+,33065
220,BUMA.1121.00103,2,3084583,3117760,+,33177
220,BUMA.1121.00102,2,1217704,1251128,+,33424
220,BUMA.1121.00028,2,615240,648426,+,33186
220,BUMA.1121.00075,2,1460828,1494096,+,33268
220,BUMA.1121.00044,2,640257,673443,+,33186
220,BUMA.1121.00076,2,2054869,2088091,+,33222
220,BUMA.1121.00074,2,3162394,3195594,-,33200
220,BUMA.1121.00073,2,1143701,1176914,+,33213
220,BUMA.1121.00083,2,2970792,3004005,+,33213
220,BUMA.1121.00035,2,96848,130016,-,33168
220,BUMA.1121.00072,2,1139863,1173076,+,33213
220,BUMA.1121.00056,2,2805287,2838466,-,33179
220,BUMA.1121.00081,2,1420875,1454115,-,33240
220,BUMA.1121.00033,2,1907938,1941121,+,33183
220,BUMA.1121.00061,2,1133676,1166888,+,33212
220,BUMA.1121.00062,2,581530,614752,-,33222
220,BUMA.1121.00064,2,1083482,1116702,+,33220
220,BUMA.1121.00060,2,1001884,1035033,-,33149
220,BUMA.1121.00069,2,1141508,1174721,+,33213
220,BUMA.1121.00070,2,1143754,1176967,+,33213
220,BUMA.1121.00068,2,2876335,2910140,+,33805
220,BUMA.1121.00067,2,2776712,2809933,-,33221
220,BUMA.1121.00037,2,1529140,1562339,+,33199
220,BUMA.1121.00065,2,1215037,1248219,+,33182
220,BUMA.1121.00058,2,1717155,1750378,+,33223
220,BUMA.1121.00041,2,2111405,2144422,+,33017
220,BUMA.1121.00084,2,2995075,3028235,+,33160
220,BUMA.1121.00096,2,1382823,1416149,+,33326
220,BUMA.1121.00080,2,1168658,1201927,+,33269
220,BUMA.1121.00013,2,1615583,1648856,-,33273
220,BUMA.1121.00100,2,2273406,2306826,+,33420
220,BUMA.1121.00012,2,499426,532683,-,33257
220,BUMA.1121.00018,2,2600071,2633319,-,33248
220,BUMA.1121.00048,2,2160223,2193463,-,33240
220,BUMA.1121.00106,2,618482,651683,-,33201
220,BUMA.1121.00017,2,589108,622301,+,33193
220,BUMA.1121.00082,2,1173835,1207048,+,33213
219,BUMA.1121.00049,2,2965103,2981690,+,16587
219,BUMA.1121.00055,2,1504168,1520747,-,16579
219,BUMA.1121.00011,2,3029276,3045907,+,16631
219,BUMA.1121.00110,2,1233099,1249624,-,16525
219,BUMA.1121.00109,2,244541,261038,-,16497
219,BUMA.1121.00077,2,2526766,2543297,-,16531
219,BUMA.1121.00027,2,2208738,2225366,+,16628
219,BUMA.1121.00026,2,101714,118218,-,16504
219,BUMA.1121.00021,2,1669960,1686553,+,16593
219,BUMA.1121.00023,2,1244799,1261366,+,16567
219,BUMA.1121.00022,2,81923,98515,+,16592
219,BUMA.1121.00034,2,572493,589066,+,16573
219,BUMA.1121.00025,2,2970207,2986683,-,16476
219,BUMA.1121.00031,2,341987,358564,+,16577
219,BUMA.1121.00007,2,1192701,1209335,+,16634
219,BUMA.1121.00097,2,999909,1016553,+,16644
219,BUMA.1121.00008,2,662417,678990,+,16573
219,BUMA.1121.00059,2,2491465,2507982,-,16517
219,BUMA.1121.00002,2,1123824,1140411,+,16587
219,BUMA.1121.00004,2,663144,679717,+,16573
219,BUMA.1121.00005,2,2584385,2601004,+,16619
219,BUMA.1121.00111,2,426110,442801,+,16691
219,BUMA.1121.00006,2,852722,869323,+,16601
219,BUMA.1121.00009,2,3053108,3069752,+,16644
219,BUMA.1121.00094,2,1194010,1210637,+,16627
219,BUMA.1121.00101,2,2244769,2261343,-,16574
219,BUMA.1121.00066,2,1132501,1149181,+,16680
219,BUMA.1121.00095,2,125630,142142,-,16512
219,BUMA.1121.00112,2,3221951,3238505,-,16554
219,BUMA.1121.00042,2,138273,154881,+,16608
219,BUMA.1121.00032,2,1065053,1081626,+,16573
219,BUMA.1121.00090,2,2138646,2155225,+,16579
219,BUMA.1121.00020,2,663151,679724,+,16573
219,BUMA.1121.00089,2,1138833,1155455,+,16622
219,BUMA.1121.00051,2,1150708,1167405,+,16697
219,BUMA.1121.00001,2,1042547,1059037,-,16490
219,BUMA.1121.00045,2,1042167,1058804,+,16637
219,BUMA.1121.00043,2,1201572,1218007,-,16435
219,BUMA.1121.00063,2,1125991,1142672,+,16681
219,BUMA.1121.00079,2,1151242,1167945,+,16703
219,BUMA.1121.00071,2,1126274,1142962,+,16688
219,BUMA.1121.00086,2,889198,905778,+,16580
219,BUMA.1121.00024,2,598495,615068,+,16573
219,BUMA.1121.00010,2,1979639,1996226,+,16587
219,BUMA.1121.00040,2,1307272,1323796,-,16524
219,BUMA.1121.00093,2,1764631,1781134,-,16503
219,BUMA.1121.00091,2,2460759,2477264,-,16505
219,BUMA.1121.00107,2,2678848,2695438,-,16590
219,BUMA.1121.00088,2,1093995,1110635,+,16640
219,BUMA.1121.00047,2,2080469,2097173,+,16704
219,BUMA.1121.00019,2,663122,679695,+,16573
219,BUMA.1121.00087,2,1156618,1173198,+,16580
219,BUMA.1121.00039,2,2790655,2807140,-,16485
219,BUMA.1121.00030,2,1532735,1549204,-,16469
219,BUMA.1121.00016,2,2538868,2555372,-,16504
219,BUMA.1121.00092,2,1163818,1180425,+,16607
219,BUMA.1121.00085,2,353461,369965,-,16504
219,BUMA.1121.00046,2,1606146,1622747,+,16601
219,BUMA.1121.00003,2,2748340,2764862,-,16522
219,BUMA.1121.00054,2,652870,669471,+,16601
219,BUMA.1121.00015,2,1334484,1351002,-,16518
219,BUMA.1121.00105,2,1355634,1372164,-,16530
219,BUMA.1121.00052,2,1042018,1058522,-,16504
219,BUMA.1121.00053,2,1437491,1454110,+,16619
219,BUMA.1121.00057,2,924834,941357,-,16523
219,BUMA.1121.00108,2,1378899,1395647,+,16748
219,BUMA.1121.00050,2,1222444,1239045,+,16601
219,BUMA.1121.00104,2,1244830,1261477,+,16647
219,BUMA.1121.00014,2,1275356,1291947,+,16591
219,BUMA.1121.00036,2,141018,157619,+,16601
219,BUMA.1121.00038,2,852757,869358,+,16601
219,BUMA.1121.00098,2,1407407,1424083,+,16676
219,BUMA.1121.00078,2,2004027,2020552,-,16525
219,BUMA.1121.00029,2,153233,169800,-,16567
219,BUMA.1121.00099,2,1409129,1425790,+,16661
219,BUMA.1121.00103,2,3067913,3084506,+,16593
219,BUMA.1121.00102,2,1200991,1217627,+,16636
219,BUMA.1121.00028,2,598590,615163,+,16573
219,BUMA.1121.00075,2,1444140,1460751,+,16611
219,BUMA.1121.00044,2,623607,640180,+,16573
219,BUMA.1121.00076,2,2038179,2054792,+,16613
219,BUMA.1121.00074,2,3195674,3212183,-,16509
219,BUMA.1121.00073,2,1126935,1143624,+,16689
219,BUMA.1121.00083,2,2954026,2970715,+,16689
219,BUMA.1121.00035,2,131726,148300,-,16574
219,BUMA.1121.00072,2,1123097,1139786,+,16689
219,BUMA.1121.00056,2,2838546,2855064,-,16518
219,BUMA.1121.00081,2,1454192,1470689,-,16497
219,BUMA.1121.00033,2,1889651,1906229,+,16578
219,BUMA.1121.00061,2,1116918,1133599,+,16681
219,BUMA.1121.00062,2,614832,631364,-,16532
219,BUMA.1121.00064,2,1066790,1083405,+,16615
219,BUMA.1121.00060,2,1035110,1051643,-,16533
219,BUMA.1121.00069,2,1124755,1141431,+,16676
219,BUMA.1121.00070,2,1126988,1143677,+,16689
219,BUMA.1121.00068,2,2859603,2876258,+,16655
219,BUMA.1121.00067,2,2810013,2826529,-,16516
219,BUMA.1121.00037,2,1510858,1527430,+,16572
219,BUMA.1121.00065,2,1196730,1213326,+,16596
219,BUMA.1121.00058,2,1700406,1717075,+,16669
219,BUMA.1121.00041,2,2093735,2111328,+,17593
219,BUMA.1121.00084,2,2978330,2994998,+,16668
219,BUMA.1121.00096,2,1366115,1382743,+,16628
219,BUMA.1121.00080,2,1151878,1168582,+,16704
219,BUMA.1121.00013,2,1648933,1665437,-,16504
219,BUMA.1121.00100,2,2256591,2273329,+,16738
219,BUMA.1121.00012,2,534392,550839,-,16447
219,BUMA.1121.00018,2,2636343,2652819,-,16476
219,BUMA.1121.00048,2,2193540,2210037,-,16497
219,BUMA.1121.00106,2,651763,668288,-,16525
219,BUMA.1121.00017,2,572458,589031,+,16573
219,BUMA.1121.00082,2,1157069,1173758,+,16689
218,BUMA.1121.00049,2,2956183,2964646,+,8463
218,BUMA.1121.00055,2,1521286,1529757,-,8471
218,BUMA.1121.00011,2,3020381,3028841,+,8460
218,BUMA.1121.00110,2,1250199,1258614,-,8415
218,BUMA.1121.00109,2,261775,270381,-,8606
218,BUMA.1121.00077,2,2543872,2552289,-,8417
218,BUMA.1121.00027,2,2199465,2208087,+,8622
218,BUMA.1121.00026,2,118856,127473,-,8617
218,BUMA.1121.00021,2,1660865,1669471,+,8606
218,BUMA.1121.00023,2,1235757,1244364,+,8607
218,BUMA.1121.00022,2,72771,81389,+,8618
218,BUMA.1121.00034,2,563404,572022,+,8618
218,BUMA.1121.00025,2,2987222,2995828,-,8606
218,BUMA.1121.00031,2,332873,341480,+,8607
218,BUMA.1121.00007,2,1183707,1192185,+,8478
218,BUMA.1121.00097,2,990986,999456,+,8470
218,BUMA.1121.00008,2,653328,661946,+,8618
218,BUMA.1121.00059,2,2508665,2517135,-,8470
218,BUMA.1121.00002,2,1114636,1123254,+,8618
218,BUMA.1121.00004,2,654055,662673,+,8618
218,BUMA.1121.00005,2,2575444,2583908,+,8464
218,BUMA.1121.00111,2,417021,425648,+,8627
218,BUMA.1121.00006,2,843530,852143,+,8613
218,BUMA.1121.00009,2,3044191,3052655,+,8464
218,BUMA.1121.00094,2,1185132,1193512,+,8380
218,BUMA.1121.00101,2,2261900,2270360,-,8460
218,BUMA.1121.00066,2,1123358,1131970,+,8612
218,BUMA.1121.00095,2,142726,151193,-,8467
218,BUMA.1121.00112,2,3239107,3247726,-,8619
218,BUMA.1121.00042,2,129049,137667,+,8618
218,BUMA.1121.00032,2,1055964,1064582,+,8618
218,BUMA.1121.00090,2,2129577,2138184,+,8607
218,BUMA.1121.00020,2,654062,662680,+,8618
218,BUMA.1121.00089,2,1129946,1138335,+,8389
218,BUMA.1121.00051,2,1141650,1150030,+,8380
218,BUMA.1121.00001,2,1059576,1068182,-,8606
218,BUMA.1121.00045,2,1033168,1041732,+,8564
218,BUMA.1121.00043,2,1218573,1227179,-,8606
218,BUMA.1121.00063,2,1116880,1125466,+,8586
218,BUMA.1121.00079,2,1142211,1150591,+,8380
218,BUMA.1121.00071,2,1117131,1125743,+,8612
218,BUMA.1121.00086,2,880019,888637,+,8618
218,BUMA.1121.00024,2,589406,598024,+,8618
218,BUMA.1121.00010,2,1970532,1979150,+,8618
218,BUMA.1121.00040,2,1324398,1333015,-,8617
218,BUMA.1121.00093,2,1781727,1790209,-,8482
218,BUMA.1121.00091,2,2477803,2486272,-,8469
218,BUMA.1121.00107,2,2696067,2704687,-,8620
218,BUMA.1121.00088,2,1085040,1093524,+,8484
218,BUMA.1121.00047,2,2071502,2079818,+,8316
218,BUMA.1121.00019,2,654033,662651,+,8618
218,BUMA.1121.00087,2,1147439,1156057,+,8618
218,BUMA.1121.00039,2,2807706,2816312,-,8606
218,BUMA.1121.00030,2,1549779,1558396,-,8617
218,BUMA.1121.00016,2,2555911,2564528,-,8617
218,BUMA.1121.00092,2,1154846,1163329,+,8483
218,BUMA.1121.00085,2,370747,379364,-,8617
218,BUMA.1121.00046,2,1596940,1605558,+,8618
218,BUMA.1121.00003,2,2765464,2773933,-,8469
218,BUMA.1121.00054,2,643678,652291,+,8613
218,BUMA.1121.00015,2,1351649,1360266,-,8617
218,BUMA.1121.00105,2,1372730,1381212,-,8482
218,BUMA.1121.00052,2,1059304,1067921,-,8617
218,BUMA.1121.00053,2,1428330,1436948,+,8618
218,BUMA.1121.00057,2,942076,950693,-,8617
218,BUMA.1121.00108,2,1369729,1378340,+,8611
218,BUMA.1121.00050,2,1213238,1221856,+,8618
218,BUMA.1121.00104,2,1235701,1244296,+,8595
218,BUMA.1121.00014,2,1266278,1274885,+,8607
218,BUMA.1121.00036,2,131794,140412,+,8618
218,BUMA.1121.00038,2,843565,852178,+,8613
218,BUMA.1121.00098,2,1398504,1406936,+,8432
218,BUMA.1121.00078,2,2021235,2029851,-,8616
218,BUMA.1121.00029,2,170339,178945,-,8606
218,BUMA.1121.00099,2,1400305,1408717,+,8412
218,BUMA.1121.00103,2,3057413,3065842,+,8429
218,BUMA.1121.00102,2,1191884,1200502,+,8618
218,BUMA.1121.00028,2,589501,598119,+,8618
218,BUMA.1121.00075,2,1435063,1443633,+,8570
218,BUMA.1121.00044,2,614518,623136,+,8618
218,BUMA.1121.00076,2,2029101,2037672,+,8571
218,BUMA.1121.00074,2,3212803,3221285,-,8482
218,BUMA.1121.00073,2,1117824,1126404,+,8580
218,BUMA.1121.00083,2,2944883,2953501,+,8618
218,BUMA.1121.00035,2,148839,157445,-,8606
218,BUMA.1121.00072,2,1113954,1122572,+,8618
218,BUMA.1121.00056,2,2855666,2864054,-,8388
218,BUMA.1121.00081,2,1471372,1479984,-,8612
218,BUMA.1121.00033,2,1880600,1889207,+,8607
218,BUMA.1121.00061,2,1107808,1116387,+,8579
218,BUMA.1121.00062,2,631948,640431,-,8483
218,BUMA.1121.00064,2,1057730,1066346,+,8616
218,BUMA.1121.00060,2,1052182,1060745,-,8563
218,BUMA.1121.00069,2,1115645,1124230,+,8585
218,BUMA.1121.00070,2,1117878,1126457,+,8579
218,BUMA.1121.00068,2,2850608,2859071,+,8463
218,BUMA.1121.00067,2,2827167,2835649,-,8482
218,BUMA.1121.00037,2,1501789,1510396,+,8607
218,BUMA.1121.00065,2,1187769,1196232,+,8463
218,BUMA.1121.00058,2,1691465,1699926,+,8461
218,BUMA.1121.00041,2,2084582,2093192,+,8610
218,BUMA.1121.00084,2,2969357,2977841,+,8484
218,BUMA.1121.00096,2,1357146,1365608,+,8462
218,BUMA.1121.00080,2,1142784,1151164,+,8380
218,BUMA.1121.00013,2,1666164,1674781,-,8617
218,BUMA.1121.00100,2,2247761,2256198,+,8437
218,BUMA.1121.00012,2,551396,560002,-,8606
218,BUMA.1121.00018,2,2653358,2661964,-,8606
218,BUMA.1121.00048,2,2210720,2219332,-,8612
218,BUMA.1121.00106,2,668872,677501,-,8629
218,BUMA.1121.00017,2,563369,571987,+,8618
218,BUMA.1121.00082,2,1147926,1156544,+,8618
217,BUMA.1121.00049,2,2947888,2955755,+,7867
217,BUMA.1121.00055,2,1530186,1538079,-,7893
217,BUMA.1121.00011,2,3012061,3019953,+,7892
217,BUMA.1121.00110,2,1259043,1266906,-,7863
217,BUMA.1121.00109,2,270810,278684,-,7874
217,BUMA.1121.00077,2,2552717,2560580,-,7863
217,BUMA.1121.00027,2,2191159,2199037,+,7878
217,BUMA.1121.00026,2,127902,135675,-,7773
217,BUMA.1121.00021,2,1652574,1660437,+,7863
217,BUMA.1121.00023,2,1227449,1235329,+,7880
217,BUMA.1121.00025,2,2996257,3004120,-,7863
217,BUMA.1121.00031,2,324565,332445,+,7880
217,BUMA.1121.00007,2,1175368,1183279,+,7911
217,BUMA.1121.00097,2,982680,990558,+,7878
217,BUMA.1121.00059,2,2517564,2525471,-,7907
217,BUMA.1121.00005,2,2567139,2575016,+,7877
217,BUMA.1121.00111,2,408730,416593,+,7863
217,BUMA.1121.00009,2,3035874,3043763,+,7889
217,BUMA.1121.00094,2,1176826,1184704,+,7878
217,BUMA.1121.00101,2,2270789,2278748,-,7959
217,BUMA.1121.00066,2,1115051,1122930,+,7879
217,BUMA.1121.00095,2,151622,159549,-,7927
217,BUMA.1121.00112,2,3248155,3256023,-,7868
217,BUMA.1121.00042,2,120848,128621,+,7773
217,BUMA.1121.00090,2,2121286,2129149,+,7863
217,BUMA.1121.00089,2,1121640,1129518,+,7878
217,BUMA.1121.00051,2,1133345,1141222,+,7877
217,BUMA.1121.00001,2,1068611,1076492,-,7881
217,BUMA.1121.00045,2,1024848,1032740,+,7892
217,BUMA.1121.00043,2,1227608,1235471,-,7863
217,BUMA.1121.00063,2,1108573,1116452,+,7879
217,BUMA.1121.00079,2,1133906,1141783,+,7877
217,BUMA.1121.00071,2,1108824,1116703,+,7879
217,BUMA.1121.00093,2,1790638,1798511,-,7873
217,BUMA.1121.00091,2,2486701,2494569,-,7868
217,BUMA.1121.00107,2,2705116,2712993,-,7877
217,BUMA.1121.00088,2,1076734,1084612,+,7878
217,BUMA.1121.00047,2,2063197,2071074,+,7877
217,BUMA.1121.00039,2,2816741,2824622,-,7881
217,BUMA.1121.00016,2,2564957,2572837,-,7880
217,BUMA.1121.00092,2,1146545,1154418,+,7873
217,BUMA.1121.00003,2,2774362,2782284,-,7922
217,BUMA.1121.00105,2,1381641,1389504,-,7863
217,BUMA.1121.00053,2,1420238,1427902,+,7664
217,BUMA.1121.00057,2,951122,959002,-,7880
217,BUMA.1121.00108,2,1361320,1369301,+,7981
217,BUMA.1121.00104,2,1227405,1235273,+,7868
217,BUMA.1121.00014,2,1257970,1265850,+,7880
217,BUMA.1121.00098,2,1390206,1398076,+,7870
217,BUMA.1121.00078,2,2030280,2038157,-,7877
217,BUMA.1121.00029,2,179374,187255,-,7881
217,BUMA.1121.00099,2,1391970,1399877,+,7907
217,BUMA.1121.00103,2,3049059,3056985,+,7926
217,BUMA.1121.00102,2,1183603,1191456,+,7853
217,BUMA.1121.00075,2,1426745,1434635,+,7890
217,BUMA.1121.00076,2,2020783,2028673,+,7890
217,BUMA.1121.00074,2,3221714,3229592,-,7878
217,BUMA.1121.00073,2,1109516,1117396,+,7880
217,BUMA.1121.00083,2,2936575,2944455,+,7880
217,BUMA.1121.00035,2,157874,165755,-,7881
217,BUMA.1121.00072,2,1105646,1113526,+,7880
217,BUMA.1121.00056,2,2864483,2872361,-,7878
217,BUMA.1121.00033,2,1872310,1880172,+,7862
217,BUMA.1121.00061,2,1099501,1107380,+,7879
217,BUMA.1121.00062,2,640860,648758,-,7898
217,BUMA.1121.00064,2,1049429,1057302,+,7873
217,BUMA.1121.00060,2,1061174,1069066,-,7892
217,BUMA.1121.00069,2,1107337,1115217,+,7880
217,BUMA.1121.00070,2,1109570,1117450,+,7880
217,BUMA.1121.00068,2,2842279,2850180,+,7901
217,BUMA.1121.00067,2,2836078,2843956,-,7878
217,BUMA.1121.00037,2,1493498,1501361,+,7863
217,BUMA.1121.00065,2,1179480,1187341,+,7861
217,BUMA.1121.00058,2,1683148,1691037,+,7889
217,BUMA.1121.00041,2,2076277,2084154,+,7877
217,BUMA.1121.00084,2,2961051,2968929,+,7878
217,BUMA.1121.00096,2,1348803,1356718,+,7915
217,BUMA.1121.00080,2,1134479,1142356,+,7877
217,BUMA.1121.00100,2,2239459,2247333,+,7874
217,BUMA.1121.00012,2,560431,568294,-,7863
217,BUMA.1121.00018,2,2662393,2670256,-,7863
217,BUMA.1121.00106,2,677930,685798,-,7868
217,BUMA.1121.00082,2,1139618,1147498,+,7880
216,BUMA.1121.00049,2,2940504,2947201,+,6697
216,BUMA.1121.00055,2,1538769,1545504,-,6735
216,BUMA.1121.00011,2,3004647,3011371,+,6724
216,BUMA.1121.00110,2,1267593,1274270,-,6677
216,BUMA.1121.00109,2,279376,286062,-,6686
216,BUMA.1121.00077,2,2561267,2567944,-,6677
216,BUMA.1121.00027,2,2183762,2190472,+,6710
216,BUMA.1121.00026,2,137323,144003,-,6680
216,BUMA.1121.00021,2,1645166,1651887,+,6721
216,BUMA.1121.00023,2,1220016,1226762,+,6746
216,BUMA.1121.00022,2,831669,838349,-,6680
216,BUMA.1121.00034,2,514393,521073,+,6680
216,BUMA.1121.00025,2,3004807,3011513,-,6706
216,BUMA.1121.00031,2,317145,323878,+,6733
216,BUMA.1121.00007,2,1167996,1174682,+,6686
216,BUMA.1121.00097,2,975318,981993,+,6675
216,BUMA.1121.00008,2,604895,611575,+,6680
216,BUMA.1121.00059,2,2526158,2532857,-,6699
216,BUMA.1121.00002,2,1826056,1832736,-,6680
216,BUMA.1121.00004,2,605044,611724,+,6680
216,BUMA.1121.00005,2,2559730,2566452,+,6722
216,BUMA.1121.00111,2,401322,408043,+,6721
216,BUMA.1121.00006,2,1590041,1596721,-,6680
216,BUMA.1121.00009,2,3028495,3035187,+,6692
216,BUMA.1121.00094,2,1169430,1176139,+,6709
216,BUMA.1121.00101,2,2279438,2286148,-,6710
216,BUMA.1121.00066,2,1107649,1114364,+,6715
216,BUMA.1121.00095,2,160239,166923,-,6684
216,BUMA.1121.00112,2,3256710,3263410,-,6700
216,BUMA.1121.00042,2,112903,119583,+,6680
216,BUMA.1121.00032,2,1029345,1036025,+,6680
216,BUMA.1121.00090,2,2113878,2120599,+,6721
216,BUMA.1121.00020,2,605051,611731,+,6680
216,BUMA.1121.00089,2,1114244,1120953,+,6709
216,BUMA.1121.00051,2,1125950,1132658,+,6708
216,BUMA.1121.00001,2,1077179,1083879,-,6700
216,BUMA.1121.00045,2,1017453,1024161,+,6708
216,BUMA.1121.00043,2,1236161,1242854,-,6693
216,BUMA.1121.00063,2,1101171,1107886,+,6715
216,BUMA.1121.00079,2,1126510,1133219,+,6709
216,BUMA.1121.00071,2,1101422,1108137,+,6715
216,BUMA.1121.00086,2,1639550,1646230,-,6680
216,BUMA.1121.00024,2,540395,547075,+,6680
216,BUMA.1121.00010,2,584807,591487,-,6680
216,BUMA.1121.00040,2,1577770,1584450,-,6680
216,BUMA.1121.00093,2,1799198,1805901,-,6703
216,BUMA.1121.00091,2,2495256,2501927,-,6671
216,BUMA.1121.00107,2,2713680,2720375,-,6695
216,BUMA.1121.00088,2,1069314,1076047,+,6733
216,BUMA.1121.00047,2,2055801,2062510,+,6709
216,BUMA.1121.00019,2,605022,611702,+,6680
216,BUMA.1121.00087,2,1906953,1913633,-,6680
216,BUMA.1121.00039,2,2825312,2832011,-,6699
216,BUMA.1121.00030,2,1600728,1607408,-,6680
216,BUMA.1121.00016,2,2573524,2580216,-,6692
216,BUMA.1121.00092,2,1139085,1145858,+,6773
216,BUMA.1121.00046,2,2068900,2075580,-,6680
216,BUMA.1121.00046,2,2146126,2152790,-,6664
216,BUMA.1121.00003,2,2782974,2789689,-,6715
216,BUMA.1121.00054,2,1390158,1396838,-,6680
216,BUMA.1121.00015,2,1466820,1473500,-,6680
216,BUMA.1121.00105,2,1390191,1396888,-,6697
216,BUMA.1121.00053,2,1412858,1419551,+,6693
216,BUMA.1121.00057,2,959689,966399,-,6710
216,BUMA.1121.00108,2,1353941,1360633,+,6692
216,BUMA.1121.00050,2,1684889,1691569,-,6680
216,BUMA.1121.00104,2,1220021,1226718,+,6697
216,BUMA.1121.00014,2,1250556,1257283,+,6727
216,BUMA.1121.00036,2,18450,25130,+,6680
216,BUMA.1121.00038,2,1491235,1497915,-,6680
216,BUMA.1121.00098,2,1382780,1389519,+,6739
216,BUMA.1121.00078,2,2038844,2045519,-,6675
216,BUMA.1121.00029,2,187942,194641,-,6699
216,BUMA.1121.00099,2,1384607,1391280,+,6673
216,BUMA.1121.00103,2,3041672,3048369,+,6697
216,BUMA.1121.00102,2,1176201,1182916,+,6715
216,BUMA.1121.00028,2,540490,547170,+,6680
216,BUMA.1121.00075,2,1419362,1426058,+,6696
216,BUMA.1121.00044,2,565509,572189,+,6680
216,BUMA.1121.00076,2,2013399,2020096,+,6697
216,BUMA.1121.00074,2,3230279,3236954,-,6675
216,BUMA.1121.00073,2,1102125,1108829,+,6704
216,BUMA.1121.00083,2,2929173,2935888,+,6715
216,BUMA.1121.00035,2,166442,173141,-,6699
216,BUMA.1121.00072,2,1098244,1104959,+,6715
216,BUMA.1121.00056,2,2873048,2879747,-,6699
216,BUMA.1121.00081,2,726793,733473,+,6680
216,BUMA.1121.00033,2,1864916,1871620,+,6704
216,BUMA.1121.00061,2,1092105,1098814,+,6709
216,BUMA.1121.00062,2,649445,656145,-,6700
216,BUMA.1121.00064,2,1042037,1048742,+,6705
216,BUMA.1121.00060,2,1069753,1076445,-,6692
216,BUMA.1121.00069,2,1099947,1106650,+,6703
216,BUMA.1121.00070,2,1102180,1108883,+,6703
216,BUMA.1121.00068,2,2834894,2841592,+,6698
216,BUMA.1121.00067,2,2844643,2851318,-,6675
216,BUMA.1121.00037,2,1486089,1492811,+,6722
216,BUMA.1121.00065,2,1172095,1178793,+,6698
216,BUMA.1121.00058,2,1675787,1682461,+,6674
216,BUMA.1121.00041,2,2068878,2075590,+,6712
216,BUMA.1121.00084,2,2953607,2960364,+,6757
216,BUMA.1121.00096,2,1341434,1348113,+,6679
216,BUMA.1121.00080,2,1127083,1133792,+,6709
216,BUMA.1121.00013,2,1936567,1943247,-,6680
216,BUMA.1121.00100,2,2232034,2238772,+,6738
216,BUMA.1121.00012,2,568981,575681,-,6700
216,BUMA.1121.00018,2,2670943,2677649,-,6706
216,BUMA.1121.00048,2,1466187,1472867,+,6680
216,BUMA.1121.00106,2,686485,693182,-,6697
216,BUMA.1121.00017,2,514359,521039,+,6680
216,BUMA.1121.00082,2,1132216,1138931,+,6715
215,BUMA.1121.00049,2,2931631,2936771,+,5140
215,BUMA.1121.00055,2,1549293,1554434,-,5141
215,BUMA.1121.00011,2,2995721,3000842,+,5121
215,BUMA.1121.00110,2,1278071,1283198,-,5127
215,BUMA.1121.00109,2,289852,294993,-,5141
215,BUMA.1121.00077,2,2571745,2576872,-,5127
215,BUMA.1121.00027,2,2174827,2179964,+,5137
215,BUMA.1121.00026,2,147693,152641,-,4948
215,BUMA.1121.00021,2,1636285,1641429,+,5144
215,BUMA.1121.00023,2,1211123,1216241,+,5118
215,BUMA.1121.00022,2,842050,847218,-,5168
215,BUMA.1121.00034,2,505519,510685,+,5166
215,BUMA.1121.00025,2,3015320,3020457,-,5137
215,BUMA.1121.00031,2,308138,313346,+,5208
215,BUMA.1121.00007,2,1159018,1164195,+,5177
215,BUMA.1121.00097,2,966403,971552,+,5149
215,BUMA.1121.00008,2,596021,601187,+,5166
215,BUMA.1121.00059,2,2536705,2541841,-,5136
215,BUMA.1121.00002,2,1836437,1841604,-,5167
215,BUMA.1121.00004,2,596170,601336,+,5166
215,BUMA.1121.00005,2,2550853,2555994,+,5141
215,BUMA.1121.00111,2,392431,397589,+,5158
215,BUMA.1121.00006,2,1600422,1605603,-,5181
215,BUMA.1121.00009,2,3019548,3024690,+,5142
215,BUMA.1121.00094,2,1160514,1165615,+,5101
215,BUMA.1121.00101,2,2290010,2295174,-,5164
215,BUMA.1121.00066,2,1098782,1103838,+,5056
215,BUMA.1121.00095,2,170723,175807,-,5084
215,BUMA.1121.00112,2,40,5147,-,5107
215,BUMA.1121.00042,2,104035,109201,+,5166
215,BUMA.1121.00032,2,1020471,1025637,+,5166
215,BUMA.1121.00090,2,2104954,2110139,+,5185
215,BUMA.1121.00020,2,596177,601343,+,5166
215,BUMA.1121.00089,2,1105328,1110429,+,5101
215,BUMA.1121.00051,2,1117035,1122135,+,5100
215,BUMA.1121.00001,2,1087663,1092766,-,5103
215,BUMA.1121.00045,2,1008505,1013620,+,5115
215,BUMA.1121.00043,2,1246686,1251789,-,5103
215,BUMA.1121.00063,2,1092230,1097364,+,5134
215,BUMA.1121.00079,2,1117561,1122701,+,5140
215,BUMA.1121.00071,2,1092477,1097611,+,5134
215,BUMA.1121.00086,2,1649931,1655099,-,5168
215,BUMA.1121.00024,2,531521,536687,+,5166
215,BUMA.1121.00010,2,595188,600355,-,5167
215,BUMA.1121.00040,2,1588157,1593324,-,5167
215,BUMA.1121.00093,2,1809781,1814900,-,5119
215,BUMA.1121.00091,2,2505668,2510809,-,5141
215,BUMA.1121.00107,2,2724140,2729277,-,5137
215,BUMA.1121.00088,2,1060425,1065569,+,5144
215,BUMA.1121.00047,2,2046891,2051992,+,5101
215,BUMA.1121.00019,2,596148,601314,+,5166
215,BUMA.1121.00087,2,1917334,1922502,-,5168
215,BUMA.1121.00039,2,2835836,2841008,-,5172
215,BUMA.1121.00030,2,1611115,1616282,-,5167
215,BUMA.1121.00016,2,2583983,2589133,-,5150
215,BUMA.1121.00092,2,1130156,1135274,+,5118
215,BUMA.1121.00046,2,2079281,2084448,-,5167
215,BUMA.1121.00003,2,2793495,2798616,-,5121
215,BUMA.1121.00054,2,1400539,1405720,-,5181
215,BUMA.1121.00015,2,1477201,1482368,-,5167
215,BUMA.1121.00105,2,1400690,1405826,-,5136
215,BUMA.1121.00053,2,1403997,1409125,+,5128
215,BUMA.1121.00057,2,970225,975372,-,5147
215,BUMA.1121.00108,2,1344989,1350118,+,5129
215,BUMA.1121.00050,2,1695270,1700437,-,5167
215,BUMA.1121.00104,2,1211148,1216288,+,5140
215,BUMA.1121.00014,2,1241573,1246763,+,5190
215,BUMA.1121.00036,2,9575,14742,+,5167
215,BUMA.1121.00038,2,1501616,1506797,-,5181
215,BUMA.1121.00098,2,1373847,1378981,+,5134
215,BUMA.1121.00078,2,2049243,2054368,-,5125
215,BUMA.1121.00029,2,198389,203492,-,5103
215,BUMA.1121.00099,2,1375514,1380672,+,5158
215,BUMA.1121.00103,2,3032760,3037849,+,5089
215,BUMA.1121.00102,2,1167373,1172487,+,5114
215,BUMA.1121.00028,2,531616,536782,+,5166
215,BUMA.1121.00075,2,1410480,1415629,+,5149
215,BUMA.1121.00044,2,556635,561801,+,5166
215,BUMA.1121.00076,2,2004517,2009666,+,5149
215,BUMA.1121.00074,2,3240699,3245838,-,5139
215,BUMA.1121.00073,2,1093180,1098314,+,5134
215,BUMA.1121.00083,2,2920228,2925362,+,5134
215,BUMA.1121.00035,2,176913,182016,-,5103
215,BUMA.1121.00072,2,1089372,1094433,+,5061
215,BUMA.1121.00056,2,2883571,2888673,-,5102
215,BUMA.1121.00081,2,717911,723091,+,5180
215,BUMA.1121.00033,2,1856031,1861183,+,5152
215,BUMA.1121.00061,2,1083225,1088359,+,5134
215,BUMA.1121.00062,2,659957,665116,-,5159
215,BUMA.1121.00064,2,1032998,1038196,+,5198
215,BUMA.1121.00060,2,1080293,1085393,-,5100
215,BUMA.1121.00069,2,1091077,1096136,+,5059
215,BUMA.1121.00070,2,1093235,1098369,+,5134
215,BUMA.1121.00068,2,2825956,2831096,+,5140
215,BUMA.1121.00067,2,2855063,2860202,-,5139
215,BUMA.1121.00037,2,1477212,1482356,+,5144
215,BUMA.1121.00065,2,1163166,1168292,+,5126
215,BUMA.1121.00058,2,1666840,1671984,+,5144
215,BUMA.1121.00041,2,2060052,2065140,+,5088
215,BUMA.1121.00084,2,2944732,2949876,+,5144
215,BUMA.1121.00096,2,1332436,1337631,+,5195
215,BUMA.1121.00080,2,1118167,1123268,+,5101
215,BUMA.1121.00013,2,1946948,1952115,-,5167
215,BUMA.1121.00100,2,2223105,2228252,+,5147
215,BUMA.1121.00012,2,579429,584544,-,5115
215,BUMA.1121.00018,2,2681456,2686593,-,5137
215,BUMA.1121.00048,2,1457305,1462485,+,5180
215,BUMA.1121.00106,2,696920,702061,-,5141
215,BUMA.1121.00017,2,505485,510651,+,5166
215,BUMA.1121.00082,2,1123271,1128405,+,5134
214,BUMA.1121.00049,2,2924360,2928105,+,3745
214,BUMA.1121.00055,2,1557967,1561715,-,3748
214,BUMA.1121.00011,2,2988400,2992134,+,3734
214,BUMA.1121.00110,2,1286758,1290497,-,3739
214,BUMA.1121.00109,2,298512,302261,-,3749
214,BUMA.1121.00077,2,2580432,2584171,-,3739
214,BUMA.1121.00027,2,2167538,2171285,+,3747
214,BUMA.1121.00026,2,156160,159897,-,3737
214,BUMA.1121.00021,2,1629009,1632754,+,3745
214,BUMA.1121.00023,2,1203860,1207596,+,3736
214,BUMA.1121.00022,2,852324,856061,-,3737
214,BUMA.1121.00034,2,496675,500413,+,3738
214,BUMA.1121.00025,2,3024035,3027759,-,3724
214,BUMA.1121.00031,2,300878,304612,+,3734
214,BUMA.1121.00007,2,1151763,1155490,+,3727
214,BUMA.1121.00097,2,959147,962872,+,3725
214,BUMA.1121.00008,2,587177,590915,+,3738
214,BUMA.1121.00059,2,2545378,2549122,-,3744
214,BUMA.1121.00002,2,1846711,1850448,-,3737
214,BUMA.1121.00004,2,587326,591064,+,3738
214,BUMA.1121.00005,2,2543608,2547341,+,3733
214,BUMA.1121.00111,2,385155,388900,+,3745
214,BUMA.1121.00006,2,1609112,1612849,-,3737
214,BUMA.1121.00009,2,3012279,3016026,+,3747
214,BUMA.1121.00094,2,1153226,1156971,+,3745
214,BUMA.1121.00101,2,2298713,2302463,-,3750
214,BUMA.1121.00066,2,1091530,1095250,+,3720
214,BUMA.1121.00095,2,180786,184575,-,3789
214,BUMA.1121.00112,2,8685,12433,-,3748
214,BUMA.1121.00042,2,96778,100516,+,3738
214,BUMA.1121.00032,2,1011627,1015365,+,3738
214,BUMA.1121.00090,2,2097689,2101423,+,3734
214,BUMA.1121.00020,2,587333,591071,+,3738
214,BUMA.1121.00089,2,1098040,1101785,+,3745
214,BUMA.1121.00051,2,1109729,1113484,+,3755
214,BUMA.1121.00001,2,1096297,1100041,-,3744
214,BUMA.1121.00045,2,1001243,1004983,+,3740
214,BUMA.1121.00043,2,1255322,1259082,-,3760
214,BUMA.1121.00063,2,1084952,1088697,+,3745
214,BUMA.1121.00079,2,1110273,1114028,+,3755
214,BUMA.1121.00071,2,1085221,1088945,+,3724
214,BUMA.1121.00086,2,1660206,1663943,-,3737
214,BUMA.1121.00024,2,522677,526415,+,3738
214,BUMA.1121.00010,2,605459,609196,-,3737
214,BUMA.1121.00040,2,1596833,1600570,-,3737
214,BUMA.1121.00093,2,1818420,1822166,-,3746
214,BUMA.1121.00091,2,2514329,2518073,-,3744
214,BUMA.1121.00107,2,2732805,2736548,-,3743
214,BUMA.1121.00088,2,1053160,1056905,+,3745
214,BUMA.1121.00047,2,2039592,2043348,+,3756
214,BUMA.1121.00019,2,587304,591042,+,3738
214,BUMA.1121.00087,2,1927609,1931346,-,3737
214,BUMA.1121.00039,2,2844547,2848280,-,3733
214,BUMA.1121.00030,2,1621388,1625125,-,3737
214,BUMA.1121.00016,2,2592670,2596414,-,3744
214,BUMA.1121.00092,2,1122889,1126636,+,3747
214,BUMA.1121.00046,2,2087957,2091694,-,3737
214,BUMA.1121.00003,2,2802156,2805882,-,3726
214,BUMA.1121.00054,2,1409229,1412966,-,3737
214,BUMA.1121.00015,2,1485877,1489614,-,3737
214,BUMA.1121.00105,2,1409362,1413119,-,3757
214,BUMA.1121.00053,2,1396740,1400485,+,3745
214,BUMA.1121.00057,2,978905,982649,-,3744
214,BUMA.1121.00108,2,1337673,1341440,+,3767
214,BUMA.1121.00050,2,1703946,1707683,-,3737
214,BUMA.1121.00104,2,1203861,1207606,+,3745
214,BUMA.1121.00014,2,1234313,1238047,+,3734
214,BUMA.1121.00036,2,732,4470,+,3738
214,BUMA.1121.00038,2,1510306,1514043,-,3737
214,BUMA.1121.00098,2,1366584,1370320,+,3736
214,BUMA.1121.00078,2,2057883,2061629,-,3746
214,BUMA.1121.00029,2,207023,210767,-,3744
214,BUMA.1121.00099,2,1368259,1371999,+,3740
214,BUMA.1121.00103,2,3025490,3029230,+,3740
214,BUMA.1121.00102,2,1160097,1163842,+,3745
214,BUMA.1121.00028,2,522772,526510,+,3738
214,BUMA.1121.00075,2,1401627,1405363,+,3736
214,BUMA.1121.00044,2,547791,551529,+,3738
214,BUMA.1121.00076,2,1995664,1999400,+,3736
214,BUMA.1121.00074,2,3249382,3253137,-,3755
214,BUMA.1121.00073,2,1085902,1089647,+,3745
214,BUMA.1121.00083,2,2912950,2916695,+,3745
214,BUMA.1121.00035,2,185547,189291,-,3744
214,BUMA.1121.00072,2,1082119,1085845,+,3726
214,BUMA.1121.00056,2,2892216,2895960,-,3744
214,BUMA.1121.00081,2,710664,714402,+,3738
214,BUMA.1121.00033,2,1848755,1852500,+,3745
214,BUMA.1121.00061,2,1075954,1079693,+,3739
214,BUMA.1121.00062,2,668671,672417,-,3746
214,BUMA.1121.00064,2,1024277,1028022,+,3745
214,BUMA.1121.00060,2,1088931,1092670,-,3739
214,BUMA.1121.00069,2,1083799,1087544,+,3745
214,BUMA.1121.00070,2,1085965,1089702,+,3737
214,BUMA.1121.00068,2,2818667,2822427,+,3760
214,BUMA.1121.00067,2,2863755,2867510,-,3755
214,BUMA.1121.00037,2,1469952,1473686,+,3734
214,BUMA.1121.00065,2,1155887,1159632,+,3745
214,BUMA.1121.00058,2,1659557,1663304,+,3747
214,BUMA.1121.00041,2,2052764,2056522,+,3758
214,BUMA.1121.00084,2,2937467,2941212,+,3745
214,BUMA.1121.00096,2,1325192,1328928,+,3736
214,BUMA.1121.00080,2,1110868,1114624,+,3756
214,BUMA.1121.00013,2,1955624,1959361,-,3737
214,BUMA.1121.00100,2,2215874,2219603,+,3729
214,BUMA.1121.00012,2,589688,593432,-,3744
214,BUMA.1121.00018,2,2690171,2693895,-,3724
214,BUMA.1121.00048,2,1450058,1453796,+,3738
214,BUMA.1121.00106,2,705612,709356,-,3744
214,BUMA.1121.00017,2,496641,500379,+,3738
214,BUMA.1121.00082,2,1115993,1119738,+,3745
213,BUMA.1121.00049,2,2899746,2922422,+,22676
213,BUMA.1121.00055,2,1563650,1586507,-,22857
213,BUMA.1121.00011,2,2963644,2986465,+,22821
213,BUMA.1121.00110,2,1292433,1315185,-,22752
213,BUMA.1121.00109,2,304197,327059,-,22862
213,BUMA.1121.00077,2,2586107,2608860,-,22753
213,BUMA.1121.00027,2,2142820,2165604,+,22784
213,BUMA.1121.00026,2,161832,184744,-,22912
213,BUMA.1121.00021,2,1604230,1627075,+,22845
213,BUMA.1121.00023,2,1179040,1201926,+,22886
213,BUMA.1121.00022,2,857996,880892,-,22896
213,BUMA.1121.00034,2,471843,494740,+,22897
213,BUMA.1121.00025,2,3029695,3052515,-,22820
213,BUMA.1121.00031,2,276051,298942,+,22891
213,BUMA.1121.00007,2,1127012,1149828,+,22816
213,BUMA.1121.00097,2,934365,957212,+,22847
213,BUMA.1121.00008,2,562345,585242,+,22897
213,BUMA.1121.00059,2,2551060,2573877,-,22817
213,BUMA.1121.00002,2,1852401,1875337,-,22936
213,BUMA.1121.00004,2,562494,585391,+,22897
213,BUMA.1121.00005,2,2518828,2541674,+,22846
213,BUMA.1121.00111,2,360324,383221,+,22897
213,BUMA.1121.00006,2,1614784,1637704,-,22920
213,BUMA.1121.00009,2,2987629,3010343,+,22714
213,BUMA.1121.00094,2,1128430,1151288,+,22858
213,BUMA.1121.00101,2,2304399,2327296,-,22897
213,BUMA.1121.00066,2,1066780,1089596,+,22816
213,BUMA.1121.00095,2,186512,209247,-,22735
213,BUMA.1121.00112,2,14368,37155,-,22787
213,BUMA.1121.00042,2,71898,94843,+,22945
213,BUMA.1121.00032,2,986795,1009692,+,22897
213,BUMA.1121.00090,2,2072772,2095753,+,22981
213,BUMA.1121.00020,2,562501,585398,+,22897
213,BUMA.1121.00089,2,1073244,1096102,+,22858
213,BUMA.1121.00051,2,1084927,1107793,+,22866
213,BUMA.1121.00001,2,1101975,1124809,-,22834
213,BUMA.1121.00045,2,976427,999293,+,22866
213,BUMA.1121.00043,2,1262381,1285326,-,22945
213,BUMA.1121.00063,2,1060196,1083018,+,22822
213,BUMA.1121.00079,2,1085504,1108337,+,22833
213,BUMA.1121.00071,2,1060465,1083287,+,22822
213,BUMA.1121.00086,2,1665878,1688792,-,22914
213,BUMA.1121.00024,2,497845,520742,+,22897
213,BUMA.1121.00010,2,611149,634073,-,22924
213,BUMA.1121.00040,2,1602505,1625408,-,22903
213,BUMA.1121.00093,2,1824102,1846893,-,22791
213,BUMA.1121.00091,2,2520007,2542873,-,22866
213,BUMA.1121.00107,2,2738483,2761304,-,22821
213,BUMA.1121.00088,2,1028397,1051226,+,22829
213,BUMA.1121.00047,2,2014801,2037656,+,22855
213,BUMA.1121.00019,2,562472,585369,+,22897
213,BUMA.1121.00087,2,1933281,1956195,-,22914
213,BUMA.1121.00039,2,2850214,2873125,-,22911
213,BUMA.1121.00030,2,1627060,1649958,-,22898
213,BUMA.1121.00016,2,2598348,2621269,-,22921
213,BUMA.1121.00092,2,1098163,1120953,+,22790
213,BUMA.1121.00046,2,2093629,2116616,-,22987
213,BUMA.1121.00003,2,2807818,2830623,-,22805
213,BUMA.1121.00054,2,1414901,1437821,-,22920
213,BUMA.1121.00015,2,1491549,1514528,-,22979
213,BUMA.1121.00105,2,1415053,1437963,-,22910
213,BUMA.1121.00053,2,1372003,1394806,+,22803
213,BUMA.1121.00057,2,984583,1007282,-,22699
213,BUMA.1121.00108,2,1312863,1335739,+,22876
213,BUMA.1121.00050,2,1709618,1732605,-,22987
213,BUMA.1121.00104,2,1179199,1201923,+,22724
213,BUMA.1121.00014,2,1209453,1232377,+,22924
213,BUMA.1121.00036,2,2259984,2282891,+,22907
213,BUMA.1121.00038,2,1515978,1538898,-,22920
213,BUMA.1121.00098,2,1341882,1364649,+,22767
213,BUMA.1121.00078,2,2063565,2086266,-,22701
213,BUMA.1121.00029,2,212701,235544,-,22843
213,BUMA.1121.00099,2,1343600,1366323,+,22723
213,BUMA.1121.00103,2,3000829,3023529,+,22700
213,BUMA.1121.00102,2,1135360,1158163,+,22803
213,BUMA.1121.00028,2,497940,520837,+,22897
213,BUMA.1121.00075,2,1376873,1399701,+,22828
213,BUMA.1121.00044,2,522959,545856,+,22897
213,BUMA.1121.00076,2,1970877,1993738,+,22861
213,BUMA.1121.00074,2,3255071,3277916,-,22845
213,BUMA.1121.00073,2,1061146,1083968,+,22822
213,BUMA.1121.00083,2,2888194,2911016,+,22822
213,BUMA.1121.00035,2,191225,214083,-,22858
213,BUMA.1121.00072,2,1057363,1080185,+,22822
213,BUMA.1121.00056,2,2897898,2920757,-,22859
213,BUMA.1121.00081,2,685810,708729,+,22919
213,BUMA.1121.00033,2,1824066,1846821,+,22755
213,BUMA.1121.00061,2,1051198,1074020,+,22822
213,BUMA.1121.00062,2,674353,697064,-,22711
213,BUMA.1121.00064,2,999610,1022343,+,22733
213,BUMA.1121.00060,2,1094620,1117487,-,22867
213,BUMA.1121.00069,2,1059043,1081865,+,22822
213,BUMA.1121.00070,2,1061209,1084031,+,22822
213,BUMA.1121.00068,2,2793960,2816752,+,22792
213,BUMA.1121.00067,2,2869444,2892259,-,22815
213,BUMA.1121.00037,2,1445028,1468016,+,22988
213,BUMA.1121.00065,2,1131268,1153953,+,22685
213,BUMA.1121.00058,2,1634804,1657621,+,22817
213,BUMA.1121.00041,2,2027962,2050830,+,22868
213,BUMA.1121.00084,2,2912664,2935532,+,22868
213,BUMA.1121.00096,2,1300392,1323256,+,22864
213,BUMA.1121.00080,2,1086083,1108932,+,22849
213,BUMA.1121.00013,2,1961296,1984213,-,22917
213,BUMA.1121.00100,2,2191166,2213939,+,22773
213,BUMA.1121.00012,2,595366,618309,-,22943
213,BUMA.1121.00018,2,2695831,2718651,-,22820
213,BUMA.1121.00048,2,1425204,1448123,+,22919
213,BUMA.1121.00106,2,711294,734007,-,22713
213,BUMA.1121.00017,2,471809,494706,+,22897
213,BUMA.1121.00082,2,1091237,1114059,+,22822
212,BUMA.1121.00049,2,2884043,2898382,+,14339
212,BUMA.1121.00055,2,1587859,1602198,-,14339
212,BUMA.1121.00011,2,2947932,2962250,+,14318
212,BUMA.1121.00110,2,1316513,1330987,-,14474
212,BUMA.1121.00109,2,328399,342856,-,14457
212,BUMA.1121.00077,2,2610188,2624662,-,14474
212,BUMA.1121.00027,2,2127140,2141474,+,14334
212,BUMA.1121.00026,2,186054,200364,-,14310
212,BUMA.1121.00021,2,1588495,1602800,+,14305
212,BUMA.1121.00023,2,1163304,1177609,+,14305
212,BUMA.1121.00022,2,882208,896524,-,14316
212,BUMA.1121.00034,2,456198,470503,+,14305
212,BUMA.1121.00025,2,3053832,3068208,-,14376
212,BUMA.1121.00031,2,260343,274638,+,14295
212,BUMA.1121.00007,2,1111302,1125630,+,14328
212,BUMA.1121.00097,2,918630,932946,+,14316
212,BUMA.1121.00008,2,546700,561005,+,14305
212,BUMA.1121.00059,2,2575278,2589646,-,14368
212,BUMA.1121.00002,2,1876647,1890975,-,14328
212,BUMA.1121.00004,2,546849,561154,+,14305
212,BUMA.1121.00005,2,2503188,2517512,+,14324
212,BUMA.1121.00111,2,344661,358977,+,14316
212,BUMA.1121.00006,2,1639014,1653324,-,14310
212,BUMA.1121.00009,2,2969401,2983734,+,14333
212,BUMA.1121.00094,2,1112780,1127089,+,14309
212,BUMA.1121.00101,2,2328636,2343042,-,14406
212,BUMA.1121.00066,2,1051093,1065420,+,14327
212,BUMA.1121.00095,2,210587,225041,-,14454
212,BUMA.1121.00112,2,38501,52827,-,14326
212,BUMA.1121.00042,2,56259,70564,+,14305
212,BUMA.1121.00032,2,971156,985461,+,14305
212,BUMA.1121.00090,2,2057081,2071386,+,14305
212,BUMA.1121.00020,2,546856,561161,+,14305
212,BUMA.1121.00089,2,1057570,1071879,+,14309
212,BUMA.1121.00051,2,1069276,1083587,+,14311
212,BUMA.1121.00001,2,1126132,1140523,-,14391
212,BUMA.1121.00045,2,960762,975057,+,14295
212,BUMA.1121.00043,2,1286804,1301209,-,14405
212,BUMA.1121.00063,2,1044537,1058864,+,14327
212,BUMA.1121.00079,2,1069824,1084134,+,14310
212,BUMA.1121.00071,2,1044795,1059122,+,14327
212,BUMA.1121.00086,2,1690114,1704431,-,14317
212,BUMA.1121.00024,2,482200,496505,+,14305
212,BUMA.1121.00010,2,635383,649711,-,14328
212,BUMA.1121.00040,2,1626718,1641028,-,14310
212,BUMA.1121.00093,2,1848233,1862664,-,14431
212,BUMA.1121.00091,2,2544195,2558517,-,14322
212,BUMA.1121.00107,2,2762626,2776963,-,14337
212,BUMA.1121.00088,2,1013947,1027021,+,13074
212,BUMA.1121.00047,2,1999145,2013455,+,14310
212,BUMA.1121.00019,2,546827,561132,+,14305
212,BUMA.1121.00087,2,1957517,1971833,-,14316
212,BUMA.1121.00039,2,2874508,2888863,-,14355
212,BUMA.1121.00030,2,1651274,1665602,-,14328
212,BUMA.1121.00016,2,2622645,2636942,-,14297
212,BUMA.1121.00092,2,1082391,1096709,+,14318
212,BUMA.1121.00046,2,2117926,2132236,-,14310
212,BUMA.1121.00003,2,2831939,2846310,-,14371
212,BUMA.1121.00054,2,1439131,1453441,-,14310
212,BUMA.1121.00015,2,1515838,1530142,-,14304
212,BUMA.1121.00105,2,1439279,1453632,-,14353
212,BUMA.1121.00053,2,1356228,1370543,+,14315
212,BUMA.1121.00057,2,1008670,1022933,-,14263
212,BUMA.1121.00108,2,1297236,1311499,+,14263
212,BUMA.1121.00050,2,1733915,1748225,-,14310
212,BUMA.1121.00104,2,1163526,1177853,+,14327
212,BUMA.1121.00014,2,1193715,1208010,+,14295
212,BUMA.1121.00036,2,2244339,2258644,+,14305
212,BUMA.1121.00038,2,1540208,1554518,-,14310
212,BUMA.1121.00098,2,1326208,1340482,+,14274
212,BUMA.1121.00078,2,2087636,2101907,-,14271
212,BUMA.1121.00029,2,236879,251246,-,14367
212,BUMA.1121.00099,2,1327952,1342242,+,14290
212,BUMA.1121.00103,2,2983528,2997820,+,14292
212,BUMA.1121.00102,2,1119637,1133942,+,14305
212,BUMA.1121.00028,2,482295,496600,+,14305
212,BUMA.1121.00075,2,1361180,1375467,+,14287
212,BUMA.1121.00044,2,507314,521619,+,14305
212,BUMA.1121.00076,2,1955235,1969525,+,14290
212,BUMA.1121.00074,2,3279232,3293599,-,14367
212,BUMA.1121.00073,2,1045505,1059832,+,14327
212,BUMA.1121.00083,2,2872467,2886794,+,14327
212,BUMA.1121.00035,2,215430,229797,-,14367
212,BUMA.1121.00072,2,1041669,1055996,+,14327
212,BUMA.1121.00056,2,2922086,2936430,-,14344
212,BUMA.1121.00081,2,670189,684494,+,14305
212,BUMA.1121.00033,2,1808373,1822690,+,14317
212,BUMA.1121.00061,2,1035540,1049867,+,14327
212,BUMA.1121.00062,2,698387,712736,-,14349
212,BUMA.1121.00064,2,983926,998228,+,14302
212,BUMA.1121.00060,2,1118863,1133170,-,14307
212,BUMA.1121.00069,2,1043404,1057731,+,14327
212,BUMA.1121.00070,2,1045526,1059853,+,14327
212,BUMA.1121.00068,2,2778207,2792531,+,14324
212,BUMA.1121.00067,2,2893593,2907936,-,14343
212,BUMA.1121.00037,2,1429292,1443610,+,14318
212,BUMA.1121.00065,2,1115628,1129928,+,14300
212,BUMA.1121.00058,2,1619114,1633428,+,14314
212,BUMA.1121.00041,2,2012250,2026574,+,14324
212,BUMA.1121.00084,2,2896936,2911269,+,14333
212,BUMA.1121.00096,2,1284730,1299034,+,14304
212,BUMA.1121.00080,2,1070415,1084725,+,14310
212,BUMA.1121.00013,2,1985523,1999862,-,14339
212,BUMA.1121.00100,2,2175419,2189748,+,14329
212,BUMA.1121.00012,2,619626,633985,-,14359
212,BUMA.1121.00018,2,2719968,2734350,-,14382
212,BUMA.1121.00048,2,1409583,1423888,+,14305
212,BUMA.1121.00106,2,735347,749715,-,14368
212,BUMA.1121.00017,2,456164,470469,+,14305
212,BUMA.1121.00082,2,1075510,1089837,+,14327
211,BUMA.1121.00049,2,2877183,2883142,+,5959
211,BUMA.1121.00055,2,1603099,1609058,-,5959
211,BUMA.1121.00011,2,2941068,2947031,+,5963
211,BUMA.1121.00110,2,1331888,1337833,-,5945
211,BUMA.1121.00109,2,343757,349702,-,5945
211,BUMA.1121.00077,2,2625563,2631508,-,5945
211,BUMA.1121.00027,2,2120281,2126239,+,5958
211,BUMA.1121.00026,2,201265,207225,-,5960
211,BUMA.1121.00021,2,1581673,1587594,+,5921
211,BUMA.1121.00023,2,1156447,1162403,+,5956
211,BUMA.1121.00022,2,897425,903385,-,5960
211,BUMA.1121.00034,2,449338,455297,+,5959
211,BUMA.1121.00025,2,3069109,3075066,-,5957
211,BUMA.1121.00031,2,253484,259442,+,5958
211,BUMA.1121.00007,2,1104443,1110401,+,5958
211,BUMA.1121.00097,2,911771,917729,+,5958
211,BUMA.1121.00008,2,539840,545799,+,5959
211,BUMA.1121.00059,2,2590547,2596506,-,5959
211,BUMA.1121.00002,2,1891876,1897836,-,5960
211,BUMA.1121.00004,2,539989,545948,+,5959
211,BUMA.1121.00005,2,2496329,2502287,+,5958
211,BUMA.1121.00111,2,337802,343760,+,5958
211,BUMA.1121.00006,2,1654225,1660185,-,5960
211,BUMA.1121.00009,2,2962541,2968500,+,5959
211,BUMA.1121.00094,2,1105920,1111879,+,5959
211,BUMA.1121.00101,2,2343943,2349902,-,5959
211,BUMA.1121.00066,2,1044233,1050192,+,5959
211,BUMA.1121.00095,2,225942,231901,-,5959
211,BUMA.1121.00112,2,53728,59686,-,5958
211,BUMA.1121.00042,2,49399,55358,+,5959
211,BUMA.1121.00032,2,964296,970255,+,5959
211,BUMA.1121.00090,2,2050222,2056180,+,5958
211,BUMA.1121.00020,2,539996,545955,+,5959
211,BUMA.1121.00089,2,1050710,1056669,+,5959
211,BUMA.1121.00051,2,1062416,1068375,+,5959
211,BUMA.1121.00001,2,1141424,1147391,-,5967
211,BUMA.1121.00045,2,953901,959861,+,5960
211,BUMA.1121.00043,2,1302110,1308066,-,5956
211,BUMA.1121.00063,2,1037677,1043636,+,5959
211,BUMA.1121.00079,2,1062964,1068923,+,5959
211,BUMA.1121.00071,2,1037935,1043894,+,5959
211,BUMA.1121.00086,2,1705332,1711292,-,5960
211,BUMA.1121.00024,2,475340,481299,+,5959
211,BUMA.1121.00010,2,650612,656571,-,5959
211,BUMA.1121.00040,2,1641929,1647888,-,5959
211,BUMA.1121.00093,2,1863565,1869533,-,5968
211,BUMA.1121.00091,2,2559418,2565377,-,5959
211,BUMA.1121.00107,2,2777864,2783826,-,5962
211,BUMA.1121.00088,2,1007087,1013046,+,5959
211,BUMA.1121.00047,2,1992285,1998244,+,5959
211,BUMA.1121.00019,2,539967,545926,+,5959
211,BUMA.1121.00087,2,1972734,1978694,-,5960
211,BUMA.1121.00039,2,2889764,2895724,-,5960
211,BUMA.1121.00030,2,1666503,1672463,-,5960
211,BUMA.1121.00016,2,2637843,2643801,-,5958
211,BUMA.1121.00092,2,1075523,1081490,+,5967
211,BUMA.1121.00046,2,2133137,2139097,-,5960
211,BUMA.1121.00003,2,2847211,2853168,-,5957
211,BUMA.1121.00054,2,1454342,1460302,-,5960
211,BUMA.1121.00015,2,1531043,1537003,-,5960
211,BUMA.1121.00105,2,1454533,1460492,-,5959
211,BUMA.1121.00053,2,1349368,1355327,+,5959
211,BUMA.1121.00057,2,1023834,1029794,-,5960
211,BUMA.1121.00108,2,1290371,1296335,+,5964
211,BUMA.1121.00050,2,1749126,1755086,-,5960
211,BUMA.1121.00104,2,1156666,1162625,+,5959
211,BUMA.1121.00014,2,1186856,1192814,+,5958
211,BUMA.1121.00036,2,2237479,2243438,+,5959
211,BUMA.1121.00038,2,1555419,1561379,-,5960
211,BUMA.1121.00098,2,1319350,1325307,+,5957
211,BUMA.1121.00078,2,2102808,2108767,-,5959
211,BUMA.1121.00029,2,252147,258103,-,5956
211,BUMA.1121.00099,2,1321092,1327051,+,5959
211,BUMA.1121.00103,2,2976666,2982627,+,5961
211,BUMA.1121.00102,2,1112778,1118736,+,5958
211,BUMA.1121.00028,2,475435,481394,+,5959
211,BUMA.1121.00075,2,1354321,1360279,+,5958
211,BUMA.1121.00044,2,500454,506413,+,5959
211,BUMA.1121.00076,2,1948376,1954334,+,5958
211,BUMA.1121.00074,2,3294500,3300457,-,5957
211,BUMA.1121.00073,2,1038645,1044604,+,5959
211,BUMA.1121.00083,2,2865607,2871566,+,5959
211,BUMA.1121.00035,2,230698,236654,-,5956
211,BUMA.1121.00072,2,1034809,1040768,+,5959
211,BUMA.1121.00056,2,2937331,2943291,-,5960
211,BUMA.1121.00081,2,663329,669288,+,5959
211,BUMA.1121.00033,2,1801516,1807472,+,5956
211,BUMA.1121.00061,2,1028680,1034639,+,5959
211,BUMA.1121.00062,2,713637,719597,-,5960
211,BUMA.1121.00064,2,977067,983025,+,5958
211,BUMA.1121.00060,2,1134071,1140032,-,5961
211,BUMA.1121.00069,2,1036544,1042503,+,5959
211,BUMA.1121.00070,2,1038666,1044625,+,5959
211,BUMA.1121.00068,2,2771345,2777306,+,5961
211,BUMA.1121.00067,2,2908837,2914794,-,5957
211,BUMA.1121.00037,2,1422432,1428391,+,5959
211,BUMA.1121.00065,2,1108770,1114727,+,5957
211,BUMA.1121.00058,2,1612249,1618213,+,5964
211,BUMA.1121.00041,2,2005391,2011349,+,5958
211,BUMA.1121.00084,2,2890077,2896035,+,5958
211,BUMA.1121.00096,2,1277871,1283829,+,5958
211,BUMA.1121.00080,2,1063555,1069514,+,5959
211,BUMA.1121.00013,2,2000763,2006723,-,5960
211,BUMA.1121.00100,2,2168560,2174518,+,5958
211,BUMA.1121.00012,2,634886,640845,-,5959
211,BUMA.1121.00018,2,2735251,2741208,-,5957
211,BUMA.1121.00048,2,1402723,1408682,+,5959
211,BUMA.1121.00106,2,750616,756576,-,5960
211,BUMA.1121.00017,2,449304,455263,+,5959
211,BUMA.1121.00082,2,1068650,1074609,+,5959
210,BUMA.1121.00049,2,2858765,2871736,+,12971
210,BUMA.1121.00055,2,1614633,1627614,-,12981
210,BUMA.1121.00011,2,2922219,2935185,+,12966
210,BUMA.1121.00110,2,1343571,1356545,-,12974
210,BUMA.1121.00109,2,355151,368151,-,13000
210,BUMA.1121.00077,2,2637375,2650349,-,12974
210,BUMA.1121.00027,2,2101578,2114553,+,12975
210,BUMA.1121.00026,2,210490,223461,-,12971
210,BUMA.1121.00021,2,1561365,1574330,+,12965
210,BUMA.1121.00023,2,1137490,1150461,+,12971
210,BUMA.1121.00022,2,910525,923488,-,12963
210,BUMA.1121.00025,2,2202,15175,-,12973
210,BUMA.1121.00031,2,234519,247492,+,12973
210,BUMA.1121.00007,2,1086246,1099225,+,12979
210,BUMA.1121.00097,2,893191,906162,+,12971
210,BUMA.1121.00008,2,520127,533091,+,12964
210,BUMA.1121.00059,2,2602256,2615183,-,12927
210,BUMA.1121.00002,2,1904976,1917939,-,12963
210,BUMA.1121.00004,2,520276,533240,+,12964
210,BUMA.1121.00005,2,2477348,2490320,+,12972
210,BUMA.1121.00111,2,318816,331780,+,12964
210,BUMA.1121.00006,2,1666809,1679772,-,12963
210,BUMA.1121.00009,2,2943997,2956975,+,12978
210,BUMA.1121.00094,2,1087327,1100299,+,12972
210,BUMA.1121.00101,2,2355650,2368627,-,12977
210,BUMA.1121.00066,2,1025796,1038765,+,12969
210,BUMA.1121.00095,2,237861,250827,-,12966
210,BUMA.1121.00112,2,64640,77606,-,12966
210,BUMA.1121.00042,2,33169,46140,+,12971
210,BUMA.1121.00032,2,944583,957547,+,12964
210,BUMA.1121.00090,2,2031267,2044230,+,12963
210,BUMA.1121.00020,2,520283,533247,+,12964
210,BUMA.1121.00089,2,1032117,1045089,+,12972
210,BUMA.1121.00051,2,1043850,1056822,+,12972
210,BUMA.1121.00001,2,1152479,1165443,-,12964
210,BUMA.1121.00045,2,934738,947717,+,12979
210,BUMA.1121.00043,2,1313701,1326672,-,12971
210,BUMA.1121.00063,2,1019238,1032207,+,12969
210,BUMA.1121.00079,2,1044371,1057343,+,12972
210,BUMA.1121.00071,2,1019499,1032467,+,12968
210,BUMA.1121.00086,2,1718432,1731395,-,12963
210,BUMA.1121.00010,2,663710,676674,-,12964
210,BUMA.1121.00093,2,1874999,1887971,-,12972
210,BUMA.1121.00091,2,2571105,2584079,-,12974
210,BUMA.1121.00107,2,2789666,2802637,-,12971
210,BUMA.1121.00088,2,988445,1001416,+,12971
210,BUMA.1121.00047,2,1974295,1987267,+,12972
210,BUMA.1121.00019,2,520254,533218,+,12964
210,BUMA.1121.00087,2,1985834,1998797,-,12963
210,BUMA.1121.00039,2,2901571,2914478,-,12907
210,BUMA.1121.00016,2,2649803,2662768,-,12965
210,BUMA.1121.00092,2,1057085,1070057,+,12972
210,BUMA.1121.00046,2,948,13912,-,12964
210,BUMA.1121.00003,2,2858886,2871816,-,12930
210,BUMA.1121.00054,2,1466926,1479889,-,12963
210,BUMA.1121.00015,2,1543627,1556590,-,12963
210,BUMA.1121.00105,2,1465041,1478006,-,12965
210,BUMA.1121.00053,2,1330793,1343790,+,12997
210,BUMA.1121.00057,2,1035374,1048343,-,12969
210,BUMA.1121.00108,2,1272555,1285527,+,12972
210,BUMA.1121.00050,2,1761710,1774673,-,12963
210,BUMA.1121.00104,2,1138022,1150994,+,12972
210,BUMA.1121.00014,2,1167891,1180864,+,12973
210,BUMA.1121.00036,2,2217376,2230338,+,12962
210,BUMA.1121.00038,2,1568003,1580966,-,12963
210,BUMA.1121.00098,2,1300549,1313526,+,12977
210,BUMA.1121.00078,2,2114481,2127452,-,12971
210,BUMA.1121.00029,2,264095,277060,-,12965
210,BUMA.1121.00099,2,1302512,1315483,+,12971
210,BUMA.1121.00103,2,2958610,2971594,+,12984
210,BUMA.1121.00102,2,1094194,1107167,+,12973
210,BUMA.1121.00075,2,1335735,1348706,+,12971
210,BUMA.1121.00076,2,1929790,1942761,+,12971
210,BUMA.1121.00074,2,3306045,3319016,-,12971
210,BUMA.1121.00073,2,1020206,1033175,+,12969
210,BUMA.1121.00083,2,2846908,2859877,+,12969
210,BUMA.1121.00035,2,242646,255611,-,12965
210,BUMA.1121.00072,2,1016372,1029341,+,12969
210,BUMA.1121.00056,2,2948912,2961884,-,12972
210,BUMA.1121.00081,2,643742,656704,+,12962
210,BUMA.1121.00033,2,1782536,1795500,+,12964
210,BUMA.1121.00061,2,1010244,1023213,+,12969
210,BUMA.1121.00062,2,725182,738138,-,12956
210,BUMA.1121.00064,2,958462,971449,+,12987
210,BUMA.1121.00060,2,1146141,1159120,-,12979
210,BUMA.1121.00069,2,1018141,1031110,+,12969
210,BUMA.1121.00070,2,1020213,1033182,+,12969
210,BUMA.1121.00068,2,2751683,2764645,+,12962
210,BUMA.1121.00067,2,2920382,2933361,-,12979
210,BUMA.1121.00037,2,1403849,1416821,+,12972
210,BUMA.1121.00065,2,1090177,1103149,+,12972
210,BUMA.1121.00058,2,1594414,1607379,+,12965
210,BUMA.1121.00041,2,1986596,1999567,+,12971
210,BUMA.1121.00084,2,2871425,2884396,+,12971
210,BUMA.1121.00096,2,1259172,1272143,+,12971
210,BUMA.1121.00080,2,1044962,1057934,+,12972
210,BUMA.1121.00100,2,2149685,2162673,+,12988
210,BUMA.1121.00012,2,646837,659819,-,12982
210,BUMA.1121.00018,2,2747329,2760302,-,12973
210,BUMA.1121.00048,2,1383136,1396100,+,12964
210,BUMA.1121.00106,2,762247,775218,-,12971
210,BUMA.1121.00082,2,1049951,1062920,+,12969
209,BUMA.1121.00049,2,2839177,2849980,+,10803
209,BUMA.1121.00055,2,1636314,1647167,-,10853
209,BUMA.1121.00011,2,2902799,2913543,+,10744
209,BUMA.1121.00110,2,1356547,1367238,-,10691
209,BUMA.1121.00109,2,376915,387642,-,10727
209,BUMA.1121.00077,2,2650351,2661042,-,10691
209,BUMA.1121.00027,2,2082061,2092839,+,10778
209,BUMA.1121.00026,2,232307,243074,-,10767
209,BUMA.1121.00021,2,1542031,1552721,+,10690
209,BUMA.1121.00023,2,1118126,1128854,+,10728
209,BUMA.1121.00022,2,932503,943297,-,10794
209,BUMA.1121.00025,2,23835,34563,-,10728
209,BUMA.1121.00031,2,215138,225891,+,10753
209,BUMA.1121.00007,2,1066826,1077490,+,10664
209,BUMA.1121.00097,2,873692,884398,+,10706
209,BUMA.1121.00008,2,500574,511336,+,10762
209,BUMA.1121.00059,2,2623883,2634626,-,10743
209,BUMA.1121.00002,2,1926872,1937652,-,10780
209,BUMA.1121.00004,2,500694,511461,+,10767
209,BUMA.1121.00005,2,2457865,2468571,+,10706
209,BUMA.1121.00111,2,299452,310188,+,10736
209,BUMA.1121.00006,2,1688576,1699375,-,10799
209,BUMA.1121.00009,2,2924503,2935225,+,10722
209,BUMA.1121.00094,2,1067764,1078526,+,10762
209,BUMA.1121.00101,2,2377381,2388123,-,10742
209,BUMA.1121.00066,2,1006320,1017009,+,10689
209,BUMA.1121.00095,2,250829,261485,-,10656
209,BUMA.1121.00112,2,77608,88383,-,10775
209,BUMA.1121.00042,2,13491,24282,+,10791
209,BUMA.1121.00032,2,924994,935756,+,10762
209,BUMA.1121.00090,2,2011919,2022639,+,10720
209,BUMA.1121.00020,2,500709,511471,+,10762
209,BUMA.1121.00089,2,1012548,1023316,+,10768
209,BUMA.1121.00051,2,1024287,1034967,+,10680
209,BUMA.1121.00001,2,1174100,1184835,-,10735
209,BUMA.1121.00045,2,915273,925998,+,10725
209,BUMA.1121.00043,2,1335468,1346205,-,10737
209,BUMA.1121.00063,2,999747,1010471,+,10724
209,BUMA.1121.00079,2,1024734,1035418,+,10684
209,BUMA.1121.00071,2,999962,1010680,+,10718
209,BUMA.1121.00086,2,1740482,1751258,-,10776
209,BUMA.1121.00010,2,685433,696213,-,10780
209,BUMA.1121.00093,2,1896788,1907491,-,10703
209,BUMA.1121.00091,2,2592824,2603041,-,10217
209,BUMA.1121.00107,2,2811593,2822340,-,10747
209,BUMA.1121.00088,2,968927,979745,+,10818
209,BUMA.1121.00047,2,1954788,1965467,+,10679
209,BUMA.1121.00019,2,500687,511444,+,10757
209,BUMA.1121.00087,2,2007708,2018484,-,10776
209,BUMA.1121.00039,2,2923122,2933856,-,10734
209,BUMA.1121.00016,2,2671476,2682206,-,10730
209,BUMA.1121.00092,2,1037573,1048276,+,10703
209,BUMA.1121.00046,2,22791,33557,-,10766
209,BUMA.1121.00003,2,2871818,2882459,-,10641
209,BUMA.1121.00054,2,1488696,1499495,-,10799
209,BUMA.1121.00015,2,1565445,1576265,-,10820
209,BUMA.1121.00105,2,1486738,1497456,-,10718
209,BUMA.1121.00053,2,1311161,1321973,+,10812
209,BUMA.1121.00057,2,1057072,1067854,-,10782
209,BUMA.1121.00108,2,1253157,1263879,+,10722
209,BUMA.1121.00050,2,1783576,1794348,-,10772
209,BUMA.1121.00104,2,1118431,1129210,+,10779
209,BUMA.1121.00014,2,1148520,1159271,+,10751
209,BUMA.1121.00036,2,2197595,2208406,+,10811
209,BUMA.1121.00038,2,1589765,1600564,-,10799
209,BUMA.1121.00098,2,1281171,1291892,+,10721
209,BUMA.1121.00078,2,2136271,2147024,-,10753
209,BUMA.1121.00029,2,285717,296470,-,10753
209,BUMA.1121.00099,2,1282693,1293431,+,10738
209,BUMA.1121.00103,2,2939246,2949873,+,10627
209,BUMA.1121.00102,2,1074392,1085193,+,10801
209,BUMA.1121.00075,2,1316226,1326980,+,10754
209,BUMA.1121.00076,2,1910282,1921042,+,10760
209,BUMA.1121.00074,2,3327772,3338558,-,10786
209,BUMA.1121.00073,2,1000644,1011419,+,10775
209,BUMA.1121.00083,2,2827306,2838088,+,10782
209,BUMA.1121.00035,2,264300,275036,-,10736
209,BUMA.1121.00072,2,996847,1007587,+,10740
209,BUMA.1121.00056,2,2970685,2981453,-,10768
209,BUMA.1121.00081,2,624136,634935,+,10799
209,BUMA.1121.00033,2,1763214,1773916,+,10702
209,BUMA.1121.00061,2,990696,1001459,+,10763
209,BUMA.1121.00062,2,746955,757653,-,10698
209,BUMA.1121.00064,2,938952,949701,+,10749
209,BUMA.1121.00060,2,1167860,1178585,-,10725
209,BUMA.1121.00069,2,998566,1009321,+,10755
209,BUMA.1121.00070,2,1000672,1011428,+,10756
209,BUMA.1121.00068,2,2732179,2742913,+,10734
209,BUMA.1121.00067,2,2942010,2952720,-,10710
209,BUMA.1121.00037,2,1384282,1395145,+,10863
209,BUMA.1121.00065,2,1070666,1081413,+,10747
209,BUMA.1121.00058,2,1574771,1585509,+,10738
209,BUMA.1121.00041,2,1967092,1977891,+,10799
209,BUMA.1121.00084,2,2851811,2862648,+,10837
209,BUMA.1121.00096,2,1239583,1250347,+,10764
209,BUMA.1121.00080,2,1025412,1036097,+,10685
209,BUMA.1121.00100,2,2130154,2140882,+,10728
209,BUMA.1121.00012,2,668447,679182,-,10735
209,BUMA.1121.00018,2,2768954,2779681,-,10727
209,BUMA.1121.00048,2,1363530,1374329,+,10799
209,BUMA.1121.00106,2,783878,794726,-,10848
209,BUMA.1121.00082,2,1030349,1041131,+,10782
208,BUMA.1121.00049,2,2825874,2835174,+,9300
208,BUMA.1121.00055,2,1651166,1660631,-,9465
208,BUMA.1121.00011,2,2889361,2898801,+,9440
208,BUMA.1121.00110,2,1371258,1380683,-,9425
208,BUMA.1121.00109,2,391592,401038,-,9446
208,BUMA.1121.00077,2,2665139,2674564,-,9425
208,BUMA.1121.00027,2,2072211,2081687,+,9476
208,BUMA.1121.00026,2,247046,256507,-,9461
208,BUMA.1121.00021,2,1528614,1538076,+,9462
208,BUMA.1121.00023,2,1104730,1114192,+,9462
208,BUMA.1121.00022,2,947374,956842,-,9468
208,BUMA.1121.00025,2,38455,47902,-,9447
208,BUMA.1121.00031,2,201736,211198,+,9462
208,BUMA.1121.00007,2,1053402,1062863,+,9461
208,BUMA.1121.00097,2,860245,869707,+,9462
208,BUMA.1121.00008,2,487142,496602,+,9460
208,BUMA.1121.00059,2,2638629,2648083,-,9454
208,BUMA.1121.00002,2,1941624,1951074,-,9450
208,BUMA.1121.00004,2,487297,496757,+,9460
208,BUMA.1121.00005,2,2444275,2453767,+,9492
208,BUMA.1121.00111,2,287959,297421,+,9462
208,BUMA.1121.00006,2,1703389,1712843,-,9454
208,BUMA.1121.00009,2,2911039,2920500,+,9461
208,BUMA.1121.00094,2,1054298,1063753,+,9455
208,BUMA.1121.00101,2,2388497,2397973,-,9476
208,BUMA.1121.00066,2,996456,1005946,+,9490
208,BUMA.1121.00095,2,261843,271331,-,9488
208,BUMA.1121.00112,2,92401,101904,-,9503
208,BUMA.1121.00042,2,58,9519,+,9461
208,BUMA.1121.00032,2,911618,921078,+,9460
208,BUMA.1121.00090,2,2000424,2009888,+,9464
208,BUMA.1121.00020,2,487277,496737,+,9460
208,BUMA.1121.00089,2,999082,1008537,+,9455
208,BUMA.1121.00051,2,1010793,1020262,+,9469
208,BUMA.1121.00001,2,1188867,1198319,-,9452
208,BUMA.1121.00045,2,901777,911246,+,9469
208,BUMA.1121.00043,2,1348236,1357708,-,9472
208,BUMA.1121.00063,2,989896,999386,+,9490
208,BUMA.1121.00079,2,1011240,1020702,+,9462
208,BUMA.1121.00071,2,990098,999588,+,9490
208,BUMA.1121.00086,2,1755293,1764754,-,9461
208,BUMA.1121.00010,2,700206,709655,-,9449
208,BUMA.1121.00093,2,1911483,1920937,-,9454
208,BUMA.1121.00091,2,2606983,2616444,-,9461
208,BUMA.1121.00107,2,2826287,2835784,-,9497
208,BUMA.1121.00088,2,955434,964903,+,9469
208,BUMA.1121.00047,2,1941301,1950756,+,9455
208,BUMA.1121.00019,2,487241,496701,+,9460
208,BUMA.1121.00087,2,2022456,2031917,-,9461
208,BUMA.1121.00039,2,2937822,2947290,-,9468
208,BUMA.1121.00016,2,2686117,2695578,-,9461
208,BUMA.1121.00092,2,1024133,1033588,+,9455
208,BUMA.1121.00046,2,37585,47039,-,9454
208,BUMA.1121.00003,2,2882833,2892315,-,9482
208,BUMA.1121.00054,2,1503509,1512963,-,9454
208,BUMA.1121.00015,2,1580265,1589719,-,9454
208,BUMA.1121.00105,2,1501405,1510873,-,9468
208,BUMA.1121.00053,2,1297660,1307136,+,9476
208,BUMA.1121.00057,2,1068228,1077724,-,9496
208,BUMA.1121.00108,2,1239688,1249144,+,9456
208,BUMA.1121.00050,2,1798369,1807823,-,9454
208,BUMA.1121.00104,2,1104980,1114463,+,9483
208,BUMA.1121.00014,2,1135040,1144502,+,9462
208,BUMA.1121.00036,2,2184077,2193546,+,9469
208,BUMA.1121.00038,2,1604582,1614036,-,9454
208,BUMA.1121.00098,2,1267668,1277130,+,9462
208,BUMA.1121.00078,2,2151069,2160529,-,9460
208,BUMA.1121.00029,2,300474,309926,-,9452
208,BUMA.1121.00099,2,1272880,1282319,+,9439
208,BUMA.1121.00103,2,2925808,2935291,+,9483
208,BUMA.1121.00102,2,1060817,1070293,+,9476
208,BUMA.1121.00075,2,1302720,1312181,+,9461
208,BUMA.1121.00076,2,1896804,1906265,+,9461
208,BUMA.1121.00074,2,3342507,3351975,-,9468
208,BUMA.1121.00073,2,990799,1000289,+,9490
208,BUMA.1121.00083,2,2817442,2826932,+,9490
208,BUMA.1121.00035,2,279019,288471,-,9452
208,BUMA.1121.00072,2,986983,996473,+,9490
208,BUMA.1121.00056,2,2985464,2994918,-,9454
208,BUMA.1121.00081,2,610667,620122,+,9455
208,BUMA.1121.00033,2,1749805,1759267,+,9462
208,BUMA.1121.00061,2,980832,990322,+,9490
208,BUMA.1121.00062,2,761614,771082,-,9468
208,BUMA.1121.00064,2,925498,934969,+,9471
208,BUMA.1121.00060,2,1182619,1192087,-,9468
208,BUMA.1121.00069,2,988702,998192,+,9490
208,BUMA.1121.00070,2,990815,1000305,+,9490
208,BUMA.1121.00068,2,2718780,2728222,+,9442
208,BUMA.1121.00067,2,2956683,2966200,-,9517
208,BUMA.1121.00037,2,1372789,1382251,+,9462
208,BUMA.1121.00065,2,1057193,1066676,+,9483
208,BUMA.1121.00058,2,1561336,1570791,+,9455
208,BUMA.1121.00041,2,1953571,1963047,+,9476
208,BUMA.1121.00084,2,2838348,2847803,+,9455
208,BUMA.1121.00096,2,1226125,1235566,+,9441
208,BUMA.1121.00080,2,1011988,1021450,+,9462
208,BUMA.1121.00100,2,2116809,2126242,+,9433
208,BUMA.1121.00012,2,683165,692654,-,9489
208,BUMA.1121.00018,2,2783587,2793033,-,9446
208,BUMA.1121.00048,2,1350061,1359516,+,9455
208,BUMA.1121.00106,2,798680,808213,-,9533
208,BUMA.1121.00082,2,1020485,1029975,+,9490
207,BUMA.1121.00049,2,2821957,2825873,+,3916
207,BUMA.1121.00055,2,1660633,1664548,-,3915
207,BUMA.1121.00011,2,2885443,2889360,+,3917
207,BUMA.1121.00110,2,1380685,1384593,-,3908
207,BUMA.1121.00109,2,401040,404956,-,3916
207,BUMA.1121.00077,2,2674566,2678474,-,3908
207,BUMA.1121.00027,2,2068294,2072210,+,3916
207,BUMA.1121.00026,2,256509,260424,-,3915
207,BUMA.1121.00021,2,1524705,1528613,+,3908
207,BUMA.1121.00023,2,1100821,1104729,+,3908
207,BUMA.1121.00022,2,956844,960759,-,3915
207,BUMA.1121.00025,2,47904,51811,-,3907
207,BUMA.1121.00031,2,197827,201735,+,3908
207,BUMA.1121.00007,2,1049493,1053401,+,3908
207,BUMA.1121.00097,2,856336,860244,+,3908
207,BUMA.1121.00008,2,483225,487141,+,3916
207,BUMA.1121.00059,2,2648085,2651993,-,3908
207,BUMA.1121.00002,2,1951076,1954991,-,3915
207,BUMA.1121.00004,2,483380,487296,+,3916
207,BUMA.1121.00005,2,2440359,2444274,+,3915
207,BUMA.1121.00111,2,284050,287958,+,3908
207,BUMA.1121.00006,2,1712845,1716760,-,3915
207,BUMA.1121.00009,2,2907129,2911038,+,3909
207,BUMA.1121.00094,2,1050381,1054297,+,3916
207,BUMA.1121.00101,2,2397975,2401886,-,3911
207,BUMA.1121.00066,2,992539,996455,+,3916
207,BUMA.1121.00095,2,271333,275248,-,3915
207,BUMA.1121.00112,2,101906,105822,-,3916
207,BUMA.1121.00042,2,2142868,2146721,+,3853
207,BUMA.1121.00032,2,907701,911617,+,3916
207,BUMA.1121.00090,2,1996515,2000423,+,3908
207,BUMA.1121.00020,2,483360,487276,+,3916
207,BUMA.1121.00089,2,995165,999081,+,3916
207,BUMA.1121.00051,2,1006876,1010792,+,3916
207,BUMA.1121.00001,2,1198321,1202228,-,3907
207,BUMA.1121.00045,2,897867,901776,+,3909
207,BUMA.1121.00043,2,1357710,1361617,-,3907
207,BUMA.1121.00063,2,985979,989895,+,3916
207,BUMA.1121.00079,2,1007331,1011239,+,3908
207,BUMA.1121.00071,2,986182,990097,+,3915
207,BUMA.1121.00086,2,1764756,1768671,-,3915
207,BUMA.1121.00010,2,709657,713572,-,3915
207,BUMA.1121.00093,2,1920939,1924854,-,3915
207,BUMA.1121.00091,2,2616446,2620361,-,3915
207,BUMA.1121.00107,2,2835786,2839693,-,3907
207,BUMA.1121.00088,2,951517,955433,+,3916
207,BUMA.1121.00047,2,1937384,1941300,+,3916
207,BUMA.1121.00019,2,483324,487240,+,3916
207,BUMA.1121.00087,2,2031919,2035834,-,3915
207,BUMA.1121.00039,2,2947292,2951199,-,3907
207,BUMA.1121.00016,2,2695580,2699487,-,3907
207,BUMA.1121.00092,2,1020216,1024132,+,3916
207,BUMA.1121.00046,2,47041,50956,-,3915
207,BUMA.1121.00003,2,2892317,2896225,-,3908
207,BUMA.1121.00054,2,1512965,1516880,-,3915
207,BUMA.1121.00015,2,1589721,1593636,-,3915
207,BUMA.1121.00105,2,1510875,1514789,-,3914
207,BUMA.1121.00053,2,1293743,1297659,+,3916
207,BUMA.1121.00057,2,1077726,1081641,-,3915
207,BUMA.1121.00108,2,1235755,1239687,+,3932
207,BUMA.1121.00050,2,1807825,1811740,-,3915
207,BUMA.1121.00104,2,1101063,1104979,+,3916
207,BUMA.1121.00014,2,1131131,1135039,+,3908
207,BUMA.1121.00036,2,2180160,2184076,+,3916
207,BUMA.1121.00038,2,1614038,1617953,-,3915
207,BUMA.1121.00098,2,1263759,1267667,+,3908
207,BUMA.1121.00078,2,2160531,2164446,-,3915
207,BUMA.1121.00029,2,309928,313835,-,3907
207,BUMA.1121.00099,2,1268962,1272879,+,3917
207,BUMA.1121.00103,2,2921891,2925807,+,3916
207,BUMA.1121.00102,2,1056868,1060816,+,3948
207,BUMA.1121.00075,2,1298803,1302719,+,3916
207,BUMA.1121.00076,2,1892887,1896803,+,3916
207,BUMA.1121.00074,2,3351977,3355885,-,3908
207,BUMA.1121.00073,2,986882,990798,+,3916
207,BUMA.1121.00083,2,2813525,2817441,+,3916
207,BUMA.1121.00035,2,288473,292380,-,3907
207,BUMA.1121.00072,2,983066,986982,+,3916
207,BUMA.1121.00056,2,2994920,2998835,-,3915
207,BUMA.1121.00081,2,606750,610666,+,3916
207,BUMA.1121.00033,2,1745897,1749804,+,3907
207,BUMA.1121.00061,2,976915,980831,+,3916
207,BUMA.1121.00062,2,771084,774999,-,3915
207,BUMA.1121.00064,2,921581,925497,+,3916
207,BUMA.1121.00060,2,1192089,1195997,-,3908
207,BUMA.1121.00069,2,984785,988701,+,3916
207,BUMA.1121.00070,2,986898,990814,+,3916
207,BUMA.1121.00068,2,2714868,2718779,+,3911
207,BUMA.1121.00067,2,2966202,2970110,-,3908
207,BUMA.1121.00037,2,1368880,1372788,+,3908
207,BUMA.1121.00065,2,1053276,1057192,+,3916
207,BUMA.1121.00058,2,1557419,1561335,+,3916
207,BUMA.1121.00041,2,1949655,1953570,+,3915
207,BUMA.1121.00084,2,2834422,2838347,+,3925
207,BUMA.1121.00096,2,1222207,1226124,+,3917
207,BUMA.1121.00080,2,1008071,1011987,+,3916
207,BUMA.1121.00100,2,2112898,2116808,+,3910
207,BUMA.1121.00012,2,692656,696563,-,3907
207,BUMA.1121.00018,2,2793035,2796942,-,3907
207,BUMA.1121.00048,2,1346144,1350060,+,3916
207,BUMA.1121.00106,2,808215,812131,-,3916
207,BUMA.1121.00082,2,1016568,1020484,+,3916
206,BUMA.1121.00049,2,2815580,2820758,+,5178
206,BUMA.1121.00055,2,1665747,1670925,-,5178
206,BUMA.1121.00011,2,2879079,2884244,+,5165
206,BUMA.1121.00110,2,1385754,1390919,-,5165
206,BUMA.1121.00109,2,406134,411299,-,5165
206,BUMA.1121.00077,2,2679635,2684800,-,5165
206,BUMA.1121.00027,2,2061928,2067106,+,5178
206,BUMA.1121.00026,2,261603,266775,-,5172
206,BUMA.1121.00021,2,1518360,1523525,+,5165
206,BUMA.1121.00023,2,1094482,1099631,+,5149
206,BUMA.1121.00022,2,961928,967100,-,5172
206,BUMA.1121.00025,2,53001,58158,-,5157
206,BUMA.1121.00031,2,191477,196637,+,5160
206,BUMA.1121.00007,2,1043122,1048294,+,5172
206,BUMA.1121.00097,2,849989,855155,+,5166
206,BUMA.1121.00008,2,476884,482056,+,5172
206,BUMA.1121.00059,2,2653183,2658349,-,5166
206,BUMA.1121.00002,2,1956160,1961332,-,5172
206,BUMA.1121.00004,2,477039,482211,+,5172
206,BUMA.1121.00005,2,2433993,2439171,+,5178
206,BUMA.1121.00111,2,276115,281265,+,5150
206,BUMA.1121.00006,2,1717929,1723101,-,5172
206,BUMA.1121.00009,2,2900766,2905949,+,5183
206,BUMA.1121.00094,2,1044010,1049182,+,5172
206,BUMA.1121.00101,2,2403066,2408243,-,5177
206,BUMA.1121.00066,2,986185,991351,+,5166
206,BUMA.1121.00095,2,276447,281612,-,5165
206,BUMA.1121.00112,2,107010,112170,-,5160
206,BUMA.1121.00042,2,2136517,2141689,+,5172
206,BUMA.1121.00032,2,901360,906532,+,5172
206,BUMA.1121.00090,2,1990159,1995325,+,5166
206,BUMA.1121.00020,2,477019,482191,+,5172
206,BUMA.1121.00089,2,988794,993966,+,5172
206,BUMA.1121.00051,2,1000505,1005677,+,5172
206,BUMA.1121.00001,2,1203418,1208584,-,5166
206,BUMA.1121.00045,2,891528,896688,+,5160
206,BUMA.1121.00043,2,1362807,1367982,-,5175
206,BUMA.1121.00063,2,979625,984791,+,5166
206,BUMA.1121.00079,2,1000976,1006141,+,5165
206,BUMA.1121.00071,2,979828,984994,+,5166
206,BUMA.1121.00086,2,1769840,1775012,-,5172
206,BUMA.1121.00010,2,714741,719913,-,5172
206,BUMA.1121.00093,2,1926053,1931219,-,5166
206,BUMA.1121.00091,2,2621560,2626726,-,5166
206,BUMA.1121.00107,2,2840863,2846028,-,5165
206,BUMA.1121.00088,2,945141,950318,+,5177
206,BUMA.1121.00047,2,1931013,1936185,+,5172
206,BUMA.1121.00019,2,476983,482155,+,5172
206,BUMA.1121.00087,2,2037003,2042175,-,5172
206,BUMA.1121.00039,2,2952389,2957555,-,5166
206,BUMA.1121.00016,2,2700677,2705843,-,5166
206,BUMA.1121.00092,2,1013851,1019017,+,5166
206,BUMA.1121.00046,2,52125,57297,-,5172
206,BUMA.1121.00003,2,2897403,2902575,-,5172
206,BUMA.1121.00054,2,1518049,1523221,-,5172
206,BUMA.1121.00015,2,1594805,1599977,-,5172
206,BUMA.1121.00105,2,1515988,1521172,-,5184
206,BUMA.1121.00053,2,1287389,1292555,+,5166
206,BUMA.1121.00057,2,1082829,1088006,-,5177
206,BUMA.1121.00108,2,1229395,1234566,+,5171
206,BUMA.1121.00050,2,1812909,1818081,-,5172
206,BUMA.1121.00104,2,1094718,1099884,+,5166
206,BUMA.1121.00014,2,1124781,1129941,+,5160
206,BUMA.1121.00036,2,2173819,2178991,+,5172
206,BUMA.1121.00038,2,1619122,1624294,-,5172
206,BUMA.1121.00098,2,1257439,1262598,+,5159
206,BUMA.1121.00078,2,2165636,2170808,-,5172
206,BUMA.1121.00029,2,315025,320191,-,5166
206,BUMA.1121.00099,2,1262616,1267793,+,5177
206,BUMA.1121.00103,2,2915546,2920712,+,5166
206,BUMA.1121.00102,2,1050503,1055669,+,5166
206,BUMA.1121.00075,2,1292449,1297615,+,5166
206,BUMA.1121.00076,2,1886533,1891699,+,5166
206,BUMA.1121.00074,2,3357075,3362241,-,5166
206,BUMA.1121.00073,2,980528,985694,+,5166
206,BUMA.1121.00083,2,2807171,2812337,+,5166
206,BUMA.1121.00035,2,293570,298736,-,5166
206,BUMA.1121.00072,2,976714,981879,+,5165
206,BUMA.1121.00056,2,3000034,3005206,-,5172
206,BUMA.1121.00081,2,600409,605581,+,5172
206,BUMA.1121.00033,2,1739541,1744707,+,5166
206,BUMA.1121.00061,2,970561,975727,+,5166
206,BUMA.1121.00062,2,776198,781363,-,5165
206,BUMA.1121.00064,2,915216,920382,+,5166
206,BUMA.1121.00060,2,1197176,1202336,-,5160
206,BUMA.1121.00069,2,978431,983597,+,5166
206,BUMA.1121.00070,2,980544,985710,+,5166
206,BUMA.1121.00068,2,2708519,2713678,+,5159
206,BUMA.1121.00067,2,2971300,2976466,-,5166
206,BUMA.1121.00037,2,1362530,1367690,+,5160
206,BUMA.1121.00065,2,1046912,1052089,+,5177
206,BUMA.1121.00058,2,1551065,1556231,+,5166
206,BUMA.1121.00041,2,1943301,1948467,+,5166
206,BUMA.1121.00084,2,2828042,2833213,+,5171
206,BUMA.1121.00096,2,1215838,1221009,+,5171
206,BUMA.1121.00080,2,1001700,1006872,+,5172
206,BUMA.1121.00100,2,2106548,2111707,+,5159
206,BUMA.1121.00012,2,697753,702919,-,5166
206,BUMA.1121.00018,2,2798132,2803289,-,5157
206,BUMA.1121.00048,2,1339803,1344975,+,5172
206,BUMA.1121.00106,2,813330,818496,-,5166
206,BUMA.1121.00082,2,1010214,1015380,+,5166
205,BUMA.1121.00049,2,2811214,2814634,+,3420
205,BUMA.1121.00055,2,1671871,1675291,-,3420
205,BUMA.1121.00011,2,2874712,2878133,+,3421
205,BUMA.1121.00110,2,1391865,1395285,-,3420
205,BUMA.1121.00109,2,412245,415665,-,3420
205,BUMA.1121.00077,2,2685746,2689165,-,3419
205,BUMA.1121.00027,2,2057572,2060982,+,3410
205,BUMA.1121.00026,2,267721,271141,-,3420
205,BUMA.1121.00021,2,1514004,1517414,+,3410
205,BUMA.1121.00023,2,1090116,1093536,+,3420
205,BUMA.1121.00022,2,968046,971466,-,3420
205,BUMA.1121.00025,2,59104,62524,-,3420
205,BUMA.1121.00031,2,187121,190531,+,3410
205,BUMA.1121.00007,2,1038756,1042176,+,3420
205,BUMA.1121.00097,2,845623,849043,+,3420
205,BUMA.1121.00008,2,472518,475938,+,3420
205,BUMA.1121.00059,2,2659295,2662715,-,3420
205,BUMA.1121.00002,2,1962278,1965698,-,3420
205,BUMA.1121.00004,2,472673,476093,+,3420
205,BUMA.1121.00005,2,2429637,2433047,+,3410
205,BUMA.1121.00111,2,271759,275169,+,3410
205,BUMA.1121.00006,2,1724047,1727467,-,3420
205,BUMA.1121.00009,2,2896400,2899820,+,3420
205,BUMA.1121.00094,2,1039641,1043064,+,3423
205,BUMA.1121.00101,2,2409189,2412610,-,3421
205,BUMA.1121.00066,2,981818,985239,+,3421
205,BUMA.1121.00095,2,282556,285966,-,3410
205,BUMA.1121.00112,2,113116,116536,-,3420
205,BUMA.1121.00042,2,2132151,2135571,+,3420
205,BUMA.1121.00032,2,896994,900414,+,3420
205,BUMA.1121.00090,2,1985803,1989213,+,3410
205,BUMA.1121.00020,2,472653,476073,+,3420
205,BUMA.1121.00089,2,984425,987848,+,3423
205,BUMA.1121.00051,2,996136,999559,+,3423
205,BUMA.1121.00001,2,1209530,1212940,-,3410
205,BUMA.1121.00045,2,887162,890582,+,3420
205,BUMA.1121.00043,2,1368928,1372338,-,3410
205,BUMA.1121.00063,2,975258,978679,+,3421
205,BUMA.1121.00079,2,996607,1000030,+,3423
205,BUMA.1121.00071,2,975461,978882,+,3421
205,BUMA.1121.00086,2,1775958,1779378,-,3420
205,BUMA.1121.00010,2,720859,724279,-,3420
205,BUMA.1121.00093,2,1932165,1935585,-,3420
205,BUMA.1121.00091,2,2627672,2631092,-,3420
205,BUMA.1121.00107,2,2846974,2850395,-,3421
205,BUMA.1121.00088,2,940784,944204,+,3420
205,BUMA.1121.00047,2,1926644,1930067,+,3423
205,BUMA.1121.00019,2,472617,476037,+,3420
205,BUMA.1121.00087,2,2043121,2046541,-,3420
205,BUMA.1121.00039,2,2958501,2961911,-,3410
205,BUMA.1121.00016,2,2706789,2710199,-,3410
205,BUMA.1121.00092,2,1009485,1012905,+,3420
205,BUMA.1121.00046,2,58243,61663,-,3420
205,BUMA.1121.00003,2,2903521,2906941,-,3420
205,BUMA.1121.00054,2,1524167,1527587,-,3420
205,BUMA.1121.00015,2,1600923,1604343,-,3420
205,BUMA.1121.00105,2,1522109,1525519,-,3410
205,BUMA.1121.00053,2,1283023,1286443,+,3420
205,BUMA.1121.00057,2,1088943,1092353,-,3410
205,BUMA.1121.00108,2,1225029,1228449,+,3420
205,BUMA.1121.00050,2,1819027,1822447,-,3420
205,BUMA.1121.00104,2,1090362,1093772,+,3410
205,BUMA.1121.00014,2,1120425,1123835,+,3410
205,BUMA.1121.00036,2,2169453,2172873,+,3420
205,BUMA.1121.00038,2,1625240,1628660,-,3420
205,BUMA.1121.00098,2,1253153,1256493,+,3340
205,BUMA.1121.00078,2,2171754,2175164,-,3410
205,BUMA.1121.00029,2,321137,324547,-,3410
205,BUMA.1121.00099,2,1258250,1261670,+,3420
205,BUMA.1121.00103,2,2911182,2914600,+,3418
205,BUMA.1121.00102,2,1046137,1049557,+,3420
205,BUMA.1121.00075,2,1288093,1291503,+,3410
205,BUMA.1121.00076,2,1882177,1885587,+,3410
205,BUMA.1121.00074,2,44,3478,-,3434
205,BUMA.1121.00073,2,976161,979582,+,3421
205,BUMA.1121.00083,2,2802804,2806225,+,3421
205,BUMA.1121.00035,2,299682,303092,-,3410
205,BUMA.1121.00072,2,972347,975768,+,3421
205,BUMA.1121.00056,2,3006152,3009575,-,3423
205,BUMA.1121.00081,2,596043,599463,+,3420
205,BUMA.1121.00033,2,1735175,1738595,+,3420
205,BUMA.1121.00061,2,966194,969615,+,3421
205,BUMA.1121.00062,2,782309,785729,-,3420
205,BUMA.1121.00064,2,910850,914270,+,3420
205,BUMA.1121.00060,2,1203282,1206702,-,3420
205,BUMA.1121.00069,2,974064,977485,+,3421
205,BUMA.1121.00070,2,976177,979598,+,3421
205,BUMA.1121.00068,2,2704153,2707573,+,3420
205,BUMA.1121.00067,2,2977412,2980832,-,3420
205,BUMA.1121.00037,2,1358176,1361584,+,3408
205,BUMA.1121.00065,2,1042546,1045966,+,3420
205,BUMA.1121.00058,2,1546700,1550119,+,3419
205,BUMA.1121.00041,2,1938935,1942355,+,3420
205,BUMA.1121.00084,2,2823676,2827096,+,3420
205,BUMA.1121.00096,2,1211472,1214892,+,3420
205,BUMA.1121.00080,2,997331,1000754,+,3423
205,BUMA.1121.00100,2,2102182,2105602,+,3420
205,BUMA.1121.00012,2,703865,707285,-,3420
205,BUMA.1121.00018,2,2804235,2807655,-,3420
205,BUMA.1121.00048,2,1335437,1338857,+,3420
205,BUMA.1121.00106,2,819442,822862,-,3420
205,BUMA.1121.00082,2,1005847,1009268,+,3421
204,BUMA.1121.00049,2,2789793,2806202,+,16409
204,BUMA.1121.00055,2,1680307,1696773,-,16466
204,BUMA.1121.00011,2,2853242,2869699,+,16457
204,BUMA.1121.00110,2,1454598,1470935,-,16337
204,BUMA.1121.00109,2,420679,437092,-,16413
204,BUMA.1121.00077,2,2748475,2764812,-,16337
204,BUMA.1121.00027,2,2036091,2052559,+,16468
204,BUMA.1121.00026,2,1688170,1704602,-,16432
204,BUMA.1121.00021,2,1438297,1454700,+,16403
204,BUMA.1121.00023,2,1015030,1031450,+,16420
204,BUMA.1121.00022,2,606203,622628,-,16425
204,BUMA.1121.00034,2,1046736,1063175,-,16439
204,BUMA.1121.00025,2,68629,85036,-,16407
204,BUMA.1121.00031,2,111391,127826,+,16435
204,BUMA.1121.00007,2,1017281,1033742,+,16461
204,BUMA.1121.00097,2,769867,786279,+,16412
204,BUMA.1121.00008,2,1030892,1047331,-,16439
204,BUMA.1121.00059,2,2667730,2684199,-,16469
204,BUMA.1121.00002,2,1484401,1500855,+,16454
204,BUMA.1121.00004,2,1031592,1048031,-,16439
204,BUMA.1121.00005,2,2359500,2375946,+,16446
204,BUMA.1121.00111,2,195186,211625,+,16439
204,BUMA.1121.00006,2,824740,841169,+,16429
204,BUMA.1121.00009,2,2874975,2891386,+,16411
204,BUMA.1121.00094,2,1018155,1034627,+,16472
204,BUMA.1121.00101,2,2417625,2434065,-,16440
204,BUMA.1121.00066,2,960837,977239,+,16402
204,BUMA.1121.00095,2,345285,361715,-,16430
204,BUMA.1121.00112,2,175876,192389,-,16513
204,BUMA.1121.00042,2,381586,398019,+,16433
204,BUMA.1121.00090,2,1910069,1926504,+,16435
204,BUMA.1121.00020,2,1031629,1048068,-,16439
204,BUMA.1121.00089,2,962939,979411,+,16472
204,BUMA.1121.00051,2,974660,991123,+,16463
204,BUMA.1121.00001,2,1272236,1288655,-,16419
204,BUMA.1121.00045,2,811399,827859,+,16460
204,BUMA.1121.00043,2,1431636,1448054,-,16418
204,BUMA.1121.00063,2,954271,970680,+,16409
204,BUMA.1121.00079,2,975131,991593,+,16462
204,BUMA.1121.00071,2,954470,970883,+,16413
204,BUMA.1121.00086,2,1413861,1430293,-,16432
204,BUMA.1121.00024,2,1166698,1183137,-,16439
204,BUMA.1121.00010,2,243248,259690,+,16442
204,BUMA.1121.00040,2,791279,807714,+,16435
204,BUMA.1121.00093,2,1940600,1957023,-,16423
204,BUMA.1121.00091,2,2690398,2706857,-,16459
204,BUMA.1121.00107,2,2909719,2926203,-,16484
204,BUMA.1121.00088,2,919331,935770,+,16439
204,BUMA.1121.00047,2,1905163,1921630,+,16467
204,BUMA.1121.00019,2,1110752,1127191,-,16439
204,BUMA.1121.00087,2,1681251,1697683,-,16432
204,BUMA.1121.00039,2,2970818,2987205,-,16387
204,BUMA.1121.00030,2,1058618,1075058,+,16440
204,BUMA.1121.00016,2,2769499,2785915,-,16416
204,BUMA.1121.00092,2,988048,1004471,+,16423
204,BUMA.1121.00085,2,499729,516161,-,16432
204,BUMA.1121.00046,2,1578162,1594579,+,16417
204,BUMA.1121.00003,2,2911955,2928417,-,16462
204,BUMA.1121.00054,2,624888,641317,+,16429
204,BUMA.1121.00105,2,1530534,1546982,-,16448
204,BUMA.1121.00052,2,1188276,1204708,-,16432
204,BUMA.1121.00053,2,1207290,1223714,+,16424
204,BUMA.1121.00057,2,1097368,1113795,-,16427
204,BUMA.1121.00108,2,1203645,1220016,+,16371
204,BUMA.1121.00050,2,1194460,1210877,+,16417
204,BUMA.1121.00104,2,1068943,1085349,+,16406
204,BUMA.1121.00014,2,1044712,1061132,+,16420
204,BUMA.1121.00036,2,665591,682030,-,16439
204,BUMA.1121.00038,2,824775,841204,+,16429
204,BUMA.1121.00098,2,1177500,1193866,+,16366
204,BUMA.1121.00078,2,2234455,2250865,-,16410
204,BUMA.1121.00029,2,385198,401617,-,16419
204,BUMA.1121.00099,2,1182582,1198979,+,16397
204,BUMA.1121.00103,2,2835412,2851841,+,16429
204,BUMA.1121.00102,2,968994,985489,+,16495
204,BUMA.1121.00028,2,1072847,1089286,-,16439
204,BUMA.1121.00075,2,1266616,1283080,+,16464
204,BUMA.1121.00044,2,1097840,1114279,-,16439
204,BUMA.1121.00076,2,1860699,1877164,+,16465
204,BUMA.1121.00074,2,8493,24928,-,16435
204,BUMA.1121.00073,2,955180,971582,+,16402
204,BUMA.1121.00083,2,2781379,2797792,+,16413
204,BUMA.1121.00035,2,362391,378805,-,16414
204,BUMA.1121.00072,2,951366,967768,+,16402
204,BUMA.1121.00056,2,3014590,3031062,-,16472
204,BUMA.1121.00081,2,1482346,1498774,-,16428
204,BUMA.1121.00033,2,1659469,1675872,+,16403
204,BUMA.1121.00061,2,945214,961616,+,16402
204,BUMA.1121.00062,2,790745,807176,-,16431
204,BUMA.1121.00064,2,889456,905836,+,16380
204,BUMA.1121.00060,2,1266006,1282465,-,16459
204,BUMA.1121.00069,2,953073,969486,+,16413
204,BUMA.1121.00070,2,955196,971598,+,16402
204,BUMA.1121.00068,2,2682699,2699139,+,16440
204,BUMA.1121.00067,2,2985847,3002303,-,16456
204,BUMA.1121.00037,2,1282461,1298881,+,16420
204,BUMA.1121.00065,2,966784,983228,+,16444
204,BUMA.1121.00058,2,1525265,1541686,+,16421
204,BUMA.1121.00041,2,1863156,1879624,+,16468
204,BUMA.1121.00084,2,2802197,2818662,+,16465
204,BUMA.1121.00096,2,1135763,1152178,+,16415
204,BUMA.1121.00080,2,975854,992317,+,16463
204,BUMA.1121.00013,2,1795044,1811476,-,16432
204,BUMA.1121.00100,2,2080753,2097170,+,16417
204,BUMA.1121.00012,2,767927,784366,-,16439
204,BUMA.1121.00018,2,2813760,2830167,-,16407
204,BUMA.1121.00048,2,2221694,2238122,-,16428
204,BUMA.1121.00106,2,827877,844357,-,16480
204,BUMA.1121.00017,2,1046715,1063154,-,16439
204,BUMA.1121.00082,2,984422,1000835,+,16413
203,BUMA.1121.00049,2,2771015,2787799,+,16784
203,BUMA.1121.00055,2,1698761,1715651,-,16890
203,BUMA.1121.00011,2,2835248,2852107,+,16859
203,BUMA.1121.00110,2,1472923,1489730,-,16807
203,BUMA.1121.00109,2,438225,455079,-,16854
203,BUMA.1121.00077,2,2766800,2783607,-,16807
203,BUMA.1121.00027,2,2017334,2034107,+,16773
203,BUMA.1121.00026,2,1705778,1722554,-,16776
203,BUMA.1121.00021,2,1419452,1436308,+,16856
203,BUMA.1121.00023,2,996195,1013043,+,16848
203,BUMA.1121.00022,2,623804,640608,-,16804
203,BUMA.1121.00034,2,1064351,1081144,-,16793
203,BUMA.1121.00025,2,87024,103750,-,16726
203,BUMA.1121.00031,2,92511,109404,+,16893
203,BUMA.1121.00007,2,998476,1015294,+,16818
203,BUMA.1121.00097,2,751893,768703,+,16810
203,BUMA.1121.00008,2,1048507,1065300,-,16793
203,BUMA.1121.00059,2,2686193,2703213,-,17020
203,BUMA.1121.00002,2,1466416,1483217,+,16801
203,BUMA.1121.00004,2,1049207,1066000,-,16793
203,BUMA.1121.00005,2,2341407,2358340,+,16933
203,BUMA.1121.00111,2,176379,193197,+,16818
203,BUMA.1121.00006,2,806805,823565,+,16760
203,BUMA.1121.00009,2,2856098,2872966,+,16868
203,BUMA.1121.00094,2,1000243,1017013,+,16770
203,BUMA.1121.00101,2,2435239,2452111,-,16872
203,BUMA.1121.00066,2,942913,959674,+,16761
203,BUMA.1121.00095,2,363712,380012,-,16300
203,BUMA.1121.00112,2,194365,211132,-,16767
203,BUMA.1121.00042,2,363680,380411,+,16731
203,BUMA.1121.00090,2,1891128,1908082,+,16954
203,BUMA.1121.00020,2,1049244,1066037,-,16793
203,BUMA.1121.00089,2,945021,961797,+,16776
203,BUMA.1121.00051,2,956732,973518,+,16786
203,BUMA.1121.00001,2,1290643,1307612,-,16969
203,BUMA.1121.00045,2,793496,810244,+,16748
203,BUMA.1121.00043,2,1450042,1466782,-,16740
203,BUMA.1121.00063,2,936373,953118,+,16745
203,BUMA.1121.00079,2,957135,973989,+,16854
203,BUMA.1121.00071,2,936657,953318,+,16661
203,BUMA.1121.00086,2,1431469,1448228,-,16759
203,BUMA.1121.00024,2,1184313,1201106,-,16793
203,BUMA.1121.00010,2,225271,242064,+,16793
203,BUMA.1121.00040,2,773337,790104,+,16767
203,BUMA.1121.00093,2,1958183,1975066,-,16883
203,BUMA.1121.00091,2,2708017,2724849,-,16832
203,BUMA.1121.00107,2,2928202,2945078,-,16876
203,BUMA.1121.00088,2,900458,917337,+,16879
203,BUMA.1121.00047,2,1887269,1904021,+,16752
203,BUMA.1121.00019,2,1128367,1145160,-,16793
203,BUMA.1121.00087,2,1698859,1715618,-,16759
203,BUMA.1121.00039,2,2989195,3006376,-,17181
203,BUMA.1121.00030,2,1040649,1057443,+,16794
203,BUMA.1121.00016,2,2787903,2804872,-,16969
203,BUMA.1121.00092,2,970005,986888,+,16883
203,BUMA.1121.00085,2,517337,534147,-,16810
203,BUMA.1121.00046,2,1560201,1576987,+,16786
203,BUMA.1121.00003,2,2930444,2947161,-,16717
203,BUMA.1121.00054,2,606953,623713,+,16760
203,BUMA.1121.00105,2,1548988,1565802,-,16814
203,BUMA.1121.00052,2,1205884,1222694,-,16810
203,BUMA.1121.00053,2,1189307,1206128,+,16821
203,BUMA.1121.00057,2,1115780,1132547,-,16767
203,BUMA.1121.00108,2,1184936,1201658,+,16722
203,BUMA.1121.00050,2,1176499,1193285,+,16786
203,BUMA.1121.00104,2,1051028,1067772,+,16744
203,BUMA.1121.00014,2,1025826,1042725,+,16899
203,BUMA.1121.00036,2,683204,699946,-,16742
203,BUMA.1121.00038,2,806840,823600,+,16760
203,BUMA.1121.00098,2,1158640,1175495,+,16855
203,BUMA.1121.00078,2,2252021,2268940,-,16919
203,BUMA.1121.00029,2,403605,420558,-,16953
203,BUMA.1121.00099,2,1163703,1180593,+,16890
203,BUMA.1121.00103,2,2816550,2833423,+,16873
203,BUMA.1121.00102,2,950962,967832,+,16870
203,BUMA.1121.00028,2,1090462,1107255,-,16793
203,BUMA.1121.00075,2,1248642,1265465,+,16823
203,BUMA.1121.00044,2,1115455,1132248,-,16793
203,BUMA.1121.00076,2,1842725,1859548,+,16823
203,BUMA.1121.00074,2,26922,43706,-,16784
203,BUMA.1121.00073,2,937249,954015,+,16766
203,BUMA.1121.00083,2,2762621,2779394,+,16773
203,BUMA.1121.00035,2,380793,397719,-,16926
203,BUMA.1121.00072,2,933445,950203,+,16758
203,BUMA.1121.00056,2,3032204,3048979,-,16775
203,BUMA.1121.00081,2,1499950,1516709,-,16759
203,BUMA.1121.00033,2,1640695,1657482,+,16787
203,BUMA.1121.00061,2,927294,944051,+,16757
203,BUMA.1121.00062,2,808348,825257,-,16909
203,BUMA.1121.00064,2,870727,887453,+,16726
203,BUMA.1121.00060,2,1283621,1300368,-,16747
203,BUMA.1121.00069,2,935169,951921,+,16752
203,BUMA.1121.00070,2,937267,954033,+,16766
203,BUMA.1121.00068,2,2664825,2681546,+,16721
203,BUMA.1121.00067,2,3004297,3021045,-,16748
203,BUMA.1121.00037,2,1263624,1280474,+,16850
203,BUMA.1121.00065,2,948785,965613,+,16828
203,BUMA.1121.00058,2,1507247,1524112,+,16865
203,BUMA.1121.00041,2,1844997,1861985,+,16988
203,BUMA.1121.00084,2,2783337,2800203,+,16866
203,BUMA.1121.00096,2,1117817,1134599,+,16782
203,BUMA.1121.00080,2,957953,974712,+,16759
203,BUMA.1121.00013,2,1812652,1829452,-,16800
203,BUMA.1121.00100,2,2062818,2079596,+,16778
203,BUMA.1121.00012,2,786354,803310,-,16956
203,BUMA.1121.00018,2,2832155,2848889,-,16734
203,BUMA.1121.00048,2,2239298,2256057,-,16759
203,BUMA.1121.00106,2,845517,862428,-,16911
203,BUMA.1121.00017,2,1064330,1081123,-,16793
203,BUMA.1121.00082,2,965664,982437,+,16773
202,BUMA.1121.00049,2,2761497,2770122,+,8625
202,BUMA.1121.00055,2,1716549,1725274,-,8725
202,BUMA.1121.00011,2,2825689,2834350,+,8661
202,BUMA.1121.00110,2,1490628,1499339,-,8711
202,BUMA.1121.00109,2,455977,464693,-,8716
202,BUMA.1121.00077,2,2784505,2793216,-,8711
202,BUMA.1121.00027,2,2007777,2016441,+,8664
202,BUMA.1121.00026,2,1723452,1732250,-,8798
202,BUMA.1121.00021,2,1409895,1418554,+,8659
202,BUMA.1121.00023,2,986636,995297,+,8661
202,BUMA.1121.00025,2,104648,113367,-,8719
202,BUMA.1121.00031,2,82953,91613,+,8660
202,BUMA.1121.00007,2,988955,997578,+,8623
202,BUMA.1121.00097,2,742349,750995,+,8646
202,BUMA.1121.00059,2,2704111,2712812,-,8701
202,BUMA.1121.00005,2,2331873,2340509,+,8636
202,BUMA.1121.00111,2,166806,175481,+,8675
202,BUMA.1121.00009,2,2846572,2855200,+,8628
202,BUMA.1121.00094,2,990700,999345,+,8645
202,BUMA.1121.00101,2,2453009,2461713,-,8704
202,BUMA.1121.00066,2,933353,942015,+,8662
202,BUMA.1121.00095,2,380910,389589,-,8679
202,BUMA.1121.00112,2,212030,220740,-,8710
202,BUMA.1121.00042,2,354102,362782,+,8680
202,BUMA.1121.00090,2,1881569,1890230,+,8661
202,BUMA.1121.00089,2,935478,944123,+,8645
202,BUMA.1121.00051,2,947189,955834,+,8645
202,BUMA.1121.00001,2,1308510,1317274,-,8764
202,BUMA.1121.00045,2,783970,792598,+,8628
202,BUMA.1121.00043,2,1467680,1476393,-,8713
202,BUMA.1121.00063,2,926811,935475,+,8664
202,BUMA.1121.00079,2,947586,956237,+,8651
202,BUMA.1121.00071,2,927097,935759,+,8662
202,BUMA.1121.00040,2,1376535,1385236,-,8701
202,BUMA.1121.00093,2,1975958,1984693,-,8735
202,BUMA.1121.00091,2,2725747,2734475,-,8728
202,BUMA.1121.00107,2,2945976,2954739,-,8763
202,BUMA.1121.00088,2,890768,899560,+,8792
202,BUMA.1121.00047,2,1877726,1886371,+,8645
202,BUMA.1121.00039,2,3007274,3016012,-,8738
202,BUMA.1121.00016,2,2805770,2814473,-,8703
202,BUMA.1121.00092,2,960465,969112,+,8647
202,BUMA.1121.00003,2,2948059,2956815,-,8756
202,BUMA.1121.00015,2,1635234,1643981,-,8747
202,BUMA.1121.00105,2,1566700,1575386,-,8686
202,BUMA.1121.00053,2,1179743,1188409,+,8666
202,BUMA.1121.00057,2,1133445,1142197,-,8752
202,BUMA.1121.00108,2,1175399,1184038,+,8639
202,BUMA.1121.00050,2,1127395,1136075,+,8680
202,BUMA.1121.00104,2,1041479,1050135,+,8656
202,BUMA.1121.00014,2,1016269,1024928,+,8659
202,BUMA.1121.00098,2,1149096,1157742,+,8646
202,BUMA.1121.00078,2,2269838,2278632,-,8794
202,BUMA.1121.00029,2,421456,430169,-,8713
202,BUMA.1121.00099,2,1154161,1162805,+,8644
202,BUMA.1121.00103,2,2807023,2815652,+,8629
202,BUMA.1121.00102,2,941398,950064,+,8666
202,BUMA.1121.00075,2,1238938,1247744,+,8806
202,BUMA.1121.00076,2,1833006,1841827,+,8821
202,BUMA.1121.00074,2,44598,53275,-,8677
202,BUMA.1121.00073,2,927688,936351,+,8663
202,BUMA.1121.00083,2,2753064,2761728,+,8664
202,BUMA.1121.00035,2,398617,407366,-,8749
202,BUMA.1121.00072,2,923885,932547,+,8662
202,BUMA.1121.00056,2,3049877,3058610,-,8733
202,BUMA.1121.00033,2,1631137,1639797,+,8660
202,BUMA.1121.00061,2,917733,926396,+,8663
202,BUMA.1121.00062,2,826155,834847,-,8692
202,BUMA.1121.00064,2,861209,869834,+,8625
202,BUMA.1121.00060,2,1301266,1309952,-,8686
202,BUMA.1121.00069,2,925607,934271,+,8664
202,BUMA.1121.00070,2,927706,936369,+,8663
202,BUMA.1121.00068,2,2655275,2663932,+,8657
202,BUMA.1121.00067,2,3021937,3030614,-,8677
202,BUMA.1121.00037,2,1254065,1262726,+,8661
202,BUMA.1121.00065,2,939245,947892,+,8647
202,BUMA.1121.00058,2,1497714,1506349,+,8635
202,BUMA.1121.00041,2,1835395,1844099,+,8704
202,BUMA.1121.00084,2,2773755,2782439,+,8684
202,BUMA.1121.00096,2,1108293,1116919,+,8626
202,BUMA.1121.00080,2,948411,957055,+,8644
202,BUMA.1121.00013,2,1358504,1367175,+,8671
202,BUMA.1121.00100,2,2053289,2061920,+,8631
202,BUMA.1121.00012,2,804208,812937,-,8729
202,BUMA.1121.00018,2,2849787,2858506,-,8719
202,BUMA.1121.00106,2,863326,872020,-,8694
202,BUMA.1121.00082,2,956107,964771,+,8664
201,BUMA.1121.00049,2,2754020,2758034,+,4014
201,BUMA.1121.00055,2,1728675,1732688,-,4013
201,BUMA.1121.00011,2,2818326,2822179,+,3853
201,BUMA.1121.00110,2,1502791,1506931,-,4140
201,BUMA.1121.00109,2,468137,471986,-,3849
201,BUMA.1121.00077,2,2796668,2800808,-,4140
201,BUMA.1121.00027,2,1998695,2002709,+,4014
201,BUMA.1121.00026,2,1737264,1741129,-,3865
201,BUMA.1121.00021,2,1402434,1406442,+,4008
201,BUMA.1121.00023,2,979148,983161,+,4013
201,BUMA.1121.00022,2,642792,646657,-,3865
201,BUMA.1121.00034,2,1083328,1087193,-,3865
201,BUMA.1121.00025,2,116760,120773,-,4013
201,BUMA.1121.00031,2,75430,79443,+,4013
201,BUMA.1121.00007,2,981494,985486,+,3992
201,BUMA.1121.00097,2,734865,738879,+,4014
201,BUMA.1121.00008,2,1067484,1071349,-,3865
201,BUMA.1121.00059,2,2716212,2720061,-,3849
201,BUMA.1121.00002,2,1460368,1464233,+,3865
201,BUMA.1121.00004,2,1068184,1072049,-,3865
201,BUMA.1121.00005,2,2324407,2328416,+,4009
201,BUMA.1121.00111,2,159302,163306,+,4004
201,BUMA.1121.00006,2,1141228,1145093,+,3865
201,BUMA.1121.00009,2,2838836,2843129,+,4293
201,BUMA.1121.00094,2,983374,987224,+,3850
201,BUMA.1121.00101,2,2465128,2469130,-,4002
201,BUMA.1121.00066,2,924271,928279,+,4008
201,BUMA.1121.00095,2,393003,396853,-,3850
201,BUMA.1121.00112,2,224133,228147,-,4014
201,BUMA.1121.00042,2,345180,349045,+,3865
201,BUMA.1121.00090,2,1874063,1878076,+,4013
201,BUMA.1121.00020,2,1068221,1072086,-,3865
201,BUMA.1121.00089,2,928135,931985,+,3850
201,BUMA.1121.00051,2,939829,943679,+,3850
201,BUMA.1121.00001,2,1320669,1324682,-,4013
201,BUMA.1121.00045,2,776501,780514,+,4013
201,BUMA.1121.00043,2,1479805,1483803,-,3998
201,BUMA.1121.00063,2,917733,921740,+,4007
201,BUMA.1121.00079,2,940260,944109,+,3849
201,BUMA.1121.00071,2,918019,922027,+,4008
201,BUMA.1121.00086,2,1450412,1454277,-,3865
201,BUMA.1121.00024,2,1203290,1207155,-,3865
201,BUMA.1121.00010,2,219223,223088,+,3865
201,BUMA.1121.00040,2,1390259,1394124,-,3865
201,BUMA.1121.00093,2,1988084,1992098,-,4014
201,BUMA.1121.00091,2,2737901,2741914,-,4013
201,BUMA.1121.00107,2,2958194,2962053,-,3859
201,BUMA.1121.00088,2,883425,887275,+,3850
201,BUMA.1121.00047,2,1870395,1874245,+,3850
201,BUMA.1121.00019,2,1147344,1151209,-,3865
201,BUMA.1121.00087,2,1717802,1721667,-,3865
201,BUMA.1121.00039,2,3019415,3023428,-,4013
201,BUMA.1121.00030,2,1034601,1038466,+,3865
201,BUMA.1121.00016,2,2817868,2821862,-,3994
201,BUMA.1121.00092,2,952973,956987,+,4014
201,BUMA.1121.00003,2,2960236,2964233,-,3997
201,BUMA.1121.00054,2,941344,945209,+,3865
201,BUMA.1121.00015,2,1648992,1652857,-,3865
201,BUMA.1121.00105,2,1578788,1582785,-,3997
201,BUMA.1121.00053,2,1172402,1176268,+,3866
201,BUMA.1121.00057,2,1145601,1149467,-,3866
201,BUMA.1121.00108,2,1167946,1171959,+,4013
201,BUMA.1121.00050,2,1118474,1122339,+,3865
201,BUMA.1121.00104,2,1034019,1038033,+,4014
201,BUMA.1121.00014,2,1008792,1012805,+,4013
201,BUMA.1121.00036,2,702130,705995,-,3865
201,BUMA.1121.00038,2,1042395,1046260,+,3865
201,BUMA.1121.00098,2,1141763,1145629,+,3866
201,BUMA.1121.00078,2,2282038,2285904,-,3866
201,BUMA.1121.00029,2,433566,437560,-,3994
201,BUMA.1121.00099,2,1146669,1150689,+,4020
201,BUMA.1121.00103,2,2798093,2801958,+,3865
201,BUMA.1121.00102,2,933997,937863,+,3866
201,BUMA.1121.00028,2,1109439,1113304,-,3865
201,BUMA.1121.00075,2,1231607,1235455,+,3848
201,BUMA.1121.00044,2,1134432,1138297,-,3865
201,BUMA.1121.00076,2,1825668,1829517,+,3849
201,BUMA.1121.00074,2,56675,60524,-,3849
201,BUMA.1121.00073,2,918606,922614,+,4008
201,BUMA.1121.00083,2,2743982,2747990,+,4008
201,BUMA.1121.00035,2,410763,414757,-,3994
201,BUMA.1121.00072,2,914815,918823,+,4008
201,BUMA.1121.00056,2,3062016,3065866,-,3850
201,BUMA.1121.00081,2,1178445,1182310,-,3865
201,BUMA.1121.00033,2,1623669,1627668,+,3999
201,BUMA.1121.00061,2,908651,912659,+,4008
201,BUMA.1121.00062,2,838253,842103,-,3850
201,BUMA.1121.00064,2,853903,857752,+,3849
201,BUMA.1121.00060,2,1313345,1317358,-,4013
201,BUMA.1121.00069,2,916525,920533,+,4008
201,BUMA.1121.00070,2,918625,922633,+,4008
201,BUMA.1121.00068,2,2647923,2651789,+,3866
201,BUMA.1121.00067,2,3034014,3037863,-,3849
201,BUMA.1121.00037,2,1246570,1250583,+,4013
201,BUMA.1121.00065,2,931772,935786,+,4014
201,BUMA.1121.00058,2,1490363,1494229,+,3866
201,BUMA.1121.00041,2,1826381,1830394,+,4013
201,BUMA.1121.00084,2,2766504,2770353,+,3849
201,BUMA.1121.00096,2,1100942,1104808,+,3866
201,BUMA.1121.00080,2,941062,944912,+,3850
201,BUMA.1121.00013,2,1349574,1353439,+,3865
201,BUMA.1121.00100,2,2045962,2049828,+,3866
201,BUMA.1121.00012,2,816333,820346,-,4013
201,BUMA.1121.00018,2,2861899,2865912,-,4013
201,BUMA.1121.00048,2,1917799,1921664,-,3865
201,BUMA.1121.00106,2,877015,880864,-,3849
201,BUMA.1121.00017,2,1083307,1087172,-,3865
201,BUMA.1121.00082,2,947025,951033,+,4008
200,BUMA.1121.00049,2,2717962,2754018,+,36056
200,BUMA.1121.00055,2,1732689,1768772,-,36083
200,BUMA.1121.00011,2,2782237,2818324,+,36087
200,BUMA.1121.00110,2,1506932,1543013,-,36081
200,BUMA.1121.00109,2,471987,508071,-,36084
200,BUMA.1121.00077,2,2800809,2836889,-,36080
200,BUMA.1121.00027,2,1962604,1998693,+,36089
200,BUMA.1121.00026,2,1741130,1777097,-,35967
200,BUMA.1121.00021,2,1366354,1402432,+,36078
200,BUMA.1121.00023,2,943079,979146,+,36067
200,BUMA.1121.00022,2,646658,682658,-,36000
200,BUMA.1121.00034,2,1087194,1123182,-,35988
200,BUMA.1121.00025,2,120774,156849,-,36075
200,BUMA.1121.00031,2,39368,75428,+,36060
200,BUMA.1121.00007,2,945425,981492,+,36067
200,BUMA.1121.00097,2,698789,734863,+,36074
200,BUMA.1121.00008,2,1071350,1107338,-,35988
200,BUMA.1121.00059,2,2720062,2756133,-,36071
200,BUMA.1121.00002,2,1424379,1460366,+,35987
200,BUMA.1121.00004,2,1072050,1108038,-,35988
200,BUMA.1121.00005,2,2288364,2324405,+,36041
200,BUMA.1121.00111,2,123231,159300,+,36069
200,BUMA.1121.00006,2,1105239,1141226,+,35987
200,BUMA.1121.00009,2,2802787,2838834,+,36047
200,BUMA.1121.00094,2,947313,983372,+,36059
200,BUMA.1121.00101,2,2469131,2505175,-,36044
200,BUMA.1121.00066,2,888193,924269,+,36076
200,BUMA.1121.00095,2,396854,432933,-,36079
200,BUMA.1121.00112,2,228148,264201,-,36053
200,BUMA.1121.00042,2,307881,345178,+,37297
200,BUMA.1121.00090,2,1837973,1874061,+,36088
200,BUMA.1121.00020,2,1072087,1108075,-,35988
200,BUMA.1121.00089,2,892063,928133,+,36070
200,BUMA.1121.00051,2,903760,939827,+,36067
200,BUMA.1121.00001,2,1324683,1360756,-,36073
200,BUMA.1121.00045,2,740447,776499,+,36052
200,BUMA.1121.00043,2,1483804,1519893,-,36089
200,BUMA.1121.00063,2,881661,917731,+,36070
200,BUMA.1121.00079,2,904189,940258,+,36069
200,BUMA.1121.00071,2,881973,918017,+,36044
200,BUMA.1121.00086,2,1454278,1490280,-,36002
200,BUMA.1121.00024,2,1207156,1243144,-,35988
200,BUMA.1121.00010,2,183232,219221,+,35989
200,BUMA.1121.00040,2,1394125,1430127,-,36002
200,BUMA.1121.00093,2,1992099,2028145,-,36046
200,BUMA.1121.00091,2,2741915,2777985,-,36070
200,BUMA.1121.00107,2,2962054,2998123,-,36069
200,BUMA.1121.00088,2,847366,883423,+,36057
200,BUMA.1121.00047,2,1834311,1870393,+,36082
200,BUMA.1121.00019,2,1151210,1187198,-,35988
200,BUMA.1121.00087,2,1721668,1757663,-,35995
200,BUMA.1121.00039,2,3023429,3059513,-,36084
200,BUMA.1121.00030,2,998612,1034599,+,35987
200,BUMA.1121.00016,2,2893379,2929451,-,36072
200,BUMA.1121.00092,2,916926,952971,+,36045
200,BUMA.1121.00003,2,2964234,3000283,-,36049
200,BUMA.1121.00054,2,905355,941342,+,35987
200,BUMA.1121.00015,2,1652858,1688853,-,35995
200,BUMA.1121.00105,2,1582786,1618827,-,36041
200,BUMA.1121.00053,2,1136312,1172400,+,36088
200,BUMA.1121.00057,2,1149468,1185594,-,36126
200,BUMA.1121.00108,2,1131888,1167944,+,36056
200,BUMA.1121.00050,2,1082485,1118472,+,35987
200,BUMA.1121.00104,2,997935,1034017,+,36082
200,BUMA.1121.00014,2,972728,1008790,+,36062
200,BUMA.1121.00036,2,705996,741991,-,35995
200,BUMA.1121.00038,2,1006406,1042393,+,35987
200,BUMA.1121.00098,2,1105675,1141761,+,36086
200,BUMA.1121.00078,2,2285905,2322017,-,36112
200,BUMA.1121.00029,2,439977,476066,-,36089
200,BUMA.1121.00099,2,1110596,1146667,+,36071
200,BUMA.1121.00103,2,2762040,2798091,+,36051
200,BUMA.1121.00102,2,897904,933995,+,36091
200,BUMA.1121.00028,2,1113305,1149293,-,35988
200,BUMA.1121.00075,2,1195532,1231605,+,36073
200,BUMA.1121.00044,2,1138298,1174286,-,35988
200,BUMA.1121.00076,2,1789622,1825666,+,36044
200,BUMA.1121.00074,2,60525,96587,-,36062
200,BUMA.1121.00073,2,882537,918604,+,36067
200,BUMA.1121.00083,2,2707904,2743980,+,36076
200,BUMA.1121.00035,2,487209,523305,-,36096
200,BUMA.1121.00072,2,878806,914813,+,36007
200,BUMA.1121.00056,2,3065867,3101938,-,36071
200,BUMA.1121.00081,2,1182311,1218300,-,35989
200,BUMA.1121.00033,2,1587589,1623667,+,36078
200,BUMA.1121.00061,2,872582,908649,+,36067
200,BUMA.1121.00062,2,842104,878180,-,36076
200,BUMA.1121.00064,2,817840,853901,+,36061
200,BUMA.1121.00060,2,1317359,1353405,-,36046
200,BUMA.1121.00069,2,880467,916523,+,36056
200,BUMA.1121.00070,2,882578,918623,+,36045
200,BUMA.1121.00068,2,2611869,2647921,+,36052
200,BUMA.1121.00067,2,3037864,3073938,-,36074
200,BUMA.1121.00037,2,1210495,1246568,+,36073
200,BUMA.1121.00065,2,895715,931770,+,36055
200,BUMA.1121.00058,2,1454302,1490361,+,36059
200,BUMA.1121.00041,2,1790303,1826379,+,36076
200,BUMA.1121.00084,2,2730457,2766502,+,36045
200,BUMA.1121.00096,2,1064863,1100940,+,36077
200,BUMA.1121.00080,2,904983,941060,+,36077
200,BUMA.1121.00013,2,1313592,1349572,+,35980
200,BUMA.1121.00100,2,2009894,2045960,+,36066
200,BUMA.1121.00012,2,820347,856400,-,36053
200,BUMA.1121.00018,2,2865913,2901988,-,36075
200,BUMA.1121.00048,2,1921665,1957653,-,35988
200,BUMA.1121.00106,2,880865,916985,-,36120
200,BUMA.1121.00017,2,1087173,1123161,-,35988
200,BUMA.1121.00082,2,910947,947023,+,36076
199,BUMA.1121.00049,2,2711348,2717743,+,6395
199,BUMA.1121.00055,2,1768994,1775357,-,6363
199,BUMA.1121.00011,2,2775617,2782012,+,6395
199,BUMA.1121.00110,2,1543238,1549631,-,6393
199,BUMA.1121.00109,2,508296,514685,-,6389
199,BUMA.1121.00077,2,2837114,2843509,-,6395
199,BUMA.1121.00027,2,1955987,1962382,+,6395
199,BUMA.1121.00026,2,1777316,1783671,-,6355
199,BUMA.1121.00021,2,1358409,1366135,+,7726
199,BUMA.1121.00023,2,935155,942860,+,7705
199,BUMA.1121.00022,2,682877,689256,-,6379
199,BUMA.1121.00034,2,1123401,1129780,-,6379
199,BUMA.1121.00025,2,157068,164773,-,7705
199,BUMA.1121.00031,2,31464,39149,+,7685
199,BUMA.1121.00007,2,938793,945200,+,6407
199,BUMA.1121.00097,2,692257,698570,+,6313
199,BUMA.1121.00008,2,1107557,1113936,-,6379
199,BUMA.1121.00059,2,2756352,2762737,-,6385
199,BUMA.1121.00002,2,1417781,1424160,+,6379
199,BUMA.1121.00004,2,1108257,1114636,-,6379
199,BUMA.1121.00005,2,2281761,2288145,+,6384
199,BUMA.1121.00111,2,116620,123012,+,6392
199,BUMA.1121.00006,2,1098641,1105020,+,6379
199,BUMA.1121.00009,2,2796167,2802562,+,6395
199,BUMA.1121.00094,2,940728,947091,+,6363
199,BUMA.1121.00101,2,2505400,2511778,-,6378
199,BUMA.1121.00066,2,881586,887971,+,6385
199,BUMA.1121.00095,2,433155,439533,-,6378
199,BUMA.1121.00112,2,264426,270822,-,6396
199,BUMA.1121.00042,2,301307,307662,+,6355
199,BUMA.1121.00090,2,1830049,1837754,+,7705
199,BUMA.1121.00020,2,1108294,1114673,-,6379
199,BUMA.1121.00089,2,885478,891841,+,6363
199,BUMA.1121.00051,2,897175,903538,+,6363
199,BUMA.1121.00001,2,1360975,1368680,-,7705
199,BUMA.1121.00045,2,733846,740222,+,6376
199,BUMA.1121.00043,2,1520115,1526520,-,6405
199,BUMA.1121.00063,2,875054,881439,+,6385
199,BUMA.1121.00079,2,897604,903967,+,6363
199,BUMA.1121.00071,2,875366,881751,+,6385
199,BUMA.1121.00086,2,1490499,1496878,-,6379
199,BUMA.1121.00024,2,1243363,1249742,-,6379
199,BUMA.1121.00010,2,176634,183013,+,6379
199,BUMA.1121.00040,2,1430346,1436725,-,6379
199,BUMA.1121.00093,2,2028364,2034746,-,6382
199,BUMA.1121.00091,2,2778210,2784595,-,6385
199,BUMA.1121.00107,2,2998348,3004777,-,6429
199,BUMA.1121.00088,2,840769,847147,+,6378
199,BUMA.1121.00047,2,1827726,1834089,+,6363
199,BUMA.1121.00019,2,1187417,1193796,-,6379
199,BUMA.1121.00087,2,1757882,1764261,-,6379
199,BUMA.1121.00039,2,3059732,3067437,-,7705
199,BUMA.1121.00030,2,992014,998393,+,6379
199,BUMA.1121.00016,2,2929673,2936072,-,6399
199,BUMA.1121.00092,2,910325,916707,+,6382
199,BUMA.1121.00003,2,3000505,3006874,-,6369
199,BUMA.1121.00054,2,898757,905136,+,6379
199,BUMA.1121.00015,2,1689072,1695451,-,6379
199,BUMA.1121.00105,2,1619049,1625433,-,6384
199,BUMA.1121.00053,2,1129705,1136093,+,6388
199,BUMA.1121.00057,2,1185816,1192200,-,6384
199,BUMA.1121.00108,2,1125278,1131663,+,6385
199,BUMA.1121.00050,2,1075887,1082266,+,6379
199,BUMA.1121.00104,2,991325,997710,+,6385
199,BUMA.1121.00014,2,964824,972509,+,7685
199,BUMA.1121.00036,2,742210,748589,-,6379
199,BUMA.1121.00038,2,999808,1006187,+,6379
199,BUMA.1121.00098,2,1099054,1105450,+,6396
199,BUMA.1121.00078,2,2322242,2328630,-,6388
199,BUMA.1121.00029,2,476285,483990,-,7705
199,BUMA.1121.00099,2,1103995,1110371,+,6376
199,BUMA.1121.00103,2,2755476,2761815,+,6339
199,BUMA.1121.00102,2,891291,897679,+,6388
199,BUMA.1121.00028,2,1149512,1155891,-,6379
199,BUMA.1121.00075,2,1188926,1195310,+,6384
199,BUMA.1121.00044,2,1174505,1180884,-,6379
199,BUMA.1121.00076,2,1783015,1789400,+,6385
199,BUMA.1121.00074,2,96806,103184,-,6378
199,BUMA.1121.00073,2,875930,882315,+,6385
199,BUMA.1121.00083,2,2701297,2707682,+,6385
199,BUMA.1121.00035,2,523524,531229,-,7705
199,BUMA.1121.00072,2,872199,878584,+,6385
199,BUMA.1121.00056,2,20,6383,-,6363
199,BUMA.1121.00081,2,1218519,1224898,-,6379
199,BUMA.1121.00033,2,1580986,1587364,+,6378
199,BUMA.1121.00061,2,865975,872360,+,6385
199,BUMA.1121.00062,2,878402,884787,-,6385
199,BUMA.1121.00064,2,811225,817621,+,6396
199,BUMA.1121.00060,2,1353630,1360006,-,6376
199,BUMA.1121.00069,2,873860,880245,+,6385
199,BUMA.1121.00070,2,875971,882356,+,6385
199,BUMA.1121.00068,2,2605265,2611644,+,6379
199,BUMA.1121.00067,2,3074157,3080542,-,6385
199,BUMA.1121.00037,2,1203985,1210276,+,6291
199,BUMA.1121.00065,2,889149,895490,+,6341
199,BUMA.1121.00058,2,1447683,1454083,+,6400
199,BUMA.1121.00041,2,1783688,1790078,+,6390
199,BUMA.1121.00084,2,2723833,2730232,+,6399
199,BUMA.1121.00096,2,1058289,1064641,+,6352
199,BUMA.1121.00080,2,898398,904761,+,6363
199,BUMA.1121.00013,2,1306994,1313373,+,6379
199,BUMA.1121.00100,2,2003288,2009669,+,6381
199,BUMA.1121.00012,2,856619,863011,-,6392
199,BUMA.1121.00018,2,2902207,2909912,-,7705
199,BUMA.1121.00048,2,1957872,1964251,-,6379
199,BUMA.1121.00106,2,917207,923592,-,6385
199,BUMA.1121.00017,2,1123380,1129759,-,6379
199,BUMA.1121.00082,2,904340,910725,+,6385
198,BUMA.1121.00049,2,2704008,2707017,+,3009
198,BUMA.1121.00055,2,1779688,1782694,-,3006
198,BUMA.1121.00011,2,2768277,2771282,+,3005
198,BUMA.1121.00110,2,1553992,1557010,-,3018
198,BUMA.1121.00109,2,519016,522025,-,3009
198,BUMA.1121.00077,2,2847867,2850885,-,3018
198,BUMA.1121.00027,2,1948648,1951657,+,3009
198,BUMA.1121.00021,2,1351059,1354076,+,3017
198,BUMA.1121.00023,2,927805,930822,+,3017
198,BUMA.1121.00025,2,169105,172122,-,3017
198,BUMA.1121.00031,2,24114,27131,+,3017
198,BUMA.1121.00007,2,931455,934460,+,3005
198,BUMA.1121.00097,2,684910,687927,+,3017
198,BUMA.1121.00059,2,2767079,2770085,-,3006
198,BUMA.1121.00005,2,2274424,2277429,+,3005
198,BUMA.1121.00111,2,109270,112287,+,3017
198,BUMA.1121.00009,2,2788811,2791828,+,3017
198,BUMA.1121.00094,2,933380,936388,+,3008
198,BUMA.1121.00101,2,2516149,2519155,-,3006
198,BUMA.1121.00066,2,874241,877246,+,3005
198,BUMA.1121.00095,2,443867,446872,-,3005
198,BUMA.1121.00112,2,276538,279547,-,3009
198,BUMA.1121.00090,2,1822699,1825716,+,3017
198,BUMA.1121.00089,2,878131,881139,+,3008
198,BUMA.1121.00051,2,889828,892836,+,3008
198,BUMA.1121.00001,2,1373012,1376029,-,3017
198,BUMA.1121.00045,2,726501,729506,+,3005
198,BUMA.1121.00043,2,1530851,1533856,-,3005
198,BUMA.1121.00063,2,867709,870714,+,3005
198,BUMA.1121.00079,2,890257,893265,+,3008
198,BUMA.1121.00071,2,868022,871027,+,3005
198,BUMA.1121.00093,2,2039085,2042091,-,3006
198,BUMA.1121.00091,2,2788926,2791932,-,3006
198,BUMA.1121.00107,2,3009108,3012114,-,3006
198,BUMA.1121.00088,2,833421,836430,+,3009
198,BUMA.1121.00047,2,1820379,1823387,+,3008
198,BUMA.1121.00039,2,3071769,3076122,-,4353
198,BUMA.1121.00016,2,2940401,2943408,-,3007
198,BUMA.1121.00092,2,902980,905985,+,3005
198,BUMA.1121.00003,2,3011205,3014213,-,3008
198,BUMA.1121.00105,2,1629912,1632918,-,3006
198,BUMA.1121.00053,2,1122355,1125372,+,3017
198,BUMA.1121.00057,2,1196531,1199540,-,3009
198,BUMA.1121.00108,2,1117934,1120939,+,3005
198,BUMA.1121.00104,2,983980,986984,+,3004
198,BUMA.1121.00014,2,957474,960491,+,3017
198,BUMA.1121.00098,2,1091710,1094714,+,3004
198,BUMA.1121.00078,2,2332969,2335978,-,3009
198,BUMA.1121.00029,2,488322,491327,-,3005
198,BUMA.1121.00099,2,1095420,1098425,+,3005
198,BUMA.1121.00103,2,2748102,2751119,+,3017
198,BUMA.1121.00102,2,883941,886958,+,3017
198,BUMA.1121.00075,2,1181578,1184587,+,3009
198,BUMA.1121.00076,2,1775667,1778676,+,3009
198,BUMA.1121.00074,2,107526,110544,-,3018
198,BUMA.1121.00073,2,868585,871590,+,3005
198,BUMA.1121.00083,2,2693952,2696957,+,3005
198,BUMA.1121.00035,2,535561,538578,-,3017
198,BUMA.1121.00072,2,864854,867859,+,3005
198,BUMA.1121.00056,2,10722,13730,-,3008
198,BUMA.1121.00033,2,1573653,1576658,+,3005
198,BUMA.1121.00061,2,858630,861635,+,3005
198,BUMA.1121.00062,2,889118,892127,-,3009
198,BUMA.1121.00064,2,803877,806882,+,3005
198,BUMA.1121.00060,2,1364345,1367351,-,3006
198,BUMA.1121.00069,2,866515,869520,+,3005
198,BUMA.1121.00070,2,868626,871631,+,3005
198,BUMA.1121.00068,2,2596681,2599702,+,3021
198,BUMA.1121.00067,2,3084884,3087890,-,3006
198,BUMA.1121.00037,2,1195364,1198381,+,3017
198,BUMA.1121.00065,2,881803,884808,+,3005
198,BUMA.1121.00058,2,1440343,1443344,+,3001
198,BUMA.1121.00041,2,1776352,1779357,+,3005
198,BUMA.1121.00084,2,2716485,2719490,+,3005
198,BUMA.1121.00096,2,1050942,1053949,+,3007
198,BUMA.1121.00080,2,891051,894059,+,3008
198,BUMA.1121.00100,2,1995948,1998954,+,3006
198,BUMA.1121.00012,2,867343,870349,-,3006
198,BUMA.1121.00018,2,2914244,2917261,-,3017
198,BUMA.1121.00106,2,927931,930939,-,3008
198,BUMA.1121.00082,2,896995,900000,+,3005
197,BUMA.1121.00049,2,2678717,2692621,+,13904
197,BUMA.1121.00055,2,1794191,1808049,-,13858
197,BUMA.1121.00011,2,2744262,2757992,+,13730
197,BUMA.1121.00110,2,1567302,1581206,-,13904
197,BUMA.1121.00109,2,532314,546257,-,13943
197,BUMA.1121.00077,2,2861177,2875078,-,13901
197,BUMA.1121.00027,2,1924510,1938365,+,13855
197,BUMA.1121.00026,2,1784908,1798723,-,13815
197,BUMA.1121.00021,2,1326905,1340786,+,13881
197,BUMA.1121.00023,2,903627,917520,+,13893
197,BUMA.1121.00022,2,695732,709604,-,13872
197,BUMA.1121.00034,2,1134503,1148389,-,13886
197,BUMA.1121.00025,2,182408,196336,-,13928
197,BUMA.1121.00031,2,1,13829,+,13828
197,BUMA.1121.00007,2,907312,921171,+,13859
197,BUMA.1121.00097,2,660922,674626,+,13704
197,BUMA.1121.00008,2,1118659,1132545,-,13886
197,BUMA.1121.00059,2,2780258,2794153,-,13895
197,BUMA.1121.00002,2,1397435,1411305,+,13870
197,BUMA.1121.00004,2,1119359,1133245,-,13886
197,BUMA.1121.00005,2,2250447,2264139,+,13692
197,BUMA.1121.00111,2,85100,98985,+,13885
197,BUMA.1121.00006,2,1453807,1467703,-,13896
197,BUMA.1121.00009,2,2764604,2778525,+,13921
197,BUMA.1121.00094,2,909199,923095,+,13896
197,BUMA.1121.00101,2,2529440,2543306,-,13866
197,BUMA.1121.00066,2,850060,863956,+,13896
197,BUMA.1121.00095,2,457045,470971,-,13926
197,BUMA.1121.00112,2,289832,303716,-,13884
197,BUMA.1121.00090,2,1798540,1812414,+,13874
197,BUMA.1121.00020,2,1119396,1133275,-,13879
197,BUMA.1121.00089,2,853958,867846,+,13888
197,BUMA.1121.00051,2,865616,879543,+,13927
197,BUMA.1121.00001,2,1386302,1400171,-,13869
197,BUMA.1121.00045,2,702276,716218,+,13942
197,BUMA.1121.00043,2,1546392,1560256,-,13864
197,BUMA.1121.00063,2,843531,857424,+,13893
197,BUMA.1121.00079,2,866035,879972,+,13937
197,BUMA.1121.00071,2,843833,857737,+,13904
197,BUMA.1121.00086,2,1503354,1517233,-,13879
197,BUMA.1121.00024,2,1254465,1268351,-,13886
197,BUMA.1121.00010,2,156288,170158,+,13870
197,BUMA.1121.00040,2,1441843,1455726,-,13883
197,BUMA.1121.00093,2,2052263,2066122,-,13859
197,BUMA.1121.00091,2,2803565,2817424,-,13859
197,BUMA.1121.00107,2,3022399,3036263,-,13864
197,BUMA.1121.00088,2,809340,823248,+,13908
197,BUMA.1121.00047,2,1796167,1810094,+,13927
197,BUMA.1121.00019,2,1198519,1212398,-,13879
197,BUMA.1121.00087,2,1770736,1784615,-,13879
197,BUMA.1121.00039,2,3086407,3100274,-,13867
197,BUMA.1121.00030,2,973405,987291,+,13886
197,BUMA.1121.00016,2,2957318,2971137,-,13819
197,BUMA.1121.00092,2,878949,892808,+,13859
197,BUMA.1121.00003,2,3023645,3037520,-,13875
197,BUMA.1121.00054,2,1253926,1267822,-,13896
197,BUMA.1121.00015,2,828115,842000,+,13885
197,BUMA.1121.00105,2,1643203,1657095,-,13892
197,BUMA.1121.00053,2,1098200,1112064,+,13864
197,BUMA.1121.00057,2,1209825,1223679,-,13854
197,BUMA.1121.00108,2,1093724,1107649,+,13925
197,BUMA.1121.00050,2,1060087,1073974,+,13887
197,BUMA.1121.00104,2,959914,973805,+,13891
197,BUMA.1121.00014,2,933315,947189,+,13874
197,BUMA.1121.00036,2,753803,767696,-,13893
197,BUMA.1121.00038,2,1354973,1368869,-,13896
197,BUMA.1121.00098,2,1066250,1080103,+,13853
197,BUMA.1121.00078,2,2346270,2360199,-,13929
197,BUMA.1121.00029,2,501600,515469,-,13869
197,BUMA.1121.00099,2,1070001,1083930,+,13929
197,BUMA.1121.00103,2,2724025,2737816,+,13791
197,BUMA.1121.00102,2,859761,873656,+,13895
197,BUMA.1121.00028,2,1160614,1174500,-,13886
197,BUMA.1121.00075,2,1157505,1171403,+,13898
197,BUMA.1121.00044,2,1185607,1199493,-,13886
197,BUMA.1121.00076,2,1751594,1765492,+,13898
197,BUMA.1121.00074,2,120718,134610,-,13892
197,BUMA.1121.00073,2,844418,858300,+,13882
197,BUMA.1121.00083,2,2669752,2683667,+,13915
197,BUMA.1121.00035,2,548851,562720,-,13869
197,BUMA.1121.00072,2,840666,854569,+,13903
197,BUMA.1121.00056,2,24015,37903,-,13888
197,BUMA.1121.00081,2,855832,869727,+,13895
197,BUMA.1121.00033,2,1545862,1559736,+,13874
197,BUMA.1121.00061,2,834463,848345,+,13882
197,BUMA.1121.00062,2,902412,916330,-,13918
197,BUMA.1121.00064,2,779785,793704,+,13919
197,BUMA.1121.00060,2,1377634,1391576,-,13942
197,BUMA.1121.00069,2,842336,856230,+,13894
197,BUMA.1121.00070,2,844460,858341,+,13881
197,BUMA.1121.00068,2,2572537,2586396,+,13859
197,BUMA.1121.00067,2,3098063,3111999,-,13936
197,BUMA.1121.00037,2,1171198,1185079,+,13881
197,BUMA.1121.00065,2,857631,871518,+,13887
197,BUMA.1121.00058,2,1416282,1430163,+,13881
197,BUMA.1121.00041,2,1753098,1766047,+,12949
197,BUMA.1121.00084,2,2692404,2706312,+,13908
197,BUMA.1121.00096,2,1026824,1040657,+,13833
197,BUMA.1121.00080,2,866825,880766,+,13941
197,BUMA.1121.00013,2,1288542,1302405,+,13863
197,BUMA.1121.00100,2,1972559,1986510,+,13951
197,BUMA.1121.00012,2,885290,899178,-,13888
197,BUMA.1121.00018,2,2927548,2941476,-,13928
197,BUMA.1121.00048,2,1595198,1609093,+,13895
197,BUMA.1121.00106,2,941114,954998,-,13884
197,BUMA.1121.00017,2,1134482,1148368,-,13886
197,BUMA.1121.00082,2,872795,886710,+,13915
196,BUMA.1121.00049,2,2669838,2678715,+,8877
196,BUMA.1121.00055,2,1808050,1816894,-,8844
196,BUMA.1121.00011,2,2735371,2744260,+,8889
196,BUMA.1121.00110,2,1581207,1589950,-,8743
196,BUMA.1121.00109,2,546258,555105,-,8847
196,BUMA.1121.00077,2,2875079,2883823,-,8744
196,BUMA.1121.00027,2,1915564,1924508,+,8944
196,BUMA.1121.00026,2,1798724,1807499,-,8775
196,BUMA.1121.00021,2,1318035,1326903,+,8868
196,BUMA.1121.00023,2,894774,903625,+,8851
196,BUMA.1121.00022,2,709605,718368,-,8763
196,BUMA.1121.00034,2,1148390,1157165,-,8775
196,BUMA.1121.00025,2,196337,205219,-,8882
196,BUMA.1121.00031,2,3257028,3265896,+,8868
196,BUMA.1121.00007,2,898402,907310,+,8908
196,BUMA.1121.00097,2,652142,660920,+,8778
196,BUMA.1121.00008,2,1132546,1141321,-,8775
196,BUMA.1121.00059,2,2794154,2802948,-,8794
196,BUMA.1121.00002,2,1388580,1397433,+,8853
196,BUMA.1121.00004,2,1133246,1142021,-,8775
196,BUMA.1121.00005,2,2241692,2250445,+,8753
196,BUMA.1121.00111,2,76255,85098,+,8843
196,BUMA.1121.00006,2,1467704,1476458,-,8754
196,BUMA.1121.00009,2,2755821,2764602,+,8781
196,BUMA.1121.00094,2,900242,909197,+,8955
196,BUMA.1121.00101,2,2543307,2552130,-,8823
196,BUMA.1121.00066,2,841148,850058,+,8910
196,BUMA.1121.00095,2,470972,479771,-,8799
196,BUMA.1121.00112,2,303717,312501,-,8784
196,BUMA.1121.00090,2,1789679,1798538,+,8859
196,BUMA.1121.00020,2,1133276,1142051,-,8775
196,BUMA.1121.00089,2,845008,853956,+,8948
196,BUMA.1121.00051,2,856661,865614,+,8953
196,BUMA.1121.00001,2,1400172,1409011,-,8839
196,BUMA.1121.00045,2,693430,702274,+,8844
196,BUMA.1121.00043,2,1560257,1569035,-,8778
196,BUMA.1121.00063,2,834559,843529,+,8970
196,BUMA.1121.00079,2,857097,866033,+,8936
196,BUMA.1121.00071,2,834895,843831,+,8936
196,BUMA.1121.00086,2,1517234,1525997,-,8763
196,BUMA.1121.00024,2,1268352,1277127,-,8775
196,BUMA.1121.00010,2,147445,156286,+,8841
196,BUMA.1121.00040,2,1455727,1464481,-,8754
196,BUMA.1121.00093,2,2066123,2074921,-,8798
196,BUMA.1121.00091,2,2817425,2826256,-,8831
196,BUMA.1121.00107,2,3036264,3045047,-,8783
196,BUMA.1121.00088,2,800483,809338,+,8855
196,BUMA.1121.00047,2,1787192,1796165,+,8973
196,BUMA.1121.00019,2,1212399,1221174,-,8775
196,BUMA.1121.00087,2,1784616,1793379,-,8763
196,BUMA.1121.00039,2,3100275,3109072,-,8797
196,BUMA.1121.00030,2,964529,973403,+,8874
196,BUMA.1121.00016,2,2971138,2979954,-,8816
196,BUMA.1121.00092,2,870098,878947,+,8849
196,BUMA.1121.00003,2,3037521,3046288,-,8767
196,BUMA.1121.00054,2,1267823,1276577,-,8754
196,BUMA.1121.00015,2,819248,828113,+,8865
196,BUMA.1121.00105,2,1657096,1665899,-,8803
196,BUMA.1121.00053,2,1089418,1098198,+,8780
196,BUMA.1121.00057,2,1223680,1232545,-,8865
196,BUMA.1121.00108,2,1084807,1093722,+,8915
196,BUMA.1121.00050,2,1051184,1060085,+,8901
196,BUMA.1121.00104,2,951083,959912,+,8829
196,BUMA.1121.00014,2,924478,933313,+,8835
196,BUMA.1121.00036,2,767697,776460,-,8763
196,BUMA.1121.00038,2,1368870,1377624,-,8754
196,BUMA.1121.00098,2,1057369,1066248,+,8879
196,BUMA.1121.00078,2,2360200,2368988,-,8788
196,BUMA.1121.00029,2,515470,524283,-,8813
196,BUMA.1121.00099,2,1061209,1069999,+,8790
196,BUMA.1121.00103,2,2715171,2724023,+,8852
196,BUMA.1121.00102,2,850964,859759,+,8795
196,BUMA.1121.00028,2,1174501,1183276,-,8775
196,BUMA.1121.00075,2,1148610,1157503,+,8893
196,BUMA.1121.00044,2,1199494,1208269,-,8775
196,BUMA.1121.00076,2,1742699,1751592,+,8893
196,BUMA.1121.00074,2,134611,143494,-,8883
196,BUMA.1121.00073,2,835461,844416,+,8955
196,BUMA.1121.00083,2,2660773,2669750,+,8977
196,BUMA.1121.00035,2,562721,571510,-,8789
196,BUMA.1121.00072,2,831857,840664,+,8807
196,BUMA.1121.00056,2,37904,46837,-,8933
196,BUMA.1121.00081,2,847001,855830,+,8829
196,BUMA.1121.00033,2,1537073,1545860,+,8787
196,BUMA.1121.00061,2,825488,834461,+,8973
196,BUMA.1121.00062,2,916331,925173,-,8842
196,BUMA.1121.00064,2,770936,779783,+,8847
196,BUMA.1121.00060,2,1391577,1400354,-,8777
196,BUMA.1121.00069,2,833370,842334,+,8964
196,BUMA.1121.00070,2,835513,844458,+,8945
196,BUMA.1121.00068,2,2563710,2572535,+,8825
196,BUMA.1121.00067,2,3112000,3120867,-,8867
196,BUMA.1121.00037,2,1162372,1171196,+,8824
196,BUMA.1121.00065,2,848820,857629,+,8809
196,BUMA.1121.00058,2,1407395,1416280,+,8885
196,BUMA.1121.00041,2,1744249,1753096,+,8847
196,BUMA.1121.00084,2,2683600,2692402,+,8802
196,BUMA.1121.00096,2,1017973,1026822,+,8849
196,BUMA.1121.00080,2,857860,866823,+,8963
196,BUMA.1121.00013,2,1279675,1288540,+,8865
196,BUMA.1121.00100,2,1963678,1972557,+,8879
196,BUMA.1121.00012,2,899179,908034,-,8855
196,BUMA.1121.00018,2,2941477,2950359,-,8882
196,BUMA.1121.00048,2,1586367,1595196,+,8829
196,BUMA.1121.00106,2,954999,963820,-,8821
196,BUMA.1121.00017,2,1148369,1157144,-,8775
196,BUMA.1121.00082,2,863816,872793,+,8977
195,BUMA.1121.00049,2,2662796,2667005,+,4209
195,BUMA.1121.00055,2,1819799,1824021,-,4222
195,BUMA.1121.00011,2,2728341,2732586,+,4245
195,BUMA.1121.00110,2,1592843,1597037,-,4194
195,BUMA.1121.00109,2,558000,562228,-,4228
195,BUMA.1121.00077,2,2886716,2890910,-,4194
195,BUMA.1121.00027,2,1908526,1912734,+,4208
195,BUMA.1121.00026,2,1810365,1814601,-,4236
195,BUMA.1121.00021,2,1310926,1315201,+,4275
195,BUMA.1121.00023,2,887710,891940,+,4230
195,BUMA.1121.00022,2,721258,725503,-,4245
195,BUMA.1121.00034,2,1160055,1164332,-,4277
195,BUMA.1121.00025,2,208125,212391,-,4266
195,BUMA.1121.00031,2,3249937,3254194,+,4257
195,BUMA.1121.00007,2,891369,895574,+,4205
195,BUMA.1121.00097,2,645114,649336,+,4222
195,BUMA.1121.00008,2,1144210,1148487,-,4277
195,BUMA.1121.00059,2,2805714,2809914,-,4200
195,BUMA.1121.00002,2,1381536,1385790,+,4254
195,BUMA.1121.00004,2,1144910,1149187,-,4277
195,BUMA.1121.00005,2,2234751,2238967,+,4216
195,BUMA.1121.00111,2,69035,73421,+,4386
195,BUMA.1121.00006,2,1479324,1483637,-,4313
195,BUMA.1121.00009,2,2748746,2752988,+,4242
195,BUMA.1121.00094,2,893204,897413,+,4209
195,BUMA.1121.00101,2,2554975,2559219,-,4244
195,BUMA.1121.00066,2,834088,838334,+,4246
195,BUMA.1121.00095,2,482569,486805,-,4236
195,BUMA.1121.00112,2,315379,319609,-,4230
195,BUMA.1121.00090,2,1782588,1786845,+,4257
195,BUMA.1121.00020,2,1144941,1149218,-,4277
195,BUMA.1121.00089,2,837970,842179,+,4209
195,BUMA.1121.00051,2,849625,853834,+,4209
195,BUMA.1121.00001,2,1411845,1416066,-,4221
195,BUMA.1121.00045,2,686384,690633,+,4249
195,BUMA.1121.00043,2,1571953,1576210,-,4257
195,BUMA.1121.00063,2,827525,831771,+,4246
195,BUMA.1121.00079,2,850052,854265,+,4213
195,BUMA.1121.00071,2,827856,832102,+,4246
195,BUMA.1121.00086,2,1528887,1533195,-,4308
195,BUMA.1121.00024,2,1280029,1284315,-,4286
195,BUMA.1121.00010,2,140401,144655,+,4254
195,BUMA.1121.00040,2,1467359,1471636,-,4277
195,BUMA.1121.00093,2,2077802,2082011,-,4209
195,BUMA.1121.00091,2,2829066,2833287,-,4221
195,BUMA.1121.00107,2,3047896,3052136,-,4240
195,BUMA.1121.00088,2,793435,797653,+,4218
195,BUMA.1121.00047,2,1780154,1784363,+,4209
195,BUMA.1121.00019,2,1224064,1228341,-,4277
195,BUMA.1121.00087,2,1796269,1800577,-,4308
195,BUMA.1121.00039,2,3111906,3116244,-,4338
195,BUMA.1121.00030,2,957462,961740,+,4278
195,BUMA.1121.00016,2,2982898,2987181,-,4283
195,BUMA.1121.00092,2,863060,867269,+,4209
195,BUMA.1121.00003,2,3049153,3053399,-,4246
195,BUMA.1121.00054,2,1279443,1283756,-,4313
195,BUMA.1121.00015,2,812142,816459,+,4317
195,BUMA.1121.00105,2,1668726,1672953,-,4227
195,BUMA.1121.00053,2,1082354,1086620,+,4266
195,BUMA.1121.00057,2,1235475,1239683,-,4208
195,BUMA.1121.00108,2,1077845,1082023,+,4178
195,BUMA.1121.00050,2,1044053,1048394,+,4341
195,BUMA.1121.00104,2,944036,948250,+,4214
195,BUMA.1121.00014,2,917378,921644,+,4266
195,BUMA.1121.00036,2,779362,783634,-,4272
195,BUMA.1121.00038,2,1380490,1384803,-,4313
195,BUMA.1121.00098,2,1050304,1054571,+,4267
195,BUMA.1121.00078,2,2371855,2376070,-,4215
195,BUMA.1121.00029,2,527117,531428,-,4311
195,BUMA.1121.00099,2,1054186,1058424,+,4238
195,BUMA.1121.00103,2,2708017,2712351,+,4334
195,BUMA.1121.00102,2,843967,848166,+,4199
195,BUMA.1121.00028,2,1186166,1190452,-,4286
195,BUMA.1121.00075,2,1141576,1145784,+,4208
195,BUMA.1121.00044,2,1211159,1215436,-,4277
195,BUMA.1121.00076,2,1735662,1739871,+,4209
195,BUMA.1121.00074,2,146327,150540,-,4213
195,BUMA.1121.00073,2,828443,832668,+,4225
195,BUMA.1121.00083,2,2653734,2657979,+,4245
195,BUMA.1121.00035,2,574344,578592,-,4248
195,BUMA.1121.00072,2,824735,828980,+,4245
195,BUMA.1121.00056,2,49682,53891,-,4209
195,BUMA.1121.00081,2,839897,844211,+,4314
195,BUMA.1121.00033,2,1529964,1534240,+,4276
195,BUMA.1121.00061,2,818449,822695,+,4246
195,BUMA.1121.00062,2,928000,932226,-,4226
195,BUMA.1121.00064,2,763903,768103,+,4200
195,BUMA.1121.00060,2,1403219,1407468,-,4249
195,BUMA.1121.00069,2,826331,830577,+,4246
195,BUMA.1121.00070,2,828514,832720,+,4206
195,BUMA.1121.00068,2,2556622,2560877,+,4255
195,BUMA.1121.00067,2,3123700,3127913,-,4213
195,BUMA.1121.00037,2,1155281,1159538,+,4257
195,BUMA.1121.00065,2,841744,845987,+,4243
195,BUMA.1121.00058,2,1400357,1404566,+,4209
195,BUMA.1121.00041,2,1737203,1741419,+,4216
195,BUMA.1121.00084,2,2676564,2680773,+,4209
195,BUMA.1121.00096,2,1010956,1015176,+,4220
195,BUMA.1121.00080,2,850823,855032,+,4209
195,BUMA.1121.00013,2,1272580,1276885,+,4305
195,BUMA.1121.00100,2,1956664,1960857,+,4193
195,BUMA.1121.00012,2,910939,915236,-,4297
195,BUMA.1121.00018,2,2953265,2957531,-,4266
195,BUMA.1121.00048,2,1579260,1583577,+,4317
195,BUMA.1121.00106,2,966675,970884,-,4209
195,BUMA.1121.00017,2,1160034,1164311,-,4277
195,BUMA.1121.00082,2,856777,861022,+,4245
194,BUMA.1121.00049,2,2634716,2662756,+,28040
194,BUMA.1121.00055,2,1824061,1852396,-,28335
194,BUMA.1121.00011,2,2700162,2728301,+,28139
194,BUMA.1121.00110,2,1597077,1625345,-,28268
194,BUMA.1121.00109,2,562268,590586,-,28318
194,BUMA.1121.00077,2,2890950,2919218,-,28268
194,BUMA.1121.00027,2,1880441,1908486,+,28045
194,BUMA.1121.00021,2,1282763,1310886,+,28123
194,BUMA.1121.00023,2,859604,887670,+,28066
194,BUMA.1121.00025,2,212431,240583,-,28152
194,BUMA.1121.00031,2,3221804,3249897,+,28093
194,BUMA.1121.00007,2,863134,891329,+,28195
194,BUMA.1121.00097,2,616866,645074,+,28208
194,BUMA.1121.00059,2,2809954,2838221,-,28267
194,BUMA.1121.00005,2,2206736,2234711,+,27975
194,BUMA.1121.00111,2,40924,68995,+,28071
194,BUMA.1121.00009,2,2720287,2748706,+,28419
194,BUMA.1121.00094,2,865024,893164,+,28140
194,BUMA.1121.00101,2,2559259,2587501,-,28242
194,BUMA.1121.00066,2,805874,834048,+,28174
194,BUMA.1121.00095,2,486845,514795,-,27950
194,BUMA.1121.00112,2,319649,347873,-,28224
194,BUMA.1121.00090,2,1754523,1782548,+,28025
194,BUMA.1121.00089,2,809790,837930,+,28140
194,BUMA.1121.00051,2,821446,849585,+,28139
194,BUMA.1121.00001,2,1416106,1444130,-,28024
194,BUMA.1121.00045,2,658235,686344,+,28109
194,BUMA.1121.00043,2,1576250,1604422,-,28172
194,BUMA.1121.00063,2,799459,827485,+,28026
194,BUMA.1121.00079,2,821867,850012,+,28145
194,BUMA.1121.00071,2,799635,827816,+,28181
194,BUMA.1121.00093,2,2082051,2109996,-,27945
194,BUMA.1121.00091,2,2833327,2861312,-,27985
194,BUMA.1121.00107,2,3052176,3080337,-,28161
194,BUMA.1121.00088,2,765363,793395,+,28032
194,BUMA.1121.00047,2,1751974,1780114,+,28140
194,BUMA.1121.00039,2,3116284,3144330,-,28046
194,BUMA.1121.00016,2,2987221,3015287,-,28066
194,BUMA.1121.00092,2,834877,863020,+,28143
194,BUMA.1121.00003,2,3053439,3081770,-,28331
194,BUMA.1121.00105,2,1672993,1701059,-,28066
194,BUMA.1121.00053,2,1054304,1082314,+,28010
194,BUMA.1121.00057,2,1239723,1267964,-,28241
194,BUMA.1121.00108,2,1049564,1077805,+,28241
194,BUMA.1121.00104,2,915930,943996,+,28066
194,BUMA.1121.00014,2,889270,917338,+,28068
194,BUMA.1121.00098,2,1021994,1050264,+,28270
194,BUMA.1121.00078,2,2376110,2404112,-,28002
194,BUMA.1121.00029,2,531468,559491,-,28023
194,BUMA.1121.00099,2,1026132,1054146,+,28014
194,BUMA.1121.00103,2,2679839,2707977,+,28138
194,BUMA.1121.00102,2,815859,843927,+,28068
194,BUMA.1121.00075,2,1113364,1141536,+,28172
194,BUMA.1121.00076,2,1707445,1735622,+,28177
194,BUMA.1121.00074,2,150580,178859,-,28279
194,BUMA.1121.00073,2,800218,828403,+,28185
194,BUMA.1121.00083,2,2625506,2653694,+,28188
194,BUMA.1121.00035,2,578632,606656,-,28024
194,BUMA.1121.00072,2,796520,824695,+,28175
194,BUMA.1121.00056,2,53931,82071,-,28140
194,BUMA.1121.00033,2,1501897,1529924,+,28027
194,BUMA.1121.00061,2,790228,818409,+,28181
194,BUMA.1121.00062,2,932266,960182,-,27916
194,BUMA.1121.00064,2,735965,763863,+,27898
194,BUMA.1121.00060,2,1407508,1435617,-,28109
194,BUMA.1121.00069,2,798113,826291,+,28178
194,BUMA.1121.00070,2,800293,828474,+,28181
194,BUMA.1121.00068,2,2528482,2556582,+,28100
194,BUMA.1121.00067,2,3127953,3156183,-,28230
194,BUMA.1121.00037,2,1127066,1155241,+,28175
194,BUMA.1121.00065,2,813587,841704,+,28117
194,BUMA.1121.00058,2,1372179,1400317,+,28138
194,BUMA.1121.00041,2,1709141,1737163,+,28022
194,BUMA.1121.00084,2,2648511,2676524,+,28013
194,BUMA.1121.00096,2,982766,1010916,+,28150
194,BUMA.1121.00080,2,822652,850783,+,28131
194,BUMA.1121.00100,2,1928528,1956624,+,28096
194,BUMA.1121.00012,2,915276,943603,-,28327
194,BUMA.1121.00018,2,2957571,2985723,-,28152
194,BUMA.1121.00106,2,970924,998964,-,28040
194,BUMA.1121.00082,2,828549,856737,+,28188
193,BUMA.1121.00049,2,2627907,2634145,+,6238
193,BUMA.1121.00055,2,1852967,1859205,-,6238
193,BUMA.1121.00011,2,2693287,2699591,+,6304
193,BUMA.1121.00110,2,1625916,1632187,-,6271
193,BUMA.1121.00109,2,591157,597302,-,6145
193,BUMA.1121.00077,2,2919789,2926060,-,6271
193,BUMA.1121.00027,2,1873615,1879870,+,6255
193,BUMA.1121.00021,2,1275875,1282192,+,6317
193,BUMA.1121.00023,2,852732,859033,+,6301
193,BUMA.1121.00025,2,241154,247386,-,6232
193,BUMA.1121.00031,2,3214915,3221233,+,6318
193,BUMA.1121.00007,2,856251,862563,+,6312
193,BUMA.1121.00097,2,609970,616295,+,6325
193,BUMA.1121.00059,2,2838792,2844961,-,6169
193,BUMA.1121.00005,2,2199873,2206165,+,6292
193,BUMA.1121.00111,2,34052,40353,+,6301
193,BUMA.1121.00009,2,2713412,2719716,+,6304
193,BUMA.1121.00094,2,858195,864453,+,6258
193,BUMA.1121.00101,2,2588072,2594328,-,6256
193,BUMA.1121.00066,2,799045,805303,+,6258
193,BUMA.1121.00095,2,515366,521590,-,6224
193,BUMA.1121.00112,2,348444,354683,-,6239
193,BUMA.1121.00090,2,1747659,1753952,+,6293
193,BUMA.1121.00089,2,802961,809219,+,6258
193,BUMA.1121.00051,2,814602,820875,+,6273
193,BUMA.1121.00001,2,1444701,1450926,-,6225
193,BUMA.1121.00045,2,651326,657664,+,6338
193,BUMA.1121.00043,2,1604992,1611234,-,6242
193,BUMA.1121.00063,2,792667,798888,+,6221
193,BUMA.1121.00079,2,815038,821296,+,6258
193,BUMA.1121.00071,2,792803,799064,+,6261
193,BUMA.1121.00093,2,2110567,2116786,-,6219
193,BUMA.1121.00091,2,2861883,2868081,-,6198
193,BUMA.1121.00107,2,3080908,3087200,-,6292
193,BUMA.1121.00088,2,758552,764792,+,6240
193,BUMA.1121.00047,2,1745153,1751403,+,6250
193,BUMA.1121.00039,2,611,6843,-,6232
193,BUMA.1121.00016,2,3015858,3022079,-,6221
193,BUMA.1121.00092,2,828010,834306,+,6296
193,BUMA.1121.00003,2,3082341,3088545,-,6204
193,BUMA.1121.00105,2,1701630,1707804,-,6174
193,BUMA.1121.00053,2,1047486,1053733,+,6247
193,BUMA.1121.00057,2,1268541,1274715,-,6174
193,BUMA.1121.00108,2,1042685,1048993,+,6308
193,BUMA.1121.00104,2,909058,915359,+,6301
193,BUMA.1121.00014,2,882389,888699,+,6310
193,BUMA.1121.00098,2,1015114,1021423,+,6309
193,BUMA.1121.00078,2,2404683,2410891,-,6208
193,BUMA.1121.00029,2,560062,566295,-,6233
193,BUMA.1121.00099,2,1019235,1025555,+,6320
193,BUMA.1121.00103,2,2673040,2679268,+,6228
193,BUMA.1121.00102,2,808949,815288,+,6339
193,BUMA.1121.00075,2,1106492,1112793,+,6301
193,BUMA.1121.00076,2,1700573,1706874,+,6301
193,BUMA.1121.00074,2,179430,185666,-,6236
193,BUMA.1121.00073,2,793384,799647,+,6263
193,BUMA.1121.00083,2,2618672,2624935,+,6263
193,BUMA.1121.00035,2,607227,613476,-,6249
193,BUMA.1121.00072,2,789743,795949,+,6206
193,BUMA.1121.00056,2,82642,88823,-,6181
193,BUMA.1121.00033,2,1494995,1501326,+,6331
193,BUMA.1121.00061,2,783401,789657,+,6256
193,BUMA.1121.00062,2,960753,966967,-,6214
193,BUMA.1121.00064,2,729148,735394,+,6246
193,BUMA.1121.00060,2,1436188,1442449,-,6261
193,BUMA.1121.00069,2,791321,797542,+,6221
193,BUMA.1121.00070,2,793459,799722,+,6263
193,BUMA.1121.00068,2,2521619,2527911,+,6292
193,BUMA.1121.00067,2,109,6321,-,6212
193,BUMA.1121.00037,2,1120162,1126495,+,6333
193,BUMA.1121.00065,2,806715,813016,+,6301
193,BUMA.1121.00058,2,1365284,1371608,+,6324
193,BUMA.1121.00041,2,1702285,1708570,+,6285
193,BUMA.1121.00084,2,2641705,2647940,+,6235
193,BUMA.1121.00096,2,975917,982195,+,6278
193,BUMA.1121.00080,2,815823,822081,+,6258
193,BUMA.1121.00100,2,1921598,1927957,+,6359
193,BUMA.1121.00012,2,944174,950390,-,6216
193,BUMA.1121.00018,2,2986294,2992526,-,6232
193,BUMA.1121.00106,2,999535,1005696,-,6161
193,BUMA.1121.00082,2,821715,827978,+,6263
192,BUMA.1121.00049,2,2611383,2626217,+,14834
192,BUMA.1121.00055,2,1860924,1875792,-,14868
192,BUMA.1121.00011,2,2676739,2691685,+,14946
192,BUMA.1121.00110,2,1633247,1648081,-,14834
192,BUMA.1121.00109,2,599107,613925,-,14818
192,BUMA.1121.00077,2,2927120,2941951,-,14831
192,BUMA.1121.00027,2,1857097,1871974,+,14877
192,BUMA.1121.00021,2,1259303,1274172,+,14869
192,BUMA.1121.00023,2,836152,851034,+,14882
192,BUMA.1121.00025,2,249212,264054,-,14842
192,BUMA.1121.00031,2,3198323,3213188,+,14865
192,BUMA.1121.00007,2,840010,855200,+,15190
192,BUMA.1121.00097,2,593976,608923,+,14947
192,BUMA.1121.00059,2,2846086,2860962,-,14876
192,BUMA.1121.00005,2,2183247,2198179,+,14932
192,BUMA.1121.00111,2,17566,32423,+,14857
192,BUMA.1121.00009,2,2697713,2712353,+,14640
192,BUMA.1121.00094,2,841754,856608,+,14854
192,BUMA.1121.00101,2,2596042,2611017,-,14975
192,BUMA.1121.00066,2,782564,797411,+,14847
192,BUMA.1121.00095,2,522717,537379,-,14662
192,BUMA.1121.00112,2,356383,371366,-,14983
192,BUMA.1121.00090,2,1731049,1745896,+,14847
192,BUMA.1121.00089,2,786520,801374,+,14854
192,BUMA.1121.00051,2,798130,813015,+,14885
192,BUMA.1121.00001,2,1452689,1467554,-,14865
192,BUMA.1121.00045,2,635389,650276,+,14887
192,BUMA.1121.00043,2,1613059,1627913,-,14854
192,BUMA.1121.00063,2,776159,791033,+,14874
192,BUMA.1121.00079,2,798603,813451,+,14848
192,BUMA.1121.00071,2,776297,791160,+,14863
192,BUMA.1121.00093,2,2119755,2134566,-,14811
192,BUMA.1121.00091,2,2869754,2884744,-,14990
192,BUMA.1121.00107,2,3088871,3103815,-,14944
192,BUMA.1121.00088,2,742024,756914,+,14890
192,BUMA.1121.00047,2,1728674,1743566,+,14892
192,BUMA.1121.00039,2,9308,24151,-,14843
192,BUMA.1121.00016,2,3023863,3038755,-,14892
192,BUMA.1121.00092,2,810306,825118,+,14812
192,BUMA.1121.00003,2,3090347,3105506,-,15159
192,BUMA.1121.00105,2,1708929,1723869,-,14940
192,BUMA.1121.00053,2,1030934,1045851,+,14917
192,BUMA.1121.00057,2,1276440,1291314,-,14874
192,BUMA.1121.00108,2,1026746,1041638,+,14892
192,BUMA.1121.00104,2,892376,907378,+,15002
192,BUMA.1121.00014,2,865826,880697,+,14871
192,BUMA.1121.00098,2,999160,1014058,+,14898
192,BUMA.1121.00078,2,2412646,2427306,-,14660
192,BUMA.1121.00029,2,568065,582932,-,14867
192,BUMA.1121.00099,2,1002495,1017633,+,15138
192,BUMA.1121.00103,2,2657054,2671990,+,14936
192,BUMA.1121.00102,2,792359,807237,+,14878
192,BUMA.1121.00075,2,1090667,1105445,+,14778
192,BUMA.1121.00076,2,1684747,1699526,+,14779
192,BUMA.1121.00074,2,187395,202286,-,14891
192,BUMA.1121.00073,2,776904,791750,+,14846
192,BUMA.1121.00083,2,2602164,2617038,+,14874
192,BUMA.1121.00035,2,615253,630158,-,14905
192,BUMA.1121.00072,2,773323,788100,+,14777
192,BUMA.1121.00056,2,90487,105341,-,14854
192,BUMA.1121.00033,2,1478415,1493288,+,14873
192,BUMA.1121.00061,2,766896,781758,+,14862
192,BUMA.1121.00062,2,968699,983612,-,14913
192,BUMA.1121.00064,2,712622,727451,+,14829
192,BUMA.1121.00060,2,1443576,1458463,-,14887
192,BUMA.1121.00069,2,774814,789678,+,14864
192,BUMA.1121.00070,2,776978,791825,+,14847
192,BUMA.1121.00068,2,2504864,2519896,+,15032
192,BUMA.1121.00067,2,8057,22955,-,14898
192,BUMA.1121.00037,2,1102820,1117760,+,14940
192,BUMA.1121.00065,2,790022,805024,+,15002
192,BUMA.1121.00058,2,1348732,1363608,+,14876
192,BUMA.1121.00041,2,1685617,1700632,+,15015
192,BUMA.1121.00084,2,2625177,2640059,+,14882
192,BUMA.1121.00096,2,959606,974249,+,14643
192,BUMA.1121.00080,2,799330,814236,+,14906
192,BUMA.1121.00100,2,1905405,1920547,+,15142
192,BUMA.1121.00012,2,952202,967052,-,14850
192,BUMA.1121.00018,2,2994352,3009194,-,14842
192,BUMA.1121.00106,2,1007428,1022316,-,14888
192,BUMA.1121.00082,2,805207,820081,+,14874
191,BUMA.1121.00049,2,2594074,2610128,+,16054
191,BUMA.1121.00055,2,1877074,1893308,-,16234
191,BUMA.1121.00011,2,2659153,2675313,+,16160
191,BUMA.1121.00110,2,1649345,1665579,-,16234
191,BUMA.1121.00109,2,615153,631288,-,16135
191,BUMA.1121.00077,2,2943215,2959449,-,16234
191,BUMA.1121.00027,2,1839556,1855689,+,16133
191,BUMA.1121.00021,2,1241997,1258066,+,16069
191,BUMA.1121.00023,2,818876,834906,+,16030
191,BUMA.1121.00025,2,265273,281391,-,16118
191,BUMA.1121.00031,2,3181024,3197051,+,16027
191,BUMA.1121.00007,2,822457,838557,+,16100
191,BUMA.1121.00097,2,576612,592685,+,16073
191,BUMA.1121.00059,2,2862226,2878354,-,16128
191,BUMA.1121.00005,2,2165917,2181965,+,16048
191,BUMA.1121.00111,2,281,16302,+,16021
191,BUMA.1121.00009,2,2680346,2696404,+,16058
191,BUMA.1121.00094,2,824235,840265,+,16030
191,BUMA.1121.00101,2,2612281,2628358,-,16077
191,BUMA.1121.00066,2,764989,781129,+,16140
191,BUMA.1121.00095,2,538625,554834,-,16209
191,BUMA.1121.00112,2,372612,388869,-,16257
191,BUMA.1121.00090,2,1713698,1729740,+,16042
191,BUMA.1121.00089,2,768953,785031,+,16078
191,BUMA.1121.00051,2,780578,796650,+,16072
191,BUMA.1121.00001,2,1468800,1484901,-,16101
191,BUMA.1121.00045,2,617777,633891,+,16114
191,BUMA.1121.00043,2,1629132,1645230,-,16098
191,BUMA.1121.00063,2,758583,774724,+,16141
191,BUMA.1121.00079,2,781015,797096,+,16081
191,BUMA.1121.00071,2,758721,774862,+,16141
191,BUMA.1121.00093,2,2135992,2152271,-,16279
191,BUMA.1121.00091,2,2885999,2902212,-,16213
191,BUMA.1121.00107,2,3105178,3121268,-,16090
191,BUMA.1121.00088,2,724367,740499,+,16132
191,BUMA.1121.00047,2,1711100,1727176,+,16076
191,BUMA.1121.00039,2,25370,41435,-,16065
191,BUMA.1121.00016,2,3039974,3056015,-,16041
191,BUMA.1121.00092,2,792627,808772,+,16145
191,BUMA.1121.00003,2,3106950,3123222,-,16272
191,BUMA.1121.00105,2,1725133,1741291,-,16158
191,BUMA.1121.00053,2,1012160,1028238,+,16078
191,BUMA.1121.00057,2,1292668,1308830,-,16162
191,BUMA.1121.00108,2,1009389,1025464,+,16075
191,BUMA.1121.00104,2,874823,890851,+,16028
191,BUMA.1121.00014,2,848571,864598,+,16027
191,BUMA.1121.00098,2,981578,997716,+,16138
191,BUMA.1121.00078,2,2428534,2444726,-,16192
191,BUMA.1121.00029,2,584160,600261,-,16101
191,BUMA.1121.00099,2,984982,1001033,+,16051
191,BUMA.1121.00103,2,2639508,2655637,+,16129
191,BUMA.1121.00102,2,774705,790825,+,16120
191,BUMA.1121.00075,2,1071563,1087693,+,16130
191,BUMA.1121.00076,2,1665631,1681763,+,16132
191,BUMA.1121.00074,2,203559,219759,-,16200
191,BUMA.1121.00073,2,759347,775478,+,16131
191,BUMA.1121.00083,2,2584572,2600666,+,16094
191,BUMA.1121.00035,2,631386,647481,-,16095
191,BUMA.1121.00072,2,755735,771888,+,16153
191,BUMA.1121.00056,2,106722,122898,-,16176
191,BUMA.1121.00033,2,1461054,1477106,+,16052
191,BUMA.1121.00061,2,749333,765461,+,16128
191,BUMA.1121.00062,2,984894,1001149,-,16255
191,BUMA.1121.00064,2,695333,711385,+,16052
191,BUMA.1121.00060,2,1459790,1476047,-,16257
191,BUMA.1121.00069,2,757251,773379,+,16128
191,BUMA.1121.00070,2,759434,775552,+,16118
191,BUMA.1121.00068,2,2487540,2503600,+,16060
191,BUMA.1121.00067,2,24219,40407,-,16188
191,BUMA.1121.00037,2,1085541,1101592,+,16051
191,BUMA.1121.00065,2,772527,788569,+,16042
191,BUMA.1121.00058,2,1331307,1347351,+,16044
191,BUMA.1121.00041,2,1668149,1684245,+,16096
191,BUMA.1121.00084,2,2607580,2623706,+,16126
191,BUMA.1121.00096,2,942193,958313,+,16120
191,BUMA.1121.00080,2,781773,797839,+,16066
191,BUMA.1121.00100,2,1886647,1904139,+,17492
191,BUMA.1121.00012,2,968289,984324,-,16035
191,BUMA.1121.00018,2,3010413,3026530,-,16117
191,BUMA.1121.00106,2,1023553,1039648,-,16095
191,BUMA.1121.00082,2,787615,803709,+,16094
190,BUMA.1121.00049,2,2590730,2593833,+,3103
190,BUMA.1121.00055,2,1893550,1896653,-,3103
190,BUMA.1121.00011,2,2655809,2658912,+,3103
190,BUMA.1121.00110,2,1665821,1668924,-,3103
190,BUMA.1121.00109,2,631530,634633,-,3103
190,BUMA.1121.00077,2,2959691,2962794,-,3103
190,BUMA.1121.00027,2,1836212,1839315,+,3103
190,BUMA.1121.00021,2,1238653,1241756,+,3103
190,BUMA.1121.00023,2,815532,818635,+,3103
190,BUMA.1121.00025,2,281633,284736,-,3103
190,BUMA.1121.00031,2,3177680,3180783,+,3103
190,BUMA.1121.00007,2,819113,822216,+,3103
190,BUMA.1121.00097,2,573268,576371,+,3103
190,BUMA.1121.00059,2,2878596,2881699,-,3103
190,BUMA.1121.00005,2,2162573,2165676,+,3103
190,BUMA.1121.00111,2,3209120,3212183,+,3063
190,BUMA.1121.00009,2,2677002,2680105,+,3103
190,BUMA.1121.00094,2,820891,823994,+,3103
190,BUMA.1121.00101,2,2628600,2631703,-,3103
190,BUMA.1121.00066,2,761645,764748,+,3103
190,BUMA.1121.00095,2,555076,558179,-,3103
190,BUMA.1121.00112,2,389111,392214,-,3103
190,BUMA.1121.00090,2,1710354,1713457,+,3103
190,BUMA.1121.00089,2,765609,768712,+,3103
190,BUMA.1121.00051,2,777234,780337,+,3103
190,BUMA.1121.00001,2,1485143,1488246,-,3103
190,BUMA.1121.00045,2,614433,617536,+,3103
190,BUMA.1121.00043,2,1645472,1648575,-,3103
190,BUMA.1121.00063,2,755239,758342,+,3103
190,BUMA.1121.00079,2,777671,780774,+,3103
190,BUMA.1121.00071,2,755377,758480,+,3103
190,BUMA.1121.00093,2,2152513,2155616,-,3103
190,BUMA.1121.00091,2,2902454,2905557,-,3103
190,BUMA.1121.00107,2,3121510,3124613,-,3103
190,BUMA.1121.00088,2,721023,724126,+,3103
190,BUMA.1121.00047,2,1707756,1710859,+,3103
190,BUMA.1121.00039,2,41677,44780,-,3103
190,BUMA.1121.00016,2,3056257,3059359,-,3102
190,BUMA.1121.00092,2,789283,792386,+,3103
190,BUMA.1121.00003,2,3123464,3126567,-,3103
190,BUMA.1121.00105,2,1741533,1744636,-,3103
190,BUMA.1121.00053,2,1008816,1011919,+,3103
190,BUMA.1121.00057,2,1309072,1312175,-,3103
190,BUMA.1121.00108,2,1006045,1009148,+,3103
190,BUMA.1121.00104,2,871479,874582,+,3103
190,BUMA.1121.00014,2,845227,848330,+,3103
190,BUMA.1121.00098,2,978234,981337,+,3103
190,BUMA.1121.00078,2,2444968,2448071,-,3103
190,BUMA.1121.00029,2,600503,603606,-,3103
190,BUMA.1121.00099,2,981638,984741,+,3103
190,BUMA.1121.00103,2,2636164,2639267,+,3103
190,BUMA.1121.00102,2,771361,774464,+,3103
190,BUMA.1121.00075,2,1068219,1071322,+,3103
190,BUMA.1121.00076,2,1662287,1665390,+,3103
190,BUMA.1121.00074,2,220001,223104,-,3103
190,BUMA.1121.00073,2,756003,759106,+,3103
190,BUMA.1121.00083,2,2581228,2584331,+,3103
190,BUMA.1121.00035,2,647723,650826,-,3103
190,BUMA.1121.00072,2,752391,755494,+,3103
190,BUMA.1121.00056,2,123140,126243,-,3103
190,BUMA.1121.00033,2,1457711,1460813,+,3102
190,BUMA.1121.00061,2,745989,749092,+,3103
190,BUMA.1121.00062,2,1001391,1004494,-,3103
190,BUMA.1121.00064,2,691989,695092,+,3103
190,BUMA.1121.00060,2,1476289,1479392,-,3103
190,BUMA.1121.00069,2,753907,757010,+,3103
190,BUMA.1121.00070,2,756090,759193,+,3103
190,BUMA.1121.00068,2,2484196,2487299,+,3103
190,BUMA.1121.00067,2,40649,43752,-,3103
190,BUMA.1121.00037,2,1082197,1085300,+,3103
190,BUMA.1121.00065,2,769183,772286,+,3103
190,BUMA.1121.00058,2,1327963,1331066,+,3103
190,BUMA.1121.00041,2,1664805,1667908,+,3103
190,BUMA.1121.00084,2,2604236,2607339,+,3103
190,BUMA.1121.00096,2,938849,941952,+,3103
190,BUMA.1121.00080,2,778429,781532,+,3103
190,BUMA.1121.00100,2,1883303,1886406,+,3103
190,BUMA.1121.00012,2,984566,987669,-,3103
190,BUMA.1121.00018,2,3026772,3029875,-,3103
190,BUMA.1121.00106,2,1039890,1042993,-,3103
190,BUMA.1121.00082,2,784271,787374,+,3103
189,BUMA.1121.00049,2,2585090,2589864,+,4774
189,BUMA.1121.00055,2,1897519,1902292,-,4773
189,BUMA.1121.00011,2,2650123,2654943,+,4820
189,BUMA.1121.00110,2,1669790,1674570,-,4780
189,BUMA.1121.00109,2,635499,640279,-,4780
189,BUMA.1121.00077,2,2963660,2968439,-,4779
189,BUMA.1121.00027,2,1830573,1835346,+,4773
189,BUMA.1121.00021,2,1233006,1237787,+,4781
189,BUMA.1121.00023,2,809885,814666,+,4781
189,BUMA.1121.00025,2,285602,290382,-,4780
189,BUMA.1121.00031,2,3172033,3176814,+,4781
189,BUMA.1121.00007,2,813458,818247,+,4789
189,BUMA.1121.00097,2,567621,572402,+,4781
189,BUMA.1121.00059,2,2882565,2887361,-,4796
189,BUMA.1121.00005,2,2156944,2161707,+,4763
189,BUMA.1121.00111,2,3203473,3208254,+,4781
189,BUMA.1121.00009,2,2671322,2676136,+,4814
189,BUMA.1121.00094,2,815185,820025,+,4840
189,BUMA.1121.00101,2,2632569,2637348,-,4779
189,BUMA.1121.00066,2,756005,760779,+,4774
189,BUMA.1121.00095,2,559045,563809,-,4764
189,BUMA.1121.00112,2,393080,397901,-,4821
189,BUMA.1121.00090,2,1704707,1709488,+,4781
189,BUMA.1121.00089,2,759890,764743,+,4853
189,BUMA.1121.00051,2,771539,776368,+,4829
189,BUMA.1121.00001,2,1489112,1493892,-,4780
189,BUMA.1121.00045,2,608778,613567,+,4789
189,BUMA.1121.00043,2,1649441,1654221,-,4780
189,BUMA.1121.00063,2,749599,754373,+,4774
189,BUMA.1121.00079,2,771976,776805,+,4829
189,BUMA.1121.00071,2,749737,754511,+,4774
189,BUMA.1121.00093,2,2156482,2161239,-,4757
189,BUMA.1121.00091,2,2906423,2911195,-,4772
189,BUMA.1121.00107,2,3125479,3130259,-,4780
189,BUMA.1121.00088,2,715376,720157,+,4781
189,BUMA.1121.00047,2,1702061,1706890,+,4829
189,BUMA.1121.00039,2,45646,50426,-,4780
189,BUMA.1121.00016,2,3060225,3065006,-,4781
189,BUMA.1121.00092,2,783659,788417,+,4758
189,BUMA.1121.00003,2,1,4771,-,4770
189,BUMA.1121.00105,2,1745502,1750281,-,4779
189,BUMA.1121.00053,2,1003152,1007950,+,4798
189,BUMA.1121.00057,2,1313041,1317814,-,4773
189,BUMA.1121.00108,2,1000367,1005179,+,4812
189,BUMA.1121.00104,2,865840,870613,+,4773
189,BUMA.1121.00014,2,839580,844361,+,4781
189,BUMA.1121.00098,2,972539,977368,+,4829
189,BUMA.1121.00078,2,2448937,2453717,-,4780
189,BUMA.1121.00029,2,604472,609252,-,4780
189,BUMA.1121.00099,2,975974,980772,+,4798
189,BUMA.1121.00103,2,2630541,2635298,+,4757
189,BUMA.1121.00102,2,765633,770495,+,4862
189,BUMA.1121.00075,2,1062579,1067353,+,4774
189,BUMA.1121.00076,2,1656647,1661421,+,4774
189,BUMA.1121.00074,2,223970,228766,-,4796
189,BUMA.1121.00073,2,750363,755137,+,4774
189,BUMA.1121.00083,2,2575588,2580362,+,4774
189,BUMA.1121.00035,2,651692,656472,-,4780
189,BUMA.1121.00072,2,746751,751525,+,4774
189,BUMA.1121.00056,2,127109,131953,-,4844
189,BUMA.1121.00033,2,1452064,1456845,+,4781
189,BUMA.1121.00061,2,740349,745123,+,4774
189,BUMA.1121.00062,2,1005360,1010133,-,4773
189,BUMA.1121.00064,2,686358,691123,+,4765
189,BUMA.1121.00060,2,1480258,1485046,-,4788
189,BUMA.1121.00069,2,748267,753041,+,4774
189,BUMA.1121.00070,2,750450,755224,+,4774
189,BUMA.1121.00068,2,2478556,2483330,+,4774
189,BUMA.1121.00067,2,44618,49414,-,4796
189,BUMA.1121.00037,2,1076860,1081331,+,4471
189,BUMA.1121.00065,2,763536,768317,+,4781
189,BUMA.1121.00058,2,1322316,1327097,+,4781
189,BUMA.1121.00041,2,1659174,1663939,+,4765
189,BUMA.1121.00084,2,2598589,2603370,+,4781
189,BUMA.1121.00096,2,933195,937984,+,4789
189,BUMA.1121.00080,2,772734,777563,+,4829
189,BUMA.1121.00100,2,1877707,1882437,+,4730
189,BUMA.1121.00012,2,988535,993315,-,4780
189,BUMA.1121.00018,2,3030741,3035521,-,4780
189,BUMA.1121.00106,2,1043859,1048632,-,4773
189,BUMA.1121.00082,2,778631,783405,+,4774
188,BUMA.1121.00049,2,2555045,2585089,+,30044
188,BUMA.1121.00055,2,1902294,1932342,-,30048
188,BUMA.1121.00011,2,2620078,2650122,+,30044
188,BUMA.1121.00110,2,1674572,1704588,-,30016
188,BUMA.1121.00109,2,640281,670324,-,30043
188,BUMA.1121.00077,2,2968441,2998458,-,30017
188,BUMA.1121.00027,2,1800528,1830572,+,30044
188,BUMA.1121.00021,2,1202961,1233005,+,30044
188,BUMA.1121.00023,2,779856,809884,+,30028
188,BUMA.1121.00022,2,1068510,1098405,-,29895
188,BUMA.1121.00025,2,290384,320427,-,30043
188,BUMA.1121.00031,2,3141995,3172032,+,30037
188,BUMA.1121.00007,2,783413,813457,+,30044
188,BUMA.1121.00097,2,537576,567620,+,30044
188,BUMA.1121.00059,2,2887363,2917405,-,30042
188,BUMA.1121.00002,2,1019242,1049141,+,29899
188,BUMA.1121.00005,2,2126902,2156943,+,30041
188,BUMA.1121.00111,2,3173428,3203472,+,30044
188,BUMA.1121.00006,2,1814098,1843996,-,29898
188,BUMA.1121.00009,2,2641276,2671321,+,30045
188,BUMA.1121.00094,2,785141,815184,+,30043
188,BUMA.1121.00101,2,2637350,2667390,-,30040
188,BUMA.1121.00066,2,725961,756004,+,30043
188,BUMA.1121.00095,2,563811,593854,-,30043
188,BUMA.1121.00112,2,397903,427946,-,30043
188,BUMA.1121.00042,2,429859,459902,+,30043
188,BUMA.1121.00090,2,1674669,1704706,+,30037
188,BUMA.1121.00089,2,729840,759889,+,30049
188,BUMA.1121.00051,2,741489,771538,+,30049
188,BUMA.1121.00001,2,1493894,1523937,-,30043
188,BUMA.1121.00045,2,578733,608777,+,30044
188,BUMA.1121.00043,2,1654223,1684266,-,30043
188,BUMA.1121.00063,2,719555,749598,+,30043
188,BUMA.1121.00079,2,741926,771975,+,30049
188,BUMA.1121.00071,2,719693,749736,+,30043
188,BUMA.1121.00086,2,1876430,1906325,-,29895
188,BUMA.1121.00010,2,1875138,1905033,+,29895
188,BUMA.1121.00040,2,1712899,1742795,-,29896
188,BUMA.1121.00093,2,2161241,2191284,-,30043
188,BUMA.1121.00091,2,2911197,2941240,-,30043
188,BUMA.1121.00107,2,3130261,3160303,-,30042
188,BUMA.1121.00088,2,685331,715375,+,30044
188,BUMA.1121.00047,2,1672010,1702060,+,30050
188,BUMA.1121.00087,2,1048878,1078773,+,29895
188,BUMA.1121.00039,2,50428,80464,-,30036
188,BUMA.1121.00016,2,3065008,3095044,-,30036
188,BUMA.1121.00092,2,753614,783658,+,30044
188,BUMA.1121.00085,2,688188,718086,-,29898
188,BUMA.1121.00046,2,148265,178163,-,29898
188,BUMA.1121.00003,2,4773,34813,-,30040
188,BUMA.1121.00054,2,1614219,1644117,-,29898
188,BUMA.1121.00015,2,707442,737341,+,29899
188,BUMA.1121.00105,2,1750283,1780325,-,30042
188,BUMA.1121.00052,2,1376735,1406633,-,29898
188,BUMA.1121.00053,2,973108,1003151,+,30043
188,BUMA.1121.00057,2,1317816,1347859,-,30043
188,BUMA.1121.00108,2,970322,1000366,+,30044
188,BUMA.1121.00050,2,1909044,1938942,-,29898
188,BUMA.1121.00104,2,835795,865839,+,30044
188,BUMA.1121.00014,2,809541,839579,+,30038
188,BUMA.1121.00036,2,2042560,2072455,+,29895
188,BUMA.1121.00038,2,1715292,1745190,-,29898
188,BUMA.1121.00098,2,942495,972538,+,30043
188,BUMA.1121.00078,2,2453719,2483759,-,30040
188,BUMA.1121.00029,2,609254,639297,-,30043
188,BUMA.1121.00099,2,945938,975973,+,30035
188,BUMA.1121.00103,2,2600509,2630540,+,30031
188,BUMA.1121.00102,2,735582,765632,+,30050
188,BUMA.1121.00075,2,1032535,1062578,+,30043
188,BUMA.1121.00076,2,1626603,1656646,+,30043
188,BUMA.1121.00074,2,228768,258810,-,30042
188,BUMA.1121.00073,2,720319,750362,+,30043
188,BUMA.1121.00083,2,2545543,2575587,+,30044
188,BUMA.1121.00035,2,656474,686517,-,30043
188,BUMA.1121.00072,2,716706,746750,+,30044
188,BUMA.1121.00056,2,131955,162003,-,30048
188,BUMA.1121.00081,2,479513,509412,+,29899
188,BUMA.1121.00033,2,1422027,1452063,+,30036
188,BUMA.1121.00061,2,710305,740348,+,30043
188,BUMA.1121.00062,2,1010135,1040177,-,30042
188,BUMA.1121.00064,2,656314,686357,+,30043
188,BUMA.1121.00060,2,1485048,1515091,-,30043
188,BUMA.1121.00069,2,718223,748266,+,30043
188,BUMA.1121.00070,2,720405,750449,+,30044
188,BUMA.1121.00068,2,2448512,2478555,+,30043
188,BUMA.1121.00067,2,49416,79458,-,30042
188,BUMA.1121.00037,2,1046822,1076859,+,30037
188,BUMA.1121.00065,2,733491,763535,+,30044
188,BUMA.1121.00058,2,1292266,1322315,+,30049
188,BUMA.1121.00041,2,1629130,1659173,+,30043
188,BUMA.1121.00084,2,2568544,2598588,+,30044
188,BUMA.1121.00096,2,903151,933194,+,30043
188,BUMA.1121.00080,2,742684,772733,+,30049
188,BUMA.1121.00013,2,2080259,2110157,-,29898
188,BUMA.1121.00100,2,1847664,1877706,+,30042
188,BUMA.1121.00012,2,993317,1023360,-,30043
188,BUMA.1121.00018,2,3035523,3065566,-,30043
188,BUMA.1121.00048,2,1218908,1248807,+,29899
188,BUMA.1121.00106,2,1048634,1078677,-,30043
188,BUMA.1121.00082,2,748586,778630,+,30044
187,BUMA.1121.00049,2,2546174,2554332,+,8158
187,BUMA.1121.00055,2,1933055,1941195,-,8140
187,BUMA.1121.00011,2,2611197,2619365,+,8168
187,BUMA.1121.00110,2,1705301,1713510,-,8209
187,BUMA.1121.00109,2,671037,679233,-,8196
187,BUMA.1121.00077,2,2999171,3007380,-,8209
187,BUMA.1121.00027,2,1791665,1799815,+,8150
187,BUMA.1121.00021,2,1194082,1202248,+,8166
187,BUMA.1121.00023,2,770977,779143,+,8166
187,BUMA.1121.00022,2,1099118,1107298,-,8180
187,BUMA.1121.00025,2,321140,329338,-,8198
187,BUMA.1121.00031,2,3133144,3141282,+,8138
187,BUMA.1121.00007,2,774912,782700,+,7788
187,BUMA.1121.00097,2,528691,536863,+,8172
187,BUMA.1121.00059,2,2918118,2926299,-,8181
187,BUMA.1121.00002,2,1010356,1018529,+,8173
187,BUMA.1121.00005,2,2117975,2126189,+,8214
187,BUMA.1121.00111,2,3164549,3172715,+,8166
187,BUMA.1121.00006,2,1844709,1852848,-,8139
187,BUMA.1121.00009,2,2632433,2640563,+,8130
187,BUMA.1121.00094,2,776301,784428,+,8127
187,BUMA.1121.00101,2,2668103,2676255,-,8152
187,BUMA.1121.00066,2,717083,725248,+,8165
187,BUMA.1121.00095,2,594567,602749,-,8182
187,BUMA.1121.00112,2,428659,436890,-,8231
187,BUMA.1121.00090,2,1665797,1673956,+,8159
187,BUMA.1121.00089,2,720990,729127,+,8137
187,BUMA.1121.00051,2,732639,740776,+,8137
187,BUMA.1121.00001,2,1524650,1532788,-,8138
187,BUMA.1121.00045,2,569873,578020,+,8147
187,BUMA.1121.00043,2,1684979,1693188,-,8209
187,BUMA.1121.00063,2,710649,718842,+,8193
187,BUMA.1121.00079,2,733070,741213,+,8143
187,BUMA.1121.00071,2,710815,718980,+,8165
187,BUMA.1121.00086,2,1907038,1915190,-,8152
187,BUMA.1121.00010,2,1866252,1874425,+,8173
187,BUMA.1121.00040,2,1743508,1751674,-,8166
187,BUMA.1121.00093,2,2191997,2200146,-,8149
187,BUMA.1121.00091,2,2941953,2950245,-,8292
187,BUMA.1121.00107,2,3161016,3169178,-,8162
187,BUMA.1121.00088,2,676452,684618,+,8166
187,BUMA.1121.00047,2,1663090,1671297,+,8207
187,BUMA.1121.00087,2,1040014,1048165,+,8151
187,BUMA.1121.00039,2,81177,89428,-,8251
187,BUMA.1121.00016,2,3095757,3103902,-,8145
187,BUMA.1121.00092,2,744753,752901,+,8148
187,BUMA.1121.00085,2,718799,726938,-,8139
187,BUMA.1121.00046,2,178876,187036,-,8160
187,BUMA.1121.00003,2,35526,43714,-,8188
187,BUMA.1121.00054,2,1644830,1652969,-,8139
187,BUMA.1121.00015,2,698591,706729,+,8138
187,BUMA.1121.00105,2,1781038,1789208,-,8170
187,BUMA.1121.00052,2,1407346,1415485,-,8139
187,BUMA.1121.00053,2,964243,972395,+,8152
187,BUMA.1121.00057,2,1348572,1356745,-,8173
187,BUMA.1121.00108,2,961471,969609,+,8138
187,BUMA.1121.00050,2,1939655,1947815,-,8160
187,BUMA.1121.00104,2,826980,835082,+,8102
187,BUMA.1121.00014,2,800683,808828,+,8145
187,BUMA.1121.00036,2,2033710,2041847,+,8137
187,BUMA.1121.00038,2,1745903,1754042,-,8139
187,BUMA.1121.00098,2,933608,941782,+,8174
187,BUMA.1121.00078,2,2484472,2492746,-,8274
187,BUMA.1121.00029,2,640010,648154,-,8144
187,BUMA.1121.00099,2,937043,945225,+,8182
187,BUMA.1121.00103,2,2591657,2599796,+,8139
187,BUMA.1121.00102,2,726710,734869,+,8159
187,BUMA.1121.00075,2,1023573,1031822,+,8249
187,BUMA.1121.00076,2,1617627,1625890,+,8263
187,BUMA.1121.00074,2,259523,267676,-,8153
187,BUMA.1121.00073,2,711441,719606,+,8165
187,BUMA.1121.00083,2,2536636,2544830,+,8194
187,BUMA.1121.00035,2,687230,695396,-,8166
187,BUMA.1121.00072,2,707799,715993,+,8194
187,BUMA.1121.00056,2,162716,170854,-,8138
187,BUMA.1121.00081,2,470662,478800,+,8138
187,BUMA.1121.00033,2,1413151,1421314,+,8163
187,BUMA.1121.00061,2,701398,709592,+,8194
187,BUMA.1121.00062,2,1040890,1049025,-,8135
187,BUMA.1121.00064,2,647470,655601,+,8131
187,BUMA.1121.00060,2,1515804,1523952,-,8148
187,BUMA.1121.00069,2,709316,717510,+,8194
187,BUMA.1121.00070,2,711520,719692,+,8172
187,BUMA.1121.00068,2,2439662,2447799,+,8137
187,BUMA.1121.00067,2,80171,88317,-,8146
187,BUMA.1121.00037,2,1037958,1046109,+,8151
187,BUMA.1121.00065,2,724618,732778,+,8160
187,BUMA.1121.00058,2,1283408,1291553,+,8145
187,BUMA.1121.00041,2,1620249,1628417,+,8168
187,BUMA.1121.00084,2,2559623,2567831,+,8208
187,BUMA.1121.00096,2,894300,902438,+,8138
187,BUMA.1121.00080,2,733848,741971,+,8123
187,BUMA.1121.00013,2,2110870,2119009,-,8139
187,BUMA.1121.00100,2,1838751,1846951,+,8200
187,BUMA.1121.00012,2,1024073,1032198,-,8125
187,BUMA.1121.00018,2,3066279,3074477,-,8198
187,BUMA.1121.00048,2,1210057,1218195,+,8138
187,BUMA.1121.00106,2,1079390,1087535,-,8145
187,BUMA.1121.00082,2,739679,747873,+,8194
186,BUMA.1121.00049,2,2523129,2536332,+,13203
186,BUMA.1121.00055,2,1951042,1964186,-,13144
186,BUMA.1121.00011,2,2587869,2601075,+,13206
186,BUMA.1121.00110,2,585854,599054,+,13200
186,BUMA.1121.00109,2,689392,702536,-,13144
186,BUMA.1121.00077,2,3017542,3030683,-,13141
186,BUMA.1121.00027,2,1768389,1781597,+,13208
186,BUMA.1121.00021,2,1170783,1183983,+,13200
186,BUMA.1121.00023,2,747741,760888,+,13147
186,BUMA.1121.00022,2,1117262,1130430,-,13168
186,BUMA.1121.00025,2,2313922,2327128,+,13206
186,BUMA.1121.00031,2,3109712,3122912,+,13200
186,BUMA.1121.00007,2,751531,764740,+,13209
186,BUMA.1121.00097,2,505597,518800,+,13203
186,BUMA.1121.00059,2,2936140,2949284,-,13144
186,BUMA.1121.00002,2,987204,1000407,+,13203
186,BUMA.1121.00005,2,9143,22293,-,13150
186,BUMA.1121.00111,2,3141352,3154502,+,13150
186,BUMA.1121.00006,2,1862804,1875948,-,13144
186,BUMA.1121.00009,2,2609182,2622391,+,13209
186,BUMA.1121.00094,2,752988,766191,+,13203
186,BUMA.1121.00101,2,2686339,2699489,-,13150
186,BUMA.1121.00066,2,694082,707285,+,13203
186,BUMA.1121.00095,2,2755323,2768522,+,13199
186,BUMA.1121.00112,2,446779,459923,-,13144
186,BUMA.1121.00042,2,538609,551836,+,13227
186,BUMA.1121.00090,2,1642433,1655633,+,13200
186,BUMA.1121.00089,2,697667,710870,+,13203
186,BUMA.1121.00051,2,709322,722525,+,13203
186,BUMA.1121.00001,2,1542761,1555902,-,13141
186,BUMA.1121.00045,2,546519,559722,+,13203
186,BUMA.1121.00043,2,1703279,1716370,-,13091
186,BUMA.1121.00063,2,687766,700969,+,13203
186,BUMA.1121.00079,2,709721,722924,+,13203
186,BUMA.1121.00071,2,687810,701013,+,13203
186,BUMA.1121.00086,2,1925162,1938306,-,13144
186,BUMA.1121.00010,2,1843099,1856302,+,13203
186,BUMA.1121.00040,2,1761634,1774802,-,13168
186,BUMA.1121.00093,2,2210294,2223438,-,13144
186,BUMA.1121.00091,2,2960341,2973491,-,13150
186,BUMA.1121.00107,2,3179048,3192198,-,13150
186,BUMA.1121.00088,2,653421,666621,+,13200
186,BUMA.1121.00047,2,1639774,1652977,+,13203
186,BUMA.1121.00087,2,1016839,1030042,+,13203
186,BUMA.1121.00039,2,99388,112529,-,13141
186,BUMA.1121.00016,2,3114075,3127216,-,13141
186,BUMA.1121.00092,2,721402,734605,+,13203
186,BUMA.1121.00085,2,736862,750002,-,13140
186,BUMA.1121.00046,2,1464163,1477366,+,13203
186,BUMA.1121.00003,2,2084553,2097762,+,13209
186,BUMA.1121.00054,2,1662925,1676069,-,13144
186,BUMA.1121.00015,2,675389,688592,+,13203
186,BUMA.1121.00105,2,1799322,1812466,-,13144
186,BUMA.1121.00052,2,1425409,1438553,-,13144
186,BUMA.1121.00053,2,940858,954058,+,13200
186,BUMA.1121.00057,2,1366816,1379966,-,13150
186,BUMA.1121.00108,2,938161,951364,+,13203
186,BUMA.1121.00050,2,1957789,1970933,-,13144
186,BUMA.1121.00104,2,803883,817092,+,13209
186,BUMA.1121.00014,2,777337,790537,+,13200
186,BUMA.1121.00036,2,2010513,2023740,+,13227
186,BUMA.1121.00038,2,1763998,1777142,-,13144
186,BUMA.1121.00098,2,910250,923453,+,13203
186,BUMA.1121.00078,2,2502982,2516123,-,13141
186,BUMA.1121.00029,2,658101,671242,-,13141
186,BUMA.1121.00099,2,913753,926962,+,13209
186,BUMA.1121.00103,2,2568552,2581755,+,13203
186,BUMA.1121.00102,2,703619,716819,+,13200
186,BUMA.1121.00075,2,2137937,2151081,-,13144
186,BUMA.1121.00076,2,1594568,1607771,+,13203
186,BUMA.1121.00074,2,277506,290650,-,13144
186,BUMA.1121.00073,2,688427,701630,+,13203
186,BUMA.1121.00083,2,2513578,2526781,+,13203
186,BUMA.1121.00035,2,705375,718516,-,13141
186,BUMA.1121.00072,2,684843,698046,+,13203
186,BUMA.1121.00056,2,180974,194118,-,13144
186,BUMA.1121.00081,2,447503,460706,+,13203
186,BUMA.1121.00033,2,1389888,1403044,+,13156
186,BUMA.1121.00061,2,678367,691570,+,13203
186,BUMA.1121.00062,2,1058893,1072037,-,13144
186,BUMA.1121.00064,2,624414,637617,+,13203
186,BUMA.1121.00060,2,1534103,1547247,-,13144
186,BUMA.1121.00069,2,686367,699570,+,13203
186,BUMA.1121.00070,2,688513,701716,+,13203
186,BUMA.1121.00068,2,2416297,2429497,+,13200
186,BUMA.1121.00067,2,98136,111280,-,13144
186,BUMA.1121.00037,2,1014558,1027758,+,13200
186,BUMA.1121.00065,2,701576,714776,+,13200
186,BUMA.1121.00058,2,1260304,1273507,+,13203
186,BUMA.1121.00041,2,1597146,1610355,+,13209
186,BUMA.1121.00084,2,2536576,2549779,+,13203
186,BUMA.1121.00096,2,870999,884208,+,13209
186,BUMA.1121.00080,2,710524,723727,+,13203
186,BUMA.1121.00013,2,2921,16065,-,13144
186,BUMA.1121.00100,2,1815417,1828626,+,13209
186,BUMA.1121.00012,2,1042079,1055226,-,13147
186,BUMA.1121.00018,2,5900,19047,-,13147
186,BUMA.1121.00048,2,1186904,1200107,+,13203
186,BUMA.1121.00106,2,3114351,3127554,+,13203
186,BUMA.1121.00082,2,716621,729824,+,13203
185,BUMA.1121.00049,2,2511646,2518558,+,6912
185,BUMA.1121.00055,2,1968815,1975728,-,6913
185,BUMA.1121.00011,2,2576386,2583298,+,6912
185,BUMA.1121.00110,2,574354,581284,+,6930
185,BUMA.1121.00109,2,707168,714078,-,6910
185,BUMA.1121.00077,2,3035312,3042243,-,6931
185,BUMA.1121.00027,2,1756907,1763819,+,6912
185,BUMA.1121.00021,2,1159300,1166212,+,6912
185,BUMA.1121.00023,2,736258,743170,+,6912
185,BUMA.1121.00022,2,1135014,1141927,-,6913
185,BUMA.1121.00025,2,2302439,2309351,+,6912
185,BUMA.1121.00031,2,3098229,3105141,+,6912
185,BUMA.1121.00007,2,740048,746960,+,6912
185,BUMA.1121.00097,2,494114,501026,+,6912
185,BUMA.1121.00059,2,2953913,2960826,-,6913
185,BUMA.1121.00002,2,975766,982678,+,6912
185,BUMA.1121.00005,2,26922,33835,-,6913
185,BUMA.1121.00111,2,3129869,3136781,+,6912
185,BUMA.1121.00006,2,1880532,1887445,-,6913
185,BUMA.1121.00009,2,2597699,2604611,+,6912
185,BUMA.1121.00094,2,741505,748417,+,6912
185,BUMA.1121.00101,2,2704118,2711022,-,6904
185,BUMA.1121.00066,2,682599,689511,+,6912
185,BUMA.1121.00095,2,2743844,2750752,+,6908
185,BUMA.1121.00112,2,464552,471465,-,6913
185,BUMA.1121.00042,2,527218,534076,+,6858
185,BUMA.1121.00090,2,1630950,1637862,+,6912
185,BUMA.1121.00089,2,686184,693096,+,6912
185,BUMA.1121.00051,2,697839,704751,+,6912
185,BUMA.1121.00001,2,1560531,1567444,-,6913
185,BUMA.1121.00045,2,535036,541948,+,6912
185,BUMA.1121.00043,2,1720999,1727912,-,6913
185,BUMA.1121.00063,2,676283,683195,+,6912
185,BUMA.1121.00079,2,698238,705150,+,6912
185,BUMA.1121.00071,2,676327,683239,+,6912
185,BUMA.1121.00086,2,1942890,1949803,-,6913
185,BUMA.1121.00010,2,1829207,1836119,+,6912
185,BUMA.1121.00040,2,1779386,1786299,-,6913
185,BUMA.1121.00093,2,2228064,2234977,-,6913
185,BUMA.1121.00091,2,2978120,2985024,-,6904
185,BUMA.1121.00107,2,3196827,3203731,-,6904
185,BUMA.1121.00088,2,641938,648850,+,6912
185,BUMA.1121.00047,2,1628291,1635203,+,6912
185,BUMA.1121.00087,2,1005401,1012313,+,6912
185,BUMA.1121.00039,2,117158,124071,-,6913
185,BUMA.1121.00016,2,3131845,3138758,-,6913
185,BUMA.1121.00092,2,709922,716834,+,6912
185,BUMA.1121.00085,2,754586,761499,-,6913
185,BUMA.1121.00046,2,1452767,1459679,+,6912
185,BUMA.1121.00003,2,2073070,2079982,+,6912
185,BUMA.1121.00054,2,1680653,1687566,-,6913
185,BUMA.1121.00015,2,663951,670863,+,6912
185,BUMA.1121.00105,2,1817095,1824008,-,6913
185,BUMA.1121.00052,2,1443137,1450050,-,6913
185,BUMA.1121.00053,2,929375,936287,+,6912
185,BUMA.1121.00057,2,1384595,1391508,-,6913
185,BUMA.1121.00108,2,926679,933591,+,6912
185,BUMA.1121.00050,2,1975475,1982388,-,6913
185,BUMA.1121.00104,2,792400,799312,+,6912
185,BUMA.1121.00014,2,765854,772766,+,6912
185,BUMA.1121.00036,2,1999075,2005987,+,6912
185,BUMA.1121.00038,2,1781726,1788639,-,6913
185,BUMA.1121.00098,2,898767,905679,+,6912
185,BUMA.1121.00078,2,2520752,2527665,-,6913
185,BUMA.1121.00029,2,675871,682784,-,6913
185,BUMA.1121.00099,2,902270,909182,+,6912
185,BUMA.1121.00103,2,2557069,2563981,+,6912
185,BUMA.1121.00102,2,692136,699048,+,6912
185,BUMA.1121.00075,2,2155710,2162623,-,6913
185,BUMA.1121.00076,2,1583085,1589997,+,6912
185,BUMA.1121.00074,2,295279,302192,-,6913
185,BUMA.1121.00073,2,676944,683856,+,6912
185,BUMA.1121.00083,2,2502095,2509007,+,6912
185,BUMA.1121.00035,2,723145,730058,-,6913
185,BUMA.1121.00072,2,673360,680272,+,6912
185,BUMA.1121.00056,2,198747,205660,-,6913
185,BUMA.1121.00081,2,436065,442977,+,6912
185,BUMA.1121.00033,2,1378405,1385317,+,6912
185,BUMA.1121.00061,2,666884,673796,+,6912
185,BUMA.1121.00062,2,1076666,1083579,-,6913
185,BUMA.1121.00064,2,612931,619843,+,6912
185,BUMA.1121.00060,2,1551876,1558789,-,6913
185,BUMA.1121.00069,2,674884,681796,+,6912
185,BUMA.1121.00070,2,677030,683942,+,6912
185,BUMA.1121.00068,2,2404814,2411726,+,6912
185,BUMA.1121.00067,2,115909,122822,-,6913
185,BUMA.1121.00037,2,1003075,1009987,+,6912
185,BUMA.1121.00065,2,690093,697005,+,6912
185,BUMA.1121.00058,2,1248820,1255732,+,6912
185,BUMA.1121.00041,2,1585672,1592575,+,6903
185,BUMA.1121.00084,2,2525093,2532005,+,6912
185,BUMA.1121.00096,2,859525,866428,+,6903
185,BUMA.1121.00080,2,699041,705953,+,6912
185,BUMA.1121.00013,2,20649,27562,-,6913
185,BUMA.1121.00100,2,1803934,1810846,+,6912
185,BUMA.1121.00012,2,1059855,1066768,-,6913
185,BUMA.1121.00018,2,23676,30589,-,6913
185,BUMA.1121.00048,2,1175466,1182378,+,6912
185,BUMA.1121.00106,2,3102868,3109780,+,6912
185,BUMA.1121.00082,2,705138,712050,+,6912
184,BUMA.1121.00049,2,2488214,2508569,+,20355
184,BUMA.1121.00055,2,1978805,1999237,-,20432
184,BUMA.1121.00011,2,2552898,2573309,+,20411
184,BUMA.1121.00110,2,550931,571277,+,20346
184,BUMA.1121.00109,2,717155,737511,-,20356
184,BUMA.1121.00077,2,3045320,3065668,-,20348
184,BUMA.1121.00027,2,1733396,1753830,+,20434
184,BUMA.1121.00021,2,1135873,1156223,+,20350
184,BUMA.1121.00023,2,712814,733181,+,20367
184,BUMA.1121.00022,2,1145004,1165336,-,20332
184,BUMA.1121.00034,2,355906,376238,+,20332
184,BUMA.1121.00025,2,2279006,2299362,+,20356
184,BUMA.1121.00031,2,3074810,3095152,+,20342
184,BUMA.1121.00007,2,716577,736971,+,20394
184,BUMA.1121.00097,2,470641,491037,+,20396
184,BUMA.1121.00008,2,355750,376082,+,20332
184,BUMA.1121.00059,2,2963903,2984270,-,20367
184,BUMA.1121.00002,2,952357,972689,+,20332
184,BUMA.1121.00004,2,355878,376210,+,20332
184,BUMA.1121.00005,2,36912,57316,-,20404
184,BUMA.1121.00111,2,3106442,3126792,+,20350
184,BUMA.1121.00006,2,379281,399613,+,20332
184,BUMA.1121.00009,2,2574266,2594622,+,20356
184,BUMA.1121.00094,2,718035,738428,+,20393
184,BUMA.1121.00101,2,2714099,2734472,-,20373
184,BUMA.1121.00066,2,659129,679522,+,20393
184,BUMA.1121.00095,2,2720379,2740767,+,20388
184,BUMA.1121.00112,2,474542,494971,-,20429
184,BUMA.1121.00032,2,780219,800551,+,20332
184,BUMA.1121.00090,2,1607523,1627873,+,20350
184,BUMA.1121.00020,2,355853,376185,+,20332
184,BUMA.1121.00089,2,662714,683107,+,20393
184,BUMA.1121.00051,2,674348,694762,+,20414
184,BUMA.1121.00001,2,1570521,1591004,-,20483
184,BUMA.1121.00045,2,511589,531959,+,20370
184,BUMA.1121.00043,2,1730989,1751338,-,20349
184,BUMA.1121.00063,2,652813,673206,+,20393
184,BUMA.1121.00079,2,674808,695161,+,20353
184,BUMA.1121.00071,2,652863,673250,+,20387
184,BUMA.1121.00086,2,1952880,1973212,-,20332
184,BUMA.1121.00024,2,355750,376082,+,20332
184,BUMA.1121.00010,2,1805798,1826130,+,20332
184,BUMA.1121.00040,2,1789376,1809707,-,20331
184,BUMA.1121.00093,2,2238054,2258432,-,20378
184,BUMA.1121.00091,2,2988101,3008565,-,20464
184,BUMA.1121.00107,2,3206808,3227179,-,20371
184,BUMA.1121.00088,2,618494,638861,+,20367
184,BUMA.1121.00047,2,1604821,1625214,+,20393
184,BUMA.1121.00019,2,355817,376149,+,20332
184,BUMA.1121.00087,2,981992,1002324,+,20332
184,BUMA.1121.00039,2,127148,147498,-,20350
184,BUMA.1121.00030,2,1745561,1765893,-,20332
184,BUMA.1121.00016,2,3141835,3162185,-,20350
184,BUMA.1121.00092,2,686467,706845,+,20378
184,BUMA.1121.00085,2,765833,786148,-,20315
184,BUMA.1121.00046,2,616794,637126,-,20332
184,BUMA.1121.00003,2,2049532,2069993,+,20461
184,BUMA.1121.00054,2,179440,199772,+,20332
184,BUMA.1121.00015,2,2091683,2112015,-,20332
184,BUMA.1121.00105,2,1827085,1847472,-,20387
184,BUMA.1121.00052,2,1454384,1474699,-,20315
184,BUMA.1121.00053,2,905899,926298,+,20399
184,BUMA.1121.00057,2,1394585,1415037,-,20452
184,BUMA.1121.00108,2,903239,923602,+,20363
184,BUMA.1121.00050,2,476441,496773,+,20332
184,BUMA.1121.00104,2,768961,789323,+,20362
184,BUMA.1121.00014,2,742435,762777,+,20342
184,BUMA.1121.00036,2,1975666,1995998,+,20332
184,BUMA.1121.00038,2,379315,399647,+,20332
184,BUMA.1121.00098,2,875279,895690,+,20411
184,BUMA.1121.00078,2,2530742,2551181,-,20439
184,BUMA.1121.00029,2,685861,706253,-,20392
184,BUMA.1121.00099,2,878834,899193,+,20359
184,BUMA.1121.00103,2,2533626,2553992,+,20366
184,BUMA.1121.00102,2,668705,689059,+,20354
184,BUMA.1121.00028,2,355832,376164,+,20332
184,BUMA.1121.00075,2,2165700,2186085,-,20385
184,BUMA.1121.00044,2,407022,427354,+,20332
184,BUMA.1121.00076,2,1559623,1580008,+,20385
184,BUMA.1121.00074,2,305269,325637,-,20368
184,BUMA.1121.00073,2,653479,673872,+,20393
184,BUMA.1121.00083,2,2478625,2499018,+,20393
184,BUMA.1121.00035,2,733135,753590,-,20455
184,BUMA.1121.00072,2,649895,670283,+,20388
184,BUMA.1121.00056,2,208737,229130,-,20393
184,BUMA.1121.00081,2,1923894,1944226,-,20332
184,BUMA.1121.00033,2,1354880,1375328,+,20448
184,BUMA.1121.00061,2,643419,663812,+,20393
184,BUMA.1121.00062,2,1086656,1107018,-,20362
184,BUMA.1121.00064,2,589491,609854,+,20363
184,BUMA.1121.00060,2,1561866,1582236,-,20370
184,BUMA.1121.00069,2,651420,671807,+,20387
184,BUMA.1121.00070,2,653563,673956,+,20393
184,BUMA.1121.00068,2,2381363,2401737,+,20374
184,BUMA.1121.00067,2,125899,146267,-,20368
184,BUMA.1121.00037,2,979648,999998,+,20350
184,BUMA.1121.00065,2,666641,687016,+,20375
184,BUMA.1121.00058,2,1225391,1245743,+,20352
184,BUMA.1121.00041,2,1562170,1582595,+,20425
184,BUMA.1121.00084,2,2501659,2522016,+,20357
184,BUMA.1121.00096,2,836016,856448,+,20432
184,BUMA.1121.00080,2,675587,695964,+,20377
184,BUMA.1121.00013,2,31896,52211,-,20315
184,BUMA.1121.00100,2,1780489,1800869,+,20380
184,BUMA.1121.00012,2,1069845,1090265,-,20420
184,BUMA.1121.00018,2,33666,54022,-,20356
184,BUMA.1121.00048,2,337934,358266,-,20332
184,BUMA.1121.00106,2,3079420,3099791,+,20371
184,BUMA.1121.00017,2,355885,376217,+,20332
184,BUMA.1121.00082,2,681668,702061,+,20393
183,BUMA.1121.00049,2,2479680,2487847,+,8167
183,BUMA.1121.00055,2,1999604,2007770,-,8166
183,BUMA.1121.00011,2,2544365,2552531,+,8166
183,BUMA.1121.00110,2,542395,550554,+,8159
183,BUMA.1121.00109,2,737878,746044,-,8166
183,BUMA.1121.00077,2,3066045,3074204,-,8159
183,BUMA.1121.00027,2,1724871,1733029,+,8158
183,BUMA.1121.00021,2,1127339,1135506,+,8167
183,BUMA.1121.00023,2,704280,712447,+,8167
183,BUMA.1121.00022,2,1165703,1173869,-,8166
183,BUMA.1121.00034,2,347373,355539,+,8166
183,BUMA.1121.00025,2,2270472,2278639,+,8167
183,BUMA.1121.00031,2,3066276,3074443,+,8167
183,BUMA.1121.00007,2,708044,716210,+,8166
183,BUMA.1121.00097,2,462127,470274,+,8147
183,BUMA.1121.00008,2,347217,355383,+,8166
183,BUMA.1121.00059,2,2984637,2992803,-,8166
183,BUMA.1121.00002,2,943824,951990,+,8166
183,BUMA.1121.00004,2,347345,355511,+,8166
183,BUMA.1121.00005,2,57683,65849,-,8166
183,BUMA.1121.00111,2,3097908,3106075,+,8167
183,BUMA.1121.00006,2,370748,378914,+,8166
183,BUMA.1121.00009,2,2565733,2573899,+,8166
183,BUMA.1121.00094,2,709501,717668,+,8167
183,BUMA.1121.00101,2,2734839,2743005,-,8166
183,BUMA.1121.00066,2,650596,658762,+,8166
183,BUMA.1121.00095,2,2711870,2720002,+,8132
183,BUMA.1121.00112,2,495338,503505,-,8167
183,BUMA.1121.00032,2,771686,779852,+,8166
183,BUMA.1121.00090,2,1599030,1607156,+,8126
183,BUMA.1121.00020,2,347320,355486,+,8166
183,BUMA.1121.00089,2,654180,662347,+,8167
183,BUMA.1121.00051,2,665815,673981,+,8166
183,BUMA.1121.00001,2,1591371,1599538,-,8167
183,BUMA.1121.00045,2,503055,511222,+,8167
183,BUMA.1121.00043,2,1751705,1759872,-,8167
183,BUMA.1121.00063,2,644280,652446,+,8166
183,BUMA.1121.00079,2,666274,674441,+,8167
183,BUMA.1121.00071,2,644330,652496,+,8166
183,BUMA.1121.00086,2,1973579,1981745,-,8166
183,BUMA.1121.00024,2,347217,355383,+,8166
183,BUMA.1121.00010,2,1797265,1805431,+,8166
183,BUMA.1121.00040,2,1810074,1818240,-,8166
183,BUMA.1121.00093,2,2258799,2266961,-,8162
183,BUMA.1121.00091,2,3008932,3017099,-,8167
183,BUMA.1121.00107,2,427,8593,-,8166
183,BUMA.1121.00088,2,609961,618127,+,8166
183,BUMA.1121.00047,2,1596287,1604454,+,8167
183,BUMA.1121.00019,2,347284,355450,+,8166
183,BUMA.1121.00087,2,973459,981625,+,8166
183,BUMA.1121.00039,2,147865,156032,-,8167
183,BUMA.1121.00030,2,1766260,1774426,-,8166
183,BUMA.1121.00016,2,3162552,3170718,-,8166
183,BUMA.1121.00092,2,677938,686100,+,8162
183,BUMA.1121.00085,2,786515,794681,-,8166
183,BUMA.1121.00046,2,637493,645659,-,8166
183,BUMA.1121.00003,2,2040998,2049165,+,8167
183,BUMA.1121.00054,2,170907,179073,+,8166
183,BUMA.1121.00015,2,2112382,2120548,-,8166
183,BUMA.1121.00105,2,1847839,1856005,-,8166
183,BUMA.1121.00052,2,1475066,1483232,-,8166
183,BUMA.1121.00053,2,897363,905532,+,8169
183,BUMA.1121.00057,2,1415404,1423562,-,8158
183,BUMA.1121.00108,2,894706,902872,+,8166
183,BUMA.1121.00050,2,467908,476074,+,8166
183,BUMA.1121.00104,2,760434,768594,+,8160
183,BUMA.1121.00014,2,733901,742068,+,8167
183,BUMA.1121.00036,2,1967133,1975299,+,8166
183,BUMA.1121.00038,2,370782,378948,+,8166
183,BUMA.1121.00098,2,866745,874912,+,8167
183,BUMA.1121.00078,2,2551548,2559716,-,8168
183,BUMA.1121.00029,2,706620,714787,-,8167
183,BUMA.1121.00099,2,870298,878457,+,8159
183,BUMA.1121.00103,2,2525092,2533249,+,8157
183,BUMA.1121.00102,2,660169,668338,+,8169
183,BUMA.1121.00028,2,347299,355465,+,8166
183,BUMA.1121.00075,2,2186452,2194621,-,8169
183,BUMA.1121.00044,2,398489,406655,+,8166
183,BUMA.1121.00076,2,1551087,1559256,+,8169
183,BUMA.1121.00074,2,326004,334170,-,8166
183,BUMA.1121.00073,2,644946,653112,+,8166
183,BUMA.1121.00083,2,2470092,2478258,+,8166
183,BUMA.1121.00035,2,753957,762114,-,8157
183,BUMA.1121.00072,2,641362,649528,+,8166
183,BUMA.1121.00056,2,229497,237664,-,8167
183,BUMA.1121.00081,2,1944593,1952759,-,8166
183,BUMA.1121.00033,2,1346347,1354513,+,8166
183,BUMA.1121.00061,2,634886,643052,+,8166
183,BUMA.1121.00062,2,1107385,1115551,-,8166
183,BUMA.1121.00064,2,580958,589124,+,8166
183,BUMA.1121.00060,2,1582603,1590770,-,8167
183,BUMA.1121.00069,2,642887,651053,+,8166
183,BUMA.1121.00070,2,645030,653196,+,8166
183,BUMA.1121.00068,2,2372828,2380996,+,8168
183,BUMA.1121.00067,2,146634,154800,-,8166
183,BUMA.1121.00037,2,971114,979281,+,8167
183,BUMA.1121.00065,2,658107,666274,+,8167
183,BUMA.1121.00058,2,1216864,1225024,+,8160
183,BUMA.1121.00041,2,1553636,1561803,+,8167
183,BUMA.1121.00084,2,2493126,2501292,+,8166
183,BUMA.1121.00096,2,827482,835649,+,8167
183,BUMA.1121.00080,2,667053,675220,+,8167
183,BUMA.1121.00013,2,52578,60744,-,8166
183,BUMA.1121.00100,2,1771956,1780122,+,8166
183,BUMA.1121.00012,2,1090632,1098798,-,8166
183,BUMA.1121.00018,2,54389,62556,-,8167
183,BUMA.1121.00048,2,358633,366799,-,8166
183,BUMA.1121.00106,2,3070894,3079053,+,8159
183,BUMA.1121.00017,2,347352,355518,+,8166
183,BUMA.1121.00082,2,673135,681301,+,8166
182,BUMA.1121.00049,2,2475455,2479084,+,3629
182,BUMA.1121.00055,2,2008342,2011970,-,3628
182,BUMA.1121.00011,2,2540151,2543769,+,3618
182,BUMA.1121.00110,2,538172,541799,+,3627
182,BUMA.1121.00109,2,746640,750321,-,3681
182,BUMA.1121.00077,2,3074800,3078426,-,3626
182,BUMA.1121.00027,2,1720591,1724275,+,3684
182,BUMA.1121.00021,2,1123116,1126743,+,3627
182,BUMA.1121.00023,2,700057,703684,+,3627
182,BUMA.1121.00022,2,1174465,1178091,-,3626
182,BUMA.1121.00034,2,343150,346777,+,3627
182,BUMA.1121.00025,2,2266248,2269876,+,3628
182,BUMA.1121.00031,2,3026802,3030429,+,3627
182,BUMA.1121.00007,2,703820,707442,+,3622
182,BUMA.1121.00097,2,457902,461531,+,3629
182,BUMA.1121.00008,2,342994,346621,+,3627
182,BUMA.1121.00059,2,2993399,2997044,-,3645
182,BUMA.1121.00002,2,939601,943228,+,3627
182,BUMA.1121.00004,2,343122,346749,+,3627
182,BUMA.1121.00005,2,66445,70073,-,3628
182,BUMA.1121.00111,2,3093676,3097312,+,3636
182,BUMA.1121.00006,2,366525,370152,+,3627
182,BUMA.1121.00009,2,2561508,2565137,+,3629
182,BUMA.1121.00094,2,705276,708905,+,3629
182,BUMA.1121.00101,2,2743601,2747240,-,3639
182,BUMA.1121.00066,2,646371,650000,+,3629
182,BUMA.1121.00095,2,2707646,2711274,+,3628
182,BUMA.1121.00112,2,504101,507727,-,3626
182,BUMA.1121.00032,2,767463,771090,+,3627
182,BUMA.1121.00090,2,1559515,1563142,+,3627
182,BUMA.1121.00020,2,343097,346724,+,3627
182,BUMA.1121.00089,2,649955,653584,+,3629
182,BUMA.1121.00051,2,661590,665219,+,3629
182,BUMA.1121.00001,2,1600134,1603760,-,3626
182,BUMA.1121.00045,2,498830,502459,+,3629
182,BUMA.1121.00043,2,1760468,1764093,-,3625
182,BUMA.1121.00063,2,640055,643684,+,3629
182,BUMA.1121.00079,2,662051,665678,+,3627
182,BUMA.1121.00071,2,640116,643734,+,3618
182,BUMA.1121.00086,2,1982341,1985967,-,3626
182,BUMA.1121.00024,2,342994,346621,+,3627
182,BUMA.1121.00010,2,1793042,1796669,+,3627
182,BUMA.1121.00040,2,1818836,1822462,-,3626
182,BUMA.1121.00093,2,2267557,2271185,-,3628
182,BUMA.1121.00091,2,3017695,3021324,-,3629
182,BUMA.1121.00107,2,9189,12817,-,3628
182,BUMA.1121.00088,2,605736,609365,+,3629
182,BUMA.1121.00047,2,1592062,1595691,+,3629
182,BUMA.1121.00019,2,343061,346688,+,3627
182,BUMA.1121.00087,2,969236,972863,+,3627
182,BUMA.1121.00039,2,156628,160254,-,3626
182,BUMA.1121.00030,2,1775022,1778648,-,3626
182,BUMA.1121.00016,2,3171314,3174940,-,3626
182,BUMA.1121.00092,2,673713,677342,+,3629
182,BUMA.1121.00085,2,795277,798903,-,3626
182,BUMA.1121.00046,2,646255,649881,-,3626
182,BUMA.1121.00003,2,2036774,2040402,+,3628
182,BUMA.1121.00054,2,166684,170311,+,3627
182,BUMA.1121.00015,2,2121144,2124770,-,3626
182,BUMA.1121.00105,2,1856601,1860229,-,3628
182,BUMA.1121.00052,2,1483828,1487454,-,3626
182,BUMA.1121.00053,2,893138,896767,+,3629
182,BUMA.1121.00057,2,1424158,1427842,-,3684
182,BUMA.1121.00108,2,890481,894110,+,3629
182,BUMA.1121.00050,2,463685,467312,+,3627
182,BUMA.1121.00104,2,756146,759838,+,3692
182,BUMA.1121.00014,2,694427,698054,+,3627
182,BUMA.1121.00036,2,1962910,1966537,+,3627
182,BUMA.1121.00038,2,366559,370186,+,3627
182,BUMA.1121.00098,2,862520,866149,+,3629
182,BUMA.1121.00078,2,2560312,2563940,-,3628
182,BUMA.1121.00029,2,715383,719009,-,3626
182,BUMA.1121.00099,2,866073,869702,+,3629
182,BUMA.1121.00103,2,2520867,2524496,+,3629
182,BUMA.1121.00102,2,655944,659573,+,3629
182,BUMA.1121.00028,2,343076,346703,+,3627
182,BUMA.1121.00075,2,2195217,2198902,-,3685
182,BUMA.1121.00044,2,394266,397893,+,3627
182,BUMA.1121.00076,2,1546805,1550491,+,3686
182,BUMA.1121.00074,2,334766,338400,-,3634
182,BUMA.1121.00073,2,640730,644350,+,3620
182,BUMA.1121.00083,2,2465867,2469496,+,3629
182,BUMA.1121.00035,2,797971,801597,-,3626
182,BUMA.1121.00072,2,637137,640766,+,3629
182,BUMA.1121.00056,2,238260,241888,-,3628
182,BUMA.1121.00081,2,1953355,1956981,-,3626
182,BUMA.1121.00033,2,1342124,1345751,+,3627
182,BUMA.1121.00061,2,630668,634290,+,3622
182,BUMA.1121.00062,2,1116147,1119832,-,3685
182,BUMA.1121.00064,2,576727,580362,+,3635
182,BUMA.1121.00060,2,1591366,1594994,-,3628
182,BUMA.1121.00069,2,638675,642291,+,3616
182,BUMA.1121.00070,2,640812,644434,+,3622
182,BUMA.1121.00068,2,2368605,2372232,+,3627
182,BUMA.1121.00067,2,155396,159030,-,3634
182,BUMA.1121.00037,2,966891,970518,+,3627
182,BUMA.1121.00065,2,653882,657511,+,3629
182,BUMA.1121.00058,2,1212588,1216268,+,3680
182,BUMA.1121.00041,2,1549411,1553040,+,3629
182,BUMA.1121.00084,2,2488901,2492530,+,3629
182,BUMA.1121.00096,2,823251,826886,+,3635
182,BUMA.1121.00080,2,662828,666457,+,3629
182,BUMA.1121.00013,2,61340,64966,-,3626
182,BUMA.1121.00100,2,1767661,1771360,+,3699
182,BUMA.1121.00012,2,1099394,1103020,-,3626
182,BUMA.1121.00018,2,63152,66779,-,3627
182,BUMA.1121.00048,2,367395,371021,-,3626
182,BUMA.1121.00106,2,3066669,3070298,+,3629
182,BUMA.1121.00017,2,343129,346756,+,3627
182,BUMA.1121.00082,2,668910,672539,+,3629
181,BUMA.1121.00049,2,2454808,2472088,+,17280
181,BUMA.1121.00055,2,2015352,2032620,-,17268
181,BUMA.1121.00011,2,2519446,2536737,+,17291
181,BUMA.1121.00110,2,517528,534800,+,17272
181,BUMA.1121.00109,2,753689,770961,-,17272
181,BUMA.1121.00077,2,3081798,3099070,-,17272
181,BUMA.1121.00027,2,1699967,1717207,+,17240
181,BUMA.1121.00021,2,1102419,1119699,+,17280
181,BUMA.1121.00023,2,679433,696707,+,17274
181,BUMA.1121.00025,2,2245552,2262832,+,17280
181,BUMA.1121.00031,2,3006111,3023386,+,17275
181,BUMA.1121.00007,2,683145,700405,+,17260
181,BUMA.1121.00097,2,437270,454533,+,17263
181,BUMA.1121.00059,2,3000461,3017709,-,17248
181,BUMA.1121.00005,2,73445,90712,-,17267
181,BUMA.1121.00111,2,3071364,3088644,+,17280
181,BUMA.1121.00009,2,2540865,2558138,+,17273
181,BUMA.1121.00094,2,684655,701908,+,17253
181,BUMA.1121.00101,2,2750677,2767914,-,17237
181,BUMA.1121.00066,2,625727,642987,+,17260
181,BUMA.1121.00095,2,2686951,2704217,+,17266
181,BUMA.1121.00112,2,511158,528419,-,17261
181,BUMA.1121.00090,2,1538819,1556099,+,17280
181,BUMA.1121.00089,2,629334,646587,+,17253
181,BUMA.1121.00051,2,640945,658222,+,17277
181,BUMA.1121.00001,2,1607176,1624473,-,17297
181,BUMA.1121.00045,2,478163,495399,+,17236
181,BUMA.1121.00043,2,1767477,1784761,-,17284
181,BUMA.1121.00063,2,619401,636673,+,17272
181,BUMA.1121.00079,2,641397,658683,+,17286
181,BUMA.1121.00071,2,619471,636732,+,17261
181,BUMA.1121.00093,2,2274568,2291788,-,17220
181,BUMA.1121.00091,2,3024696,3041961,-,17265
181,BUMA.1121.00107,2,16188,33466,-,17278
181,BUMA.1121.00088,2,585112,602370,+,17258
181,BUMA.1121.00047,2,1571408,1588694,+,17286
181,BUMA.1121.00039,2,163671,180950,-,17279
181,BUMA.1121.00016,2,3179711,3196993,-,17282
181,BUMA.1121.00092,2,653110,670330,+,17220
181,BUMA.1121.00003,2,2016112,2033350,+,17238
181,BUMA.1121.00105,2,1863613,1880877,-,17264
181,BUMA.1121.00053,2,872500,889767,+,17267
181,BUMA.1121.00057,2,1431226,1448468,-,17242
181,BUMA.1121.00108,2,869843,887111,+,17268
181,BUMA.1121.00104,2,735485,752777,+,17292
181,BUMA.1121.00014,2,673736,691011,+,17275
181,BUMA.1121.00098,2,841874,859146,+,17272
181,BUMA.1121.00078,2,2567311,2584572,-,17261
181,BUMA.1121.00029,2,722426,739720,-,17294
181,BUMA.1121.00099,2,845383,862656,+,17273
181,BUMA.1121.00103,2,2500203,2517435,+,17232
181,BUMA.1121.00102,2,635317,652575,+,17258
181,BUMA.1121.00075,2,2202272,2219540,-,17268
181,BUMA.1121.00076,2,1526167,1543436,+,17269
181,BUMA.1121.00074,2,341828,359107,-,17279
181,BUMA.1121.00073,2,620080,637346,+,17266
181,BUMA.1121.00083,2,2445217,2462483,+,17266
181,BUMA.1121.00035,2,805014,822311,-,17297
181,BUMA.1121.00072,2,616493,633754,+,17261
181,BUMA.1121.00056,2,245257,262510,-,17253
181,BUMA.1121.00033,2,1320076,1337355,+,17279
181,BUMA.1121.00061,2,610018,627284,+,17266
181,BUMA.1121.00062,2,1123260,1140539,-,17279
181,BUMA.1121.00064,2,556020,573299,+,17279
181,BUMA.1121.00060,2,1598425,1615661,-,17236
181,BUMA.1121.00069,2,618030,635291,+,17261
181,BUMA.1121.00070,2,620167,637428,+,17261
181,BUMA.1121.00068,2,2347943,2365220,+,17277
181,BUMA.1121.00067,2,162458,179737,-,17279
181,BUMA.1121.00037,2,946185,963475,+,17290
181,BUMA.1121.00065,2,633219,650498,+,17279
181,BUMA.1121.00058,2,1191946,1209219,+,17273
181,BUMA.1121.00041,2,1528785,1546028,+,17243
181,BUMA.1121.00084,2,2468283,2485535,+,17252
181,BUMA.1121.00096,2,802564,819839,+,17275
181,BUMA.1121.00080,2,642176,659460,+,17284
181,BUMA.1121.00100,2,1747036,1764292,+,17256
181,BUMA.1121.00012,2,1106356,1123615,-,17259
181,BUMA.1121.00018,2,70196,87475,-,17279
181,BUMA.1121.00106,2,3046037,3063300,+,17263
181,BUMA.1121.00082,2,648260,665526,+,17266
180,BUMA.1121.00049,2,2447757,2453215,+,5458
180,BUMA.1121.00055,2,2034213,2039667,-,5454
180,BUMA.1121.00011,2,2512403,2517853,+,5450
180,BUMA.1121.00110,2,510490,515934,+,5444
180,BUMA.1121.00109,2,772554,778028,-,5474
180,BUMA.1121.00077,2,3100663,3106107,-,5444
180,BUMA.1121.00027,2,1692916,1698374,+,5458
180,BUMA.1121.00021,2,1095376,1100826,+,5450
180,BUMA.1121.00023,2,672390,677840,+,5450
180,BUMA.1121.00025,2,2238509,2243959,+,5450
180,BUMA.1121.00031,2,2999068,3004518,+,5450
180,BUMA.1121.00007,2,676116,681551,+,5435
180,BUMA.1121.00097,2,430238,435682,+,5444
180,BUMA.1121.00059,2,3019302,3024756,-,5454
180,BUMA.1121.00005,2,92305,97763,-,5458
180,BUMA.1121.00111,2,3064325,3069771,+,5446
180,BUMA.1121.00009,2,2533828,2539272,+,5444
180,BUMA.1121.00094,2,677671,683061,+,5390
180,BUMA.1121.00101,2,2769503,2774940,-,5437
180,BUMA.1121.00066,2,618680,624134,+,5454
180,BUMA.1121.00095,2,2679932,2685358,+,5426
180,BUMA.1121.00112,2,530012,535447,-,5435
180,BUMA.1121.00090,2,1531776,1537226,+,5450
180,BUMA.1121.00089,2,622350,627740,+,5390
180,BUMA.1121.00051,2,633961,639351,+,5390
180,BUMA.1121.00001,2,1626066,1631516,-,5450
180,BUMA.1121.00045,2,471128,476570,+,5442
180,BUMA.1121.00043,2,1786354,1791787,-,5433
180,BUMA.1121.00063,2,612360,617814,+,5454
180,BUMA.1121.00079,2,634415,639804,+,5389
180,BUMA.1121.00071,2,612443,617878,+,5435
180,BUMA.1121.00093,2,2293381,2298835,-,5454
180,BUMA.1121.00091,2,3043554,3049008,-,5454
180,BUMA.1121.00107,2,35053,40496,-,5443
180,BUMA.1121.00088,2,578061,583519,+,5458
180,BUMA.1121.00047,2,1564424,1569814,+,5390
180,BUMA.1121.00039,2,182543,187958,-,5415
180,BUMA.1121.00016,2,3198586,3204036,-,5450
180,BUMA.1121.00092,2,646063,651517,+,5454
180,BUMA.1121.00003,2,2009070,2014518,+,5448
180,BUMA.1121.00105,2,1882470,1887924,-,5454
180,BUMA.1121.00053,2,865453,870907,+,5454
180,BUMA.1121.00057,2,1450061,1455502,-,5441
180,BUMA.1121.00108,2,862796,868250,+,5454
180,BUMA.1121.00104,2,728434,733892,+,5458
180,BUMA.1121.00014,2,666693,672143,+,5450
180,BUMA.1121.00098,2,834843,840280,+,5437
180,BUMA.1121.00078,2,2586165,2591611,-,5446
180,BUMA.1121.00029,2,741313,746763,-,5450
180,BUMA.1121.00099,2,838363,843789,+,5426
180,BUMA.1121.00103,2,2493165,2498610,+,5445
180,BUMA.1121.00102,2,628274,633724,+,5450
180,BUMA.1121.00075,2,2221133,2226586,-,5453
180,BUMA.1121.00076,2,1519120,1524574,+,5454
180,BUMA.1121.00074,2,360700,366154,-,5454
180,BUMA.1121.00073,2,613033,618487,+,5454
180,BUMA.1121.00083,2,2438170,2443624,+,5454
180,BUMA.1121.00035,2,823904,829354,-,5450
180,BUMA.1121.00072,2,609446,614900,+,5454
180,BUMA.1121.00056,2,264103,269493,-,5390
180,BUMA.1121.00033,2,1313029,1318483,+,5454
180,BUMA.1121.00061,2,602971,608425,+,5454
180,BUMA.1121.00062,2,1142132,1147586,-,5454
180,BUMA.1121.00064,2,548973,554427,+,5454
180,BUMA.1121.00060,2,1617254,1622696,-,5442
180,BUMA.1121.00069,2,610983,616437,+,5454
180,BUMA.1121.00070,2,613130,618574,+,5444
180,BUMA.1121.00068,2,2340912,2346350,+,5438
180,BUMA.1121.00067,2,181330,186784,-,5454
180,BUMA.1121.00037,2,939142,944592,+,5450
180,BUMA.1121.00065,2,626177,631631,+,5454
180,BUMA.1121.00058,2,1184947,1190353,+,5406
180,BUMA.1121.00041,2,1521742,1527192,+,5450
180,BUMA.1121.00084,2,2461232,2466690,+,5458
180,BUMA.1121.00096,2,795523,800971,+,5448
180,BUMA.1121.00080,2,635193,640583,+,5390
180,BUMA.1121.00100,2,1739984,1745430,+,5446
180,BUMA.1121.00012,2,1125208,1130656,-,5448
180,BUMA.1121.00018,2,89068,94518,-,5450
180,BUMA.1121.00106,2,3038986,3044444,+,5458
180,BUMA.1121.00082,2,641213,646667,+,5454
179,BUMA.1121.00049,2,2415575,2440428,+,24853
179,BUMA.1121.00055,2,2047002,2071759,-,24757
179,BUMA.1121.00011,2,2480250,2505068,+,24818
179,BUMA.1121.00110,2,478345,503155,+,24810
179,BUMA.1121.00109,2,785363,810193,-,24830
179,BUMA.1121.00077,2,3113445,3138253,-,24808
179,BUMA.1121.00027,2,1660734,1685581,+,24847
179,BUMA.1121.00021,2,1063215,1088041,+,24826
179,BUMA.1121.00023,2,640171,665055,+,24884
179,BUMA.1121.00025,2,2206274,2231174,+,24900
179,BUMA.1121.00031,2,2966916,2991733,+,24817
179,BUMA.1121.00007,2,644032,668781,+,24749
179,BUMA.1121.00097,2,398160,422909,+,24749
179,BUMA.1121.00059,2,3032091,3056768,-,24677
179,BUMA.1121.00005,2,105098,129996,-,24898
179,BUMA.1121.00111,2,3032100,3056990,+,24890
179,BUMA.1121.00009,2,2501561,2526493,+,24932
179,BUMA.1121.00094,2,645469,670336,+,24867
179,BUMA.1121.00101,2,2782275,2807102,-,24827
179,BUMA.1121.00066,2,586483,611351,+,24868
179,BUMA.1121.00095,2,2647783,2672603,+,24820
179,BUMA.1121.00112,2,542782,567641,-,24859
179,BUMA.1121.00090,2,1499578,1524456,+,24878
179,BUMA.1121.00089,2,590190,615015,+,24825
179,BUMA.1121.00051,2,601776,626626,+,24850
179,BUMA.1121.00001,2,1638851,1663713,-,24862
179,BUMA.1121.00045,2,439007,463793,+,24786
179,BUMA.1121.00043,2,1799116,1824109,-,24993
179,BUMA.1121.00063,2,580168,605025,+,24857
179,BUMA.1121.00079,2,602180,627080,+,24900
179,BUMA.1121.00071,2,580246,605108,+,24862
179,BUMA.1121.00093,2,2306170,2331006,-,24836
179,BUMA.1121.00091,2,3056343,3081174,-,24831
179,BUMA.1121.00107,2,47825,72629,-,24804
179,BUMA.1121.00088,2,545866,570726,+,24860
179,BUMA.1121.00047,2,1532249,1557089,+,24840
179,BUMA.1121.00039,2,195293,220160,-,24867
179,BUMA.1121.00016,2,3211371,3236245,-,24874
179,BUMA.1121.00092,2,613892,638728,+,24836
179,BUMA.1121.00003,2,1977003,2001735,+,24732
179,BUMA.1121.00105,2,1895259,1920170,-,24911
179,BUMA.1121.00053,2,833280,858133,+,24853
179,BUMA.1121.00057,2,1462837,1487657,-,24820
179,BUMA.1121.00108,2,830719,855461,+,24742
179,BUMA.1121.00104,2,696276,721105,+,24829
179,BUMA.1121.00014,2,634548,659358,+,24810
179,BUMA.1121.00098,2,802851,827514,+,24663
179,BUMA.1121.00078,2,2598943,2623816,-,24873
179,BUMA.1121.00029,2,754097,778981,-,24884
179,BUMA.1121.00099,2,806066,831028,+,24962
179,BUMA.1121.00103,2,2461011,2485830,+,24819
179,BUMA.1121.00102,2,596031,620945,+,24914
179,BUMA.1121.00075,2,2233906,2258749,-,24843
179,BUMA.1121.00076,2,1486944,1511800,+,24856
179,BUMA.1121.00074,2,373489,398265,-,24776
179,BUMA.1121.00073,2,580855,605698,+,24843
179,BUMA.1121.00083,2,2405967,2430835,+,24868
179,BUMA.1121.00035,2,836689,861536,-,24847
179,BUMA.1121.00072,2,577248,602114,+,24866
179,BUMA.1121.00056,2,276828,301653,-,24825
179,BUMA.1121.00033,2,1280788,1305695,+,24907
179,BUMA.1121.00061,2,570772,595636,+,24864
179,BUMA.1121.00062,2,1154921,1179755,-,24834
179,BUMA.1121.00064,2,516749,541638,+,24889
179,BUMA.1121.00060,2,1630031,1654817,-,24786
179,BUMA.1121.00069,2,578797,603648,+,24851
179,BUMA.1121.00070,2,580946,605795,+,24849
179,BUMA.1121.00068,2,2308715,2333583,+,24868
179,BUMA.1121.00067,2,194119,218960,-,24841
179,BUMA.1121.00037,2,906944,931807,+,24863
179,BUMA.1121.00065,2,594065,618857,+,24792
179,BUMA.1121.00058,2,1152794,1177612,+,24818
179,BUMA.1121.00041,2,1489568,1514422,+,24854
179,BUMA.1121.00084,2,2429039,2453897,+,24858
179,BUMA.1121.00096,2,763416,788194,+,24778
179,BUMA.1121.00080,2,603021,627858,+,24837
179,BUMA.1121.00100,2,1707861,1732655,+,24794
179,BUMA.1121.00012,2,1137989,1162899,-,24910
179,BUMA.1121.00018,2,101853,126753,-,24900
179,BUMA.1121.00106,2,3006807,3031657,+,24850
179,BUMA.1121.00082,2,609010,633878,+,24868
178,BUMA.1121.00049,2,2408899,2415551,+,6652
178,BUMA.1121.00055,2,2071784,2078440,-,6656
178,BUMA.1121.00011,2,2473540,2480226,+,6686
178,BUMA.1121.00110,2,471650,478321,+,6671
178,BUMA.1121.00109,2,810218,816874,-,6656
178,BUMA.1121.00077,2,3138278,3144949,-,6671
178,BUMA.1121.00027,2,1654077,1660710,+,6633
178,BUMA.1121.00021,2,1056521,1063191,+,6670
178,BUMA.1121.00023,2,633477,640147,+,6670
178,BUMA.1121.00025,2,2199580,2206250,+,6670
178,BUMA.1121.00031,2,2960222,2966892,+,6670
178,BUMA.1121.00007,2,637336,643999,+,6663
178,BUMA.1121.00097,2,391459,398136,+,6677
178,BUMA.1121.00059,2,3056793,3063444,-,6651
178,BUMA.1121.00005,2,130021,136683,-,6662
178,BUMA.1121.00111,2,3025406,3032076,+,6670
178,BUMA.1121.00009,2,2494879,2501537,+,6658
178,BUMA.1121.00094,2,638762,645445,+,6683
178,BUMA.1121.00101,2,2807127,2813797,-,6670
178,BUMA.1121.00066,2,579827,586459,+,6632
178,BUMA.1121.00095,2,2641090,2647759,+,6669
178,BUMA.1121.00112,2,567666,574315,-,6649
178,BUMA.1121.00090,2,1492884,1499554,+,6670
178,BUMA.1121.00089,2,583483,590166,+,6683
178,BUMA.1121.00051,2,595069,601752,+,6683
178,BUMA.1121.00001,2,1663738,1670408,-,6670
178,BUMA.1121.00045,2,432304,438983,+,6679
178,BUMA.1121.00043,2,1824134,1830804,-,6670
178,BUMA.1121.00063,2,573512,580144,+,6632
178,BUMA.1121.00079,2,595473,602156,+,6683
178,BUMA.1121.00071,2,573589,580222,+,6633
178,BUMA.1121.00093,2,2331031,2337714,-,6683
178,BUMA.1121.00091,2,3081199,3087852,-,6653
178,BUMA.1121.00107,2,72654,79315,-,6661
178,BUMA.1121.00088,2,539176,545842,+,6666
178,BUMA.1121.00047,2,1525542,1532225,+,6683
178,BUMA.1121.00039,2,220185,226855,-,6670
178,BUMA.1121.00016,2,3236270,3242940,-,6670
178,BUMA.1121.00092,2,607185,613868,+,6683
178,BUMA.1121.00003,2,1970343,1976979,+,6636
178,BUMA.1121.00105,2,1920195,1926867,-,6672
178,BUMA.1121.00053,2,826586,833256,+,6670
178,BUMA.1121.00057,2,1487682,1494315,-,6633
178,BUMA.1121.00108,2,824018,830695,+,6677
178,BUMA.1121.00104,2,689586,696252,+,6666
178,BUMA.1121.00014,2,627854,634524,+,6670
178,BUMA.1121.00098,2,796151,802827,+,6676
178,BUMA.1121.00078,2,2623841,2630529,-,6688
178,BUMA.1121.00029,2,779006,785664,-,6658
178,BUMA.1121.00099,2,799404,806042,+,6638
178,BUMA.1121.00103,2,2454345,2460987,+,6642
178,BUMA.1121.00102,2,589346,596007,+,6661
178,BUMA.1121.00075,2,2258774,2265473,-,6699
178,BUMA.1121.00076,2,1480221,1486920,+,6699
178,BUMA.1121.00074,2,398290,404970,-,6680
178,BUMA.1121.00073,2,574198,580831,+,6633
178,BUMA.1121.00083,2,2399310,2405943,+,6633
178,BUMA.1121.00035,2,861561,868219,-,6658
178,BUMA.1121.00072,2,570592,577224,+,6632
178,BUMA.1121.00056,2,301678,308361,-,6683
178,BUMA.1121.00033,2,1274094,1280764,+,6670
178,BUMA.1121.00061,2,564115,570748,+,6633
178,BUMA.1121.00062,2,1179780,1186436,-,6656
178,BUMA.1121.00064,2,510045,516725,+,6680
178,BUMA.1121.00060,2,1654842,1661521,-,6679
178,BUMA.1121.00069,2,572140,578773,+,6633
178,BUMA.1121.00070,2,574289,580922,+,6633
178,BUMA.1121.00068,2,2302031,2308691,+,6660
178,BUMA.1121.00067,2,218985,225656,-,6671
178,BUMA.1121.00037,2,900250,906920,+,6670
178,BUMA.1121.00065,2,587371,594041,+,6670
178,BUMA.1121.00058,2,1146071,1152770,+,6699
178,BUMA.1121.00041,2,1482887,1489544,+,6657
178,BUMA.1121.00084,2,2422349,2429015,+,6666
178,BUMA.1121.00096,2,756731,763392,+,6661
178,BUMA.1121.00080,2,596314,602997,+,6683
178,BUMA.1121.00100,2,1701211,1707825,+,6614
178,BUMA.1121.00012,2,1163871,1170510,-,6639
178,BUMA.1121.00018,2,126778,133448,-,6670
178,BUMA.1121.00106,2,3000117,3006783,+,6666
178,BUMA.1121.00082,2,602353,608986,+,6633
177,BUMA.1121.00049,2,2397436,2408659,+,11223
177,BUMA.1121.00055,2,2078680,2089914,-,11234
177,BUMA.1121.00011,2,2462044,2473300,+,11256
177,BUMA.1121.00110,2,460192,471405,+,11213
177,BUMA.1121.00109,2,817119,828432,-,11313
177,BUMA.1121.00077,2,3145194,3156406,-,11212
177,BUMA.1121.00027,2,1642646,1653833,+,11187
177,BUMA.1121.00021,2,1044930,1056281,+,11351
177,BUMA.1121.00023,2,621853,633237,+,11384
177,BUMA.1121.00025,2,2187937,2199340,+,11403
177,BUMA.1121.00031,2,2948629,2959982,+,11353
177,BUMA.1121.00007,2,625805,637112,+,11307
177,BUMA.1121.00097,2,379956,391215,+,11259
177,BUMA.1121.00059,2,3063688,3074875,-,11187
177,BUMA.1121.00005,2,136923,148140,-,11217
177,BUMA.1121.00111,2,3013813,3025166,+,11353
177,BUMA.1121.00009,2,2483455,2494657,+,11202
177,BUMA.1121.00094,2,627335,638522,+,11187
177,BUMA.1121.00101,2,2814036,2825325,-,11289
177,BUMA.1121.00066,2,568445,579732,+,11287
177,BUMA.1121.00095,2,2629620,2640859,+,11239
177,BUMA.1121.00112,2,574546,585827,-,11281
177,BUMA.1121.00090,2,1481301,1492644,+,11343
177,BUMA.1121.00089,2,572056,583243,+,11187
177,BUMA.1121.00051,2,583642,594829,+,11187
177,BUMA.1121.00001,2,1670648,1682028,-,11380
177,BUMA.1121.00045,2,420790,432073,+,11283
177,BUMA.1121.00043,2,1831044,1842350,-,11306
177,BUMA.1121.00063,2,562130,573417,+,11287
177,BUMA.1121.00079,2,583963,595231,+,11268
177,BUMA.1121.00071,2,562255,573494,+,11239
177,BUMA.1121.00093,2,2337958,2349185,-,11227
177,BUMA.1121.00091,2,3088092,3099347,-,11255
177,BUMA.1121.00107,2,79554,90876,-,11322
177,BUMA.1121.00088,2,527576,538932,+,11356
177,BUMA.1121.00047,2,1514115,1525302,+,11187
177,BUMA.1121.00039,2,227094,238417,-,11323
177,BUMA.1121.00016,2,1,11256,-,11255
177,BUMA.1121.00092,2,595714,606941,+,11227
177,BUMA.1121.00003,2,1958779,1970105,+,11326
177,BUMA.1121.00105,2,1927106,1938315,-,11209
177,BUMA.1121.00053,2,814992,826346,+,11354
177,BUMA.1121.00057,2,1494559,1505746,-,11187
177,BUMA.1121.00108,2,812602,823794,+,11192
177,BUMA.1121.00104,2,678070,689346,+,11276
177,BUMA.1121.00014,2,616271,627614,+,11343
177,BUMA.1121.00098,2,784596,795907,+,11311
177,BUMA.1121.00078,2,2630769,2641971,-,11202
177,BUMA.1121.00029,2,785904,797274,-,11370
177,BUMA.1121.00099,2,787849,799155,+,11306
177,BUMA.1121.00103,2,2442811,2454101,+,11290
177,BUMA.1121.00102,2,577835,589102,+,11267
177,BUMA.1121.00075,2,2265717,2277030,-,11313
177,BUMA.1121.00076,2,1468663,1479977,+,11314
177,BUMA.1121.00074,2,405214,416423,-,11209
177,BUMA.1121.00073,2,562816,574103,+,11287
177,BUMA.1121.00083,2,2387928,2399215,+,11287
177,BUMA.1121.00035,2,868459,879809,-,11350
177,BUMA.1121.00072,2,559210,570497,+,11287
177,BUMA.1121.00056,2,308601,319788,-,11187
177,BUMA.1121.00033,2,1262547,1273854,+,11307
177,BUMA.1121.00061,2,552734,564020,+,11286
177,BUMA.1121.00062,2,1186676,1197949,-,11273
177,BUMA.1121.00064,2,498592,509801,+,11209
177,BUMA.1121.00060,2,1661752,1673035,-,11283
177,BUMA.1121.00069,2,560758,572045,+,11287
177,BUMA.1121.00070,2,562907,574194,+,11287
177,BUMA.1121.00068,2,2290413,2301791,+,11378
177,BUMA.1121.00067,2,225900,237217,-,11317
177,BUMA.1121.00037,2,888677,900010,+,11333
177,BUMA.1121.00065,2,575750,587131,+,11381
177,BUMA.1121.00058,2,1134608,1145827,+,11219
177,BUMA.1121.00041,2,1471375,1482643,+,11268
177,BUMA.1121.00084,2,2410881,2422105,+,11224
177,BUMA.1121.00096,2,745159,756498,+,11339
177,BUMA.1121.00080,2,584879,596074,+,11195
177,BUMA.1121.00100,2,1689737,1700966,+,11229
177,BUMA.1121.00012,2,1170750,1182123,-,11373
177,BUMA.1121.00018,2,133688,145091,-,11403
177,BUMA.1121.00106,2,2988659,2999873,+,11214
177,BUMA.1121.00082,2,590971,602258,+,11287
176,BUMA.1121.00049,2,2365554,2377028,+,11474
176,BUMA.1121.00055,2,2090142,2101601,-,11459
176,BUMA.1121.00011,2,2430168,2441642,+,11474
176,BUMA.1121.00110,2,428326,439799,+,11473
176,BUMA.1121.00109,2,848831,860303,-,11472
176,BUMA.1121.00077,2,3176799,3188271,-,11472
176,BUMA.1121.00027,2,1610764,1622237,+,11473
176,BUMA.1121.00021,2,1013054,1024528,+,11474
176,BUMA.1121.00023,2,589978,601451,+,11473
176,BUMA.1121.00025,2,2156066,2167540,+,11474
176,BUMA.1121.00031,2,2916753,2928227,+,11474
176,BUMA.1121.00007,2,593967,605441,+,11474
176,BUMA.1121.00097,2,348073,359547,+,11474
176,BUMA.1121.00059,2,3095284,3106756,-,11472
176,BUMA.1121.00005,2,168543,180015,-,11472
176,BUMA.1121.00111,2,2981919,2993393,+,11474
176,BUMA.1121.00009,2,2451573,2463046,+,11473
176,BUMA.1121.00094,2,595459,606932,+,11473
176,BUMA.1121.00101,2,2845725,2857197,-,11472
176,BUMA.1121.00066,2,536568,548042,+,11474
176,BUMA.1121.00095,2,2597737,2609211,+,11474
176,BUMA.1121.00112,2,606229,617701,-,11472
176,BUMA.1121.00090,2,1449425,1460899,+,11474
176,BUMA.1121.00089,2,540180,551653,+,11473
176,BUMA.1121.00051,2,551768,563241,+,11473
176,BUMA.1121.00001,2,1702430,1713903,-,11473
176,BUMA.1121.00045,2,388916,400390,+,11474
176,BUMA.1121.00043,2,1862746,1874218,-,11472
176,BUMA.1121.00063,2,530253,541727,+,11474
176,BUMA.1121.00079,2,552089,563562,+,11473
176,BUMA.1121.00071,2,530378,541852,+,11474
176,BUMA.1121.00093,2,2369579,2381051,-,11472
176,BUMA.1121.00091,2,3119750,3131223,-,11473
176,BUMA.1121.00107,2,111267,122740,-,11473
176,BUMA.1121.00088,2,495700,507173,+,11473
176,BUMA.1121.00047,2,1482239,1493712,+,11473
176,BUMA.1121.00039,2,258819,270292,-,11473
176,BUMA.1121.00016,2,31647,43119,-,11472
176,BUMA.1121.00092,2,563847,575320,+,11473
176,BUMA.1121.00003,2,1926905,1938379,+,11474
176,BUMA.1121.00105,2,1958718,1970190,-,11472
176,BUMA.1121.00053,2,783115,794589,+,11474
176,BUMA.1121.00057,2,1526155,1537628,-,11473
176,BUMA.1121.00108,2,780726,792199,+,11473
176,BUMA.1121.00104,2,647483,658957,+,11474
176,BUMA.1121.00014,2,584396,595869,+,11473
176,BUMA.1121.00098,2,752719,764193,+,11474
176,BUMA.1121.00078,2,2662379,2673852,-,11473
176,BUMA.1121.00029,2,817676,829149,-,11473
176,BUMA.1121.00099,2,755967,767441,+,11474
176,BUMA.1121.00103,2,2410934,2422408,+,11474
176,BUMA.1121.00102,2,545958,557432,+,11474
176,BUMA.1121.00075,2,2297434,2308907,-,11473
176,BUMA.1121.00076,2,1436785,1448259,+,11474
176,BUMA.1121.00074,2,436836,448308,-,11472
176,BUMA.1121.00073,2,530939,542413,+,11474
176,BUMA.1121.00083,2,2356051,2367525,+,11474
176,BUMA.1121.00035,2,900211,911684,-,11473
176,BUMA.1121.00072,2,527334,538808,+,11474
176,BUMA.1121.00056,2,340191,351663,-,11472
176,BUMA.1121.00033,2,1230680,1242151,+,11471
176,BUMA.1121.00061,2,520857,532331,+,11474
176,BUMA.1121.00062,2,1218352,1229825,-,11473
176,BUMA.1121.00064,2,466706,478179,+,11473
176,BUMA.1121.00060,2,1693435,1704908,-,11473
176,BUMA.1121.00069,2,528881,540355,+,11474
176,BUMA.1121.00070,2,531030,542504,+,11474
176,BUMA.1121.00068,2,2258537,2270010,+,11473
176,BUMA.1121.00067,2,257630,269102,-,11472
176,BUMA.1121.00037,2,856801,868274,+,11473
176,BUMA.1121.00065,2,543873,555347,+,11474
176,BUMA.1121.00058,2,1102719,1114193,+,11474
176,BUMA.1121.00041,2,1459681,1471147,+,11466
176,BUMA.1121.00084,2,2379004,2390478,+,11474
176,BUMA.1121.00096,2,713279,724752,+,11473
176,BUMA.1121.00080,2,553003,564476,+,11473
176,BUMA.1121.00100,2,1657854,1669328,+,11474
176,BUMA.1121.00012,2,1202525,1213998,-,11473
176,BUMA.1121.00018,2,165488,176961,-,11473
176,BUMA.1121.00106,2,2956781,2968255,+,11474
176,BUMA.1121.00082,2,559094,570568,+,11474
175,BUMA.1121.00049,2,2356399,2364722,+,8323
175,BUMA.1121.00055,2,2102434,2110756,-,8322
175,BUMA.1121.00011,2,2421013,2429336,+,8323
175,BUMA.1121.00110,2,419171,427494,+,8323
175,BUMA.1121.00109,2,861136,869458,-,8322
175,BUMA.1121.00077,2,3189104,3197426,-,8322
175,BUMA.1121.00027,2,1601609,1609932,+,8323
175,BUMA.1121.00021,2,1003887,1012222,+,8335
175,BUMA.1121.00023,2,580823,589146,+,8323
175,BUMA.1121.00022,2,1002395,1010717,-,8322
175,BUMA.1121.00034,2,434232,442555,+,8323
175,BUMA.1121.00025,2,2146911,2155234,+,8323
175,BUMA.1121.00031,2,2907598,2915921,+,8323
175,BUMA.1121.00007,2,584812,593135,+,8323
175,BUMA.1121.00097,2,338918,347241,+,8323
175,BUMA.1121.00008,2,434044,442367,+,8323
175,BUMA.1121.00059,2,3107589,3115911,-,8322
175,BUMA.1121.00004,2,434199,442522,+,8323
175,BUMA.1121.00005,2,180848,189170,-,8322
175,BUMA.1121.00111,2,2972764,2981087,+,8323
175,BUMA.1121.00009,2,2442418,2450741,+,8323
175,BUMA.1121.00094,2,586304,594627,+,8323
175,BUMA.1121.00101,2,2858030,2866352,-,8322
175,BUMA.1121.00066,2,527413,535736,+,8323
175,BUMA.1121.00095,2,2588582,2596905,+,8323
175,BUMA.1121.00112,2,618534,626856,-,8322
175,BUMA.1121.00042,2,517668,525981,+,8313
175,BUMA.1121.00032,2,858520,866843,+,8323
175,BUMA.1121.00090,2,1440270,1448593,+,8323
175,BUMA.1121.00020,2,434179,442502,+,8323
175,BUMA.1121.00089,2,531025,539348,+,8323
175,BUMA.1121.00051,2,542613,550936,+,8323
175,BUMA.1121.00001,2,1714736,1723058,-,8322
175,BUMA.1121.00045,2,379761,388084,+,8323
175,BUMA.1121.00043,2,1875051,1883373,-,8322
175,BUMA.1121.00063,2,521098,529421,+,8323
175,BUMA.1121.00079,2,542934,551257,+,8323
175,BUMA.1121.00071,2,521223,529546,+,8323
175,BUMA.1121.00086,2,1810290,1818612,-,8322
175,BUMA.1121.00024,2,434076,442399,+,8323
175,BUMA.1121.00093,2,2381884,2390206,-,8322
175,BUMA.1121.00091,2,3132056,3140378,-,8322
175,BUMA.1121.00107,2,123573,131895,-,8322
175,BUMA.1121.00088,2,486545,494868,+,8323
175,BUMA.1121.00047,2,1473084,1481407,+,8323
175,BUMA.1121.00019,2,434143,442466,+,8323
175,BUMA.1121.00087,2,2077453,2085775,-,8322
175,BUMA.1121.00039,2,271125,279447,-,8322
175,BUMA.1121.00030,2,1679246,1687568,-,8322
175,BUMA.1121.00016,2,43952,52274,-,8322
175,BUMA.1121.00092,2,554692,563015,+,8323
175,BUMA.1121.00003,2,1917750,1926073,+,8323
175,BUMA.1121.00105,2,1971023,1979345,-,8322
175,BUMA.1121.00053,2,773960,782283,+,8323
175,BUMA.1121.00057,2,1538461,1546783,-,8322
175,BUMA.1121.00108,2,771571,779894,+,8323
175,BUMA.1121.00104,2,638328,646651,+,8323
175,BUMA.1121.00014,2,575232,583564,+,8332
175,BUMA.1121.00036,2,2130282,2138605,+,8323
175,BUMA.1121.00098,2,743564,751887,+,8323
175,BUMA.1121.00078,2,2674685,2683007,-,8322
175,BUMA.1121.00029,2,829982,838304,-,8322
175,BUMA.1121.00099,2,746812,755135,+,8323
175,BUMA.1121.00103,2,2401779,2410102,+,8323
175,BUMA.1121.00102,2,536803,545126,+,8323
175,BUMA.1121.00028,2,434158,442481,+,8323
175,BUMA.1121.00075,2,2309740,2318062,-,8322
175,BUMA.1121.00044,2,485348,493671,+,8323
175,BUMA.1121.00076,2,1427630,1435953,+,8323
175,BUMA.1121.00074,2,449141,457463,-,8322
175,BUMA.1121.00073,2,521784,530107,+,8323
175,BUMA.1121.00083,2,2346896,2355219,+,8323
175,BUMA.1121.00035,2,912517,920839,-,8322
175,BUMA.1121.00072,2,518179,526502,+,8323
175,BUMA.1121.00056,2,352496,360818,-,8322
175,BUMA.1121.00033,2,1221526,1229848,+,8322
175,BUMA.1121.00061,2,511702,520025,+,8323
175,BUMA.1121.00062,2,1230658,1238980,-,8322
175,BUMA.1121.00064,2,457551,465874,+,8323
175,BUMA.1121.00060,2,1705741,1714063,-,8322
175,BUMA.1121.00069,2,519726,528049,+,8323
175,BUMA.1121.00070,2,521875,530198,+,8323
175,BUMA.1121.00068,2,2249382,2257705,+,8323
175,BUMA.1121.00067,2,269935,278257,-,8322
175,BUMA.1121.00037,2,847646,855969,+,8323
175,BUMA.1121.00065,2,534718,543041,+,8323
175,BUMA.1121.00058,2,1093564,1101887,+,8323
175,BUMA.1121.00041,2,1450526,1458849,+,8323
175,BUMA.1121.00084,2,2369849,2378172,+,8323
175,BUMA.1121.00096,2,704124,712447,+,8323
175,BUMA.1121.00080,2,543848,552171,+,8323
175,BUMA.1121.00013,2,2014167,2022489,-,8322
175,BUMA.1121.00100,2,1648699,1657022,+,8323
175,BUMA.1121.00012,2,1214831,1223153,-,8322
175,BUMA.1121.00018,2,177794,186116,-,8322
175,BUMA.1121.00106,2,2947626,2955949,+,8323
175,BUMA.1121.00017,2,434198,442521,+,8323
175,BUMA.1121.00082,2,549939,558262,+,8323
174,BUMA.1121.00049,2,2329106,2334045,+,4939
174,BUMA.1121.00068,2,2229647,2234587,+,4940
173,BUMA.1121.00049,2,2317872,2326650,+,8778
173,BUMA.1121.00055,2,2123983,2132760,-,8777
173,BUMA.1121.00011,2,2328106,2336884,+,8778
173,BUMA.1121.00110,2,376369,385147,+,8778
173,BUMA.1121.00077,2,3231449,3240224,-,8775
173,BUMA.1121.00027,2,1559437,1568214,+,8777
173,BUMA.1121.00026,2,914922,923689,+,8767
173,BUMA.1121.00021,2,969377,978155,+,8778
173,BUMA.1121.00023,2,561981,570759,+,8778
173,BUMA.1121.00022,2,1182873,1191639,-,8766
173,BUMA.1121.00034,2,329602,338369,+,8767
173,BUMA.1121.00025,2,2128699,2137477,+,8778
173,BUMA.1121.00031,2,2845325,2854103,+,8778
173,BUMA.1121.00007,2,519764,528537,+,8773
173,BUMA.1121.00097,2,305223,313991,+,8768
173,BUMA.1121.00008,2,329446,338213,+,8767
173,BUMA.1121.00059,2,3139603,3148380,-,8777
173,BUMA.1121.00002,2,926054,934821,+,8767
173,BUMA.1121.00004,2,329574,338341,+,8767
173,BUMA.1121.00005,2,211707,220478,-,8771
173,BUMA.1121.00109,1,535386,544163,-,8777
173,BUMA.1121.00111,2,2947430,2956208,+,8778
173,BUMA.1121.00006,2,352977,361744,+,8767
173,BUMA.1121.00009,2,2358191,2366967,+,8776
173,BUMA.1121.00094,2,506396,515168,+,8772
173,BUMA.1121.00101,2,2943942,2952719,-,8777
173,BUMA.1121.00066,2,505062,513833,+,8771
173,BUMA.1121.00095,2,2565932,2574710,+,8778
173,BUMA.1121.00112,2,641265,650042,-,8777
173,BUMA.1121.00042,2,2094942,2103709,+,8767
173,BUMA.1121.00032,2,753915,762682,+,8767
173,BUMA.1121.00090,2,1409826,1418604,+,8778
173,BUMA.1121.00020,2,329549,338316,+,8767
173,BUMA.1121.00089,2,507520,516298,+,8778
173,BUMA.1121.00051,2,507775,516546,+,8771
173,BUMA.1121.00001,2,1746421,1755198,-,8777
173,BUMA.1121.00045,2,356575,365352,+,8777
173,BUMA.1121.00043,2,1927323,1936100,-,8777
173,BUMA.1121.00063,2,498175,506953,+,8778
173,BUMA.1121.00079,2,508075,516846,+,8771
173,BUMA.1121.00071,2,499007,507778,+,8771
173,BUMA.1121.00086,2,1990749,1999515,-,8766
173,BUMA.1121.00024,2,329446,338213,+,8767
173,BUMA.1121.00010,2,1779495,1788262,+,8767
173,BUMA.1121.00040,2,1827244,1836010,-,8766
173,BUMA.1121.00093,2,2428611,2437388,-,8777
173,BUMA.1121.00091,2,3174846,3183623,-,8777
173,BUMA.1121.00107,2,146323,155100,-,8777
173,BUMA.1121.00088,2,459227,468005,+,8778
173,BUMA.1121.00047,2,1438252,1447024,+,8772
173,BUMA.1121.00019,2,329513,338280,+,8767
173,BUMA.1121.00087,2,955688,964455,+,8767
173,BUMA.1121.00039,2,288326,297103,-,8777
173,BUMA.1121.00030,2,1783430,1792196,-,8766
173,BUMA.1121.00016,2,88685,97462,-,8777
173,BUMA.1121.00092,2,507509,516287,+,8778
173,BUMA.1121.00085,2,803685,812451,-,8766
173,BUMA.1121.00046,2,654663,663429,-,8766
173,BUMA.1121.00003,2,1893354,1902143,+,8789
173,BUMA.1121.00054,2,153136,161903,+,8767
173,BUMA.1121.00015,2,2129552,2138318,-,8766
173,BUMA.1121.00105,2,1993758,2002535,-,8777
173,BUMA.1121.00052,2,1492236,1501002,-,8766
173,BUMA.1121.00053,2,736969,745747,+,8778
173,BUMA.1121.00057,2,1580191,1588968,-,8777
173,BUMA.1121.00108,2,748351,757123,+,8772
173,BUMA.1121.00050,2,450137,458904,+,8767
173,BUMA.1121.00104,2,614821,623599,+,8778
173,BUMA.1121.00014,2,513107,521885,+,8778
173,BUMA.1121.00036,2,1949364,1958131,+,8767
173,BUMA.1121.00038,2,353011,361778,+,8767
173,BUMA.1121.00098,2,716483,725261,+,8778
173,BUMA.1121.00078,2,2711224,2720010,-,8786
173,BUMA.1121.00029,2,857024,865801,-,8777
173,BUMA.1121.00099,2,649983,658754,+,8771
173,BUMA.1121.00103,2,2378575,2387352,+,8777
173,BUMA.1121.00102,2,511016,519803,+,8787
173,BUMA.1121.00028,2,329528,338295,+,8767
173,BUMA.1121.00075,2,2343901,2352678,-,8777
173,BUMA.1121.00044,2,380718,389485,+,8767
173,BUMA.1121.00076,2,1393014,1401792,+,8778
173,BUMA.1121.00074,2,514966,523737,-,8771
173,BUMA.1121.00073,2,498101,506879,+,8778
173,BUMA.1121.00083,2,2304713,2313491,+,8778
173,BUMA.1121.00035,2,941907,950684,-,8777
173,BUMA.1121.00072,2,497474,506252,+,8778
173,BUMA.1121.00056,2,375546,384323,-,8777
173,BUMA.1121.00081,2,1961763,1970529,-,8766
173,BUMA.1121.00033,2,1183139,1191916,+,8777
173,BUMA.1121.00061,2,488871,497649,+,8778
173,BUMA.1121.00062,2,1262438,1271215,-,8777
173,BUMA.1121.00064,2,434148,442926,+,8778
173,BUMA.1121.00060,2,1728473,1737249,-,8776
173,BUMA.1121.00069,2,497560,506338,+,8778
173,BUMA.1121.00070,2,498103,506881,+,8778
173,BUMA.1121.00068,2,2218413,2227191,+,8778
173,BUMA.1121.00067,2,292864,301641,-,8777
173,BUMA.1121.00037,2,786446,795224,+,8778
173,BUMA.1121.00065,2,509651,518428,+,8777
173,BUMA.1121.00058,2,1070377,1079155,+,8778
173,BUMA.1121.00041,2,1398194,1406972,+,8778
173,BUMA.1121.00084,2,2346350,2355122,+,8772
173,BUMA.1121.00096,2,670261,679033,+,8772
173,BUMA.1121.00080,2,507797,516569,+,8772
173,BUMA.1121.00013,2,69748,78514,-,8766
173,BUMA.1121.00100,2,1622351,1631129,+,8778
173,BUMA.1121.00012,2,1308118,1316895,-,8777
173,BUMA.1121.00018,2,195551,204328,-,8777
173,BUMA.1121.00048,2,375803,384569,-,8766
173,BUMA.1121.00106,2,2924119,2932897,+,8778
173,BUMA.1121.00017,2,329581,338348,+,8767
173,BUMA.1121.00082,2,507756,516534,+,8778
172,BUMA.1121.00049,2,2313275,2316681,+,3406
172,BUMA.1121.00055,2,2133951,2137357,-,3406
172,BUMA.1121.00011,2,2323511,2326915,+,3404
172,BUMA.1121.00110,2,371774,375178,+,3404
172,BUMA.1121.00077,2,3241415,3244812,-,3397
172,BUMA.1121.00027,2,1554844,1558246,+,3402
172,BUMA.1121.00026,2,1108229,1111648,+,3419
172,BUMA.1121.00021,2,964782,968186,+,3404
172,BUMA.1121.00023,2,557386,560790,+,3404
172,BUMA.1121.00022,2,2260560,2263979,+,3419
172,BUMA.1121.00034,2,1390014,1393433,-,3419
172,BUMA.1121.00025,2,2124104,2127508,+,3404
172,BUMA.1121.00031,2,2840730,2844134,+,3404
172,BUMA.1121.00007,2,515167,518573,+,3406
172,BUMA.1121.00097,2,300628,304032,+,3404
172,BUMA.1121.00008,2,1374188,1377607,-,3419
172,BUMA.1121.00059,2,3149571,3152977,-,3406
172,BUMA.1121.00002,2,1971748,1975167,-,3419
172,BUMA.1121.00004,2,1374864,1378283,-,3419
172,BUMA.1121.00005,2,221669,225074,-,3405
172,BUMA.1121.00109,1,545354,548759,-,3405
172,BUMA.1121.00111,2,2942835,2946239,+,3404
172,BUMA.1121.00006,2,680458,683877,+,3419
172,BUMA.1121.00009,2,2353596,2357000,+,3404
172,BUMA.1121.00094,2,501801,505205,+,3404
172,BUMA.1121.00101,2,2953910,2957317,-,3407
172,BUMA.1121.00066,2,500477,503871,+,3394
172,BUMA.1121.00095,2,2561337,2564741,+,3404
172,BUMA.1121.00112,2,651233,654638,-,3405
172,BUMA.1121.00042,2,1151530,1154949,-,3419
172,BUMA.1121.00032,2,1541700,1545119,-,3419
172,BUMA.1121.00090,2,1405231,1408635,+,3404
172,BUMA.1121.00020,2,1374950,1378369,-,3419
172,BUMA.1121.00089,2,502925,506329,+,3404
172,BUMA.1121.00051,2,503180,506584,+,3404
172,BUMA.1121.00001,2,1756389,1759794,-,3405
172,BUMA.1121.00045,2,351979,355384,+,3405
172,BUMA.1121.00043,2,1937291,1940696,-,3405
172,BUMA.1121.00063,2,493580,496984,+,3404
172,BUMA.1121.00079,2,503480,506884,+,3404
172,BUMA.1121.00071,2,494423,497816,+,3393
172,BUMA.1121.00086,2,715740,719159,+,3419
172,BUMA.1121.00024,2,1509966,1513385,-,3419
172,BUMA.1121.00010,2,730328,733747,-,3419
172,BUMA.1121.00040,2,647145,650564,+,3419
172,BUMA.1121.00093,2,2438579,2441985,-,3406
172,BUMA.1121.00091,2,3184814,3188205,-,3391
172,BUMA.1121.00107,2,156291,159697,-,3406
172,BUMA.1121.00088,2,454635,458036,+,3401
172,BUMA.1121.00047,2,1433657,1437061,+,3404
172,BUMA.1121.00019,2,1454085,1457504,-,3419
172,BUMA.1121.00087,2,2235788,2239207,-,3419
172,BUMA.1121.00039,2,298294,301698,-,3404
172,BUMA.1121.00030,2,728365,731784,+,3419
172,BUMA.1121.00016,2,98653,102057,-,3404
172,BUMA.1121.00092,2,502913,506318,+,3405
172,BUMA.1121.00046,2,332109,335528,-,3419
172,BUMA.1121.00003,2,1888757,1892162,+,3405
172,BUMA.1121.00054,2,480608,484027,+,3419
172,BUMA.1121.00015,2,1807015,1810434,-,3419
172,BUMA.1121.00105,2,2003726,2007132,-,3406
172,BUMA.1121.00053,2,732385,735778,+,3393
172,BUMA.1121.00057,2,1590159,1593564,-,3405
172,BUMA.1121.00108,2,743756,747160,+,3404
172,BUMA.1121.00050,2,778159,781578,+,3419
172,BUMA.1121.00104,2,610224,613630,+,3406
172,BUMA.1121.00014,2,508512,511916,+,3404
172,BUMA.1121.00036,2,944179,947598,-,3419
172,BUMA.1121.00038,2,680493,683912,+,3419
172,BUMA.1121.00098,2,711888,715292,+,3404
172,BUMA.1121.00078,2,2721201,2724607,-,3406
172,BUMA.1121.00029,2,866992,870397,-,3405
172,BUMA.1121.00099,2,645386,648792,+,3406
172,BUMA.1121.00103,2,2373980,2377384,+,3404
172,BUMA.1121.00102,2,506432,509825,+,3393
172,BUMA.1121.00028,2,1416175,1419594,-,3419
172,BUMA.1121.00075,2,2353869,2357275,-,3406
172,BUMA.1121.00044,2,1441114,1444533,-,3419
172,BUMA.1121.00076,2,1388418,1391823,+,3405
172,BUMA.1121.00074,2,524928,528334,-,3406
172,BUMA.1121.00073,2,493506,496910,+,3404
172,BUMA.1121.00083,2,2300118,2303522,+,3404
172,BUMA.1121.00035,2,951875,955280,-,3405
172,BUMA.1121.00072,2,492889,496283,+,3394
172,BUMA.1121.00056,2,385514,388919,-,3405
172,BUMA.1121.00081,2,1639638,1643057,-,3419
172,BUMA.1121.00033,2,1178545,1181948,+,3403
172,BUMA.1121.00061,2,484276,487680,+,3404
172,BUMA.1121.00062,2,1272406,1275812,-,3406
172,BUMA.1121.00064,2,429552,432957,+,3405
172,BUMA.1121.00060,2,1738440,1741846,-,3406
172,BUMA.1121.00069,2,492976,496369,+,3393
172,BUMA.1121.00070,2,493508,496912,+,3404
172,BUMA.1121.00068,2,2213817,2217221,+,3404
172,BUMA.1121.00067,2,302832,306238,-,3406
172,BUMA.1121.00037,2,781851,785255,+,3404
172,BUMA.1121.00065,2,505054,508460,+,3406
172,BUMA.1121.00058,2,1065781,1069186,+,3405
172,BUMA.1121.00041,2,1393609,1397003,+,3394
172,BUMA.1121.00084,2,2341753,2345159,+,3406
172,BUMA.1121.00096,2,665666,669070,+,3404
172,BUMA.1121.00080,2,503202,506606,+,3404
172,BUMA.1121.00013,2,1146246,1149665,+,3419
172,BUMA.1121.00100,2,1617755,1621159,+,3404
172,BUMA.1121.00012,2,1318086,1321491,-,3405
172,BUMA.1121.00018,2,205519,208924,-,3405
172,BUMA.1121.00048,2,53631,57050,-,3419
172,BUMA.1121.00106,2,2919522,2922928,+,3406
172,BUMA.1121.00017,2,1390007,1393426,-,3419
172,BUMA.1121.00082,2,503161,506565,+,3404
171,BUMA.1121.00049,2,2306274,2313191,+,6917
171,BUMA.1121.00055,2,2137441,2144360,-,6919
171,BUMA.1121.00011,2,2316507,2323427,+,6920
171,BUMA.1121.00110,2,364770,371690,+,6920
171,BUMA.1121.00077,2,3244902,3251819,-,6917
171,BUMA.1121.00027,2,1547845,1554760,+,6915
171,BUMA.1121.00026,2,1261652,1268569,+,6917
171,BUMA.1121.00021,2,957781,964698,+,6917
171,BUMA.1121.00023,2,550385,557302,+,6917
171,BUMA.1121.00022,2,56433,63351,-,6918
171,BUMA.1121.00034,2,552865,559781,+,6916
171,BUMA.1121.00025,2,2117103,2124020,+,6917
171,BUMA.1121.00031,2,2833729,2840646,+,6917
171,BUMA.1121.00007,2,508163,515083,+,6920
171,BUMA.1121.00097,2,293626,300544,+,6918
171,BUMA.1121.00008,2,642789,649705,+,6916
171,BUMA.1121.00059,2,3153061,3159977,-,6916
171,BUMA.1121.00002,2,1101450,1108366,-,6916
171,BUMA.1121.00004,2,643516,650432,+,6916
171,BUMA.1121.00005,2,225158,232074,-,6916
171,BUMA.1121.00109,1,548843,555762,-,6919
171,BUMA.1121.00111,2,2935834,2942751,+,6917
171,BUMA.1121.00006,2,1415650,1422567,-,6917
171,BUMA.1121.00009,2,2346592,2353512,+,6920
171,BUMA.1121.00094,2,494797,501717,+,6920
171,BUMA.1121.00101,2,2957401,2964317,-,6916
171,BUMA.1121.00066,2,493473,500393,+,6920
171,BUMA.1121.00095,2,2554334,2561254,+,6920
171,BUMA.1121.00112,2,654722,661639,-,6917
171,BUMA.1121.00042,2,993082,1000000,-,6918
171,BUMA.1121.00032,2,1045425,1052341,+,6916
171,BUMA.1121.00090,2,1398230,1405147,+,6917
171,BUMA.1121.00020,2,643523,650439,+,6916
171,BUMA.1121.00089,2,495921,502841,+,6920
171,BUMA.1121.00051,2,496176,503096,+,6920
171,BUMA.1121.00001,2,1759878,1766794,-,6916
171,BUMA.1121.00045,2,344975,351895,+,6920
171,BUMA.1121.00043,2,1940780,1947696,-,6916
171,BUMA.1121.00063,2,486576,493496,+,6920
171,BUMA.1121.00079,2,496477,503396,+,6919
171,BUMA.1121.00071,2,487419,494339,+,6920
171,BUMA.1121.00086,2,863718,870636,-,6918
171,BUMA.1121.00024,2,578867,585783,+,6916
171,BUMA.1121.00010,2,1957346,1964264,-,6918
171,BUMA.1121.00040,2,1336636,1343554,-,6918
171,BUMA.1121.00093,2,2442069,2448985,-,6916
171,BUMA.1121.00091,2,3188292,3195208,-,6916
171,BUMA.1121.00107,2,159781,166697,-,6916
171,BUMA.1121.00088,2,447631,454548,+,6917
171,BUMA.1121.00047,2,1426653,1433573,+,6920
171,BUMA.1121.00019,2,643494,650410,+,6916
171,BUMA.1121.00087,2,1131138,1138056,-,6918
171,BUMA.1121.00039,2,301782,308698,-,6916
171,BUMA.1121.00030,2,1562019,1568935,-,6916
171,BUMA.1121.00016,2,102141,109056,-,6915
171,BUMA.1121.00092,2,495912,502829,+,6917
171,BUMA.1121.00085,2,1709840,1716757,+,6917
171,BUMA.1121.00003,2,1881757,1888673,+,6916
171,BUMA.1121.00054,2,1215769,1222686,-,6917
171,BUMA.1121.00015,2,802017,808934,+,6917
171,BUMA.1121.00105,2,2007216,2014135,-,6919
171,BUMA.1121.00052,2,663486,670403,+,6917
171,BUMA.1121.00053,2,725382,732301,+,6919
171,BUMA.1121.00057,2,1593648,1600567,-,6919
171,BUMA.1121.00108,2,736752,743672,+,6920
171,BUMA.1121.00050,2,1165478,1172395,+,6917
171,BUMA.1121.00104,2,603223,610140,+,6917
171,BUMA.1121.00014,2,501511,508428,+,6917
171,BUMA.1121.00036,2,792684,799603,+,6919
171,BUMA.1121.00038,2,1316816,1323733,-,6917
171,BUMA.1121.00098,2,704884,711804,+,6920
171,BUMA.1121.00078,2,2724691,2731607,-,6916
171,BUMA.1121.00029,2,870481,877397,-,6916
171,BUMA.1121.00099,2,638383,645302,+,6919
171,BUMA.1121.00103,2,2366976,2373896,+,6920
171,BUMA.1121.00102,2,499432,506348,+,6916
171,BUMA.1121.00028,2,578962,585878,+,6916
171,BUMA.1121.00075,2,2357359,2364275,-,6916
171,BUMA.1121.00044,2,603979,610895,+,6916
171,BUMA.1121.00076,2,1381417,1388334,+,6917
171,BUMA.1121.00074,2,528418,535334,-,6916
171,BUMA.1121.00073,2,486502,493422,+,6920
171,BUMA.1121.00083,2,2293114,2300034,+,6920
171,BUMA.1121.00035,2,955364,962280,-,6916
171,BUMA.1121.00072,2,485885,492805,+,6920
171,BUMA.1121.00056,2,389003,395922,-,6919
171,BUMA.1121.00081,2,900967,907884,+,6917
171,BUMA.1121.00033,2,1171544,1178461,+,6917
171,BUMA.1121.00061,2,477272,484192,+,6920
171,BUMA.1121.00062,2,1275896,1282812,-,6916
171,BUMA.1121.00064,2,422551,429468,+,6917
171,BUMA.1121.00060,2,1741930,1748849,-,6919
171,BUMA.1121.00069,2,485972,492892,+,6920
171,BUMA.1121.00070,2,486504,493424,+,6920
171,BUMA.1121.00068,2,2206817,2213733,+,6916
171,BUMA.1121.00067,2,306322,313238,-,6916
171,BUMA.1121.00037,2,774850,781767,+,6917
171,BUMA.1121.00065,2,498050,504970,+,6920
171,BUMA.1121.00058,2,1058780,1065697,+,6917
171,BUMA.1121.00041,2,1386605,1393525,+,6920
171,BUMA.1121.00084,2,2334752,2341669,+,6917
171,BUMA.1121.00096,2,658663,665582,+,6919
171,BUMA.1121.00080,2,496198,503118,+,6920
171,BUMA.1121.00013,2,1390658,1397576,-,6918
171,BUMA.1121.00100,2,1610751,1617671,+,6920
171,BUMA.1121.00012,2,1321575,1328489,-,6914
171,BUMA.1121.00018,2,209008,215924,-,6916
171,BUMA.1121.00048,2,1640331,1647248,+,6917
171,BUMA.1121.00106,2,2912521,2919438,+,6917
171,BUMA.1121.00017,2,552830,559746,+,6916
171,BUMA.1121.00082,2,496157,503077,+,6920
170,BUMA.1121.00049,2,2290990,2294947,+,3957
170,BUMA.1121.00055,2,2155642,2159599,-,3957
170,BUMA.1121.00011,2,2300039,2303996,+,3957
170,BUMA.1121.00110,2,349475,353432,+,3957
170,BUMA.1121.00109,2,980931,984890,-,3959
170,BUMA.1121.00077,2,5935,9892,-,3957
170,BUMA.1121.00027,2,1532605,1536562,+,3957
170,BUMA.1121.00026,2,1242698,1246666,+,3968
170,BUMA.1121.00021,2,942543,946501,+,3958
170,BUMA.1121.00023,2,535147,539105,+,3958
170,BUMA.1121.00022,2,45239,49207,+,3968
170,BUMA.1121.00034,2,533911,537879,+,3968
170,BUMA.1121.00025,2,2101896,2105854,+,3958
170,BUMA.1121.00031,2,2818493,2822451,+,3958
170,BUMA.1121.00007,2,491285,495242,+,3957
170,BUMA.1121.00097,2,278341,282298,+,3957
170,BUMA.1121.00008,2,624413,628381,+,3968
170,BUMA.1121.00059,2,3172478,3176440,-,3962
170,BUMA.1121.00004,2,624562,628530,+,3968
170,BUMA.1121.00005,2,243362,247320,-,3958
170,BUMA.1121.00111,2,2920596,2924554,+,3958
170,BUMA.1121.00006,2,1437553,1441521,-,3968
170,BUMA.1121.00009,2,2330125,2334069,+,3944
170,BUMA.1121.00094,2,479563,483528,+,3965
170,BUMA.1121.00101,2,2975610,2979568,-,3958
170,BUMA.1121.00066,2,478227,482185,+,3958
170,BUMA.1121.00095,2,2539100,2543057,+,3957
170,BUMA.1121.00112,2,672923,676880,-,3957
170,BUMA.1121.00042,2,1016526,1020494,-,3968
170,BUMA.1121.00090,2,1382993,1386951,+,3958
170,BUMA.1121.00020,2,624569,628537,+,3968
170,BUMA.1121.00089,2,480692,484657,+,3965
170,BUMA.1121.00051,2,480908,484873,+,3965
170,BUMA.1121.00001,2,1778043,1782001,-,3958
170,BUMA.1121.00045,2,329724,333681,+,3957
170,BUMA.1121.00043,2,1958941,1962899,-,3958
170,BUMA.1121.00063,2,471330,475288,+,3958
170,BUMA.1121.00079,2,481248,485213,+,3965
170,BUMA.1121.00071,2,472174,476132,+,3958
170,BUMA.1121.00086,2,852521,856489,+,3968
170,BUMA.1121.00024,2,559913,563881,+,3968
170,BUMA.1121.00040,2,1358538,1362506,-,3968
170,BUMA.1121.00093,2,2460313,2464270,-,3957
170,BUMA.1121.00091,2,3206491,3210448,-,3957
170,BUMA.1121.00107,2,179623,183580,-,3957
170,BUMA.1121.00088,2,432341,436303,+,3962
170,BUMA.1121.00047,2,1411424,1415389,+,3965
170,BUMA.1121.00019,2,624540,628508,+,3968
170,BUMA.1121.00087,2,2098457,2102425,-,3968
170,BUMA.1121.00039,2,319943,323900,-,3957
170,BUMA.1121.00030,2,1583921,1587889,-,3968
170,BUMA.1121.00016,2,120332,124290,-,3958
170,BUMA.1121.00092,2,480666,484623,+,3957
170,BUMA.1121.00085,2,1730983,1734922,+,3939
170,BUMA.1121.00003,2,1866478,1870431,+,3953
170,BUMA.1121.00054,2,1237672,1241640,-,3968
170,BUMA.1121.00015,2,1618980,1622948,-,3968
170,BUMA.1121.00105,2,2025447,2029404,-,3957
170,BUMA.1121.00052,2,684629,688597,+,3968
170,BUMA.1121.00053,2,710151,714108,+,3957
170,BUMA.1121.00057,2,1611831,1615795,-,3964
170,BUMA.1121.00108,2,718682,722641,+,3959
170,BUMA.1121.00050,2,1148361,1152329,+,3968
170,BUMA.1121.00104,2,586344,590306,+,3962
170,BUMA.1121.00014,2,486272,490230,+,3958
170,BUMA.1121.00036,2,806827,810795,-,3968
170,BUMA.1121.00038,2,1338719,1342687,-,3968
170,BUMA.1121.00098,2,689606,693563,+,3957
170,BUMA.1121.00078,2,2742880,2746842,-,3962
170,BUMA.1121.00029,2,888646,892604,-,3958
170,BUMA.1121.00099,2,623131,627088,+,3957
170,BUMA.1121.00103,2,2351693,2355651,+,3958
170,BUMA.1121.00102,2,482848,486805,+,3957
170,BUMA.1121.00028,2,560008,563976,+,3968
170,BUMA.1121.00075,2,2375595,2379557,-,3962
170,BUMA.1121.00044,2,585026,588994,+,3968
170,BUMA.1121.00076,2,1366132,1370094,+,3962
170,BUMA.1121.00074,2,764638,768595,-,3957
170,BUMA.1121.00073,2,471256,475214,+,3958
170,BUMA.1121.00083,2,2277868,2281826,+,3958
170,BUMA.1121.00035,2,973559,977517,-,3958
170,BUMA.1121.00072,2,470639,474597,+,3958
170,BUMA.1121.00056,2,407226,411190,-,3964
170,BUMA.1121.00081,2,882013,885981,+,3968
170,BUMA.1121.00033,2,1156308,1160265,+,3957
170,BUMA.1121.00061,2,462026,465984,+,3958
170,BUMA.1121.00062,2,1294140,1298097,-,3957
170,BUMA.1121.00064,2,407264,411221,+,3957
170,BUMA.1121.00060,2,1760143,1764100,-,3957
170,BUMA.1121.00069,2,470727,474684,+,3957
170,BUMA.1121.00070,2,471258,475216,+,3958
170,BUMA.1121.00068,2,2191523,2195480,+,3957
170,BUMA.1121.00067,2,324568,328525,-,3957
170,BUMA.1121.00037,2,759663,763570,+,3907
170,BUMA.1121.00065,2,482793,486750,+,3957
170,BUMA.1121.00058,2,1043495,1047452,+,3957
170,BUMA.1121.00041,2,1371365,1375322,+,3957
170,BUMA.1121.00084,2,2319462,2323424,+,3962
170,BUMA.1121.00096,2,642151,646095,+,3944
170,BUMA.1121.00080,2,480969,484934,+,3965
170,BUMA.1121.00013,2,1379461,1383429,+,3968
170,BUMA.1121.00100,2,1595468,1599421,+,3953
170,BUMA.1121.00012,2,1341146,1345104,-,3958
170,BUMA.1121.00018,2,227172,231130,-,3958
170,BUMA.1121.00048,2,1621379,1625347,+,3968
170,BUMA.1121.00106,2,2895637,2899599,+,3962
170,BUMA.1121.00017,2,533877,537845,+,3968
170,BUMA.1121.00082,2,480911,484869,+,3958
169,BUMA.1121.00049,2,2281281,2289758,+,8477
169,BUMA.1121.00055,2,2160831,2169317,-,8486
169,BUMA.1121.00011,2,2290325,2298807,+,8482
169,BUMA.1121.00110,2,339761,348243,+,8482
169,BUMA.1121.00109,2,986122,994598,-,8476
169,BUMA.1121.00077,2,11124,19606,-,8482
169,BUMA.1121.00027,2,1522897,1531373,+,8476
169,BUMA.1121.00026,2,1233011,1241466,+,8455
169,BUMA.1121.00021,2,932835,941311,+,8476
169,BUMA.1121.00023,2,525448,533915,+,8467
169,BUMA.1121.00022,2,35532,44007,+,8475
169,BUMA.1121.00034,2,524204,532679,+,8475
169,BUMA.1121.00025,2,2092197,2100664,+,8467
169,BUMA.1121.00031,2,2808785,2817261,+,8476
169,BUMA.1121.00007,2,481560,490053,+,8493
169,BUMA.1121.00097,2,268624,277109,+,8485
169,BUMA.1121.00008,2,614706,623181,+,8475
169,BUMA.1121.00059,2,1232,9709,-,8477
169,BUMA.1121.00004,2,614855,623330,+,8475
169,BUMA.1121.00005,2,248552,257037,-,8485
169,BUMA.1121.00111,2,2910888,2919364,+,8476
169,BUMA.1121.00006,2,1442753,1451081,-,8328
169,BUMA.1121.00009,2,2320401,2328893,+,8492
169,BUMA.1121.00094,2,469855,478331,+,8476
169,BUMA.1121.00101,2,2980793,2989275,-,8482
169,BUMA.1121.00066,2,468519,476995,+,8476
169,BUMA.1121.00095,2,2529375,2537868,+,8493
169,BUMA.1121.00112,2,678105,686587,-,8482
169,BUMA.1121.00042,2,1021726,1030211,-,8485
169,BUMA.1121.00090,2,1373285,1381761,+,8476
169,BUMA.1121.00020,2,614862,623337,+,8475
169,BUMA.1121.00089,2,470984,479460,+,8476
169,BUMA.1121.00051,2,471201,479676,+,8475
169,BUMA.1121.00001,2,1783233,1791709,-,8476
169,BUMA.1121.00045,2,320016,328492,+,8476
169,BUMA.1121.00043,2,1964131,1972598,-,8467
169,BUMA.1121.00063,2,461622,470098,+,8476
169,BUMA.1121.00079,2,471541,480016,+,8475
169,BUMA.1121.00071,2,462466,470942,+,8476
169,BUMA.1121.00086,2,842814,851289,+,8475
169,BUMA.1121.00024,2,550206,558681,+,8475
169,BUMA.1121.00040,2,1365352,1373803,-,8451
169,BUMA.1121.00093,2,2465502,2473977,-,8475
169,BUMA.1121.00091,2,3211680,3220147,-,8467
169,BUMA.1121.00107,2,184812,193289,-,8477
169,BUMA.1121.00088,2,422634,431109,+,8475
169,BUMA.1121.00047,2,1401715,1410192,+,8477
169,BUMA.1121.00019,2,614833,623308,+,8475
169,BUMA.1121.00087,2,2103657,2112133,-,8476
169,BUMA.1121.00039,2,325132,333609,-,8477
169,BUMA.1121.00030,2,1589121,1597597,-,8476
169,BUMA.1121.00016,2,125522,133999,-,8477
169,BUMA.1121.00092,2,470960,479434,+,8474
169,BUMA.1121.00085,2,1721424,1729751,+,8327
169,BUMA.1121.00003,2,1856912,1865246,+,8334
169,BUMA.1121.00054,2,1242872,1251200,-,8328
169,BUMA.1121.00015,2,1624180,1632508,-,8328
169,BUMA.1121.00105,2,2030636,2039113,-,8477
169,BUMA.1121.00052,2,675070,683397,+,8327
169,BUMA.1121.00053,2,700460,708934,+,8474
169,BUMA.1121.00057,2,1617027,1625503,-,8476
169,BUMA.1121.00108,2,708956,717450,+,8494
169,BUMA.1121.00050,2,1138802,1147129,+,8327
169,BUMA.1121.00104,2,576636,585112,+,8476
169,BUMA.1121.00014,2,476564,485040,+,8476
169,BUMA.1121.00036,2,812027,820503,-,8476
169,BUMA.1121.00038,2,1343919,1352247,-,8328
169,BUMA.1121.00098,2,679883,688374,+,8491
169,BUMA.1121.00078,2,2748074,2756551,-,8477
169,BUMA.1121.00029,2,893836,902312,-,8476
169,BUMA.1121.00099,2,613415,621899,+,8484
169,BUMA.1121.00103,2,2341987,2350461,+,8474
169,BUMA.1121.00102,2,473142,481616,+,8474
169,BUMA.1121.00028,2,550301,558776,+,8475
169,BUMA.1121.00075,2,2380789,2389263,-,8474
169,BUMA.1121.00044,2,575320,583794,+,8474
169,BUMA.1121.00076,2,1356427,1364900,+,8473
169,BUMA.1121.00074,2,769827,778305,-,8478
169,BUMA.1121.00073,2,461548,470024,+,8476
169,BUMA.1121.00083,2,2268160,2276636,+,8476
169,BUMA.1121.00035,2,978749,987225,-,8476
169,BUMA.1121.00072,2,460931,469407,+,8476
169,BUMA.1121.00056,2,412422,420899,-,8477
169,BUMA.1121.00081,2,872454,880781,+,8327
169,BUMA.1121.00033,2,1146601,1155076,+,8475
169,BUMA.1121.00061,2,452318,460794,+,8476
169,BUMA.1121.00062,2,1299329,1307815,-,8486
169,BUMA.1121.00064,2,397557,406032,+,8475
169,BUMA.1121.00060,2,1765332,1773809,-,8477
169,BUMA.1121.00069,2,461019,469495,+,8476
169,BUMA.1121.00070,2,461550,470026,+,8476
169,BUMA.1121.00068,2,2181840,2190291,+,8451
169,BUMA.1121.00067,2,329757,338235,-,8478
169,BUMA.1121.00037,2,749984,758408,+,8424
169,BUMA.1121.00065,2,473086,481561,+,8475
169,BUMA.1121.00058,2,1033786,1042263,+,8477
169,BUMA.1121.00041,2,1361657,1370133,+,8476
169,BUMA.1121.00084,2,2309754,2318230,+,8476
169,BUMA.1121.00096,2,632423,640919,+,8496
169,BUMA.1121.00080,2,471263,479737,+,8474
169,BUMA.1121.00013,2,1369902,1378229,+,8327
169,BUMA.1121.00100,2,1585754,1594236,+,8482
169,BUMA.1121.00012,2,1346336,1354812,-,8476
169,BUMA.1121.00018,2,232362,240830,-,8468
169,BUMA.1121.00048,2,1611820,1620147,+,8327
169,BUMA.1121.00106,2,2885929,2894405,+,8476
169,BUMA.1121.00017,2,524170,532645,+,8475
169,BUMA.1121.00082,2,471203,479679,+,8476
168,BUMA.1121.00049,2,2270125,2279415,+,9290
168,BUMA.1121.00055,2,2171195,2180528,-,9333
168,BUMA.1121.00011,2,2279084,2288434,+,9350
168,BUMA.1121.00110,2,328570,337908,+,9338
168,BUMA.1121.00109,2,996451,1005784,-,9333
168,BUMA.1121.00077,2,21459,30797,-,9338
168,BUMA.1121.00027,2,1511748,1521021,+,9273
168,BUMA.1121.00026,2,1221877,1231109,+,9232
168,BUMA.1121.00021,2,921627,930959,+,9332
168,BUMA.1121.00023,2,514242,523565,+,9323
168,BUMA.1121.00022,2,23158,32390,+,9232
168,BUMA.1121.00034,2,1270371,1279603,-,9232
168,BUMA.1121.00025,2,2080990,2090320,+,9330
168,BUMA.1121.00031,2,2797577,2806909,+,9332
168,BUMA.1121.00007,2,470348,479677,+,9329
168,BUMA.1121.00097,2,257465,266740,+,9275
168,BUMA.1121.00008,2,1254546,1263778,-,9232
168,BUMA.1121.00059,2,11574,20876,-,9302
168,BUMA.1121.00004,2,1255231,1264463,-,9232
168,BUMA.1121.00005,2,258968,268292,-,9324
168,BUMA.1121.00111,2,2899680,2909012,+,9332
168,BUMA.1121.00006,2,795023,804255,+,9232
168,BUMA.1121.00009,2,2309165,2318522,+,9357
168,BUMA.1121.00094,2,458639,467971,+,9332
168,BUMA.1121.00101,2,2991152,3000478,-,9326
168,BUMA.1121.00066,2,457369,466642,+,9273
168,BUMA.1121.00095,2,2518156,2527498,+,9342
168,BUMA.1121.00112,2,688484,697811,-,9327
168,BUMA.1121.00042,2,1032113,1041345,-,9232
168,BUMA.1121.00090,2,1362077,1371409,+,9332
168,BUMA.1121.00020,2,1255307,1264539,-,9232
168,BUMA.1121.00089,2,459768,469100,+,9332
168,BUMA.1121.00051,2,460027,469317,+,9290
168,BUMA.1121.00001,2,1793585,1802865,-,9280
168,BUMA.1121.00045,2,308795,318145,+,9350
168,BUMA.1121.00043,2,1974474,1983804,-,9330
168,BUMA.1121.00063,2,450472,459745,+,9273
168,BUMA.1121.00079,2,460367,469657,+,9290
168,BUMA.1121.00071,2,451315,460589,+,9274
168,BUMA.1121.00086,2,830431,839672,+,9241
168,BUMA.1121.00024,2,1390323,1399555,-,9232
168,BUMA.1121.00040,2,761555,770787,+,9232
168,BUMA.1121.00093,2,2475843,2485124,-,9281
168,BUMA.1121.00091,2,3222065,3231356,-,9291
168,BUMA.1121.00107,2,195154,204487,-,9333
168,BUMA.1121.00088,2,411454,420757,+,9303
168,BUMA.1121.00047,2,1390499,1399831,+,9332
168,BUMA.1121.00019,2,1334442,1343674,-,9232
168,BUMA.1121.00087,2,2115275,2124516,-,9241
168,BUMA.1121.00039,2,335485,344817,-,9332
168,BUMA.1121.00030,2,842194,851426,+,9232
168,BUMA.1121.00016,2,135875,145207,-,9332
168,BUMA.1121.00092,2,459813,469094,+,9281
168,BUMA.1121.00046,2,222818,232050,-,9232
168,BUMA.1121.00003,2,1845613,1854953,+,9340
168,BUMA.1121.00054,2,595171,604403,+,9232
168,BUMA.1121.00015,2,1697782,1707014,-,9232
168,BUMA.1121.00105,2,2040990,2050323,-,9333
168,BUMA.1121.00053,2,689288,698563,+,9275
168,BUMA.1121.00057,2,1627387,1636661,-,9274
168,BUMA.1121.00108,2,697751,707084,+,9333
168,BUMA.1121.00050,2,881637,890869,+,9232
168,BUMA.1121.00104,2,565414,574759,+,9345
168,BUMA.1121.00014,2,465371,474703,+,9332
168,BUMA.1121.00036,2,823645,832877,-,9232
168,BUMA.1121.00038,2,795058,804290,+,9232
168,BUMA.1121.00098,2,668670,678000,+,9330
168,BUMA.1121.00078,2,2758449,2767780,-,9331
168,BUMA.1121.00029,2,904188,913468,-,9280
168,BUMA.1121.00099,2,602237,611519,+,9282
168,BUMA.1121.00103,2,2330795,2340127,+,9332
168,BUMA.1121.00102,2,461970,471245,+,9275
168,BUMA.1121.00028,2,1296533,1305765,-,9232
168,BUMA.1121.00075,2,2391187,2400488,-,9301
168,BUMA.1121.00044,2,1321472,1330704,-,9232
168,BUMA.1121.00076,2,1345202,1354503,+,9301
168,BUMA.1121.00074,2,780182,789472,-,9290
168,BUMA.1121.00073,2,450397,459671,+,9274
168,BUMA.1121.00083,2,2257009,2266283,+,9274
168,BUMA.1121.00035,2,989101,998381,-,9280
168,BUMA.1121.00072,2,449780,459054,+,9274
168,BUMA.1121.00056,2,422783,432115,-,9332
168,BUMA.1121.00081,2,1519260,1528492,-,9232
168,BUMA.1121.00033,2,1135392,1144724,+,9332
168,BUMA.1121.00061,2,441167,450441,+,9274
168,BUMA.1121.00062,2,1309706,1319039,-,9333
168,BUMA.1121.00064,2,386347,395680,+,9333
168,BUMA.1121.00060,2,1775680,1785030,-,9350
168,BUMA.1121.00069,2,449870,459144,+,9274
168,BUMA.1121.00070,2,450400,459673,+,9273
168,BUMA.1121.00068,2,2170545,2179892,+,9347
168,BUMA.1121.00067,2,340112,349403,-,9291
168,BUMA.1121.00037,2,730710,739919,+,9209
168,BUMA.1121.00065,2,461917,471190,+,9273
168,BUMA.1121.00058,2,1022572,1031904,+,9332
168,BUMA.1121.00041,2,1350453,1359792,+,9339
168,BUMA.1121.00084,2,2298574,2307877,+,9303
168,BUMA.1121.00096,2,621205,630545,+,9340
168,BUMA.1121.00080,2,460089,469379,+,9290
168,BUMA.1121.00013,2,1261691,1270923,+,9232
168,BUMA.1121.00100,2,1574557,1583889,+,9332
168,BUMA.1121.00012,2,1356688,1366020,-,9332
168,BUMA.1121.00018,2,242707,252037,-,9330
168,BUMA.1121.00048,2,2258608,2267840,-,9232
168,BUMA.1121.00106,2,2874712,2884045,+,9333
168,BUMA.1121.00017,2,1270364,1279596,-,9232
168,BUMA.1121.00082,2,460052,469326,+,9274
167,BUMA.1121.00049,2,2265778,2269465,+,3687
167,BUMA.1121.00055,2,2181188,2184859,-,3671
167,BUMA.1121.00011,2,2274734,2278424,+,3690
167,BUMA.1121.00110,2,324246,327910,+,3664
167,BUMA.1121.00109,2,1006444,1010141,-,3697
167,BUMA.1121.00077,2,31457,35122,-,3665
167,BUMA.1121.00027,2,1507402,1511088,+,3686
167,BUMA.1121.00026,2,1217551,1221217,+,3666
167,BUMA.1121.00021,2,917281,920967,+,3686
167,BUMA.1121.00023,2,509898,513582,+,3684
167,BUMA.1121.00022,2,18830,22498,+,3668
167,BUMA.1121.00034,2,1280263,1283931,-,3668
167,BUMA.1121.00025,2,2076644,2080330,+,3686
167,BUMA.1121.00031,2,2793231,2796917,+,3686
167,BUMA.1121.00007,2,466004,469688,+,3684
167,BUMA.1121.00097,2,253114,256805,+,3691
167,BUMA.1121.00008,2,1264438,1268106,-,3668
167,BUMA.1121.00059,2,21536,25225,-,3689
167,BUMA.1121.00004,2,1265123,1268791,-,3668
167,BUMA.1121.00005,2,268952,272613,-,3661
167,BUMA.1121.00111,2,2895350,2899020,+,3670
167,BUMA.1121.00006,2,790695,794363,+,3668
167,BUMA.1121.00009,2,2304830,2308505,+,3675
167,BUMA.1121.00094,2,454317,457979,+,3662
167,BUMA.1121.00101,2,3001138,3004808,-,3670
167,BUMA.1121.00066,2,453049,456709,+,3660
167,BUMA.1121.00095,2,2513815,2517496,+,3681
167,BUMA.1121.00112,2,698471,702139,-,3668
167,BUMA.1121.00042,2,1042005,1045663,-,3658
167,BUMA.1121.00090,2,1357731,1361417,+,3686
167,BUMA.1121.00020,2,1265199,1268867,-,3668
167,BUMA.1121.00089,2,455446,459108,+,3662
167,BUMA.1121.00051,2,455661,459367,+,3706
167,BUMA.1121.00001,2,1803525,1807202,-,3677
167,BUMA.1121.00045,2,304455,308135,+,3680
167,BUMA.1121.00043,2,1984464,1988201,-,3737
167,BUMA.1121.00063,2,446152,449812,+,3660
167,BUMA.1121.00079,2,456020,459707,+,3687
167,BUMA.1121.00071,2,446995,450655,+,3660
167,BUMA.1121.00086,2,826103,829771,+,3668
167,BUMA.1121.00024,2,1400215,1403883,-,3668
167,BUMA.1121.00040,2,757227,760895,+,3668
167,BUMA.1121.00093,2,2485784,2489501,-,3717
167,BUMA.1121.00091,2,3232016,3235714,-,3698
167,BUMA.1121.00107,2,205147,208816,-,3669
167,BUMA.1121.00088,2,407098,410794,+,3696
167,BUMA.1121.00047,2,1386141,1389839,+,3698
167,BUMA.1121.00019,2,1344334,1348002,-,3668
167,BUMA.1121.00087,2,2125176,2128844,-,3668
167,BUMA.1121.00039,2,345477,349153,-,3676
167,BUMA.1121.00030,2,837866,841534,+,3668
167,BUMA.1121.00016,2,145867,149553,-,3686
167,BUMA.1121.00092,2,455436,459153,+,3717
167,BUMA.1121.00046,2,232710,236378,-,3668
167,BUMA.1121.00003,2,1841294,1844953,+,3659
167,BUMA.1121.00054,2,590843,594511,+,3668
167,BUMA.1121.00015,2,1707674,1711342,-,3668
167,BUMA.1121.00105,2,2050983,2054651,-,3668
167,BUMA.1121.00053,2,684940,688628,+,3688
167,BUMA.1121.00057,2,1637321,1641019,-,3698
167,BUMA.1121.00108,2,693419,697091,+,3672
167,BUMA.1121.00050,2,877309,880977,+,3668
167,BUMA.1121.00104,2,561067,564754,+,3687
167,BUMA.1121.00014,2,461024,464711,+,3687
167,BUMA.1121.00036,2,833537,837205,-,3668
167,BUMA.1121.00038,2,790730,794398,+,3668
167,BUMA.1121.00098,2,664340,668010,+,3670
167,BUMA.1121.00078,2,2768440,2772163,-,3723
167,BUMA.1121.00029,2,914128,917805,-,3677
167,BUMA.1121.00099,2,597873,601577,+,3704
167,BUMA.1121.00103,2,2326431,2330135,+,3704
167,BUMA.1121.00102,2,457605,461310,+,3705
167,BUMA.1121.00028,2,1306425,1310093,-,3668
167,BUMA.1121.00075,2,2401148,2404833,-,3685
167,BUMA.1121.00044,2,1331364,1335032,-,3668
167,BUMA.1121.00076,2,1340853,1344542,+,3689
167,BUMA.1121.00074,2,790132,793819,-,3687
167,BUMA.1121.00073,2,446077,449737,+,3660
167,BUMA.1121.00083,2,2252689,2256349,+,3660
167,BUMA.1121.00035,2,999041,1002715,-,3674
167,BUMA.1121.00072,2,445460,449120,+,3660
167,BUMA.1121.00056,2,432775,436437,-,3662
167,BUMA.1121.00081,2,1529152,1532820,-,3668
167,BUMA.1121.00033,2,1131007,1134732,+,3725
167,BUMA.1121.00061,2,436847,440507,+,3660
167,BUMA.1121.00062,2,1319699,1323404,-,3705
167,BUMA.1121.00064,2,382019,385687,+,3668
167,BUMA.1121.00060,2,1785690,1789370,-,3680
167,BUMA.1121.00069,2,445550,449210,+,3660
167,BUMA.1121.00070,2,446080,449740,+,3660
167,BUMA.1121.00068,2,2166196,2169885,+,3689
167,BUMA.1121.00067,2,350063,353749,-,3686
167,BUMA.1121.00037,2,726243,729990,+,3747
167,BUMA.1121.00065,2,457552,461257,+,3705
167,BUMA.1121.00058,2,1018232,1021912,+,3680
167,BUMA.1121.00041,2,1346087,1349793,+,3706
167,BUMA.1121.00084,2,2294256,2297914,+,3658
167,BUMA.1121.00096,2,616816,620545,+,3729
167,BUMA.1121.00080,2,455714,459429,+,3715
167,BUMA.1121.00013,2,1257363,1261031,+,3668
167,BUMA.1121.00100,2,1570217,1573897,+,3680
167,BUMA.1121.00012,2,1366680,1370350,-,3670
167,BUMA.1121.00018,2,252697,256383,-,3686
167,BUMA.1121.00048,2,2268500,2272168,-,3668
167,BUMA.1121.00106,2,2870353,2874052,+,3699
167,BUMA.1121.00017,2,1280256,1283924,-,3668
167,BUMA.1121.00082,2,455732,459392,+,3660
78,BUMA.1121.00049,2,1137764,1147470,+,9706
78,BUMA.1121.00055,2,172849,182580,-,9731
78,BUMA.1121.00011,2,1112587,1122271,+,9684
78,BUMA.1121.00110,2,2457452,2467253,+,9801
78,BUMA.1121.00109,2,2124088,2133874,-,9786
78,BUMA.1121.00077,2,1148700,1158507,-,9807
78,BUMA.1121.00027,2,413165,422952,+,9787
78,BUMA.1121.00026,2,476792,486493,+,9701
78,BUMA.1121.00021,2,2991696,3001295,+,9599
78,BUMA.1121.00023,2,2633345,2643149,+,9804
78,BUMA.1121.00022,2,1773412,1783087,-,9675
78,BUMA.1121.00034,2,1870885,1880585,+,9700
78,BUMA.1121.00025,2,1022029,1031773,+,9744
78,BUMA.1121.00031,2,1678290,1688177,+,9887
78,BUMA.1121.00007,2,2618954,2628617,+,9663
78,BUMA.1121.00097,2,2331264,2341020,+,9756
78,BUMA.1121.00008,2,1855100,1864800,+,9700
78,BUMA.1121.00059,2,1096808,1106592,-,9784
78,BUMA.1121.00002,2,333464,343152,+,9688
78,BUMA.1121.00004,2,1855553,1865253,+,9700
78,BUMA.1121.00005,2,1420593,1430330,-,9737
78,BUMA.1121.00111,2,1825579,1835389,+,9810
78,BUMA.1121.00006,2,2086720,2096413,+,9693
78,BUMA.1121.00009,2,1155141,1164869,+,9728
78,BUMA.1121.00094,2,2534526,2544341,+,9815
78,BUMA.1121.00101,2,909381,919147,-,9766
78,BUMA.1121.00066,2,2463484,2473309,+,9825
78,BUMA.1121.00095,2,1359065,1368810,+,9745
78,BUMA.1121.00112,2,1867595,1877315,-,9720
78,BUMA.1121.00042,2,1828685,1838386,-,9701
78,BUMA.1121.00032,2,295925,305632,+,9707
78,BUMA.1121.00090,2,232929,242737,+,9808
78,BUMA.1121.00020,2,1855822,1865522,+,9700
78,BUMA.1121.00089,2,2480334,2490151,+,9817
78,BUMA.1121.00051,2,2493633,2503404,+,9771
78,BUMA.1121.00001,2,2901333,2911105,-,9772
78,BUMA.1121.00045,2,2377257,2387026,+,9769
78,BUMA.1121.00043,2,3056641,3066242,-,9601
78,BUMA.1121.00063,2,2472788,2482604,+,9816
78,BUMA.1121.00079,2,2494052,2503755,+,9703
78,BUMA.1121.00071,2,2479604,2489430,+,9826
78,BUMA.1121.00086,2,228268,237956,-,9688
78,BUMA.1121.00024,2,1990754,2000454,+,9700
78,BUMA.1121.00010,2,1185492,1195180,+,9688
78,BUMA.1121.00040,2,188274,197966,-,9692
78,BUMA.1121.00093,2,432081,441792,-,9711
78,BUMA.1121.00091,2,1130698,1140535,-,9837
78,BUMA.1121.00107,2,1290617,1300554,-,9937
78,BUMA.1121.00088,2,2505140,2514854,+,9714
78,BUMA.1121.00047,2,308192,318009,+,9817
78,BUMA.1121.00019,2,1934967,1944667,+,9700
78,BUMA.1121.00087,2,365308,374996,+,9688
78,BUMA.1121.00039,2,1464030,1473825,-,9795
78,BUMA.1121.00030,2,241433,251133,-,9700
78,BUMA.1121.00016,2,1208983,1218717,-,9734
78,BUMA.1121.00092,2,2496171,2505882,+,9711
78,BUMA.1121.00085,2,1391292,1400986,-,9694
78,BUMA.1121.00046,2,1243902,1253609,-,9707
78,BUMA.1121.00003,2,738579,748219,+,9640
78,BUMA.1121.00054,2,1886833,1896526,+,9693
78,BUMA.1121.00015,2,479355,489042,-,9687
78,BUMA.1121.00105,2,3130023,3139792,-,9769
78,BUMA.1121.00052,2,344951,354645,-,9694
78,BUMA.1121.00053,2,2782140,2791867,+,9727
78,BUMA.1121.00057,2,2735906,2745693,-,9787
78,BUMA.1121.00108,2,2741704,2751507,+,9803
78,BUMA.1121.00050,2,2181537,2191244,+,9707
78,BUMA.1121.00104,2,2584784,2594519,+,9735
78,BUMA.1121.00014,2,2612952,2622819,+,9867
78,BUMA.1121.00036,2,1425284,1434965,+,9681
78,BUMA.1121.00038,2,1987935,1997628,+,9693
78,BUMA.1121.00098,2,2753908,2763770,+,9862
78,BUMA.1121.00078,2,632919,642599,-,9680
78,BUMA.1121.00029,2,2019819,2029648,-,9829
78,BUMA.1121.00099,2,2740177,2749944,+,9767
78,BUMA.1121.00103,2,1135587,1145438,+,9851
78,BUMA.1121.00102,2,2525248,2535015,+,9767
78,BUMA.1121.00028,2,1897016,1906695,+,9679
78,BUMA.1121.00075,2,336517,346251,-,9734
78,BUMA.1121.00044,2,1921768,1931468,+,9700
78,BUMA.1121.00076,2,251191,260925,+,9734
78,BUMA.1121.00074,2,1869221,1878919,-,9698
78,BUMA.1121.00073,2,2479712,2489539,+,9827
78,BUMA.1121.00083,2,1149994,1159821,+,9827
78,BUMA.1121.00035,2,2097508,2107381,-,9873
78,BUMA.1121.00072,2,2454184,2464011,+,9827
78,BUMA.1121.00056,2,1501547,1511376,-,9829
78,BUMA.1121.00081,2,227106,236799,-,9693
78,BUMA.1121.00033,2,48554,58422,+,9868
78,BUMA.1121.00061,2,2462833,2472648,+,9815
78,BUMA.1121.00062,2,2404630,2414338,-,9708
78,BUMA.1121.00064,2,2401314,2411025,+,9711
78,BUMA.1121.00060,2,2878079,2887848,-,9769
78,BUMA.1121.00069,2,2445624,2455448,+,9824
78,BUMA.1121.00070,2,2459053,2468877,+,9824
78,BUMA.1121.00068,2,1085696,1095475,+,9779
78,BUMA.1121.00067,2,1424368,1434070,-,9702
78,BUMA.1121.00037,2,2847826,2857556,+,9730
78,BUMA.1121.00065,2,2568848,2578528,+,9680
78,BUMA.1121.00058,2,3102912,3112638,+,9726
78,BUMA.1121.00041,2,226433,236145,+,9712
78,BUMA.1121.00084,2,1210048,1219749,+,9701
78,BUMA.1121.00096,2,2809705,2819368,+,9663
78,BUMA.1121.00080,2,2550080,2559856,+,9776
78,BUMA.1121.00013,2,657735,667436,-,9701
78,BUMA.1121.00100,2,524994,534705,+,9711
78,BUMA.1121.00012,2,2427103,2436934,-,9831
78,BUMA.1121.00018,2,1301160,1310904,-,9744
78,BUMA.1121.00048,2,966555,976248,-,9693
78,BUMA.1121.00106,2,1775307,1785072,+,9765
78,BUMA.1121.00017,2,1870867,1880567,+,9700
78,BUMA.1121.00082,2,2526078,2535905,+,9827
77,BUMA.1121.00049,2,1133024,1137381,+,4357
77,BUMA.1121.00055,2,182963,187454,-,4491
77,BUMA.1121.00011,2,1107710,1112204,+,4494
77,BUMA.1121.00110,2,2452493,2457069,+,4576
77,BUMA.1121.00109,2,2134257,2138740,-,4483
77,BUMA.1121.00077,2,1158890,1163458,-,4568
77,BUMA.1121.00027,2,408211,412782,+,4571
77,BUMA.1121.00026,2,471924,476409,+,4485
77,BUMA.1121.00021,2,2986876,2991313,+,4437
77,BUMA.1121.00023,2,2628479,2632962,+,4483
77,BUMA.1121.00022,2,1783470,1787928,-,4458
77,BUMA.1121.00034,2,1866036,1870502,+,4466
77,BUMA.1121.00025,2,1017289,1021646,+,4357
77,BUMA.1121.00031,2,1673548,1677907,+,4359
77,BUMA.1121.00007,2,2614042,2618571,+,4529
77,BUMA.1121.00097,2,2326334,2330881,+,4547
77,BUMA.1121.00008,2,1850272,1854717,+,4445
77,BUMA.1121.00059,2,1106975,1111331,-,4356
77,BUMA.1121.00002,2,328530,333081,+,4551
77,BUMA.1121.00004,2,1850718,1855170,+,4452
77,BUMA.1121.00005,2,1430713,1435212,-,4499
77,BUMA.1121.00111,2,1820837,1825196,+,4359
77,BUMA.1121.00006,2,2081796,2086337,+,4541
77,BUMA.1121.00009,2,1150289,1154758,+,4469
77,BUMA.1121.00094,2,2529596,2534143,+,4547
77,BUMA.1121.00101,2,919530,924021,-,4491
77,BUMA.1121.00066,2,2458601,2463101,+,4500
77,BUMA.1121.00095,2,1354175,1358682,+,4507
77,BUMA.1121.00112,2,1877698,1882090,-,4392
77,BUMA.1121.00042,2,1838769,1843274,-,4505
77,BUMA.1121.00032,2,291097,295542,+,4445
77,BUMA.1121.00090,2,228189,232546,+,4357
77,BUMA.1121.00020,2,1850973,1855439,+,4466
77,BUMA.1121.00089,2,2475404,2479951,+,4547
77,BUMA.1121.00051,2,2488752,2493250,+,4498
77,BUMA.1121.00001,2,2911488,2915844,-,4356
77,BUMA.1121.00045,2,2372389,2376874,+,4485
77,BUMA.1121.00043,2,3066625,3070973,-,4348
77,BUMA.1121.00063,2,2467905,2472405,+,4500
77,BUMA.1121.00079,2,2489312,2493669,+,4357
77,BUMA.1121.00071,2,2474721,2479221,+,4500
77,BUMA.1121.00086,2,238339,242860,-,4521
77,BUMA.1121.00024,2,1985926,1990371,+,4445
77,BUMA.1121.00010,2,1180699,1185109,+,4410
77,BUMA.1121.00040,2,198349,202818,-,4469
77,BUMA.1121.00093,2,442175,446709,-,4534
77,BUMA.1121.00091,2,1140918,1145389,-,4471
77,BUMA.1121.00107,2,1300937,1305450,-,4513
77,BUMA.1121.00088,2,2500398,2504757,+,4359
77,BUMA.1121.00047,2,303213,307809,+,4596
77,BUMA.1121.00019,2,1930118,1934584,+,4466
77,BUMA.1121.00087,2,360459,364925,+,4466
77,BUMA.1121.00039,2,1474208,1478572,-,4364
77,BUMA.1121.00030,2,251516,255981,-,4465
77,BUMA.1121.00016,2,1219100,1223456,-,4356
77,BUMA.1121.00092,2,2491316,2495788,+,4472
77,BUMA.1121.00085,2,1401369,1405993,-,4624
77,BUMA.1121.00046,2,1253992,1258595,-,4603
77,BUMA.1121.00003,2,733839,738196,+,4357
77,BUMA.1121.00054,2,1881916,1886450,+,4534
77,BUMA.1121.00015,2,489425,494028,-,4603
77,BUMA.1121.00105,2,3140175,3144580,-,4405
77,BUMA.1121.00052,2,355028,359631,-,4603
77,BUMA.1121.00053,2,2777225,2781756,+,4531
77,BUMA.1121.00057,2,2746076,2750568,-,4492
77,BUMA.1121.00108,2,2736851,2741321,+,4470
77,BUMA.1121.00050,2,2176564,2181154,+,4590
77,BUMA.1121.00104,2,2580044,2584401,+,4357
77,BUMA.1121.00014,2,2608220,2612569,+,4349
77,BUMA.1121.00036,2,1420421,1424901,+,4480
77,BUMA.1121.00038,2,1982996,1987552,+,4556
77,BUMA.1121.00098,2,2749020,2753525,+,4505
77,BUMA.1121.00078,2,642982,647460,-,4478
77,BUMA.1121.00029,2,2030031,2034387,-,4356
77,BUMA.1121.00099,2,2735294,2739794,+,4500
77,BUMA.1121.00103,2,1130813,1135204,+,4391
77,BUMA.1121.00102,2,2520201,2524865,+,4664
77,BUMA.1121.00028,2,1892181,1896633,+,4452
77,BUMA.1121.00075,2,346634,350990,-,4356
77,BUMA.1121.00044,2,1916919,1921385,+,4466
77,BUMA.1121.00076,2,246451,250808,+,4357
77,BUMA.1121.00074,2,1879302,1883658,-,4356
77,BUMA.1121.00073,2,2474829,2479329,+,4500
77,BUMA.1121.00083,2,1145111,1149611,+,4500
77,BUMA.1121.00035,2,2107764,2112128,-,4364
77,BUMA.1121.00072,2,2449406,2453801,+,4395
77,BUMA.1121.00056,2,1511759,1516193,-,4434
77,BUMA.1121.00081,2,237182,241722,-,4540
77,BUMA.1121.00033,2,43814,48171,+,4357
77,BUMA.1121.00061,2,2457950,2462450,+,4500
77,BUMA.1121.00062,2,2414721,2419079,-,4358
77,BUMA.1121.00064,2,2396574,2400931,+,4357
77,BUMA.1121.00060,2,2888231,2892736,-,4505
77,BUMA.1121.00069,2,2440741,2445241,+,4500
77,BUMA.1121.00070,2,2454170,2458670,+,4500
77,BUMA.1121.00068,2,1080837,1085313,+,4476
77,BUMA.1121.00067,2,1434453,1438809,-,4356
77,BUMA.1121.00037,2,2843084,2847443,+,4359
77,BUMA.1121.00065,2,2563952,2568465,+,4513
77,BUMA.1121.00058,2,3098116,3102538,+,4422
77,BUMA.1121.00041,2,221613,226050,+,4437
77,BUMA.1121.00084,2,1205186,1209665,+,4479
77,BUMA.1121.00096,2,2804756,2809322,+,4566
77,BUMA.1121.00080,2,2545164,2549697,+,4533
77,BUMA.1121.00013,2,667819,672380,-,4561
77,BUMA.1121.00100,2,520261,524611,+,4350
77,BUMA.1121.00012,2,2437317,2441673,-,4356
77,BUMA.1121.00018,2,1311287,1315643,-,4356
77,BUMA.1121.00048,2,976631,981171,-,4540
77,BUMA.1121.00106,2,1770567,1774924,+,4357
77,BUMA.1121.00017,2,1866018,1870484,+,4466
77,BUMA.1121.00082,2,2521195,2525695,+,4500
76,BUMA.1121.00049,2,1123506,1127891,+,4385
76,BUMA.1121.00055,2,192552,196937,-,4385
76,BUMA.1121.00011,2,1098018,1102409,+,4391
76,BUMA.1121.00110,2,2442928,2447312,+,4384
76,BUMA.1121.00109,2,2143805,2148166,-,4361
76,BUMA.1121.00077,2,1168639,1173024,-,4385
76,BUMA.1121.00027,2,398623,402995,+,4372
76,BUMA.1121.00026,2,462330,466713,+,4383
76,BUMA.1121.00021,2,2977268,2981648,+,4380
76,BUMA.1121.00023,2,2618834,2623207,+,4373
76,BUMA.1121.00022,2,1793125,1797509,-,4384
76,BUMA.1121.00034,2,1856470,1860853,+,4383
76,BUMA.1121.00025,2,1007646,1012032,+,4386
76,BUMA.1121.00031,2,1663997,1668369,+,4372
76,BUMA.1121.00007,2,2604453,2608837,+,4384
76,BUMA.1121.00097,2,2316756,2321153,+,4397
76,BUMA.1121.00008,2,1840706,1845089,+,4383
76,BUMA.1121.00059,2,1116466,1120852,-,4386
76,BUMA.1121.00002,2,319018,323401,+,4383
76,BUMA.1121.00004,2,1841145,1845528,+,4383
76,BUMA.1121.00005,2,1440321,1444707,-,4386
76,BUMA.1121.00111,2,1811212,1815585,+,4373
76,BUMA.1121.00006,2,2072223,2076606,+,4383
76,BUMA.1121.00009,2,1140719,1145104,+,4385
76,BUMA.1121.00094,2,2520027,2524412,+,4385
76,BUMA.1121.00101,2,929150,933531,-,4381
76,BUMA.1121.00066,2,2449045,2453430,+,4385
76,BUMA.1121.00095,2,1344529,1348903,+,4374
76,BUMA.1121.00112,2,1887321,1891695,-,4374
76,BUMA.1121.00042,2,1848394,1852778,-,4384
76,BUMA.1121.00032,2,281510,285893,+,4383
76,BUMA.1121.00090,2,218656,223029,+,4373
76,BUMA.1121.00020,2,1841393,1845776,+,4383
76,BUMA.1121.00089,2,2465815,2470200,+,4385
76,BUMA.1121.00051,2,2479242,2483626,+,4384
76,BUMA.1121.00001,2,2921097,2925471,-,4374
76,BUMA.1121.00045,2,2362875,2367260,+,4385
76,BUMA.1121.00043,2,3076251,3080625,-,4374
76,BUMA.1121.00063,2,2458357,2462739,+,4382
76,BUMA.1121.00079,2,2479753,2484137,+,4384
76,BUMA.1121.00071,2,2465165,2469550,+,4385
76,BUMA.1121.00086,2,248071,252455,-,4384
76,BUMA.1121.00024,2,1976346,1980729,+,4383
76,BUMA.1121.00010,2,1171208,1175591,+,4383
76,BUMA.1121.00040,2,207959,212343,-,4384
76,BUMA.1121.00093,2,452007,456393,-,4386
76,BUMA.1121.00091,2,1150524,1154898,-,4374
76,BUMA.1121.00107,2,1310641,1315034,-,4393
76,BUMA.1121.00088,2,2490825,2495210,+,4385
76,BUMA.1121.00047,2,293645,298031,+,4386
76,BUMA.1121.00019,2,1920538,1924921,+,4383
76,BUMA.1121.00087,2,350872,355255,+,4383
76,BUMA.1121.00039,2,1483853,1488227,-,4374
76,BUMA.1121.00030,2,261157,265541,-,4384
76,BUMA.1121.00016,2,1228638,1233012,-,4374
76,BUMA.1121.00092,2,2481640,2486025,+,4385
76,BUMA.1121.00085,2,1411136,1415520,-,4384
76,BUMA.1121.00046,2,1263743,1268127,-,4384
76,BUMA.1121.00003,2,724270,728639,+,4369
76,BUMA.1121.00054,2,1872343,1876726,+,4383
76,BUMA.1121.00015,2,499196,503580,-,4384
76,BUMA.1121.00105,2,3149641,3154026,-,4385
76,BUMA.1121.00052,2,364774,369158,-,4384
76,BUMA.1121.00053,2,2767701,2772074,+,4373
76,BUMA.1121.00057,2,2755716,2760102,-,4386
76,BUMA.1121.00108,2,2727308,2731701,+,4393
76,BUMA.1121.00050,2,2167019,2171402,+,4383
76,BUMA.1121.00104,2,2570482,2574867,+,4385
76,BUMA.1121.00014,2,2598602,2602974,+,4372
76,BUMA.1121.00036,2,1410787,1415170,+,4383
76,BUMA.1121.00038,2,1973416,1977799,+,4383
76,BUMA.1121.00098,2,2739356,2743728,+,4372
76,BUMA.1121.00078,2,652630,656992,-,4362
76,BUMA.1121.00029,2,2039599,2043973,-,4374
76,BUMA.1121.00099,2,2725741,2730113,+,4372
76,BUMA.1121.00103,2,1121300,1125665,+,4365
76,BUMA.1121.00102,2,2510605,2514990,+,4385
76,BUMA.1121.00028,2,1882594,1886977,+,4383
76,BUMA.1121.00075,2,356281,360664,-,4383
76,BUMA.1121.00044,2,1907360,1911743,+,4383
76,BUMA.1121.00076,2,236809,241194,+,4385
76,BUMA.1121.00074,2,1888844,1893230,-,4386
76,BUMA.1121.00073,2,2465323,2469708,+,4385
76,BUMA.1121.00083,2,1135552,1139937,+,4385
76,BUMA.1121.00035,2,2117351,2121726,-,4375
76,BUMA.1121.00072,2,2439852,2444237,+,4385
76,BUMA.1121.00056,2,1521397,1525783,-,4386
76,BUMA.1121.00081,2,246912,251296,-,4384
76,BUMA.1121.00033,2,34179,38552,+,4373
76,BUMA.1121.00061,2,2448400,2452780,+,4380
76,BUMA.1121.00062,2,2424318,2428691,-,4373
76,BUMA.1121.00064,2,2386968,2391353,+,4385
76,BUMA.1121.00060,2,2897879,2902265,-,4386
76,BUMA.1121.00069,2,2431190,2435571,+,4381
76,BUMA.1121.00070,2,2444680,2449065,+,4385
76,BUMA.1121.00068,2,1071257,1075641,+,4384
76,BUMA.1121.00067,2,1443918,1448304,-,4386
76,BUMA.1121.00037,2,2833521,2837893,+,4372
76,BUMA.1121.00065,2,2554378,2558751,+,4373
76,BUMA.1121.00058,2,3088617,3092990,+,4373
76,BUMA.1121.00041,2,212093,216478,+,4385
76,BUMA.1121.00084,2,1195699,1200084,+,4385
76,BUMA.1121.00096,2,2795263,2799648,+,4385
76,BUMA.1121.00080,2,2535647,2540031,+,4384
76,BUMA.1121.00013,2,677572,681956,-,4384
76,BUMA.1121.00100,2,510681,515066,+,4385
76,BUMA.1121.00012,2,2446824,2451199,-,4375
76,BUMA.1121.00018,2,1320886,1325273,-,4387
76,BUMA.1121.00048,2,986305,990689,-,4384
76,BUMA.1121.00106,2,1761012,1765385,+,4373
76,BUMA.1121.00017,2,1856459,1860842,+,4383
76,BUMA.1121.00082,2,2511636,2516021,+,4385
75,BUMA.1121.00049,2,1106361,1122976,+,16615
75,BUMA.1121.00055,2,197466,214048,-,16582
75,BUMA.1121.00011,2,1080876,1097488,+,16612
75,BUMA.1121.00110,2,2425798,2442398,+,16600
75,BUMA.1121.00109,2,2148707,2165312,-,16605
75,BUMA.1121.00077,2,1173553,1190158,-,16605
75,BUMA.1121.00027,2,381514,398093,+,16579
75,BUMA.1121.00026,2,445240,461800,+,16560
75,BUMA.1121.00021,2,2960167,2976738,+,16571
75,BUMA.1121.00023,2,2601676,2618304,+,16628
75,BUMA.1121.00022,2,1798038,1814599,-,16561
75,BUMA.1121.00034,2,1839379,1855940,+,16561
75,BUMA.1121.00025,2,990531,1007116,+,16585
75,BUMA.1121.00031,2,1646875,1663467,+,16592
75,BUMA.1121.00007,2,2587304,2603923,+,16619
75,BUMA.1121.00097,2,2299725,2316226,+,16501
75,BUMA.1121.00008,2,1823615,1840176,+,16561
75,BUMA.1121.00059,2,1121381,1137955,-,16574
75,BUMA.1121.00002,2,301918,318488,+,16570
75,BUMA.1121.00004,2,1824054,1840615,+,16561
75,BUMA.1121.00005,2,1445236,1461812,-,16576
75,BUMA.1121.00111,2,1794062,1810682,+,16620
75,BUMA.1121.00006,2,2055132,2071693,+,16561
75,BUMA.1121.00009,2,1123618,1140189,+,16571
75,BUMA.1121.00094,2,2502885,2519497,+,16612
75,BUMA.1121.00101,2,935661,952287,-,16626
75,BUMA.1121.00066,2,2431919,2448515,+,16596
75,BUMA.1121.00095,2,1325825,1342396,+,16571
75,BUMA.1121.00112,2,1892224,1908794,-,16570
75,BUMA.1121.00042,2,1853307,1869861,-,16554
75,BUMA.1121.00032,2,264419,280980,+,16561
75,BUMA.1121.00090,2,201508,218126,+,16618
75,BUMA.1121.00020,2,1824302,1840863,+,16561
75,BUMA.1121.00089,2,2448725,2465285,+,16560
75,BUMA.1121.00051,2,2462152,2478712,+,16560
75,BUMA.1121.00001,2,2926000,2942586,-,16586
75,BUMA.1121.00045,2,2345754,2362345,+,16591
75,BUMA.1121.00043,2,3081154,3097760,-,16606
75,BUMA.1121.00063,2,2441231,2457827,+,16596
75,BUMA.1121.00079,2,2462665,2479223,+,16558
75,BUMA.1121.00071,2,2448044,2464635,+,16591
75,BUMA.1121.00086,2,252984,269545,-,16561
75,BUMA.1121.00024,2,1959255,1975816,+,16561
75,BUMA.1121.00010,2,1154108,1170678,+,16570
75,BUMA.1121.00040,2,212872,229425,-,16553
75,BUMA.1121.00093,2,456922,473500,-,16578
75,BUMA.1121.00091,2,1155427,1172022,-,16595
75,BUMA.1121.00107,2,1315563,1332184,-,16621
75,BUMA.1121.00088,2,2473688,2490295,+,16607
75,BUMA.1121.00047,2,276555,293115,+,16560
75,BUMA.1121.00019,2,1903447,1920008,+,16561
75,BUMA.1121.00087,2,333780,350342,+,16562
75,BUMA.1121.00039,2,1488756,1505384,-,16628
75,BUMA.1121.00030,2,266070,282631,-,16561
75,BUMA.1121.00016,2,1233541,1250166,-,16625
75,BUMA.1121.00092,2,2464533,2481110,+,16577
75,BUMA.1121.00085,2,1416049,1432612,-,16563
75,BUMA.1121.00046,2,1268656,1285217,-,16561
75,BUMA.1121.00003,2,707161,723729,+,16568
75,BUMA.1121.00054,2,1855252,1871813,+,16561
75,BUMA.1121.00015,2,504109,520672,-,16563
75,BUMA.1121.00105,2,3154555,3171171,-,16616
75,BUMA.1121.00052,2,369687,386250,-,16563
75,BUMA.1121.00053,2,2750576,2767171,+,16595
75,BUMA.1121.00057,2,2760631,2777233,-,16602
75,BUMA.1121.00108,2,2710140,2726778,+,16638
75,BUMA.1121.00050,2,2149928,2166489,+,16561
75,BUMA.1121.00104,2,2553338,2569952,+,16614
75,BUMA.1121.00014,2,2581502,2598072,+,16570
75,BUMA.1121.00036,2,1393695,1410257,+,16562
75,BUMA.1121.00038,2,1956325,1972886,+,16561
75,BUMA.1121.00098,2,2722260,2738826,+,16566
75,BUMA.1121.00078,2,659123,675715,-,16592
75,BUMA.1121.00029,2,2044502,2061095,-,16593
75,BUMA.1121.00099,2,2708588,2725211,+,16623
75,BUMA.1121.00103,2,1104141,1120770,+,16629
75,BUMA.1121.00102,2,2493522,2510075,+,16553
75,BUMA.1121.00028,2,1865503,1882064,+,16561
75,BUMA.1121.00075,2,361193,377818,-,16625
75,BUMA.1121.00044,2,1890269,1906830,+,16561
75,BUMA.1121.00076,2,219647,236279,+,16632
75,BUMA.1121.00074,2,1893759,1910325,-,16566
75,BUMA.1121.00073,2,2448197,2464793,+,16596
75,BUMA.1121.00083,2,1118426,1135022,+,16596
75,BUMA.1121.00035,2,2122255,2138841,-,16586
75,BUMA.1121.00072,2,2422726,2439322,+,16596
75,BUMA.1121.00056,2,1526312,1542873,-,16561
75,BUMA.1121.00081,2,251825,268386,-,16561
75,BUMA.1121.00033,2,17023,33649,+,16626
75,BUMA.1121.00061,2,2431274,2447870,+,16596
75,BUMA.1121.00062,2,2429220,2445846,-,16626
75,BUMA.1121.00064,2,2369873,2386438,+,16565
75,BUMA.1121.00060,2,2902794,2919386,-,16592
75,BUMA.1121.00069,2,2414064,2430660,+,16596
75,BUMA.1121.00070,2,2427554,2444150,+,16596
75,BUMA.1121.00068,2,1054083,1070727,+,16644
75,BUMA.1121.00067,2,1448833,1465470,-,16637
75,BUMA.1121.00037,2,2816383,2832991,+,16608
75,BUMA.1121.00065,2,2537267,2553848,+,16581
75,BUMA.1121.00058,2,3071499,3088087,+,16588
75,BUMA.1121.00041,2,194929,211563,+,16634
75,BUMA.1121.00084,2,1178575,1195169,+,16594
75,BUMA.1121.00096,2,2778094,2794733,+,16639
75,BUMA.1121.00080,2,2518559,2535117,+,16558
75,BUMA.1121.00013,2,682485,699048,-,16563
75,BUMA.1121.00100,2,493546,510151,+,16605
75,BUMA.1121.00012,2,2451728,2468314,-,16586
75,BUMA.1121.00018,2,1325802,1342388,-,16586
75,BUMA.1121.00048,2,991218,1007779,-,16561
75,BUMA.1121.00106,2,1742285,1758878,+,16593
75,BUMA.1121.00017,2,1839368,1855929,+,16561
75,BUMA.1121.00082,2,2494510,2511106,+,16596
74,BUMA.1121.00049,2,1089298,1106324,+,17026
74,BUMA.1121.00055,2,214085,231088,-,17003
74,BUMA.1121.00011,2,1063816,1080839,+,17023
74,BUMA.1121.00110,2,2408733,2425756,+,17023
74,BUMA.1121.00109,2,2165349,2182372,-,17023
74,BUMA.1121.00077,2,1190200,1207223,-,17023
74,BUMA.1121.00027,2,364446,381477,+,17031
74,BUMA.1121.00021,2,2943125,2960130,+,17005
74,BUMA.1121.00023,2,2584619,2601639,+,17020
74,BUMA.1121.00025,2,973481,990494,+,17013
74,BUMA.1121.00031,2,1629817,1646838,+,17021
74,BUMA.1121.00007,2,2570251,2587267,+,17016
74,BUMA.1121.00097,2,2282673,2299688,+,17015
74,BUMA.1121.00059,2,1137992,1154989,-,16997
74,BUMA.1121.00005,2,1461849,1478853,-,17004
74,BUMA.1121.00111,2,1776984,1794025,+,17041
74,BUMA.1121.00009,2,1106578,1123581,+,17003
74,BUMA.1121.00094,2,2485832,2502848,+,17016
74,BUMA.1121.00101,2,952324,969346,-,17022
74,BUMA.1121.00066,2,2414860,2431882,+,17022
74,BUMA.1121.00095,2,1308747,1325775,+,17028
74,BUMA.1121.00112,2,1908831,1925824,-,16993
74,BUMA.1121.00090,2,184429,201471,+,17042
74,BUMA.1121.00089,2,2431672,2448688,+,17016
74,BUMA.1121.00051,2,2445099,2462115,+,17016
74,BUMA.1121.00001,2,2942623,2959658,-,17035
74,BUMA.1121.00045,2,2328713,2345717,+,17004
74,BUMA.1121.00043,2,3097797,3114829,-,17032
74,BUMA.1121.00063,2,2424172,2441194,+,17022
74,BUMA.1121.00079,2,2445612,2462628,+,17016
74,BUMA.1121.00071,2,2430985,2448007,+,17022
74,BUMA.1121.00093,2,473537,490559,-,17022
74,BUMA.1121.00091,2,1172059,1189072,-,17013
74,BUMA.1121.00107,2,1332221,1349249,-,17028
74,BUMA.1121.00088,2,2456628,2473651,+,17023
74,BUMA.1121.00047,2,259502,276518,+,17016
74,BUMA.1121.00039,2,1505421,1522437,-,17016
74,BUMA.1121.00016,2,1250203,1267245,-,17042
74,BUMA.1121.00092,2,2447474,2464496,+,17022
74,BUMA.1121.00003,2,690108,707124,+,17016
74,BUMA.1121.00105,2,3171208,3188224,-,17016
74,BUMA.1121.00053,2,2733542,2750539,+,16997
74,BUMA.1121.00057,2,2777270,2794302,-,17032
74,BUMA.1121.00108,2,2693088,2710103,+,17015
74,BUMA.1121.00104,2,2536285,2553301,+,17016
74,BUMA.1121.00014,2,2564444,2581465,+,17021
74,BUMA.1121.00098,2,2705200,2722223,+,17023
74,BUMA.1121.00078,2,675752,692754,-,17002
74,BUMA.1121.00029,2,2061132,2078166,-,17034
74,BUMA.1121.00099,2,2691547,2708551,+,17004
74,BUMA.1121.00103,2,1087082,1104104,+,17022
74,BUMA.1121.00102,2,2476453,2493485,+,17032
74,BUMA.1121.00075,2,377855,394877,-,17022
74,BUMA.1121.00076,2,202587,219610,+,17023
74,BUMA.1121.00074,2,1910362,1927378,-,17016
74,BUMA.1121.00073,2,2431138,2448160,+,17022
74,BUMA.1121.00083,2,1101367,1118389,+,17022
74,BUMA.1121.00035,2,2138878,2155913,-,17035
74,BUMA.1121.00072,2,2405667,2422689,+,17022
74,BUMA.1121.00056,2,1542910,1559926,-,17016
74,BUMA.1121.00033,2,1,16986,+,16985
74,BUMA.1121.00061,2,2414215,2431237,+,17022
74,BUMA.1121.00062,2,2445883,2462899,-,17016
74,BUMA.1121.00064,2,2352820,2369836,+,17016
74,BUMA.1121.00060,2,2919423,2936427,-,17004
74,BUMA.1121.00069,2,2397005,2414027,+,17022
74,BUMA.1121.00070,2,2410495,2427517,+,17022
74,BUMA.1121.00068,2,1037024,1054046,+,17022
74,BUMA.1121.00067,2,1465507,1482523,-,17016
74,BUMA.1121.00037,2,2799314,2816346,+,17032
74,BUMA.1121.00065,2,2520227,2537230,+,17003
74,BUMA.1121.00058,2,3054439,3071462,+,17023
74,BUMA.1121.00041,2,177849,194892,+,17043
74,BUMA.1121.00084,2,1161515,1178538,+,17023
74,BUMA.1121.00096,2,2761055,2778057,+,17002
74,BUMA.1121.00080,2,2501506,2518522,+,17016
74,BUMA.1121.00100,2,476496,493509,+,17013
74,BUMA.1121.00012,2,2468351,2485373,-,17022
74,BUMA.1121.00018,2,1342425,1359438,-,17013
74,BUMA.1121.00106,2,1725232,1742248,+,17016
74,BUMA.1121.00082,2,2477451,2494473,+,17022
73,BUMA.1121.00049,2,1076790,1089296,+,12506
73,BUMA.1121.00055,2,231089,243637,-,12548
73,BUMA.1121.00011,2,1051297,1063814,+,12517
73,BUMA.1121.00110,2,2396184,2408731,+,12547
73,BUMA.1121.00109,2,2182373,2194883,-,12510
73,BUMA.1121.00077,2,1207224,1219772,-,12548
73,BUMA.1121.00027,2,351897,364444,+,12547
73,BUMA.1121.00021,2,2930575,2943123,+,12548
73,BUMA.1121.00023,2,2572103,2584617,+,12514
73,BUMA.1121.00025,2,960931,973479,+,12548
73,BUMA.1121.00031,2,1617267,1629815,+,12548
73,BUMA.1121.00007,2,2557740,2570249,+,12509
73,BUMA.1121.00097,2,2270124,2282671,+,12547
73,BUMA.1121.00059,2,1154990,1167500,-,12510
73,BUMA.1121.00005,2,1478854,1491402,-,12548
73,BUMA.1121.00111,2,1764434,1776982,+,12548
73,BUMA.1121.00009,2,1094029,1106576,+,12547
73,BUMA.1121.00094,2,2473332,2485830,+,12498
73,BUMA.1121.00101,2,969347,981895,-,12548
73,BUMA.1121.00066,2,2402341,2414858,+,12517
73,BUMA.1121.00095,2,1296228,1308745,+,12517
73,BUMA.1121.00112,2,1925825,1938368,-,12543
73,BUMA.1121.00090,2,171879,184427,+,12548
73,BUMA.1121.00089,2,2419122,2431670,+,12548
73,BUMA.1121.00051,2,2432549,2445097,+,12548
73,BUMA.1121.00001,2,2959659,2972178,-,12519
73,BUMA.1121.00045,2,2316153,2328711,+,12558
73,BUMA.1121.00043,2,3114830,3127374,-,12544
73,BUMA.1121.00063,2,2411670,2424170,+,12500
73,BUMA.1121.00079,2,2433062,2445610,+,12548
73,BUMA.1121.00071,2,2418466,2430983,+,12517
73,BUMA.1121.00093,2,490560,503108,-,12548
73,BUMA.1121.00091,2,1189073,1201583,-,12510
73,BUMA.1121.00107,2,1349250,1361793,-,12543
73,BUMA.1121.00088,2,2444109,2456626,+,12517
73,BUMA.1121.00047,2,246952,259500,+,12548
73,BUMA.1121.00039,2,1522438,1534987,-,12549
73,BUMA.1121.00016,2,1267246,1279795,-,12549
73,BUMA.1121.00092,2,2434925,2447472,+,12547
73,BUMA.1121.00003,2,677565,690106,+,12541
73,BUMA.1121.00105,2,3188225,3200711,-,12486
73,BUMA.1121.00053,2,2721061,2733540,+,12479
73,BUMA.1121.00057,2,2794303,2806851,-,12548
73,BUMA.1121.00108,2,2680528,2693086,+,12558
73,BUMA.1121.00104,2,2523735,2536283,+,12548
73,BUMA.1121.00014,2,2551894,2564442,+,12548
73,BUMA.1121.00098,2,2692645,2705198,+,12553
73,BUMA.1121.00078,2,692755,705311,-,12556
73,BUMA.1121.00029,2,2078167,2090686,-,12519
73,BUMA.1121.00099,2,2679024,2691545,+,12521
73,BUMA.1121.00103,2,1074583,1087080,+,12497
73,BUMA.1121.00102,2,2463942,2476451,+,12509
73,BUMA.1121.00075,2,394878,407396,-,12518
73,BUMA.1121.00076,2,190068,202585,+,12517
73,BUMA.1121.00074,2,1927379,1939886,-,12507
73,BUMA.1121.00073,2,2418618,2431136,+,12518
73,BUMA.1121.00083,2,1088818,1101365,+,12547
73,BUMA.1121.00035,2,2155914,2168433,-,12519
73,BUMA.1121.00072,2,2393149,2405665,+,12516
73,BUMA.1121.00056,2,1559927,1572476,-,12549
73,BUMA.1121.00033,2,3232504,3245064,+,12560
73,BUMA.1121.00061,2,2401696,2414213,+,12517
73,BUMA.1121.00062,2,2462900,2475405,-,12505
73,BUMA.1121.00064,2,2340312,2352818,+,12506
73,BUMA.1121.00060,2,2936428,2948987,-,12559
73,BUMA.1121.00069,2,2384474,2397003,+,12529
73,BUMA.1121.00070,2,2397977,2410493,+,12516
73,BUMA.1121.00068,2,1024481,1037022,+,12541
73,BUMA.1121.00067,2,1482524,1495031,-,12507
73,BUMA.1121.00037,2,2786764,2799312,+,12548
73,BUMA.1121.00065,2,2507678,2520225,+,12547
73,BUMA.1121.00058,2,3041889,3054437,+,12548
73,BUMA.1121.00041,2,165338,177847,+,12509
73,BUMA.1121.00084,2,1148996,1161513,+,12517
73,BUMA.1121.00096,2,2748536,2761053,+,12517
73,BUMA.1121.00080,2,2488956,2501504,+,12548
73,BUMA.1121.00100,2,463977,476494,+,12517
73,BUMA.1121.00012,2,2485374,2497923,-,12549
73,BUMA.1121.00018,2,1359439,1371988,-,12549
73,BUMA.1121.00106,2,1712724,1725230,+,12506
73,BUMA.1121.00082,2,2464902,2477449,+,12547
72,BUMA.1121.00049,2,1048267,1076768,+,28501
72,BUMA.1121.00055,2,243659,272128,-,28469
72,BUMA.1121.00011,2,1022773,1051275,+,28502
72,BUMA.1121.00110,2,2367661,2396162,+,28501
72,BUMA.1121.00109,2,2194905,2223305,-,28400
72,BUMA.1121.00077,2,1219794,1248291,-,28497
72,BUMA.1121.00027,2,323365,351875,+,28510
72,BUMA.1121.00026,2,414328,443989,+,29661
72,BUMA.1121.00021,2,2902112,2930553,+,28441
72,BUMA.1121.00023,2,2543605,2572081,+,28476
72,BUMA.1121.00022,2,1815852,1844200,-,28348
72,BUMA.1121.00034,2,1809779,1838127,+,28348
72,BUMA.1121.00025,2,932454,960909,+,28455
72,BUMA.1121.00031,2,1588784,1617245,+,28461
72,BUMA.1121.00007,2,2529111,2557718,+,28607
72,BUMA.1121.00097,2,2241631,2270102,+,28471
72,BUMA.1121.00008,2,1794015,1822363,+,28348
72,BUMA.1121.00059,2,1167522,1195998,-,28476
72,BUMA.1121.00002,2,272318,300667,+,28349
72,BUMA.1121.00004,2,1794455,1822802,+,28347
72,BUMA.1121.00005,2,1491424,1519882,-,28458
72,BUMA.1121.00111,2,1735938,1764412,+,28474
72,BUMA.1121.00006,2,2025539,2053880,+,28341
72,BUMA.1121.00009,2,1065495,1094007,+,28512
72,BUMA.1121.00094,2,2444843,2473310,+,28467
72,BUMA.1121.00101,2,981917,1010471,-,28554
72,BUMA.1121.00066,2,2373800,2402319,+,28519
72,BUMA.1121.00095,2,1267714,1296206,+,28492
72,BUMA.1121.00112,2,1938390,1966908,-,28518
72,BUMA.1121.00042,2,1871112,1900773,-,29661
72,BUMA.1121.00032,2,234819,263167,+,28348
72,BUMA.1121.00090,2,143372,171857,+,28485
72,BUMA.1121.00020,2,1794702,1823050,+,28348
72,BUMA.1121.00089,2,2390638,2419100,+,28462
72,BUMA.1121.00051,2,2404076,2432527,+,28451
72,BUMA.1121.00001,2,2972200,3000689,-,28489
72,BUMA.1121.00045,2,2287585,2316131,+,28546
72,BUMA.1121.00043,2,3127396,3155846,-,28450
72,BUMA.1121.00063,2,2383149,2411648,+,28499
72,BUMA.1121.00079,2,2404588,2433040,+,28452
72,BUMA.1121.00071,2,2389925,2418444,+,28519
72,BUMA.1121.00086,2,270798,299146,-,28348
72,BUMA.1121.00024,2,1929655,1958003,+,28348
72,BUMA.1121.00010,2,1124507,1152857,+,28350
72,BUMA.1121.00040,2,230678,259019,-,28341
72,BUMA.1121.00093,2,503130,531619,-,28489
72,BUMA.1121.00091,2,1201605,1230078,-,28473
72,BUMA.1121.00107,2,1361815,1390221,-,28406
72,BUMA.1121.00088,2,2415614,2444087,+,28473
72,BUMA.1121.00047,2,218468,246930,+,28462
72,BUMA.1121.00019,2,1873847,1902195,+,28348
72,BUMA.1121.00087,2,304180,332528,+,28348
72,BUMA.1121.00039,2,1535009,1563470,-,28461
72,BUMA.1121.00030,2,283884,312232,-,28348
72,BUMA.1121.00016,2,1279817,1308298,-,28481
72,BUMA.1121.00092,2,2406414,2434903,+,28489
72,BUMA.1121.00085,2,1433863,1462205,-,28342
72,BUMA.1121.00046,2,1286470,1314812,-,28342
72,BUMA.1121.00003,2,649065,677543,+,28478
72,BUMA.1121.00054,2,1825659,1854000,+,28341
72,BUMA.1121.00015,2,521923,550265,-,28342
72,BUMA.1121.00105,2,60,28512,-,28452
72,BUMA.1121.00052,2,387501,415843,-,28342
72,BUMA.1121.00053,2,2692541,2721039,+,28498
72,BUMA.1121.00057,2,2806873,2835371,-,28498
72,BUMA.1121.00108,2,2652071,2680506,+,28435
72,BUMA.1121.00050,2,2120334,2148676,+,28342
72,BUMA.1121.00104,2,2495226,2523713,+,28487
72,BUMA.1121.00014,2,2523418,2551872,+,28454
72,BUMA.1121.00036,2,1364094,1392442,+,28348
72,BUMA.1121.00038,2,1926732,1955073,+,28341
72,BUMA.1121.00098,2,2664128,2692623,+,28495
72,BUMA.1121.00078,2,705339,733705,-,28366
72,BUMA.1121.00029,2,2090708,2119228,-,28520
72,BUMA.1121.00099,2,2650531,2679002,+,28471
72,BUMA.1121.00103,2,1045993,1074561,+,28568
72,BUMA.1121.00102,2,2435401,2463920,+,28519
72,BUMA.1121.00028,2,1835903,1864251,+,28348
72,BUMA.1121.00075,2,407418,435916,-,28498
72,BUMA.1121.00044,2,1860669,1889017,+,28348
72,BUMA.1121.00076,2,161553,190046,+,28493
72,BUMA.1121.00074,2,1939908,1968367,-,28459
72,BUMA.1121.00073,2,2390166,2418596,+,28430
72,BUMA.1121.00083,2,1060277,1088796,+,28519
72,BUMA.1121.00035,2,2168455,2196920,-,28465
72,BUMA.1121.00072,2,2364668,2393127,+,28459
72,BUMA.1121.00056,2,1572498,1600960,-,28462
72,BUMA.1121.00081,2,269639,297980,-,28341
72,BUMA.1121.00033,2,3204006,3232482,+,28476
72,BUMA.1121.00061,2,2373265,2401674,+,28409
72,BUMA.1121.00062,2,2475427,2503982,-,28555
72,BUMA.1121.00064,2,2311898,2340290,+,28392
72,BUMA.1121.00060,2,2949009,2977555,-,28546
72,BUMA.1121.00069,2,2356043,2384452,+,28409
72,BUMA.1121.00070,2,2369536,2397955,+,28419
72,BUMA.1121.00068,2,995872,1024459,+,28587
72,BUMA.1121.00067,2,1495053,1523504,-,28451
72,BUMA.1121.00037,2,2758278,2786742,+,28464
72,BUMA.1121.00065,2,2479246,2507656,+,28410
72,BUMA.1121.00058,2,3013329,3041867,+,28538
72,BUMA.1121.00041,2,136902,165316,+,28414
72,BUMA.1121.00084,2,1120455,1148974,+,28519
72,BUMA.1121.00096,2,2720084,2748514,+,28430
72,BUMA.1121.00080,2,2460490,2488934,+,28444
72,BUMA.1121.00013,2,700299,728641,-,28342
72,BUMA.1121.00100,2,435507,463955,+,28448
72,BUMA.1121.00012,2,2497945,2526407,-,28462
72,BUMA.1121.00018,2,1372010,1400465,-,28455
72,BUMA.1121.00048,2,1009032,1037373,-,28341
72,BUMA.1121.00106,2,1684193,1712702,+,28509
72,BUMA.1121.00017,2,1809768,1838116,+,28348
72,BUMA.1121.00082,2,2436361,2464880,+,28519
71,BUMA.1121.00049,2,1032479,1042160,+,9681
71,BUMA.1121.00055,2,278229,287875,-,9646
71,BUMA.1121.00011,2,1007087,1016669,+,9582
71,BUMA.1121.00110,2,2351899,2361559,+,9660
71,BUMA.1121.00109,2,2229413,2239074,-,9661
71,BUMA.1121.00077,2,1254393,1264052,-,9659
71,BUMA.1121.00027,2,307664,317272,+,9608
71,BUMA.1121.00026,2,398479,408223,+,9744
71,BUMA.1121.00021,2,2886319,2896005,+,9686
71,BUMA.1121.00023,2,2527806,2537498,+,9692
71,BUMA.1121.00022,2,1851544,1861324,-,9780
71,BUMA.1121.00034,2,1792690,1802434,+,9744
71,BUMA.1121.00025,2,915772,925429,+,9657
71,BUMA.1121.00031,2,1572956,1582676,+,9720
71,BUMA.1121.00007,2,2513398,2523014,+,9616
71,BUMA.1121.00097,2,2224566,2234212,+,9646
71,BUMA.1121.00008,2,1776927,1786670,+,9743
71,BUMA.1121.00059,2,1202101,1211789,-,9688
71,BUMA.1121.00002,2,256504,266213,+,9709
71,BUMA.1121.00004,2,1777366,1787110,+,9744
71,BUMA.1121.00005,2,1525985,1535645,-,9660
71,BUMA.1121.00111,2,1720104,1729831,+,9727
71,BUMA.1121.00006,2,2009694,2019434,+,9740
71,BUMA.1121.00009,2,1049665,1059392,+,9727
71,BUMA.1121.00094,2,2429084,2438740,+,9656
71,BUMA.1121.00101,2,1016577,1026237,-,9660
71,BUMA.1121.00066,2,2358099,2367707,+,9608
71,BUMA.1121.00095,2,1252001,1261626,+,9625
71,BUMA.1121.00112,2,1973016,1982668,-,9652
71,BUMA.1121.00042,2,1906877,1916594,-,9717
71,BUMA.1121.00032,2,217730,227474,+,9744
71,BUMA.1121.00090,2,127545,137265,+,9720
71,BUMA.1121.00020,2,1777613,1787357,+,9744
71,BUMA.1121.00089,2,2374849,2384533,+,9684
71,BUMA.1121.00051,2,2388331,2397973,+,9642
71,BUMA.1121.00001,2,3006795,3016489,-,9694
71,BUMA.1121.00045,2,2271825,2281478,+,9653
71,BUMA.1121.00043,2,3161951,3171651,-,9700
71,BUMA.1121.00063,2,2367448,2377056,+,9608
71,BUMA.1121.00079,2,2388773,2398485,+,9712
71,BUMA.1121.00071,2,2374224,2383832,+,9608
71,BUMA.1121.00086,2,306490,316214,-,9724
71,BUMA.1121.00024,2,1912566,1922310,+,9744
71,BUMA.1121.00010,2,1108694,1118402,+,9708
71,BUMA.1121.00040,2,263886,273626,-,9740
71,BUMA.1121.00093,2,537721,547301,-,9580
71,BUMA.1121.00091,2,1236186,1245885,-,9699
71,BUMA.1121.00107,2,1396325,1405985,-,9660
71,BUMA.1121.00088,2,2399906,2409507,+,9601
71,BUMA.1121.00047,2,202686,212363,+,9677
71,BUMA.1121.00019,2,1856758,1866502,+,9744
71,BUMA.1121.00087,2,287113,296836,+,9723
71,BUMA.1121.00039,2,1569577,1579263,-,9686
71,BUMA.1121.00030,2,319576,329321,-,9745
71,BUMA.1121.00016,2,1314404,1324041,-,9637
71,BUMA.1121.00092,2,2390710,2400311,+,9601
71,BUMA.1121.00085,2,1468309,1478054,-,9745
71,BUMA.1121.00046,2,1320916,1330614,-,9698
71,BUMA.1121.00003,2,637192,646842,+,9650
71,BUMA.1121.00054,2,1809814,1819554,+,9740
71,BUMA.1121.00015,2,556369,566039,-,9670
71,BUMA.1121.00105,2,34616,44302,-,9686
71,BUMA.1121.00052,2,421947,431692,-,9745
71,BUMA.1121.00053,2,2675297,2684982,+,9685
71,BUMA.1121.00057,2,2841474,2851181,-,9707
71,BUMA.1121.00108,2,2636295,2645974,+,9679
71,BUMA.1121.00050,2,2104531,2114229,+,9698
71,BUMA.1121.00104,2,2479489,2489122,+,9633
71,BUMA.1121.00014,2,2507602,2517308,+,9706
71,BUMA.1121.00036,2,1347002,1356753,+,9751
71,BUMA.1121.00038,2,1910887,1920627,+,9740
71,BUMA.1121.00098,2,2648438,2658019,+,9581
71,BUMA.1121.00078,2,739810,749511,-,9701
71,BUMA.1121.00029,2,2125334,2135035,-,9701
71,BUMA.1121.00099,2,2634713,2644398,+,9685
71,BUMA.1121.00103,2,1030298,1039888,+,9590
71,BUMA.1121.00102,2,2418143,2427842,+,9699
71,BUMA.1121.00028,2,1818821,1828558,+,9737
71,BUMA.1121.00075,2,442018,451703,-,9685
71,BUMA.1121.00044,2,1843580,1853324,+,9744
71,BUMA.1121.00076,2,145764,155450,+,9686
71,BUMA.1121.00074,2,1974469,1984147,-,9678
71,BUMA.1121.00073,2,2374465,2384073,+,9608
71,BUMA.1121.00083,2,1044576,1054184,+,9608
71,BUMA.1121.00035,2,2203026,2212713,-,9687
71,BUMA.1121.00072,2,2348967,2358575,+,9608
71,BUMA.1121.00056,2,1607064,1616777,-,9713
71,BUMA.1121.00081,2,304084,313824,-,9740
71,BUMA.1121.00033,2,3188187,3197899,+,9712
71,BUMA.1121.00061,2,2357564,2367172,+,9608
71,BUMA.1121.00062,2,2510085,2519806,-,9721
71,BUMA.1121.00064,2,2296097,2305795,+,9698
71,BUMA.1121.00060,2,2983661,2993314,-,9653
71,BUMA.1121.00069,2,2340342,2349950,+,9608
71,BUMA.1121.00070,2,2353835,2363443,+,9608
71,BUMA.1121.00068,2,980110,989765,+,9655
71,BUMA.1121.00067,2,1529606,1539326,-,9720
71,BUMA.1121.00037,2,2742485,2752170,+,9685
71,BUMA.1121.00065,2,2463466,2473144,+,9678
71,BUMA.1121.00058,2,2997547,3007235,+,9688
71,BUMA.1121.00041,2,121133,130796,+,9663
71,BUMA.1121.00084,2,1104750,1114351,+,9601
71,BUMA.1121.00096,2,2704319,2713979,+,9660
71,BUMA.1121.00080,2,2444722,2454385,+,9663
71,BUMA.1121.00013,2,734745,744504,-,9759
71,BUMA.1121.00100,2,419751,429401,+,9650
71,BUMA.1121.00012,2,2532512,2542156,-,9644
71,BUMA.1121.00018,2,1407488,1417146,-,9658
71,BUMA.1121.00048,2,1043477,1053217,-,9740
71,BUMA.1121.00106,2,1668388,1678090,+,9702
71,BUMA.1121.00017,2,1792679,1802423,+,9744
71,BUMA.1121.00082,2,2420660,2430268,+,9608
70,BUMA.1121.00049,2,1026918,1032478,+,5560
70,BUMA.1121.00055,2,287877,293437,-,5560
70,BUMA.1121.00011,2,1001526,1007086,+,5560
70,BUMA.1121.00110,2,2346337,2351898,+,5561
70,BUMA.1121.00109,2,2239076,2244638,-,5562
70,BUMA.1121.00077,2,1264054,1269615,-,5561
70,BUMA.1121.00027,2,302104,307663,+,5559
70,BUMA.1121.00026,2,684242,689802,-,5560
70,BUMA.1121.00021,2,2879164,2884724,+,5560
70,BUMA.1121.00023,2,2520664,2526224,+,5560
70,BUMA.1121.00022,2,1862905,1868465,-,5560
70,BUMA.1121.00034,2,1785549,1791109,+,5560
70,BUMA.1121.00025,2,908631,914191,+,5560
70,BUMA.1121.00031,2,1565815,1571375,+,5560
70,BUMA.1121.00007,2,2506259,2511819,+,5560
70,BUMA.1121.00097,2,2219005,2224565,+,5560
70,BUMA.1121.00008,2,1769786,1775346,+,5560
70,BUMA.1121.00059,2,1211791,1217351,-,5560
70,BUMA.1121.00002,2,249363,254923,+,5560
70,BUMA.1121.00004,2,1770225,1775785,+,5560
70,BUMA.1121.00005,2,1535647,1541207,-,5560
70,BUMA.1121.00111,2,1712963,1718523,+,5560
70,BUMA.1121.00006,2,2004133,2009693,+,5560
70,BUMA.1121.00009,2,1044104,1049664,+,5560
70,BUMA.1121.00094,2,2421943,2427503,+,5560
70,BUMA.1121.00101,2,1026239,1031800,-,5561
70,BUMA.1121.00066,2,2352538,2358098,+,5560
70,BUMA.1121.00095,2,1246438,1252000,+,5562
70,BUMA.1121.00112,2,1984249,1989810,-,5561
70,BUMA.1121.00042,2,1448014,1453574,+,5560
70,BUMA.1121.00032,2,210589,216149,+,5560
70,BUMA.1121.00090,2,120404,125964,+,5560
70,BUMA.1121.00020,2,1770472,1776032,+,5560
70,BUMA.1121.00089,2,2367708,2373268,+,5560
70,BUMA.1121.00051,2,2381190,2386750,+,5560
70,BUMA.1121.00001,2,3018084,3023644,-,5560
70,BUMA.1121.00045,2,2266264,2271824,+,5560
70,BUMA.1121.00043,2,3173232,3178792,-,5560
70,BUMA.1121.00063,2,2361887,2367447,+,5560
70,BUMA.1121.00079,2,2381632,2387192,+,5560
70,BUMA.1121.00071,2,2368663,2374223,+,5560
70,BUMA.1121.00086,2,317795,323355,-,5560
70,BUMA.1121.00024,2,1905425,1910985,+,5560
70,BUMA.1121.00010,2,1101553,1107113,+,5560
70,BUMA.1121.00040,2,273628,279188,-,5560
70,BUMA.1121.00093,2,547303,552864,-,5561
70,BUMA.1121.00091,2,1247466,1253026,-,5560
70,BUMA.1121.00107,2,1405987,1411547,-,5560
70,BUMA.1121.00088,2,2392764,2398324,+,5560
70,BUMA.1121.00047,2,195545,201105,+,5560
70,BUMA.1121.00019,2,1849617,1855177,+,5560
70,BUMA.1121.00087,2,279972,285532,+,5560
70,BUMA.1121.00039,2,1580844,1586404,-,5560
70,BUMA.1121.00030,2,330902,336462,-,5560
70,BUMA.1121.00016,2,1325622,1331182,-,5560
70,BUMA.1121.00092,2,2385148,2390709,+,5561
70,BUMA.1121.00085,2,1479637,1485197,-,5560
70,BUMA.1121.00046,2,1330616,1336176,-,5560
70,BUMA.1121.00003,2,630053,635613,+,5560
70,BUMA.1121.00054,2,1804253,1809813,+,5560
70,BUMA.1121.00015,2,566041,571601,-,5560
70,BUMA.1121.00105,2,45885,51445,-,5560
70,BUMA.1121.00052,2,433275,438835,-,5560
70,BUMA.1121.00053,2,2668156,2673716,+,5560
70,BUMA.1121.00057,2,2851183,2856743,-,5560
70,BUMA.1121.00108,2,2630734,2636294,+,5560
70,BUMA.1121.00050,2,2098970,2104530,+,5560
70,BUMA.1121.00104,2,2473928,2479488,+,5560
70,BUMA.1121.00014,2,2500461,2506021,+,5560
70,BUMA.1121.00036,2,1339858,1345418,+,5560
70,BUMA.1121.00038,2,1905326,1910886,+,5560
70,BUMA.1121.00098,2,2641297,2646857,+,5560
70,BUMA.1121.00078,2,749513,755073,-,5560
70,BUMA.1121.00029,2,2136630,2142190,-,5560
70,BUMA.1121.00099,2,2627578,2633133,+,5555
70,BUMA.1121.00103,2,1024737,1030297,+,5560
70,BUMA.1121.00102,2,2411002,2416562,+,5560
70,BUMA.1121.00028,2,1811680,1817240,+,5560
70,BUMA.1121.00075,2,451705,457265,-,5560
70,BUMA.1121.00044,2,1836439,1841999,+,5560
70,BUMA.1121.00076,2,140203,145763,+,5560
70,BUMA.1121.00074,2,1985728,1991288,-,5560
70,BUMA.1121.00073,2,2368904,2374464,+,5560
70,BUMA.1121.00083,2,1039015,1044575,+,5560
70,BUMA.1121.00035,2,2214308,2219868,-,5560
70,BUMA.1121.00072,2,2343406,2348966,+,5560
70,BUMA.1121.00056,2,1618358,1623918,-,5560
70,BUMA.1121.00081,2,313826,319386,-,5560
70,BUMA.1121.00033,2,3181046,3186606,+,5560
70,BUMA.1121.00061,2,2352003,2357563,+,5560
70,BUMA.1121.00062,2,2521387,2526947,-,5560
70,BUMA.1121.00064,2,2288955,2294516,+,5561
70,BUMA.1121.00060,2,2993316,2998876,-,5560
70,BUMA.1121.00069,2,2334781,2340341,+,5560
70,BUMA.1121.00070,2,2348274,2353834,+,5560
70,BUMA.1121.00068,2,974549,980109,+,5560
70,BUMA.1121.00067,2,1540907,1546468,-,5561
70,BUMA.1121.00037,2,2735344,2740904,+,5560
70,BUMA.1121.00065,2,2456324,2461884,+,5560
70,BUMA.1121.00058,2,2991986,2997546,+,5560
70,BUMA.1121.00041,2,113992,119552,+,5560
70,BUMA.1121.00084,2,1097609,1103169,+,5560
70,BUMA.1121.00096,2,2698758,2704318,+,5560
70,BUMA.1121.00080,2,2437581,2443141,+,5560
70,BUMA.1121.00013,2,746087,751647,-,5560
70,BUMA.1121.00100,2,412611,418171,+,5560
70,BUMA.1121.00012,2,2543737,2549297,-,5560
70,BUMA.1121.00018,2,1418727,1424287,-,5560
70,BUMA.1121.00048,2,1053219,1058779,-,5560
70,BUMA.1121.00106,2,1662827,1668387,+,5560
70,BUMA.1121.00017,2,1785538,1791098,+,5560
70,BUMA.1121.00082,2,2415099,2420659,+,5560
69,BUMA.1121.00049,2,1018533,1026712,+,8179
69,BUMA.1121.00055,2,293642,301791,-,8149
69,BUMA.1121.00011,2,993139,1001320,+,8181
69,BUMA.1121.00110,2,2337951,2346131,+,8180
69,BUMA.1121.00109,2,2244844,2253024,-,8180
69,BUMA.1121.00077,2,1269821,1278001,-,8180
69,BUMA.1121.00027,2,292124,300302,+,8178
69,BUMA.1121.00026,2,690007,698156,-,8149
69,BUMA.1121.00021,2,2870809,2878958,+,8149
69,BUMA.1121.00023,2,2512309,2520458,+,8149
69,BUMA.1121.00022,2,1868670,1876819,-,8149
69,BUMA.1121.00034,2,1777195,1785344,+,8149
69,BUMA.1121.00025,2,898680,906829,+,8149
69,BUMA.1121.00031,2,1557460,1565609,+,8149
69,BUMA.1121.00007,2,2497891,2506053,+,8162
69,BUMA.1121.00097,2,2210642,2218799,+,8157
69,BUMA.1121.00008,2,1761432,1769581,+,8149
69,BUMA.1121.00059,2,1217557,1225736,-,8179
69,BUMA.1121.00002,2,241009,249158,+,8149
69,BUMA.1121.00004,2,1761871,1770020,+,8149
69,BUMA.1121.00005,2,1541413,1549561,-,8148
69,BUMA.1121.00111,2,1704601,1712757,+,8156
69,BUMA.1121.00006,2,1994183,2002332,+,8149
69,BUMA.1121.00009,2,1035719,1043898,+,8179
69,BUMA.1121.00094,2,2413588,2421737,+,8149
69,BUMA.1121.00101,2,1032006,1040156,-,8150
69,BUMA.1121.00066,2,2344155,2352332,+,8177
69,BUMA.1121.00095,2,1238051,1246230,+,8179
69,BUMA.1121.00112,2,1990016,1998195,-,8179
69,BUMA.1121.00042,2,1439660,1447809,+,8149
69,BUMA.1121.00032,2,202235,210384,+,8149
69,BUMA.1121.00090,2,112049,120198,+,8149
69,BUMA.1121.00020,2,1762118,1770267,+,8149
69,BUMA.1121.00089,2,2359353,2367502,+,8149
69,BUMA.1121.00051,2,2372835,2380984,+,8149
69,BUMA.1121.00001,2,3023850,3031999,-,8149
69,BUMA.1121.00045,2,2257903,2266059,+,8156
69,BUMA.1121.00043,2,3178998,3187147,-,8149
69,BUMA.1121.00063,2,2353504,2361681,+,8177
69,BUMA.1121.00079,2,2373277,2381426,+,8149
69,BUMA.1121.00071,2,2360281,2368458,+,8177
69,BUMA.1121.00086,2,323560,331709,-,8149
69,BUMA.1121.00024,2,1897071,1905220,+,8149
69,BUMA.1121.00010,2,1093199,1101348,+,8149
69,BUMA.1121.00040,2,279393,287542,-,8149
69,BUMA.1121.00093,2,553069,561218,-,8149
69,BUMA.1121.00091,2,1253232,1261362,-,8130
69,BUMA.1121.00107,2,1411753,1419925,-,8172
69,BUMA.1121.00088,2,2384379,2392558,+,8179
69,BUMA.1121.00047,2,187190,195339,+,8149
69,BUMA.1121.00019,2,1841263,1849412,+,8149
69,BUMA.1121.00087,2,271618,279767,+,8149
69,BUMA.1121.00039,2,1586598,1594754,-,8156
69,BUMA.1121.00030,2,336667,344816,-,8149
69,BUMA.1121.00016,2,1331388,1339537,-,8149
69,BUMA.1121.00092,2,2376794,2384943,+,8149
69,BUMA.1121.00085,2,1485402,1493551,-,8149
69,BUMA.1121.00046,2,1337977,1346126,-,8149
69,BUMA.1121.00003,2,621660,629847,+,8187
69,BUMA.1121.00054,2,1794303,1802452,+,8149
69,BUMA.1121.00015,2,573402,581551,-,8149
69,BUMA.1121.00105,2,51651,59830,-,8179
69,BUMA.1121.00052,2,439040,447189,-,8149
69,BUMA.1121.00053,2,2659765,2667950,+,8185
69,BUMA.1121.00057,2,2858545,2866723,-,8178
69,BUMA.1121.00108,2,2622348,2630528,+,8180
69,BUMA.1121.00050,2,2089020,2097169,+,8149
69,BUMA.1121.00104,2,2465535,2473722,+,8187
69,BUMA.1121.00014,2,2492106,2500255,+,8149
69,BUMA.1121.00036,2,1331506,1339653,+,8147
69,BUMA.1121.00038,2,1895376,1903525,+,8149
69,BUMA.1121.00098,2,2632935,2641092,+,8157
69,BUMA.1121.00078,2,755279,763458,-,8179
69,BUMA.1121.00029,2,2142396,2150546,-,8150
69,BUMA.1121.00099,2,2619188,2627366,+,8178
69,BUMA.1121.00103,2,1016371,1024532,+,8161
69,BUMA.1121.00102,2,2402617,2410796,+,8179
69,BUMA.1121.00028,2,1803326,1811475,+,8149
69,BUMA.1121.00075,2,459149,467298,+,8149
69,BUMA.1121.00044,2,1828085,1836234,+,8149
69,BUMA.1121.00076,2,130170,138319,-,8149
69,BUMA.1121.00074,2,1991494,1999673,-,8179
69,BUMA.1121.00073,2,2360520,2368698,+,8178
69,BUMA.1121.00083,2,1030631,1038809,+,8178
69,BUMA.1121.00035,2,2220074,2228223,-,8149
69,BUMA.1121.00072,2,2335028,2343201,+,8173
69,BUMA.1121.00056,2,1624124,1632273,-,8149
69,BUMA.1121.00081,2,321187,329336,-,8149
69,BUMA.1121.00033,2,3172691,3180840,+,8149
69,BUMA.1121.00061,2,2343619,2351797,+,8178
69,BUMA.1121.00062,2,2527153,2535332,-,8179
69,BUMA.1121.00064,2,2280601,2288750,+,8149
69,BUMA.1121.00060,2,2999081,3007237,-,8156
69,BUMA.1121.00069,2,2326397,2334575,+,8178
69,BUMA.1121.00070,2,2339890,2348068,+,8178
69,BUMA.1121.00068,2,966158,974343,+,8185
69,BUMA.1121.00067,2,1546673,1554822,-,8149
69,BUMA.1121.00037,2,2726989,2735138,+,8149
69,BUMA.1121.00065,2,2447969,2456118,+,8149
69,BUMA.1121.00058,2,2983601,2991780,+,8179
69,BUMA.1121.00041,2,105601,113787,+,8186
69,BUMA.1121.00084,2,1089224,1097403,+,8179
69,BUMA.1121.00096,2,2690373,2698552,+,8179
69,BUMA.1121.00080,2,2429226,2437375,+,8149
69,BUMA.1121.00013,2,751852,760001,-,8149
69,BUMA.1121.00100,2,404225,412405,+,8180
69,BUMA.1121.00012,2,2549491,2557640,-,8149
69,BUMA.1121.00018,2,1426089,1434238,-,8149
69,BUMA.1121.00048,2,1060580,1068729,-,8149
69,BUMA.1121.00106,2,1654472,1662621,+,8149
69,BUMA.1121.00017,2,1777184,1785333,+,8149
69,BUMA.1121.00082,2,2406715,2414893,+,8178
68,BUMA.1121.00049,2,1002768,1015306,+,12538
68,BUMA.1121.00055,2,305018,317558,-,12540
68,BUMA.1121.00011,2,977546,990078,+,12532
68,BUMA.1121.00110,2,2322187,2334724,+,12537
68,BUMA.1121.00109,2,2261459,2274011,-,12552
68,BUMA.1121.00077,2,1281227,1293763,-,12536
68,BUMA.1121.00027,2,276346,288898,+,12552
68,BUMA.1121.00026,2,782136,794649,-,12513
68,BUMA.1121.00021,2,2853706,2866246,+,12540
68,BUMA.1121.00023,2,2496541,2509081,+,12540
68,BUMA.1121.00022,2,1959024,1971546,-,12522
68,BUMA.1121.00034,2,1682348,1694871,+,12523
68,BUMA.1121.00025,2,882912,895452,+,12540
68,BUMA.1121.00031,2,1541673,1554232,+,12559
68,BUMA.1121.00007,2,2427147,2439616,+,12469
68,BUMA.1121.00097,2,2195047,2207580,+,12533
68,BUMA.1121.00008,2,1666579,1679102,+,12523
68,BUMA.1121.00059,2,1228965,1241502,-,12537
68,BUMA.1121.00004,2,1667048,1679571,+,12523
68,BUMA.1121.00005,2,1554117,1566579,-,12462
68,BUMA.1121.00111,2,1688836,1701373,+,12537
68,BUMA.1121.00006,2,1899156,1911679,+,12523
68,BUMA.1121.00009,2,1018502,1031031,+,12529
68,BUMA.1121.00094,2,2397830,2410361,+,12531
68,BUMA.1121.00101,2,1051123,1063654,-,12531
68,BUMA.1121.00066,2,2328392,2340927,+,12535
68,BUMA.1121.00095,2,1222302,1234826,+,12524
68,BUMA.1121.00112,2,2001254,2013751,-,12497
68,BUMA.1121.00042,2,1342754,1355268,+,12514
68,BUMA.1121.00032,2,107422,119945,+,12523
68,BUMA.1121.00090,2,96281,108821,+,12540
68,BUMA.1121.00020,2,1667313,1679836,+,12523
68,BUMA.1121.00089,2,2343594,2356125,+,12531
68,BUMA.1121.00051,2,2357076,2369607,+,12531
68,BUMA.1121.00001,2,3035227,3047748,-,12521
68,BUMA.1121.00045,2,2242302,2254840,+,12538
68,BUMA.1121.00043,2,3203407,3215946,-,12539
68,BUMA.1121.00063,2,2337741,2350276,+,12535
68,BUMA.1121.00079,2,2357513,2370051,+,12538
68,BUMA.1121.00071,2,2344518,2357053,+,12535
68,BUMA.1121.00086,2,414023,426545,-,12522
68,BUMA.1121.00024,2,1802263,1814786,+,12523
68,BUMA.1121.00093,2,564445,576971,-,12526
68,BUMA.1121.00091,2,1264588,1277143,-,12555
68,BUMA.1121.00107,2,1430898,1443438,-,12540
68,BUMA.1121.00088,2,2368621,2381150,+,12529
68,BUMA.1121.00047,2,171426,183961,+,12535
68,BUMA.1121.00019,2,1746458,1758981,+,12523
68,BUMA.1121.00087,2,176781,189304,+,12523
68,BUMA.1121.00039,2,1597982,1610521,-,12539
68,BUMA.1121.00030,2,427140,439662,-,12522
68,BUMA.1121.00016,2,1342766,1355305,-,12539
68,BUMA.1121.00092,2,2361040,2373567,+,12527
68,BUMA.1121.00046,2,1428533,1441055,-,12522
68,BUMA.1121.00003,2,605901,618434,+,12533
68,BUMA.1121.00054,2,1699277,1711800,+,12523
68,BUMA.1121.00105,2,63058,75592,-,12534
68,BUMA.1121.00053,2,2643931,2656538,+,12607
68,BUMA.1121.00057,2,2869950,2882502,-,12552
68,BUMA.1121.00108,2,2582424,2594911,+,12487
68,BUMA.1121.00050,2,1994099,2006622,+,12523
68,BUMA.1121.00104,2,2449787,2462325,+,12538
68,BUMA.1121.00014,2,2476319,2488878,+,12559
68,BUMA.1121.00036,2,1236614,1249137,+,12523
68,BUMA.1121.00038,2,1800350,1812873,+,12523
68,BUMA.1121.00098,2,2617330,2629872,+,12542
68,BUMA.1121.00078,2,778904,791507,-,12603
68,BUMA.1121.00029,2,2153774,2166305,-,12531
68,BUMA.1121.00099,2,2603595,2616125,+,12530
68,BUMA.1121.00103,2,948780,961301,+,12521
68,BUMA.1121.00102,2,2386838,2399390,+,12552
68,BUMA.1121.00028,2,1708511,1721034,+,12523
68,BUMA.1121.00075,2,482653,495184,-,12531
68,BUMA.1121.00044,2,1733239,1745762,+,12523
68,BUMA.1121.00076,2,102281,114815,+,12534
68,BUMA.1121.00074,2,2002900,2015437,-,12537
68,BUMA.1121.00073,2,2344757,2357292,+,12535
68,BUMA.1121.00083,2,1014868,1027403,+,12535
68,BUMA.1121.00035,2,2231451,2243981,-,12530
68,BUMA.1121.00072,2,2319267,2331801,+,12534
68,BUMA.1121.00056,2,1635501,1648031,-,12530
68,BUMA.1121.00081,2,411831,424353,-,12522
68,BUMA.1121.00033,2,3144738,3157252,+,12514
68,BUMA.1121.00061,2,2327856,2340391,+,12535
68,BUMA.1121.00062,2,2538560,2551097,-,12537
68,BUMA.1121.00064,2,2264836,2277374,+,12538
68,BUMA.1121.00060,2,1896,14433,-,12537
68,BUMA.1121.00069,2,2311270,2323805,+,12535
68,BUMA.1121.00070,2,2324127,2336662,+,12535
68,BUMA.1121.00068,2,938192,950707,+,12515
68,BUMA.1121.00067,2,1558049,1570586,-,12537
68,BUMA.1121.00037,2,2711215,2723761,+,12546
68,BUMA.1121.00065,2,2432121,2444742,+,12621
68,BUMA.1121.00058,2,2967832,2980370,+,12538
68,BUMA.1121.00041,2,89795,102374,+,12579
68,BUMA.1121.00084,2,1073438,1085996,+,12558
68,BUMA.1121.00096,2,2674615,2687146,+,12531
68,BUMA.1121.00080,2,2413467,2425998,+,12531
68,BUMA.1121.00013,2,844829,857351,-,12522
68,BUMA.1121.00100,2,377840,390378,+,12538
68,BUMA.1121.00012,2,2588997,2601539,-,12542
68,BUMA.1121.00018,2,1437466,1450006,-,12540
68,BUMA.1121.00048,2,1151232,1163754,-,12522
68,BUMA.1121.00106,2,1638710,1651245,+,12535
68,BUMA.1121.00017,2,1682337,1694860,+,12523
68,BUMA.1121.00082,2,2390952,2403487,+,12535
67,BUMA.1121.00049,2,984730,994137,+,9407
67,BUMA.1121.00055,2,326085,335506,-,9421
67,BUMA.1121.00011,2,959590,969019,+,9429
67,BUMA.1121.00110,2,2304242,2313660,+,9418
67,BUMA.1121.00109,2,2282533,2291959,-,9426
67,BUMA.1121.00077,2,1302290,1311708,-,9418
67,BUMA.1121.00027,2,258389,267819,+,9430
67,BUMA.1121.00021,2,2835780,2845179,+,9399
67,BUMA.1121.00023,2,2478624,2488014,+,9390
67,BUMA.1121.00025,2,864995,874385,+,9390
67,BUMA.1121.00031,2,1523756,1533146,+,9390
67,BUMA.1121.00007,2,2409209,2418620,+,9411
67,BUMA.1121.00097,2,2177100,2186520,+,9420
67,BUMA.1121.00059,2,1250029,1259462,-,9433
67,BUMA.1121.00005,2,1575105,1584537,-,9432
67,BUMA.1121.00111,2,1670919,1680309,+,9390
67,BUMA.1121.00009,2,1000549,1009980,+,9431
67,BUMA.1121.00094,2,2379882,2389303,+,9421
67,BUMA.1121.00101,2,1072181,1081608,-,9427
67,BUMA.1121.00066,2,2310445,2319865,+,9420
67,BUMA.1121.00095,2,1204355,1213775,+,9420
67,BUMA.1121.00112,2,2022278,2031697,-,9419
67,BUMA.1121.00090,2,78355,87754,+,9399
67,BUMA.1121.00089,2,2325646,2335067,+,9421
67,BUMA.1121.00051,2,2339119,2348549,+,9430
67,BUMA.1121.00001,2,3056275,3065665,-,9390
67,BUMA.1121.00045,2,2224303,2233775,+,9472
67,BUMA.1121.00043,2,3224473,3233882,-,9409
67,BUMA.1121.00063,2,2319794,2329214,+,9420
67,BUMA.1121.00079,2,2339552,2348986,+,9434
67,BUMA.1121.00071,2,2326571,2335991,+,9420
67,BUMA.1121.00093,2,585498,594922,-,9424
67,BUMA.1121.00091,2,1285670,1295071,-,9401
67,BUMA.1121.00107,2,1451965,1461394,-,9429
67,BUMA.1121.00088,2,2350673,2360094,+,9421
67,BUMA.1121.00047,2,153469,162899,+,9430
67,BUMA.1121.00039,2,1619048,1628438,-,9390
67,BUMA.1121.00016,2,1363832,1373242,-,9410
67,BUMA.1121.00092,2,2343089,2352513,+,9424
67,BUMA.1121.00003,2,587953,597374,+,9421
67,BUMA.1121.00105,2,84119,93543,-,9424
67,BUMA.1121.00053,2,2625972,2635404,+,9432
67,BUMA.1121.00057,2,2891029,2900459,-,9430
67,BUMA.1121.00108,2,2564477,2573897,+,9420
67,BUMA.1121.00104,2,2431839,2441260,+,9421
67,BUMA.1121.00014,2,2458402,2467792,+,9390
67,BUMA.1121.00098,2,2599373,2608803,+,9430
67,BUMA.1121.00078,2,800034,809685,-,9651
67,BUMA.1121.00029,2,2174832,2184222,-,9390
67,BUMA.1121.00099,2,2585652,2595068,+,9416
67,BUMA.1121.00103,2,930833,940253,+,9420
67,BUMA.1121.00102,2,2368919,2378311,+,9392
67,BUMA.1121.00075,2,503706,513127,-,9421
67,BUMA.1121.00076,2,84338,93759,+,9421
67,BUMA.1121.00074,2,2023964,2033396,-,9432
67,BUMA.1121.00073,2,2326810,2336230,+,9420
67,BUMA.1121.00083,2,996921,1006341,+,9420
67,BUMA.1121.00035,2,2252508,2261898,-,9390
67,BUMA.1121.00072,2,2301320,2310740,+,9420
67,BUMA.1121.00056,2,1656558,1665979,-,9421
67,BUMA.1121.00033,2,3126821,3136211,+,9390
67,BUMA.1121.00061,2,2309909,2319329,+,9420
67,BUMA.1121.00062,2,2559624,2569059,-,9435
67,BUMA.1121.00064,2,2246874,2256309,+,9435
67,BUMA.1121.00060,2,22960,32432,-,9472
67,BUMA.1121.00069,2,2293323,2302743,+,9420
67,BUMA.1121.00070,2,2306180,2315600,+,9420
67,BUMA.1121.00068,2,920259,929665,+,9406
67,BUMA.1121.00067,2,1579113,1588545,-,9432
67,BUMA.1121.00037,2,2693298,2702688,+,9390
67,BUMA.1121.00065,2,2414202,2423594,+,9392
67,BUMA.1121.00058,2,2949872,2959305,+,9433
67,BUMA.1121.00041,2,71840,81268,+,9428
67,BUMA.1121.00084,2,1055478,1064911,+,9433
67,BUMA.1121.00096,2,2656682,2666088,+,9406
67,BUMA.1121.00080,2,2395510,2404940,+,9430
67,BUMA.1121.00100,2,359876,369300,+,9424
67,BUMA.1121.00012,2,2610066,2619456,-,9390
67,BUMA.1121.00018,2,1458533,1467923,-,9390
67,BUMA.1121.00106,2,1620762,1630183,+,9421
67,BUMA.1121.00082,2,2373005,2382425,+,9420
66,BUMA.1121.00049,2,979627,984729,+,5102
66,BUMA.1121.00055,2,335508,340624,-,5116
66,BUMA.1121.00011,2,954481,959589,+,5108
66,BUMA.1121.00110,2,2299133,2304241,+,5108
66,BUMA.1121.00109,2,2291961,2297080,-,5119
66,BUMA.1121.00077,2,1311710,1316815,-,5105
66,BUMA.1121.00027,2,253278,258388,+,5110
66,BUMA.1121.00026,2,803351,808467,-,5116
66,BUMA.1121.00021,2,2830662,2835779,+,5117
66,BUMA.1121.00023,2,2473506,2478623,+,5117
66,BUMA.1121.00022,2,1981348,1986455,-,5107
66,BUMA.1121.00034,2,1667525,1672633,+,5108
66,BUMA.1121.00025,2,859877,864994,+,5117
66,BUMA.1121.00031,2,1518638,1523755,+,5117
66,BUMA.1121.00007,2,2404109,2409208,+,5099
66,BUMA.1121.00097,2,2171982,2177099,+,5117
66,BUMA.1121.00008,2,1651756,1656864,+,5108
66,BUMA.1121.00059,2,1259464,1264574,-,5110
66,BUMA.1121.00002,2,155392,160500,+,5108
66,BUMA.1121.00004,2,1652225,1657333,+,5108
66,BUMA.1121.00005,2,1584539,1589655,-,5116
66,BUMA.1121.00111,2,1665801,1670918,+,5117
66,BUMA.1121.00006,2,402020,407127,-,5107
66,BUMA.1121.00009,2,995431,1000548,+,5117
66,BUMA.1121.00094,2,2374764,2379881,+,5117
66,BUMA.1121.00101,2,1081610,1086716,-,5106
66,BUMA.1121.00066,2,2305327,2310444,+,5117
66,BUMA.1121.00095,2,1199246,1204354,+,5108
66,BUMA.1121.00112,2,2031699,2036815,-,5116
66,BUMA.1121.00042,2,2109152,2114268,-,5116
66,BUMA.1121.00032,2,92599,97707,+,5108
66,BUMA.1121.00090,2,73237,78354,+,5117
66,BUMA.1121.00020,2,1652490,1657598,+,5108
66,BUMA.1121.00089,2,2320528,2325645,+,5117
66,BUMA.1121.00051,2,2334001,2339118,+,5117
66,BUMA.1121.00001,2,3065667,3070782,-,5115
66,BUMA.1121.00045,2,2219194,2224302,+,5108
66,BUMA.1121.00043,2,3233884,3238862,-,4978
66,BUMA.1121.00063,2,2314676,2319793,+,5117
66,BUMA.1121.00079,2,2334440,2339551,+,5111
66,BUMA.1121.00071,2,2321453,2326570,+,5117
66,BUMA.1121.00086,2,436347,441454,-,5107
66,BUMA.1121.00024,2,1787440,1792548,+,5108
66,BUMA.1121.00010,2,1007573,1012681,+,5108
66,BUMA.1121.00040,2,368061,373168,-,5107
66,BUMA.1121.00093,2,594924,600034,-,5110
66,BUMA.1121.00091,2,1295073,1300189,-,5116
66,BUMA.1121.00107,2,1461396,1466503,-,5107
66,BUMA.1121.00088,2,2345561,2350672,+,5111
66,BUMA.1121.00047,2,148351,153468,+,5117
66,BUMA.1121.00019,2,1731635,1736743,+,5108
66,BUMA.1121.00087,2,161871,166979,+,5108
66,BUMA.1121.00039,2,1628440,1633556,-,5116
66,BUMA.1121.00030,2,449378,454485,-,5107
66,BUMA.1121.00016,2,1373244,1378222,-,4978
66,BUMA.1121.00092,2,2337977,2343088,+,5111
66,BUMA.1121.00085,2,1576529,1581636,-,5107
66,BUMA.1121.00046,2,609356,614464,+,5108
66,BUMA.1121.00003,2,582835,587952,+,5117
66,BUMA.1121.00054,2,202179,207286,-,5107
66,BUMA.1121.00015,2,2084168,2089276,+,5108
66,BUMA.1121.00105,2,93545,98655,-,5110
66,BUMA.1121.00052,2,530167,535274,-,5107
66,BUMA.1121.00053,2,2620854,2625971,+,5117
66,BUMA.1121.00057,2,2900461,2905568,-,5107
66,BUMA.1121.00108,2,2559365,2564476,+,5111
66,BUMA.1121.00050,2,499180,504287,-,5107
66,BUMA.1121.00104,2,2426736,2431838,+,5102
66,BUMA.1121.00014,2,2453284,2458401,+,5117
66,BUMA.1121.00036,2,1221705,1226813,+,5108
66,BUMA.1121.00038,2,402054,407161,-,5107
66,BUMA.1121.00098,2,2594264,2599372,+,5108
66,BUMA.1121.00078,2,809687,814803,-,5116
66,BUMA.1121.00029,2,2184224,2189340,-,5116
66,BUMA.1121.00099,2,2580536,2585651,+,5115
66,BUMA.1121.00103,2,925717,930832,+,5115
66,BUMA.1121.00102,2,2363801,2368918,+,5117
66,BUMA.1121.00028,2,1693688,1698796,+,5108
66,BUMA.1121.00075,2,513129,518245,-,5116
66,BUMA.1121.00044,2,1718416,1723524,+,5108
66,BUMA.1121.00076,2,79220,84337,+,5117
66,BUMA.1121.00074,2,2033398,2038499,-,5101
66,BUMA.1121.00073,2,2321692,2326809,+,5117
66,BUMA.1121.00083,2,991803,996920,+,5117
66,BUMA.1121.00035,2,2261900,2267016,-,5116
66,BUMA.1121.00072,2,2296203,2301319,+,5116
66,BUMA.1121.00056,2,1665981,1671097,-,5116
66,BUMA.1121.00081,2,1916379,1921487,+,5108
66,BUMA.1121.00033,2,3121705,3126820,+,5115
66,BUMA.1121.00061,2,2304791,2309908,+,5117
66,BUMA.1121.00062,2,2569061,2574171,-,5110
66,BUMA.1121.00064,2,2241762,2246873,+,5111
66,BUMA.1121.00060,2,32434,37541,-,5107
66,BUMA.1121.00069,2,2288205,2293322,+,5117
66,BUMA.1121.00070,2,2301062,2306179,+,5117
66,BUMA.1121.00068,2,915155,920257,+,5102
66,BUMA.1121.00067,2,1588547,1593657,-,5110
66,BUMA.1121.00037,2,2688180,2693297,+,5117
66,BUMA.1121.00065,2,2409086,2414201,+,5115
66,BUMA.1121.00058,2,2944769,2949871,+,5102
66,BUMA.1121.00041,2,66722,71839,+,5117
66,BUMA.1121.00084,2,1050366,1055477,+,5111
66,BUMA.1121.00096,2,2651569,2656680,+,5111
66,BUMA.1121.00080,2,2390392,2395509,+,5117
66,BUMA.1121.00013,2,867153,872260,-,5107
66,BUMA.1121.00100,2,354763,359874,+,5111
66,BUMA.1121.00012,2,2619458,2624574,-,5116
66,BUMA.1121.00018,2,1467925,1473041,-,5116
66,BUMA.1121.00048,2,330419,335527,+,5108
66,BUMA.1121.00106,2,1615659,1620761,+,5102
66,BUMA.1121.00017,2,1667514,1672622,+,5108
66,BUMA.1121.00082,2,2367887,2373004,+,5117
65,BUMA.1121.00049,2,966160,979626,+,13466
65,BUMA.1121.00055,2,340626,354083,-,13457
65,BUMA.1121.00011,2,941021,954480,+,13459
65,BUMA.1121.00110,2,2285673,2299132,+,13459
65,BUMA.1121.00109,2,2297082,2310540,-,13458
65,BUMA.1121.00077,2,1316817,1330275,-,13458
65,BUMA.1121.00027,2,239811,253277,+,13466
65,BUMA.1121.00026,2,808469,821927,-,13458
65,BUMA.1121.00021,2,2817202,2830661,+,13459
65,BUMA.1121.00023,2,2460046,2473505,+,13459
65,BUMA.1121.00022,2,1986457,1999900,-,13443
65,BUMA.1121.00034,2,1654065,1667524,+,13459
65,BUMA.1121.00025,2,846417,859876,+,13459
65,BUMA.1121.00031,2,1505178,1518637,+,13459
65,BUMA.1121.00007,2,2390649,2404108,+,13459
65,BUMA.1121.00097,2,2158523,2171981,+,13458
65,BUMA.1121.00008,2,1638296,1651755,+,13459
65,BUMA.1121.00059,2,1264576,1278041,-,13465
65,BUMA.1121.00002,2,141932,155391,+,13459
65,BUMA.1121.00004,2,1638765,1652224,+,13459
65,BUMA.1121.00005,2,1589657,1603115,-,13458
65,BUMA.1121.00111,2,1652340,1665800,+,13460
65,BUMA.1121.00006,2,407129,420587,-,13458
65,BUMA.1121.00009,2,981971,995430,+,13459
65,BUMA.1121.00094,2,2361304,2374763,+,13459
65,BUMA.1121.00101,2,1086718,1100176,-,13458
65,BUMA.1121.00066,2,2291867,2305326,+,13459
65,BUMA.1121.00095,2,1185786,1199245,+,13459
65,BUMA.1121.00112,2,2036817,2050275,-,13458
65,BUMA.1121.00042,2,2114270,2127728,-,13458
65,BUMA.1121.00032,2,79139,92598,+,13459
65,BUMA.1121.00090,2,59777,73236,+,13459
65,BUMA.1121.00020,2,1639030,1652489,+,13459
65,BUMA.1121.00089,2,2307068,2320527,+,13459
65,BUMA.1121.00051,2,2320541,2334000,+,13459
65,BUMA.1121.00001,2,3070784,3084242,-,13458
65,BUMA.1121.00045,2,2205734,2219193,+,13459
65,BUMA.1121.00043,2,3238864,3252322,-,13458
65,BUMA.1121.00063,2,2301216,2314675,+,13459
65,BUMA.1121.00079,2,2320973,2334439,+,13466
65,BUMA.1121.00071,2,2307993,2321452,+,13459
65,BUMA.1121.00086,2,441456,454914,-,13458
65,BUMA.1121.00024,2,1773980,1787439,+,13459
65,BUMA.1121.00010,2,994113,1007572,+,13459
65,BUMA.1121.00040,2,373170,386628,-,13458
65,BUMA.1121.00093,2,600036,613501,-,13465
65,BUMA.1121.00091,2,1300191,1313648,-,13457
65,BUMA.1121.00107,2,1466505,1479963,-,13458
65,BUMA.1121.00088,2,2332094,2345560,+,13466
65,BUMA.1121.00047,2,134891,148350,+,13459
65,BUMA.1121.00019,2,1718175,1731634,+,13459
65,BUMA.1121.00087,2,148411,161870,+,13459
65,BUMA.1121.00039,2,1633558,1647016,-,13458
65,BUMA.1121.00030,2,454487,467945,-,13458
65,BUMA.1121.00016,2,1378224,1391682,-,13458
65,BUMA.1121.00092,2,2324510,2337976,+,13466
65,BUMA.1121.00085,2,1581638,1595096,-,13458
65,BUMA.1121.00046,2,595896,609355,+,13459
65,BUMA.1121.00003,2,569375,582834,+,13459
65,BUMA.1121.00054,2,207288,220746,-,13458
65,BUMA.1121.00015,2,2070708,2084167,+,13459
65,BUMA.1121.00105,2,98657,112122,-,13465
65,BUMA.1121.00052,2,535276,548734,-,13458
65,BUMA.1121.00053,2,2607395,2620853,+,13458
65,BUMA.1121.00057,2,2905570,2919028,-,13458
65,BUMA.1121.00108,2,2545898,2559364,+,13466
65,BUMA.1121.00050,2,504289,517747,-,13458
65,BUMA.1121.00104,2,2413269,2426735,+,13466
65,BUMA.1121.00014,2,2439824,2453283,+,13459
65,BUMA.1121.00036,2,1208245,1221704,+,13459
65,BUMA.1121.00038,2,407163,420621,-,13458
65,BUMA.1121.00098,2,2580804,2594263,+,13459
65,BUMA.1121.00078,2,814805,828262,-,13457
65,BUMA.1121.00029,2,2189342,2202800,-,13458
65,BUMA.1121.00099,2,2565491,2578945,+,13454
65,BUMA.1121.00103,2,910954,924424,+,13470
65,BUMA.1121.00102,2,2350342,2363800,+,13458
65,BUMA.1121.00028,2,1680228,1693687,+,13459
65,BUMA.1121.00075,2,518247,531704,-,13457
65,BUMA.1121.00044,2,1704956,1718415,+,13459
65,BUMA.1121.00076,2,65760,79219,+,13459
65,BUMA.1121.00074,2,2038501,2051966,-,13465
65,BUMA.1121.00073,2,2308232,2321691,+,13459
65,BUMA.1121.00083,2,978343,991802,+,13459
65,BUMA.1121.00035,2,2267018,2280476,-,13458
65,BUMA.1121.00072,2,2282743,2296202,+,13459
65,BUMA.1121.00056,2,1671099,1684557,-,13458
65,BUMA.1121.00081,2,1902919,1916378,+,13459
65,BUMA.1121.00033,2,3108245,3121704,+,13459
65,BUMA.1121.00061,2,2291331,2304790,+,13459
65,BUMA.1121.00062,2,2574173,2587638,-,13465
65,BUMA.1121.00064,2,2228295,2241761,+,13466
65,BUMA.1121.00060,2,37543,51001,-,13458
65,BUMA.1121.00069,2,2274745,2288204,+,13459
65,BUMA.1121.00070,2,2287602,2301061,+,13459
65,BUMA.1121.00068,2,901695,915154,+,13459
65,BUMA.1121.00067,2,1593659,1607124,-,13465
65,BUMA.1121.00037,2,2674720,2688179,+,13459
65,BUMA.1121.00065,2,2395627,2409085,+,13458
65,BUMA.1121.00058,2,2931302,2944768,+,13466
65,BUMA.1121.00041,2,53262,66721,+,13459
65,BUMA.1121.00084,2,1036899,1050365,+,13466
65,BUMA.1121.00096,2,2638109,2651568,+,13459
65,BUMA.1121.00080,2,2376932,2390391,+,13459
65,BUMA.1121.00013,2,872262,885720,-,13458
65,BUMA.1121.00100,2,341303,354762,+,13459
65,BUMA.1121.00012,2,2624576,2638034,-,13458
65,BUMA.1121.00018,2,1473043,1486501,-,13458
65,BUMA.1121.00048,2,316959,330418,+,13459
65,BUMA.1121.00106,2,1602192,1615658,+,13466
65,BUMA.1121.00017,2,1654054,1667513,+,13459
65,BUMA.1121.00082,2,2354427,2367886,+,13459
64,BUMA.1121.00049,2,949516,962542,+,13026
64,BUMA.1121.00055,2,357702,370705,-,13003
64,BUMA.1121.00011,2,924393,937403,+,13010
64,BUMA.1121.00110,2,2268989,2282055,+,13066
64,BUMA.1121.00109,2,2314159,2327164,-,13005
64,BUMA.1121.00077,2,1333894,1346957,-,13063
64,BUMA.1121.00027,2,223180,236193,+,13013
64,BUMA.1121.00026,2,930197,943178,-,12981
64,BUMA.1121.00021,2,2800581,2813584,+,13003
64,BUMA.1121.00023,2,2443418,2456428,+,13010
64,BUMA.1121.00022,2,2004758,2017739,-,12981
64,BUMA.1121.00034,2,1636227,1649208,+,12981
64,BUMA.1121.00025,2,829796,842799,+,13003
64,BUMA.1121.00031,2,1488556,1501560,+,13004
64,BUMA.1121.00007,2,2374027,2387031,+,13004
64,BUMA.1121.00097,2,2141903,2154905,+,13002
64,BUMA.1121.00008,2,1620458,1633439,+,12981
64,BUMA.1121.00059,2,1281660,1294650,-,12990
64,BUMA.1121.00002,2,124094,137075,+,12981
64,BUMA.1121.00004,2,1620927,1633908,+,12981
64,BUMA.1121.00005,2,1606734,1619729,-,12995
64,BUMA.1121.00111,2,1635720,1648723,+,13003
64,BUMA.1121.00006,2,425445,438426,-,12981
64,BUMA.1121.00009,2,965354,978353,+,12999
64,BUMA.1121.00094,2,2344659,2357686,+,13027
64,BUMA.1121.00101,2,1103795,1116808,-,13013
64,BUMA.1121.00066,2,2275228,2288249,+,13021
64,BUMA.1121.00095,2,1169164,1182168,+,13004
64,BUMA.1121.00112,2,2053894,2066897,-,13003
64,BUMA.1121.00042,2,1318767,1331748,+,12981
64,BUMA.1121.00032,2,61301,74282,+,12981
64,BUMA.1121.00090,2,43157,56159,+,13002
64,BUMA.1121.00020,2,1621192,1634173,+,12981
64,BUMA.1121.00089,2,2290450,2303450,+,13000
64,BUMA.1121.00051,2,2303923,2316923,+,13000
64,BUMA.1121.00001,2,3087861,3100864,-,13003
64,BUMA.1121.00045,2,2189107,2202116,+,13009
64,BUMA.1121.00043,2,3255941,3268944,-,13003
64,BUMA.1121.00063,2,2284577,2297598,+,13021
64,BUMA.1121.00079,2,2304333,2317355,+,13022
64,BUMA.1121.00071,2,2291374,2304375,+,13001
64,BUMA.1121.00086,2,459772,472753,-,12981
64,BUMA.1121.00024,2,1756142,1769123,+,12981
64,BUMA.1121.00010,2,976275,989256,+,12981
64,BUMA.1121.00040,2,391486,404467,-,12981
64,BUMA.1121.00093,2,617120,630121,-,13001
64,BUMA.1121.00091,2,1317267,1330270,-,13003
64,BUMA.1121.00107,2,1483583,1496594,-,13011
64,BUMA.1121.00088,2,2315472,2328476,+,13004
64,BUMA.1121.00047,2,118273,131273,+,13000
64,BUMA.1121.00019,2,1700337,1713318,+,12981
64,BUMA.1121.00087,2,130573,143554,+,12981
64,BUMA.1121.00039,2,1650635,1663638,-,13003
64,BUMA.1121.00030,2,472803,485784,-,12981
64,BUMA.1121.00016,2,1395301,1408303,-,13002
64,BUMA.1121.00092,2,2307891,2320892,+,13001
64,BUMA.1121.00085,2,1599954,1612935,-,12981
64,BUMA.1121.00046,2,578058,591039,+,12981
64,BUMA.1121.00003,2,552767,565757,+,12990
64,BUMA.1121.00054,2,225604,238585,-,12981
64,BUMA.1121.00015,2,2052870,2065851,+,12981
64,BUMA.1121.00105,2,115741,128745,-,13004
64,BUMA.1121.00052,2,553592,566573,-,12981
64,BUMA.1121.00053,2,2590793,2603777,+,12984
64,BUMA.1121.00057,2,2922647,2935660,-,13013
64,BUMA.1121.00108,2,2527837,2540766,+,12929
64,BUMA.1121.00050,2,522605,535586,-,12981
64,BUMA.1121.00104,2,2396650,2409651,+,13001
64,BUMA.1121.00014,2,2423202,2436206,+,13004
64,BUMA.1121.00036,2,1190407,1203388,+,12981
64,BUMA.1121.00038,2,425479,438460,-,12981
64,BUMA.1121.00098,2,2564177,2577186,+,13009
64,BUMA.1121.00078,2,831881,844856,-,12975
64,BUMA.1121.00029,2,2206419,2219422,-,13003
64,BUMA.1121.00099,2,2548861,2561873,+,13012
64,BUMA.1121.00103,2,894326,907336,+,13010
64,BUMA.1121.00102,2,2333740,2346724,+,12984
64,BUMA.1121.00028,2,1662390,1675371,+,12981
64,BUMA.1121.00075,2,535323,548244,-,12921
64,BUMA.1121.00044,2,1687118,1700099,+,12981
64,BUMA.1121.00076,2,49220,62142,+,12922
64,BUMA.1121.00074,2,2055585,2068589,-,13004
64,BUMA.1121.00073,2,2291583,2304614,+,13031
64,BUMA.1121.00083,2,961686,974725,+,13039
64,BUMA.1121.00035,2,2284095,2297098,-,13003
64,BUMA.1121.00072,2,2266113,2279125,+,13012
64,BUMA.1121.00056,2,1688176,1701176,-,13000
64,BUMA.1121.00081,2,1885081,1898062,+,12981
64,BUMA.1121.00033,2,3091625,3104627,+,13002
64,BUMA.1121.00061,2,2274692,2287713,+,13021
64,BUMA.1121.00062,2,2591257,2604285,-,13028
64,BUMA.1121.00064,2,2211648,2224677,+,13029
64,BUMA.1121.00060,2,54620,67629,-,13009
64,BUMA.1121.00069,2,2258107,2271127,+,13020
64,BUMA.1121.00070,2,2270955,2283984,+,13029
64,BUMA.1121.00068,2,885056,898077,+,13021
64,BUMA.1121.00067,2,1610743,1623745,-,13002
64,BUMA.1121.00037,2,2658098,2671102,+,13004
64,BUMA.1121.00065,2,2378987,2392009,+,13022
64,BUMA.1121.00058,2,2914661,2927684,+,13023
64,BUMA.1121.00041,2,36653,49644,+,12991
64,BUMA.1121.00084,2,1020280,1033281,+,13001
64,BUMA.1121.00096,2,2621473,2634479,+,13006
64,BUMA.1121.00080,2,2360314,2373314,+,13000
64,BUMA.1121.00013,2,890578,903559,-,12981
64,BUMA.1121.00100,2,324681,337685,+,13004
64,BUMA.1121.00012,2,2641653,2654657,-,13004
64,BUMA.1121.00018,2,1490120,1503123,-,13003
64,BUMA.1121.00048,2,299121,312102,+,12981
64,BUMA.1121.00106,2,1585572,1598574,+,13002
64,BUMA.1121.00017,2,1636216,1649197,+,12981
64,BUMA.1121.00082,2,2337770,2350809,+,13039
63,BUMA.1121.00049,2,924024,948763,+,24739
63,BUMA.1121.00055,2,371469,396180,-,24711
63,BUMA.1121.00011,2,898904,923607,+,24703
63,BUMA.1121.00110,2,2243524,2268203,+,24679
63,BUMA.1121.00109,2,2327949,2352663,-,24714
63,BUMA.1121.00077,2,1347742,1372415,-,24673
63,BUMA.1121.00027,2,197660,222394,+,24734
63,BUMA.1121.00026,2,943963,968683,-,24720
63,BUMA.1121.00021,2,2775056,2799795,+,24739
63,BUMA.1121.00023,2,2417893,2442632,+,24739
63,BUMA.1121.00022,2,2018524,2043106,-,24582
63,BUMA.1121.00034,2,1610842,1635441,+,24599
63,BUMA.1121.00025,2,804250,829010,+,24760
63,BUMA.1121.00031,2,1463038,1487770,+,24732
63,BUMA.1121.00007,2,2348506,2373241,+,24735
63,BUMA.1121.00097,2,2116382,2141117,+,24735
63,BUMA.1121.00008,2,1595073,1619672,+,24599
63,BUMA.1121.00059,2,1295435,1320155,-,24720
63,BUMA.1121.00002,2,98726,123308,+,24582
63,BUMA.1121.00004,2,1595542,1620141,+,24599
63,BUMA.1121.00005,2,1620493,1645208,-,24715
63,BUMA.1121.00111,2,1610188,1634934,+,24746
63,BUMA.1121.00006,2,439211,463713,-,24502
63,BUMA.1121.00009,2,939834,964557,+,24723
63,BUMA.1121.00094,2,2319153,2343873,+,24720
63,BUMA.1121.00101,2,1117593,1142318,-,24725
63,BUMA.1121.00066,2,2249706,2274442,+,24736
63,BUMA.1121.00095,2,1143670,1168378,+,24708
63,BUMA.1121.00112,2,2067682,2092423,-,24741
63,BUMA.1121.00042,2,1293275,1317981,+,24706
63,BUMA.1121.00032,2,35916,60515,+,24599
63,BUMA.1121.00090,2,17632,42371,+,24739
63,BUMA.1121.00020,2,1595807,1620406,+,24599
63,BUMA.1121.00089,2,2264944,2289664,+,24720
63,BUMA.1121.00051,2,2278419,2303137,+,24718
63,BUMA.1121.00001,2,3101649,3126381,-,24732
63,BUMA.1121.00045,2,2163590,2188321,+,24731
63,BUMA.1121.00043,2,40,24780,-,24740
63,BUMA.1121.00063,2,2259078,2283805,+,24727
63,BUMA.1121.00079,2,2278850,2303547,+,24697
63,BUMA.1121.00071,2,2265848,2290588,+,24740
63,BUMA.1121.00086,2,473538,498120,-,24582
63,BUMA.1121.00024,2,1730757,1755356,+,24599
63,BUMA.1121.00010,2,950907,975489,+,24582
63,BUMA.1121.00040,2,405252,429817,-,24565
63,BUMA.1121.00093,2,630906,655625,-,24719
63,BUMA.1121.00091,2,1331034,1357074,-,26040
63,BUMA.1121.00107,2,1497379,1522091,-,24712
63,BUMA.1121.00088,2,2289960,2314686,+,24726
63,BUMA.1121.00047,2,92767,117487,+,24720
63,BUMA.1121.00019,2,1674952,1699551,+,24599
63,BUMA.1121.00087,2,105205,129787,+,24582
63,BUMA.1121.00039,2,1664423,1689145,-,24722
63,BUMA.1121.00030,2,486569,511167,-,24598
63,BUMA.1121.00016,2,1409088,1433840,-,24752
63,BUMA.1121.00092,2,2282386,2307105,+,24719
63,BUMA.1121.00085,2,1613720,1638292,-,24572
63,BUMA.1121.00046,2,552797,577272,+,24475
63,BUMA.1121.00003,2,527226,551966,+,24740
63,BUMA.1121.00054,2,239370,263872,-,24502
63,BUMA.1121.00015,2,2027623,2052084,+,24461
63,BUMA.1121.00105,2,129530,154253,-,24723
63,BUMA.1121.00052,2,567358,591930,-,24572
63,BUMA.1121.00053,2,2565285,2590007,+,24722
63,BUMA.1121.00057,2,2936445,2961185,-,24740
63,BUMA.1121.00108,2,2502319,2527051,+,24732
63,BUMA.1121.00050,2,536371,560846,-,24475
63,BUMA.1121.00104,2,2371128,2395864,+,24736
63,BUMA.1121.00014,2,2397684,2422416,+,24732
63,BUMA.1121.00036,2,1165039,1189621,+,24582
63,BUMA.1121.00038,2,439245,463747,-,24502
63,BUMA.1121.00098,2,2538685,2563391,+,24706
63,BUMA.1121.00078,2,845641,870340,-,24699
63,BUMA.1121.00029,2,2220207,2244953,-,24746
63,BUMA.1121.00099,2,2523366,2548075,+,24709
63,BUMA.1121.00103,2,868813,893525,+,24712
63,BUMA.1121.00102,2,2308235,2332954,+,24719
63,BUMA.1121.00028,2,1637005,1661604,+,24599
63,BUMA.1121.00075,2,549040,573775,-,24735
63,BUMA.1121.00044,2,1661733,1686332,+,24599
63,BUMA.1121.00076,2,23686,48423,+,24737
63,BUMA.1121.00074,2,2069392,2094117,-,24725
63,BUMA.1121.00073,2,2266076,2290810,+,24734
63,BUMA.1121.00083,2,936159,960900,+,24741
63,BUMA.1121.00035,2,2297883,2322615,-,24732
63,BUMA.1121.00072,2,2240586,2265327,+,24741
63,BUMA.1121.00056,2,1701961,1726681,-,24720
63,BUMA.1121.00081,2,1859794,1884295,+,24501
63,BUMA.1121.00033,2,3066090,3090839,+,24749
63,BUMA.1121.00061,2,2249179,2273920,+,24741
63,BUMA.1121.00062,2,2605070,2629817,-,24747
63,BUMA.1121.00064,2,2186137,2210862,+,24725
63,BUMA.1121.00060,2,68414,93145,-,24731
63,BUMA.1121.00069,2,2232590,2257321,+,24731
63,BUMA.1121.00070,2,2245449,2270183,+,24734
63,BUMA.1121.00068,2,859546,884270,+,24724
63,BUMA.1121.00067,2,1624548,1649268,-,24720
63,BUMA.1121.00037,2,2632573,2657312,+,24739
63,BUMA.1121.00065,2,2353488,2378201,+,24713
63,BUMA.1121.00058,2,2889142,2913875,+,24733
63,BUMA.1121.00041,2,11125,35856,+,24731
63,BUMA.1121.00084,2,994774,1019494,+,24720
63,BUMA.1121.00096,2,2595979,2620687,+,24708
63,BUMA.1121.00080,2,2334801,2359528,+,24727
63,BUMA.1121.00013,2,904344,928912,-,24568
63,BUMA.1121.00100,2,299163,323895,+,24732
63,BUMA.1121.00012,2,2655442,2680156,-,24714
63,BUMA.1121.00018,2,1503908,1528668,-,24760
63,BUMA.1121.00048,2,273833,298335,+,24502
63,BUMA.1121.00106,2,1560060,1584786,+,24726
63,BUMA.1121.00017,2,1610831,1635430,+,24599
63,BUMA.1121.00082,2,2312243,2336984,+,24741
62,BUMA.1121.00049,2,914280,920273,+,5993
62,BUMA.1121.00055,2,400012,406053,-,6041
62,BUMA.1121.00011,2,888968,895112,+,6144
62,BUMA.1121.00110,2,2233621,2239738,+,6117
62,BUMA.1121.00109,2,2356379,2362469,-,6090
62,BUMA.1121.00077,2,1376201,1382469,-,6268
62,BUMA.1121.00027,2,187860,193914,+,6054
62,BUMA.1121.00026,2,973637,979596,-,5959
62,BUMA.1121.00021,2,2763833,2769987,+,6154
62,BUMA.1121.00023,2,2407923,2414185,+,6262
62,BUMA.1121.00022,2,2046813,2052825,-,6012
62,BUMA.1121.00034,2,1601133,1607136,+,6003
62,BUMA.1121.00025,2,794335,800542,+,6207
62,BUMA.1121.00031,2,1453154,1459302,+,6148
62,BUMA.1121.00007,2,2338608,2344686,+,6078
62,BUMA.1121.00097,2,2106407,2112659,+,6252
62,BUMA.1121.00008,2,1585364,1591367,+,6003
62,BUMA.1121.00059,2,1323914,1329976,-,6062
62,BUMA.1121.00002,2,89063,95027,+,5964
62,BUMA.1121.00004,2,1585833,1591836,+,6003
62,BUMA.1121.00005,2,1648911,1654944,-,6033
62,BUMA.1121.00111,2,1600355,1606459,+,6104
62,BUMA.1121.00006,2,467420,473415,-,5995
62,BUMA.1121.00009,2,929906,936077,+,6171
62,BUMA.1121.00094,2,2309306,2315424,+,6118
62,BUMA.1121.00101,2,1146072,1152127,-,6055
62,BUMA.1121.00066,2,2239906,2245982,+,6076
62,BUMA.1121.00095,2,1133891,1139928,+,6037
62,BUMA.1121.00112,2,2096189,2102221,-,6032
62,BUMA.1121.00042,2,1283625,1289583,+,5958
62,BUMA.1121.00032,2,26223,32210,+,5987
62,BUMA.1121.00090,2,7766,13868,+,6102
62,BUMA.1121.00020,2,1586098,1592101,+,6003
62,BUMA.1121.00089,2,2255073,2261193,+,6120
62,BUMA.1121.00051,2,2268574,2274633,+,6059
62,BUMA.1121.00001,2,3130119,3136242,-,6123
62,BUMA.1121.00045,2,2153820,2159853,+,6033
62,BUMA.1121.00043,2,28565,34679,-,6114
62,BUMA.1121.00063,2,2249273,2255347,+,6074
62,BUMA.1121.00079,2,2267678,2273736,+,6058
62,BUMA.1121.00071,2,2256061,2262137,+,6076
62,BUMA.1121.00086,2,501827,507816,-,5989
62,BUMA.1121.00024,2,1721048,1727051,+,6003
62,BUMA.1121.00010,2,941244,947208,+,5964
62,BUMA.1121.00040,2,433517,439532,-,6015
62,BUMA.1121.00093,2,659405,665483,-,6078
62,BUMA.1121.00091,2,1360791,1366818,-,6027
62,BUMA.1121.00107,2,1525841,1531940,-,6099
62,BUMA.1121.00088,2,2280205,2286202,+,5997
62,BUMA.1121.00047,2,82826,88967,+,6141
62,BUMA.1121.00019,2,1665243,1671246,+,6003
62,BUMA.1121.00087,2,95509,101499,+,5990
62,BUMA.1121.00039,2,1692861,1698855,-,5994
62,BUMA.1121.00030,2,514874,520876,-,6002
62,BUMA.1121.00016,2,1437564,1443690,-,6126
62,BUMA.1121.00092,2,2272479,2278607,+,6128
62,BUMA.1121.00085,2,1641999,1647959,-,5960
62,BUMA.1121.00046,2,543091,549091,+,6000
62,BUMA.1121.00003,2,517487,523456,+,5969
62,BUMA.1121.00054,2,267579,273567,-,5988
62,BUMA.1121.00015,2,2017919,2023917,+,5998
62,BUMA.1121.00105,2,158026,164128,-,6102
62,BUMA.1121.00052,2,595637,601597,-,5960
62,BUMA.1121.00053,2,2555350,2561555,+,6205
62,BUMA.1121.00057,2,2964933,2971118,-,6185
62,BUMA.1121.00108,2,2492499,2498569,+,6070
62,BUMA.1121.00050,2,564553,570575,-,6022
62,BUMA.1121.00104,2,2361329,2367384,+,6055
62,BUMA.1121.00014,2,2387799,2393928,+,6129
62,BUMA.1121.00036,2,1155327,1161326,+,5999
62,BUMA.1121.00038,2,467454,473442,-,5988
62,BUMA.1121.00098,2,2528825,2534878,+,6053
62,BUMA.1121.00078,2,874085,880041,-,5956
62,BUMA.1121.00029,2,2248698,2254838,-,6140
62,BUMA.1121.00099,2,2513525,2519644,+,6119
62,BUMA.1121.00103,2,859026,865084,+,6058
62,BUMA.1121.00102,2,2298196,2304491,+,6295
62,BUMA.1121.00028,2,1627324,1633299,+,5975
62,BUMA.1121.00075,2,577509,583513,-,6004
62,BUMA.1121.00044,2,1652024,1658027,+,6003
62,BUMA.1121.00076,2,13826,19952,+,6126
62,BUMA.1121.00074,2,2097890,2104020,-,6130
62,BUMA.1121.00073,2,2256279,2262352,+,6073
62,BUMA.1121.00083,2,926352,932430,+,6078
62,BUMA.1121.00035,2,2326353,2332514,-,6161
62,BUMA.1121.00072,2,2230787,2236862,+,6075
62,BUMA.1121.00056,2,1730433,1736566,-,6133
62,BUMA.1121.00081,2,1850099,1856088,+,5989
62,BUMA.1121.00033,2,3056241,3062355,+,6114
62,BUMA.1121.00061,2,2239381,2245448,+,6067
62,BUMA.1121.00062,2,2633590,2639637,-,6047
62,BUMA.1121.00064,2,2176162,2182344,+,6182
62,BUMA.1121.00060,2,96883,102894,-,6011
62,BUMA.1121.00069,2,2222783,2228859,+,6076
62,BUMA.1121.00070,2,2235649,2241725,+,6076
62,BUMA.1121.00068,2,849702,855792,+,6090
62,BUMA.1121.00067,2,1652985,1659026,-,6041
62,BUMA.1121.00037,2,2622651,2628865,+,6214
62,BUMA.1121.00065,2,2343623,2349751,+,6128
62,BUMA.1121.00058,2,2879313,2885342,+,6029
62,BUMA.1121.00041,2,1257,7342,+,6085
62,BUMA.1121.00084,2,985007,991059,+,6052
62,BUMA.1121.00096,2,2586140,2592201,+,6061
62,BUMA.1121.00080,2,2324888,2330996,+,6108
62,BUMA.1121.00013,2,932619,938544,-,5925
62,BUMA.1121.00100,2,289316,295465,+,6149
62,BUMA.1121.00012,2,2683915,2690035,-,6120
62,BUMA.1121.00018,2,1532377,1538597,-,6220
62,BUMA.1121.00048,2,264138,270127,+,5989
62,BUMA.1121.00106,2,1550279,1556323,+,6044
62,BUMA.1121.00017,2,1601122,1607125,+,6003
62,BUMA.1121.00082,2,2302436,2308514,+,6078
61,BUMA.1121.00049,2,907168,913704,+,6536
61,BUMA.1121.00055,2,406560,413225,-,6665
61,BUMA.1121.00011,2,881706,888368,+,6662
61,BUMA.1121.00110,2,2226313,2232966,+,6653
61,BUMA.1121.00109,2,2362926,2369651,-,6725
61,BUMA.1121.00077,2,1383052,1389768,-,6716
61,BUMA.1121.00027,2,180528,187186,+,6658
61,BUMA.1121.00026,2,980148,986790,-,6642
61,BUMA.1121.00021,2,2756681,2763339,+,6658
61,BUMA.1121.00023,2,2400709,2407344,+,6635
61,BUMA.1121.00022,2,2053457,2060120,-,6663
61,BUMA.1121.00034,2,1593909,1600544,+,6635
61,BUMA.1121.00025,2,787187,793845,+,6658
61,BUMA.1121.00031,2,1445858,1452509,+,6651
61,BUMA.1121.00007,2,2331475,2338116,+,6641
61,BUMA.1121.00097,2,2099151,2105809,+,6658
61,BUMA.1121.00008,2,1578107,1584742,+,6635
61,BUMA.1121.00059,2,1330496,1337038,-,6542
61,BUMA.1121.00002,2,81919,88554,+,6635
61,BUMA.1121.00004,2,1578769,1585404,+,6635
61,BUMA.1121.00005,2,1655360,1661973,-,6613
61,BUMA.1121.00111,2,1593197,1599850,+,6653
61,BUMA.1121.00006,2,474119,480737,-,6618
61,BUMA.1121.00009,2,922464,929065,+,6601
61,BUMA.1121.00094,2,2302157,2308705,+,6548
61,BUMA.1121.00101,2,1152598,1159277,-,6679
61,BUMA.1121.00066,2,2232658,2239316,+,6658
61,BUMA.1121.00095,2,1126713,1133375,+,6662
61,BUMA.1121.00112,2,2102581,2109271,-,6690
61,BUMA.1121.00042,2,1276280,1282915,+,6635
61,BUMA.1121.00032,2,18869,25504,+,6635
61,BUMA.1121.00090,2,690,7268,+,6578
61,BUMA.1121.00020,2,1578876,1585511,+,6635
61,BUMA.1121.00089,2,2247924,2254472,+,6548
61,BUMA.1121.00051,2,2261471,2268018,+,6547
61,BUMA.1121.00001,2,3136830,3143544,-,6714
61,BUMA.1121.00045,2,2146786,2153448,+,6662
61,BUMA.1121.00043,2,35217,41900,-,6683
61,BUMA.1121.00063,2,2242025,2248683,+,6658
61,BUMA.1121.00079,2,2260359,2266895,+,6536
61,BUMA.1121.00071,2,2248813,2255471,+,6658
61,BUMA.1121.00086,2,508512,515161,-,6649
61,BUMA.1121.00024,2,1713786,1720421,+,6635
61,BUMA.1121.00010,2,934188,940823,+,6635
61,BUMA.1121.00040,2,440051,446783,-,6732
61,BUMA.1121.00093,2,666227,672905,-,6678
61,BUMA.1121.00091,2,1368996,1375604,-,6608
61,BUMA.1121.00107,2,1532387,1539078,-,6691
61,BUMA.1121.00088,2,2272892,2279440,+,6548
61,BUMA.1121.00047,2,75645,82193,+,6548
61,BUMA.1121.00019,2,1658013,1664648,+,6635
61,BUMA.1121.00087,2,88333,94968,+,6635
61,BUMA.1121.00039,2,1699590,1706262,-,6672
61,BUMA.1121.00030,2,521244,527893,-,6649
61,BUMA.1121.00016,2,1444201,1450950,-,6749
61,BUMA.1121.00092,2,2265072,2271736,+,6664
61,BUMA.1121.00085,2,1648383,1655018,-,6635
61,BUMA.1121.00046,2,535905,542540,+,6635
61,BUMA.1121.00003,2,510248,516906,+,6658
61,BUMA.1121.00054,2,274270,280888,-,6618
61,BUMA.1121.00015,2,2010738,2017373,+,6635
61,BUMA.1121.00105,2,164627,171298,-,6671
61,BUMA.1121.00052,2,602029,608664,-,6635
61,BUMA.1121.00053,2,2548151,2554809,+,6658
61,BUMA.1121.00057,2,2971688,2978360,-,6672
61,BUMA.1121.00108,2,2485434,2492035,+,6601
61,BUMA.1121.00050,2,571142,577777,-,6635
61,BUMA.1121.00104,2,2353824,2360360,+,6536
61,BUMA.1121.00014,2,2380456,2387107,+,6651
61,BUMA.1121.00036,2,1147997,1154632,+,6635
61,BUMA.1121.00038,2,474154,480772,-,6618
61,BUMA.1121.00098,2,2521759,2528417,+,6658
61,BUMA.1121.00078,2,880623,887296,-,6673
61,BUMA.1121.00029,2,2255375,2262068,-,6693
61,BUMA.1121.00099,2,2506372,2513030,+,6658
61,BUMA.1121.00103,2,851862,858520,+,6658
61,BUMA.1121.00102,2,2291033,2297691,+,6658
61,BUMA.1121.00028,2,1620049,1626684,+,6635
61,BUMA.1121.00075,2,584027,590698,-,6671
61,BUMA.1121.00044,2,1645008,1651643,+,6635
61,BUMA.1121.00076,2,6641,13299,+,6658
61,BUMA.1121.00074,2,2104596,2111159,-,6563
61,BUMA.1121.00073,2,2249031,2255689,+,6658
61,BUMA.1121.00083,2,919104,925762,+,6658
61,BUMA.1121.00035,2,2333045,2339801,-,6756
61,BUMA.1121.00072,2,2223539,2230197,+,6658
61,BUMA.1121.00056,2,1737147,1743716,-,6569
61,BUMA.1121.00081,2,1842778,1849396,+,6618
61,BUMA.1121.00033,2,3049034,3055647,+,6613
61,BUMA.1121.00061,2,2232133,2238791,+,6658
61,BUMA.1121.00062,2,2640148,2646819,-,6671
61,BUMA.1121.00064,2,2168915,2175463,+,6548
61,BUMA.1121.00060,2,103253,109929,-,6676
61,BUMA.1121.00069,2,2215536,2222193,+,6657
61,BUMA.1121.00070,2,2228401,2235059,+,6658
61,BUMA.1121.00068,2,842406,849064,+,6658
61,BUMA.1121.00067,2,1659786,1666349,-,6563
61,BUMA.1121.00037,2,2615394,2622029,+,6635
61,BUMA.1121.00065,2,2336390,2343048,+,6658
61,BUMA.1121.00058,2,2871933,2878481,+,6548
61,BUMA.1121.00041,2,3218779,3225437,+,6658
61,BUMA.1121.00084,2,977913,984455,+,6542
61,BUMA.1121.00096,2,2578838,2585487,+,6649
61,BUMA.1121.00080,2,2317679,2324227,+,6548
61,BUMA.1121.00013,2,939208,945843,-,6635
61,BUMA.1121.00100,2,282013,288671,+,6658
61,BUMA.1121.00012,2,2690601,2697264,-,6663
61,BUMA.1121.00018,2,1539079,1545793,-,6714
61,BUMA.1121.00048,2,256772,263390,+,6618
61,BUMA.1121.00106,2,1542877,1549535,+,6658
61,BUMA.1121.00017,2,1593890,1600525,+,6635
61,BUMA.1121.00082,2,2295188,2301846,+,6658
60,BUMA.1121.00049,2,900535,906607,+,6072
60,BUMA.1121.00055,2,413775,419891,-,6116
60,BUMA.1121.00011,2,875133,881219,+,6086
60,BUMA.1121.00110,2,2219572,2225667,+,6095
60,BUMA.1121.00109,2,2370279,2376449,-,6170
60,BUMA.1121.00077,2,1390414,1396508,-,6094
60,BUMA.1121.00027,2,173861,179975,+,6114
60,BUMA.1121.00026,2,987325,993440,-,6115
60,BUMA.1121.00021,2,2749909,2756053,+,6144
60,BUMA.1121.00023,2,2392635,2398759,+,6124
60,BUMA.1121.00022,2,2060673,2066739,-,6066
60,BUMA.1121.00034,2,1587327,1593401,+,6074
60,BUMA.1121.00025,2,780430,786532,+,6102
60,BUMA.1121.00031,2,1439095,1445239,+,6144
60,BUMA.1121.00007,2,2324828,2330946,+,6118
60,BUMA.1121.00097,2,2092423,2098580,+,6157
60,BUMA.1121.00008,2,1571516,1577590,+,6074
60,BUMA.1121.00059,2,1337633,1343683,-,6050
60,BUMA.1121.00002,2,75335,81402,+,6067
60,BUMA.1121.00004,2,1572178,1578252,+,6074
60,BUMA.1121.00005,2,1662555,1668650,-,6095
60,BUMA.1121.00111,2,1586419,1592542,+,6123
60,BUMA.1121.00006,2,481245,487339,-,6094
60,BUMA.1121.00009,2,915769,921884,+,6115
60,BUMA.1121.00094,2,2295420,2301586,+,6166
60,BUMA.1121.00101,2,1159893,1166000,-,6107
60,BUMA.1121.00066,2,2225986,2232069,+,6083
60,BUMA.1121.00095,2,1119968,1126061,+,6093
60,BUMA.1121.00112,2,2109884,2115997,-,6113
60,BUMA.1121.00042,2,1269643,1275745,+,6102
60,BUMA.1121.00032,2,12278,18352,+,6074
60,BUMA.1121.00090,2,3254065,3260214,+,6149
60,BUMA.1121.00020,2,1572285,1578359,+,6074
60,BUMA.1121.00089,2,2241180,2247388,+,6208
60,BUMA.1121.00051,2,2254753,2260926,+,6173
60,BUMA.1121.00001,2,3144271,3150434,-,6163
60,BUMA.1121.00045,2,2140145,2146224,+,6079
60,BUMA.1121.00043,2,42564,48747,-,6183
60,BUMA.1121.00063,2,2235343,2241436,+,6093
60,BUMA.1121.00079,2,2253691,2259763,+,6072
60,BUMA.1121.00071,2,2242144,2248224,+,6080
60,BUMA.1121.00086,2,515696,521769,-,6073
60,BUMA.1121.00024,2,1707195,1713269,+,6074
60,BUMA.1121.00010,2,927604,933671,+,6067
60,BUMA.1121.00040,2,447309,453389,-,6080
60,BUMA.1121.00093,2,673461,679594,-,6133
60,BUMA.1121.00091,2,1376139,1382240,-,6101
60,BUMA.1121.00107,2,1539613,1545809,-,6196
60,BUMA.1121.00088,2,2266206,2272320,+,6114
60,BUMA.1121.00047,2,67607,73752,+,6145
60,BUMA.1121.00019,2,1651422,1657496,+,6074
60,BUMA.1121.00087,2,81724,87798,+,6074
60,BUMA.1121.00039,2,1706959,1713135,-,6176
60,BUMA.1121.00030,2,528401,534474,-,6073
60,BUMA.1121.00016,2,1451623,1457807,-,6184
60,BUMA.1121.00092,2,2258381,2264516,+,6135
60,BUMA.1121.00085,2,1655544,1661645,-,6101
60,BUMA.1121.00046,2,529279,535388,+,6109
60,BUMA.1121.00003,2,503511,509668,+,6157
60,BUMA.1121.00054,2,281396,287490,-,6094
60,BUMA.1121.00015,2,2004140,2010221,+,6081
60,BUMA.1121.00105,2,173294,179372,-,6078
60,BUMA.1121.00052,2,609190,615291,-,6101
60,BUMA.1121.00053,2,2541344,2547553,+,6209
60,BUMA.1121.00057,2,2978975,2985046,-,6071
60,BUMA.1121.00108,2,2478769,2484863,+,6094
60,BUMA.1121.00050,2,578294,584416,-,6122
60,BUMA.1121.00104,2,2347105,2353256,+,6151
60,BUMA.1121.00014,2,2373669,2379855,+,6186
60,BUMA.1121.00036,2,1141386,1147453,+,6067
60,BUMA.1121.00038,2,481280,487374,-,6094
60,BUMA.1121.00098,2,2515070,2521227,+,6157
60,BUMA.1121.00078,2,887831,893967,-,6136
60,BUMA.1121.00029,2,2262660,2268858,-,6198
60,BUMA.1121.00099,2,2499747,2505848,+,6101
60,BUMA.1121.00103,2,845172,851315,+,6143
60,BUMA.1121.00102,2,2284323,2290480,+,6157
60,BUMA.1121.00028,2,1613458,1619532,+,6074
60,BUMA.1121.00075,2,591266,597358,-,6092
60,BUMA.1121.00044,2,1638426,1644500,+,6074
60,BUMA.1121.00076,2,16,6082,+,6066
60,BUMA.1121.00074,2,2111775,2117909,-,6134
60,BUMA.1121.00073,2,2242350,2248443,+,6093
60,BUMA.1121.00083,2,912422,918515,+,6093
60,BUMA.1121.00035,2,2340483,2346639,-,6156
60,BUMA.1121.00072,2,2216857,2222950,+,6093
60,BUMA.1121.00056,2,1744252,1750459,-,6207
60,BUMA.1121.00081,2,1836175,1842270,+,6095
60,BUMA.1121.00033,2,3042244,3048388,+,6144
60,BUMA.1121.00061,2,2225465,2231544,+,6079
60,BUMA.1121.00062,2,2647408,2653535,-,6127
60,BUMA.1121.00064,2,2162189,2168317,+,6128
60,BUMA.1121.00060,2,110482,116578,-,6096
60,BUMA.1121.00069,2,2208863,2214956,+,6093
60,BUMA.1121.00070,2,2221719,2227812,+,6093
60,BUMA.1121.00068,2,835700,841808,+,6108
60,BUMA.1121.00067,2,1669636,1675724,-,6088
60,BUMA.1121.00037,2,2608602,2614793,+,6191
60,BUMA.1121.00065,2,2329563,2335672,+,6109
60,BUMA.1121.00058,2,2865244,2871352,+,6108
60,BUMA.1121.00041,2,3212110,3218226,+,6116
60,BUMA.1121.00084,2,969804,975890,+,6086
60,BUMA.1121.00096,2,2572177,2578297,+,6120
60,BUMA.1121.00080,2,2310982,2317134,+,6152
60,BUMA.1121.00013,2,946351,952452,-,6101
60,BUMA.1121.00100,2,275295,281460,+,6165
60,BUMA.1121.00012,2,2697838,2703952,-,6114
60,BUMA.1121.00018,2,1546439,1552540,-,6101
60,BUMA.1121.00048,2,250169,256264,+,6095
60,BUMA.1121.00106,2,1536221,1542307,+,6086
60,BUMA.1121.00017,2,1587308,1593382,+,6074
60,BUMA.1121.00082,2,2288506,2294599,+,6093
59,BUMA.1121.00049,2,896966,900534,+,3568
59,BUMA.1121.00055,2,419893,423460,-,3567
59,BUMA.1121.00011,2,871564,875132,+,3568
59,BUMA.1121.00110,2,2216003,2219571,+,3568
59,BUMA.1121.00109,2,2376451,2379984,-,3533
59,BUMA.1121.00077,2,1396510,1400077,-,3567
59,BUMA.1121.00027,2,170292,173860,+,3568
59,BUMA.1121.00026,2,993442,997009,-,3567
59,BUMA.1121.00021,2,2746340,2749908,+,3568
59,BUMA.1121.00023,2,2389066,2392634,+,3568
59,BUMA.1121.00022,2,2066741,2070308,-,3567
59,BUMA.1121.00034,2,1583758,1587326,+,3568
59,BUMA.1121.00025,2,776861,780429,+,3568
59,BUMA.1121.00031,2,1435526,1439094,+,3568
59,BUMA.1121.00007,2,2321259,2324827,+,3568
59,BUMA.1121.00097,2,2088854,2092422,+,3568
59,BUMA.1121.00008,2,1567947,1571515,+,3568
59,BUMA.1121.00059,2,1343685,1347252,-,3567
59,BUMA.1121.00002,2,71766,75334,+,3568
59,BUMA.1121.00004,2,1568609,1572177,+,3568
59,BUMA.1121.00005,2,1668652,1672219,-,3567
59,BUMA.1121.00111,2,1582858,1586418,+,3560
59,BUMA.1121.00006,2,487341,490908,-,3567
59,BUMA.1121.00009,2,912200,915768,+,3568
59,BUMA.1121.00094,2,2291851,2295419,+,3568
59,BUMA.1121.00101,2,1166002,1169569,-,3567
59,BUMA.1121.00066,2,2222417,2225985,+,3568
59,BUMA.1121.00095,2,1116399,1119967,+,3568
59,BUMA.1121.00112,2,2115999,2119566,-,3567
59,BUMA.1121.00042,2,1266074,1269642,+,3568
59,BUMA.1121.00032,2,8709,12277,+,3568
59,BUMA.1121.00090,2,3250496,3254064,+,3568
59,BUMA.1121.00020,2,1568716,1572284,+,3568
59,BUMA.1121.00089,2,2237611,2241179,+,3568
59,BUMA.1121.00051,2,2251184,2254752,+,3568
59,BUMA.1121.00001,2,3150436,3154003,-,3567
59,BUMA.1121.00045,2,2136578,2140144,+,3566
59,BUMA.1121.00043,2,48749,52316,-,3567
59,BUMA.1121.00063,2,2231774,2235342,+,3568
59,BUMA.1121.00079,2,2250122,2253690,+,3568
59,BUMA.1121.00071,2,2238575,2242143,+,3568
59,BUMA.1121.00086,2,521771,525338,-,3567
59,BUMA.1121.00024,2,1703626,1707194,+,3568
59,BUMA.1121.00010,2,924035,927603,+,3568
59,BUMA.1121.00040,2,453391,456958,-,3567
59,BUMA.1121.00093,2,679596,683163,-,3567
59,BUMA.1121.00091,2,1382242,1385817,-,3575
59,BUMA.1121.00107,2,1545811,1549378,-,3567
59,BUMA.1121.00088,2,2262637,2266205,+,3568
59,BUMA.1121.00047,2,64038,67606,+,3568
59,BUMA.1121.00019,2,1647853,1651421,+,3568
59,BUMA.1121.00087,2,78155,81723,+,3568
59,BUMA.1121.00039,2,1713137,1716704,-,3567
59,BUMA.1121.00030,2,534476,538043,-,3567
59,BUMA.1121.00016,2,1457809,1461376,-,3567
59,BUMA.1121.00092,2,2254812,2258380,+,3568
59,BUMA.1121.00085,2,1661647,1665214,-,3567
59,BUMA.1121.00046,2,525710,529278,+,3568
59,BUMA.1121.00003,2,499934,503510,+,3576
59,BUMA.1121.00054,2,287492,291059,-,3567
59,BUMA.1121.00015,2,2000571,2004139,+,3568
59,BUMA.1121.00105,2,179374,182941,-,3567
59,BUMA.1121.00052,2,615293,618860,-,3567
59,BUMA.1121.00053,2,2537775,2541343,+,3568
59,BUMA.1121.00057,2,2985048,2988615,-,3567
59,BUMA.1121.00108,2,2475200,2478768,+,3568
59,BUMA.1121.00050,2,584418,587985,-,3567
59,BUMA.1121.00104,2,2343536,2347104,+,3568
59,BUMA.1121.00014,2,2370100,2373668,+,3568
59,BUMA.1121.00036,2,1137817,1141385,+,3568
59,BUMA.1121.00038,2,487376,490943,-,3567
59,BUMA.1121.00098,2,2511503,2515069,+,3566
59,BUMA.1121.00078,2,893969,897557,-,3588
59,BUMA.1121.00029,2,2268860,2272427,-,3567
59,BUMA.1121.00099,2,2496178,2499746,+,3568
59,BUMA.1121.00103,2,841603,845171,+,3568
59,BUMA.1121.00102,2,2280754,2284322,+,3568
59,BUMA.1121.00028,2,1609889,1613457,+,3568
59,BUMA.1121.00075,2,597360,600927,-,3567
59,BUMA.1121.00044,2,1634857,1638425,+,3568
59,BUMA.1121.00076,2,3204953,3208521,+,3568
59,BUMA.1121.00074,2,2117911,2121478,-,3567
59,BUMA.1121.00073,2,2238781,2242349,+,3568
59,BUMA.1121.00083,2,908853,912421,+,3568
59,BUMA.1121.00035,2,2346641,2350208,-,3567
59,BUMA.1121.00072,2,2213288,2216856,+,3568
59,BUMA.1121.00056,2,1750461,1754028,-,3567
59,BUMA.1121.00081,2,1832606,1836174,+,3568
59,BUMA.1121.00033,2,3038675,3042243,+,3568
59,BUMA.1121.00061,2,2221896,2225464,+,3568
59,BUMA.1121.00062,2,2653537,2657104,-,3567
59,BUMA.1121.00064,2,2158620,2162188,+,3568
59,BUMA.1121.00060,2,116580,120145,-,3565
59,BUMA.1121.00069,2,2205294,2208862,+,3568
59,BUMA.1121.00070,2,2218150,2221718,+,3568
59,BUMA.1121.00068,2,832131,835699,+,3568
59,BUMA.1121.00067,2,1675726,1679293,-,3567
59,BUMA.1121.00037,2,2605033,2608601,+,3568
59,BUMA.1121.00065,2,2325994,2329562,+,3568
59,BUMA.1121.00058,2,2861667,2865243,+,3576
59,BUMA.1121.00041,2,3208541,3212109,+,3568
59,BUMA.1121.00084,2,966235,969803,+,3568
59,BUMA.1121.00096,2,2568608,2572176,+,3568
59,BUMA.1121.00080,2,2307413,2310981,+,3568
59,BUMA.1121.00013,2,952454,956021,-,3567
59,BUMA.1121.00100,2,271726,275294,+,3568
59,BUMA.1121.00012,2,2703954,2707521,-,3567
59,BUMA.1121.00018,2,1552542,1556109,-,3567
59,BUMA.1121.00048,2,246600,250168,+,3568
59,BUMA.1121.00106,2,1532652,1536220,+,3568
59,BUMA.1121.00017,2,1583739,1587307,+,3568
59,BUMA.1121.00082,2,2284937,2288505,+,3568
58,BUMA.1121.00049,2,888327,893086,+,4759
58,BUMA.1121.00055,2,427342,432094,-,4752
58,BUMA.1121.00011,2,862432,867546,+,5114
58,BUMA.1121.00110,2,2148027,2152792,+,4765
58,BUMA.1121.00109,2,2424245,2429021,-,4776
58,BUMA.1121.00077,2,1463290,1468054,-,4764
58,BUMA.1121.00027,2,102877,107660,+,4783
58,BUMA.1121.00026,2,1000891,1005643,-,4752
58,BUMA.1121.00021,2,2736359,2741124,+,4765
58,BUMA.1121.00023,2,2380432,2385185,+,4753
58,BUMA.1121.00022,2,2074190,2078948,-,4758
58,BUMA.1121.00034,2,1575112,1579877,+,4765
58,BUMA.1121.00025,2,767275,772064,+,4789
58,BUMA.1121.00031,2,1426860,1431637,+,4777
58,BUMA.1121.00007,2,2312594,2317371,+,4777
58,BUMA.1121.00097,2,2079710,2084836,+,5126
58,BUMA.1121.00008,2,1559301,1564066,+,4765
58,BUMA.1121.00059,2,1351133,1355909,-,4776
58,BUMA.1121.00002,2,63116,67885,+,4769
58,BUMA.1121.00004,2,1559963,1564728,+,4765
58,BUMA.1121.00005,2,1676099,1680887,-,4788
58,BUMA.1121.00111,2,1574199,1578970,+,4771
58,BUMA.1121.00006,2,494790,499554,-,4764
58,BUMA.1121.00009,2,903074,908182,+,5108
58,BUMA.1121.00094,2,2283218,2287971,+,4753
58,BUMA.1121.00101,2,1173588,1178695,-,5107
58,BUMA.1121.00066,2,2213765,2218536,+,4771
58,BUMA.1121.00095,2,1068342,1073468,+,5126
58,BUMA.1121.00112,2,2123447,2128228,-,4781
58,BUMA.1121.00042,2,1257440,1262193,+,4753
58,BUMA.1121.00032,2,48,4828,+,4780
58,BUMA.1121.00090,2,3241832,3246615,+,4783
58,BUMA.1121.00020,2,1560070,1564835,+,4765
58,BUMA.1121.00089,2,2228978,2233731,+,4753
58,BUMA.1121.00051,2,2242551,2247304,+,4753
58,BUMA.1121.00001,2,3157885,3162673,-,4788
58,BUMA.1121.00045,2,2127430,2132559,+,5129
58,BUMA.1121.00043,2,56198,60983,-,4785
58,BUMA.1121.00063,2,2223122,2227893,+,4771
58,BUMA.1121.00079,2,2241489,2246242,+,4753
58,BUMA.1121.00071,2,2229923,2234694,+,4771
58,BUMA.1121.00086,2,529220,533984,-,4764
58,BUMA.1121.00024,2,1694980,1699745,+,4765
58,BUMA.1121.00010,2,915389,920154,+,4765
58,BUMA.1121.00040,2,460840,465610,-,4770
58,BUMA.1121.00093,2,687052,691840,-,4788
58,BUMA.1121.00091,2,1389699,1394451,-,4752
58,BUMA.1121.00107,2,1553398,1558523,-,5125
58,BUMA.1121.00088,2,2253974,2258757,+,4783
58,BUMA.1121.00047,2,55405,60158,+,4753
58,BUMA.1121.00019,2,1639207,1643972,+,4765
58,BUMA.1121.00087,2,69509,74274,+,4765
58,BUMA.1121.00039,2,1720586,1725362,-,4776
58,BUMA.1121.00030,2,541925,546689,-,4764
58,BUMA.1121.00016,2,1465258,1470031,-,4773
58,BUMA.1121.00092,2,2246135,2250924,+,4789
58,BUMA.1121.00085,2,1669096,1673872,-,4776
58,BUMA.1121.00046,2,517058,521829,+,4771
58,BUMA.1121.00003,2,451554,456638,+,5084
58,BUMA.1121.00054,2,294941,299705,-,4764
58,BUMA.1121.00015,2,1991919,1996690,+,4771
58,BUMA.1121.00105,2,186823,191605,-,4782
58,BUMA.1121.00052,2,622742,627518,-,4776
58,BUMA.1121.00053,2,2529123,2533894,+,4771
58,BUMA.1121.00057,2,2992497,2997261,-,4764
58,BUMA.1121.00108,2,2466029,2471182,+,5153
58,BUMA.1121.00050,2,591867,596637,-,4770
58,BUMA.1121.00104,2,2334897,2339656,+,4759
58,BUMA.1121.00014,2,2361434,2366211,+,4777
58,BUMA.1121.00036,2,1129171,1133936,+,4765
58,BUMA.1121.00038,2,494825,499589,-,4764
58,BUMA.1121.00098,2,2502367,2507484,+,5117
58,BUMA.1121.00078,2,901439,906209,-,4770
58,BUMA.1121.00029,2,2332621,2337415,-,4794
58,BUMA.1121.00099,2,2487016,2492160,+,5144
58,BUMA.1121.00103,2,832458,837584,+,5126
58,BUMA.1121.00102,2,2272078,2276873,+,4795
58,BUMA.1121.00028,2,1601243,1606008,+,4765
58,BUMA.1121.00075,2,604808,609572,-,4764
58,BUMA.1121.00044,2,1626211,1630976,+,4765
58,BUMA.1121.00076,2,3196308,3201073,+,4765
58,BUMA.1121.00074,2,2125359,2130141,-,4782
58,BUMA.1121.00073,2,2230129,2234900,+,4771
58,BUMA.1121.00083,2,900201,904972,+,4771
58,BUMA.1121.00035,2,2354090,2358872,-,4782
58,BUMA.1121.00072,2,2204636,2209407,+,4771
58,BUMA.1121.00056,2,1757909,1762661,-,4752
58,BUMA.1121.00081,2,1823960,1828725,+,4765
58,BUMA.1121.00033,2,3029999,3034794,+,4795
58,BUMA.1121.00061,2,2213244,2218015,+,4771
58,BUMA.1121.00062,2,2660985,2665755,-,4770
58,BUMA.1121.00064,2,2149975,2154740,+,4765
58,BUMA.1121.00060,2,124165,129293,-,5128
58,BUMA.1121.00069,2,2196642,2201413,+,4771
58,BUMA.1121.00070,2,2209498,2214269,+,4771
58,BUMA.1121.00068,2,822962,828112,+,5150
58,BUMA.1121.00067,2,1741490,1746272,-,4782
58,BUMA.1121.00037,2,2596375,2601152,+,4777
58,BUMA.1121.00065,2,2278639,2283410,+,4771
58,BUMA.1121.00058,2,2852998,2857787,+,4789
58,BUMA.1121.00041,2,3199877,3204660,+,4783
58,BUMA.1121.00084,2,957578,962355,+,4777
58,BUMA.1121.00096,2,2499651,2504759,+,5108
58,BUMA.1121.00080,2,2239855,2244608,+,4753
58,BUMA.1121.00013,2,959903,964685,-,4782
58,BUMA.1121.00100,2,263068,267845,+,4777
58,BUMA.1121.00012,2,2711410,2716186,-,4776
58,BUMA.1121.00018,2,1560907,1565701,-,4794
58,BUMA.1121.00048,2,237954,242719,+,4765
58,BUMA.1121.00106,2,1524018,1528772,+,4754
58,BUMA.1121.00017,2,1575093,1579858,+,4765
58,BUMA.1121.00082,2,2276285,2281056,+,4771
57,BUMA.1121.00049,2,860757,888326,+,27569
57,BUMA.1121.00055,2,432096,459652,-,27556
57,BUMA.1121.00011,2,834865,862431,+,27566
57,BUMA.1121.00110,2,2120447,2148026,+,27579
57,BUMA.1121.00109,2,2429023,2456608,-,27585
57,BUMA.1121.00077,2,1468056,1495634,-,27578
57,BUMA.1121.00027,2,75328,102876,+,27548
57,BUMA.1121.00026,2,1005645,1033215,-,27570
57,BUMA.1121.00021,2,2708805,2736358,+,27553
57,BUMA.1121.00023,2,2352879,2380431,+,27552
57,BUMA.1121.00022,2,2078950,2106520,-,27570
57,BUMA.1121.00034,2,1547540,1575111,+,27571
57,BUMA.1121.00025,2,739722,767274,+,27552
57,BUMA.1121.00031,2,1399305,1426859,+,27554
57,BUMA.1121.00007,2,2285009,2312593,+,27584
57,BUMA.1121.00097,2,2052141,2079709,+,27568
57,BUMA.1121.00008,2,1531729,1559300,+,27571
57,BUMA.1121.00059,2,1355911,1383448,-,27537
57,BUMA.1121.00002,2,35550,63115,+,27565
57,BUMA.1121.00004,2,1532391,1559962,+,27571
57,BUMA.1121.00005,2,1680889,1708428,-,27539
57,BUMA.1121.00111,2,1546843,1574198,+,27355
57,BUMA.1121.00006,2,499556,527126,-,27570
57,BUMA.1121.00009,2,875484,903073,+,27589
57,BUMA.1121.00094,2,2255710,2283217,+,27507
57,BUMA.1121.00101,2,1178697,1206250,-,27553
57,BUMA.1121.00066,2,2186217,2213764,+,27547
57,BUMA.1121.00095,2,1040762,1068341,+,27579
57,BUMA.1121.00112,2,2128230,2155679,-,27449
57,BUMA.1121.00042,2,1229868,1257439,+,27571
57,BUMA.1121.00032,2,1699236,1726745,+,27509
57,BUMA.1121.00090,2,3214265,3241831,+,27566
57,BUMA.1121.00020,2,1532498,1560069,+,27571
57,BUMA.1121.00089,2,2201470,2228977,+,27507
57,BUMA.1121.00051,2,2215033,2242550,+,27517
57,BUMA.1121.00001,2,3162675,3190202,-,27527
57,BUMA.1121.00045,2,2099845,2127429,+,27584
57,BUMA.1121.00043,2,60985,88540,-,27555
57,BUMA.1121.00063,2,2195575,2223121,+,27546
57,BUMA.1121.00079,2,2213913,2241488,+,27575
57,BUMA.1121.00071,2,2202375,2229922,+,27547
57,BUMA.1121.00086,2,533986,561556,-,27570
57,BUMA.1121.00024,2,1667408,1694979,+,27571
57,BUMA.1121.00010,2,887823,915388,+,27565
57,BUMA.1121.00040,2,465612,493181,-,27569
57,BUMA.1121.00093,2,691842,719402,-,27560
57,BUMA.1121.00091,2,1394453,1422016,-,27563
57,BUMA.1121.00107,2,1558525,1586083,-,27558
57,BUMA.1121.00088,2,2226385,2253973,+,27588
57,BUMA.1121.00047,2,27887,55404,+,27517
57,BUMA.1121.00019,2,1611635,1639206,+,27571
57,BUMA.1121.00087,2,41937,69508,+,27571
57,BUMA.1121.00039,2,1725364,1752928,-,27564
57,BUMA.1121.00030,2,546691,574261,-,27570
57,BUMA.1121.00016,2,1470033,1497604,-,27571
57,BUMA.1121.00092,2,2218573,2246134,+,27561
57,BUMA.1121.00085,2,1673874,1701444,-,27570
57,BUMA.1121.00046,2,489486,517057,+,27571
57,BUMA.1121.00003,2,423986,451553,+,27567
57,BUMA.1121.00054,2,299707,327277,-,27570
57,BUMA.1121.00015,2,1964347,1991918,+,27571
57,BUMA.1121.00105,2,191607,219144,-,27537
57,BUMA.1121.00052,2,627520,655090,-,27570
57,BUMA.1121.00053,2,2501570,2529122,+,27552
57,BUMA.1121.00057,2,2997263,3024814,-,27551
57,BUMA.1121.00108,2,2438443,2466028,+,27585
57,BUMA.1121.00050,2,596639,624209,-,27570
57,BUMA.1121.00104,2,2307327,2334896,+,27569
57,BUMA.1121.00014,2,2333878,2361433,+,27555
57,BUMA.1121.00036,2,1101599,1129170,+,27571
57,BUMA.1121.00038,2,499591,527161,-,27570
57,BUMA.1121.00098,2,2474799,2502366,+,27567
57,BUMA.1121.00078,2,906211,933792,-,27581
57,BUMA.1121.00029,2,2337417,2364928,-,27511
57,BUMA.1121.00099,2,2459408,2487015,+,27607
57,BUMA.1121.00103,2,804907,832457,+,27550
57,BUMA.1121.00102,2,2244539,2272077,+,27538
57,BUMA.1121.00028,2,1573671,1601242,+,27571
57,BUMA.1121.00075,2,609574,637173,-,27599
57,BUMA.1121.00044,2,1598639,1626210,+,27571
57,BUMA.1121.00076,2,3168706,3196307,+,27601
57,BUMA.1121.00074,2,2130143,2157679,-,27536
57,BUMA.1121.00073,2,2202580,2230128,+,27548
57,BUMA.1121.00083,2,872652,900200,+,27548
57,BUMA.1121.00035,2,2358874,2386385,-,27511
57,BUMA.1121.00072,2,2177087,2204635,+,27548
57,BUMA.1121.00056,2,1762663,1790169,-,27506
57,BUMA.1121.00081,2,1796388,1823959,+,27571
57,BUMA.1121.00033,2,3002590,3029998,+,27408
57,BUMA.1121.00061,2,2185695,2213243,+,27548
57,BUMA.1121.00062,2,2665757,2693299,-,27542
57,BUMA.1121.00064,2,2122436,2149974,+,27538
57,BUMA.1121.00060,2,129295,156878,-,27583
57,BUMA.1121.00069,2,2169093,2196641,+,27548
57,BUMA.1121.00070,2,2181949,2209497,+,27548
57,BUMA.1121.00068,2,795400,822961,+,27561
57,BUMA.1121.00067,2,1746274,1773843,-,27569
57,BUMA.1121.00037,2,2568822,2596374,+,27552
57,BUMA.1121.00065,2,2251070,2278638,+,27568
57,BUMA.1121.00058,2,2825446,2852997,+,27551
57,BUMA.1121.00041,2,3172309,3199876,+,27567
57,BUMA.1121.00084,2,930013,957577,+,27564
57,BUMA.1121.00096,2,2472066,2499650,+,27584
57,BUMA.1121.00080,2,2212337,2239854,+,27517
57,BUMA.1121.00013,2,964687,992257,-,27570
57,BUMA.1121.00100,2,235501,263067,+,27566
57,BUMA.1121.00012,2,2716188,2743742,-,27554
57,BUMA.1121.00018,2,1565703,1593254,-,27551
57,BUMA.1121.00048,2,210382,237953,+,27571
57,BUMA.1121.00106,2,1496446,1524017,+,27571
57,BUMA.1121.00017,2,1547521,1575092,+,27571
57,BUMA.1121.00082,2,2248736,2276284,+,27548
56,BUMA.1121.00049,2,824273,840596,+,16323
56,BUMA.1121.00055,2,493265,509617,-,16352
56,BUMA.1121.00011,2,784808,801287,+,16479
56,BUMA.1121.00110,2,2070575,2086955,+,16380
56,BUMA.1121.00109,2,2490128,2506621,-,16493
56,BUMA.1121.00077,2,1529126,1545565,-,16439
56,BUMA.1121.00027,2,25291,41694,+,16403
56,BUMA.1121.00021,2,2685628,2701966,+,16338
56,BUMA.1121.00023,2,2302737,2319222,+,16485
56,BUMA.1121.00022,2,2114439,2130897,-,16458
56,BUMA.1121.00034,2,1523172,1539622,+,16450
56,BUMA.1121.00025,2,689694,706080,+,16386
56,BUMA.1121.00031,2,1349255,1365677,+,16422
56,BUMA.1121.00007,2,2235100,2251547,+,16447
56,BUMA.1121.00097,2,2002136,2018607,+,16471
56,BUMA.1121.00008,2,1507361,1523811,+,16450
56,BUMA.1121.00059,2,1417292,1433704,-,16412
56,BUMA.1121.00002,2,11173,27632,+,16459
56,BUMA.1121.00004,2,1508019,1524473,+,16454
56,BUMA.1121.00005,2,1742004,1758345,-,16341
56,BUMA.1121.00111,2,1496806,1513255,+,16449
56,BUMA.1121.00006,2,535045,551458,-,16413
56,BUMA.1121.00009,2,825530,841951,+,16421
56,BUMA.1121.00094,2,2205637,2222017,+,16380
56,BUMA.1121.00101,2,1239813,1256198,-,16385
56,BUMA.1121.00066,2,2136335,2152736,+,16401
56,BUMA.1121.00095,2,990829,1007236,+,16407
56,BUMA.1121.00112,2,2196016,2212356,-,16340
56,BUMA.1121.00032,2,1674868,1691318,+,16450
56,BUMA.1121.00090,2,3164198,3180611,+,16413
56,BUMA.1121.00020,2,1508132,1524580,+,16448
56,BUMA.1121.00089,2,2151397,2167777,+,16380
56,BUMA.1121.00051,2,2164952,2181364,+,16412
56,BUMA.1121.00001,2,20185,36597,-,16412
56,BUMA.1121.00045,2,2049734,2066255,+,16521
56,BUMA.1121.00043,2,122234,138717,-,16483
56,BUMA.1121.00063,2,2145776,2162162,+,16386
56,BUMA.1121.00079,2,2163862,2180280,+,16418
56,BUMA.1121.00071,2,2152576,2168888,+,16312
56,BUMA.1121.00086,2,569475,585978,-,16503
56,BUMA.1121.00024,2,1643041,1659490,+,16449
56,BUMA.1121.00010,2,863446,879905,+,16459
56,BUMA.1121.00040,2,501100,517537,-,16437
56,BUMA.1121.00093,2,759640,775999,-,16359
56,BUMA.1121.00091,2,1455583,1471969,-,16386
56,BUMA.1121.00107,2,1633180,1649609,-,16429
56,BUMA.1121.00088,2,2176264,2192761,+,16497
56,BUMA.1121.00047,2,3097341,3113811,+,16470
56,BUMA.1121.00019,2,1587267,1603717,+,16450
56,BUMA.1121.00087,2,17516,34019,+,16503
56,BUMA.1121.00039,2,1786517,1803064,-,16547
56,BUMA.1121.00030,2,582180,598625,-,16445
56,BUMA.1121.00016,2,1531202,1547641,-,16439
56,BUMA.1121.00092,2,2168740,2185102,+,16362
56,BUMA.1121.00046,2,465136,481568,+,16432
56,BUMA.1121.00003,2,397483,413859,+,16376
56,BUMA.1121.00054,2,335196,351609,-,16413
56,BUMA.1121.00015,2,1939860,1956429,+,16569
56,BUMA.1121.00105,2,249526,265890,-,16364
56,BUMA.1121.00053,2,2451691,2468062,+,16371
56,BUMA.1121.00057,2,3058451,3074861,-,16410
56,BUMA.1121.00108,2,2388461,2404811,+,16350
56,BUMA.1121.00050,2,632128,648559,-,16431
56,BUMA.1121.00104,2,2257359,2273682,+,16323
56,BUMA.1121.00014,2,2283887,2300246,+,16359
56,BUMA.1121.00036,2,1077285,1093681,+,16396
56,BUMA.1121.00038,2,535080,551493,-,16413
56,BUMA.1121.00098,2,2424885,2441286,+,16401
56,BUMA.1121.00078,2,967358,983774,-,16416
56,BUMA.1121.00029,2,2398571,2414992,-,16421
56,BUMA.1121.00099,2,2409305,2425832,+,16527
56,BUMA.1121.00103,2,745068,761400,+,16332
56,BUMA.1121.00102,2,2211383,2227776,+,16393
56,BUMA.1121.00028,2,1549305,1565753,+,16448
56,BUMA.1121.00075,2,647394,663778,-,16384
56,BUMA.1121.00044,2,1574271,1590721,+,16450
56,BUMA.1121.00076,2,3118680,3135064,+,16384
56,BUMA.1121.00074,2,2191382,2207755,-,16373
56,BUMA.1121.00073,2,2152580,2169018,+,16438
56,BUMA.1121.00083,2,822524,838962,+,16438
56,BUMA.1121.00035,2,2420028,2436422,-,16394
56,BUMA.1121.00072,2,2127240,2143559,+,16319
56,BUMA.1121.00056,2,1827085,1843464,-,16379
56,BUMA.1121.00081,2,1772056,1788470,+,16414
56,BUMA.1121.00033,2,2952327,2968899,+,16572
56,BUMA.1121.00061,2,2136131,2152435,+,16304
56,BUMA.1121.00062,2,2726885,2743270,-,16385
56,BUMA.1121.00064,2,2072327,2088698,+,16371
56,BUMA.1121.00060,2,183673,200193,-,16520
56,BUMA.1121.00069,2,2119114,2135543,+,16429
56,BUMA.1121.00070,2,2132018,2148384,+,16366
56,BUMA.1121.00068,2,745379,761738,+,16359
56,BUMA.1121.00067,2,1807558,1823919,-,16361
56,BUMA.1121.00037,2,2518722,2535189,+,16467
56,BUMA.1121.00065,2,2200976,2217518,+,16542
56,BUMA.1121.00058,2,2775495,2791788,+,16293
56,BUMA.1121.00041,2,3122338,3138670,+,16332
56,BUMA.1121.00084,2,879982,896389,+,16407
56,BUMA.1121.00096,2,2428575,2445024,+,16449
56,BUMA.1121.00080,2,2165538,2181983,+,16445
56,BUMA.1121.00013,2,1000176,1016619,-,16443
56,BUMA.1121.00100,2,185471,201868,+,16397
56,BUMA.1121.00012,2,2777412,2793905,-,16493
56,BUMA.1121.00018,2,1626896,1643281,-,16385
56,BUMA.1121.00048,2,186050,202464,+,16414
56,BUMA.1121.00106,2,1446496,1462801,+,16305
56,BUMA.1121.00017,2,1523163,1539603,+,16440
56,BUMA.1121.00082,2,2198608,2215046,+,16438
55,BUMA.1121.00049,2,816877,823645,+,6768
55,BUMA.1121.00055,2,510245,517014,-,6769
55,BUMA.1121.00011,2,777436,784180,+,6744
55,BUMA.1121.00110,2,2063179,2069947,+,6768
55,BUMA.1121.00109,2,2507249,2514063,-,6814
55,BUMA.1121.00077,2,1546193,1552965,-,6772
55,BUMA.1121.00027,2,17883,24663,+,6780
55,BUMA.1121.00026,2,1039605,1046372,-,6767
55,BUMA.1121.00021,2,2678232,2685000,+,6768
55,BUMA.1121.00023,2,2295341,2302109,+,6768
55,BUMA.1121.00022,2,2131519,2138286,-,6767
55,BUMA.1121.00034,2,1515784,1522550,+,6766
55,BUMA.1121.00025,2,682310,689066,+,6756
55,BUMA.1121.00031,2,1341871,1348627,+,6756
55,BUMA.1121.00007,2,2227738,2234481,+,6743
55,BUMA.1121.00097,2,1994752,2001508,+,6756
55,BUMA.1121.00008,2,1499973,1506739,+,6766
55,BUMA.1121.00059,2,1434332,1441113,-,6781
55,BUMA.1121.00002,2,3797,10551,+,6754
55,BUMA.1121.00004,2,1500631,1507397,+,6766
55,BUMA.1121.00005,2,1758973,1765718,-,6745
55,BUMA.1121.00111,2,1489410,1496178,+,6768
55,BUMA.1121.00006,2,552080,558847,-,6767
55,BUMA.1121.00009,2,818146,824902,+,6756
55,BUMA.1121.00094,2,2198229,2205009,+,6780
55,BUMA.1121.00101,2,1256826,1263595,-,6769
55,BUMA.1121.00066,2,2128951,2135707,+,6756
55,BUMA.1121.00095,2,983444,990201,+,6757
55,BUMA.1121.00112,2,2212984,2219729,-,6745
55,BUMA.1121.00042,2,1216712,1223478,+,6766
55,BUMA.1121.00032,2,1667480,1674246,+,6766
55,BUMA.1121.00090,2,3156802,3163570,+,6768
55,BUMA.1121.00020,2,1500744,1507510,+,6766
55,BUMA.1121.00089,2,2143989,2150769,+,6780
55,BUMA.1121.00051,2,2157545,2164324,+,6779
55,BUMA.1121.00001,2,37225,43991,-,6766
55,BUMA.1121.00045,2,2042338,2049106,+,6768
55,BUMA.1121.00043,2,139345,146111,-,6766
55,BUMA.1121.00063,2,2138392,2145148,+,6756
55,BUMA.1121.00079,2,2156454,2163234,+,6780
55,BUMA.1121.00071,2,2145192,2151948,+,6756
55,BUMA.1121.00086,2,586600,593367,-,6767
55,BUMA.1121.00024,2,1635653,1642419,+,6766
55,BUMA.1121.00010,2,856070,862824,+,6754
55,BUMA.1121.00040,2,518159,524926,-,6767
55,BUMA.1121.00093,2,776627,783393,-,6766
55,BUMA.1121.00091,2,1472597,1479366,-,6769
55,BUMA.1121.00107,2,1650222,1656979,-,6757
55,BUMA.1121.00088,2,2168868,2175636,+,6768
55,BUMA.1121.00047,2,3089933,3096713,+,6780
55,BUMA.1121.00019,2,1579879,1586645,+,6766
55,BUMA.1121.00087,2,10128,16894,+,6766
55,BUMA.1121.00039,2,1803692,1810458,-,6766
55,BUMA.1121.00030,2,599247,606014,-,6767
55,BUMA.1121.00016,2,1548269,1555035,-,6766
55,BUMA.1121.00092,2,2161344,2168112,+,6768
55,BUMA.1121.00046,2,457748,464514,+,6766
55,BUMA.1121.00003,2,390111,396855,+,6744
55,BUMA.1121.00054,2,352231,358998,-,6767
55,BUMA.1121.00015,2,1932472,1939238,+,6766
55,BUMA.1121.00105,2,266518,273287,-,6769
55,BUMA.1121.00053,2,2444307,2451063,+,6756
55,BUMA.1121.00057,2,3075489,3082270,-,6781
55,BUMA.1121.00108,2,2381065,2387833,+,6768
55,BUMA.1121.00050,2,649181,655948,-,6767
55,BUMA.1121.00104,2,2249963,2256731,+,6768
55,BUMA.1121.00014,2,2276491,2283259,+,6768
55,BUMA.1121.00036,2,1069897,1076663,+,6766
55,BUMA.1121.00038,2,552115,558882,-,6767
55,BUMA.1121.00098,2,2417522,2424266,+,6744
55,BUMA.1121.00078,2,984402,991171,-,6769
55,BUMA.1121.00029,2,2415620,2422386,-,6766
55,BUMA.1121.00099,2,2401873,2408677,+,6804
55,BUMA.1121.00103,2,737695,744440,+,6745
55,BUMA.1121.00102,2,2203999,2210755,+,6756
55,BUMA.1121.00028,2,1541917,1548683,+,6766
55,BUMA.1121.00075,2,664406,671159,-,6753
55,BUMA.1121.00044,2,1566883,1573649,+,6766
55,BUMA.1121.00076,2,3111296,3118052,+,6756
55,BUMA.1121.00074,2,2208383,2215152,-,6769
55,BUMA.1121.00073,2,2145196,2151952,+,6756
55,BUMA.1121.00083,2,815140,821896,+,6756
55,BUMA.1121.00035,2,2437050,2443816,-,6766
55,BUMA.1121.00072,2,2119856,2126612,+,6756
55,BUMA.1121.00056,2,1844092,1850870,-,6778
55,BUMA.1121.00081,2,1764668,1771434,+,6766
55,BUMA.1121.00033,2,2944931,2951699,+,6768
55,BUMA.1121.00061,2,2128747,2135503,+,6756
55,BUMA.1121.00062,2,2743898,2750667,-,6769
55,BUMA.1121.00064,2,2064931,2071699,+,6768
55,BUMA.1121.00060,2,200821,207587,-,6766
55,BUMA.1121.00069,2,2111730,2118486,+,6756
55,BUMA.1121.00070,2,2124634,2131390,+,6756
55,BUMA.1121.00068,2,737997,744751,+,6754
55,BUMA.1121.00067,2,1824547,1831316,-,6769
55,BUMA.1121.00037,2,2511326,2518094,+,6768
55,BUMA.1121.00065,2,2193598,2200348,+,6750
55,BUMA.1121.00058,2,2768099,2774867,+,6768
55,BUMA.1121.00041,2,3114942,3121710,+,6768
55,BUMA.1121.00084,2,872598,879354,+,6756
55,BUMA.1121.00096,2,2421203,2427947,+,6744
55,BUMA.1121.00080,2,2158130,2164910,+,6780
55,BUMA.1121.00013,2,1017241,1024008,-,6767
55,BUMA.1121.00100,2,178099,184843,+,6744
55,BUMA.1121.00012,2,2794533,2801299,-,6766
55,BUMA.1121.00018,2,1643909,1650663,-,6754
55,BUMA.1121.00048,2,178662,185428,+,6766
55,BUMA.1121.00106,2,1439088,1445868,+,6780
55,BUMA.1121.00017,2,1515775,1522541,+,6766
55,BUMA.1121.00082,2,2191224,2197980,+,6756
54,BUMA.1121.00049,2,806636,812835,+,6199
54,BUMA.1121.00055,2,521059,527225,-,6166
54,BUMA.1121.00011,2,767193,773393,+,6200
54,BUMA.1121.00110,2,2052959,2059137,+,6178
54,BUMA.1121.00109,2,2518108,2524300,-,6192
54,BUMA.1121.00077,2,1557012,1563190,-,6178
54,BUMA.1121.00027,2,7649,13839,+,6190
54,BUMA.1121.00021,2,2667961,2674187,+,6226
54,BUMA.1121.00023,2,2285119,2291296,+,6177
54,BUMA.1121.00022,2,2142326,2148467,-,6141
54,BUMA.1121.00034,2,1505603,1511744,+,6141
54,BUMA.1121.00025,2,672067,678265,+,6198
54,BUMA.1121.00031,2,1331614,1337825,+,6211
54,BUMA.1121.00007,2,2217530,2223695,+,6165
54,BUMA.1121.00097,2,1984578,1990710,+,6132
54,BUMA.1121.00008,2,1489792,1495933,+,6141
54,BUMA.1121.00059,2,1445158,1451341,-,6183
54,BUMA.1121.00002,2,2087176,2093317,+,6141
54,BUMA.1121.00004,2,1490450,1496591,+,6141
54,BUMA.1121.00005,2,1769763,1775960,-,6197
54,BUMA.1121.00111,2,1479104,1485365,+,6261
54,BUMA.1121.00006,2,562887,569028,-,6141
54,BUMA.1121.00009,2,807931,814104,+,6173
54,BUMA.1121.00094,2,2188014,2194184,+,6170
54,BUMA.1121.00101,2,1267641,1273799,-,6158
54,BUMA.1121.00066,2,2118718,2124908,+,6190
54,BUMA.1121.00095,2,973251,979398,+,6147
54,BUMA.1121.00112,2,2223771,2229992,-,6221
54,BUMA.1121.00032,2,1657299,1663440,+,6141
54,BUMA.1121.00090,2,3146593,3152756,+,6163
54,BUMA.1121.00020,2,1490563,1496704,+,6141
54,BUMA.1121.00089,2,2133781,2139944,+,6163
54,BUMA.1121.00051,2,2147302,2153500,+,6198
54,BUMA.1121.00001,2,48039,54244,-,6205
54,BUMA.1121.00045,2,2032081,2038279,+,6198
54,BUMA.1121.00043,2,150160,156393,-,6233
54,BUMA.1121.00063,2,2128159,2134349,+,6190
54,BUMA.1121.00079,2,2146197,2152409,+,6212
54,BUMA.1121.00071,2,2134959,2141149,+,6190
54,BUMA.1121.00086,2,597407,603548,-,6141
54,BUMA.1121.00024,2,1625472,1631613,+,6141
54,BUMA.1121.00010,2,845889,852030,+,6141
54,BUMA.1121.00040,2,528966,535107,-,6141
54,BUMA.1121.00093,2,787441,793604,-,6163
54,BUMA.1121.00091,2,1483411,1489568,-,6157
54,BUMA.1121.00107,2,1661034,1667224,-,6190
54,BUMA.1121.00088,2,2158631,2164823,+,6192
54,BUMA.1121.00047,2,3079676,3085888,+,6212
54,BUMA.1121.00019,2,1569698,1575839,+,6141
54,BUMA.1121.00087,2,1,6088,+,6087
54,BUMA.1121.00039,2,1814506,1820692,-,6186
54,BUMA.1121.00030,2,610054,616195,-,6141
54,BUMA.1121.00016,2,1559083,1565281,-,6198
54,BUMA.1121.00092,2,2151136,2157299,+,6163
54,BUMA.1121.00046,2,447567,453708,+,6141
54,BUMA.1121.00003,2,379924,386069,+,6145
54,BUMA.1121.00054,2,363038,369179,-,6141
54,BUMA.1121.00015,2,1922291,1928432,+,6141
54,BUMA.1121.00105,2,277332,283502,-,6170
54,BUMA.1121.00053,2,2434081,2440262,+,6181
54,BUMA.1121.00057,2,3086315,3092512,-,6197
54,BUMA.1121.00108,2,2370850,2377023,+,6173
54,BUMA.1121.00050,2,659988,666129,-,6141
54,BUMA.1121.00104,2,2239735,2245918,+,6183
54,BUMA.1121.00014,2,2266205,2272445,+,6240
54,BUMA.1121.00036,2,1059716,1065857,+,6141
54,BUMA.1121.00038,2,562922,569063,-,6141
54,BUMA.1121.00098,2,2407363,2413481,+,6118
54,BUMA.1121.00078,2,995215,1001378,-,6163
54,BUMA.1121.00029,2,2426434,2432625,-,6191
54,BUMA.1121.00099,2,2391680,2397831,+,6151
54,BUMA.1121.00103,2,727449,733653,+,6204
54,BUMA.1121.00102,2,2193737,2199964,+,6227
54,BUMA.1121.00028,2,1531736,1537877,+,6141
54,BUMA.1121.00075,2,675207,681429,-,6222
54,BUMA.1121.00044,2,1556702,1562843,+,6141
54,BUMA.1121.00076,2,3101028,3107251,+,6223
54,BUMA.1121.00074,2,2219197,2225408,-,6211
54,BUMA.1121.00073,2,2134963,2141153,+,6190
54,BUMA.1121.00083,2,804905,811095,+,6190
54,BUMA.1121.00035,2,2447864,2454076,-,6212
54,BUMA.1121.00072,2,2109623,2115813,+,6190
54,BUMA.1121.00056,2,1854918,1861081,-,6163
54,BUMA.1121.00081,2,1754487,1760628,+,6141
54,BUMA.1121.00033,2,2934724,2940886,+,6162
54,BUMA.1121.00061,2,2118514,2124704,+,6190
54,BUMA.1121.00062,2,2754712,2760895,-,6183
54,BUMA.1121.00064,2,2054696,2060886,+,6190
54,BUMA.1121.00060,2,211649,217847,-,6198
54,BUMA.1121.00069,2,2101497,2107687,+,6190
54,BUMA.1121.00070,2,2114401,2120591,+,6190
54,BUMA.1121.00068,2,727754,733952,+,6198
54,BUMA.1121.00067,2,1835361,1841565,-,6204
54,BUMA.1121.00037,2,2501054,2507280,+,6226
54,BUMA.1121.00065,2,2183332,2189537,+,6205
54,BUMA.1121.00058,2,2757864,2764054,+,6190
54,BUMA.1121.00041,2,3104699,3110897,+,6198
54,BUMA.1121.00084,2,862314,868553,+,6239
54,BUMA.1121.00096,2,2410979,2417158,+,6179
54,BUMA.1121.00080,2,2147873,2154085,+,6212
54,BUMA.1121.00013,2,1028048,1034189,-,6141
54,BUMA.1121.00100,2,167889,174053,+,6164
54,BUMA.1121.00012,2,2805347,2811531,-,6184
54,BUMA.1121.00018,2,1654711,1660909,-,6198
54,BUMA.1121.00048,2,168481,174622,+,6141
54,BUMA.1121.00106,2,1428860,1435043,+,6183
54,BUMA.1121.00017,2,1505594,1511735,+,6141
54,BUMA.1121.00082,2,2180991,2187181,+,6190
53,BUMA.1121.00049,2,799102,806626,+,7524
53,BUMA.1121.00055,2,527235,534807,-,7572
53,BUMA.1121.00011,2,759615,767183,+,7568
53,BUMA.1121.00110,2,2045427,2052949,+,7522
53,BUMA.1121.00109,2,2524310,2531861,-,7551
53,BUMA.1121.00077,2,1563200,1570724,-,7524
53,BUMA.1121.00027,2,81,7639,+,7558
53,BUMA.1121.00021,2,2660364,2667951,+,7587
53,BUMA.1121.00023,2,2277558,2285109,+,7551
53,BUMA.1121.00022,2,2148477,2156034,-,7557
53,BUMA.1121.00034,2,1498036,1505593,+,7557
53,BUMA.1121.00025,2,664476,672057,+,7581
53,BUMA.1121.00031,2,1324035,1331604,+,7569
53,BUMA.1121.00007,2,2209977,2217520,+,7543
53,BUMA.1121.00097,2,1977005,1984568,+,7563
53,BUMA.1121.00008,2,1482225,1489782,+,7557
53,BUMA.1121.00059,2,1451351,1458872,-,7521
53,BUMA.1121.00002,2,2079609,2087166,+,7557
53,BUMA.1121.00004,2,1482884,1490440,+,7556
53,BUMA.1121.00005,2,1775970,1783532,-,7562
53,BUMA.1121.00111,2,1471525,1479094,+,7569
53,BUMA.1121.00006,2,569038,576595,-,7557
53,BUMA.1121.00009,2,800353,807921,+,7568
53,BUMA.1121.00094,2,2180447,2188004,+,7557
53,BUMA.1121.00101,2,1273809,1281353,-,7544
53,BUMA.1121.00066,2,2111161,2118708,+,7547
53,BUMA.1121.00095,2,965654,973241,+,7587
53,BUMA.1121.00112,2,2230002,2237588,-,7586
53,BUMA.1121.00032,2,1649732,1657289,+,7557
53,BUMA.1121.00090,2,3139011,3146583,+,7572
53,BUMA.1121.00020,2,1482996,1490553,+,7557
53,BUMA.1121.00089,2,2126192,2133771,+,7579
53,BUMA.1121.00051,2,2139757,2147292,+,7535
53,BUMA.1121.00001,2,54254,61820,-,7566
53,BUMA.1121.00045,2,2024511,2032071,+,7560
53,BUMA.1121.00043,2,156403,163972,-,7569
53,BUMA.1121.00063,2,2120602,2128149,+,7547
53,BUMA.1121.00079,2,2138673,2146187,+,7514
53,BUMA.1121.00071,2,2127404,2134949,+,7545
53,BUMA.1121.00086,2,603558,611115,-,7557
53,BUMA.1121.00024,2,1617905,1625462,+,7557
53,BUMA.1121.00010,2,838322,845879,+,7557
53,BUMA.1121.00040,2,535117,542674,-,7557
53,BUMA.1121.00093,2,793614,801182,-,7568
53,BUMA.1121.00091,2,1489578,1497146,-,7568
53,BUMA.1121.00107,2,1667234,1674812,-,7578
53,BUMA.1121.00088,2,2151064,2158621,+,7557
53,BUMA.1121.00047,2,3072127,3079666,+,7539
53,BUMA.1121.00019,2,1562131,1569688,+,7557
53,BUMA.1121.00087,2,2343797,2351354,+,7557
53,BUMA.1121.00039,2,1820702,1828271,-,7569
53,BUMA.1121.00030,2,616205,623762,-,7557
53,BUMA.1121.00016,2,1565291,1572860,-,7569
53,BUMA.1121.00092,2,2143557,2151126,+,7569
53,BUMA.1121.00046,2,440000,447557,+,7557
53,BUMA.1121.00003,2,372332,379914,+,7582
53,BUMA.1121.00054,2,369189,376746,-,7557
53,BUMA.1121.00015,2,1914724,1922281,+,7557
53,BUMA.1121.00105,2,283512,291033,-,7521
53,BUMA.1121.00053,2,2426517,2434071,+,7554
53,BUMA.1121.00057,2,3092522,3100080,-,7558
53,BUMA.1121.00108,2,2363233,2370838,+,7605
53,BUMA.1121.00050,2,666139,673696,-,7557
53,BUMA.1121.00104,2,2232204,2239725,+,7521
53,BUMA.1121.00014,2,2258637,2266195,+,7558
53,BUMA.1121.00036,2,1052149,1059706,+,7557
53,BUMA.1121.00038,2,569073,576630,-,7557
53,BUMA.1121.00098,2,2399788,2407353,+,7565
53,BUMA.1121.00078,2,1001388,1008940,-,7552
53,BUMA.1121.00029,2,2432635,2440201,-,7566
53,BUMA.1121.00099,2,2384149,2391670,+,7521
53,BUMA.1121.00103,2,719920,727439,+,7519
53,BUMA.1121.00102,2,2186137,2193727,+,7590
53,BUMA.1121.00028,2,1524169,1531726,+,7557
53,BUMA.1121.00075,2,681439,689046,-,7607
53,BUMA.1121.00044,2,1549136,1556692,+,7556
53,BUMA.1121.00076,2,3093411,3101018,+,7607
53,BUMA.1121.00074,2,2225418,2232975,-,7557
53,BUMA.1121.00073,2,2127425,2134953,+,7528
53,BUMA.1121.00083,2,797348,804895,+,7547
53,BUMA.1121.00035,2,2454086,2461652,-,7566
53,BUMA.1121.00072,2,2102088,2109613,+,7525
53,BUMA.1121.00056,2,1861091,1868670,-,7579
53,BUMA.1121.00081,2,1746920,1754477,+,7557
53,BUMA.1121.00033,2,2927145,2934714,+,7569
53,BUMA.1121.00061,2,2110966,2118504,+,7538
53,BUMA.1121.00062,2,2760905,2768462,-,7557
53,BUMA.1121.00064,2,2047165,2054686,+,7521
53,BUMA.1121.00060,2,217857,225417,-,7560
53,BUMA.1121.00069,2,2093940,2101487,+,7547
53,BUMA.1121.00070,2,2106863,2114391,+,7528
53,BUMA.1121.00068,2,720211,727744,+,7533
53,BUMA.1121.00067,2,1841575,1849132,-,7557
53,BUMA.1121.00037,2,2493475,2501044,+,7569
53,BUMA.1121.00065,2,2175753,2183322,+,7569
53,BUMA.1121.00058,2,2750297,2757854,+,7557
53,BUMA.1121.00041,2,3097120,3104689,+,7569
53,BUMA.1121.00084,2,854750,862304,+,7554
53,BUMA.1121.00096,2,2403379,2410969,+,7590
53,BUMA.1121.00080,2,2140325,2147863,+,7538
53,BUMA.1121.00013,2,1034199,1041756,-,7557
53,BUMA.1121.00100,2,160283,167879,+,7596
53,BUMA.1121.00012,2,2811541,2819110,-,7569
53,BUMA.1121.00018,2,1660919,1668500,-,7581
53,BUMA.1121.00048,2,160914,168471,+,7557
53,BUMA.1121.00106,2,1421329,1428850,+,7521
53,BUMA.1121.00017,2,1498029,1505584,+,7555
53,BUMA.1121.00082,2,2173434,2180981,+,7547
52,BUMA.1121.00049,2,788442,798709,+,10267
52,BUMA.1121.00055,2,535200,545464,-,10264
52,BUMA.1121.00011,2,748956,759222,+,10266
52,BUMA.1121.00110,2,2034766,2045034,+,10268
52,BUMA.1121.00109,2,2532254,2542518,-,10264
52,BUMA.1121.00077,2,1571117,1581385,-,10268
52,BUMA.1121.00027,2,3178233,3188498,+,10265
52,BUMA.1121.00021,2,2649703,2659971,+,10268
52,BUMA.1121.00023,2,2266897,2277165,+,10268
52,BUMA.1121.00022,2,2156427,2166679,-,10252
52,BUMA.1121.00034,2,1487391,1497643,+,10252
52,BUMA.1121.00025,2,653815,664083,+,10268
52,BUMA.1121.00031,2,1313374,1323642,+,10268
52,BUMA.1121.00007,2,2199325,2209583,+,10258
52,BUMA.1121.00097,2,1966349,1976612,+,10263
52,BUMA.1121.00008,2,1471580,1481832,+,10252
52,BUMA.1121.00059,2,1459265,1469533,-,10268
52,BUMA.1121.00002,2,2068963,2079216,+,10253
52,BUMA.1121.00004,2,1472239,1482491,+,10252
52,BUMA.1121.00005,2,1783925,1794193,-,10268
52,BUMA.1121.00111,2,1460864,1471132,+,10268
52,BUMA.1121.00006,2,576988,587242,-,10254
52,BUMA.1121.00009,2,789696,799960,+,10264
52,BUMA.1121.00094,2,2169785,2180054,+,10269
52,BUMA.1121.00101,2,1281746,1292012,-,10266
52,BUMA.1121.00066,2,2100501,2110768,+,10267
52,BUMA.1121.00095,2,954998,965261,+,10263
52,BUMA.1121.00112,2,2237981,2248244,-,10263
52,BUMA.1121.00032,2,1639087,1649339,+,10252
52,BUMA.1121.00090,2,3128353,3138618,+,10265
52,BUMA.1121.00020,2,1472351,1482603,+,10252
52,BUMA.1121.00089,2,2115537,2125799,+,10262
52,BUMA.1121.00051,2,2129103,2139364,+,10261
52,BUMA.1121.00001,2,62213,72478,-,10265
52,BUMA.1121.00045,2,2013851,2024118,+,10267
52,BUMA.1121.00043,2,164365,174630,-,10265
52,BUMA.1121.00063,2,2109942,2120209,+,10267
52,BUMA.1121.00079,2,2128015,2138280,+,10265
52,BUMA.1121.00071,2,2116744,2127011,+,10267
52,BUMA.1121.00086,2,611508,621760,-,10252
52,BUMA.1121.00024,2,1607260,1617512,+,10252
52,BUMA.1121.00010,2,827676,837929,+,10253
52,BUMA.1121.00040,2,543067,553318,-,10251
52,BUMA.1121.00093,2,801575,811844,-,10269
52,BUMA.1121.00091,2,1497539,1507802,-,10263
52,BUMA.1121.00107,2,1675205,1685470,-,10265
52,BUMA.1121.00088,2,2140411,2150671,+,10260
52,BUMA.1121.00047,2,3061476,3071734,+,10258
52,BUMA.1121.00019,2,1551486,1561738,+,10252
52,BUMA.1121.00087,2,2333152,2343404,+,10252
52,BUMA.1121.00039,2,1828664,1838937,-,10273
52,BUMA.1121.00030,2,624155,634407,-,10252
52,BUMA.1121.00016,2,1573253,1583521,-,10268
52,BUMA.1121.00092,2,2132895,2143164,+,10269
52,BUMA.1121.00046,2,429354,439607,+,10253
52,BUMA.1121.00003,2,361671,371939,+,10268
52,BUMA.1121.00054,2,377139,387392,-,10253
52,BUMA.1121.00015,2,1904076,1914331,+,10255
52,BUMA.1121.00105,2,291426,301696,-,10270
52,BUMA.1121.00053,2,2415856,2426124,+,10268
52,BUMA.1121.00057,2,3100473,3110747,-,10274
52,BUMA.1121.00108,2,2352554,2362840,+,10286
52,BUMA.1121.00050,2,674089,684342,-,10253
52,BUMA.1121.00104,2,2221568,2231811,+,10243
52,BUMA.1121.00014,2,2247971,2258244,+,10273
52,BUMA.1121.00036,2,1041503,1051756,+,10253
52,BUMA.1121.00038,2,577023,587277,-,10254
52,BUMA.1121.00098,2,2389128,2399395,+,10267
52,BUMA.1121.00078,2,1009333,1019603,-,10270
52,BUMA.1121.00029,2,2440594,2450859,-,10265
52,BUMA.1121.00099,2,2373487,2383756,+,10269
52,BUMA.1121.00103,2,709260,719527,+,10267
52,BUMA.1121.00102,2,2175486,2185744,+,10258
52,BUMA.1121.00028,2,1513524,1523776,+,10252
52,BUMA.1121.00075,2,689439,699704,-,10265
52,BUMA.1121.00044,2,1538491,1548743,+,10252
52,BUMA.1121.00076,2,3082753,3093018,+,10265
52,BUMA.1121.00074,2,2233368,2243633,-,10265
52,BUMA.1121.00073,2,2116765,2127032,+,10267
52,BUMA.1121.00083,2,786688,796955,+,10267
52,BUMA.1121.00035,2,2462045,2472310,-,10265
52,BUMA.1121.00072,2,2091428,2101695,+,10267
52,BUMA.1121.00056,2,1869063,1879325,-,10262
52,BUMA.1121.00081,2,1736273,1746527,+,10254
52,BUMA.1121.00033,2,2916484,2926752,+,10268
52,BUMA.1121.00061,2,2100306,2110573,+,10267
52,BUMA.1121.00062,2,2768855,2779122,-,10267
52,BUMA.1121.00064,2,2036507,2046772,+,10265
52,BUMA.1121.00060,2,225810,236077,-,10267
52,BUMA.1121.00069,2,2083280,2093547,+,10267
52,BUMA.1121.00070,2,2096203,2106470,+,10267
52,BUMA.1121.00068,2,709549,719818,+,10269
52,BUMA.1121.00067,2,1849525,1859790,-,10265
52,BUMA.1121.00037,2,2482809,2493082,+,10273
52,BUMA.1121.00065,2,2165095,2175360,+,10265
52,BUMA.1121.00058,2,2739638,2749904,+,10266
52,BUMA.1121.00041,2,3086462,3096727,+,10265
52,BUMA.1121.00084,2,844113,854357,+,10244
52,BUMA.1121.00096,2,2392717,2402986,+,10269
52,BUMA.1121.00080,2,2129670,2139932,+,10262
52,BUMA.1121.00013,2,1042149,1052401,-,10252
52,BUMA.1121.00100,2,149637,159890,+,10253
52,BUMA.1121.00012,2,2819503,2829768,-,10265
52,BUMA.1121.00018,2,1668893,1679161,-,10268
52,BUMA.1121.00048,2,150267,160521,+,10254
52,BUMA.1121.00106,2,1410668,1420936,+,10268
52,BUMA.1121.00017,2,1487384,1497636,+,10252
52,BUMA.1121.00082,2,2162774,2173041,+,10267
51,BUMA.1121.00049,2,759956,787898,+,27942
51,BUMA.1121.00055,2,545963,573777,-,27814
51,BUMA.1121.00011,2,720668,748442,+,27774
51,BUMA.1121.00110,2,2006443,2034251,+,27808
51,BUMA.1121.00109,2,2543015,2570677,-,27662
51,BUMA.1121.00077,2,1581895,1609707,-,27812
51,BUMA.1121.00027,2,3150001,3177772,+,27771
51,BUMA.1121.00021,2,2621296,2649193,+,27897
51,BUMA.1121.00023,2,2238562,2266400,+,27838
51,BUMA.1121.00022,2,2167120,2193964,-,26844
51,BUMA.1121.00034,2,1460102,1486918,+,26816
51,BUMA.1121.00025,2,625388,653295,+,27907
51,BUMA.1121.00031,2,1284991,1312890,+,27899
51,BUMA.1121.00007,2,2170960,2198808,+,27848
51,BUMA.1121.00097,2,1938017,1965864,+,27847
51,BUMA.1121.00008,2,1444291,1471107,+,26816
51,BUMA.1121.00059,2,1470078,1497937,-,27859
51,BUMA.1121.00002,2,2041683,2068501,+,26818
51,BUMA.1121.00004,2,1444950,1471766,+,26816
51,BUMA.1121.00005,2,1794643,1822605,-,27962
51,BUMA.1121.00111,2,1432455,1460362,+,27907
51,BUMA.1121.00006,2,587707,614553,-,26846
51,BUMA.1121.00009,2,761425,789219,+,27794
51,BUMA.1121.00094,2,2141184,2169157,+,27973
51,BUMA.1121.00101,2,1292564,1320444,-,27880
51,BUMA.1121.00066,2,2072338,2100017,+,27679
51,BUMA.1121.00095,2,926465,954483,+,28018
51,BUMA.1121.00112,2,2248734,2276597,-,27863
51,BUMA.1121.00032,2,1611806,1638622,+,26816
51,BUMA.1121.00090,2,3099930,3127827,+,27897
51,BUMA.1121.00020,2,1445062,1471878,+,26816
51,BUMA.1121.00089,2,2086940,2114917,+,27977
51,BUMA.1121.00051,2,2100595,2128565,+,27970
51,BUMA.1121.00001,2,72962,100963,-,28001
51,BUMA.1121.00045,2,1985558,2013383,+,27825
51,BUMA.1121.00043,2,175135,203072,-,27937
51,BUMA.1121.00063,2,2081772,2109466,+,27694
51,BUMA.1121.00079,2,2099554,2127422,+,27868
51,BUMA.1121.00071,2,2088567,2116273,+,27706
51,BUMA.1121.00086,2,622217,649069,-,26852
51,BUMA.1121.00024,2,1579971,1606787,+,26816
51,BUMA.1121.00010,2,800396,827214,+,26818
51,BUMA.1121.00040,2,553799,580672,-,26873
51,BUMA.1121.00093,2,812294,840071,-,27777
51,BUMA.1121.00091,2,1508280,1536271,-,27991
51,BUMA.1121.00107,2,1685905,1713734,-,27829
51,BUMA.1121.00088,2,2111963,2139857,+,27894
51,BUMA.1121.00047,2,3031753,3059710,+,27957
51,BUMA.1121.00019,2,1524197,1551013,+,26816
51,BUMA.1121.00087,2,2305843,2332687,+,26844
51,BUMA.1121.00039,2,1839450,1867331,-,27881
51,BUMA.1121.00030,2,634864,661696,-,26832
51,BUMA.1121.00016,2,1583965,1611908,-,27943
51,BUMA.1121.00092,2,2104668,2132440,+,27772
51,BUMA.1121.00046,2,402027,428873,+,26846
51,BUMA.1121.00003,2,333344,361166,+,27822
51,BUMA.1121.00054,2,387857,414703,-,26846
51,BUMA.1121.00015,2,1876687,1903563,+,26876
51,BUMA.1121.00105,2,302170,329943,-,27773
51,BUMA.1121.00053,2,2387566,2415335,+,27769
51,BUMA.1121.00057,2,3111215,3139014,-,27799
51,BUMA.1121.00108,2,2324081,2352018,+,27937
51,BUMA.1121.00050,2,684807,711669,-,26862
51,BUMA.1121.00104,2,2191660,2219629,+,27969
51,BUMA.1121.00014,2,2219543,2247469,+,27926
51,BUMA.1121.00036,2,1014186,1041030,+,26844
51,BUMA.1121.00038,2,587742,614588,-,26846
51,BUMA.1121.00098,2,2360737,2388614,+,27877
51,BUMA.1121.00078,2,1020053,1047908,-,27855
51,BUMA.1121.00029,2,2451343,2479360,-,28017
51,BUMA.1121.00099,2,2344899,2372949,+,28050
51,BUMA.1121.00103,2,681103,708781,+,27678
51,BUMA.1121.00102,2,2147210,2174930,+,27720
51,BUMA.1121.00028,2,1486235,1513051,+,26816
51,BUMA.1121.00075,2,700207,728017,-,27810
51,BUMA.1121.00044,2,1511202,1538018,+,26816
51,BUMA.1121.00076,2,3054430,3082237,+,27807
51,BUMA.1121.00074,2,2244186,2272202,-,28016
51,BUMA.1121.00073,2,2088585,2116294,+,27709
51,BUMA.1121.00083,2,758508,786212,+,27704
51,BUMA.1121.00035,2,2472770,2500752,-,27982
51,BUMA.1121.00072,2,2063260,2090944,+,27684
51,BUMA.1121.00056,2,1879857,1907914,-,28057
51,BUMA.1121.00081,2,1708962,1735792,+,26830
51,BUMA.1121.00033,2,2888029,2915950,+,27921
51,BUMA.1121.00061,2,2072171,2099835,+,27664
51,BUMA.1121.00062,2,2779633,2807381,-,27748
51,BUMA.1121.00064,2,2008100,2036029,+,27929
51,BUMA.1121.00060,2,236503,264370,-,27867
51,BUMA.1121.00069,2,2055109,2082809,+,27700
51,BUMA.1121.00070,2,2068028,2095733,+,27705
51,BUMA.1121.00068,2,681206,709043,+,27837
51,BUMA.1121.00067,2,1860271,1888198,-,27927
51,BUMA.1121.00037,2,2454387,2482307,+,27920
51,BUMA.1121.00065,2,2136626,2164569,+,27943
51,BUMA.1121.00058,2,2711126,2739100,+,27974
51,BUMA.1121.00041,2,3058164,3085996,+,27832
51,BUMA.1121.00084,2,814327,842125,+,27798
51,BUMA.1121.00096,2,2364549,2392211,+,27662
51,BUMA.1121.00080,2,2101424,2129067,+,27643
51,BUMA.1121.00013,2,1052866,1079723,-,26857
51,BUMA.1121.00100,2,121282,149135,+,27853
51,BUMA.1121.00012,2,2830228,2858136,-,27908
51,BUMA.1121.00018,2,1679665,1707579,-,27914
51,BUMA.1121.00048,2,122956,149786,+,26830
51,BUMA.1121.00106,2,1382209,1410132,+,27923
51,BUMA.1121.00017,2,1460095,1486911,+,26816
51,BUMA.1121.00082,2,2134594,2162298,+,27704
50,BUMA.1121.00049,2,754845,759946,+,5101
50,BUMA.1121.00055,2,573787,578887,-,5100
50,BUMA.1121.00011,2,715565,720658,+,5093
50,BUMA.1121.00110,2,2001332,2006433,+,5101
50,BUMA.1121.00109,2,2570687,2575787,-,5100
50,BUMA.1121.00077,2,1609717,1614817,-,5100
50,BUMA.1121.00027,2,3144891,3149991,+,5100
50,BUMA.1121.00021,2,2616196,2621286,+,5090
50,BUMA.1121.00023,2,2233462,2238552,+,5090
50,BUMA.1121.00022,2,2193974,2199067,-,5093
50,BUMA.1121.00034,2,1454998,1460092,+,5094
50,BUMA.1121.00025,2,620288,625378,+,5090
50,BUMA.1121.00031,2,1279891,1284981,+,5090
50,BUMA.1121.00007,2,2165849,2170950,+,5101
50,BUMA.1121.00097,2,1932926,1938007,+,5081
50,BUMA.1121.00008,2,1439187,1444281,+,5094
50,BUMA.1121.00059,2,1497947,1503036,-,5089
50,BUMA.1121.00002,2,2036579,2041673,+,5094
50,BUMA.1121.00004,2,1439846,1444940,+,5094
50,BUMA.1121.00005,2,1822615,1827707,-,5092
50,BUMA.1121.00111,2,1427355,1432445,+,5090
50,BUMA.1121.00006,2,614563,619656,-,5093
50,BUMA.1121.00009,2,756315,761415,+,5100
50,BUMA.1121.00094,2,2136084,2141174,+,5090
50,BUMA.1121.00101,2,1320454,1325527,-,5073
50,BUMA.1121.00066,2,2067238,2072328,+,5090
50,BUMA.1121.00095,2,921352,926455,+,5103
50,BUMA.1121.00112,2,2276607,2281747,-,5140
50,BUMA.1121.00032,2,1606702,1611796,+,5094
50,BUMA.1121.00090,2,3094830,3099920,+,5090
50,BUMA.1121.00020,2,1439958,1445052,+,5094
50,BUMA.1121.00089,2,2081830,2086930,+,5100
50,BUMA.1121.00051,2,2095496,2100585,+,5089
50,BUMA.1121.00001,2,100973,106064,-,5091
50,BUMA.1121.00045,2,1980439,1985548,+,5109
50,BUMA.1121.00043,2,203082,208175,-,5093
50,BUMA.1121.00063,2,2076673,2081762,+,5089
50,BUMA.1121.00079,2,2094458,2099544,+,5086
50,BUMA.1121.00071,2,2083467,2088557,+,5090
50,BUMA.1121.00086,2,649079,654172,-,5093
50,BUMA.1121.00024,2,1574867,1579961,+,5094
50,BUMA.1121.00010,2,795292,800386,+,5094
50,BUMA.1121.00040,2,580682,585775,-,5093
50,BUMA.1121.00093,2,840081,845181,-,5100
50,BUMA.1121.00091,2,1536281,1541381,-,5100
50,BUMA.1121.00107,2,1713744,1718843,-,5099
50,BUMA.1121.00088,2,2106852,2111953,+,5101
50,BUMA.1121.00047,2,3026653,3031743,+,5090
50,BUMA.1121.00019,2,1519093,1524187,+,5094
50,BUMA.1121.00087,2,2300739,2305833,+,5094
50,BUMA.1121.00039,2,1867341,1872430,-,5089
50,BUMA.1121.00030,2,661706,666799,-,5093
50,BUMA.1121.00016,2,1611918,1617007,-,5089
50,BUMA.1121.00092,2,2099557,2104658,+,5101
50,BUMA.1121.00046,2,396923,402017,+,5094
50,BUMA.1121.00003,2,328240,333334,+,5094
50,BUMA.1121.00054,2,414713,419806,-,5093
50,BUMA.1121.00015,2,1871583,1876677,+,5094
50,BUMA.1121.00105,2,329953,335042,-,5089
50,BUMA.1121.00053,2,2382466,2387556,+,5090
50,BUMA.1121.00057,2,1,5047,-,5046
50,BUMA.1121.00108,2,2318960,2324071,+,5111
50,BUMA.1121.00050,2,711679,716772,-,5093
50,BUMA.1121.00104,2,2186549,2191650,+,5101
50,BUMA.1121.00014,2,2214443,2219533,+,5090
50,BUMA.1121.00036,2,1009082,1014176,+,5094
50,BUMA.1121.00038,2,614598,619691,-,5093
50,BUMA.1121.00098,2,2355626,2360727,+,5101
50,BUMA.1121.00078,2,1047918,1053024,-,5106
50,BUMA.1121.00029,2,2479370,2484462,-,5092
50,BUMA.1121.00099,2,2339772,2344889,+,5117
50,BUMA.1121.00103,2,675991,681093,+,5102
50,BUMA.1121.00102,2,2142099,2147200,+,5101
50,BUMA.1121.00028,2,1481131,1486225,+,5094
50,BUMA.1121.00075,2,728027,733116,-,5089
50,BUMA.1121.00044,2,1506098,1511192,+,5094
50,BUMA.1121.00076,2,3049330,3054420,+,5090
50,BUMA.1121.00074,2,2272212,2277311,-,5099
50,BUMA.1121.00073,2,2083485,2088575,+,5090
50,BUMA.1121.00083,2,753408,758498,+,5090
50,BUMA.1121.00035,2,2500762,2505854,-,5092
50,BUMA.1121.00072,2,2058161,2063250,+,5089
50,BUMA.1121.00056,2,1907924,1913023,-,5099
50,BUMA.1121.00081,2,1703858,1708952,+,5094
50,BUMA.1121.00033,2,2882929,2888019,+,5090
50,BUMA.1121.00061,2,2067071,2072161,+,5090
50,BUMA.1121.00062,2,2807391,2812480,-,5089
50,BUMA.1121.00064,2,2002999,2008090,+,5091
50,BUMA.1121.00060,2,264380,269488,-,5108
50,BUMA.1121.00069,2,2050010,2055099,+,5089
50,BUMA.1121.00070,2,2062928,2068018,+,5090
50,BUMA.1121.00068,2,676105,681196,+,5091
50,BUMA.1121.00067,2,1888208,1893307,-,5099
50,BUMA.1121.00037,2,2449287,2454377,+,5090
50,BUMA.1121.00065,2,2131526,2136616,+,5090
50,BUMA.1121.00058,2,2706015,2711116,+,5101
50,BUMA.1121.00041,2,3053052,3058154,+,5102
50,BUMA.1121.00084,2,809216,814317,+,5101
50,BUMA.1121.00096,2,2359437,2364539,+,5102
50,BUMA.1121.00080,2,2096324,2101414,+,5090
50,BUMA.1121.00013,2,1079733,1084826,-,5093
50,BUMA.1121.00100,2,116198,121272,+,5074
50,BUMA.1121.00012,2,2858146,2863223,-,5077
50,BUMA.1121.00018,2,1707589,1712678,-,5089
50,BUMA.1121.00048,2,117852,122946,+,5094
50,BUMA.1121.00106,2,1377100,1382199,+,5099
50,BUMA.1121.00017,2,1454991,1460085,+,5094
50,BUMA.1121.00082,2,2129494,2134584,+,5090
49,BUMA.1121.00049,2,740087,754673,+,14586
49,BUMA.1121.00055,2,579060,593662,-,14602
49,BUMA.1121.00011,2,700852,715393,+,14541
49,BUMA.1121.00110,2,1986645,2001160,+,14515
49,BUMA.1121.00109,2,2575960,2590587,-,14627
49,BUMA.1121.00077,2,1614990,1629506,-,14516
49,BUMA.1121.00027,2,3130112,3144719,+,14607
49,BUMA.1121.00026,2,1046446,1061208,-,14762
49,BUMA.1121.00021,2,2601351,2616024,+,14673
49,BUMA.1121.00023,2,2218658,2233290,+,14632
49,BUMA.1121.00022,2,2199240,2213976,-,14736
49,BUMA.1121.00034,2,1440084,1454826,+,14742
49,BUMA.1121.00025,2,605460,620116,+,14656
49,BUMA.1121.00031,2,1265053,1279719,+,14666
49,BUMA.1121.00007,2,2151076,2165677,+,14601
49,BUMA.1121.00097,2,1918176,1932754,+,14578
49,BUMA.1121.00008,2,1424265,1439015,+,14750
49,BUMA.1121.00059,2,1503209,1517887,-,14678
49,BUMA.1121.00002,2,2021749,2036407,+,14658
49,BUMA.1121.00004,2,1424941,1439674,+,14733
49,BUMA.1121.00005,2,1827880,1842498,-,14618
49,BUMA.1121.00111,2,1412560,1427183,+,14623
49,BUMA.1121.00006,2,619829,634491,-,14662
49,BUMA.1121.00009,2,741556,756143,+,14587
49,BUMA.1121.00094,2,2121237,2135912,+,14675
49,BUMA.1121.00101,2,1325700,1340315,-,14615
49,BUMA.1121.00066,2,2052425,2067066,+,14641
49,BUMA.1121.00095,2,906629,921180,+,14551
49,BUMA.1121.00112,2,2281920,2296533,-,14613
49,BUMA.1121.00042,2,1201987,1216638,+,14651
49,BUMA.1121.00032,2,1591789,1606530,+,14741
49,BUMA.1121.00090,2,3080003,3094658,+,14655
49,BUMA.1121.00020,2,1425036,1439786,+,14750
49,BUMA.1121.00089,2,2066981,2081658,+,14677
49,BUMA.1121.00051,2,2080640,2095324,+,14684
49,BUMA.1121.00001,2,106234,120913,-,14679
49,BUMA.1121.00045,2,1965767,1980267,+,14500
49,BUMA.1121.00043,2,208348,222972,-,14624
49,BUMA.1121.00063,2,2061844,2076501,+,14657
49,BUMA.1121.00079,2,2079732,2094286,+,14554
49,BUMA.1121.00071,2,2068648,2083295,+,14647
49,BUMA.1121.00086,2,654345,669080,-,14735
49,BUMA.1121.00024,2,1560025,1574695,+,14670
49,BUMA.1121.00010,2,780327,795120,+,14793
49,BUMA.1121.00040,2,585948,600537,-,14589
49,BUMA.1121.00093,2,845354,860055,-,14701
49,BUMA.1121.00091,2,1541554,1556142,-,14588
49,BUMA.1121.00107,2,1719016,1733605,-,14589
49,BUMA.1121.00088,2,2092050,2106680,+,14630
49,BUMA.1121.00047,2,3011840,3026481,+,14641
49,BUMA.1121.00019,2,1504171,1518921,+,14750
49,BUMA.1121.00087,2,2285832,2300567,+,14735
49,BUMA.1121.00039,2,1872603,1887362,-,14759
49,BUMA.1121.00030,2,666972,681714,-,14742
49,BUMA.1121.00016,2,1617180,1631927,-,14747
49,BUMA.1121.00092,2,2084675,2099385,+,14710
49,BUMA.1121.00046,2,382107,396751,+,14644
49,BUMA.1121.00003,2,313431,328068,+,14637
49,BUMA.1121.00054,2,419979,434641,-,14662
49,BUMA.1121.00015,2,1856726,1871411,+,14685
49,BUMA.1121.00105,2,335215,349849,-,14634
49,BUMA.1121.00053,2,2367681,2382294,+,14613
49,BUMA.1121.00057,2,5220,19819,-,14599
49,BUMA.1121.00108,2,2304194,2318788,+,14594
49,BUMA.1121.00050,2,716945,731580,-,14635
49,BUMA.1121.00104,2,2171590,2186377,+,14787
49,BUMA.1121.00014,2,2199606,2214271,+,14665
49,BUMA.1121.00036,2,994246,1008910,+,14664
49,BUMA.1121.00038,2,619864,634526,-,14662
49,BUMA.1121.00098,2,2340849,2355454,+,14605
49,BUMA.1121.00078,2,1053197,1067879,-,14682
49,BUMA.1121.00029,2,2484632,2499415,-,14783
49,BUMA.1121.00099,2,2325047,2339600,+,14553
49,BUMA.1121.00103,2,661189,675819,+,14630
49,BUMA.1121.00102,2,2127330,2141927,+,14597
49,BUMA.1121.00028,2,1466234,1480959,+,14725
49,BUMA.1121.00075,2,733289,747910,-,14621
49,BUMA.1121.00044,2,1491184,1505926,+,14742
49,BUMA.1121.00076,2,3034536,3049158,+,14622
49,BUMA.1121.00074,2,2277484,2292140,-,14656
49,BUMA.1121.00073,2,2068773,2083313,+,14540
49,BUMA.1121.00083,2,738577,753236,+,14659
49,BUMA.1121.00035,2,2506024,2520732,-,14708
49,BUMA.1121.00072,2,2043333,2057989,+,14656
49,BUMA.1121.00056,2,1913196,1927810,-,14614
49,BUMA.1121.00081,2,1689024,1703686,+,14662
49,BUMA.1121.00033,2,2868205,2882757,+,14552
49,BUMA.1121.00061,2,2052250,2066899,+,14649
49,BUMA.1121.00062,2,2812653,2827240,-,14587
49,BUMA.1121.00064,2,1988088,2002827,+,14739
49,BUMA.1121.00060,2,269661,284161,-,14500
49,BUMA.1121.00069,2,2035180,2049838,+,14658
49,BUMA.1121.00070,2,2048222,2062756,+,14534
49,BUMA.1121.00068,2,661455,675933,+,14478
49,BUMA.1121.00067,2,1893480,1908203,-,14723
49,BUMA.1121.00037,2,2434511,2449115,+,14604
49,BUMA.1121.00065,2,2116657,2131354,+,14697
49,BUMA.1121.00058,2,2691225,2705843,+,14618
49,BUMA.1121.00041,2,3038267,3052880,+,14613
49,BUMA.1121.00084,2,794421,809044,+,14623
49,BUMA.1121.00096,2,2344685,2359265,+,14580
49,BUMA.1121.00080,2,2081526,2096152,+,14626
49,BUMA.1121.00013,2,1084999,1099653,-,14654
49,BUMA.1121.00100,2,101441,116026,+,14585
49,BUMA.1121.00012,2,2863396,2877978,-,14582
49,BUMA.1121.00018,2,1712851,1727498,-,14647
49,BUMA.1121.00048,2,103018,117680,+,14662
49,BUMA.1121.00106,2,1362135,1376928,+,14793
49,BUMA.1121.00017,2,1440077,1454819,+,14742
49,BUMA.1121.00082,2,2114663,2129322,+,14659
48,BUMA.1121.00049,2,697200,740085,+,42885
48,BUMA.1121.00055,2,593663,636373,-,42710
48,BUMA.1121.00011,2,658085,700850,+,42765
48,BUMA.1121.00110,2,1943841,1986643,+,42802
48,BUMA.1121.00109,2,2590588,2633195,-,42607
48,BUMA.1121.00077,2,1629507,1672201,-,42694
48,BUMA.1121.00027,2,3087259,3130110,+,42851
48,BUMA.1121.00026,2,1061209,1103857,-,42648
48,BUMA.1121.00021,2,2558326,2601349,+,43023
48,BUMA.1121.00023,2,2175801,2218656,+,42855
48,BUMA.1121.00022,2,2213977,2256626,-,42649
48,BUMA.1121.00034,2,1397244,1440082,+,42838
48,BUMA.1121.00025,2,562655,605458,+,42803
48,BUMA.1121.00031,2,1222348,1265051,+,42703
48,BUMA.1121.00007,2,2108388,2151074,+,42686
48,BUMA.1121.00097,2,1875203,1918174,+,42971
48,BUMA.1121.00008,2,1381418,1424263,+,42845
48,BUMA.1121.00059,2,1517888,1560812,-,42924
48,BUMA.1121.00002,2,1978979,2021747,+,42768
48,BUMA.1121.00004,2,1382094,1424939,+,42845
48,BUMA.1121.00005,2,1842499,1885166,-,42667
48,BUMA.1121.00111,2,1369694,1412558,+,42864
48,BUMA.1121.00006,2,634492,677115,-,42623
48,BUMA.1121.00009,2,698714,741554,+,42840
48,BUMA.1121.00094,2,2078379,2121235,+,42856
48,BUMA.1121.00101,2,1340316,1382947,-,42631
48,BUMA.1121.00066,2,2009733,2052423,+,42690
48,BUMA.1121.00095,2,829222,871997,+,42775
48,BUMA.1121.00112,2,2296534,2339204,-,42670
48,BUMA.1121.00042,2,1159198,1201985,+,42787
48,BUMA.1121.00032,2,1548930,1591787,+,42857
48,BUMA.1121.00090,2,3037192,3080001,+,42809
48,BUMA.1121.00020,2,1382180,1425034,+,42854
48,BUMA.1121.00089,2,2024042,2066979,+,42937
48,BUMA.1121.00051,2,2037779,2080638,+,42859
48,BUMA.1121.00001,2,120914,163655,-,42741
48,BUMA.1121.00045,2,1922946,1965765,+,42819
48,BUMA.1121.00043,2,222973,265637,-,42664
48,BUMA.1121.00063,2,2019159,2061842,+,42683
48,BUMA.1121.00079,2,2036888,2079730,+,42842
48,BUMA.1121.00071,2,2025941,2068646,+,42705
48,BUMA.1121.00086,2,669081,711806,-,42725
48,BUMA.1121.00024,2,1517196,1560023,+,42827
48,BUMA.1121.00010,2,737558,780325,+,42767
48,BUMA.1121.00040,2,600538,643211,-,42673
48,BUMA.1121.00093,2,860056,902965,-,42909
48,BUMA.1121.00091,2,1556144,1598931,-,42787
48,BUMA.1121.00107,2,1733606,1776256,-,42650
48,BUMA.1121.00088,2,2049155,2092048,+,42893
48,BUMA.1121.00047,2,2969020,3011838,+,42818
48,BUMA.1121.00019,2,1461315,1504169,+,42854
48,BUMA.1121.00087,2,2243019,2285830,+,42811
48,BUMA.1121.00039,2,1887363,1930169,-,42806
48,BUMA.1121.00030,2,681715,724431,-,42716
48,BUMA.1121.00016,2,1631928,1674684,-,42756
48,BUMA.1121.00092,2,2041480,2084673,+,43193
48,BUMA.1121.00046,2,339339,382105,+,42766
48,BUMA.1121.00003,2,270625,313429,+,42804
48,BUMA.1121.00054,2,434642,477265,-,42623
48,BUMA.1121.00015,2,1813924,1856724,+,42800
48,BUMA.1121.00105,2,349850,392567,-,42717
48,BUMA.1121.00053,2,2324849,2367679,+,42830
48,BUMA.1121.00057,2,19820,62596,-,42776
48,BUMA.1121.00108,2,2261586,2304192,+,42606
48,BUMA.1121.00050,2,731581,774225,-,42644
48,BUMA.1121.00104,2,2128731,2171588,+,42857
48,BUMA.1121.00014,2,2156733,2199604,+,42871
48,BUMA.1121.00036,2,951409,994244,+,42835
48,BUMA.1121.00038,2,634527,677150,-,42623
48,BUMA.1121.00098,2,2298101,2340847,+,42746
48,BUMA.1121.00078,2,1067880,1110673,-,42793
48,BUMA.1121.00029,2,2499416,2542179,-,42763
48,BUMA.1121.00099,2,2282171,2325045,+,42874
48,BUMA.1121.00103,2,582390,625264,+,42874
48,BUMA.1121.00102,2,2084190,2127328,+,43138
48,BUMA.1121.00028,2,1423405,1466232,+,42827
48,BUMA.1121.00075,2,747911,790537,-,42626
48,BUMA.1121.00044,2,1448344,1491182,+,42838
48,BUMA.1121.00076,2,2991819,3034534,+,42715
48,BUMA.1121.00074,2,2292141,2334979,-,42838
48,BUMA.1121.00073,2,2026063,2068771,+,42708
48,BUMA.1121.00083,2,695784,738575,+,42791
48,BUMA.1121.00035,2,2520733,2563441,-,42708
48,BUMA.1121.00072,2,2000591,2043331,+,42740
48,BUMA.1121.00056,2,1927811,1970542,-,42731
48,BUMA.1121.00081,2,1646277,1689022,+,42745
48,BUMA.1121.00033,2,2825414,2868203,+,42789
48,BUMA.1121.00061,2,2009488,2052248,+,42760
48,BUMA.1121.00062,2,2827241,2870066,-,42825
48,BUMA.1121.00064,2,1945193,1988086,+,42893
48,BUMA.1121.00060,2,284162,326853,-,42691
48,BUMA.1121.00069,2,1992561,2035178,+,42617
48,BUMA.1121.00070,2,2005510,2048220,+,42710
48,BUMA.1121.00068,2,618660,661453,+,42793
48,BUMA.1121.00067,2,1908204,1951004,-,42800
48,BUMA.1121.00037,2,2391746,2434509,+,42763
48,BUMA.1121.00065,2,2073844,2116655,+,42811
48,BUMA.1121.00058,2,2648486,2691223,+,42737
48,BUMA.1121.00041,2,2995471,3038265,+,42794
48,BUMA.1121.00084,2,751624,794419,+,42795
48,BUMA.1121.00096,2,2301828,2344683,+,42855
48,BUMA.1121.00080,2,2038567,2081524,+,42957
48,BUMA.1121.00013,2,1099654,1142312,-,42658
48,BUMA.1121.00100,2,58576,101439,+,42863
48,BUMA.1121.00012,2,2877979,2920730,-,42751
48,BUMA.1121.00018,2,1727499,1770179,-,42680
48,BUMA.1121.00048,2,60270,103016,+,42746
48,BUMA.1121.00106,2,1319222,1362133,+,42911
48,BUMA.1121.00017,2,1397237,1440075,+,42838
48,BUMA.1121.00082,2,2071870,2114661,+,42791
47,BUMA.1121.00049,2,680332,692463,+,12131
47,BUMA.1121.00055,2,641245,653285,-,12040
47,BUMA.1121.00011,2,641374,653339,+,11965
47,BUMA.1121.00110,2,1926969,1939094,+,12125
47,BUMA.1121.00109,2,2638064,2650220,-,12156
47,BUMA.1121.00077,2,1677070,1689195,-,12125
47,BUMA.1121.00027,2,3070468,3082513,+,12045
47,BUMA.1121.00026,2,48113,60217,+,12104
47,BUMA.1121.00021,2,2541420,2553580,+,12160
47,BUMA.1121.00023,2,2158996,2171054,+,12058
47,BUMA.1121.00022,2,816922,828921,+,11999
47,BUMA.1121.00034,2,1255579,1267612,+,12033
47,BUMA.1121.00025,2,545739,557907,+,12168
47,BUMA.1121.00031,2,1205544,1217602,+,12058
47,BUMA.1121.00007,2,2091579,2103642,+,12063
47,BUMA.1121.00097,2,1862164,1874143,+,11979
47,BUMA.1121.00008,2,1239754,1251787,+,12033
47,BUMA.1121.00059,2,1565680,1577737,-,12057
47,BUMA.1121.00002,2,1811284,1823308,+,12024
47,BUMA.1121.00004,2,1240439,1252472,+,12033
47,BUMA.1121.00005,2,1890036,1902000,-,11964
47,BUMA.1121.00111,2,1352811,1364948,+,12137
47,BUMA.1121.00006,2,1575198,1587293,+,12095
47,BUMA.1121.00009,2,681645,693969,+,12324
47,BUMA.1121.00094,2,2061540,2073633,+,12093
47,BUMA.1121.00101,2,1387815,1399860,-,12045
47,BUMA.1121.00066,2,1992997,2004994,+,11997
47,BUMA.1121.00095,2,816047,828134,+,12087
47,BUMA.1121.00112,2,2344071,2356112,-,12041
47,BUMA.1121.00042,2,197711,209790,-,12079
47,BUMA.1121.00090,2,3020327,3032445,+,12118
47,BUMA.1121.00020,2,1240515,1252548,+,12033
47,BUMA.1121.00089,2,2007242,2019295,+,12053
47,BUMA.1121.00051,2,2020971,2033032,+,12061
47,BUMA.1121.00001,2,168523,180767,-,12244
47,BUMA.1121.00045,2,1906062,1918200,+,12138
47,BUMA.1121.00043,2,270506,282554,-,12048
47,BUMA.1121.00063,2,2002424,2014421,+,11997
47,BUMA.1121.00079,2,2020144,2032141,+,11997
47,BUMA.1121.00071,2,2009209,2021206,+,11997
47,BUMA.1121.00086,2,1624779,1636802,+,12023
47,BUMA.1121.00024,2,1375531,1387564,+,12033
47,BUMA.1121.00010,2,570035,582059,+,12024
47,BUMA.1121.00040,2,1563004,1575022,+,12018
47,BUMA.1121.00093,2,907835,919932,-,12097
47,BUMA.1121.00091,2,1603799,1615746,-,11947
47,BUMA.1121.00107,2,1781124,1793150,-,12026
47,BUMA.1121.00088,2,2032243,2044409,+,12166
47,BUMA.1121.00047,2,2952291,2964273,+,11982
47,BUMA.1121.00019,2,1319650,1331683,+,12033
47,BUMA.1121.00087,2,1892182,1904205,+,12023
47,BUMA.1121.00039,2,1936392,1948527,-,12135
47,BUMA.1121.00030,2,854184,866217,-,12033
47,BUMA.1121.00016,2,1679553,1691737,-,12184
47,BUMA.1121.00092,2,2024653,2036732,+,12079
47,BUMA.1121.00085,2,626452,638567,+,12115
47,BUMA.1121.00046,2,2054194,2066152,+,11958
47,BUMA.1121.00003,2,257541,269533,+,11992
47,BUMA.1121.00054,2,1375315,1387410,+,12095
47,BUMA.1121.00015,2,1452070,1464072,+,12002
47,BUMA.1121.00105,2,397435,409491,-,12056
47,BUMA.1121.00052,2,1314999,1327114,+,12115
47,BUMA.1121.00053,2,2308127,2320103,+,11976
47,BUMA.1121.00057,2,67464,79475,-,12011
47,BUMA.1121.00108,2,2244855,2256842,+,11987
47,BUMA.1121.00050,2,1670183,1682141,+,11958
47,BUMA.1121.00104,2,2112003,2123985,+,11982
47,BUMA.1121.00014,2,2139948,2151987,+,12039
47,BUMA.1121.00036,2,27877,39877,-,12000
47,BUMA.1121.00038,2,1476400,1488487,+,12087
47,BUMA.1121.00098,2,2281247,2293356,+,12109
47,BUMA.1121.00078,2,1115542,1127620,-,12078
47,BUMA.1121.00029,2,2547046,2559214,-,12168
47,BUMA.1121.00099,2,2268874,2281088,+,12214
47,BUMA.1121.00103,2,565548,577644,+,12096
47,BUMA.1121.00102,2,2067343,2079445,+,12102
47,BUMA.1121.00028,2,1281733,1293774,+,12041
47,BUMA.1121.00075,2,795407,807386,-,11979
47,BUMA.1121.00044,2,1306680,1318713,+,12033
47,BUMA.1121.00076,2,2975105,2987071,+,11966
47,BUMA.1121.00074,2,2339847,2351866,-,12019
47,BUMA.1121.00073,2,2009326,2021323,+,11997
47,BUMA.1121.00083,2,679040,691037,+,11997
47,BUMA.1121.00035,2,2568310,2580489,-,12179
47,BUMA.1121.00072,2,1983847,1995844,+,11997
47,BUMA.1121.00056,2,1975411,1987464,-,12053
47,BUMA.1121.00081,2,736220,748315,-,12095
47,BUMA.1121.00033,2,2808630,2820668,+,12038
47,BUMA.1121.00061,2,1992753,2004750,+,11997
47,BUMA.1121.00062,2,2874934,2887040,-,12106
47,BUMA.1121.00064,2,1928410,1940447,+,12037
47,BUMA.1121.00060,2,331721,343814,-,12093
47,BUMA.1121.00069,2,1979894,1991891,+,11997
47,BUMA.1121.00070,2,1988775,2000772,+,11997
47,BUMA.1121.00068,2,601740,613914,+,12174
47,BUMA.1121.00067,2,1955872,1967915,-,12043
47,BUMA.1121.00037,2,2374928,2386997,+,12069
47,BUMA.1121.00065,2,2056984,2069097,+,12113
47,BUMA.1121.00058,2,2631744,2643739,+,11995
47,BUMA.1121.00041,2,2978529,2990741,+,12212
47,BUMA.1121.00084,2,734830,746878,+,12048
47,BUMA.1121.00096,2,2288596,2300745,+,12149
47,BUMA.1121.00080,2,2021776,2033820,+,12044
47,BUMA.1121.00013,2,1921742,1933819,+,12077
47,BUMA.1121.00100,2,45322,57487,+,12165
47,BUMA.1121.00012,2,2925599,2937663,-,12064
47,BUMA.1121.00018,2,1775049,1787217,-,12168
47,BUMA.1121.00048,2,1475614,1487709,-,12095
47,BUMA.1121.00106,2,1302470,1314476,+,12006
47,BUMA.1121.00017,2,1255572,1267605,+,12033
47,BUMA.1121.00082,2,2055126,2067123,+,11997
46,BUMA.1121.00049,2,675708,678757,+,3049
46,BUMA.1121.00055,2,654872,657921,-,3049
46,BUMA.1121.00011,2,636738,639787,+,3049
46,BUMA.1121.00110,2,1922324,1925373,+,3049
46,BUMA.1121.00109,2,2651807,2654856,-,3049
46,BUMA.1121.00077,2,1690791,1693840,-,3049
46,BUMA.1121.00027,2,3065844,3068893,+,3049
46,BUMA.1121.00026,2,43477,46526,+,3049
46,BUMA.1121.00021,2,2536793,2539842,+,3049
46,BUMA.1121.00023,2,2154369,2157418,+,3049
46,BUMA.1121.00022,2,812286,815335,+,3049
46,BUMA.1121.00034,2,1250943,1253992,+,3049
46,BUMA.1121.00025,2,541103,544152,+,3049
46,BUMA.1121.00031,2,1200917,1203966,+,3049
46,BUMA.1121.00007,2,2086943,2089992,+,3049
46,BUMA.1121.00097,2,1857510,1860559,+,3049
46,BUMA.1121.00008,2,1235118,1238167,+,3049
46,BUMA.1121.00059,2,1579312,1582361,-,3049
46,BUMA.1121.00002,2,1806648,1809697,+,3049
46,BUMA.1121.00004,2,1235803,1238852,+,3049
46,BUMA.1121.00005,2,1903585,1906634,-,3049
46,BUMA.1121.00111,2,1348183,1351233,+,3050
46,BUMA.1121.00006,2,1570562,1573611,+,3049
46,BUMA.1121.00009,2,677009,680058,+,3049
46,BUMA.1121.00094,2,2056913,2059962,+,3049
46,BUMA.1121.00101,2,1401447,1404496,-,3049
46,BUMA.1121.00066,2,1988361,1991410,+,3049
46,BUMA.1121.00095,2,811411,814460,+,3049
46,BUMA.1121.00112,2,2357699,2360748,-,3049
46,BUMA.1121.00042,2,211377,214426,-,3049
46,BUMA.1121.00090,2,3015700,3018749,+,3049
46,BUMA.1121.00020,2,1235879,1238928,+,3049
46,BUMA.1121.00089,2,2002615,2005664,+,3049
46,BUMA.1121.00051,2,2016345,2019394,+,3049
46,BUMA.1121.00001,2,182345,185394,-,3049
46,BUMA.1121.00045,2,1901426,1904475,+,3049
46,BUMA.1121.00043,2,284141,287190,-,3049
46,BUMA.1121.00063,2,1997788,2000837,+,3049
46,BUMA.1121.00079,2,2015518,2018566,+,3048
46,BUMA.1121.00071,2,2004573,2007622,+,3049
46,BUMA.1121.00086,2,1620143,1623192,+,3049
46,BUMA.1121.00024,2,1370895,1373944,+,3049
46,BUMA.1121.00010,2,565399,568448,+,3049
46,BUMA.1121.00040,2,1558368,1561417,+,3049
46,BUMA.1121.00093,2,921519,924568,-,3049
46,BUMA.1121.00091,2,1617333,1620382,-,3049
46,BUMA.1121.00107,2,1794710,1797759,-,3049
46,BUMA.1121.00088,2,2027616,2030665,+,3049
46,BUMA.1121.00047,2,2947667,2950716,+,3049
46,BUMA.1121.00019,2,1315014,1318063,+,3049
46,BUMA.1121.00087,2,1887546,1890595,+,3049
46,BUMA.1121.00039,2,1950105,1953154,-,3049
46,BUMA.1121.00030,2,867804,870853,-,3049
46,BUMA.1121.00016,2,1693315,1696364,-,3049
46,BUMA.1121.00092,2,2020017,2023066,+,3049
46,BUMA.1121.00085,2,621816,624865,+,3049
46,BUMA.1121.00046,2,2049558,2052607,+,3049
46,BUMA.1121.00003,2,252905,255954,+,3049
46,BUMA.1121.00054,2,1370679,1373728,+,3049
46,BUMA.1121.00015,2,1447434,1450483,+,3049
46,BUMA.1121.00105,2,411069,414118,-,3049
46,BUMA.1121.00052,2,1310363,1313412,+,3049
46,BUMA.1121.00053,2,2303491,2306540,+,3049
46,BUMA.1121.00057,2,81062,84111,-,3049
46,BUMA.1121.00108,2,2240219,2243268,+,3049
46,BUMA.1121.00050,2,1665547,1668596,+,3049
46,BUMA.1121.00104,2,2107367,2110416,+,3049
46,BUMA.1121.00014,2,2135321,2138370,+,3049
46,BUMA.1121.00036,2,41464,44513,-,3049
46,BUMA.1121.00038,2,1471764,1474813,+,3049
46,BUMA.1121.00098,2,2276620,2279669,+,3049
46,BUMA.1121.00078,2,1129207,1132256,-,3049
46,BUMA.1121.00029,2,2560792,2563841,-,3049
46,BUMA.1121.00099,2,2264238,2267287,+,3049
46,BUMA.1121.00103,2,560912,563961,+,3049
46,BUMA.1121.00102,2,2062707,2065756,+,3049
46,BUMA.1121.00028,2,1277097,1280146,+,3049
46,BUMA.1121.00075,2,808973,812022,-,3049
46,BUMA.1121.00044,2,1302044,1305093,+,3049
46,BUMA.1121.00076,2,2970469,2973518,+,3049
46,BUMA.1121.00074,2,2353441,2356490,-,3049
46,BUMA.1121.00073,2,2004690,2007739,+,3049
46,BUMA.1121.00083,2,674404,677453,+,3049
46,BUMA.1121.00035,2,2582067,2585116,-,3049
46,BUMA.1121.00072,2,1979211,1982260,+,3049
46,BUMA.1121.00056,2,1989042,1992091,-,3049
46,BUMA.1121.00081,2,749902,752951,-,3049
46,BUMA.1121.00033,2,2804003,2807052,+,3049
46,BUMA.1121.00061,2,1988117,1991166,+,3049
46,BUMA.1121.00062,2,2888615,2891664,-,3049
46,BUMA.1121.00064,2,1923786,1926835,+,3049
46,BUMA.1121.00060,2,345401,348450,-,3049
46,BUMA.1121.00069,2,1975258,1978307,+,3049
46,BUMA.1121.00070,2,1984139,1987188,+,3049
46,BUMA.1121.00068,2,597104,600153,+,3049
46,BUMA.1121.00067,2,1969493,1972542,-,3049
46,BUMA.1121.00037,2,2370301,2373350,+,3049
46,BUMA.1121.00065,2,2052348,2055397,+,3049
46,BUMA.1121.00058,2,2627108,2630157,+,3049
46,BUMA.1121.00041,2,2973893,2976942,+,3049
46,BUMA.1121.00084,2,730194,733243,+,3049
46,BUMA.1121.00096,2,2283956,2287009,+,3053
46,BUMA.1121.00080,2,2017149,2020198,+,3049
46,BUMA.1121.00013,2,1917106,1920155,+,3049
46,BUMA.1121.00100,2,40686,43735,+,3049
46,BUMA.1121.00012,2,2939247,2942296,-,3049
46,BUMA.1121.00018,2,1788804,1791853,-,3049
46,BUMA.1121.00048,2,1489296,1492345,-,3049
46,BUMA.1121.00106,2,1297846,1300895,+,3049
46,BUMA.1121.00017,2,1250936,1253985,+,3049
46,BUMA.1121.00082,2,2050490,2053539,+,3049
45,BUMA.1121.00049,2,660395,670715,+,10320
45,BUMA.1121.00055,2,662905,673347,-,10442
45,BUMA.1121.00011,2,621354,631691,+,10337
45,BUMA.1121.00110,2,1907028,1917322,+,10294
45,BUMA.1121.00109,2,2659876,2670193,-,10317
45,BUMA.1121.00077,2,1698842,1709134,-,10292
45,BUMA.1121.00027,2,3050487,3060779,+,10292
45,BUMA.1121.00026,2,28014,38358,+,10344
45,BUMA.1121.00021,2,2521481,2531782,+,10301
45,BUMA.1121.00023,2,2138977,2149286,+,10309
45,BUMA.1121.00022,2,796841,807284,+,10443
45,BUMA.1121.00034,2,1235515,1245905,+,10390
45,BUMA.1121.00025,2,525723,536056,+,10333
45,BUMA.1121.00031,2,1185554,1195897,+,10343
45,BUMA.1121.00007,2,2071567,2081888,+,10321
45,BUMA.1121.00097,2,1842136,1852445,+,10309
45,BUMA.1121.00008,2,1219695,1230071,+,10376
45,BUMA.1121.00059,2,1587336,1597613,-,10277
45,BUMA.1121.00002,2,1791119,1801538,+,10419
45,BUMA.1121.00004,2,1220389,1230765,+,10376
45,BUMA.1121.00005,2,1911661,1922070,-,10409
45,BUMA.1121.00111,2,1332897,1343209,+,10312
45,BUMA.1121.00006,2,1555061,1565524,+,10463
45,BUMA.1121.00009,2,661686,671998,+,10312
45,BUMA.1121.00094,2,2041593,2051902,+,10309
45,BUMA.1121.00101,2,1409633,1419961,-,10328
45,BUMA.1121.00066,2,1973007,1983368,+,10361
45,BUMA.1121.00095,2,796153,806409,+,10256
45,BUMA.1121.00112,2,2365741,2376040,-,10299
45,BUMA.1121.00042,2,219464,229906,-,10442
45,BUMA.1121.00090,2,3000299,3010599,+,10300
45,BUMA.1121.00020,2,1220442,1230832,+,10390
45,BUMA.1121.00089,2,1987304,1997604,+,10300
45,BUMA.1121.00051,2,2001036,2011335,+,10299
45,BUMA.1121.00001,2,190504,200819,-,10315
45,BUMA.1121.00045,2,1886140,1896406,+,10266
45,BUMA.1121.00043,2,292309,302593,-,10284
45,BUMA.1121.00063,2,1982427,1992795,+,10368
45,BUMA.1121.00079,2,2000288,2010579,+,10291
45,BUMA.1121.00071,2,1989264,1999580,+,10316
45,BUMA.1121.00086,2,1604665,1615141,+,10476
45,BUMA.1121.00024,2,1355458,1365848,+,10390
45,BUMA.1121.00010,2,549906,560289,+,10383
45,BUMA.1121.00040,2,1542967,1553366,+,10399
45,BUMA.1121.00093,2,929606,939919,-,10313
45,BUMA.1121.00091,2,1625456,1635923,-,10467
45,BUMA.1121.00107,2,1802806,1813168,-,10362
45,BUMA.1121.00088,2,2012337,2022641,+,10304
45,BUMA.1121.00047,2,2932365,2942665,+,10300
45,BUMA.1121.00019,2,1299586,1309976,+,10390
45,BUMA.1121.00087,2,1872068,1882544,+,10476
45,BUMA.1121.00039,2,1958183,1968475,-,10292
45,BUMA.1121.00030,2,875891,886282,-,10391
45,BUMA.1121.00016,2,1701420,1711794,-,10374
45,BUMA.1121.00092,2,2004667,2014979,+,10312
45,BUMA.1121.00085,2,606300,616769,+,10469
45,BUMA.1121.00046,2,2034020,2044457,+,10437
45,BUMA.1121.00003,2,237604,247930,+,10326
45,BUMA.1121.00054,2,1355178,1365641,+,10463
45,BUMA.1121.00015,2,1432042,1442450,+,10408
45,BUMA.1121.00105,2,419084,429388,-,10304
45,BUMA.1121.00052,2,1294847,1305316,+,10469
45,BUMA.1121.00053,2,2288171,2298453,+,10282
45,BUMA.1121.00057,2,89095,99414,-,10319
45,BUMA.1121.00108,2,2224870,2235172,+,10302
45,BUMA.1121.00050,2,1650000,1660446,+,10446
45,BUMA.1121.00104,2,2091975,2102311,+,10336
45,BUMA.1121.00014,2,2119965,2130310,+,10345
45,BUMA.1121.00036,2,49551,59986,-,10435
45,BUMA.1121.00038,2,1456263,1466726,+,10463
45,BUMA.1121.00098,2,2261354,2271663,+,10309
45,BUMA.1121.00078,2,1137361,1147747,-,10386
45,BUMA.1121.00029,2,2568933,2579240,-,10307
45,BUMA.1121.00099,2,2248814,2259117,+,10303
45,BUMA.1121.00103,2,545596,555892,+,10296
45,BUMA.1121.00102,2,2047097,2057669,+,10572
45,BUMA.1121.00028,2,1261660,1272050,+,10390
45,BUMA.1121.00075,2,817122,827423,-,10301
45,BUMA.1121.00044,2,1286616,1297006,+,10390
45,BUMA.1121.00076,2,2955113,2965413,+,10300
45,BUMA.1121.00074,2,2361483,2371796,-,10313
45,BUMA.1121.00073,2,1989331,1999705,+,10374
45,BUMA.1121.00083,2,659030,669411,+,10381
45,BUMA.1121.00035,2,2590199,2600515,-,10316
45,BUMA.1121.00072,2,1963843,1974218,+,10375
45,BUMA.1121.00056,2,1997102,2007403,-,10301
45,BUMA.1121.00081,2,757989,768453,-,10464
45,BUMA.1121.00033,2,2788702,2798983,+,10281
45,BUMA.1121.00061,2,1972883,1983124,+,10241
45,BUMA.1121.00062,2,2896630,2906970,-,10340
45,BUMA.1121.00064,2,1908463,1918775,+,10312
45,BUMA.1121.00060,2,353479,363747,-,10268
45,BUMA.1121.00069,2,1959962,1970265,+,10303
45,BUMA.1121.00070,2,1968828,1979154,+,10326
45,BUMA.1121.00068,2,581752,592066,+,10314
45,BUMA.1121.00067,2,1977562,1987884,-,10322
45,BUMA.1121.00037,2,2354999,2365317,+,10318
45,BUMA.1121.00065,2,2037091,2047328,+,10237
45,BUMA.1121.00058,2,2611761,2622079,+,10318
45,BUMA.1121.00041,2,2958483,2968829,+,10346
45,BUMA.1121.00084,2,714808,725111,+,10303
45,BUMA.1121.00096,2,2268425,2278877,+,10452
45,BUMA.1121.00080,2,2001794,2012103,+,10309
45,BUMA.1121.00013,2,1901606,1911996,+,10390
45,BUMA.1121.00100,2,25382,35675,+,10293
45,BUMA.1121.00012,2,2947405,2957710,-,10305
45,BUMA.1121.00018,2,1796873,1807197,-,10324
45,BUMA.1121.00048,2,1497383,1507833,-,10450
45,BUMA.1121.00106,2,1282472,1292844,+,10372
45,BUMA.1121.00017,2,1235508,1245898,+,10390
45,BUMA.1121.00082,2,2035116,2045497,+,10381
44,BUMA.1121.00049,2,635746,658879,+,23133
44,BUMA.1121.00055,2,674863,698160,-,23297
44,BUMA.1121.00011,2,596684,619838,+,23154
44,BUMA.1121.00110,2,1882317,1905527,+,23210
44,BUMA.1121.00109,2,2671640,2694821,-,23181
44,BUMA.1121.00077,2,1710635,1733876,-,23241
44,BUMA.1121.00027,2,3025890,3048972,+,23082
44,BUMA.1121.00026,2,3782,26966,+,23184
44,BUMA.1121.00021,2,2496488,2519980,+,23492
44,BUMA.1121.00023,2,2114296,2137491,+,23195
44,BUMA.1121.00022,2,772675,795802,+,23127
44,BUMA.1121.00034,2,1211241,1234449,+,23208
44,BUMA.1121.00025,2,500956,524222,+,23266
44,BUMA.1121.00031,2,1160742,1184054,+,23312
44,BUMA.1121.00007,2,2046861,2070051,+,23190
44,BUMA.1121.00097,2,1817529,1840635,+,23106
44,BUMA.1121.00008,2,1195401,1218623,+,23222
44,BUMA.1121.00059,2,1599114,1622308,-,23194
44,BUMA.1121.00002,2,1766862,1790074,+,23212
44,BUMA.1121.00004,2,1196116,1219317,+,23201
44,BUMA.1121.00005,2,1923565,1946721,-,23156
44,BUMA.1121.00111,2,1308055,1331396,+,23341
44,BUMA.1121.00006,2,1530840,1554022,+,23182
44,BUMA.1121.00009,2,636840,660201,+,23361
44,BUMA.1121.00094,2,2016835,2040092,+,23257
44,BUMA.1121.00101,2,1421447,1444826,-,23379
44,BUMA.1121.00066,2,1949930,1972868,+,22938
44,BUMA.1121.00095,2,771379,794607,+,23228
44,BUMA.1121.00112,2,2377556,2400751,-,23195
44,BUMA.1121.00042,2,230951,254127,-,23176
44,BUMA.1121.00090,2,2975524,2998813,+,23289
44,BUMA.1121.00020,2,1196155,1219370,+,23215
44,BUMA.1121.00089,2,1962538,1985803,+,23265
44,BUMA.1121.00051,2,1976287,1999535,+,23248
44,BUMA.1121.00001,2,202320,225557,-,23237
44,BUMA.1121.00045,2,1861575,1884624,+,23049
44,BUMA.1121.00043,2,304094,327479,-,23385
44,BUMA.1121.00063,2,1959364,1982289,+,22925
44,BUMA.1121.00079,2,1975372,1998787,+,23415
44,BUMA.1121.00071,2,1966155,1989126,+,22971
44,BUMA.1121.00086,2,1580452,1603626,+,23174
44,BUMA.1121.00024,2,1331214,1354422,+,23208
44,BUMA.1121.00010,2,525656,548861,+,23205
44,BUMA.1121.00040,2,1518731,1541901,+,23170
44,BUMA.1121.00093,2,941420,964857,-,23437
44,BUMA.1121.00091,2,1637439,1660594,-,23155
44,BUMA.1121.00107,2,1814684,1837784,-,23100
44,BUMA.1121.00088,2,1987246,2010836,+,23590
44,BUMA.1121.00047,2,2907619,2930864,+,23245
44,BUMA.1121.00019,2,1275299,1298514,+,23215
44,BUMA.1121.00087,2,1847855,1871029,+,23174
44,BUMA.1121.00039,2,1969976,1993153,-,23177
44,BUMA.1121.00030,2,887348,910547,-,23199
44,BUMA.1121.00016,2,1713280,1736759,-,23479
44,BUMA.1121.00092,2,1979728,2003166,+,23438
44,BUMA.1121.00085,2,582044,605255,+,23211
44,BUMA.1121.00046,2,2009818,2032978,+,23160
44,BUMA.1121.00003,2,213372,236550,+,23178
44,BUMA.1121.00054,2,1330957,1354139,+,23182
44,BUMA.1121.00015,2,1407850,1430982,+,23132
44,BUMA.1121.00105,2,430889,454186,-,23297
44,BUMA.1121.00052,2,1270591,1293802,+,23211
44,BUMA.1121.00053,2,2263326,2286685,+,23359
44,BUMA.1121.00057,2,100915,124193,-,23278
44,BUMA.1121.00108,2,2200038,2223339,+,23301
44,BUMA.1121.00050,2,1625798,1648958,+,23160
44,BUMA.1121.00104,2,2067201,2090474,+,23273
44,BUMA.1121.00014,2,2095040,2118464,+,23424
44,BUMA.1121.00036,2,61043,84202,-,23159
44,BUMA.1121.00038,2,1432042,1455224,+,23182
44,BUMA.1121.00098,2,2236673,2259853,+,23180
44,BUMA.1121.00078,2,1149209,1172421,-,23212
44,BUMA.1121.00029,2,2580726,2604046,-,23320
44,BUMA.1121.00099,2,2224633,2247781,+,23148
44,BUMA.1121.00103,2,520759,544050,+,23291
44,BUMA.1121.00102,2,2022245,2045581,+,23336
44,BUMA.1121.00028,2,1237386,1260594,+,23208
44,BUMA.1121.00075,2,828885,852080,-,23195
44,BUMA.1121.00044,2,1262349,1285550,+,23201
44,BUMA.1121.00076,2,2930489,2953651,+,23162
44,BUMA.1121.00074,2,2373297,2396534,-,23237
44,BUMA.1121.00073,2,1966225,1989192,+,22967
44,BUMA.1121.00083,2,634503,657529,+,23026
44,BUMA.1121.00035,2,2602016,2625385,-,23369
44,BUMA.1121.00072,2,1940728,1963705,+,22977
44,BUMA.1121.00056,2,2008904,2032063,-,23159
44,BUMA.1121.00081,2,769492,792673,-,23181
44,BUMA.1121.00033,2,2763969,2787203,+,23234
44,BUMA.1121.00061,2,1948392,1971385,+,22993
44,BUMA.1121.00062,2,2908471,2931969,-,23498
44,BUMA.1121.00064,2,1883748,1906962,+,23214
44,BUMA.1121.00060,2,365263,388311,-,23048
44,BUMA.1121.00069,2,1936822,1959824,+,23002
44,BUMA.1121.00070,2,1945692,1968689,+,22997
44,BUMA.1121.00068,2,556701,580251,+,23550
44,BUMA.1121.00067,2,1989385,2012868,-,23483
44,BUMA.1121.00037,2,2330233,2353513,+,23280
44,BUMA.1121.00065,2,2012399,2035605,+,23206
44,BUMA.1121.00058,2,2587017,2610260,+,23243
44,BUMA.1121.00041,2,2933809,2957006,+,23197
44,BUMA.1121.00084,2,689993,713307,+,23314
44,BUMA.1121.00096,2,2244203,2267374,+,23171
44,BUMA.1121.00080,2,1977006,2000293,+,23287
44,BUMA.1121.00013,2,1877385,1900561,+,23176
44,BUMA.1121.00100,2,620,23920,+,23300
44,BUMA.1121.00012,2,2959196,2982463,-,23267
44,BUMA.1121.00018,2,1808697,1831954,-,23257
44,BUMA.1121.00048,2,1508872,1532053,-,23181
44,BUMA.1121.00106,2,1257714,1280971,+,23257
44,BUMA.1121.00017,2,1211227,1234442,+,23215
44,BUMA.1121.00082,2,2010589,2033615,+,23026
43,BUMA.1121.00049,2,591139,631946,+,40807
43,BUMA.1121.00055,2,701960,742791,-,40831
43,BUMA.1121.00011,2,551684,592852,+,41168
43,BUMA.1121.00110,2,1837425,1878524,+,41099
43,BUMA.1121.00109,2,2698618,2739745,-,41127
43,BUMA.1121.00077,2,1737670,1778922,-,41252
43,BUMA.1121.00027,2,2979724,3020632,+,40908
43,BUMA.1121.00026,2,1817530,1858520,+,40990
43,BUMA.1121.00021,2,2451750,2492692,+,40942
43,BUMA.1121.00023,2,2069454,2110500,+,41046
43,BUMA.1121.00022,2,727722,768875,+,41153
43,BUMA.1121.00034,2,1166555,1207441,+,40886
43,BUMA.1121.00025,2,456413,497160,+,40747
43,BUMA.1121.00031,2,1116202,1156946,+,40744
43,BUMA.1121.00007,2,2001896,2043051,+,41155
43,BUMA.1121.00097,2,1772640,1813719,+,41079
43,BUMA.1121.00008,2,1150710,1191601,+,40891
43,BUMA.1121.00059,2,1626119,1667176,-,41057
43,BUMA.1121.00002,2,1722112,1763063,+,40951
43,BUMA.1121.00004,2,1151410,1192316,+,40906
43,BUMA.1121.00005,2,1950518,1991714,-,41196
43,BUMA.1121.00111,2,1262207,1302905,+,40698
43,BUMA.1121.00006,2,1485860,1527039,+,41179
43,BUMA.1121.00009,2,592299,633025,+,40726
43,BUMA.1121.00094,2,1972203,2013039,+,40836
43,BUMA.1121.00101,2,1448623,1489328,-,40705
43,BUMA.1121.00066,2,1903844,1944672,+,40828
43,BUMA.1121.00095,2,726522,767578,+,41056
43,BUMA.1121.00112,2,2404548,2445278,-,40730
43,BUMA.1121.00042,2,257929,298985,-,41056
43,BUMA.1121.00090,2,2930874,2971728,+,40854
43,BUMA.1121.00020,2,1151441,1192355,+,40914
43,BUMA.1121.00089,2,1917898,1958742,+,40844
43,BUMA.1121.00051,2,1931406,1972491,+,41085
43,BUMA.1121.00001,2,230708,271617,-,40909
43,BUMA.1121.00045,2,1816958,1857765,+,40807
43,BUMA.1121.00043,2,331276,372056,-,40780
43,BUMA.1121.00063,2,1913289,1954106,+,40817
43,BUMA.1121.00079,2,1930553,1971576,+,41023
43,BUMA.1121.00071,2,1920072,1960897,+,40825
43,BUMA.1121.00086,2,1535414,1576652,+,41238
43,BUMA.1121.00024,2,1286538,1327414,+,40876
43,BUMA.1121.00010,2,480916,521856,+,40940
43,BUMA.1121.00040,2,1473859,1514931,+,41072
43,BUMA.1121.00093,2,968654,1009400,-,40746
43,BUMA.1121.00091,2,1664391,1705405,-,41014
43,BUMA.1121.00107,2,1841606,1882229,-,40623
43,BUMA.1121.00088,2,1942665,1983425,+,40760
43,BUMA.1121.00047,2,2862695,2903823,+,41128
43,BUMA.1121.00019,2,1230564,1271499,+,40935
43,BUMA.1121.00087,2,1802797,1844055,+,41258
43,BUMA.1121.00039,2,1996950,2037699,-,40749
43,BUMA.1121.00030,2,914348,955239,-,40891
43,BUMA.1121.00016,2,1740556,1781272,-,40716
43,BUMA.1121.00092,2,1935143,1975932,+,40789
43,BUMA.1121.00085,2,537263,578243,+,40980
43,BUMA.1121.00046,2,1964780,2006017,+,41237
43,BUMA.1121.00003,2,168792,209572,+,40780
43,BUMA.1121.00054,2,1285979,1327156,+,41177
43,BUMA.1121.00015,2,1362814,1404049,+,41235
43,BUMA.1121.00105,2,457983,498932,-,40949
43,BUMA.1121.00052,2,1225810,1266790,+,40980
43,BUMA.1121.00053,2,2218722,2259505,+,40783
43,BUMA.1121.00057,2,129452,170236,-,40784
43,BUMA.1121.00108,2,2155292,2196231,+,40939
43,BUMA.1121.00050,2,1580971,1621997,+,41026
43,BUMA.1121.00104,2,2022557,2063402,+,40845
43,BUMA.1121.00014,2,2050450,2091244,+,40794
43,BUMA.1121.00036,2,88003,129201,-,41198
43,BUMA.1121.00038,2,1387026,1428241,+,41215
43,BUMA.1121.00098,2,2192151,2232883,+,40732
43,BUMA.1121.00078,2,1176221,1217332,-,41111
43,BUMA.1121.00029,2,2609197,2649968,-,40771
43,BUMA.1121.00099,2,2180171,2220821,+,40650
43,BUMA.1121.00103,2,476083,516960,+,40877
43,BUMA.1121.00102,2,1977470,2018424,+,40954
43,BUMA.1121.00028,2,1192675,1233586,+,40911
43,BUMA.1121.00075,2,855871,896814,-,40943
43,BUMA.1121.00044,2,1217659,1258549,+,40890
43,BUMA.1121.00076,2,2885622,2926699,+,41077
43,BUMA.1121.00074,2,2400342,2441230,-,40888
43,BUMA.1121.00073,2,1920143,1960967,+,40824
43,BUMA.1121.00083,2,588405,629245,+,40840
43,BUMA.1121.00035,2,2630536,2671405,-,40869
43,BUMA.1121.00072,2,1894640,1935470,+,40830
43,BUMA.1121.00056,2,2035860,2076668,-,40808
43,BUMA.1121.00081,2,796475,837674,-,41199
43,BUMA.1121.00033,2,2719456,2760173,+,40717
43,BUMA.1121.00061,2,1902303,1943134,+,40831
43,BUMA.1121.00062,2,2935766,2976394,-,40628
43,BUMA.1121.00064,2,1839162,1879941,+,40779
43,BUMA.1121.00060,2,392122,432941,-,40819
43,BUMA.1121.00069,2,1892187,1933013,+,40826
43,BUMA.1121.00070,2,1899606,1940434,+,40828
43,BUMA.1121.00068,2,511751,552874,+,41123
43,BUMA.1121.00067,2,2016676,2057446,-,40770
43,BUMA.1121.00037,2,2285359,2326437,+,41078
43,BUMA.1121.00065,2,1967698,2008600,+,40902
43,BUMA.1121.00058,2,2542391,2583218,+,40827
43,BUMA.1121.00041,2,2888717,2929988,+,41271
43,BUMA.1121.00084,2,645377,686197,+,40820
43,BUMA.1121.00096,2,2199258,2240408,+,41150
43,BUMA.1121.00080,2,1932015,1973210,+,41195
43,BUMA.1121.00013,2,1832568,1873584,+,41016
43,BUMA.1121.00100,2,3063896,3104814,+,40918
43,BUMA.1121.00012,2,2987613,3028315,-,40702
43,BUMA.1121.00018,2,1835751,1876510,-,40759
43,BUMA.1121.00048,2,1535855,1577040,-,41185
43,BUMA.1121.00106,2,1213178,1253920,+,40742
43,BUMA.1121.00017,2,1166534,1207427,+,40893
43,BUMA.1121.00082,2,1964498,2005331,+,40833
42,BUMA.1121.00049,2,583743,587293,+,3550
42,BUMA.1121.00055,2,745692,749254,-,3562
42,BUMA.1121.00011,2,544563,548108,+,3545
42,BUMA.1121.00110,2,1830626,1834158,+,3532
42,BUMA.1121.00109,2,2743579,2747112,-,3533
42,BUMA.1121.00077,2,1782189,1785722,-,3533
42,BUMA.1121.00027,2,2972481,2976028,+,3547
42,BUMA.1121.00021,2,2444341,2447874,+,3533
42,BUMA.1121.00023,2,2063591,2067138,+,3547
42,BUMA.1121.00025,2,448990,452537,+,3547
42,BUMA.1121.00031,2,1110522,1114069,+,3547
42,BUMA.1121.00007,2,1994026,1997570,+,3544
42,BUMA.1121.00097,2,1765272,1768818,+,3546
42,BUMA.1121.00059,2,1671022,1674570,-,3548
42,BUMA.1121.00005,2,1995236,1998795,-,3559
42,BUMA.1121.00111,2,1254784,1258331,+,3547
42,BUMA.1121.00009,2,585081,588627,+,3546
42,BUMA.1121.00094,2,1965248,1968795,+,3547
42,BUMA.1121.00101,2,1493054,1496587,-,3533
42,BUMA.1121.00066,2,1896635,1900181,+,3546
42,BUMA.1121.00095,2,719517,723063,+,3546
42,BUMA.1121.00112,2,2448374,2451912,-,3538
42,BUMA.1121.00090,2,2923446,2926998,+,3552
42,BUMA.1121.00089,2,1910454,1914001,+,3547
42,BUMA.1121.00051,2,1923964,1927509,+,3545
42,BUMA.1121.00001,2,275493,279041,-,3548
42,BUMA.1121.00045,2,1809749,1813295,+,3546
42,BUMA.1121.00043,2,375932,379480,-,3548
42,BUMA.1121.00063,2,1906081,1909626,+,3545
42,BUMA.1121.00079,2,1923109,1926656,+,3547
42,BUMA.1121.00071,2,1912864,1916409,+,3545
42,BUMA.1121.00093,2,1013288,1016821,-,3533
42,BUMA.1121.00091,2,1708969,1712517,-,3548
42,BUMA.1121.00107,2,1886006,1889538,-,3532
42,BUMA.1121.00088,2,1935328,1938873,+,3545
42,BUMA.1121.00047,2,2855380,2858927,+,3547
42,BUMA.1121.00039,2,2040996,2044544,-,3548
42,BUMA.1121.00016,2,1785406,1788954,-,3548
42,BUMA.1121.00092,2,1927723,1931255,+,3532
42,BUMA.1121.00003,2,161514,165045,+,3531
42,BUMA.1121.00105,2,502466,506014,-,3548
42,BUMA.1121.00053,2,2211612,2215158,+,3546
42,BUMA.1121.00057,2,173899,177447,-,3548
42,BUMA.1121.00108,2,2148171,2151716,+,3545
42,BUMA.1121.00104,2,2015164,2018711,+,3547
42,BUMA.1121.00014,2,2044374,2047921,+,3547
42,BUMA.1121.00098,2,2184771,2188308,+,3537
42,BUMA.1121.00078,2,1220359,1223913,-,3554
42,BUMA.1121.00029,2,2653844,2657392,-,3548
42,BUMA.1121.00099,2,2172770,2176316,+,3546
42,BUMA.1121.00103,2,469000,472546,+,3546
42,BUMA.1121.00102,2,1970360,1973906,+,3546
42,BUMA.1121.00075,2,901140,904688,-,3548
42,BUMA.1121.00076,2,2877749,2881296,+,3547
42,BUMA.1121.00074,2,2444656,2448204,-,3548
42,BUMA.1121.00073,2,1912934,1916480,+,3546
42,BUMA.1121.00083,2,581196,584742,+,3546
42,BUMA.1121.00035,2,2675281,2678843,-,3562
42,BUMA.1121.00072,2,1887618,1891164,+,3546
42,BUMA.1121.00056,2,2080574,2084122,-,3548
42,BUMA.1121.00033,2,2712033,2715580,+,3547
42,BUMA.1121.00061,2,1895095,1898640,+,3545
42,BUMA.1121.00062,2,2980162,2983695,-,3533
42,BUMA.1121.00064,2,1832189,1835736,+,3547
42,BUMA.1121.00060,2,436604,440151,-,3547
42,BUMA.1121.00069,2,1884996,1888542,+,3546
42,BUMA.1121.00070,2,1892397,1895943,+,3546
42,BUMA.1121.00068,2,504626,508172,+,3546
42,BUMA.1121.00067,2,2059045,2062593,-,3548
42,BUMA.1121.00037,2,2279454,2283001,+,3547
42,BUMA.1121.00065,2,1961289,1964836,+,3547
42,BUMA.1121.00058,2,2535886,2539446,+,3560
42,BUMA.1121.00041,2,2881009,2884553,+,3544
42,BUMA.1121.00084,2,637911,641456,+,3545
42,BUMA.1121.00096,2,2192235,2195766,+,3531
42,BUMA.1121.00080,2,1924571,1928118,+,3547
42,BUMA.1121.00100,2,3056764,3060299,+,3535
42,BUMA.1121.00012,2,3030502,3034057,-,3555
42,BUMA.1121.00018,2,1880386,1883934,-,3548
42,BUMA.1121.00106,2,1205785,1209332,+,3547
42,BUMA.1121.00082,2,1957289,1960835,+,3546
41,BUMA.1121.00049,2,549125,571671,+,22546
41,BUMA.1121.00055,2,760539,783077,-,22538
41,BUMA.1121.00011,2,510056,533015,+,22959
41,BUMA.1121.00110,2,1796959,1819996,+,23037
41,BUMA.1121.00109,2,2758029,2781219,-,23190
41,BUMA.1121.00077,2,1796350,1819388,-,23038
41,BUMA.1121.00027,2,2938796,2961340,+,22544
41,BUMA.1121.00026,2,826699,849250,-,22551
41,BUMA.1121.00021,2,2409896,2432995,+,23099
41,BUMA.1121.00023,2,2031136,2054178,+,23042
41,BUMA.1121.00022,2,975432,998075,+,22643
41,BUMA.1121.00025,2,414855,437844,+,22989
41,BUMA.1121.00031,2,1078421,1101500,+,23079
41,BUMA.1121.00007,2,1959943,1982981,+,23038
41,BUMA.1121.00097,2,1729750,1752224,+,22474
41,BUMA.1121.00008,2,445899,468553,-,22654
41,BUMA.1121.00059,2,1685517,1708008,-,22491
41,BUMA.1121.00004,2,446054,468708,-,22654
41,BUMA.1121.00005,2,2010420,2033084,-,22664
41,BUMA.1121.00111,2,1221372,1244276,+,22904
41,BUMA.1121.00006,2,1731433,1754056,+,22623
41,BUMA.1121.00009,2,551072,573974,+,22902
41,BUMA.1121.00094,2,1930988,1953433,+,22445
41,BUMA.1121.00101,2,1507990,1530797,-,22807
41,BUMA.1121.00066,2,1863261,1885767,+,22506
41,BUMA.1121.00095,2,686385,709231,+,22846
41,BUMA.1121.00112,2,2463914,2486836,-,22922
41,BUMA.1121.00032,2,870375,893029,-,22654
41,BUMA.1121.00090,2,2889194,2912164,+,22970
41,BUMA.1121.00020,2,446034,468688,-,22654
41,BUMA.1121.00089,2,1876197,1898639,+,22442
41,BUMA.1121.00051,2,1889677,1912156,+,22479
41,BUMA.1121.00001,2,289785,312338,-,22553
41,BUMA.1121.00045,2,1777290,1800343,+,23053
41,BUMA.1121.00043,2,390749,413270,-,22521
41,BUMA.1121.00063,2,1872278,1894798,+,22520
41,BUMA.1121.00079,2,1888859,1911301,+,22442
41,BUMA.1121.00071,2,1878896,1901417,+,22521
41,BUMA.1121.00086,2,1783344,1805959,+,22615
41,BUMA.1121.00024,2,445931,468585,-,22654
41,BUMA.1121.00093,2,1027540,1050133,-,22593
41,BUMA.1121.00091,2,1722546,1745268,-,22722
41,BUMA.1121.00107,2,1900655,1923282,-,22627
41,BUMA.1121.00088,2,1900265,1922792,+,22527
41,BUMA.1121.00047,2,2821104,2843572,+,22468
41,BUMA.1121.00019,2,445998,468652,-,22654
41,BUMA.1121.00087,2,2050507,2073122,+,22615
41,BUMA.1121.00039,2,2051701,2074352,-,22651
41,BUMA.1121.00016,2,1799682,1822264,-,22582
41,BUMA.1121.00092,2,1894411,1917003,+,22592
41,BUMA.1121.00046,2,65629,88181,+,22552
41,BUMA.1121.00003,2,127221,150101,+,22880
41,BUMA.1121.00054,2,1531553,1554176,+,22623
41,BUMA.1121.00105,2,515829,538369,-,22540
41,BUMA.1121.00053,2,2177634,2200276,+,22642
41,BUMA.1121.00057,2,188912,211410,-,22498
41,BUMA.1121.00108,2,2115473,2138411,+,22938
41,BUMA.1121.00050,2,1826413,1848965,+,22552
41,BUMA.1121.00104,2,1981231,2003745,+,22514
41,BUMA.1121.00014,2,2012267,2035352,+,23085
41,BUMA.1121.00036,2,2142924,2165488,-,22564
41,BUMA.1121.00038,2,1632626,1655249,+,22623
41,BUMA.1121.00098,2,2150845,2173378,+,22533
41,BUMA.1121.00078,2,1235090,1257741,-,22651
41,BUMA.1121.00029,2,2668135,2690721,-,22586
41,BUMA.1121.00099,2,2139463,2162036,+,22573
41,BUMA.1121.00103,2,435215,458302,+,23087
41,BUMA.1121.00102,2,1939964,1962608,+,22644
41,BUMA.1121.00028,2,446013,468680,-,22667
41,BUMA.1121.00075,2,915643,938589,-,22946
41,BUMA.1121.00076,2,2843845,2866793,+,22948
41,BUMA.1121.00074,2,2458803,2481312,-,22509
41,BUMA.1121.00073,2,1878949,1901470,+,22521
41,BUMA.1121.00083,2,547209,569730,+,22521
41,BUMA.1121.00035,2,2686638,2709215,-,22577
41,BUMA.1121.00072,2,1853789,1876309,+,22520
41,BUMA.1121.00056,2,2095669,2118112,-,22443
41,BUMA.1121.00081,2,569454,592078,-,22624
41,BUMA.1121.00033,2,2678384,2701030,+,22646
41,BUMA.1121.00061,2,1861123,1883644,+,22521
41,BUMA.1121.00062,2,2995386,3017958,-,22572
41,BUMA.1121.00064,2,1799008,1821589,+,22581
41,BUMA.1121.00060,2,449556,472649,-,23093
41,BUMA.1121.00069,2,1851241,1873744,+,22503
41,BUMA.1121.00070,2,1858412,1880931,+,22519
41,BUMA.1121.00068,2,472337,494688,+,22351
41,BUMA.1121.00067,2,2073192,2095775,-,22583
41,BUMA.1121.00037,2,2248742,2271291,+,22549
41,BUMA.1121.00065,2,1928398,1951320,+,22922
41,BUMA.1121.00058,2,2503325,2525833,+,22508
41,BUMA.1121.00041,2,2846978,2870062,+,23084
41,BUMA.1121.00084,2,603526,626103,+,22577
41,BUMA.1121.00096,2,2158329,2181349,+,23020
41,BUMA.1121.00080,2,1890574,1913030,+,22456
41,BUMA.1121.00100,2,3024360,3047465,+,23105
41,BUMA.1121.00012,2,3044921,3067972,-,23051
41,BUMA.1121.00018,2,1895079,1918069,-,22990
41,BUMA.1121.00048,2,1308848,1331472,-,22624
41,BUMA.1121.00106,2,1172041,1194581,+,22540
41,BUMA.1121.00082,2,1923302,1945823,+,22521
40,BUMA.1121.00049,2,521265,549104,+,27839
40,BUMA.1121.00055,2,783098,810968,-,27870
40,BUMA.1121.00011,2,482160,510035,+,27875
40,BUMA.1121.00110,2,1769051,1796938,+,27887
40,BUMA.1121.00109,2,2781240,2809116,-,27876
40,BUMA.1121.00077,2,1819409,1847297,-,27888
40,BUMA.1121.00027,2,2910913,2938775,+,27862
40,BUMA.1121.00021,2,2382024,2409875,+,27851
40,BUMA.1121.00023,2,2003249,2031115,+,27866
40,BUMA.1121.00025,2,386977,414834,+,27857
40,BUMA.1121.00031,2,1050536,1078400,+,27864
40,BUMA.1121.00007,2,1932076,1959922,+,27846
40,BUMA.1121.00097,2,1701853,1729729,+,27876
40,BUMA.1121.00059,2,1708029,1735884,-,27855
40,BUMA.1121.00005,2,2033105,2060968,-,27863
40,BUMA.1121.00111,2,1193499,1221351,+,27852
40,BUMA.1121.00009,2,523170,551051,+,27881
40,BUMA.1121.00094,2,1903160,1930985,+,27825
40,BUMA.1121.00101,2,1530818,1558675,-,27857
40,BUMA.1121.00066,2,1835379,1863240,+,27861
40,BUMA.1121.00095,2,658505,686364,+,27859
40,BUMA.1121.00112,2,2486857,2514708,-,27851
40,BUMA.1121.00090,2,2861303,2889173,+,27870
40,BUMA.1121.00089,2,1848369,1876194,+,27825
40,BUMA.1121.00051,2,1861831,1889674,+,27843
40,BUMA.1121.00001,2,312359,340236,-,27877
40,BUMA.1121.00045,2,1749399,1777269,+,27870
40,BUMA.1121.00043,2,413291,441150,-,27859
40,BUMA.1121.00063,2,1844394,1872257,+,27863
40,BUMA.1121.00079,2,1861008,1888856,+,27848
40,BUMA.1121.00071,2,1851005,1878875,+,27870
40,BUMA.1121.00093,2,1050154,1077994,-,27840
40,BUMA.1121.00091,2,1745289,1773128,-,27839
40,BUMA.1121.00107,2,1923303,1951160,-,27857
40,BUMA.1121.00088,2,1872374,1900244,+,27870
40,BUMA.1121.00047,2,2793258,2821101,+,27843
40,BUMA.1121.00039,2,2074373,2102227,-,27854
40,BUMA.1121.00016,2,1822285,1850142,-,27857
40,BUMA.1121.00092,2,1866550,1894390,+,27840
40,BUMA.1121.00003,2,99359,127200,+,27841
40,BUMA.1121.00105,2,538390,566254,-,27864
40,BUMA.1121.00053,2,2149759,2177613,+,27854
40,BUMA.1121.00057,2,211431,239289,-,27858
40,BUMA.1121.00108,2,2087576,2115452,+,27876
40,BUMA.1121.00104,2,1953352,1981210,+,27858
40,BUMA.1121.00014,2,1984380,2012246,+,27866
40,BUMA.1121.00098,2,2122976,2150824,+,27848
40,BUMA.1121.00078,2,1257762,1285602,-,27840
40,BUMA.1121.00029,2,2690742,2718599,-,27857
40,BUMA.1121.00099,2,2111602,2139442,+,27840
40,BUMA.1121.00103,2,407366,435194,+,27828
40,BUMA.1121.00102,2,1912055,1939943,+,27888
40,BUMA.1121.00075,2,938610,966476,-,27866
40,BUMA.1121.00076,2,2815958,2843824,+,27866
40,BUMA.1121.00074,2,2481315,2509176,-,27861
40,BUMA.1121.00073,2,1851066,1878928,+,27862
40,BUMA.1121.00083,2,519318,547188,+,27870
40,BUMA.1121.00035,2,2709236,2737102,-,27866
40,BUMA.1121.00072,2,1825907,1853768,+,27861
40,BUMA.1121.00056,2,2118115,2145940,-,27825
40,BUMA.1121.00033,2,2650869,2678363,+,27494
40,BUMA.1121.00061,2,1833242,1861102,+,27860
40,BUMA.1121.00062,2,3017979,3045837,-,27858
40,BUMA.1121.00064,2,1771141,1798987,+,27846
40,BUMA.1121.00060,2,472670,500540,-,27870
40,BUMA.1121.00069,2,1823350,1851220,+,27870
40,BUMA.1121.00070,2,1830530,1858391,+,27861
40,BUMA.1121.00068,2,444445,472316,+,27871
40,BUMA.1121.00067,2,2095796,2123666,-,27870
40,BUMA.1121.00037,2,2220828,2248721,+,27893
40,BUMA.1121.00065,2,1900513,1928377,+,27864
40,BUMA.1121.00058,2,2475434,2503304,+,27870
40,BUMA.1121.00041,2,2819118,2846957,+,27839
40,BUMA.1121.00084,2,575635,603505,+,27870
40,BUMA.1121.00096,2,2130468,2158308,+,27840
40,BUMA.1121.00080,2,1862728,1890571,+,27843
40,BUMA.1121.00100,2,2996497,3024339,+,27842
40,BUMA.1121.00012,2,3067993,3095837,-,27844
40,BUMA.1121.00018,2,1918090,1945948,-,27858
40,BUMA.1121.00106,2,1144156,1172020,+,27864
40,BUMA.1121.00082,2,1895411,1923281,+,27870
39,BUMA.1121.00049,2,514389,517524,+,3135
39,BUMA.1121.00055,2,813185,816318,-,3133
39,BUMA.1121.00011,2,476807,479943,+,3136
39,BUMA.1121.00110,2,1765279,1768414,+,3135
39,BUMA.1121.00109,2,2809753,2812885,-,3132
39,BUMA.1121.00077,2,1847934,1851065,-,3131
39,BUMA.1121.00027,2,2905564,2908697,+,3133
39,BUMA.1121.00021,2,2376673,2379807,+,3134
39,BUMA.1121.00023,2,1997899,2001032,+,3133
39,BUMA.1121.00025,2,381626,384759,+,3133
39,BUMA.1121.00031,2,1043867,1047001,+,3134
39,BUMA.1121.00007,2,1928306,1931439,+,3133
39,BUMA.1121.00097,2,1696500,1699636,+,3136
39,BUMA.1121.00059,2,1738101,1741236,-,3135
39,BUMA.1121.00005,2,2063185,2066319,-,3134
39,BUMA.1121.00111,2,1188149,1191282,+,3133
39,BUMA.1121.00009,2,517819,520953,+,3134
39,BUMA.1121.00094,2,1899400,1902523,+,3123
39,BUMA.1121.00101,2,1560892,1564026,-,3134
39,BUMA.1121.00066,2,1830029,1833162,+,3133
39,BUMA.1121.00095,2,654735,657869,+,3134
39,BUMA.1121.00112,2,2516925,2520072,-,3147
39,BUMA.1121.00090,2,2855952,2859086,+,3134
39,BUMA.1121.00089,2,1844609,1847732,+,3123
39,BUMA.1121.00051,2,1858071,1861194,+,3123
39,BUMA.1121.00001,2,342453,345585,-,3132
39,BUMA.1121.00045,2,1744049,1747182,+,3133
39,BUMA.1121.00043,2,443368,446500,-,3132
39,BUMA.1121.00079,2,1857248,1860371,+,3123
39,BUMA.1121.00071,2,1845655,1848788,+,3133
39,BUMA.1121.00093,2,1080211,1083343,-,3132
39,BUMA.1121.00091,2,1775345,1778478,-,3133
39,BUMA.1121.00107,2,1953377,1956511,-,3134
39,BUMA.1121.00088,2,1867023,1870157,+,3134
39,BUMA.1121.00047,2,2789498,2792621,+,3123
39,BUMA.1121.00039,2,2104444,2107576,-,3132
39,BUMA.1121.00016,2,1852358,1855490,-,3132
39,BUMA.1121.00092,2,1861200,1864333,+,3133
39,BUMA.1121.00003,2,95593,98723,+,3130
39,BUMA.1121.00105,2,566891,570024,-,3133
39,BUMA.1121.00053,2,2144408,2147542,+,3134
39,BUMA.1121.00057,2,241506,244638,-,3132
39,BUMA.1121.00108,2,2082224,2085359,+,3135
39,BUMA.1121.00104,2,1948001,1951135,+,3134
39,BUMA.1121.00014,2,1977710,1980844,+,3134
39,BUMA.1121.00098,2,2117626,2120759,+,3133
39,BUMA.1121.00078,2,1287819,1290953,-,3134
39,BUMA.1121.00029,2,2720816,2723948,-,3132
39,BUMA.1121.00099,2,2107855,2110965,+,3110
39,BUMA.1121.00103,2,403592,406728,+,3136
39,BUMA.1121.00102,2,1906704,1909838,+,3134
39,BUMA.1121.00075,2,968693,971826,-,3133
39,BUMA.1121.00076,2,2810607,2813741,+,3134
39,BUMA.1121.00074,2,2511393,2514526,-,3133
39,BUMA.1121.00073,2,1845716,1848849,+,3133
39,BUMA.1121.00083,2,513968,517101,+,3133
39,BUMA.1121.00035,2,2739319,2742451,-,3132
39,BUMA.1121.00072,2,1820557,1823690,+,3133
39,BUMA.1121.00056,2,2146577,2149699,-,3122
39,BUMA.1121.00033,2,2645519,2648652,+,3133
39,BUMA.1121.00062,2,3046474,3049607,-,3133
39,BUMA.1121.00064,2,1765791,1768924,+,3133
39,BUMA.1121.00060,2,502757,505889,-,3132
39,BUMA.1121.00069,2,1818000,1821133,+,3133
39,BUMA.1121.00070,2,1825180,1828313,+,3133
39,BUMA.1121.00067,2,2125883,2129015,-,3132
39,BUMA.1121.00037,2,2215477,2218610,+,3133
39,BUMA.1121.00065,2,1895162,1898296,+,3134
39,BUMA.1121.00058,2,2471674,2474797,+,3123
39,BUMA.1121.00041,2,2813766,2816901,+,3135
39,BUMA.1121.00084,2,570284,573418,+,3134
39,BUMA.1121.00096,2,2125122,2128251,+,3129
39,BUMA.1121.00080,2,1858968,1862091,+,3123
39,BUMA.1121.00100,2,2992738,2995861,+,3123
39,BUMA.1121.00012,2,3098053,3101185,-,3132
39,BUMA.1121.00018,2,1948166,1951298,-,3132
39,BUMA.1121.00106,2,1138805,1141939,+,3134
39,BUMA.1121.00082,2,1890061,1893194,+,3133
38,BUMA.1121.00049,2,497792,510666,+,12874
38,BUMA.1121.00055,2,820036,832922,-,12886
38,BUMA.1121.00011,2,460204,473096,+,12892
38,BUMA.1121.00110,2,1748938,1761562,+,12624
38,BUMA.1121.00109,2,2816609,2829373,-,12764
38,BUMA.1121.00077,2,1854783,1867406,-,12623
38,BUMA.1121.00027,2,2889031,2901859,+,12828
38,BUMA.1121.00021,2,2360060,2372950,+,12890
38,BUMA.1121.00023,2,1981335,1994182,+,12847
38,BUMA.1121.00025,2,365019,377903,+,12884
38,BUMA.1121.00031,2,1027324,1040185,+,12861
38,BUMA.1121.00007,2,1911691,1924589,+,12898
38,BUMA.1121.00097,2,1679897,1692783,+,12886
38,BUMA.1121.00059,2,1744951,1757844,-,12893
38,BUMA.1121.00005,2,2070043,2082898,-,12855
38,BUMA.1121.00111,2,1171486,1184432,+,12946
38,BUMA.1121.00009,2,501236,514096,+,12860
38,BUMA.1121.00094,2,1882789,1895683,+,12894
38,BUMA.1121.00101,2,1567747,1580644,-,12897
38,BUMA.1121.00066,2,1813527,1826312,+,12785
38,BUMA.1121.00095,2,638149,651018,+,12869
38,BUMA.1121.00112,2,2523796,2536535,-,12739
38,BUMA.1121.00090,2,2839337,2852229,+,12892
38,BUMA.1121.00089,2,1828009,1840892,+,12883
38,BUMA.1121.00051,2,1841441,1854355,+,12914
38,BUMA.1121.00001,2,349309,362175,-,12866
38,BUMA.1121.00045,2,1727465,1740332,+,12867
38,BUMA.1121.00043,2,450224,463102,-,12878
38,BUMA.1121.00063,2,1827815,1840624,+,12809
38,BUMA.1121.00079,2,1840636,1853531,+,12895
38,BUMA.1121.00071,2,1829142,1841938,+,12796
38,BUMA.1121.00093,2,1087067,1099936,-,12869
38,BUMA.1121.00091,2,1782196,1795091,-,12895
38,BUMA.1121.00107,2,1960229,1973091,-,12862
38,BUMA.1121.00088,2,1850870,1863306,+,12436
38,BUMA.1121.00047,2,2772860,2785781,+,12921
38,BUMA.1121.00039,2,2111294,2124193,-,12899
38,BUMA.1121.00016,2,1859208,1872134,-,12926
38,BUMA.1121.00092,2,1844607,1857477,+,12870
38,BUMA.1121.00003,2,79021,91875,+,12854
38,BUMA.1121.00105,2,573748,586606,-,12858
38,BUMA.1121.00053,2,2127987,2140691,+,12704
38,BUMA.1121.00057,2,248344,261207,-,12863
38,BUMA.1121.00108,2,2064612,2078507,+,13895
38,BUMA.1121.00104,2,1931945,1944278,+,12333
38,BUMA.1121.00014,2,1961142,1973997,+,12855
38,BUMA.1121.00098,2,2100984,2113911,+,12927
38,BUMA.1121.00078,2,1294677,1308816,-,14139
38,BUMA.1121.00029,2,2727672,2740538,-,12866
38,BUMA.1121.00099,2,2091243,2104138,+,12895
38,BUMA.1121.00103,2,387004,399871,+,12867
38,BUMA.1121.00102,2,1890104,1902987,+,12883
38,BUMA.1121.00075,2,975544,988433,-,12889
38,BUMA.1121.00076,2,2793998,2806890,+,12892
38,BUMA.1121.00074,2,2518244,2531104,-,12860
38,BUMA.1121.00073,2,1829196,1841999,+,12803
38,BUMA.1121.00083,2,497387,510251,+,12864
38,BUMA.1121.00035,2,2746175,2759048,-,12873
38,BUMA.1121.00072,2,1804024,1816834,+,12810
38,BUMA.1121.00056,2,2153417,2166299,-,12882
38,BUMA.1121.00033,2,2628907,2641790,+,12883
38,BUMA.1121.00061,2,1816667,1829478,+,12811
38,BUMA.1121.00062,2,3053325,3066161,-,12836
38,BUMA.1121.00064,2,1749656,1762074,+,12418
38,BUMA.1121.00060,2,509607,522473,-,12866
38,BUMA.1121.00069,2,1801463,1814283,+,12820
38,BUMA.1121.00070,2,1808662,1821463,+,12801
38,BUMA.1121.00068,2,417893,430726,+,12833
38,BUMA.1121.00067,2,2132733,2145559,-,12826
38,BUMA.1121.00037,2,2198837,2211754,+,12917
38,BUMA.1121.00065,2,1878647,1891439,+,12792
38,BUMA.1121.00058,2,2455648,2467957,+,12309
38,BUMA.1121.00041,2,2797273,2810049,+,12776
38,BUMA.1121.00084,2,554140,566561,+,12421
38,BUMA.1121.00096,2,2108592,2121399,+,12807
38,BUMA.1121.00080,2,1842356,1855251,+,12895
38,BUMA.1121.00100,2,2976209,2989021,+,12812
38,BUMA.1121.00012,2,3104909,3117763,-,12854
38,BUMA.1121.00018,2,1955022,1967898,-,12876
38,BUMA.1121.00106,2,1122651,1135088,+,12437
38,BUMA.1121.00082,2,1873480,1886344,+,12864
37,BUMA.1121.00049,2,481870,495204,+,13334
37,BUMA.1121.00055,2,835413,848751,-,13338
37,BUMA.1121.00011,2,444265,457616,+,13351
37,BUMA.1121.00110,2,1733111,1746399,+,13288
37,BUMA.1121.00109,2,2831962,2845267,-,13305
37,BUMA.1121.00077,2,1869946,1883233,-,13287
37,BUMA.1121.00027,2,2873141,2886443,+,13302
37,BUMA.1121.00026,2,1671264,1684513,+,13249
37,BUMA.1121.00021,2,2344172,2357472,+,13300
37,BUMA.1121.00023,2,1965598,1978894,+,13296
37,BUMA.1121.00022,2,589301,602546,+,13245
37,BUMA.1121.00034,2,1029834,1043079,+,13245
37,BUMA.1121.00025,2,349134,362431,+,13297
37,BUMA.1121.00031,2,1011438,1024736,+,13298
37,BUMA.1121.00007,2,1895801,1909127,+,13326
37,BUMA.1121.00097,2,1664004,1677309,+,13305
37,BUMA.1121.00008,2,1013990,1027235,+,13245
37,BUMA.1121.00059,2,1760384,1773689,-,13305
37,BUMA.1121.00002,2,1504512,1517756,-,13244
37,BUMA.1121.00004,2,1014690,1027935,+,13245
37,BUMA.1121.00005,2,2085536,2098849,-,13313
37,BUMA.1121.00111,2,1155653,1168947,+,13294
37,BUMA.1121.00006,2,1397866,1411123,+,13257
37,BUMA.1121.00009,2,485426,498695,+,13269
37,BUMA.1121.00094,2,1866875,1880152,+,13277
37,BUMA.1121.00101,2,1583233,1596545,-,13312
37,BUMA.1121.00066,2,1797653,1810939,+,13286
37,BUMA.1121.00095,2,622268,635610,+,13342
37,BUMA.1121.00112,2,2539077,2552349,-,13272
37,BUMA.1121.00042,2,401676,414924,-,13248
37,BUMA.1121.00032,2,1522389,1535634,+,13245
37,BUMA.1121.00090,2,2823452,2836749,+,13297
37,BUMA.1121.00020,2,1014727,1027972,+,13245
37,BUMA.1121.00089,2,1812095,1825372,+,13277
37,BUMA.1121.00051,2,1825528,1838804,+,13276
37,BUMA.1121.00001,2,364715,378011,-,13296
37,BUMA.1121.00045,2,1711571,1724877,+,13306
37,BUMA.1121.00043,2,465691,478999,-,13308
37,BUMA.1121.00063,2,1811941,1825227,+,13286
37,BUMA.1121.00079,2,1824673,1837950,+,13277
37,BUMA.1121.00071,2,1813268,1826554,+,13286
37,BUMA.1121.00086,2,1396959,1410204,+,13245
37,BUMA.1121.00024,2,1149796,1163041,+,13245
37,BUMA.1121.00010,2,263347,276591,-,13244
37,BUMA.1121.00040,2,811371,824615,-,13244
37,BUMA.1121.00093,2,1102525,1115805,-,13280
37,BUMA.1121.00091,2,1797680,1810978,-,13298
37,BUMA.1121.00107,2,1975631,1988935,-,13304
37,BUMA.1121.00088,2,1834832,1848135,+,13303
37,BUMA.1121.00047,2,2756946,2770223,+,13277
37,BUMA.1121.00019,2,1093850,1107095,+,13245
37,BUMA.1121.00087,2,1664350,1677595,+,13245
37,BUMA.1121.00039,2,2126733,2140029,-,13296
37,BUMA.1121.00030,2,1078715,1091959,-,13244
37,BUMA.1121.00016,2,1874723,1888018,-,13295
37,BUMA.1121.00092,2,1828738,1842019,+,13281
37,BUMA.1121.00085,2,483176,496421,+,13245
37,BUMA.1121.00046,2,207108,220365,+,13257
37,BUMA.1121.00003,2,63261,76578,+,13317
37,BUMA.1121.00054,2,1197985,1211242,+,13257
37,BUMA.1121.00015,2,844038,857295,-,13257
37,BUMA.1121.00105,2,589146,602418,-,13272
37,BUMA.1121.00052,2,1171723,1184968,+,13245
37,BUMA.1121.00053,2,2112205,2125497,+,13292
37,BUMA.1121.00057,2,263796,277111,-,13315
37,BUMA.1121.00108,2,2048699,2062022,+,13323
37,BUMA.1121.00050,2,893322,906579,-,13257
37,BUMA.1121.00104,2,1916070,1929357,+,13287
37,BUMA.1121.00014,2,1945256,1958554,+,13298
37,BUMA.1121.00036,2,648689,661934,+,13245
37,BUMA.1121.00038,2,1299032,1312289,+,13257
37,BUMA.1121.00098,2,2085196,2098396,+,13200
37,BUMA.1121.00078,2,1311358,1324682,-,13324
37,BUMA.1121.00029,2,2743127,2756422,-,13295
37,BUMA.1121.00099,2,2075353,2088655,+,13302
37,BUMA.1121.00103,2,371098,384416,+,13318
37,BUMA.1121.00102,2,1874204,1887516,+,13312
37,BUMA.1121.00028,2,1055945,1069190,+,13245
37,BUMA.1121.00075,2,991022,1004325,-,13303
37,BUMA.1121.00044,2,1080938,1094183,+,13245
37,BUMA.1121.00076,2,2778106,2791410,+,13304
37,BUMA.1121.00074,2,2533644,2546930,-,13286
37,BUMA.1121.00073,2,1813322,1826608,+,13286
37,BUMA.1121.00083,2,481513,494799,+,13286
37,BUMA.1121.00035,2,2761686,2774982,-,13296
37,BUMA.1121.00072,2,1788151,1801436,+,13285
37,BUMA.1121.00056,2,2168937,2182213,-,13276
37,BUMA.1121.00081,2,912412,925669,-,13257
37,BUMA.1121.00033,2,2613027,2626319,+,13292
37,BUMA.1121.00061,2,1800793,1814077,+,13284
37,BUMA.1121.00062,2,3068701,3081987,-,13286
37,BUMA.1121.00064,2,1733787,1747068,+,13281
37,BUMA.1121.00060,2,525062,538367,-,13305
37,BUMA.1121.00069,2,1785589,1798875,+,13286
37,BUMA.1121.00070,2,1792788,1806074,+,13286
37,BUMA.1121.00068,2,402164,415450,+,13286
37,BUMA.1121.00067,2,2148099,2161383,-,13284
37,BUMA.1121.00037,2,2182964,2196249,+,13285
37,BUMA.1121.00065,2,1862730,1876059,+,13329
37,BUMA.1121.00058,2,2439661,2452962,+,13301
37,BUMA.1121.00041,2,2781374,2794683,+,13309
37,BUMA.1121.00084,2,538314,551601,+,13287
37,BUMA.1121.00096,2,2092860,2106101,+,13241
37,BUMA.1121.00080,2,1826442,1839719,+,13277
37,BUMA.1121.00013,2,1778491,1791736,+,13245
37,BUMA.1121.00100,2,2960272,2973570,+,13298
37,BUMA.1121.00012,2,3120401,3133698,-,13297
37,BUMA.1121.00018,2,1970487,1983783,-,13296
37,BUMA.1121.00048,2,1651776,1665033,-,13257
37,BUMA.1121.00106,2,1106776,1120063,+,13287
37,BUMA.1121.00017,2,1029813,1043058,+,13245
37,BUMA.1121.00082,2,1857606,1870892,+,13286
16,BUMA.1121.00049,2,169460,207967,+,38507
16,BUMA.1121.00055,2,1119601,1158125,-,38524
16,BUMA.1121.00011,2,141894,180414,+,38520
16,BUMA.1121.00110,2,853667,892187,-,38520
16,BUMA.1121.00109,2,3189153,3227696,-,38543
16,BUMA.1121.00077,2,2147288,2185804,-,38516
16,BUMA.1121.00027,2,2569538,2608071,+,38533
16,BUMA.1121.00021,2,2040649,2079156,+,38507
16,BUMA.1121.00023,2,1653112,1691631,+,38519
16,BUMA.1121.00025,2,2583520,2622033,-,38513
16,BUMA.1121.00031,2,701448,739967,+,38519
16,BUMA.1121.00007,2,1592035,1630567,+,38532
16,BUMA.1121.00097,2,1360315,1398836,+,38521
16,BUMA.1121.00059,2,2108534,2147064,-,38530
16,BUMA.1121.00005,2,2946242,2985875,+,39633
16,BUMA.1121.00111,2,852844,891363,+,38519
16,BUMA.1121.00009,2,178753,217276,+,38523
16,BUMA.1121.00094,2,1556179,1594679,+,38500
16,BUMA.1121.00101,2,1861158,1899699,-,38541
16,BUMA.1121.00066,2,1495302,1533844,+,38542
16,BUMA.1121.00095,2,3024043,3062561,-,38518
16,BUMA.1121.00112,2,2839801,2878320,-,38519
16,BUMA.1121.00090,2,2500705,2539218,+,38513
16,BUMA.1121.00089,2,1501352,1539852,+,38500
16,BUMA.1121.00051,2,1514752,1553244,+,38492
16,BUMA.1121.00001,2,650751,689231,-,38480
16,BUMA.1121.00045,2,1407749,1446282,+,38533
16,BUMA.1121.00043,2,745757,784314,-,38557
16,BUMA.1121.00063,2,1509407,1547946,+,38539
16,BUMA.1121.00079,2,1515414,1553907,+,38493
16,BUMA.1121.00071,2,1510225,1548767,+,38542
16,BUMA.1121.00093,2,1380673,1419180,-,38507
16,BUMA.1121.00091,2,2075876,2114382,-,38506
16,BUMA.1121.00107,2,2256792,2295316,-,38524
16,BUMA.1121.00088,2,1454908,1493420,+,38512
16,BUMA.1121.00047,2,2445870,2484364,+,38494
16,BUMA.1121.00039,2,2405728,2444237,-,38509
16,BUMA.1121.00016,2,2154767,2193258,-,38491
16,BUMA.1121.00092,2,1525169,1563676,+,38507
16,BUMA.1121.00003,2,2361673,2400208,-,38535
16,BUMA.1121.00105,2,936458,974969,-,38511
16,BUMA.1121.00053,2,1805188,1843726,+,38538
16,BUMA.1121.00057,2,542262,580777,-,38515
16,BUMA.1121.00108,2,1738933,1777439,+,38506
16,BUMA.1121.00104,2,1605341,1643840,+,38499
16,BUMA.1121.00014,2,1635025,1673588,+,38563
16,BUMA.1121.00098,2,1782363,1820893,+,38530
16,BUMA.1121.00078,2,1590064,1628577,-,38513
16,BUMA.1121.00029,2,3029155,3067645,-,38490
16,BUMA.1121.00099,2,1770983,1809505,+,38522
16,BUMA.1121.00103,2,65802,104284,+,38482
16,BUMA.1121.00102,2,1565535,1604048,+,38513
16,BUMA.1121.00075,2,1843211,1881726,+,38515
16,BUMA.1121.00076,2,2473820,2512336,+,38516
16,BUMA.1121.00074,2,2812640,2851156,-,38516
16,BUMA.1121.00073,2,1510660,1549202,+,38542
16,BUMA.1121.00083,2,177807,216349,+,38542
16,BUMA.1121.00035,2,3046435,3084926,-,38491
16,BUMA.1121.00072,2,1489599,1528141,+,38542
16,BUMA.1121.00056,2,2454196,2492696,-,38500
16,BUMA.1121.00033,2,2278862,2317385,+,38523
16,BUMA.1121.00061,2,1498479,1537021,+,38542
16,BUMA.1121.00062,2,196253,234765,-,38512
16,BUMA.1121.00064,2,1427553,1466076,+,38523
16,BUMA.1121.00069,2,1487129,1525671,+,38542
16,BUMA.1121.00070,2,1490270,1528812,+,38542
16,BUMA.1121.00068,2,99068,137619,+,38551
16,BUMA.1121.00067,2,2426907,2465432,-,38525
16,BUMA.1121.00037,2,1872849,1911356,+,38507
16,BUMA.1121.00065,2,1558662,1597169,+,38507
16,BUMA.1121.00058,2,2061512,2100023,+,38511
16,BUMA.1121.00041,2,2455399,2493923,+,38524
16,BUMA.1121.00084,2,158407,196945,+,38538
16,BUMA.1121.00096,2,1728202,1766713,+,38511
16,BUMA.1121.00080,2,1515990,1554484,+,38494
16,BUMA.1121.00100,2,2655063,2693568,+,38505
16,BUMA.1121.00012,2,112577,151085,-,38508
16,BUMA.1121.00018,2,2249604,2288117,-,38513
16,BUMA.1121.00106,2,266068,304567,-,38499
16,BUMA.1121.00082,2,1553917,1592459,+,38542
15,BUMA.1121.00049,2,148125,166993,+,18868
15,BUMA.1121.00055,2,1160610,1179522,-,18912
15,BUMA.1121.00011,2,120526,139425,+,18899
15,BUMA.1121.00110,2,894659,913563,-,18904
15,BUMA.1121.00109,2,3230182,3249059,-,18877
15,BUMA.1121.00077,2,2188276,2207183,-,18907
15,BUMA.1121.00027,2,2548173,2567071,+,18898
15,BUMA.1121.00021,2,2011313,2030213,+,18900
15,BUMA.1121.00023,2,1631771,1650665,+,18894
15,BUMA.1121.00025,2,2624500,2643399,-,18899
15,BUMA.1121.00031,2,680075,698981,+,18906
15,BUMA.1121.00007,2,1570677,1589570,+,18893
15,BUMA.1121.00097,2,1338942,1357845,+,18903
15,BUMA.1121.00059,2,2149531,2168443,-,18912
15,BUMA.1121.00005,2,2924853,2943741,+,18888
15,BUMA.1121.00111,2,831477,850377,+,18900
15,BUMA.1121.00009,2,157352,176256,+,18904
15,BUMA.1121.00094,2,1534794,1553712,+,18918
15,BUMA.1121.00101,2,1902164,1921066,-,18902
15,BUMA.1121.00066,2,1473957,1492845,+,18888
15,BUMA.1121.00095,2,3065005,3083907,-,18902
15,BUMA.1121.00112,2,2880807,2899694,-,18887
15,BUMA.1121.00090,2,2479324,2498238,+,18914
15,BUMA.1121.00089,2,1479952,1498885,+,18933
15,BUMA.1121.00051,2,1492049,1510966,+,18917
15,BUMA.1121.00001,2,699667,718583,-,18916
15,BUMA.1121.00045,2,1386363,1405261,+,18898
15,BUMA.1121.00043,2,813947,832845,-,18898
15,BUMA.1121.00063,2,1488059,1506947,+,18888
15,BUMA.1121.00079,2,1492736,1511628,+,18892
15,BUMA.1121.00071,2,1488880,1507768,+,18888
15,BUMA.1121.00093,2,1421647,1440544,-,18897
15,BUMA.1121.00091,2,2116861,2135753,-,18892
15,BUMA.1121.00107,2,2297788,2316673,-,18885
15,BUMA.1121.00088,2,1433486,1452385,+,18899
15,BUMA.1121.00047,2,2423166,2442084,+,18918
15,BUMA.1121.00039,2,2446704,2465606,-,18902
15,BUMA.1121.00016,2,2195725,2214621,-,18896
15,BUMA.1121.00092,2,1503804,1522702,+,18898
15,BUMA.1121.00003,2,2402682,2421570,-,18888
15,BUMA.1121.00105,2,977509,996396,-,18887
15,BUMA.1121.00053,2,1783805,1802703,+,18898
15,BUMA.1121.00057,2,583245,602143,-,18898
15,BUMA.1121.00108,2,1717541,1736445,+,18904
15,BUMA.1121.00104,2,1583975,1602874,+,18899
15,BUMA.1121.00014,2,1613662,1632558,+,18896
15,BUMA.1121.00098,2,1760993,1779896,+,18903
15,BUMA.1121.00078,2,1631044,1649932,-,18888
15,BUMA.1121.00029,2,3078080,3096996,-,18916
15,BUMA.1121.00099,2,1749609,1768498,+,18889
15,BUMA.1121.00103,2,44452,63341,+,18889
15,BUMA.1121.00102,2,1542836,1561749,+,18913
15,BUMA.1121.00075,2,1821834,1840723,+,18889
15,BUMA.1121.00076,2,2452439,2471332,+,18893
15,BUMA.1121.00074,2,2853641,2872538,-,18897
15,BUMA.1121.00073,2,1489312,1508200,+,18888
15,BUMA.1121.00083,2,156459,175347,+,18888
15,BUMA.1121.00035,2,3095362,3114278,-,18916
15,BUMA.1121.00072,2,1468251,1487139,+,18888
15,BUMA.1121.00056,2,2495163,2514095,-,18932
15,BUMA.1121.00033,2,2230297,2249232,+,18935
15,BUMA.1121.00061,2,1477140,1496019,+,18879
15,BUMA.1121.00062,2,237250,256137,-,18887
15,BUMA.1121.00064,2,1406155,1425068,+,18913
15,BUMA.1121.00069,2,1465781,1484669,+,18888
15,BUMA.1121.00070,2,1468925,1487810,+,18885
15,BUMA.1121.00068,2,77715,96613,+,18898
15,BUMA.1121.00067,2,2467917,2486814,-,18897
15,BUMA.1121.00037,2,1851486,1870382,+,18896
15,BUMA.1121.00065,2,1537292,1556195,+,18903
15,BUMA.1121.00058,2,2040128,2059027,+,18899
15,BUMA.1121.00041,2,2434021,2452909,+,18888
15,BUMA.1121.00084,2,136977,155876,+,18899
15,BUMA.1121.00096,2,1706829,1725728,+,18899
15,BUMA.1121.00080,2,1493286,1512204,+,18918
15,BUMA.1121.00100,2,2633720,2652603,+,18883
15,BUMA.1121.00012,2,180718,199611,-,18893
15,BUMA.1121.00018,2,2290584,2309483,-,18899
15,BUMA.1121.00106,2,307114,326036,-,18922
15,BUMA.1121.00082,2,1532569,1551457,+,18888
14,BUMA.1121.00049,2,135932,147250,+,11318
14,BUMA.1121.00055,2,1180397,1191647,-,11250
14,BUMA.1121.00011,2,108322,119651,+,11329
14,BUMA.1121.00110,2,914438,925747,-,11309
14,BUMA.1121.00109,2,3249934,3261233,-,11299
14,BUMA.1121.00077,2,2208058,2219367,-,11309
14,BUMA.1121.00027,2,2535963,2547298,+,11335
14,BUMA.1121.00021,2,1999128,2010438,+,11310
14,BUMA.1121.00023,2,1608772,1620083,+,11311
14,BUMA.1121.00025,2,2644274,2655537,-,11263
14,BUMA.1121.00031,2,667932,679200,+,11268
14,BUMA.1121.00007,2,1558499,1569802,+,11303
14,BUMA.1121.00097,2,1326809,1338067,+,11258
14,BUMA.1121.00059,2,2169318,2180627,-,11309
14,BUMA.1121.00005,2,2912661,2923978,+,11317
14,BUMA.1121.00111,2,819333,830602,+,11269
14,BUMA.1121.00009,2,145163,156477,+,11314
14,BUMA.1121.00094,2,1522603,1533919,+,11316
14,BUMA.1121.00101,2,1921941,1933238,-,11297
14,BUMA.1121.00066,2,1461804,1473082,+,11278
14,BUMA.1121.00095,2,3084782,3096080,-,11298
14,BUMA.1121.00112,2,2900569,2911870,-,11301
14,BUMA.1121.00090,2,2467181,2478449,+,11268
14,BUMA.1121.00089,2,1467761,1479077,+,11316
14,BUMA.1121.00051,2,1479858,1491174,+,11316
14,BUMA.1121.00001,2,719458,730727,-,11269
14,BUMA.1121.00045,2,1374181,1385488,+,11307
14,BUMA.1121.00043,2,833720,845023,-,11303
14,BUMA.1121.00063,2,1475906,1487184,+,11278
14,BUMA.1121.00079,2,1480546,1491861,+,11315
14,BUMA.1121.00071,2,1476726,1488005,+,11279
14,BUMA.1121.00093,2,1441419,1452727,-,11308
14,BUMA.1121.00091,2,2136628,2147964,-,11336
14,BUMA.1121.00107,2,2317548,2328855,-,11307
14,BUMA.1121.00088,2,1421343,1432611,+,11268
14,BUMA.1121.00047,2,2410975,2422291,+,11316
14,BUMA.1121.00039,2,2466481,2477750,-,11269
14,BUMA.1121.00016,2,2215496,2226759,-,11263
14,BUMA.1121.00092,2,1491622,1502929,+,11307
14,BUMA.1121.00003,2,2422445,2433763,-,11318
14,BUMA.1121.00105,2,997271,1008510,-,11239
14,BUMA.1121.00053,2,1771585,1782930,+,11345
14,BUMA.1121.00057,2,603018,614350,-,11332
14,BUMA.1121.00108,2,1705366,1716666,+,11300
14,BUMA.1121.00104,2,1571832,1583100,+,11268
14,BUMA.1121.00014,2,1601519,1612787,+,11268
14,BUMA.1121.00098,2,1748801,1760118,+,11317
14,BUMA.1121.00078,2,1650807,1662099,-,11292
14,BUMA.1121.00029,2,3097871,3109140,-,11269
14,BUMA.1121.00099,2,1737436,1748734,+,11298
14,BUMA.1121.00103,2,32270,43577,+,11307
14,BUMA.1121.00102,2,1530607,1541961,+,11354
14,BUMA.1121.00075,2,1809682,1820959,+,11277
14,BUMA.1121.00076,2,2440287,2451564,+,11277
14,BUMA.1121.00074,2,2873413,2884730,-,11317
14,BUMA.1121.00073,2,1477159,1488437,+,11278
14,BUMA.1121.00083,2,144305,155584,+,11279
14,BUMA.1121.00035,2,3115153,3126422,-,11269
14,BUMA.1121.00072,2,1456098,1467376,+,11278
14,BUMA.1121.00056,2,2514970,2526287,-,11317
14,BUMA.1121.00033,2,2218105,2229422,+,11317
14,BUMA.1121.00061,2,1464987,1476265,+,11278
14,BUMA.1121.00062,2,257012,268252,-,11240
14,BUMA.1121.00064,2,1394012,1405280,+,11268
14,BUMA.1121.00069,2,1453628,1464906,+,11278
14,BUMA.1121.00070,2,1456772,1468050,+,11278
14,BUMA.1121.00068,2,65520,76840,+,11320
14,BUMA.1121.00067,2,2487689,2499006,-,11317
14,BUMA.1121.00037,2,1839343,1850611,+,11268
14,BUMA.1121.00065,2,1525157,1536417,+,11260
14,BUMA.1121.00058,2,2027972,2039253,+,11281
14,BUMA.1121.00041,2,2421830,2433146,+,11316
14,BUMA.1121.00084,2,124834,136102,+,11268
14,BUMA.1121.00096,2,1694636,1705954,+,11318
14,BUMA.1121.00080,2,1481095,1492411,+,11316
14,BUMA.1121.00100,2,2621537,2632845,+,11308
14,BUMA.1121.00012,2,200486,211755,-,11269
14,BUMA.1121.00018,2,2310358,2321621,-,11263
14,BUMA.1121.00106,2,326911,338172,-,11261
14,BUMA.1121.00082,2,1520415,1531694,+,11279
13,BUMA.1121.00049,2,124418,134197,+,9779
13,BUMA.1121.00055,2,1193380,1203139,-,9759
13,BUMA.1121.00011,2,96826,106588,+,9762
13,BUMA.1121.00110,2,927480,937248,-,9768
13,BUMA.1121.00109,2,3262966,3272718,-,9752
13,BUMA.1121.00077,2,2221100,2230868,-,9768
13,BUMA.1121.00027,2,2524488,2534229,+,9741
13,BUMA.1121.00021,2,1987635,1997394,+,9759
13,BUMA.1121.00023,2,1597288,1607038,+,9750
13,BUMA.1121.00025,2,2657270,2667020,-,9750
13,BUMA.1121.00031,2,656448,666198,+,9750
13,BUMA.1121.00007,2,1547003,1556765,+,9762
13,BUMA.1121.00097,2,1315316,1325075,+,9759
13,BUMA.1121.00059,2,2182361,2192111,-,9750
13,BUMA.1121.00005,2,2901179,2910927,+,9748
13,BUMA.1121.00111,2,807849,817599,+,9750
13,BUMA.1121.00009,2,133651,143428,+,9777
13,BUMA.1121.00094,2,1511089,1520868,+,9779
13,BUMA.1121.00101,2,1934971,1944709,-,9738
13,BUMA.1121.00066,2,1450327,1460070,+,9743
13,BUMA.1121.00095,2,3097813,3107580,-,9767
13,BUMA.1121.00112,2,2913603,2923347,-,9744
13,BUMA.1121.00090,2,2455697,2465447,+,9750
13,BUMA.1121.00089,2,1456247,1466026,+,9779
13,BUMA.1121.00051,2,1468344,1478123,+,9779
13,BUMA.1121.00001,2,732460,742219,-,9759
13,BUMA.1121.00045,2,1362706,1372447,+,9741
13,BUMA.1121.00043,2,846756,856506,-,9750
13,BUMA.1121.00063,2,1464428,1474171,+,9743
13,BUMA.1121.00079,2,1469035,1478811,+,9776
13,BUMA.1121.00071,2,1465249,1474992,+,9743
13,BUMA.1121.00093,2,1454460,1464219,-,9759
13,BUMA.1121.00091,2,2149697,2159447,-,9750
13,BUMA.1121.00107,2,2330589,2340357,-,9768
13,BUMA.1121.00088,2,1409852,1419609,+,9757
13,BUMA.1121.00047,2,2399461,2409240,+,9779
13,BUMA.1121.00039,2,2479483,2489233,-,9750
13,BUMA.1121.00016,2,2228492,2238241,-,9749
13,BUMA.1121.00092,2,1480129,1489888,+,9759
13,BUMA.1121.00003,2,2435496,2445253,-,9757
13,BUMA.1121.00105,2,1010241,1019990,-,9749
13,BUMA.1121.00053,2,1760086,1769851,+,9765
13,BUMA.1121.00057,2,616083,625851,-,9768
13,BUMA.1121.00108,2,1693890,1703631,+,9741
13,BUMA.1121.00104,2,1560348,1570098,+,9750
13,BUMA.1121.00014,2,1590035,1599785,+,9750
13,BUMA.1121.00098,2,1737302,1747067,+,9765
13,BUMA.1121.00078,2,1663832,1673596,-,9764
13,BUMA.1121.00029,2,3110873,3120632,-,9759
13,BUMA.1121.00099,2,1725944,1735702,+,9758
13,BUMA.1121.00103,2,20777,30536,+,9759
13,BUMA.1121.00102,2,1519114,1528873,+,9759
13,BUMA.1121.00075,2,1798199,1807948,+,9749
13,BUMA.1121.00076,2,2428803,2438553,+,9750
13,BUMA.1121.00074,2,2886464,2896214,-,9750
13,BUMA.1121.00073,2,1465681,1475424,+,9743
13,BUMA.1121.00083,2,132828,142571,+,9743
13,BUMA.1121.00035,2,3128155,3137914,-,9759
13,BUMA.1121.00072,2,1444620,1454363,+,9743
13,BUMA.1121.00056,2,2528021,2537800,-,9779
13,BUMA.1121.00033,2,2206612,2216371,+,9759
13,BUMA.1121.00061,2,1453510,1463253,+,9743
13,BUMA.1121.00062,2,269985,279744,-,9759
13,BUMA.1121.00064,2,1382499,1392278,+,9779
13,BUMA.1121.00069,2,1442151,1451893,+,9742
13,BUMA.1121.00070,2,1445294,1455037,+,9743
13,BUMA.1121.00068,2,54023,63786,+,9763
13,BUMA.1121.00067,2,2500740,2510490,-,9750
13,BUMA.1121.00037,2,1827859,1837609,+,9750
13,BUMA.1121.00065,2,1513665,1523423,+,9758
13,BUMA.1121.00058,2,2016488,2026238,+,9750
13,BUMA.1121.00041,2,2410338,2420096,+,9758
13,BUMA.1121.00084,2,113343,123100,+,9757
13,BUMA.1121.00096,2,1683143,1692902,+,9759
13,BUMA.1121.00080,2,1469581,1479360,+,9779
13,BUMA.1121.00100,2,2610026,2619803,+,9777
13,BUMA.1121.00012,2,213488,223238,-,9750
13,BUMA.1121.00018,2,2323354,2333104,-,9750
13,BUMA.1121.00106,2,339905,349664,-,9759
13,BUMA.1121.00082,2,1508938,1518681,+,9743
12,BUMA.1121.00049,2,121061,124417,+,3356
12,BUMA.1121.00055,2,1203141,1206502,-,3361
12,BUMA.1121.00011,2,93469,96825,+,3356
12,BUMA.1121.00110,2,937250,940608,-,3358
12,BUMA.1121.00109,2,3272720,3276075,-,3355
12,BUMA.1121.00077,2,2230870,2234228,-,3358
12,BUMA.1121.00027,2,2521128,2524487,+,3359
12,BUMA.1121.00026,2,1652863,1656222,+,3359
12,BUMA.1121.00021,2,1984278,1987634,+,3356
12,BUMA.1121.00023,2,1593931,1597287,+,3356
12,BUMA.1121.00022,2,366175,369534,+,3359
12,BUMA.1121.00034,2,856758,860117,+,3359
12,BUMA.1121.00025,2,2667022,2670377,-,3355
12,BUMA.1121.00031,2,653091,656447,+,3356
12,BUMA.1121.00007,2,1543646,1547002,+,3356
12,BUMA.1121.00097,2,1311956,1315315,+,3359
12,BUMA.1121.00008,2,840893,844252,+,3359
12,BUMA.1121.00059,2,2192113,2195468,-,3355
12,BUMA.1121.00002,2,1690009,1693367,-,3358
12,BUMA.1121.00004,2,841612,844971,+,3359
12,BUMA.1121.00005,2,2897822,2901178,+,3356
12,BUMA.1121.00111,2,804492,807848,+,3356
12,BUMA.1121.00006,2,1230682,1234040,-,3358
12,BUMA.1121.00009,2,130291,133650,+,3359
12,BUMA.1121.00094,2,1507730,1511088,+,3358
12,BUMA.1121.00101,2,1944711,1948066,-,3355
12,BUMA.1121.00066,2,1446967,1450326,+,3359
12,BUMA.1121.00095,2,3107582,3110940,-,3358
12,BUMA.1121.00112,2,2923349,2926707,-,3358
12,BUMA.1121.00042,2,706586,709945,+,3359
12,BUMA.1121.00032,2,1349330,1352689,+,3359
12,BUMA.1121.00090,2,2452340,2455696,+,3356
12,BUMA.1121.00020,2,841634,844993,+,3359
12,BUMA.1121.00089,2,1452887,1456246,+,3359
12,BUMA.1121.00051,2,1464984,1468343,+,3359
12,BUMA.1121.00001,2,742221,745576,-,3355
12,BUMA.1121.00045,2,1359349,1362705,+,3356
12,BUMA.1121.00043,2,856508,859863,-,3355
12,BUMA.1121.00063,2,1461068,1464427,+,3359
12,BUMA.1121.00079,2,1465675,1469034,+,3359
12,BUMA.1121.00071,2,1461889,1465248,+,3359
12,BUMA.1121.00086,2,1173607,1176966,+,3359
12,BUMA.1121.00024,2,976729,980088,+,3359
12,BUMA.1121.00010,2,448813,452171,-,3358
12,BUMA.1121.00040,2,1182612,1185971,+,3359
12,BUMA.1121.00093,2,1464221,1467576,-,3355
12,BUMA.1121.00091,2,2159449,2162807,-,3358
12,BUMA.1121.00107,2,2340359,2343717,-,3358
12,BUMA.1121.00088,2,1406495,1409851,+,3356
12,BUMA.1121.00047,2,2396101,2399460,+,3359
12,BUMA.1121.00019,2,841598,844957,+,3359
12,BUMA.1121.00087,2,1441104,1444463,+,3359
12,BUMA.1121.00039,2,2489235,2492590,-,3355
12,BUMA.1121.00030,2,1261670,1265028,-,3358
12,BUMA.1121.00016,2,2238243,2241598,-,3355
12,BUMA.1121.00092,2,1476772,1480128,+,3356
12,BUMA.1121.00085,2,33777,37136,+,3359
12,BUMA.1121.00046,2,1932682,1936040,-,3358
12,BUMA.1121.00003,2,2445255,2448613,-,3358
12,BUMA.1121.00054,2,1030805,1034163,-,3358
12,BUMA.1121.00015,2,1021415,1024773,+,3358
12,BUMA.1121.00105,2,1019992,1023347,-,3355
12,BUMA.1121.00052,2,722344,725703,+,3359
12,BUMA.1121.00053,2,1756726,1760085,+,3359
12,BUMA.1121.00057,2,625853,629208,-,3355
12,BUMA.1121.00108,2,1690533,1693889,+,3356
12,BUMA.1121.00050,2,1548873,1552231,-,3358
12,BUMA.1121.00104,2,1556988,1560347,+,3359
12,BUMA.1121.00014,2,1586678,1590034,+,3356
12,BUMA.1121.00036,2,425410,428769,+,3359
12,BUMA.1121.00038,2,1131842,1135200,-,3358
12,BUMA.1121.00098,2,1733945,1737301,+,3356
12,BUMA.1121.00078,2,1673598,1676953,-,3355
12,BUMA.1121.00029,2,3120634,3123989,-,3355
12,BUMA.1121.00099,2,1722587,1725943,+,3356
12,BUMA.1121.00103,2,17420,20776,+,3356
12,BUMA.1121.00102,2,1515757,1519113,+,3356
12,BUMA.1121.00028,2,882864,886223,+,3359
12,BUMA.1121.00075,2,1794842,1798198,+,3356
12,BUMA.1121.00044,2,907870,911229,+,3359
12,BUMA.1121.00076,2,2425446,2428802,+,3356
12,BUMA.1121.00074,2,2896216,2899571,-,3355
12,BUMA.1121.00073,2,1462321,1465680,+,3359
12,BUMA.1121.00083,2,129468,132827,+,3359
12,BUMA.1121.00035,2,3137916,3141271,-,3355
12,BUMA.1121.00072,2,1441260,1444619,+,3359
12,BUMA.1121.00056,2,2537802,2541160,-,3358
12,BUMA.1121.00081,2,1089490,1092849,+,3359
12,BUMA.1121.00033,2,2203255,2206611,+,3356
12,BUMA.1121.00061,2,1450150,1453509,+,3359
12,BUMA.1121.00062,2,279746,283104,-,3358
12,BUMA.1121.00064,2,1379142,1382498,+,3356
12,BUMA.1121.00069,2,1438791,1442150,+,3359
12,BUMA.1121.00070,2,1441934,1445293,+,3359
12,BUMA.1121.00068,2,50663,54022,+,3359
12,BUMA.1121.00067,2,2510492,2513847,-,3355
12,BUMA.1121.00037,2,1824502,1827858,+,3356
12,BUMA.1121.00065,2,1510308,1513664,+,3356
12,BUMA.1121.00058,2,2013128,2016487,+,3359
12,BUMA.1121.00041,2,2406978,2410337,+,3359
12,BUMA.1121.00084,2,109986,113342,+,3356
12,BUMA.1121.00096,2,1679786,1683142,+,3356
12,BUMA.1121.00080,2,1466221,1469580,+,3359
12,BUMA.1121.00013,2,1435060,1438419,+,3359
12,BUMA.1121.00100,2,2606666,2610025,+,3359
12,BUMA.1121.00012,2,223240,226594,-,3354
12,BUMA.1121.00018,2,2333106,2336461,-,3355
12,BUMA.1121.00048,2,1828862,1832221,+,3359
12,BUMA.1121.00106,2,349666,353021,-,3355
12,BUMA.1121.00017,2,856730,860089,+,3359
12,BUMA.1121.00082,2,1505578,1508937,+,3359
11,BUMA.1121.00049,2,107010,119107,+,12097
11,BUMA.1121.00055,2,1208456,1220547,-,12091
11,BUMA.1121.00011,2,79454,91524,+,12070
11,BUMA.1121.00110,2,942550,954646,-,12096
11,BUMA.1121.00109,2,3278029,3290140,-,12111
11,BUMA.1121.00077,2,2236169,2248265,-,12096
11,BUMA.1121.00027,2,2507067,2519174,+,12107
11,BUMA.1121.00026,2,1638846,1650918,+,12072
11,BUMA.1121.00021,2,1970216,1982285,+,12069
11,BUMA.1121.00023,2,1579917,1591986,+,12069
11,BUMA.1121.00022,2,352297,364230,+,11933
11,BUMA.1121.00034,2,842869,854813,+,11944
11,BUMA.1121.00025,2,2672331,2684401,-,12070
11,BUMA.1121.00031,2,639061,651128,+,12067
11,BUMA.1121.00007,2,1529634,1541701,+,12067
11,BUMA.1121.00097,2,1297910,1310014,+,12104
11,BUMA.1121.00008,2,827004,838948,+,11944
11,BUMA.1121.00059,2,2197422,2209527,-,12105
11,BUMA.1121.00002,2,1695312,1707257,-,11945
11,BUMA.1121.00004,2,827723,839667,+,11944
11,BUMA.1121.00005,2,2883792,2895868,+,12076
11,BUMA.1121.00111,2,790500,802529,+,12029
11,BUMA.1121.00006,2,1235985,1247908,-,11923
11,BUMA.1121.00009,2,116276,128337,+,12061
11,BUMA.1121.00094,2,1493665,1505776,+,12111
11,BUMA.1121.00101,2,1949999,1962078,-,12079
11,BUMA.1121.00066,2,1432905,1445013,+,12108
11,BUMA.1121.00095,2,3112882,3124972,-,12090
11,BUMA.1121.00112,2,2928649,2940726,-,12077
11,BUMA.1121.00042,2,692569,704641,+,12072
11,BUMA.1121.00032,2,1335441,1347385,+,11944
11,BUMA.1121.00090,2,2438308,2450377,+,12069
11,BUMA.1121.00020,2,827745,839689,+,11944
11,BUMA.1121.00089,2,1438815,1450933,+,12118
11,BUMA.1121.00051,2,1450940,1463030,+,12090
11,BUMA.1121.00001,2,747530,759599,-,12069
11,BUMA.1121.00045,2,1345297,1357386,+,12089
11,BUMA.1121.00043,2,861817,873900,-,12083
11,BUMA.1121.00063,2,1447006,1459114,+,12108
11,BUMA.1121.00079,2,1451594,1463721,+,12127
11,BUMA.1121.00071,2,1447827,1459935,+,12108
11,BUMA.1121.00086,2,1159718,1171662,+,11944
11,BUMA.1121.00024,2,962840,974784,+,11944
11,BUMA.1121.00010,2,454117,466062,-,11945
11,BUMA.1121.00040,2,1168731,1180667,+,11936
11,BUMA.1121.00093,2,1469539,1481620,-,12081
11,BUMA.1121.00091,2,2164779,2176856,-,12077
11,BUMA.1121.00107,2,2345668,2357707,-,12039
11,BUMA.1121.00088,2,1392465,1404541,+,12076
11,BUMA.1121.00047,2,2382022,2394147,+,12125
11,BUMA.1121.00019,2,827709,839653,+,11944
11,BUMA.1121.00087,2,1427215,1439159,+,11944
11,BUMA.1121.00039,2,2494553,2506630,-,12077
11,BUMA.1121.00030,2,1266973,1278918,-,11945
11,BUMA.1121.00016,2,2243552,2255610,-,12058
11,BUMA.1121.00092,2,1462729,1474809,+,12080
11,BUMA.1121.00085,2,19909,31832,+,11923
11,BUMA.1121.00046,2,1937985,1949922,-,11937
11,BUMA.1121.00003,2,2450555,2462633,-,12078
11,BUMA.1121.00054,2,1036108,1048031,-,11923
11,BUMA.1121.00015,2,1007527,1019470,+,11943
11,BUMA.1121.00105,2,1025292,1037376,-,12084
11,BUMA.1121.00052,2,708476,720399,+,11923
11,BUMA.1121.00053,2,1742667,1754784,+,12117
11,BUMA.1121.00057,2,631148,643278,-,12130
11,BUMA.1121.00108,2,1676496,1688579,+,12083
11,BUMA.1121.00050,2,1554176,1566113,-,11937
11,BUMA.1121.00104,2,1542915,1555034,+,12119
11,BUMA.1121.00014,2,1572646,1584715,+,12069
11,BUMA.1121.00036,2,411521,423465,+,11944
11,BUMA.1121.00038,2,1137145,1149068,-,11923
11,BUMA.1121.00098,2,1719910,1731982,+,12072
11,BUMA.1121.00078,2,1678907,1690983,-,12076
11,BUMA.1121.00029,2,3125943,3138013,-,12070
11,BUMA.1121.00099,2,1708525,1720645,+,12120
11,BUMA.1121.00103,2,3368,15466,+,12098
11,BUMA.1121.00102,2,1501661,1513794,+,12133
11,BUMA.1121.00028,2,868975,880919,+,11944
11,BUMA.1121.00075,2,1780799,1792888,+,12089
11,BUMA.1121.00044,2,893981,905925,+,11944
11,BUMA.1121.00076,2,2411402,2423492,+,12090
11,BUMA.1121.00074,2,2901525,2913638,-,12113
11,BUMA.1121.00073,2,1448260,1460368,+,12108
11,BUMA.1121.00083,2,115406,127514,+,12108
11,BUMA.1121.00035,2,3143225,3155295,-,12070
11,BUMA.1121.00072,2,1427198,1439306,+,12108
11,BUMA.1121.00056,2,2543114,2555233,-,12119
11,BUMA.1121.00081,2,1075623,1087545,+,11922
11,BUMA.1121.00033,2,2189235,2201301,+,12066
11,BUMA.1121.00061,2,1436088,1448196,+,12108
11,BUMA.1121.00062,2,285049,297161,-,12112
11,BUMA.1121.00064,2,1365119,1377188,+,12069
11,BUMA.1121.00069,2,1424729,1436837,+,12108
11,BUMA.1121.00070,2,1427872,1439980,+,12108
11,BUMA.1121.00068,2,36641,48709,+,12068
11,BUMA.1121.00067,2,2515801,2527921,-,12120
11,BUMA.1121.00037,2,1810478,1822548,+,12070
11,BUMA.1121.00065,2,1496240,1508345,+,12105
11,BUMA.1121.00058,2,1999087,2011174,+,12087
11,BUMA.1121.00041,2,2392948,2405024,+,12076
11,BUMA.1121.00084,2,95956,108032,+,12076
11,BUMA.1121.00096,2,1665761,1677844,+,12083
11,BUMA.1121.00080,2,1452177,1464267,+,12090
11,BUMA.1121.00013,2,1421192,1433115,+,11923
11,BUMA.1121.00100,2,2592656,2604712,+,12056
11,BUMA.1121.00012,2,228557,240619,-,12062
11,BUMA.1121.00018,2,2338415,2350485,-,12070
11,BUMA.1121.00048,2,1814995,1826917,+,11922
11,BUMA.1121.00106,2,354975,367066,-,12091
11,BUMA.1121.00017,2,842841,854785,+,11944
11,BUMA.1121.00082,2,1491516,1503624,+,12108
10,BUMA.1121.00049,2,92961,103677,+,10716
10,BUMA.1121.00055,2,1223914,1234630,-,10716
10,BUMA.1121.00011,2,65472,76171,+,10699
10,BUMA.1121.00110,2,957975,968678,-,10703
10,BUMA.1121.00109,2,3293497,3304225,-,10728
10,BUMA.1121.00077,2,2251594,2262297,-,10703
10,BUMA.1121.00027,2,2493018,2503732,+,10714
10,BUMA.1121.00021,2,1956170,1966899,+,10729
10,BUMA.1121.00023,2,1565876,1576590,+,10714
10,BUMA.1121.00025,2,2687725,2698449,-,10724
10,BUMA.1121.00031,2,625030,635745,+,10715
10,BUMA.1121.00007,2,1515594,1526294,+,10700
10,BUMA.1121.00097,2,1283834,1294567,+,10733
10,BUMA.1121.00059,2,2212830,2223565,-,10735
10,BUMA.1121.00005,2,2869720,2880448,+,10728
10,BUMA.1121.00111,2,765610,776324,+,10714
10,BUMA.1121.00009,2,102228,112932,+,10704
10,BUMA.1121.00094,2,1479612,1490328,+,10716
10,BUMA.1121.00101,2,1965444,1976187,-,10743
10,BUMA.1121.00066,2,1418844,1429558,+,10714
10,BUMA.1121.00095,2,3128330,3139083,-,10753
10,BUMA.1121.00112,2,2944062,2954812,-,10750
10,BUMA.1121.00090,2,2424267,2434981,+,10714
10,BUMA.1121.00089,2,1424752,1435467,+,10715
10,BUMA.1121.00051,2,1436878,1447593,+,10715
10,BUMA.1121.00001,2,762916,773640,-,10724
10,BUMA.1121.00045,2,1331229,1341920,+,10691
10,BUMA.1121.00043,2,877240,887905,-,10665
10,BUMA.1121.00063,2,1432945,1443659,+,10714
10,BUMA.1121.00079,2,1437533,1448247,+,10714
10,BUMA.1121.00071,2,1433766,1444480,+,10714
10,BUMA.1121.00093,2,1484908,1495642,-,10734
10,BUMA.1121.00091,2,2180216,2190968,-,10752
10,BUMA.1121.00107,2,2361084,2371725,-,10641
10,BUMA.1121.00088,2,1378418,1389132,+,10714
10,BUMA.1121.00047,2,2367960,2378675,+,10715
10,BUMA.1121.00039,2,2509947,2520671,-,10724
10,BUMA.1121.00016,2,2258960,2269647,-,10687
10,BUMA.1121.00092,2,1448707,1459431,+,10724
10,BUMA.1121.00003,2,2465985,2476718,-,10733
10,BUMA.1121.00105,2,1040716,1051440,-,10724
10,BUMA.1121.00053,2,1728595,1739323,+,10728
10,BUMA.1121.00057,2,646603,657327,-,10724
10,BUMA.1121.00108,2,1662396,1673126,+,10730
10,BUMA.1121.00104,2,1528901,1539615,+,10714
10,BUMA.1121.00014,2,1558615,1569330,+,10715
10,BUMA.1121.00098,2,1705828,1716550,+,10722
10,BUMA.1121.00078,2,1694326,1705057,-,10731
10,BUMA.1121.00029,2,3141330,3152054,-,10724
10,BUMA.1121.00099,2,1694397,1705132,+,10735
10,BUMA.1121.00103,2,3380256,3390988,+,10732
10,BUMA.1121.00102,2,1487581,1498297,+,10716
10,BUMA.1121.00075,2,1766772,1777488,+,10716
10,BUMA.1121.00076,2,2397374,2408091,+,10717
10,BUMA.1121.00074,2,2916975,2927703,-,10728
10,BUMA.1121.00073,2,1434199,1444913,+,10714
10,BUMA.1121.00083,2,101345,112059,+,10714
10,BUMA.1121.00035,2,3158612,3169336,-,10724
10,BUMA.1121.00072,2,1413137,1423851,+,10714
10,BUMA.1121.00056,2,2558571,2569296,-,10725
10,BUMA.1121.00033,2,2175211,2185908,+,10697
10,BUMA.1121.00061,2,1422027,1432741,+,10714
10,BUMA.1121.00062,2,300487,311229,-,10742
10,BUMA.1121.00064,2,1351040,1361758,+,10718
10,BUMA.1121.00069,2,1410668,1421382,+,10714
10,BUMA.1121.00070,2,1413811,1424525,+,10714
10,BUMA.1121.00068,2,22609,33304,+,10695
10,BUMA.1121.00067,2,2531248,2541996,-,10748
10,BUMA.1121.00037,2,1796447,1807162,+,10715
10,BUMA.1121.00065,2,1482173,1492887,+,10714
10,BUMA.1121.00058,2,1985037,1995765,+,10728
10,BUMA.1121.00041,2,2378856,2389573,+,10717
10,BUMA.1121.00084,2,81901,92634,+,10733
10,BUMA.1121.00096,2,1651681,1662417,+,10736
10,BUMA.1121.00080,2,1438115,1448830,+,10715
10,BUMA.1121.00100,2,2578598,2589320,+,10722
10,BUMA.1121.00012,2,243978,254706,-,10728
10,BUMA.1121.00018,2,2353809,2364533,-,10724
10,BUMA.1121.00106,2,370378,381120,-,10742
10,BUMA.1121.00082,2,1477455,1488169,+,10714
9,BUMA.1121.00049,2,86161,90522,+,4361
9,BUMA.1121.00055,2,1237069,1241457,-,4388
9,BUMA.1121.00011,2,58668,63033,+,4365
9,BUMA.1121.00110,2,971098,975448,-,4350
9,BUMA.1121.00109,2,3306664,3311020,-,4356
9,BUMA.1121.00077,2,2264717,2269067,-,4350
9,BUMA.1121.00027,2,2486254,2490579,+,4325
9,BUMA.1121.00021,2,1949380,1953731,+,4351
9,BUMA.1121.00023,2,1559130,1563447,+,4317
9,BUMA.1121.00025,2,2700888,2705253,-,4365
9,BUMA.1121.00031,2,620712,625027,+,4315
9,BUMA.1121.00007,2,1508760,1513155,+,4395
9,BUMA.1121.00097,2,1277032,1281408,+,4376
9,BUMA.1121.00059,2,2226004,2230357,-,4353
9,BUMA.1121.00005,2,2862934,2867278,+,4344
9,BUMA.1121.00111,2,758835,763171,+,4336
9,BUMA.1121.00009,2,95439,99765,+,4326
9,BUMA.1121.00094,2,1472834,1477173,+,4339
9,BUMA.1121.00101,2,1978625,1982974,-,4349
9,BUMA.1121.00066,2,1412081,1416405,+,4324
9,BUMA.1121.00095,2,3141519,3145828,-,4309
9,BUMA.1121.00112,2,2957204,2961525,-,4321
9,BUMA.1121.00090,2,2417482,2421828,+,4346
9,BUMA.1121.00089,2,1417981,1422313,+,4332
9,BUMA.1121.00051,2,1430113,1434439,+,4326
9,BUMA.1121.00001,2,776079,780415,-,4336
9,BUMA.1121.00045,2,1324464,1328797,+,4333
9,BUMA.1121.00043,2,890344,894759,-,4415
9,BUMA.1121.00063,2,1426183,1430506,+,4323
9,BUMA.1121.00079,2,1430650,1434977,+,4327
9,BUMA.1121.00071,2,1427005,1431327,+,4322
9,BUMA.1121.00093,2,1498081,1502445,-,4364
9,BUMA.1121.00091,2,2193407,2197774,-,4367
9,BUMA.1121.00107,2,2374164,2378463,-,4299
9,BUMA.1121.00088,2,1371647,1375979,+,4332
9,BUMA.1121.00047,2,2361172,2365521,+,4349
9,BUMA.1121.00039,2,2523099,2527486,-,4387
9,BUMA.1121.00016,2,2272086,2276421,-,4335
9,BUMA.1121.00092,2,1441903,1446268,+,4365
9,BUMA.1121.00003,2,2479157,2483463,-,4306
9,BUMA.1121.00105,2,1053879,1058201,-,4322
9,BUMA.1121.00053,2,1721785,1726163,+,4378
9,BUMA.1121.00057,2,659766,664090,-,4324
9,BUMA.1121.00108,2,1655671,1659967,+,4296
9,BUMA.1121.00104,2,1522080,1526462,+,4382
9,BUMA.1121.00014,2,1554276,1558612,+,4336
9,BUMA.1121.00098,2,1698927,1703381,+,4454
9,BUMA.1121.00078,2,1707496,1711827,-,4331
9,BUMA.1121.00029,2,3154493,3158839,-,4346
9,BUMA.1121.00099,2,1687615,1691958,+,4343
9,BUMA.1121.00103,2,3373463,3377820,+,4357
9,BUMA.1121.00102,2,1480766,1485150,+,4384
9,BUMA.1121.00075,2,1759968,1764333,+,4365
9,BUMA.1121.00076,2,2390560,2394935,+,4375
9,BUMA.1121.00074,2,2930142,2934475,-,4333
9,BUMA.1121.00073,2,1427436,1431760,+,4324
9,BUMA.1121.00083,2,94582,98906,+,4324
9,BUMA.1121.00035,2,3171775,3176111,-,4336
9,BUMA.1121.00072,2,1406376,1410698,+,4322
9,BUMA.1121.00056,2,2571735,2576066,-,4331
9,BUMA.1121.00033,2,2168446,2172772,+,4326
9,BUMA.1121.00061,2,1415265,1419588,+,4323
9,BUMA.1121.00062,2,313668,317990,-,4322
9,BUMA.1121.00064,2,1344278,1348601,+,4323
9,BUMA.1121.00069,2,1403911,1408229,+,4318
9,BUMA.1121.00070,2,1407049,1411372,+,4323
9,BUMA.1121.00068,2,15884,20178,+,4294
9,BUMA.1121.00067,2,2544435,2548768,-,4333
9,BUMA.1121.00037,2,1789673,1794008,+,4335
9,BUMA.1121.00065,2,1475385,1479734,+,4349
9,BUMA.1121.00058,2,1978256,1982600,+,4344
9,BUMA.1121.00041,2,2372046,2376417,+,4371
9,BUMA.1121.00084,2,75130,79462,+,4332
9,BUMA.1121.00096,2,1644831,1649250,+,4419
9,BUMA.1121.00080,2,1431350,1435676,+,4326
9,BUMA.1121.00100,2,2571678,2576161,+,4483
9,BUMA.1121.00012,2,257138,261553,-,4415
9,BUMA.1121.00018,2,2366972,2371337,-,4365
9,BUMA.1121.00106,2,383559,387890,-,4331
9,BUMA.1121.00082,2,1470692,1475016,+,4324
8,BUMA.1121.00049,2,82349,86160,+,3811
8,BUMA.1121.00055,2,1241459,1245270,-,3811
8,BUMA.1121.00011,2,54868,58667,+,3799
8,BUMA.1121.00110,2,975450,979261,-,3811
8,BUMA.1121.00109,2,3311022,3314833,-,3811
8,BUMA.1121.00077,2,2269069,2272880,-,3811
8,BUMA.1121.00027,2,2482442,2486253,+,3811
8,BUMA.1121.00021,2,1945568,1949379,+,3811
8,BUMA.1121.00023,2,1555318,1559129,+,3811
8,BUMA.1121.00025,2,2705255,2709066,-,3811
8,BUMA.1121.00031,2,616900,620711,+,3811
8,BUMA.1121.00007,2,1504948,1508759,+,3811
8,BUMA.1121.00097,2,1273220,1277031,+,3811
8,BUMA.1121.00059,2,2230359,2234170,-,3811
8,BUMA.1121.00005,2,2859125,2862933,+,3808
8,BUMA.1121.00111,2,755023,758834,+,3811
8,BUMA.1121.00009,2,91627,95438,+,3811
8,BUMA.1121.00094,2,1469022,1472833,+,3811
8,BUMA.1121.00101,2,1982976,1986787,-,3811
8,BUMA.1121.00066,2,1408269,1412080,+,3811
8,BUMA.1121.00095,2,3145830,3149641,-,3811
8,BUMA.1121.00112,2,2961527,2965338,-,3811
8,BUMA.1121.00090,2,2413670,2417481,+,3811
8,BUMA.1121.00089,2,1414169,1417980,+,3811
8,BUMA.1121.00051,2,1426301,1430112,+,3811
8,BUMA.1121.00001,2,780417,784228,-,3811
8,BUMA.1121.00045,2,1320652,1324463,+,3811
8,BUMA.1121.00043,2,894761,898572,-,3811
8,BUMA.1121.00063,2,1422371,1426182,+,3811
8,BUMA.1121.00079,2,1426839,1430649,+,3810
8,BUMA.1121.00071,2,1423193,1427004,+,3811
8,BUMA.1121.00093,2,1502447,1506258,-,3811
8,BUMA.1121.00091,2,2197776,2201587,-,3811
8,BUMA.1121.00107,2,2378465,2382239,-,3774
8,BUMA.1121.00088,2,1367835,1371646,+,3811
8,BUMA.1121.00047,2,2357360,2361171,+,3811
8,BUMA.1121.00039,2,2527488,2531299,-,3811
8,BUMA.1121.00016,2,2276423,2280234,-,3811
8,BUMA.1121.00092,2,1438091,1441902,+,3811
8,BUMA.1121.00003,2,2483465,2487276,-,3811
8,BUMA.1121.00105,2,1058203,1062014,-,3811
8,BUMA.1121.00053,2,1717973,1721784,+,3811
8,BUMA.1121.00057,2,664092,667903,-,3811
8,BUMA.1121.00108,2,1651859,1655670,+,3811
8,BUMA.1121.00104,2,1518268,1522079,+,3811
8,BUMA.1121.00014,2,1550464,1554275,+,3811
8,BUMA.1121.00098,2,1695115,1698926,+,3811
8,BUMA.1121.00078,2,1711829,1715640,-,3811
8,BUMA.1121.00029,2,3158841,3162653,-,3812
8,BUMA.1121.00099,2,1683803,1687614,+,3811
8,BUMA.1121.00103,2,3369651,3373462,+,3811
8,BUMA.1121.00102,2,1476954,1480765,+,3811
8,BUMA.1121.00075,2,1756156,1759967,+,3811
8,BUMA.1121.00076,2,2386748,2390559,+,3811
8,BUMA.1121.00074,2,2934477,2938288,-,3811
8,BUMA.1121.00073,2,1423624,1427435,+,3811
8,BUMA.1121.00083,2,90770,94581,+,3811
8,BUMA.1121.00035,2,3176113,3179924,-,3811
8,BUMA.1121.00072,2,1402564,1406375,+,3811
8,BUMA.1121.00056,2,2576068,2579879,-,3811
8,BUMA.1121.00033,2,2164634,2168445,+,3811
8,BUMA.1121.00061,2,1411453,1415264,+,3811
8,BUMA.1121.00062,2,317992,321803,-,3811
8,BUMA.1121.00064,2,1340466,1344277,+,3811
8,BUMA.1121.00060,2,769561,773317,-,3756
8,BUMA.1121.00069,2,1400099,1403910,+,3811
8,BUMA.1121.00070,2,1403237,1407048,+,3811
8,BUMA.1121.00068,2,12072,15883,+,3811
8,BUMA.1121.00067,2,2548770,2552581,-,3811
8,BUMA.1121.00037,2,1785861,1789672,+,3811
8,BUMA.1121.00065,2,1471573,1475384,+,3811
8,BUMA.1121.00058,2,1974444,1978255,+,3811
8,BUMA.1121.00041,2,2368234,2372045,+,3811
8,BUMA.1121.00084,2,71318,75129,+,3811
8,BUMA.1121.00096,2,1641019,1644830,+,3811
8,BUMA.1121.00080,2,1427538,1431349,+,3811
8,BUMA.1121.00100,2,2567866,2571677,+,3811
8,BUMA.1121.00012,2,261555,265366,-,3811
8,BUMA.1121.00018,2,2371339,2375150,-,3811
8,BUMA.1121.00106,2,387892,391703,-,3811
8,BUMA.1121.00082,2,1466880,1470691,+,3811
7,BUMA.1121.00049,2,78507,82347,+,3840
7,BUMA.1121.00055,2,1245271,1249144,-,3873
7,BUMA.1121.00011,2,51009,54866,+,3857
7,BUMA.1121.00110,2,979262,983127,-,3865
7,BUMA.1121.00109,2,3314834,3318768,-,3934
7,BUMA.1121.00077,2,2272881,2276746,-,3865
7,BUMA.1121.00027,2,2478600,2482440,+,3840
7,BUMA.1121.00021,2,1941714,1945566,+,3852
7,BUMA.1121.00023,2,1551465,1555316,+,3851
7,BUMA.1121.00025,2,2709067,2712936,-,3869
7,BUMA.1121.00031,2,613047,616898,+,3851
7,BUMA.1121.00007,2,1501099,1504946,+,3847
7,BUMA.1121.00097,2,1269405,1273218,+,3813
7,BUMA.1121.00059,2,2234171,2238052,-,3881
7,BUMA.1121.00005,2,2855259,2859123,+,3864
7,BUMA.1121.00111,2,751170,755021,+,3851
7,BUMA.1121.00009,2,87757,91625,+,3868
7,BUMA.1121.00094,2,1465164,1469020,+,3856
7,BUMA.1121.00101,2,1986788,1990656,-,3868
7,BUMA.1121.00066,2,1404418,1408267,+,3849
7,BUMA.1121.00095,2,3149642,3153525,-,3883
7,BUMA.1121.00112,2,2965339,2969179,-,3840
7,BUMA.1121.00090,2,2409817,2413668,+,3851
7,BUMA.1121.00089,2,1410311,1414167,+,3856
7,BUMA.1121.00051,2,1422443,1426299,+,3856
7,BUMA.1121.00001,2,784229,788098,-,3869
7,BUMA.1121.00045,2,1316800,1320650,+,3850
7,BUMA.1121.00043,2,898573,902442,-,3869
7,BUMA.1121.00063,2,1418512,1422369,+,3857
7,BUMA.1121.00079,2,1422972,1426837,+,3865
7,BUMA.1121.00071,2,1419339,1423191,+,3852
7,BUMA.1121.00093,2,1506259,1510132,-,3873
7,BUMA.1121.00091,2,2201588,2205454,-,3866
7,BUMA.1121.00107,2,2383728,2387619,-,3891
7,BUMA.1121.00088,2,1363978,1367833,+,3855
7,BUMA.1121.00047,2,2353517,2357358,+,3841
7,BUMA.1121.00039,2,2531300,2535169,-,3869
7,BUMA.1121.00016,2,2280235,2284088,-,3853
7,BUMA.1121.00092,2,1434234,1438089,+,3855
7,BUMA.1121.00003,2,2487277,2491174,-,3897
7,BUMA.1121.00105,2,1062015,1065896,-,3881
7,BUMA.1121.00053,2,1714123,1717971,+,3848
7,BUMA.1121.00057,2,667904,671762,-,3858
7,BUMA.1121.00108,2,1647992,1651857,+,3865
7,BUMA.1121.00104,2,1514411,1518266,+,3855
7,BUMA.1121.00014,2,1546612,1550462,+,3850
7,BUMA.1121.00098,2,1691287,1695113,+,3826
7,BUMA.1121.00078,2,1715641,1719497,-,3856
7,BUMA.1121.00029,2,3162654,3166523,-,3869
7,BUMA.1121.00099,2,1679946,1683801,+,3855
7,BUMA.1121.00103,2,3365813,3369649,+,3836
7,BUMA.1121.00102,2,1473104,1476952,+,3848
7,BUMA.1121.00075,2,1752294,1756154,+,3860
7,BUMA.1121.00076,2,2382885,2386746,+,3861
7,BUMA.1121.00074,2,2938289,2942161,-,3872
7,BUMA.1121.00073,2,1419759,1423622,+,3863
7,BUMA.1121.00083,2,86905,90768,+,3863
7,BUMA.1121.00035,2,3179925,3183794,-,3869
7,BUMA.1121.00072,2,1398710,1402562,+,3852
7,BUMA.1121.00056,2,2579880,2583754,-,3874
7,BUMA.1121.00033,2,2160781,2164632,+,3851
7,BUMA.1121.00061,2,1407588,1411451,+,3863
7,BUMA.1121.00062,2,321804,325685,-,3881
7,BUMA.1121.00064,2,1336603,1340464,+,3861
7,BUMA.1121.00060,2,773318,777186,-,3868
7,BUMA.1121.00069,2,1396234,1400097,+,3863
7,BUMA.1121.00070,2,1399376,1403235,+,3859
7,BUMA.1121.00068,2,8227,12070,+,3843
7,BUMA.1121.00067,2,2552582,2556466,-,3884
7,BUMA.1121.00037,2,1782008,1785859,+,3851
7,BUMA.1121.00065,2,1467731,1471571,+,3840
7,BUMA.1121.00058,2,1970587,1974442,+,3855
7,BUMA.1121.00041,2,2364386,2368232,+,3846
7,BUMA.1121.00084,2,67461,71316,+,3855
7,BUMA.1121.00096,2,1637167,1641017,+,3850
7,BUMA.1121.00080,2,1423680,1427536,+,3856
7,BUMA.1121.00100,2,2564008,2567864,+,3856
7,BUMA.1121.00012,2,265367,269236,-,3869
7,BUMA.1121.00018,2,2375151,2379020,-,3869
7,BUMA.1121.00106,2,391704,395577,-,3873
7,BUMA.1121.00082,2,1463015,1466878,+,3863
2,BUMA.1121.00049,2,10606,21887,+,11281
2,BUMA.1121.00055,2,1307156,1318311,-,11155
2,BUMA.1121.00011,2,3232880,3244206,+,11326
2,BUMA.1121.00110,2,1036590,1047876,-,11286
2,BUMA.1121.00109,2,47682,58963,-,11281
2,BUMA.1121.00077,2,2330216,2341529,-,11313
2,BUMA.1121.00027,2,2410805,2422077,+,11272
2,BUMA.1121.00021,2,1874628,1885761,+,11133
2,BUMA.1121.00023,2,1449255,1460424,+,11169
2,BUMA.1121.00022,2,284381,295549,+,11168
2,BUMA.1121.00034,2,774950,786136,+,11186
2,BUMA.1121.00025,2,2770678,2781847,-,11169
2,BUMA.1121.00031,2,545508,556668,+,11160
2,BUMA.1121.00007,2,1394712,1406038,+,11326
2,BUMA.1121.00097,2,1201947,1213263,+,11316
2,BUMA.1121.00059,2,2294719,2305987,-,11268
2,BUMA.1121.00002,2,1326347,1337515,+,11168
2,BUMA.1121.00005,2,2786435,2797734,+,11299
2,BUMA.1121.00111,2,629713,640888,+,11175
2,BUMA.1121.00006,2,1049632,1060800,+,11168
2,BUMA.1121.00009,2,3255383,3266601,+,11218
2,BUMA.1121.00094,2,1397452,1408598,+,11146
2,BUMA.1121.00101,2,2048265,2059575,-,11310
2,BUMA.1121.00066,2,1334614,1345900,+,11286
2,BUMA.1121.00095,2,3268926,3280231,-,11305
2,BUMA.1121.00112,2,3025602,3036775,-,11173
2,BUMA.1121.00042,2,836149,847362,-,11213
2,BUMA.1121.00032,2,1267522,1278708,+,11186
2,BUMA.1121.00090,2,2342244,2353404,+,11160
2,BUMA.1121.00089,2,1342513,1353734,+,11221
2,BUMA.1121.00051,2,1354506,1365830,+,11324
2,BUMA.1121.00001,2,844592,855734,-,11142
2,BUMA.1121.00045,2,1244189,1255476,+,11287
2,BUMA.1121.00043,2,1003475,1014662,-,11187
2,BUMA.1121.00063,2,1327890,1339176,+,11286
2,BUMA.1121.00079,2,1355123,1366439,+,11316
2,BUMA.1121.00071,2,1328436,1339717,+,11281
2,BUMA.1121.00086,2,1091783,1102951,+,11168
2,BUMA.1121.00024,2,894920,906106,+,11186
2,BUMA.1121.00010,2,85218,96386,+,11168
2,BUMA.1121.00040,2,1100809,1111973,+,11164
2,BUMA.1121.00093,2,1567493,1578802,-,11309
2,BUMA.1121.00091,2,2261966,2273229,-,11263
2,BUMA.1121.00107,2,2482044,2493285,-,11241
2,BUMA.1121.00088,2,1296183,1307442,+,11259
2,BUMA.1121.00047,2,2284534,2295860,+,11326
2,BUMA.1121.00087,2,1359280,1370448,+,11168
2,BUMA.1121.00039,2,2591132,2602283,-,11151
2,BUMA.1121.00030,2,1335651,1346837,-,11186
2,BUMA.1121.00016,2,2340551,2351715,-,11164
2,BUMA.1121.00092,2,1366286,1377684,+,11398
2,BUMA.1121.00085,2,161920,173106,-,11186
2,BUMA.1121.00046,2,1803234,1814401,+,11167
2,BUMA.1121.00003,2,2548679,2559834,-,11155
2,BUMA.1121.00054,2,849748,860916,+,11168
2,BUMA.1121.00015,2,1142930,1154088,-,11158
2,BUMA.1121.00105,2,1158955,1170178,-,11223
2,BUMA.1121.00052,2,850486,861672,-,11186
2,BUMA.1121.00053,2,1641846,1653131,+,11285
2,BUMA.1121.00057,2,727891,739163,-,11272
2,BUMA.1121.00108,2,1580978,1592208,+,11230
2,BUMA.1121.00050,2,1419428,1430595,+,11167
2,BUMA.1121.00104,2,1446822,1458198,+,11376
2,BUMA.1121.00014,2,1478989,1490150,+,11161
2,BUMA.1121.00036,2,343561,354765,+,11204
2,BUMA.1121.00098,2,1609496,1620674,+,11178
2,BUMA.1121.00078,2,1776259,1787478,-,11219
2,BUMA.1121.00029,2,3223019,3234160,-,11141
2,BUMA.1121.00099,2,1610945,1622208,+,11263
2,BUMA.1121.00103,2,3270966,3282246,+,11280
2,BUMA.1121.00102,2,1405206,1416518,+,11312
2,BUMA.1121.00028,2,801056,812242,+,11186
2,BUMA.1121.00075,2,1647647,1658923,+,11276
2,BUMA.1121.00044,2,826063,837249,+,11186
2,BUMA.1121.00076,2,2241611,2252888,+,11277
2,BUMA.1121.00074,2,2998758,3009934,-,11176
2,BUMA.1121.00073,2,1329118,1340426,+,11308
2,BUMA.1121.00083,2,3156273,3167557,+,11284
2,BUMA.1121.00035,2,3240242,3251384,-,11142
2,BUMA.1121.00072,2,1325229,1336522,+,11293
2,BUMA.1121.00056,2,2640315,2651536,-,11221
2,BUMA.1121.00081,2,1262739,1273907,-,11168
2,BUMA.1121.00033,2,2093101,2104270,+,11169
2,BUMA.1121.00061,2,1318776,1330065,+,11289
2,BUMA.1121.00062,2,418017,429294,-,11277
2,BUMA.1121.00064,2,1268780,1279961,+,11181
2,BUMA.1121.00060,2,838491,849718,-,11227
2,BUMA.1121.00069,2,1326642,1338001,+,11359
2,BUMA.1121.00070,2,1329162,1340470,+,11308
2,BUMA.1121.00068,2,3062491,3073817,+,11326
2,BUMA.1121.00067,2,2613055,2624314,-,11259
2,BUMA.1121.00037,2,1714438,1725607,+,11169
2,BUMA.1121.00065,2,1400166,1411335,+,11169
2,BUMA.1121.00058,2,1902583,1913936,+,11353
2,BUMA.1121.00041,2,2296467,2307721,+,11254
2,BUMA.1121.00084,2,90,11322,+,11232
2,BUMA.1121.00096,2,1568249,1579488,+,11239
2,BUMA.1121.00080,2,1355760,1367086,+,11326
2,BUMA.1121.00100,2,2458937,2470191,+,11254
2,BUMA.1121.00012,2,335510,346718,-,11208
2,BUMA.1121.00018,2,2436762,2447931,-,11169
2,BUMA.1121.00048,2,2002092,2013260,-,11168
2,BUMA.1121.00106,2,453594,464998,-,11404
2,BUMA.1121.00017,2,774922,786108,+,11186
2,BUMA.1121.00082,2,1359316,1370600,+,11284
1,BUMA.1121.00049,2,1447,10527,+,9080
1,BUMA.1121.00055,2,1318363,1327551,-,9188
1,BUMA.1121.00011,2,3223667,3232855,+,9188
1,BUMA.1121.00110,2,1047976,1056802,-,8826
1,BUMA.1121.00109,2,59006,68087,-,9081
1,BUMA.1121.00077,2,2341630,2350456,-,8826
1,BUMA.1121.00027,2,2401808,2410804,+,8996
1,BUMA.1121.00021,2,1865567,1874608,+,9041
1,BUMA.1121.00023,2,1440248,1449226,+,8978
1,BUMA.1121.00022,2,275471,284365,+,8894
1,BUMA.1121.00034,2,766031,774916,+,8885
1,BUMA.1121.00025,2,2781867,2790848,-,8981
1,BUMA.1121.00031,2,536468,545479,+,9011
1,BUMA.1121.00007,2,1385604,1394687,+,9083
1,BUMA.1121.00097,2,1192897,1201909,+,9012
1,BUMA.1121.00059,2,2306007,2315018,-,9011
1,BUMA.1121.00002,2,1317402,1326331,+,8929
1,BUMA.1121.00005,2,2777314,2786356,+,9042
1,BUMA.1121.00111,2,620679,629693,+,9014
1,BUMA.1121.00006,2,1040746,1049616,+,8870
1,BUMA.1121.00009,2,3246402,3255340,+,8938
1,BUMA.1121.00094,2,1388292,1397432,+,9140
1,BUMA.1121.00101,2,2059645,2068644,-,8999
1,BUMA.1121.00066,2,1325574,1334540,+,8966
1,BUMA.1121.00095,2,3280301,3289306,-,9005
1,BUMA.1121.00112,2,3036827,3045721,-,8894
1,BUMA.1121.00042,2,847378,856226,-,8848
1,BUMA.1121.00032,2,1258630,1267506,+,8876
1,BUMA.1121.00090,2,2333246,2342215,+,8969
1,BUMA.1121.00089,2,1333270,1342497,+,9227
1,BUMA.1121.00051,2,1345370,1354490,+,9120
1,BUMA.1121.00001,2,855772,864804,-,9032
1,BUMA.1121.00045,2,1235183,1244188,+,9005
1,BUMA.1121.00043,2,1014682,1023744,-,9062
1,BUMA.1121.00063,2,1318850,1327816,+,8966
1,BUMA.1121.00079,2,1345881,1355107,+,9226
1,BUMA.1121.00071,2,1319435,1328362,+,8927
1,BUMA.1121.00086,2,1082864,1091767,+,8903
1,BUMA.1121.00024,2,885992,894886,+,8894
1,BUMA.1121.00010,2,76290,85202,+,8912
1,BUMA.1121.00040,2,1091913,1100780,+,8867
1,BUMA.1121.00093,2,1578917,1588092,-,9175
1,BUMA.1121.00091,2,2273281,2282226,-,8945
1,BUMA.1121.00107,2,2493377,2502304,-,8927
1,BUMA.1121.00088,2,1287038,1296145,+,9107
1,BUMA.1121.00047,2,2275267,2284518,+,9251
1,BUMA.1121.00087,2,1350361,1359264,+,8903
1,BUMA.1121.00039,2,2602312,2611479,-,9167
1,BUMA.1121.00030,2,1346871,1355747,-,8876
1,BUMA.1121.00016,2,2351758,2360904,-,9146
1,BUMA.1121.00092,2,1357094,1366261,+,9167
1,BUMA.1121.00085,2,173122,181953,-,8831
1,BUMA.1121.00046,2,1794387,1803218,+,8831
1,BUMA.1121.00003,2,2559841,2568948,-,9107
1,BUMA.1121.00054,2,840871,849732,+,8861
1,BUMA.1121.00015,2,1154104,1163052,-,8948
1,BUMA.1121.00105,2,1170234,1179299,-,9065
1,BUMA.1121.00052,2,861688,870519,-,8831
1,BUMA.1121.00053,2,1632804,1641845,+,9041
1,BUMA.1121.00057,2,739233,748208,-,8975
1,BUMA.1121.00108,2,1571968,1580926,+,8958
1,BUMA.1121.00050,2,1410581,1419412,+,8831
1,BUMA.1121.00104,2,1437722,1446802,+,9080
1,BUMA.1121.00014,2,1469962,1478937,+,8975
1,BUMA.1121.00036,2,334678,343545,+,8867
1,BUMA.1121.00098,2,1600432,1609458,+,9026
1,BUMA.1121.00078,2,1787575,1796583,-,9008
1,BUMA.1121.00029,2,3234189,3243176,-,8987
1,BUMA.1121.00099,2,1601999,1610929,+,8930
1,BUMA.1121.00103,2,3261921,3270941,+,9020
1,BUMA.1121.00102,2,1396263,1405190,+,8927
1,BUMA.1121.00028,2,792128,801022,+,8894
1,BUMA.1121.00075,2,1638643,1647627,+,8984
1,BUMA.1121.00044,2,817144,826029,+,8885
1,BUMA.1121.00076,2,2232604,2241591,+,8987
1,BUMA.1121.00074,2,3009941,3019111,-,9170
1,BUMA.1121.00073,2,1320100,1329066,+,8966
1,BUMA.1121.00083,2,3147237,3156203,+,8966
1,BUMA.1121.00035,2,3251404,3260454,-,9050
1,BUMA.1121.00072,2,1316215,1325168,+,8953
1,BUMA.1121.00056,2,2651552,2660715,-,9163
1,BUMA.1121.00081,2,1273923,1282784,-,8861
1,BUMA.1121.00033,2,2084034,2093036,+,9002
1,BUMA.1121.00061,2,1309740,1318706,+,8966
1,BUMA.1121.00062,2,429314,438394,-,9080
1,BUMA.1121.00064,2,1259698,1268769,+,9071
1,BUMA.1121.00060,2,849770,858765,-,8995
1,BUMA.1121.00069,2,1317675,1326641,+,8966
1,BUMA.1121.00070,2,1320144,1329110,+,8966
1,BUMA.1121.00068,2,3053404,3062457,+,9053
1,BUMA.1121.00067,2,2624334,2633469,-,9135
1,BUMA.1121.00037,2,1705419,1714427,+,9008
1,BUMA.1121.00065,2,1391076,1400114,+,9038
1,BUMA.1121.00058,2,1893320,1902567,+,9247
1,BUMA.1121.00041,2,2287521,2296379,+,8858
1,BUMA.1121.00084,2,3172701,3181762,+,9061
1,BUMA.1121.00096,2,1559246,1568215,+,8969
1,BUMA.1121.00080,2,1346606,1355744,+,9138
1,BUMA.1121.00100,2,2449757,2458912,+,9155
1,BUMA.1121.00012,2,346720,355692,-,8972
1,BUMA.1121.00018,2,2447951,2456950,-,8999
1,BUMA.1121.00048,2,2013276,2022137,-,8861
1,BUMA.1121.00106,2,465018,474029,-,9011
1,BUMA.1121.00017,2,766003,774888,+,8885
1,BUMA.1121.00082,2,1350280,1359246,+,8966
3,BUMA.1121.00049,2,27395,32539,+,5144
3,BUMA.1121.00055,2,1296519,1301624,-,5105
3,BUMA.1121.00011,2,1,5151,+,5150
3,BUMA.1121.00110,2,1026007,1031094,-,5087
3,BUMA.1121.00109,2,37462,42567,-,5105
3,BUMA.1121.00077,2,2319633,2324720,-,5087
3,BUMA.1121.00027,2,2427630,2432756,+,5126
3,BUMA.1121.00021,2,1890885,1895990,+,5105
3,BUMA.1121.00023,2,1465602,1470713,+,5111
3,BUMA.1121.00022,2,300649,305781,+,5132
3,BUMA.1121.00034,2,791209,796323,+,5114
3,BUMA.1121.00025,2,2760062,2765167,-,5105
3,BUMA.1121.00031,2,562179,567284,+,5105
3,BUMA.1121.00007,2,1411954,1417068,+,5114
3,BUMA.1121.00097,2,1218351,1223447,+,5096
3,BUMA.1121.00059,2,2284052,2289199,-,5147
3,BUMA.1121.00002,2,1342615,1347720,+,5105
3,BUMA.1121.00005,2,2803281,2808404,+,5123
3,BUMA.1121.00111,2,646426,651531,+,5105
3,BUMA.1121.00006,2,1065873,1070978,+,5105
3,BUMA.1121.00009,2,1,5133,+,5132
3,BUMA.1121.00094,2,1414118,1419253,+,5135
3,BUMA.1121.00101,2,2037619,2042733,-,5114
3,BUMA.1121.00066,2,1351403,1356538,+,5135
3,BUMA.1121.00095,2,3257903,3263017,-,5114
3,BUMA.1121.00112,2,3015028,3020115,-,5087
3,BUMA.1121.00042,2,824364,829496,-,5132
3,BUMA.1121.00032,2,1283781,1288895,+,5114
3,BUMA.1121.00090,2,2358951,2364056,+,5105
3,BUMA.1121.00089,2,1359254,1364389,+,5135
3,BUMA.1121.00051,2,1371307,1376421,+,5114
3,BUMA.1121.00001,2,833931,839036,-,5105
3,BUMA.1121.00045,2,1261056,1266170,+,5114
3,BUMA.1121.00043,2,993228,998333,-,5105
3,BUMA.1121.00063,2,1344681,1349825,+,5144
3,BUMA.1121.00079,2,1371933,1377056,+,5123
3,BUMA.1121.00071,2,1345169,1350308,+,5139
3,BUMA.1121.00086,2,1108042,1113174,+,5132
3,BUMA.1121.00024,2,911179,916293,+,5114
3,BUMA.1121.00010,2,101486,106591,+,5105
3,BUMA.1121.00040,2,1117046,1122151,+,5105
3,BUMA.1121.00093,2,1556020,1561158,-,5138
3,BUMA.1121.00091,2,2251326,2256437,-,5111
3,BUMA.1121.00107,2,2471401,2476515,-,5114
3,BUMA.1121.00088,2,1312971,1318109,+,5138
3,BUMA.1121.00047,2,2301362,2306485,+,5123
3,BUMA.1121.00087,2,1375539,1380671,+,5132
3,BUMA.1121.00039,2,2580912,2586017,-,5105
3,BUMA.1121.00030,2,1325464,1330578,-,5114
3,BUMA.1121.00016,2,2329894,2334999,-,5105
3,BUMA.1121.00092,2,1383192,1388330,+,5138
3,BUMA.1121.00085,2,151733,156847,-,5114
3,BUMA.1121.00046,2,1819501,1824606,+,5105
3,BUMA.1121.00003,2,2538036,2543150,-,5114
3,BUMA.1121.00054,2,865989,871094,+,5105
3,BUMA.1121.00015,2,1132734,1137857,-,5123
3,BUMA.1121.00105,2,1148303,1153432,-,5129
3,BUMA.1121.00052,2,840299,845413,-,5114
3,BUMA.1121.00053,2,1658314,1663434,+,5120
3,BUMA.1121.00057,2,717629,722800,-,5171
3,BUMA.1121.00108,2,1596936,1602050,+,5114
3,BUMA.1121.00050,2,1435695,1440800,+,5105
3,BUMA.1121.00104,2,1463283,1468415,+,5132
3,BUMA.1121.00014,2,1495688,1500795,+,5107
3,BUMA.1121.00036,2,359856,364988,+,5132
3,BUMA.1121.00098,2,1626203,1631353,+,5150
3,BUMA.1121.00078,2,1765584,1770731,-,5147
3,BUMA.1121.00029,2,3212349,3217454,-,5105
3,BUMA.1121.00099,2,1627770,1632884,+,5114
3,BUMA.1121.00103,2,3287790,3292892,+,5102
3,BUMA.1121.00102,2,1422067,1427178,+,5111
3,BUMA.1121.00028,2,817315,822429,+,5114
3,BUMA.1121.00075,2,1664434,1669566,+,5132
3,BUMA.1121.00044,2,842322,847436,+,5114
3,BUMA.1121.00076,2,2258399,2263531,+,5132
3,BUMA.1121.00074,2,2988112,2993247,-,5135
3,BUMA.1121.00073,2,1345929,1351073,+,5144
3,BUMA.1121.00083,2,1,5145,+,5144
3,BUMA.1121.00035,2,3229599,3234704,-,5105
3,BUMA.1121.00072,2,1342031,1347175,+,5144
3,BUMA.1121.00056,2,2629660,2634795,-,5135
3,BUMA.1121.00081,2,1252561,1257666,-,5105
3,BUMA.1121.00033,2,2109870,2114966,+,5096
3,BUMA.1121.00061,2,1335568,1340711,+,5143
3,BUMA.1121.00062,2,407380,412512,-,5132
3,BUMA.1121.00064,2,1285481,1290616,+,5135
3,BUMA.1121.00060,2,827806,832920,-,5114
3,BUMA.1121.00069,2,1343505,1348643,+,5138
3,BUMA.1121.00070,2,1345974,1351118,+,5144
3,BUMA.1121.00068,2,3079337,3084451,+,5114
3,BUMA.1121.00067,2,2602418,2607532,-,5114
3,BUMA.1121.00037,2,1731145,1736250,+,5105
3,BUMA.1121.00065,2,1416840,1421945,+,5105
3,BUMA.1121.00058,2,1919444,1924555,+,5111
3,BUMA.1121.00041,2,2313208,2318322,+,5114
3,BUMA.1121.00084,2,16851,21968,+,5117
3,BUMA.1121.00096,2,1585038,1590158,+,5120
3,BUMA.1121.00080,2,1372587,1377710,+,5123
3,BUMA.1121.00100,2,2475738,2480816,+,5078
3,BUMA.1121.00012,2,324678,329783,-,5105
3,BUMA.1121.00018,2,2426146,2431251,-,5105
3,BUMA.1121.00048,2,1991914,1997019,-,5105
3,BUMA.1121.00106,2,442955,448102,-,5147
3,BUMA.1121.00017,2,791181,796295,+,5114
3,BUMA.1121.00082,2,1376111,1381255,+,5144
4,BUMA.1121.00049,2,34691,50055,+,15364
4,BUMA.1121.00055,2,1279012,1294401,-,15389
4,BUMA.1121.00011,2,7191,22504,+,15313
4,BUMA.1121.00110,2,1008530,1023888,-,15358
4,BUMA.1121.00109,2,20070,35406,-,15336
4,BUMA.1121.00077,2,2302155,2317514,-,15359
4,BUMA.1121.00027,2,2434884,2450230,+,15346
4,BUMA.1121.00021,2,1897969,1913324,+,15355
4,BUMA.1121.00023,2,1472782,1488114,+,15332
4,BUMA.1121.00022,2,307892,323191,+,15299
4,BUMA.1121.00034,2,798412,813753,+,15341
4,BUMA.1121.00025,2,2742594,2757990,-,15396
4,BUMA.1121.00031,2,569353,584668,+,15315
4,BUMA.1121.00007,2,1419174,1434605,+,15431
4,BUMA.1121.00097,2,1225473,1240844,+,15371
4,BUMA.1121.00059,2,2266482,2281899,-,15417
4,BUMA.1121.00002,2,1349820,1365183,+,15363
4,BUMA.1121.00005,2,2810533,2825902,+,15369
4,BUMA.1121.00111,2,653600,668894,+,15294
4,BUMA.1121.00006,2,1073078,1088447,+,15369
4,BUMA.1121.00009,2,7228,22577,+,15349
4,BUMA.1121.00094,2,1421307,1436666,+,15359
4,BUMA.1121.00101,2,2020117,2035534,-,15417
4,BUMA.1121.00066,2,1358664,1374014,+,15350
4,BUMA.1121.00095,2,3240442,3255755,-,15313
4,BUMA.1121.00112,2,2997603,3012921,-,15318
4,BUMA.1121.00042,2,807085,822404,-,15319
4,BUMA.1121.00032,2,1290984,1306325,+,15341
4,BUMA.1121.00090,2,2366136,2381430,+,15294
4,BUMA.1121.00089,2,1366454,1381813,+,15359
4,BUMA.1121.00051,2,1378501,1393914,+,15413
4,BUMA.1121.00001,2,816510,831861,-,15351
4,BUMA.1121.00045,2,1268252,1283626,+,15374
4,BUMA.1121.00043,2,975840,991158,-,15318
4,BUMA.1121.00063,2,1351953,1367320,+,15367
4,BUMA.1121.00079,2,1379136,1394486,+,15350
4,BUMA.1121.00071,2,1352436,1367793,+,15357
4,BUMA.1121.00086,2,1115285,1130612,+,15327
4,BUMA.1121.00024,2,918382,933724,+,15342
4,BUMA.1121.00010,2,108691,124047,+,15356
4,BUMA.1121.00040,2,1124251,1139599,+,15348
4,BUMA.1121.00093,2,1538599,1553878,-,15279
4,BUMA.1121.00091,2,2233852,2249196,-,15344
4,BUMA.1121.00107,2,2453887,2469305,-,15418
4,BUMA.1121.00088,2,1320139,1335528,+,15389
4,BUMA.1121.00047,2,2308565,2323987,+,15422
4,BUMA.1121.00087,2,1382782,1398109,+,15327
4,BUMA.1121.00039,2,2563525,2578842,-,15317
4,BUMA.1121.00030,2,1308034,1323374,-,15340
4,BUMA.1121.00016,2,2312620,2327824,-,15204
4,BUMA.1121.00092,2,1390471,1405750,+,15279
4,BUMA.1121.00085,2,134320,149632,-,15312
4,BUMA.1121.00046,2,1826706,1842033,+,15327
4,BUMA.1121.00003,2,2520612,2535931,-,15319
4,BUMA.1121.00054,2,873194,888563,+,15369
4,BUMA.1121.00015,2,1115304,1130644,-,15340
4,BUMA.1121.00105,2,1130899,1146272,-,15373
4,BUMA.1121.00052,2,822886,838198,-,15312
4,BUMA.1121.00053,2,1665551,1680893,+,15342
4,BUMA.1121.00057,2,700120,715500,-,15380
4,BUMA.1121.00108,2,1604038,1619506,+,15468
4,BUMA.1121.00050,2,1442900,1458227,+,15327
4,BUMA.1121.00104,2,1470556,1485889,+,15333
4,BUMA.1121.00014,2,1502865,1518243,+,15378
4,BUMA.1121.00036,2,367088,382415,+,15327
4,BUMA.1121.00098,2,1633500,1648586,+,15086
4,BUMA.1121.00078,2,1748026,1763481,-,15455
4,BUMA.1121.00029,2,3194956,3210279,-,15323
4,BUMA.1121.00099,2,1634992,1650446,+,15454
4,BUMA.1121.00103,2,3294990,3310308,+,15318
4,BUMA.1121.00102,2,1429273,1444586,+,15313
4,BUMA.1121.00028,2,824518,839859,+,15341
4,BUMA.1121.00075,2,1671661,1687093,+,15432
4,BUMA.1121.00044,2,849525,864866,+,15341
4,BUMA.1121.00076,2,2265626,2281059,+,15433
4,BUMA.1121.00074,2,2970621,2985981,-,15360
4,BUMA.1121.00073,2,1353201,1368568,+,15367
4,BUMA.1121.00083,2,7273,22640,+,15367
4,BUMA.1121.00035,2,3212213,3227529,-,15316
4,BUMA.1121.00072,2,1349303,1364668,+,15365
4,BUMA.1121.00056,2,2612236,2627594,-,15358
4,BUMA.1121.00081,2,1235092,1250460,-,15368
4,BUMA.1121.00033,2,2117035,2132360,+,15325
4,BUMA.1121.00061,2,1342839,1358206,+,15367
4,BUMA.1121.00062,2,389928,405227,-,15299
4,BUMA.1121.00064,2,1292768,1308132,+,15364
4,BUMA.1121.00060,2,810343,825723,-,15380
4,BUMA.1121.00069,2,1350771,1366132,+,15361
4,BUMA.1121.00070,2,1353246,1368613,+,15367
4,BUMA.1121.00068,2,3086429,3101711,+,15282
4,BUMA.1121.00067,2,2584957,2600374,-,15417
4,BUMA.1121.00037,2,1738319,1753628,+,15309
4,BUMA.1121.00065,2,1424051,1439395,+,15344
4,BUMA.1121.00058,2,1926661,1941998,+,15337
4,BUMA.1121.00041,2,2320439,2335873,+,15434
4,BUMA.1121.00084,2,23998,39377,+,15379
4,BUMA.1121.00096,2,1592264,1607737,+,15473
4,BUMA.1121.00080,2,1379790,1395203,+,15413
4,BUMA.1121.00100,2,2482817,2498263,+,15446
4,BUMA.1121.00012,2,307269,322608,-,15339
4,BUMA.1121.00018,2,2408678,2424074,-,15396
4,BUMA.1121.00048,2,1974445,1989813,-,15368
4,BUMA.1121.00106,2,425479,440826,-,15347
4,BUMA.1121.00017,2,798384,813725,+,15341
4,BUMA.1121.00082,2,1383383,1398750,+,15367
5,BUMA.1121.00049,2,65617,69979,+,4362
5,BUMA.1121.00055,2,1259150,1263512,-,4362
5,BUMA.1121.00011,2,38096,42449,+,4353
5,BUMA.1121.00110,2,992661,997008,-,4347
5,BUMA.1121.00109,2,224,4586,-,4362
5,BUMA.1121.00077,2,2286282,2290630,-,4348
5,BUMA.1121.00027,2,2465700,2470053,+,4353
5,BUMA.1121.00026,2,1626168,1630575,+,4407
5,BUMA.1121.00021,2,1928843,1933205,+,4362
5,BUMA.1121.00023,2,1538558,1542956,+,4398
5,BUMA.1121.00022,2,339665,344027,+,4362
5,BUMA.1121.00034,2,830227,834598,+,4371
5,BUMA.1121.00025,2,2721439,2725799,-,4360
5,BUMA.1121.00031,2,600176,604538,+,4362
5,BUMA.1121.00007,2,1450186,1454548,+,4362
5,BUMA.1121.00097,2,1256449,1260802,+,4353
5,BUMA.1121.00008,2,814362,818733,+,4371
5,BUMA.1121.00059,2,2246586,2250939,-,4353
5,BUMA.1121.00002,2,1715522,1719883,-,4361
5,BUMA.1121.00004,2,815082,819453,+,4371
5,BUMA.1121.00005,2,2841526,2845888,+,4362
5,BUMA.1121.00111,2,738289,742651,+,4362
5,BUMA.1121.00006,2,1256161,1260532,-,4371
5,BUMA.1121.00009,2,73600,77947,+,4347
5,BUMA.1121.00094,2,1452246,1456608,+,4362
5,BUMA.1121.00101,2,2000148,2004495,-,4347
5,BUMA.1121.00066,2,1389540,1393893,+,4353
5,BUMA.1121.00095,2,3220493,3224855,-,4362
5,BUMA.1121.00112,2,2977703,2982050,-,4347
5,BUMA.1121.00042,2,679922,684298,+,4376
5,BUMA.1121.00032,2,1322799,1327170,+,4371
5,BUMA.1121.00090,2,2396901,2401263,+,4362
5,BUMA.1121.00020,2,815103,819474,+,4371
5,BUMA.1121.00089,2,1397392,1401754,+,4362
5,BUMA.1121.00051,2,1409525,1413887,+,4362
5,BUMA.1121.00001,2,796618,800980,-,4362
5,BUMA.1121.00045,2,1299256,1303618,+,4362
5,BUMA.1121.00043,2,920639,925001,-,4362
5,BUMA.1121.00063,2,1382889,1387242,+,4353
5,BUMA.1121.00079,2,1410039,1414401,+,4362
5,BUMA.1121.00071,2,1383353,1387706,+,4353
5,BUMA.1121.00086,2,1147086,1151448,+,4362
5,BUMA.1121.00024,2,950198,954569,+,4371
5,BUMA.1121.00010,2,474327,478688,-,4361
5,BUMA.1121.00040,2,1156072,1160443,+,4371
5,BUMA.1121.00093,2,1518656,1523018,-,4362
5,BUMA.1121.00091,2,2213933,2218280,-,4347
5,BUMA.1121.00107,2,2433904,2438266,-,4362
5,BUMA.1121.00088,2,1351078,1355431,+,4353
5,BUMA.1121.00047,2,2339600,2343974,+,4374
5,BUMA.1121.00019,2,815067,819438,+,4371
5,BUMA.1121.00087,2,1414583,1418945,+,4362
5,BUMA.1121.00039,2,2543661,2548023,-,4362
5,BUMA.1121.00030,2,1287189,1291560,-,4371
5,BUMA.1121.00016,2,2292686,2297048,-,4362
5,BUMA.1121.00092,2,1421331,1425693,+,4362
5,BUMA.1121.00085,2,7267,11638,+,4371
5,BUMA.1121.00046,2,1958181,1962552,-,4371
5,BUMA.1121.00003,2,2500743,2505126,-,4383
5,BUMA.1121.00054,2,1056284,1060655,-,4371
5,BUMA.1121.00015,2,994897,999268,+,4371
5,BUMA.1121.00105,2,1111129,1115491,-,4362
5,BUMA.1121.00052,2,695834,700205,+,4371
5,BUMA.1121.00053,2,1696531,1700893,+,4362
5,BUMA.1121.00057,2,680292,684645,-,4353
5,BUMA.1121.00108,2,1635081,1639443,+,4362
5,BUMA.1121.00050,2,1574372,1578743,-,4371
5,BUMA.1121.00104,2,1501436,1505798,+,4362
5,BUMA.1121.00014,2,1533741,1538103,+,4362
5,BUMA.1121.00036,2,398889,403251,+,4362
5,BUMA.1121.00038,2,1157321,1161692,-,4371
5,BUMA.1121.00098,2,1664160,1668522,+,4362
5,BUMA.1121.00078,2,1728107,1732454,-,4347
5,BUMA.1121.00029,2,3175043,3179405,-,4362
5,BUMA.1121.00099,2,1666037,1670411,+,4374
5,BUMA.1121.00103,2,3325958,3330317,+,4359
5,BUMA.1121.00102,2,1460158,1464523,+,4365
5,BUMA.1121.00028,2,856333,860704,+,4371
5,BUMA.1121.00075,2,1739331,1743693,+,4362
5,BUMA.1121.00044,2,881340,885711,+,4371
5,BUMA.1121.00076,2,2333299,2337661,+,4362
5,BUMA.1121.00074,2,2950708,2955061,-,4353
5,BUMA.1121.00073,2,1384137,1388490,+,4353
5,BUMA.1121.00083,2,38209,42562,+,4353
5,BUMA.1121.00035,2,3192307,3196669,-,4362
5,BUMA.1121.00072,2,1380195,1384548,+,4353
5,BUMA.1121.00056,2,2592294,2596656,-,4362
5,BUMA.1121.00081,2,1062999,1067370,+,4371
5,BUMA.1121.00033,2,2147851,2152213,+,4362
5,BUMA.1121.00061,2,1373775,1378128,+,4353
5,BUMA.1121.00062,2,370011,374358,-,4347
5,BUMA.1121.00064,2,1323701,1328054,+,4353
5,BUMA.1121.00060,2,790351,794713,-,4362
5,BUMA.1121.00069,2,1381701,1386054,+,4353
5,BUMA.1121.00070,2,1384182,1388535,+,4353
5,BUMA.1121.00068,2,3117334,3121702,+,4368
5,BUMA.1121.00067,2,2565023,2569376,-,4353
5,BUMA.1121.00037,2,1769126,1773488,+,4362
5,BUMA.1121.00065,2,1454831,1459193,+,4362
5,BUMA.1121.00058,2,1957664,1962026,+,4362
5,BUMA.1121.00041,2,2351488,2355856,+,4368
5,BUMA.1121.00084,2,54560,58913,+,4353
5,BUMA.1121.00096,2,1623336,1627683,+,4347
5,BUMA.1121.00080,2,1410763,1415125,+,4362
5,BUMA.1121.00013,2,1408550,1412921,+,4371
5,BUMA.1121.00100,2,2513834,2518187,+,4353
5,BUMA.1121.00012,2,287382,291729,-,4347
5,BUMA.1121.00018,2,2387523,2391883,-,4360
5,BUMA.1121.00048,2,1802371,1806742,+,4371
5,BUMA.1121.00106,2,405566,409928,-,4362
5,BUMA.1121.00017,2,830199,834570,+,4371
5,BUMA.1121.00082,2,1414319,1418672,+,4353
6,BUMA.1121.00049,2,70289,74475,+,4186
6,BUMA.1121.00055,2,1254654,1258840,-,4186
6,BUMA.1121.00011,2,42775,46945,+,4170
6,BUMA.1121.00110,2,988165,992351,-,4186
6,BUMA.1121.00109,2,3322797,3326983,-,4186
6,BUMA.1121.00077,2,2281783,2285972,-,4189
6,BUMA.1121.00027,2,2470363,2474549,+,4186
6,BUMA.1121.00026,2,1630885,1635071,+,4186
6,BUMA.1121.00021,2,1933515,1937701,+,4186
6,BUMA.1121.00023,2,1543266,1547452,+,4186
6,BUMA.1121.00022,2,344337,348523,+,4186
6,BUMA.1121.00034,2,834908,839094,+,4186
6,BUMA.1121.00025,2,2716943,2721129,-,4186
6,BUMA.1121.00031,2,604848,609034,+,4186
6,BUMA.1121.00007,2,1454858,1459043,+,4185
6,BUMA.1121.00097,2,1261112,1265298,+,4186
6,BUMA.1121.00008,2,819043,823229,+,4186
6,BUMA.1121.00059,2,2242092,2246276,-,4184
6,BUMA.1121.00002,2,1711026,1715212,-,4186
6,BUMA.1121.00004,2,819763,823949,+,4186
6,BUMA.1121.00005,2,2846198,2850384,+,4186
6,BUMA.1121.00111,2,742961,747146,+,4185
6,BUMA.1121.00006,2,1251665,1255851,-,4186
6,BUMA.1121.00009,2,78257,82443,+,4186
6,BUMA.1121.00094,2,1456918,1461104,+,4186
6,BUMA.1121.00101,2,1995652,1999838,-,4186
6,BUMA.1121.00066,2,1394203,1398389,+,4186
6,BUMA.1121.00095,2,3215997,3220183,-,4186
6,BUMA.1121.00112,2,2973207,2977393,-,4186
6,BUMA.1121.00042,2,684608,688794,+,4186
6,BUMA.1121.00032,2,1327480,1331666,+,4186
6,BUMA.1121.00090,2,2401573,2405759,+,4186
6,BUMA.1121.00020,2,819784,823970,+,4186
6,BUMA.1121.00089,2,1402064,1406250,+,4186
6,BUMA.1121.00051,2,1414197,1418383,+,4186
6,BUMA.1121.00001,2,792122,796308,-,4186
6,BUMA.1121.00045,2,1303928,1308114,+,4186
6,BUMA.1121.00043,2,916143,920329,-,4186
6,BUMA.1121.00063,2,1387552,1391738,+,4186
6,BUMA.1121.00079,2,1414711,1418896,+,4185
6,BUMA.1121.00071,2,1388016,1392202,+,4186
6,BUMA.1121.00086,2,1151758,1155944,+,4186
6,BUMA.1121.00024,2,954879,959065,+,4186
6,BUMA.1121.00010,2,469831,474017,-,4186
6,BUMA.1121.00040,2,1160753,1164939,+,4186
6,BUMA.1121.00093,2,1514160,1518346,-,4186
6,BUMA.1121.00091,2,2209437,2213623,-,4186
6,BUMA.1121.00107,2,2429408,2433594,-,4186
6,BUMA.1121.00088,2,1355741,1359927,+,4186
6,BUMA.1121.00047,2,2344284,2348470,+,4186
6,BUMA.1121.00019,2,819748,823934,+,4186
6,BUMA.1121.00087,2,1419255,1423441,+,4186
6,BUMA.1121.00039,2,2539165,2543351,-,4186
6,BUMA.1121.00030,2,1282693,1286879,-,4186
6,BUMA.1121.00016,2,2288190,2292376,-,4186
6,BUMA.1121.00092,2,1426003,1430189,+,4186
6,BUMA.1121.00085,2,11948,16134,+,4186
6,BUMA.1121.00046,2,1953685,1957871,-,4186
6,BUMA.1121.00003,2,2496247,2500416,-,4169
6,BUMA.1121.00054,2,1051788,1055974,-,4186
6,BUMA.1121.00015,2,999578,1003764,+,4186
6,BUMA.1121.00105,2,1106633,1110819,-,4186
6,BUMA.1121.00052,2,700515,704701,+,4186
6,BUMA.1121.00053,2,1701203,1705389,+,4186
6,BUMA.1121.00057,2,675796,679982,-,4186
6,BUMA.1121.00108,2,1639753,1643939,+,4186
6,BUMA.1121.00050,2,1569876,1574062,-,4186
6,BUMA.1121.00104,2,1506108,1510294,+,4186
6,BUMA.1121.00014,2,1538413,1542599,+,4186
6,BUMA.1121.00036,2,403561,407747,+,4186
6,BUMA.1121.00038,2,1152825,1157011,-,4186
6,BUMA.1121.00098,2,1668832,1673018,+,4186
6,BUMA.1121.00078,2,1723611,1727797,-,4186
6,BUMA.1121.00029,2,3170547,3174733,-,4186
6,BUMA.1121.00099,2,1670721,1674907,+,4186
6,BUMA.1121.00103,2,3330627,3334813,+,4186
6,BUMA.1121.00102,2,1464833,1469019,+,4186
6,BUMA.1121.00028,2,861014,865200,+,4186
6,BUMA.1121.00075,2,1744003,1748189,+,4186
6,BUMA.1121.00044,2,886021,890207,+,4186
6,BUMA.1121.00076,2,2337971,2342137,+,4166
6,BUMA.1121.00074,2,2946212,2950398,-,4186
6,BUMA.1121.00073,2,1388800,1392986,+,4186
6,BUMA.1121.00083,2,42872,47058,+,4186
6,BUMA.1121.00035,2,3187811,3191997,-,4186
6,BUMA.1121.00072,2,1384858,1389044,+,4186
6,BUMA.1121.00056,2,2587798,2591984,-,4186
6,BUMA.1121.00081,2,1067680,1071866,+,4186
6,BUMA.1121.00033,2,2152523,2156709,+,4186
6,BUMA.1121.00061,2,1378438,1382581,+,4143
6,BUMA.1121.00062,2,365515,369701,-,4186
6,BUMA.1121.00064,2,1328364,1332550,+,4186
6,BUMA.1121.00060,2,785855,790041,-,4186
6,BUMA.1121.00069,2,1386364,1390550,+,4186
6,BUMA.1121.00070,2,1388845,1393031,+,4186
6,BUMA.1121.00068,2,3122012,3126197,+,4185
6,BUMA.1121.00067,2,2560527,2564713,-,4186
6,BUMA.1121.00037,2,1773798,1777984,+,4186
6,BUMA.1121.00065,2,1459503,1463689,+,4186
6,BUMA.1121.00058,2,1962336,1966522,+,4186
6,BUMA.1121.00041,2,2356166,2360352,+,4186
6,BUMA.1121.00084,2,59223,63409,+,4186
6,BUMA.1121.00096,2,1628009,1632179,+,4170
6,BUMA.1121.00080,2,1415435,1419621,+,4186
6,BUMA.1121.00013,2,1413231,1417417,+,4186
6,BUMA.1121.00100,2,2518497,2522683,+,4186
6,BUMA.1121.00012,2,282886,287072,-,4186
6,BUMA.1121.00018,2,2383027,2387213,-,4186
6,BUMA.1121.00048,2,1807052,1811238,+,4186
6,BUMA.1121.00106,2,401070,405256,-,4186
6,BUMA.1121.00017,2,834880,839066,+,4186
6,BUMA.1121.00082,2,1418982,1423168,+,4186
17,BUMA.1121.00049,2,208502,241975,+,33473
17,BUMA.1121.00055,2,1085607,1119066,-,33459
17,BUMA.1121.00011,2,180482,213937,+,33455
17,BUMA.1121.00110,2,819669,853129,-,33460
17,BUMA.1121.00109,2,3086561,3119973,-,33412
17,BUMA.1121.00077,2,2113292,2146750,-,33458
17,BUMA.1121.00027,2,2608606,2641991,+,33385
17,BUMA.1121.00021,2,2079691,2113167,+,33476
17,BUMA.1121.00023,2,1692166,1725610,+,33444
17,BUMA.1121.00025,2,2549559,2582982,-,33423
17,BUMA.1121.00031,2,740502,773936,+,33434
17,BUMA.1121.00007,2,1631102,1664549,+,33447
17,BUMA.1121.00097,2,1399371,1432785,+,33414
17,BUMA.1121.00059,2,2007438,2040818,-,33380
17,BUMA.1121.00005,2,2985943,3019365,+,33422
17,BUMA.1121.00111,2,891898,925416,+,33518
17,BUMA.1121.00009,2,217811,251235,+,33424
17,BUMA.1121.00094,2,1594747,1628131,+,33384
17,BUMA.1121.00101,2,1827139,1860623,-,33484
17,BUMA.1121.00066,2,1534379,1567767,+,33388
17,BUMA.1121.00095,2,2990551,3023975,-,33424
17,BUMA.1121.00112,2,2806267,2839733,-,33466
17,BUMA.1121.00090,2,2539753,2573226,+,33473
17,BUMA.1121.00089,2,1539920,1573304,+,33384
17,BUMA.1121.00051,2,1553312,1586692,+,33380
17,BUMA.1121.00001,2,616750,650216,-,33466
17,BUMA.1121.00045,2,1446817,1480321,+,33504
17,BUMA.1121.00043,2,711723,745222,-,33499
17,BUMA.1121.00063,2,1548481,1581869,+,33388
17,BUMA.1121.00079,2,1553975,1587390,+,33415
17,BUMA.1121.00071,2,1549302,1582685,+,33383
17,BUMA.1121.00093,2,1346727,1380138,-,33411
17,BUMA.1121.00091,2,2041935,2075341,-,33406
17,BUMA.1121.00107,2,2222957,2256255,-,33298
17,BUMA.1121.00088,2,1563662,1597071,+,33409
17,BUMA.1121.00047,2,2484432,2517800,+,33368
17,BUMA.1121.00039,2,2371762,2405193,-,33431
17,BUMA.1121.00016,2,2120812,2154232,-,33420
17,BUMA.1121.00092,2,1564211,1597622,+,33411
17,BUMA.1121.00003,2,2327693,2361138,-,33445
17,BUMA.1121.00105,2,832530,865948,-,33418
17,BUMA.1121.00053,2,1844261,1877676,+,33415
17,BUMA.1121.00057,2,508340,541727,-,33387
17,BUMA.1121.00108,2,1777507,1810868,+,33361
17,BUMA.1121.00104,2,1644375,1677815,+,33440
17,BUMA.1121.00014,2,1674123,1707565,+,33442
17,BUMA.1121.00098,2,1820961,1854371,+,33410
17,BUMA.1121.00078,2,1556146,1589529,-,33383
17,BUMA.1121.00029,2,2995137,3028620,-,33483
17,BUMA.1121.00099,2,1810040,1843449,+,33409
17,BUMA.1121.00103,2,104819,138171,+,33352
17,BUMA.1121.00102,2,1604116,1637540,+,33424
17,BUMA.1121.00075,2,1881794,1915280,+,33486
17,BUMA.1121.00076,2,2512404,2545893,+,33489
17,BUMA.1121.00074,2,2778630,2812105,-,33475
17,BUMA.1121.00073,2,1549737,1583096,+,33359
17,BUMA.1121.00083,2,216884,250273,+,33389
17,BUMA.1121.00035,2,3012416,3045900,-,33484
17,BUMA.1121.00072,2,1528676,1562033,+,33357
17,BUMA.1121.00056,2,2420743,2454128,-,33385
17,BUMA.1121.00033,2,2317920,2351324,+,33404
17,BUMA.1121.00061,2,1537556,1570914,+,33358
17,BUMA.1121.00062,2,94227,127670,-,33443
17,BUMA.1121.00064,2,1466611,1500085,+,33474
17,BUMA.1121.00069,2,1526206,1559557,+,33351
17,BUMA.1121.00070,2,1529347,1562704,+,33357
17,BUMA.1121.00068,2,138154,171602,+,33448
17,BUMA.1121.00067,2,2392897,2426372,-,33475
17,BUMA.1121.00037,2,1911891,1945336,+,33445
17,BUMA.1121.00065,2,1597704,1631150,+,33446
17,BUMA.1121.00058,2,2168573,2202003,+,33430
17,BUMA.1121.00041,2,2494458,2527896,+,33438
17,BUMA.1121.00084,2,267187,300560,+,33373
17,BUMA.1121.00096,2,1767248,1800711,+,33463
17,BUMA.1121.00080,2,1554552,1587932,+,33380
17,BUMA.1121.00100,2,2694103,2727534,+,33431
17,BUMA.1121.00012,2,78557,112042,-,33485
17,BUMA.1121.00018,2,2215643,2249066,-,33423
17,BUMA.1121.00106,2,162097,195566,-,33469
17,BUMA.1121.00082,2,1592994,1626383,+,33389
18,BUMA.1121.00049,2,241977,245746,+,3769
18,BUMA.1121.00055,2,1081837,1085606,-,3769
18,BUMA.1121.00011,2,213939,217699,+,3760
18,BUMA.1121.00110,2,815899,819668,-,3769
18,BUMA.1121.00109,2,3082791,3086560,-,3769
18,BUMA.1121.00077,2,2109522,2113291,-,3769
18,BUMA.1121.00027,2,2641993,2645762,+,3769
18,BUMA.1121.00021,2,2113169,2116938,+,3769
18,BUMA.1121.00023,2,1725612,1729381,+,3769
18,BUMA.1121.00025,2,2545789,2549558,-,3769
18,BUMA.1121.00031,2,773938,777707,+,3769
18,BUMA.1121.00007,2,1664551,1668320,+,3769
18,BUMA.1121.00097,2,1432787,1436553,+,3766
18,BUMA.1121.00059,2,2003668,2007437,-,3769
18,BUMA.1121.00005,2,3019367,3023136,+,3769
18,BUMA.1121.00111,2,925418,929187,+,3769
18,BUMA.1121.00009,2,251237,255006,+,3769
18,BUMA.1121.00094,2,1628133,1631902,+,3769
18,BUMA.1121.00101,2,1823369,1827138,-,3769
18,BUMA.1121.00066,2,1567769,1571538,+,3769
18,BUMA.1121.00095,2,2986781,2990550,-,3769
18,BUMA.1121.00112,2,2802497,2806266,-,3769
18,BUMA.1121.00090,2,2573228,2576997,+,3769
18,BUMA.1121.00089,2,1573306,1577075,+,3769
18,BUMA.1121.00051,2,1586694,1590463,+,3769
18,BUMA.1121.00001,2,612980,616749,-,3769
18,BUMA.1121.00045,2,1480323,1484092,+,3769
18,BUMA.1121.00043,2,707953,711722,-,3769
18,BUMA.1121.00063,2,1581871,1585640,+,3769
18,BUMA.1121.00079,2,1587392,1591161,+,3769
18,BUMA.1121.00071,2,1582687,1586456,+,3769
18,BUMA.1121.00093,2,1342957,1346726,-,3769
18,BUMA.1121.00091,2,2038165,2041934,-,3769
18,BUMA.1121.00107,2,2219187,2222956,-,3769
18,BUMA.1121.00088,2,1597073,1600842,+,3769
18,BUMA.1121.00047,2,2517802,2521571,+,3769
18,BUMA.1121.00039,2,2367992,2371761,-,3769
18,BUMA.1121.00016,2,2117042,2120811,-,3769
18,BUMA.1121.00092,2,1597624,1601393,+,3769
18,BUMA.1121.00003,2,2323923,2327692,-,3769
18,BUMA.1121.00105,2,828760,832529,-,3769
18,BUMA.1121.00053,2,1877678,1881447,+,3769
18,BUMA.1121.00057,2,504570,508339,-,3769
18,BUMA.1121.00108,2,1810870,1814639,+,3769
18,BUMA.1121.00104,2,1677817,1681586,+,3769
18,BUMA.1121.00014,2,1707567,1711334,+,3767
18,BUMA.1121.00098,2,1854373,1858142,+,3769
18,BUMA.1121.00078,2,1552376,1556145,-,3769
18,BUMA.1121.00029,2,2991368,2995136,-,3768
18,BUMA.1121.00099,2,1843451,1847220,+,3769
18,BUMA.1121.00103,2,138173,141942,+,3769
18,BUMA.1121.00102,2,1637542,1641311,+,3769
18,BUMA.1121.00075,2,1915282,1919051,+,3769
18,BUMA.1121.00076,2,2545895,2549664,+,3769
18,BUMA.1121.00074,2,2774860,2778629,-,3769
18,BUMA.1121.00073,2,1583098,1586867,+,3769
18,BUMA.1121.00083,2,250275,254044,+,3769
18,BUMA.1121.00035,2,3008646,3012415,-,3769
18,BUMA.1121.00072,2,1562035,1565804,+,3769
18,BUMA.1121.00056,2,2416973,2420742,-,3769
18,BUMA.1121.00033,2,2351326,2355079,+,3753
18,BUMA.1121.00061,2,1570916,1574685,+,3769
18,BUMA.1121.00062,2,90457,94226,-,3769
18,BUMA.1121.00064,2,1500087,1503856,+,3769
18,BUMA.1121.00060,2,765756,769525,-,3769
18,BUMA.1121.00069,2,1559559,1563328,+,3769
18,BUMA.1121.00070,2,1562706,1566475,+,3769
18,BUMA.1121.00068,2,171604,175373,+,3769
18,BUMA.1121.00067,2,2389127,2392896,-,3769
18,BUMA.1121.00037,2,1945338,1949107,+,3769
18,BUMA.1121.00065,2,1631152,1634921,+,3769
18,BUMA.1121.00058,2,2202005,2205774,+,3769
18,BUMA.1121.00041,2,2527898,2531667,+,3769
18,BUMA.1121.00084,2,300562,304331,+,3769
18,BUMA.1121.00096,2,1800713,1804482,+,3769
18,BUMA.1121.00080,2,1587934,1591703,+,3769
18,BUMA.1121.00100,2,2727536,2731305,+,3769
18,BUMA.1121.00012,2,74787,78556,-,3769
18,BUMA.1121.00018,2,2211873,2215642,-,3769
18,BUMA.1121.00106,2,158327,162096,-,3769
18,BUMA.1121.00082,2,1626385,1630154,+,3769
19,BUMA.1121.00049,2,261900,265547,+,3647
19,BUMA.1121.00055,2,1062064,1065693,-,3629
19,BUMA.1121.00011,2,235243,238865,+,3622
19,BUMA.1121.00110,2,796112,799710,-,3598
19,BUMA.1121.00109,2,3062967,3066607,-,3640
19,BUMA.1121.00077,2,2089737,2093335,-,3598
19,BUMA.1121.00027,2,2663199,2666842,+,3643
19,BUMA.1121.00026,2,1493717,1497364,-,3647
19,BUMA.1121.00021,2,2134387,2137959,+,3572
19,BUMA.1121.00023,2,1748199,1751764,+,3565
19,BUMA.1121.00022,2,373425,377036,+,3611
19,BUMA.1121.00034,2,864008,867633,+,3625
19,BUMA.1121.00025,2,2523700,2527266,-,3566
19,BUMA.1121.00031,2,795157,798724,+,3567
19,BUMA.1121.00007,2,1685759,1689401,+,3642
19,BUMA.1121.00097,2,1454012,1457605,+,3593
19,BUMA.1121.00008,2,848143,851768,+,3625
19,BUMA.1121.00059,2,1980431,1984144,-,3713
19,BUMA.1121.00002,2,1681045,1684685,-,3640
19,BUMA.1121.00004,2,848862,852487,+,3625
19,BUMA.1121.00005,2,3059351,3062959,+,3608
19,BUMA.1121.00111,2,946646,950211,+,3565
19,BUMA.1121.00006,2,1221926,1225552,-,3626
19,BUMA.1121.00009,2,272486,276121,+,3635
19,BUMA.1121.00094,2,1649336,1652987,+,3651
19,BUMA.1121.00101,2,1802299,1805975,-,3676
19,BUMA.1121.00066,2,1588349,1591967,+,3618
19,BUMA.1121.00095,2,2965743,2969334,-,3591
19,BUMA.1121.00112,2,2761518,2765252,-,3734
19,BUMA.1121.00042,2,715075,718700,+,3625
19,BUMA.1121.00032,2,1356580,1360205,+,3625
19,BUMA.1121.00090,2,2594455,2598041,+,3586
19,BUMA.1121.00020,2,848884,852509,+,3625
19,BUMA.1121.00089,2,1594510,1598161,+,3651
19,BUMA.1121.00051,2,1607898,1611567,+,3669
19,BUMA.1121.00001,2,591949,595522,-,3573
19,BUMA.1121.00045,2,1501528,1505199,+,3671
19,BUMA.1121.00043,2,685590,689149,-,3559
19,BUMA.1121.00063,2,1602557,1606175,+,3618
19,BUMA.1121.00079,2,1607282,1610947,+,3665
19,BUMA.1121.00071,2,1603843,1607447,+,3604
19,BUMA.1121.00086,2,1180857,1184482,+,3625
19,BUMA.1121.00024,2,983979,987604,+,3625
19,BUMA.1121.00010,2,439850,443490,-,3640
19,BUMA.1121.00040,2,1191101,1194719,+,3618
19,BUMA.1121.00093,2,1321833,1325499,-,3666
19,BUMA.1121.00091,2,2017090,2020752,-,3662
19,BUMA.1121.00107,2,2198120,2201667,-,3547
19,BUMA.1121.00088,2,1618271,1621898,+,3627
19,BUMA.1121.00047,2,2538984,2542677,+,3693
19,BUMA.1121.00019,2,848848,852473,+,3625
19,BUMA.1121.00087,2,1448354,1451979,+,3625
19,BUMA.1121.00039,2,2345608,2349174,-,3566
19,BUMA.1121.00030,2,1254153,1257779,-,3626
19,BUMA.1121.00016,2,2096005,2099584,-,3579
19,BUMA.1121.00092,2,1618851,1622516,+,3665
19,BUMA.1121.00085,2,42265,45883,+,3618
19,BUMA.1121.00046,2,1923933,1927552,-,3619
19,BUMA.1121.00003,2,2301571,2305288,-,3717
19,BUMA.1121.00054,2,1022049,1025675,-,3626
19,BUMA.1121.00015,2,1029903,1033549,+,3646
19,BUMA.1121.00105,2,807694,811367,-,3673
19,BUMA.1121.00052,2,730832,734450,+,3618
19,BUMA.1121.00053,2,1898867,1902530,+,3663
19,BUMA.1121.00057,2,483494,487132,-,3638
19,BUMA.1121.00108,2,1832156,1835753,+,3597
19,BUMA.1121.00050,2,1540125,1543744,-,3619
19,BUMA.1121.00104,2,1698960,1702601,+,3641
19,BUMA.1121.00014,2,1728773,1732347,+,3574
19,BUMA.1121.00036,2,432660,436299,+,3639
19,BUMA.1121.00038,2,1123086,1126712,-,3626
19,BUMA.1121.00098,2,1875555,1879233,+,3678
19,BUMA.1121.00078,2,1531285,1534962,-,3677
19,BUMA.1121.00029,2,2969021,2972594,-,3573
19,BUMA.1121.00099,2,1864637,1868276,+,3639
19,BUMA.1121.00103,2,159351,163020,+,3669
19,BUMA.1121.00102,2,1660059,1663710,+,3651
19,BUMA.1121.00028,2,890114,893739,+,3625
19,BUMA.1121.00075,2,1937752,1941410,+,3658
19,BUMA.1121.00044,2,915120,918745,+,3625
19,BUMA.1121.00076,2,2568365,2572030,+,3665
19,BUMA.1121.00074,2,2753727,2757419,-,3692
19,BUMA.1121.00073,2,1603675,1607289,+,3614
19,BUMA.1121.00083,2,271425,275043,+,3618
19,BUMA.1121.00035,2,2987578,2991151,-,3573
19,BUMA.1121.00072,2,1578940,1582558,+,3618
19,BUMA.1121.00056,2,2395886,2399538,-,3652
19,BUMA.1121.00081,2,1097979,1101604,+,3625
19,BUMA.1121.00033,2,2403336,2406914,+,3578
19,BUMA.1121.00061,2,1591322,1594933,+,3611
19,BUMA.1121.00062,2,69360,73025,-,3665
19,BUMA.1121.00064,2,1523736,1527441,+,3705
19,BUMA.1121.00060,2,744648,748320,-,3672
19,BUMA.1121.00069,2,1576332,1579945,+,3613
19,BUMA.1121.00070,2,1583292,1586906,+,3614
19,BUMA.1121.00068,2,192822,196483,+,3661
19,BUMA.1121.00067,2,2368001,2371693,-,3692
19,BUMA.1121.00037,2,1966568,1970135,+,3567
19,BUMA.1121.00065,2,1652371,1655962,+,3591
19,BUMA.1121.00058,2,2223220,2226936,+,3716
19,BUMA.1121.00041,2,2566685,2570396,+,3711
19,BUMA.1121.00084,2,321756,325383,+,3627
19,BUMA.1121.00096,2,1820603,1824238,+,3635
19,BUMA.1121.00080,2,1609126,1612770,+,3644
19,BUMA.1121.00013,2,1443548,1447166,+,3618
19,BUMA.1121.00100,2,2750109,2753729,+,3620
19,BUMA.1121.00012,2,52382,55948,-,3566
19,BUMA.1121.00018,2,2189784,2193350,-,3566
19,BUMA.1121.00048,2,1837351,1840976,+,3625
19,BUMA.1121.00106,2,137223,140837,-,3614
19,BUMA.1121.00017,2,863980,867605,+,3625
19,BUMA.1121.00082,2,1647541,1651159,+,3618
20,BUMA.1121.00049,2,272879,284520,+,11641
20,BUMA.1121.00055,2,1043170,1054754,-,11584
20,BUMA.1121.00011,2,239493,251115,+,11622
20,BUMA.1121.00110,2,783839,795485,-,11646
20,BUMA.1121.00109,2,3043918,3055650,-,11732
20,BUMA.1121.00077,2,2077464,2089110,-,11646
20,BUMA.1121.00027,2,2667470,2679039,+,11569
20,BUMA.1121.00026,2,1481520,1493090,-,11570
20,BUMA.1121.00021,2,2138587,2150283,+,11696
20,BUMA.1121.00023,2,1759112,1770708,+,11596
20,BUMA.1121.00022,2,377664,389226,+,11562
20,BUMA.1121.00034,2,868261,879888,+,11627
20,BUMA.1121.00025,2,2511458,2523073,-,11615
20,BUMA.1121.00031,2,806078,817673,+,11595
20,BUMA.1121.00007,2,1690029,1701686,+,11657
20,BUMA.1121.00097,2,1458233,1469833,+,11600
20,BUMA.1121.00008,2,852396,864009,+,11613
20,BUMA.1121.00059,2,1968195,1979804,-,11609
20,BUMA.1121.00002,2,1668840,1680418,-,11578
20,BUMA.1121.00004,2,853115,864742,+,11627
20,BUMA.1121.00005,2,3063587,3075165,+,11578
20,BUMA.1121.00111,2,950839,962434,+,11595
20,BUMA.1121.00006,2,1209687,1221299,-,11612
20,BUMA.1121.00009,2,276749,288350,+,11601
20,BUMA.1121.00094,2,1660305,1671928,+,11623
20,BUMA.1121.00101,2,1790063,1801666,-,11603
20,BUMA.1121.00066,2,1592595,1604211,+,11616
20,BUMA.1121.00095,2,2953444,2965116,-,11672
20,BUMA.1121.00112,2,2749246,2760874,-,11628
20,BUMA.1121.00042,2,719328,730939,+,11611
20,BUMA.1121.00032,2,1360833,1372439,+,11606
20,BUMA.1121.00090,2,2598669,2610296,+,11627
20,BUMA.1121.00020,2,853137,864757,+,11620
20,BUMA.1121.00089,2,1605479,1617095,+,11616
20,BUMA.1121.00051,2,1618885,1630501,+,11616
20,BUMA.1121.00001,2,573096,584702,-,11606
20,BUMA.1121.00045,2,1505827,1517443,+,11616
20,BUMA.1121.00043,2,673341,684963,-,11622
20,BUMA.1121.00063,2,1606803,1618419,+,11616
20,BUMA.1121.00079,2,1618265,1629921,+,11656
20,BUMA.1121.00071,2,1608075,1619691,+,11616
20,BUMA.1121.00086,2,1185110,1196693,+,11583
20,BUMA.1121.00024,2,988232,999852,+,11620
20,BUMA.1121.00010,2,427645,439223,-,11578
20,BUMA.1121.00040,2,1195347,1206963,+,11616
20,BUMA.1121.00093,2,1309616,1321206,-,11590
20,BUMA.1121.00091,2,2004858,2016463,-,11605
20,BUMA.1121.00107,2,2185881,2197497,-,11616
20,BUMA.1121.00088,2,1629216,1640822,+,11606
20,BUMA.1121.00047,2,2550009,2561688,+,11679
20,BUMA.1121.00019,2,853101,864721,+,11620
20,BUMA.1121.00087,2,1452607,1464190,+,11583
20,BUMA.1121.00039,2,2333216,2344981,-,11765
20,BUMA.1121.00030,2,1241906,1253526,-,11620
20,BUMA.1121.00016,2,2083752,2095378,-,11626
20,BUMA.1121.00092,2,1623144,1634734,+,11590
20,BUMA.1121.00085,2,46511,58102,+,11591
20,BUMA.1121.00046,2,1911750,1923306,-,11556
20,BUMA.1121.00003,2,2282574,2294240,-,11666
20,BUMA.1121.00054,2,1009810,1021422,-,11612
20,BUMA.1121.00015,2,1034177,1045775,+,11598
20,BUMA.1121.00105,2,795453,807067,-,11614
20,BUMA.1121.00052,2,735078,746669,+,11591
20,BUMA.1121.00053,2,1903158,1914748,+,11590
20,BUMA.1121.00057,2,471245,482867,-,11622
20,BUMA.1121.00108,2,1843064,1854698,+,11634
20,BUMA.1121.00050,2,1527942,1539498,-,11556
20,BUMA.1121.00104,2,1709926,1721586,+,11660
20,BUMA.1121.00014,2,1739710,1751291,+,11581
20,BUMA.1121.00036,2,436927,448525,+,11598
20,BUMA.1121.00038,2,1110847,1122459,-,11612
20,BUMA.1121.00098,2,1879861,1891474,+,11613
20,BUMA.1121.00078,2,1519026,1530658,-,11632
20,BUMA.1121.00029,2,2950137,2961774,-,11637
20,BUMA.1121.00099,2,1868904,1880510,+,11606
20,BUMA.1121.00103,2,163648,175297,+,11649
20,BUMA.1121.00102,2,1664338,1676100,+,11762
20,BUMA.1121.00028,2,894367,905987,+,11620
20,BUMA.1121.00075,2,1942038,1953666,+,11628
20,BUMA.1121.00044,2,919373,930993,+,11620
20,BUMA.1121.00076,2,2572658,2584356,+,11698
20,BUMA.1121.00074,2,2741540,2753100,-,11560
20,BUMA.1121.00073,2,1607917,1619533,+,11616
20,BUMA.1121.00083,2,275671,287293,+,11622
20,BUMA.1121.00035,2,2968744,2980331,-,11587
20,BUMA.1121.00072,2,1583186,1594798,+,11612
20,BUMA.1121.00056,2,2376953,2388569,-,11616
20,BUMA.1121.00081,2,1102232,1113844,+,11612
20,BUMA.1121.00033,2,2407542,2419238,+,11696
20,BUMA.1121.00061,2,1595561,1607177,+,11616
20,BUMA.1121.00062,2,57159,68733,-,11574
20,BUMA.1121.00064,2,1528069,1539677,+,11608
20,BUMA.1121.00060,2,732405,744021,-,11616
20,BUMA.1121.00069,2,1580573,1592189,+,11616
20,BUMA.1121.00070,2,1587534,1599150,+,11616
20,BUMA.1121.00068,2,197111,207824,+,10713
20,BUMA.1121.00067,2,2355786,2367374,-,11588
20,BUMA.1121.00037,2,1977511,1989095,+,11584
20,BUMA.1121.00065,2,1656585,1668221,+,11636
20,BUMA.1121.00058,2,2234261,2245913,+,11652
20,BUMA.1121.00041,2,2571024,2582662,+,11638
20,BUMA.1121.00084,2,332694,344304,+,11610
20,BUMA.1121.00096,2,1824866,1836487,+,11621
20,BUMA.1121.00080,2,1620088,1631690,+,11602
20,BUMA.1121.00013,2,1447794,1459371,+,11577
20,BUMA.1121.00100,2,2754357,2765982,+,11625
20,BUMA.1121.00012,2,40142,51755,-,11613
20,BUMA.1121.00018,2,2177536,2189157,-,11621
20,BUMA.1121.00048,2,1841604,1853216,+,11612
20,BUMA.1121.00106,2,118312,129913,-,11601
20,BUMA.1121.00017,2,868233,879867,+,11634
20,BUMA.1121.00082,2,1651787,1663403,+,11616
21,BUMA.1121.00049,2,285478,297252,+,11774
21,BUMA.1121.00055,2,1030382,1042274,-,11892
21,BUMA.1121.00011,2,252058,263901,+,11843
21,BUMA.1121.00110,2,771023,782911,-,11888
21,BUMA.1121.00109,2,3029654,3041544,-,11890
21,BUMA.1121.00077,2,2064648,2076536,-,11888
21,BUMA.1121.00027,2,2679980,2691803,+,11823
21,BUMA.1121.00026,2,1468822,1480592,-,11770
21,BUMA.1121.00021,2,2151192,2163051,+,11859
21,BUMA.1121.00023,2,1771617,1783471,+,11854
21,BUMA.1121.00022,2,390154,401943,+,11789
21,BUMA.1121.00034,2,880816,892595,+,11779
21,BUMA.1121.00025,2,2498700,2510549,-,11849
21,BUMA.1121.00031,2,818582,830428,+,11846
21,BUMA.1121.00007,2,1702615,1714563,+,11948
21,BUMA.1121.00097,2,1470761,1482614,+,11853
21,BUMA.1121.00008,2,864937,876716,+,11779
21,BUMA.1121.00059,2,1955315,1967252,-,11937
21,BUMA.1121.00002,2,1656116,1667912,-,11796
21,BUMA.1121.00004,2,865670,877449,+,11779
21,BUMA.1121.00005,2,3076092,3088002,+,11910
21,BUMA.1121.00111,2,963343,975206,+,11863
21,BUMA.1121.00006,2,1196922,1208759,-,11837
21,BUMA.1121.00009,2,289285,301166,+,11881
21,BUMA.1121.00094,2,1672871,1684708,+,11837
21,BUMA.1121.00101,2,1777206,1789116,-,11910
21,BUMA.1121.00066,2,1605154,1617012,+,11858
21,BUMA.1121.00095,2,2940698,2952531,-,11833
21,BUMA.1121.00112,2,2736477,2748292,-,11815
21,BUMA.1121.00042,2,731867,743637,+,11770
21,BUMA.1121.00032,2,1373367,1385146,+,11779
21,BUMA.1121.00090,2,2611205,2623058,+,11853
21,BUMA.1121.00020,2,865685,877464,+,11779
21,BUMA.1121.00089,2,1618038,1629875,+,11837
21,BUMA.1121.00051,2,1631444,1643279,+,11835
21,BUMA.1121.00001,2,560245,572152,-,11907
21,BUMA.1121.00045,2,1518370,1530189,+,11819
21,BUMA.1121.00043,2,660535,672432,-,11897
21,BUMA.1121.00063,2,1619362,1631214,+,11852
21,BUMA.1121.00079,2,1630864,1642697,+,11833
21,BUMA.1121.00071,2,1620634,1632486,+,11852
21,BUMA.1121.00086,2,1197621,1209410,+,11789
21,BUMA.1121.00024,2,1000780,1012559,+,11779
21,BUMA.1121.00010,2,414921,426717,-,11796
21,BUMA.1121.00040,2,1207891,1219653,+,11762
21,BUMA.1121.00093,2,1296789,1308689,-,11900
21,BUMA.1121.00091,2,1992047,2003931,-,11884
21,BUMA.1121.00107,2,2173047,2184953,-,11906
21,BUMA.1121.00088,2,1641754,1653616,+,11862
21,BUMA.1121.00047,2,2562631,2574468,+,11837
21,BUMA.1121.00019,2,865649,877428,+,11779
21,BUMA.1121.00087,2,1465118,1476907,+,11789
21,BUMA.1121.00039,2,2320453,2332307,-,11854
21,BUMA.1121.00030,2,1229191,1240978,-,11787
21,BUMA.1121.00016,2,2071003,2082843,-,11840
21,BUMA.1121.00092,2,1635661,1647561,+,11900
21,BUMA.1121.00085,2,59030,70595,+,11565
21,BUMA.1121.00046,2,1898993,1910822,-,11829
21,BUMA.1121.00003,2,2269775,2281662,-,11887
21,BUMA.1121.00054,2,997045,1008882,-,11837
21,BUMA.1121.00015,2,1046703,1058560,+,11857
21,BUMA.1121.00105,2,782696,794526,-,11830
21,BUMA.1121.00052,2,747597,759162,+,11565
21,BUMA.1121.00053,2,1915675,1927571,+,11896
21,BUMA.1121.00057,2,458383,470318,-,11935
21,BUMA.1121.00108,2,1855636,1867494,+,11858
21,BUMA.1121.00050,2,1515185,1527014,-,11829
21,BUMA.1121.00104,2,1722529,1734358,+,11829
21,BUMA.1121.00014,2,1752200,1764046,+,11846
21,BUMA.1121.00036,2,449453,461242,+,11789
21,BUMA.1121.00038,2,1098082,1109919,-,11837
21,BUMA.1121.00098,2,1892424,1904307,+,11883
21,BUMA.1121.00078,2,1506219,1518082,-,11863
21,BUMA.1121.00029,2,2937309,2949193,-,11884
21,BUMA.1121.00099,2,1881438,1893336,+,11898
21,BUMA.1121.00103,2,177491,189284,+,11793
21,BUMA.1121.00102,2,1677012,1688935,+,11923
21,BUMA.1121.00028,2,906915,918694,+,11779
21,BUMA.1121.00075,2,1954609,1966497,+,11888
21,BUMA.1121.00044,2,931921,943700,+,11779
21,BUMA.1121.00076,2,2585299,2597189,+,11890
21,BUMA.1121.00074,2,2728760,2740597,-,11837
21,BUMA.1121.00073,2,1620476,1632331,+,11855
21,BUMA.1121.00083,2,288236,300102,+,11866
21,BUMA.1121.00035,2,2955880,2967800,-,11920
21,BUMA.1121.00072,2,1595741,1607586,+,11845
21,BUMA.1121.00056,2,2364165,2376010,-,11845
21,BUMA.1121.00081,2,1114772,1126593,+,11821
21,BUMA.1121.00033,2,2420147,2432018,+,11871
21,BUMA.1121.00061,2,1608120,1619974,+,11854
21,BUMA.1121.00062,2,44318,56216,-,11898
21,BUMA.1121.00064,2,1540620,1552458,+,11838
21,BUMA.1121.00060,2,719659,731478,-,11819
21,BUMA.1121.00069,2,1593132,1604955,+,11823
21,BUMA.1121.00070,2,1600093,1611945,+,11852
21,BUMA.1121.00068,2,208751,220702,+,11951
21,BUMA.1121.00067,2,2343005,2354843,-,11838
21,BUMA.1121.00037,2,1989989,2001835,+,11846
21,BUMA.1121.00065,2,1669164,1681018,+,11854
21,BUMA.1121.00058,2,2246845,2258691,+,11846
21,BUMA.1121.00041,2,2583571,2595424,+,11853
21,BUMA.1121.00084,2,345226,357064,+,11838
21,BUMA.1121.00096,2,1837416,1849280,+,11864
21,BUMA.1121.00080,2,1632633,1644469,+,11836
21,BUMA.1121.00013,2,1460299,1471864,+,11565
21,BUMA.1121.00100,2,2766895,2778692,+,11797
21,BUMA.1121.00012,2,27375,39222,-,11847
21,BUMA.1121.00018,2,2164778,2176627,-,11849
21,BUMA.1121.00048,2,1854144,1865965,+,11821
21,BUMA.1121.00106,2,105487,117369,-,11882
21,BUMA.1121.00017,2,880795,892574,+,11779
21,BUMA.1121.00082,2,1664346,1676212,+,11866
22,BUMA.1121.00049,2,297569,310873,+,13304
22,BUMA.1121.00055,2,1016779,1030094,-,13315
22,BUMA.1121.00011,2,264261,277535,+,13274
22,BUMA.1121.00110,2,757553,770689,-,13136
22,BUMA.1121.00109,2,3016222,3029456,-,13234
22,BUMA.1121.00077,2,2051178,2064314,-,13136
22,BUMA.1121.00027,2,2692145,2705425,+,13280
22,BUMA.1121.00026,2,1455213,1468537,-,13324
22,BUMA.1121.00021,2,2163393,2176672,+,13279
22,BUMA.1121.00023,2,1783768,1797100,+,13332
22,BUMA.1121.00022,2,402236,415560,+,13324
22,BUMA.1121.00034,2,892888,906212,+,13324
22,BUMA.1121.00025,2,2485103,2498381,-,13278
22,BUMA.1121.00031,2,830797,844092,+,13295
22,BUMA.1121.00007,2,1714934,1728200,+,13266
22,BUMA.1121.00097,2,1482907,1496192,+,13285
22,BUMA.1121.00008,2,877009,890333,+,13324
22,BUMA.1121.00059,2,1941689,1955014,-,13325
22,BUMA.1121.00002,2,1642507,1655831,-,13324
22,BUMA.1121.00004,2,877742,891066,+,13324
22,BUMA.1121.00005,2,3088295,3101610,+,13315
22,BUMA.1121.00111,2,975556,988847,+,13291
22,BUMA.1121.00006,2,1183313,1196637,-,13324
22,BUMA.1121.00009,2,301478,314772,+,13294
22,BUMA.1121.00094,2,1685029,1698300,+,13271
22,BUMA.1121.00101,2,1763599,1776899,-,13300
22,BUMA.1121.00066,2,1617309,1630625,+,13316
22,BUMA.1121.00095,2,2926828,2940348,-,13520
22,BUMA.1121.00112,2,2722879,2736159,-,13280
22,BUMA.1121.00042,2,743930,757254,+,13324
22,BUMA.1121.00032,2,1385439,1398763,+,13324
22,BUMA.1121.00090,2,2642614,2655831,+,13217
22,BUMA.1121.00020,2,877757,891081,+,13324
22,BUMA.1121.00089,2,1630196,1643478,+,13282
22,BUMA.1121.00051,2,1643599,1656879,+,13280
22,BUMA.1121.00001,2,546641,559903,-,13262
22,BUMA.1121.00045,2,1530231,1543512,+,13281
22,BUMA.1121.00043,2,646846,660126,-,13280
22,BUMA.1121.00063,2,1631511,1644814,+,13303
22,BUMA.1121.00079,2,1643009,1656334,+,13325
22,BUMA.1121.00071,2,1632783,1646116,+,13333
22,BUMA.1121.00086,2,1209703,1223027,+,13324
22,BUMA.1121.00024,2,1012852,1026176,+,13324
22,BUMA.1121.00010,2,401312,414636,-,13324
22,BUMA.1121.00040,2,1219938,1233270,+,13332
22,BUMA.1121.00093,2,1283177,1296493,-,13316
22,BUMA.1121.00091,2,1978480,1991754,-,13274
22,BUMA.1121.00107,2,2159446,2172665,-,13219
22,BUMA.1121.00088,2,1653941,1667250,+,13309
22,BUMA.1121.00047,2,2574773,2588055,+,13282
22,BUMA.1121.00019,2,877721,891045,+,13324
22,BUMA.1121.00087,2,1477200,1490524,+,13324
22,BUMA.1121.00039,2,2306824,2320111,-,13287
22,BUMA.1121.00030,2,1215582,1228906,-,13324
22,BUMA.1121.00016,2,2057290,2070615,-,13325
22,BUMA.1121.00092,2,1647857,1661173,+,13316
22,BUMA.1121.00085,2,70888,84220,+,13332
22,BUMA.1121.00046,2,1885376,1898708,-,13332
22,BUMA.1121.00003,2,2256171,2269481,-,13310
22,BUMA.1121.00054,2,983436,996760,-,13324
22,BUMA.1121.00015,2,1058869,1072201,+,13332
22,BUMA.1121.00105,2,769095,782407,-,13312
22,BUMA.1121.00052,2,759455,772787,+,13332
22,BUMA.1121.00053,2,1927872,1941170,+,13298
22,BUMA.1121.00057,2,444776,458082,-,13306
22,BUMA.1121.00108,2,1867819,1881151,+,13332
22,BUMA.1121.00050,2,1501568,1514900,-,13332
22,BUMA.1121.00104,2,1734737,1747990,+,13253
22,BUMA.1121.00014,2,1764415,1777710,+,13295
22,BUMA.1121.00036,2,461535,474859,+,13324
22,BUMA.1121.00038,2,1084473,1097797,-,13324
22,BUMA.1121.00098,2,1904593,1917904,+,13311
22,BUMA.1121.00078,2,1492604,1505882,-,13278
22,BUMA.1121.00029,2,2923705,2936967,-,13262
22,BUMA.1121.00099,2,1893617,1906927,+,13310
22,BUMA.1121.00103,2,189649,202868,+,13219
22,BUMA.1121.00102,2,1689244,1702516,+,13272
22,BUMA.1121.00028,2,918987,932311,+,13324
22,BUMA.1121.00075,2,1966847,1980066,+,13219
22,BUMA.1121.00044,2,943993,957317,+,13324
22,BUMA.1121.00076,2,2597539,2610764,+,13225
22,BUMA.1121.00074,2,2715235,2728426,-,13191
22,BUMA.1121.00073,2,1632628,1645953,+,13325
22,BUMA.1121.00083,2,300452,313746,+,13294
22,BUMA.1121.00035,2,2942276,2955538,-,13262
22,BUMA.1121.00072,2,1607883,1621230,+,13347
22,BUMA.1121.00056,2,2350570,2363852,-,13282
22,BUMA.1121.00081,2,1126894,1140218,+,13324
22,BUMA.1121.00033,2,2432382,2445714,+,13332
22,BUMA.1121.00061,2,1620271,1633618,+,13347
22,BUMA.1121.00062,2,30700,44022,-,13322
22,BUMA.1121.00064,2,1552808,1566080,+,13272
22,BUMA.1121.00060,2,706336,719617,-,13281
22,BUMA.1121.00069,2,1605252,1618578,+,13326
22,BUMA.1121.00070,2,1612242,1625567,+,13325
22,BUMA.1121.00068,2,220988,234303,+,13315
22,BUMA.1121.00067,2,2329414,2342671,-,13257
22,BUMA.1121.00037,2,2002180,2015459,+,13279
22,BUMA.1121.00065,2,1681360,1694647,+,13287
22,BUMA.1121.00058,2,2259049,2272350,+,13301
22,BUMA.1121.00041,2,2595757,2609015,+,13258
22,BUMA.1121.00084,2,357430,370640,+,13210
22,BUMA.1121.00096,2,1849566,1862845,+,13279
22,BUMA.1121.00080,2,1644790,1658072,+,13282
22,BUMA.1121.00013,2,1472157,1485489,+,13332
22,BUMA.1121.00100,2,2779050,2792329,+,13279
22,BUMA.1121.00012,2,14055,27067,-,13012
22,BUMA.1121.00018,2,2151188,2164467,-,13279
22,BUMA.1121.00048,2,1866266,1879590,+,13324
22,BUMA.1121.00106,2,91855,105129,-,13274
22,BUMA.1121.00017,2,892867,906191,+,13324
22,BUMA.1121.00082,2,1676562,1689856,+,13294
23,BUMA.1121.00049,2,315297,318407,+,3110
23,BUMA.1121.00055,2,1012228,1015339,-,3111
23,BUMA.1121.00011,2,278977,282097,+,3120
23,BUMA.1121.00110,2,753018,756129,-,3111
23,BUMA.1121.00109,2,3011671,3014782,-,3111
23,BUMA.1121.00077,2,2046643,2049754,-,3111
23,BUMA.1121.00027,2,2706865,2709985,+,3120
23,BUMA.1121.00026,2,1450677,1453797,-,3120
23,BUMA.1121.00021,2,2178088,2181202,+,3114
23,BUMA.1121.00023,2,1798524,1801638,+,3114
23,BUMA.1121.00022,2,416976,420096,+,3120
23,BUMA.1121.00034,2,907628,910748,+,3120
23,BUMA.1121.00025,2,2480590,2483695,-,3105
23,BUMA.1121.00031,2,845500,848614,+,3114
23,BUMA.1121.00007,2,1729574,1732694,+,3120
23,BUMA.1121.00097,2,1497600,1500720,+,3120
23,BUMA.1121.00008,2,891749,894869,+,3120
23,BUMA.1121.00059,2,1937159,1940273,-,3114
23,BUMA.1121.00002,2,1637971,1641091,-,3120
23,BUMA.1121.00004,2,892482,895602,+,3120
23,BUMA.1121.00005,2,3103034,3106159,+,3125
23,BUMA.1121.00111,2,990272,993386,+,3114
23,BUMA.1121.00006,2,1178777,1181897,-,3120
23,BUMA.1121.00009,2,319196,322312,+,3116
23,BUMA.1121.00094,2,1699748,1702859,+,3111
23,BUMA.1121.00101,2,1759051,1762165,-,3114
23,BUMA.1121.00066,2,1632065,1635176,+,3111
23,BUMA.1121.00095,2,2922310,2925421,-,3111
23,BUMA.1121.00112,2,2715335,2718445,-,3110
23,BUMA.1121.00042,2,758670,761790,+,3120
23,BUMA.1121.00032,2,1400179,1403299,+,3120
23,BUMA.1121.00090,2,2657247,2660361,+,3114
23,BUMA.1121.00020,2,892497,895617,+,3120
23,BUMA.1121.00089,2,1644926,1648037,+,3111
23,BUMA.1121.00051,2,1658327,1661438,+,3111
23,BUMA.1121.00001,2,542127,545247,-,3120
23,BUMA.1121.00045,2,1544946,1548077,+,3131
23,BUMA.1121.00043,2,642324,645438,-,3114
23,BUMA.1121.00063,2,1646150,1649261,+,3111
23,BUMA.1121.00079,2,1657782,1660902,+,3120
23,BUMA.1121.00071,2,1647556,1650667,+,3111
23,BUMA.1121.00086,2,1224443,1227563,+,3120
23,BUMA.1121.00024,2,1027592,1030712,+,3120
23,BUMA.1121.00010,2,396776,399896,-,3120
23,BUMA.1121.00040,2,1234686,1237806,+,3120
23,BUMA.1121.00093,2,1278649,1281769,-,3120
23,BUMA.1121.00091,2,1973948,1977056,-,3108
23,BUMA.1121.00107,2,2151906,2155022,-,3116
23,BUMA.1121.00088,2,1668706,1671826,+,3120
23,BUMA.1121.00047,2,2589503,2592614,+,3111
23,BUMA.1121.00019,2,892461,895581,+,3120
23,BUMA.1121.00087,2,1491940,1495060,+,3120
23,BUMA.1121.00039,2,2302302,2305416,-,3114
23,BUMA.1121.00030,2,1211046,1214166,-,3120
23,BUMA.1121.00016,2,2052760,2055874,-,3114
23,BUMA.1121.00092,2,1662581,1665701,+,3120
23,BUMA.1121.00085,2,85636,88756,+,3120
23,BUMA.1121.00046,2,1880840,1883960,-,3120
23,BUMA.1121.00003,2,2251619,2254730,-,3111
23,BUMA.1121.00054,2,978900,982020,-,3120
23,BUMA.1121.00015,2,1073617,1076737,+,3120
23,BUMA.1121.00105,2,764539,767647,-,3108
23,BUMA.1121.00052,2,774203,777323,+,3120
23,BUMA.1121.00053,2,1945594,1948710,+,3116
23,BUMA.1121.00057,2,440200,443320,-,3120
23,BUMA.1121.00108,2,1882587,1885706,+,3119
23,BUMA.1121.00050,2,1497032,1500152,-,3120
23,BUMA.1121.00104,2,1749502,1752622,+,3120
23,BUMA.1121.00014,2,1779118,1782232,+,3114
23,BUMA.1121.00036,2,476275,479395,+,3120
23,BUMA.1121.00038,2,1079937,1083057,-,3120
23,BUMA.1121.00098,2,1919248,1922379,+,3131
23,BUMA.1121.00078,2,1488165,1491284,-,3119
23,BUMA.1121.00029,2,2919191,2922311,-,3120
23,BUMA.1121.00099,2,1908359,1911494,+,3135
23,BUMA.1121.00103,2,204242,207378,+,3136
23,BUMA.1121.00102,2,1706939,1710055,+,3116
23,BUMA.1121.00028,2,933727,936847,+,3120
23,BUMA.1121.00075,2,1981378,1984498,+,3120
23,BUMA.1121.00044,2,958733,961853,+,3120
23,BUMA.1121.00076,2,2612076,2615196,+,3120
23,BUMA.1121.00074,2,2710691,2713811,-,3120
23,BUMA.1121.00073,2,1647393,1650504,+,3111
23,BUMA.1121.00083,2,315186,318297,+,3111
23,BUMA.1121.00035,2,2937762,2940882,-,3120
23,BUMA.1121.00072,2,1622670,1625781,+,3111
23,BUMA.1121.00056,2,2346011,2349122,-,3111
23,BUMA.1121.00081,2,1141634,1144754,+,3120
23,BUMA.1121.00033,2,2447138,2450252,+,3114
23,BUMA.1121.00061,2,1635058,1638169,+,3111
23,BUMA.1121.00062,2,26144,29252,-,3108
23,BUMA.1121.00064,2,1567544,1570664,+,3120
23,BUMA.1121.00060,2,701771,704902,-,3131
23,BUMA.1121.00069,2,1620018,1623129,+,3111
23,BUMA.1121.00070,2,1627007,1630118,+,3111
23,BUMA.1121.00068,2,235728,238848,+,3120
23,BUMA.1121.00067,2,2324870,2327990,-,3120
23,BUMA.1121.00037,2,2016867,2019981,+,3114
23,BUMA.1121.00065,2,1696072,1699186,+,3114
23,BUMA.1121.00058,2,2273782,2276902,+,3120
23,BUMA.1121.00041,2,2613439,2616549,+,3110
23,BUMA.1121.00084,2,372104,375224,+,3120
23,BUMA.1121.00096,2,1867269,1870385,+,3116
23,BUMA.1121.00080,2,1659520,1662631,+,3111
23,BUMA.1121.00013,2,1486905,1490025,+,3120
23,BUMA.1121.00100,2,2793714,2796828,+,3114
23,BUMA.1121.00012,2,9507,12621,-,3114
23,BUMA.1121.00018,2,2146675,2149780,-,3105
23,BUMA.1121.00048,2,1881006,1884126,+,3120
23,BUMA.1121.00106,2,87319,90439,-,3120
23,BUMA.1121.00017,2,907607,910727,+,3120
23,BUMA.1121.00082,2,1691296,1694407,+,3111
24,BUMA.1121.00049,2,322920,327907,+,4987
24,BUMA.1121.00055,2,1002755,1007714,-,4959
24,BUMA.1121.00011,2,286610,291549,+,4939
24,BUMA.1121.00110,2,743585,748504,-,4919
24,BUMA.1121.00109,2,3002214,3007157,-,4943
24,BUMA.1121.00077,2,2037211,2042130,-,4919
24,BUMA.1121.00027,2,2714498,2719427,+,4929
24,BUMA.1121.00026,2,1441251,1446171,-,4920
24,BUMA.1121.00021,2,2185715,2190645,+,4930
24,BUMA.1121.00023,2,1806130,1811059,+,4929
24,BUMA.1121.00022,2,424601,429522,+,4921
24,BUMA.1121.00034,2,915253,920174,+,4921
24,BUMA.1121.00025,2,2471138,2476067,-,4929
24,BUMA.1121.00031,2,853127,858057,+,4930
24,BUMA.1121.00007,2,1737207,1742214,+,5007
24,BUMA.1121.00097,2,1505233,1510159,+,4926
24,BUMA.1121.00008,2,899374,904295,+,4921
24,BUMA.1121.00059,2,1927620,1932645,-,5025
24,BUMA.1121.00002,2,1628545,1633465,-,4920
24,BUMA.1121.00004,2,900107,905028,+,4921
24,BUMA.1121.00005,2,3110672,3115714,+,5042
24,BUMA.1121.00111,2,997899,1002833,+,4934
24,BUMA.1121.00006,2,1169351,1174271,-,4920
24,BUMA.1121.00009,2,326825,331886,+,5061
24,BUMA.1121.00094,2,1707372,1712405,+,5033
24,BUMA.1121.00101,2,1749607,1754537,-,4930
24,BUMA.1121.00066,2,1639689,1644622,+,4933
24,BUMA.1121.00095,2,2912796,2917796,-,5000
24,BUMA.1121.00112,2,2705768,2710821,-,5053
24,BUMA.1121.00042,2,766295,771216,+,4921
24,BUMA.1121.00032,2,1407804,1412725,+,4921
24,BUMA.1121.00090,2,2664874,2669813,+,4939
24,BUMA.1121.00020,2,900122,905043,+,4921
24,BUMA.1121.00089,2,1652550,1657583,+,5033
24,BUMA.1121.00051,2,1665951,1671014,+,5063
24,BUMA.1121.00001,2,532684,537613,-,4929
24,BUMA.1121.00045,2,1552590,1557595,+,5005
24,BUMA.1121.00043,2,632882,637810,-,4928
24,BUMA.1121.00063,2,1653774,1658697,+,4923
24,BUMA.1121.00079,2,1665415,1670366,+,4951
24,BUMA.1121.00071,2,1655180,1660113,+,4933
24,BUMA.1121.00086,2,1232068,1236989,+,4921
24,BUMA.1121.00024,2,1035217,1040138,+,4921
24,BUMA.1121.00010,2,387350,392270,-,4920
24,BUMA.1121.00040,2,1242311,1247232,+,4921
24,BUMA.1121.00093,2,1269135,1274135,-,5000
24,BUMA.1121.00091,2,1964414,1969434,-,5020
24,BUMA.1121.00107,2,2142473,2147392,-,4919
24,BUMA.1121.00088,2,1676339,1681293,+,4954
24,BUMA.1121.00047,2,2597127,2602119,+,4992
24,BUMA.1121.00019,2,900086,905007,+,4921
24,BUMA.1121.00087,2,1499565,1504486,+,4921
24,BUMA.1121.00039,2,2292859,2297788,-,4929
24,BUMA.1121.00030,2,1201620,1206540,-,4920
24,BUMA.1121.00016,2,2043315,2048246,-,4931
24,BUMA.1121.00092,2,1670214,1675215,+,5001
24,BUMA.1121.00085,2,93261,98182,+,4921
24,BUMA.1121.00046,2,1871414,1876334,-,4920
24,BUMA.1121.00003,2,2242173,2247106,-,4933
24,BUMA.1121.00054,2,969474,974394,-,4920
24,BUMA.1121.00015,2,1081242,1086163,+,4921
24,BUMA.1121.00105,2,755074,760025,-,4951
24,BUMA.1121.00052,2,781828,786749,+,4921
24,BUMA.1121.00053,2,1953223,1958184,+,4961
24,BUMA.1121.00057,2,430757,435686,-,4929
24,BUMA.1121.00108,2,1890220,1895200,+,4980
24,BUMA.1121.00050,2,1487606,1492526,-,4920
24,BUMA.1121.00104,2,1757135,1762147,+,5012
24,BUMA.1121.00014,2,1786745,1791674,+,4929
24,BUMA.1121.00036,2,483900,488821,+,4921
24,BUMA.1121.00038,2,1070511,1075431,-,4920
24,BUMA.1121.00098,2,1926892,1931821,+,4929
24,BUMA.1121.00078,2,1478571,1483651,-,5080
24,BUMA.1121.00029,2,2909748,2914677,-,4929
24,BUMA.1121.00099,2,1916007,1920959,+,4952
24,BUMA.1121.00103,2,211891,216911,+,5020
24,BUMA.1121.00102,2,1714568,1719489,+,4921
24,BUMA.1121.00028,2,941352,946273,+,4921
24,BUMA.1121.00075,2,1989011,1993961,+,4950
24,BUMA.1121.00044,2,966358,971279,+,4921
24,BUMA.1121.00076,2,2619709,2624661,+,4952
24,BUMA.1121.00074,2,2701226,2706177,-,4951
24,BUMA.1121.00073,2,1655017,1659950,+,4933
24,BUMA.1121.00083,2,322810,327761,+,4951
24,BUMA.1121.00035,2,2928319,2933248,-,4929
24,BUMA.1121.00072,2,1630294,1635245,+,4951
24,BUMA.1121.00056,2,2336465,2341497,-,5032
24,BUMA.1121.00081,2,1149259,1154180,+,4921
24,BUMA.1121.00033,2,2454765,2459695,+,4930
24,BUMA.1121.00061,2,1642682,1647614,+,4932
24,BUMA.1121.00062,2,16679,21630,-,4951
24,BUMA.1121.00064,2,1575177,1580162,+,4985
24,BUMA.1121.00060,2,692273,697257,-,4984
24,BUMA.1121.00069,2,1627642,1632574,+,4932
24,BUMA.1121.00070,2,1634631,1639564,+,4933
24,BUMA.1121.00068,2,243361,248337,+,4976
24,BUMA.1121.00067,2,2315402,2320356,-,4954
24,BUMA.1121.00037,2,2024494,2029433,+,4939
24,BUMA.1121.00065,2,1703699,1708649,+,4950
24,BUMA.1121.00058,2,2281415,2286367,+,4952
24,BUMA.1121.00041,2,2621062,2625995,+,4933
24,BUMA.1121.00084,2,379737,384689,+,4952
24,BUMA.1121.00096,2,1874889,1879804,+,4915
24,BUMA.1121.00080,2,1667144,1672127,+,4983
24,BUMA.1121.00013,2,1494530,1499451,+,4921
24,BUMA.1121.00100,2,2801341,2806416,+,5075
24,BUMA.1121.00012,2,64,4993,-,4929
24,BUMA.1121.00018,2,2137223,2142152,-,4929
24,BUMA.1121.00048,2,1888631,1893552,+,4921
24,BUMA.1121.00106,2,77854,82805,-,4951
24,BUMA.1121.00017,2,915232,920153,+,4921
24,BUMA.1121.00082,2,1698920,1703871,+,4951
25,BUMA.1121.00049,2,328200,344319,+,16119
25,BUMA.1121.00055,2,986259,1002385,-,16126
25,BUMA.1121.00011,2,291653,307507,+,15854
25,BUMA.1121.00110,2,727282,743355,-,16073
25,BUMA.1121.00109,2,2986246,3002040,-,15794
25,BUMA.1121.00077,2,2020875,2036948,-,16073
25,BUMA.1121.00027,2,2719699,2736030,+,16331
25,BUMA.1121.00026,2,1425356,1441098,-,15742
25,BUMA.1121.00021,2,2191176,2207314,+,16138
25,BUMA.1121.00023,2,1811310,1827482,+,16172
25,BUMA.1121.00022,2,429780,446001,+,16221
25,BUMA.1121.00034,2,920327,936543,+,16216
25,BUMA.1121.00025,2,2454742,2470894,-,16152
25,BUMA.1121.00031,2,858322,874415,+,16093
25,BUMA.1121.00007,2,1742416,1758522,+,16106
25,BUMA.1121.00097,2,1510403,1526591,+,16188
25,BUMA.1121.00008,2,904455,920671,+,16216
25,BUMA.1121.00059,2,1911117,1927341,-,16224
25,BUMA.1121.00002,2,1612415,1628392,-,15977
25,BUMA.1121.00004,2,905202,921418,+,16216
25,BUMA.1121.00005,2,3115944,3132108,+,16164
25,BUMA.1121.00111,2,1003147,1018804,+,15657
25,BUMA.1121.00006,2,1153186,1169163,-,15977
25,BUMA.1121.00009,2,332017,348113,+,16096
25,BUMA.1121.00094,2,1712679,1728838,+,16159
25,BUMA.1121.00101,2,1733480,1749363,-,15883
25,BUMA.1121.00066,2,1644814,1660911,+,16097
25,BUMA.1121.00095,2,2896750,2912594,-,15844
25,BUMA.1121.00112,2,2689472,2705482,-,16010
25,BUMA.1121.00042,2,771348,787089,+,15741
25,BUMA.1121.00032,2,1412878,1429094,+,16216
25,BUMA.1121.00090,2,2670141,2686264,+,16123
25,BUMA.1121.00020,2,905196,921412,+,16216
25,BUMA.1121.00089,2,1657855,1673988,+,16133
25,BUMA.1121.00051,2,1671216,1687400,+,16184
25,BUMA.1121.00001,2,516244,532377,-,16133
25,BUMA.1121.00045,2,1558000,1574148,+,16148
25,BUMA.1121.00043,2,616113,632239,-,16126
25,BUMA.1121.00063,2,1658934,1675014,+,16080
25,BUMA.1121.00079,2,1670680,1686685,+,16005
25,BUMA.1121.00071,2,1660346,1676458,+,16112
25,BUMA.1121.00086,2,1237310,1253526,+,16216
25,BUMA.1121.00024,2,1040291,1056507,+,16216
25,BUMA.1121.00010,2,371220,387197,-,15977
25,BUMA.1121.00040,2,1247651,1263880,+,16229
25,BUMA.1121.00093,2,1252769,1268926,-,16157
25,BUMA.1121.00091,2,1948183,1964184,-,16001
25,BUMA.1121.00107,2,2126205,2142257,-,16052
25,BUMA.1121.00088,2,1681684,1697255,+,15571
25,BUMA.1121.00047,2,2602489,2618639,+,16150
25,BUMA.1121.00019,2,905160,921376,+,16216
25,BUMA.1121.00087,2,1504744,1520960,+,16216
25,BUMA.1121.00039,2,2276947,2292496,-,15549
25,BUMA.1121.00030,2,1185250,1201467,-,16217
25,BUMA.1121.00016,2,2026726,2042637,-,15911
25,BUMA.1121.00092,2,1675508,1691664,+,16156
25,BUMA.1121.00085,2,98349,114325,+,15976
25,BUMA.1121.00046,2,1855079,1871296,-,16217
25,BUMA.1121.00003,2,2225824,2241916,-,16092
25,BUMA.1121.00054,2,953302,969279,-,15977
25,BUMA.1121.00015,2,1086281,1102257,+,15976
25,BUMA.1121.00105,2,739303,754893,-,15590
25,BUMA.1121.00052,2,786916,802892,+,15976
25,BUMA.1121.00053,2,1958456,1974552,+,16096
25,BUMA.1121.00057,2,414338,430569,-,16231
25,BUMA.1121.00108,2,1895353,1911243,+,15890
25,BUMA.1121.00050,2,1471271,1487488,-,16217
25,BUMA.1121.00104,2,1762188,1778390,+,16202
25,BUMA.1121.00014,2,1792072,1808200,+,16128
25,BUMA.1121.00036,2,489023,505239,+,16216
25,BUMA.1121.00038,2,1054353,1070330,-,15977
25,BUMA.1121.00098,2,1932310,1947973,+,15663
25,BUMA.1121.00078,2,1462221,1478355,-,16134
25,BUMA.1121.00029,2,2893309,2909553,-,16244
25,BUMA.1121.00099,2,1921280,1937679,+,16399
25,BUMA.1121.00103,2,217281,233379,+,16098
25,BUMA.1121.00102,2,1719852,1736192,+,16340
25,BUMA.1121.00028,2,946426,962642,+,16216
25,BUMA.1121.00075,2,1994205,2010093,+,15888
25,BUMA.1121.00044,2,971432,987648,+,16216
25,BUMA.1121.00076,2,2624919,2640826,+,15907
25,BUMA.1121.00074,2,2684606,2700779,-,16173
25,BUMA.1121.00073,2,1660186,1676283,+,16097
25,BUMA.1121.00083,2,328061,344174,+,16113
25,BUMA.1121.00035,2,2911802,2927881,-,16079
25,BUMA.1121.00072,2,1635482,1651591,+,16109
25,BUMA.1121.00056,2,2320052,2336186,-,16134
25,BUMA.1121.00081,2,1154375,1170351,+,15976
25,BUMA.1121.00033,2,2459988,2476089,+,16101
25,BUMA.1121.00061,2,1647851,1663918,+,16067
25,BUMA.1121.00062,2,429,16260,-,15831
25,BUMA.1121.00064,2,1580448,1596508,+,16060
25,BUMA.1121.00060,2,675791,691945,-,16154
25,BUMA.1121.00069,2,1632807,1648873,+,16066
25,BUMA.1121.00070,2,1639765,1655863,+,16098
25,BUMA.1121.00068,2,248628,264723,+,16095
25,BUMA.1121.00067,2,2298957,2315095,-,16138
25,BUMA.1121.00037,2,2029719,2045861,+,16142
25,BUMA.1121.00065,2,1708851,1725050,+,16199
25,BUMA.1121.00058,2,2286541,2302436,+,15895
25,BUMA.1121.00041,2,2626337,2642449,+,16112
25,BUMA.1121.00084,2,384884,400747,+,15863
25,BUMA.1121.00096,2,1880314,1896508,+,16194
25,BUMA.1121.00080,2,1672420,1688377,+,15957
25,BUMA.1121.00013,2,1499597,1515573,+,15976
25,BUMA.1121.00100,2,2806646,2823033,+,16387
25,BUMA.1121.00012,2,3270621,3286754,-,16133
25,BUMA.1121.00018,2,2120859,2136986,-,16127
25,BUMA.1121.00048,2,1893733,1909709,+,15976
25,BUMA.1121.00106,2,61349,77484,-,16135
25,BUMA.1121.00017,2,920306,936522,+,16216
25,BUMA.1121.00082,2,1704108,1720220,+,16112
26,BUMA.1121.00049,2,346309,371862,+,25553
26,BUMA.1121.00055,2,958638,984270,-,25632
26,BUMA.1121.00011,2,309497,334990,+,25493
26,BUMA.1121.00110,2,699799,725293,-,25494
26,BUMA.1121.00109,2,2958725,2984257,-,25532
26,BUMA.1121.00077,2,1993393,2018886,-,25493
26,BUMA.1121.00027,2,2738020,2763702,+,25682
26,BUMA.1121.00026,2,1599310,1624870,-,25560
26,BUMA.1121.00021,2,2209304,2234920,+,25616
26,BUMA.1121.00023,2,1829472,1855076,+,25604
26,BUMA.1121.00022,2,450821,476314,+,25493
26,BUMA.1121.00025,2,2427125,2452753,-,25628
26,BUMA.1121.00031,2,876405,902000,+,25595
26,BUMA.1121.00007,2,1760512,1786020,+,25508
26,BUMA.1121.00097,2,1528581,1554056,+,25475
26,BUMA.1121.00059,2,1883606,1909128,-,25522
26,BUMA.1121.00005,2,3134098,3159745,+,25647
26,BUMA.1121.00111,2,1020794,1046405,+,25611
26,BUMA.1121.00006,2,1261830,1287351,+,25521
26,BUMA.1121.00009,2,350103,375602,+,25499
26,BUMA.1121.00094,2,1730828,1756496,+,25668
26,BUMA.1121.00101,2,1705965,1731491,-,25526
26,BUMA.1121.00066,2,1662901,1688417,+,25516
26,BUMA.1121.00095,2,2869248,2894761,-,25513
26,BUMA.1121.00112,2,2661908,2687483,-,25575
26,BUMA.1121.00042,2,653054,678624,-,25570
26,BUMA.1121.00090,2,2688254,2713854,+,25600
26,BUMA.1121.00089,2,1675978,1701666,+,25688
26,BUMA.1121.00051,2,1689390,1715113,+,25723
26,BUMA.1121.00001,2,488608,514255,-,25647
26,BUMA.1121.00045,2,1576138,1601644,+,25506
26,BUMA.1121.00043,2,588511,614124,-,25613
26,BUMA.1121.00063,2,1677004,1702501,+,25497
26,BUMA.1121.00079,2,1688675,1714199,+,25524
26,BUMA.1121.00071,2,1678448,1703928,+,25480
26,BUMA.1121.00086,2,1258348,1283850,+,25502
26,BUMA.1121.00040,2,935225,960760,-,25535
26,BUMA.1121.00093,2,1225242,1250780,-,25538
26,BUMA.1121.00091,2,1920641,1946194,-,25553
26,BUMA.1121.00107,2,2098673,2124216,-,25543
26,BUMA.1121.00088,2,1699245,1724756,+,25511
26,BUMA.1121.00047,2,2620629,2646335,+,25706
26,BUMA.1121.00087,2,1525782,1551284,+,25502
26,BUMA.1121.00039,2,2249434,2274958,-,25524
26,BUMA.1121.00016,2,1999053,2024737,-,25684
26,BUMA.1121.00092,2,1693654,1719192,+,25538
26,BUMA.1121.00003,2,2198175,2223835,-,25660
26,BUMA.1121.00054,2,1061953,1087474,+,25521
26,BUMA.1121.00015,2,968096,993599,-,25503
26,BUMA.1121.00105,2,711820,737314,-,25494
26,BUMA.1121.00053,2,1976542,2002030,+,25488
26,BUMA.1121.00057,2,386606,412349,-,25743
26,BUMA.1121.00108,2,1913233,1938754,+,25521
26,BUMA.1121.00050,2,1017236,1042761,-,25525
26,BUMA.1121.00104,2,1780380,1805991,+,25611
26,BUMA.1121.00014,2,1810190,1835787,+,25597
26,BUMA.1121.00036,2,510059,535561,+,25502
26,BUMA.1121.00038,2,1162990,1188511,+,25521
26,BUMA.1121.00098,2,1949963,1975512,+,25549
26,BUMA.1121.00078,2,1434573,1460232,-,25659
26,BUMA.1121.00029,2,2865689,2891320,-,25631
26,BUMA.1121.00099,2,1939669,1965205,+,25536
26,BUMA.1121.00103,2,235369,260948,+,25579
26,BUMA.1121.00102,2,1738182,1763879,+,25697
26,BUMA.1121.00075,2,2012083,2037756,+,25673
26,BUMA.1121.00076,2,2642816,2668489,+,25673
26,BUMA.1121.00074,2,2656979,2682617,-,25638
26,BUMA.1121.00073,2,1678273,1703789,+,25516
26,BUMA.1121.00083,2,346164,371680,+,25516
26,BUMA.1121.00035,2,2884192,2909813,-,25621
26,BUMA.1121.00072,2,1653581,1679081,+,25500
26,BUMA.1121.00056,2,2292375,2318063,-,25688
26,BUMA.1121.00081,2,1036180,1061701,-,25521
26,BUMA.1121.00033,2,2478079,2503761,+,25682
26,BUMA.1121.00061,2,1665908,1691414,+,25506
26,BUMA.1121.00062,2,3198478,3224005,-,25527
26,BUMA.1121.00064,2,1598498,1624124,+,25626
26,BUMA.1121.00060,2,648296,673802,-,25506
26,BUMA.1121.00069,2,1650863,1676372,+,25509
26,BUMA.1121.00070,2,1657853,1683369,+,25516
26,BUMA.1121.00068,2,266713,292336,+,25623
26,BUMA.1121.00067,2,2271348,2296968,-,25620
26,BUMA.1121.00037,2,2047851,2073472,+,25621
26,BUMA.1121.00065,2,1727040,1752587,+,25547
26,BUMA.1121.00058,2,2304426,2330049,+,25623
26,BUMA.1121.00041,2,2644439,2670064,+,25625
26,BUMA.1121.00084,2,402737,428346,+,25609
26,BUMA.1121.00096,2,1898498,1924018,+,25520
26,BUMA.1121.00080,2,1690367,1716069,+,25702
26,BUMA.1121.00100,2,2825023,2850628,+,25605
26,BUMA.1121.00012,2,3242995,3268632,-,25637
26,BUMA.1121.00018,2,2093242,2118870,-,25628
26,BUMA.1121.00048,2,1775552,1801073,-,25521
26,BUMA.1121.00106,2,33672,59360,-,25688
26,BUMA.1121.00082,2,1722210,1747726,+,25516
27,BUMA.1121.00049,2,375121,381364,+,6243
27,BUMA.1121.00055,2,949232,955377,-,6145
27,BUMA.1121.00011,2,338246,344390,+,6144
27,BUMA.1121.00110,2,690264,696409,-,6145
27,BUMA.1121.00109,2,2949295,2955440,-,6145
27,BUMA.1121.00077,2,1983859,1990004,-,6145
27,BUMA.1121.00027,2,2766983,2773259,+,6276
27,BUMA.1121.00026,2,1589881,1596026,-,6145
27,BUMA.1121.00021,2,2238190,2244323,+,6133
27,BUMA.1121.00023,2,1858370,1864503,+,6133
27,BUMA.1121.00022,2,480826,486981,+,6155
27,BUMA.1121.00025,2,2417685,2423819,-,6134
27,BUMA.1121.00031,2,905258,911446,+,6188
27,BUMA.1121.00007,2,1789306,1795439,+,6133
27,BUMA.1121.00097,2,1557345,1563478,+,6133
27,BUMA.1121.00059,2,1873817,1879962,-,6145
27,BUMA.1121.00005,2,3163040,3169349,+,6309
27,BUMA.1121.00111,2,1049735,1055868,+,6133
27,BUMA.1121.00006,2,1289629,1295780,+,6151
27,BUMA.1121.00009,2,378835,384979,+,6144
27,BUMA.1121.00094,2,1759755,1765976,+,6221
27,BUMA.1121.00101,2,1696528,1702683,-,6155
27,BUMA.1121.00066,2,1691748,1698068,+,6320
27,BUMA.1121.00095,2,2859814,2865958,-,6144
27,BUMA.1121.00112,2,2652459,2658604,-,6145
27,BUMA.1121.00042,2,643637,649782,-,6145
27,BUMA.1121.00090,2,2717160,2723293,+,6133
27,BUMA.1121.00089,2,1704925,1711146,+,6221
27,BUMA.1121.00051,2,1718371,1724592,+,6221
27,BUMA.1121.00001,2,479144,485278,-,6134
27,BUMA.1121.00045,2,1604938,1611082,+,6144
27,BUMA.1121.00043,2,579074,585219,-,6145
27,BUMA.1121.00063,2,1705706,1712026,+,6320
27,BUMA.1121.00079,2,1717458,1723862,+,6404
27,BUMA.1121.00071,2,1707161,1713481,+,6320
27,BUMA.1121.00086,2,1288362,1294517,+,6155
27,BUMA.1121.00040,2,926791,932936,-,6145
27,BUMA.1121.00093,2,1215814,1221948,-,6134
27,BUMA.1121.00091,2,1911148,1917293,-,6145
27,BUMA.1121.00107,2,2089159,2095304,-,6145
27,BUMA.1121.00088,2,1728015,1734423,+,6408
27,BUMA.1121.00047,2,2649594,2655815,+,6221
27,BUMA.1121.00087,2,1555796,1561951,+,6155
27,BUMA.1121.00039,2,2239970,2246104,-,6134
27,BUMA.1121.00016,2,1989616,1995749,-,6133
27,BUMA.1121.00092,2,1722486,1728619,+,6133
27,BUMA.1121.00003,2,2188749,2194894,-,6145
27,BUMA.1121.00054,2,1089752,1095903,+,6151
27,BUMA.1121.00015,2,959662,965807,-,6145
27,BUMA.1121.00105,2,702404,708538,-,6134
27,BUMA.1121.00053,2,2005324,2011611,+,6287
27,BUMA.1121.00057,2,377126,383270,-,6144
27,BUMA.1121.00108,2,1942061,1948216,+,6155
27,BUMA.1121.00050,2,1008802,1014947,-,6145
27,BUMA.1121.00104,2,1809250,1815647,+,6397
27,BUMA.1121.00014,2,1839045,1845233,+,6188
27,BUMA.1121.00036,2,540068,546223,+,6155
27,BUMA.1121.00038,2,1190789,1196940,+,6151
27,BUMA.1121.00098,2,1978794,1985037,+,6243
27,BUMA.1121.00078,2,1425148,1431293,-,6145
27,BUMA.1121.00029,2,2856262,2862396,-,6134
27,BUMA.1121.00099,2,1968498,1974653,+,6155
27,BUMA.1121.00103,2,264211,270476,+,6265
27,BUMA.1121.00102,2,1767187,1773419,+,6232
27,BUMA.1121.00075,2,2041036,2047201,+,6165
27,BUMA.1121.00076,2,2671770,2677935,+,6165
27,BUMA.1121.00074,2,2647476,2653621,-,6145
27,BUMA.1121.00073,2,1707018,1713338,+,6320
27,BUMA.1121.00083,2,375011,381320,+,6309
27,BUMA.1121.00035,2,2874728,2880862,-,6134
27,BUMA.1121.00072,2,1682365,1688685,+,6320
27,BUMA.1121.00056,2,2282894,2289039,-,6145
27,BUMA.1121.00081,2,1027750,1033891,-,6141
27,BUMA.1121.00033,2,2507042,2513174,+,6132
27,BUMA.1121.00061,2,1694767,1700958,+,6191
27,BUMA.1121.00062,2,3188700,3194845,-,6145
27,BUMA.1121.00064,2,1627460,1633604,+,6144
27,BUMA.1121.00060,2,638857,645002,-,6145
27,BUMA.1121.00069,2,1679663,1685983,+,6320
27,BUMA.1121.00070,2,1686597,1692917,+,6320
27,BUMA.1121.00068,2,295616,301782,+,6166
27,BUMA.1121.00067,2,2261856,2268001,-,6145
27,BUMA.1121.00037,2,2076765,2082898,+,6133
27,BUMA.1121.00065,2,1755957,1762014,+,6057
27,BUMA.1121.00058,2,2333308,2339518,+,6210
27,BUMA.1121.00041,2,2673301,2679566,+,6265
27,BUMA.1121.00084,2,431605,438035,+,6430
27,BUMA.1121.00096,2,1927269,1933411,+,6142
27,BUMA.1121.00080,2,1719328,1725548,+,6220
27,BUMA.1121.00100,2,2853890,2860034,+,6144
27,BUMA.1121.00012,2,3233568,3239702,-,6134
27,BUMA.1121.00018,2,2083791,2089925,-,6134
27,BUMA.1121.00048,2,1767122,1773263,-,6141
27,BUMA.1121.00106,2,24012,30157,-,6145
27,BUMA.1121.00082,2,1751057,1757377,+,6320
28,BUMA.1121.00049,2,381366,393408,+,12042
28,BUMA.1121.00055,2,937161,949231,-,12070
28,BUMA.1121.00011,2,344392,356388,+,11996
28,BUMA.1121.00110,2,678185,690263,-,12078
28,BUMA.1121.00109,2,2937155,2949294,-,12139
28,BUMA.1121.00077,2,1971782,1983858,-,12076
28,BUMA.1121.00027,2,2773261,2785365,+,12104
28,BUMA.1121.00026,2,1577916,1589880,-,11964
28,BUMA.1121.00021,2,2244325,2256383,+,12058
28,BUMA.1121.00023,2,1864505,1876564,+,12059
28,BUMA.1121.00022,2,486983,499051,+,12068
28,BUMA.1121.00025,2,2405645,2417684,-,12039
28,BUMA.1121.00031,2,911448,923520,+,12072
28,BUMA.1121.00007,2,1795441,1807574,+,12133
28,BUMA.1121.00097,2,1563480,1575542,+,12062
28,BUMA.1121.00059,2,1861720,1873816,-,12096
28,BUMA.1121.00005,2,3169351,3181374,+,12023
28,BUMA.1121.00111,2,1055870,1067941,+,12071
28,BUMA.1121.00006,2,1295782,1307753,+,11971
28,BUMA.1121.00009,2,384981,397048,+,12067
28,BUMA.1121.00094,2,1765978,1778015,+,12037
28,BUMA.1121.00101,2,1684424,1696527,-,12103
28,BUMA.1121.00066,2,1698070,1710083,+,12013
28,BUMA.1121.00095,2,2847804,2859813,-,12009
28,BUMA.1121.00112,2,2640421,2652458,-,12037
28,BUMA.1121.00042,2,631678,643636,-,11958
28,BUMA.1121.00090,2,2723295,2735367,+,12072
28,BUMA.1121.00089,2,1711148,1723209,+,12061
28,BUMA.1121.00051,2,1724594,1736632,+,12038
28,BUMA.1121.00001,2,467098,479143,-,12045
28,BUMA.1121.00045,2,1611084,1623215,+,12131
28,BUMA.1121.00043,2,567043,579073,-,12030
28,BUMA.1121.00063,2,1712028,1724044,+,12016
28,BUMA.1121.00079,2,1723864,1735833,+,11969
28,BUMA.1121.00071,2,1713483,1725451,+,11968
28,BUMA.1121.00086,2,1294519,1306707,+,12188
28,BUMA.1121.00040,2,914836,926790,-,11954
28,BUMA.1121.00093,2,1203851,1215813,-,11962
28,BUMA.1121.00091,2,1899114,1911147,-,12033
28,BUMA.1121.00107,2,2077061,2089158,-,12097
28,BUMA.1121.00088,2,1734425,1746604,+,12179
28,BUMA.1121.00047,2,2655817,2667907,+,12090
28,BUMA.1121.00087,2,1561953,1574057,+,12104
28,BUMA.1121.00039,2,2227886,2239969,-,12083
28,BUMA.1121.00016,2,1977611,1989615,-,12004
28,BUMA.1121.00092,2,1728621,1740583,+,11962
28,BUMA.1121.00085,2,380976,392968,+,11992
28,BUMA.1121.00003,2,2176717,2188748,-,12031
28,BUMA.1121.00054,2,1095905,1107876,+,11971
28,BUMA.1121.00015,2,947675,959661,-,11986
28,BUMA.1121.00105,2,690399,702403,-,12004
28,BUMA.1121.00052,2,1069533,1081525,+,11992
28,BUMA.1121.00053,2,2011613,2023655,+,12042
28,BUMA.1121.00057,2,365029,377125,-,12096
28,BUMA.1121.00108,2,1948218,1960398,+,12180
28,BUMA.1121.00050,2,996845,1008801,-,11956
28,BUMA.1121.00104,2,1815649,1827718,+,12069
28,BUMA.1121.00014,2,1845235,1857295,+,12060
28,BUMA.1121.00036,2,546225,558281,+,12056
28,BUMA.1121.00038,2,1196942,1208913,+,11971
28,BUMA.1121.00098,2,1985039,1997118,+,12079
28,BUMA.1121.00078,2,1413095,1425147,-,12052
28,BUMA.1121.00029,2,2844114,2856261,-,12147
28,BUMA.1121.00099,2,1974655,1986821,+,12166
28,BUMA.1121.00103,2,270478,282690,+,12212
28,BUMA.1121.00102,2,1773421,1785453,+,12032
28,BUMA.1121.00075,2,2047203,2059224,+,12021
28,BUMA.1121.00076,2,2677937,2689960,+,12023
28,BUMA.1121.00074,2,2635469,2647475,-,12006
28,BUMA.1121.00073,2,1713340,1725413,+,12073
28,BUMA.1121.00083,2,381322,393481,+,12159
28,BUMA.1121.00035,2,2862664,2874727,-,12063
28,BUMA.1121.00072,2,1688687,1700575,+,11888
28,BUMA.1121.00056,2,2270830,2282893,-,12063
28,BUMA.1121.00081,2,1015778,1027749,-,11971
28,BUMA.1121.00033,2,2513176,2525230,+,12054
28,BUMA.1121.00061,2,1700960,1712927,+,11967
28,BUMA.1121.00062,2,3176667,3188699,-,12032
28,BUMA.1121.00064,2,1633606,1645651,+,12045
28,BUMA.1121.00060,2,626725,638856,-,12131
28,BUMA.1121.00069,2,1685985,1697924,+,11939
28,BUMA.1121.00070,2,1692919,1704967,+,12048
28,BUMA.1121.00068,2,301784,313828,+,12044
28,BUMA.1121.00067,2,2249842,2261855,-,12013
28,BUMA.1121.00037,2,2082900,2094967,+,12067
28,BUMA.1121.00065,2,1762016,1774093,+,12077
28,BUMA.1121.00058,2,2339520,2351531,+,12011
28,BUMA.1121.00041,2,2679568,2691694,+,12126
28,BUMA.1121.00084,2,438037,450226,+,12189
28,BUMA.1121.00096,2,1933413,1945460,+,12047
28,BUMA.1121.00080,2,1725550,1737623,+,12073
28,BUMA.1121.00013,2,1676393,1688379,+,11986
28,BUMA.1121.00100,2,2860036,2872050,+,12014
28,BUMA.1121.00012,2,3221484,3233567,-,12083
28,BUMA.1121.00018,2,2071746,2083790,-,12044
28,BUMA.1121.00048,2,1755150,1767121,-,11971
28,BUMA.1121.00106,2,12040,24011,-,11971
28,BUMA.1121.00082,2,1757379,1769574,+,12195
29,BUMA.1121.00049,2,393758,403147,+,9389
29,BUMA.1121.00055,2,927515,936822,-,9307
29,BUMA.1121.00011,2,356648,365990,+,9342
29,BUMA.1121.00110,2,668558,677879,-,9321
29,BUMA.1121.00109,2,2927417,2936849,-,9432
29,BUMA.1121.00077,2,1962155,1971476,-,9321
29,BUMA.1121.00027,2,2785671,2794928,+,9257
29,BUMA.1121.00026,2,1566965,1576370,-,9405
29,BUMA.1121.00021,2,2256689,2265971,+,9282
29,BUMA.1121.00023,2,1876870,1886168,+,9298
29,BUMA.1121.00022,2,500608,510098,+,9490
29,BUMA.1121.00034,2,941445,950815,+,9370
29,BUMA.1121.00025,2,2396029,2405339,-,9310
29,BUMA.1121.00031,2,923826,933118,+,9292
29,BUMA.1121.00007,2,1807880,1817259,+,9379
29,BUMA.1121.00097,2,1575815,1585191,+,9376
29,BUMA.1121.00008,2,925573,934951,+,9378
29,BUMA.1121.00059,2,1852036,1861414,-,9378
29,BUMA.1121.00002,2,1598007,1607513,-,9506
29,BUMA.1121.00004,2,926320,935690,+,9370
29,BUMA.1121.00005,2,3181713,3191098,+,9385
29,BUMA.1121.00111,2,1068269,1077539,+,9270
29,BUMA.1121.00006,2,1309310,1318688,+,9378
29,BUMA.1121.00009,2,397354,406697,+,9343
29,BUMA.1121.00094,2,1778321,1787685,+,9364
29,BUMA.1121.00101,2,1674877,1684129,-,9252
29,BUMA.1121.00066,2,1710389,1719625,+,9236
29,BUMA.1121.00095,2,2838053,2847498,-,9445
29,BUMA.1121.00112,2,2630887,2640115,-,9228
29,BUMA.1121.00042,2,620746,630132,-,9386
29,BUMA.1121.00032,2,1433996,1443374,+,9378
29,BUMA.1121.00090,2,2735673,2744943,+,9270
29,BUMA.1121.00020,2,926314,935708,+,9394
29,BUMA.1121.00089,2,1723515,1732896,+,9381
29,BUMA.1121.00051,2,1736938,1746279,+,9341
29,BUMA.1121.00001,2,457521,466792,-,9271
29,BUMA.1121.00045,2,1623521,1632889,+,9368
29,BUMA.1121.00043,2,557460,566737,-,9277
29,BUMA.1121.00063,2,1724350,1733587,+,9237
29,BUMA.1121.00079,2,1736150,1745540,+,9390
29,BUMA.1121.00071,2,1725757,1734983,+,9226
29,BUMA.1121.00086,2,1308264,1317826,+,9562
29,BUMA.1121.00024,2,1061409,1070787,+,9378
29,BUMA.1121.00010,2,356836,366318,-,9482
29,BUMA.1121.00040,2,903820,913304,-,9484
29,BUMA.1121.00093,2,1194106,1203545,-,9439
29,BUMA.1121.00091,2,1889365,1898797,-,9432
29,BUMA.1121.00107,2,2067402,2076744,-,9342
29,BUMA.1121.00088,2,1746910,1756273,+,9363
29,BUMA.1121.00047,2,2668213,2677657,+,9444
29,BUMA.1121.00019,2,926278,935670,+,9392
29,BUMA.1121.00019,2,1005448,1014828,+,9380
29,BUMA.1121.00087,2,1575614,1585176,+,9562
29,BUMA.1121.00039,2,2218265,2227580,-,9315
29,BUMA.1121.00030,2,1170979,1180349,-,9370
29,BUMA.1121.00016,2,1967974,1977305,-,9331
29,BUMA.1121.00092,2,1740889,1750307,+,9418
29,BUMA.1121.00085,2,394525,404031,+,9506
29,BUMA.1121.00046,2,1546475,1555965,-,9490
29,BUMA.1121.00003,2,2166999,2176411,-,9412
29,BUMA.1121.00054,2,1109433,1118811,+,9378
29,BUMA.1121.00015,2,936596,946118,-,9522
29,BUMA.1121.00105,2,680803,690082,-,9279
29,BUMA.1121.00052,2,1083082,1092588,+,9506
29,BUMA.1121.00053,2,2023972,2033303,+,9331
29,BUMA.1121.00057,2,355449,364723,-,9274
29,BUMA.1121.00108,2,1960716,1970093,+,9377
29,BUMA.1121.00050,2,985782,995288,-,9506
29,BUMA.1121.00104,2,1828035,1837378,+,9343
29,BUMA.1121.00014,2,1857601,1866885,+,9284
29,BUMA.1121.00036,2,559838,569408,+,9570
29,BUMA.1121.00038,2,1210470,1219848,+,9378
29,BUMA.1121.00098,2,1997423,2006633,+,9210
29,BUMA.1121.00078,2,1403494,1412789,-,9295
29,BUMA.1121.00029,2,2834495,2843808,-,9313
29,BUMA.1121.00099,2,1987138,1996462,+,9324
29,BUMA.1121.00103,2,283019,292342,+,9323
29,BUMA.1121.00102,2,1785770,1795199,+,9429
29,BUMA.1121.00028,2,967544,976922,+,9378
29,BUMA.1121.00075,2,2059530,2068864,+,9334
29,BUMA.1121.00044,2,992550,1001920,+,9370
29,BUMA.1121.00076,2,2690266,2699609,+,9343
29,BUMA.1121.00074,2,2625836,2635163,-,9327
29,BUMA.1121.00073,2,1725708,1734939,+,9231
29,BUMA.1121.00083,2,393787,403030,+,9243
29,BUMA.1121.00035,2,2853056,2862358,-,9302
29,BUMA.1121.00072,2,1700881,1710124,+,9243
29,BUMA.1121.00056,2,2261143,2270524,-,9381
29,BUMA.1121.00081,2,1004843,1014221,-,9378
29,BUMA.1121.00033,2,2525536,2534834,+,9298
29,BUMA.1121.00061,2,1713233,1722483,+,9250
29,BUMA.1121.00062,2,3167108,3176361,-,9253
29,BUMA.1121.00064,2,1645957,1655252,+,9295
29,BUMA.1121.00060,2,617051,626419,-,9368
29,BUMA.1121.00069,2,1698230,1707459,+,9229
29,BUMA.1121.00070,2,1705256,1714485,+,9229
29,BUMA.1121.00068,2,314157,323568,+,9411
29,BUMA.1121.00067,2,2240263,2249536,-,9273
29,BUMA.1121.00037,2,2095273,2104585,+,9312
29,BUMA.1121.00065,2,1774421,1783716,+,9295
29,BUMA.1121.00058,2,2351837,2361140,+,9303
29,BUMA.1121.00041,2,2692000,2701466,+,9466
29,BUMA.1121.00084,2,450532,459852,+,9320
29,BUMA.1121.00096,2,1945766,1955113,+,9347
29,BUMA.1121.00080,2,1737929,1747307,+,9378
29,BUMA.1121.00013,2,1689936,1699426,+,9490
29,BUMA.1121.00100,2,2872345,2881733,+,9388
29,BUMA.1121.00012,2,3211863,3221178,-,9315
29,BUMA.1121.00018,2,2062130,2071440,-,9310
29,BUMA.1121.00048,2,1744215,1753593,-,9378
29,BUMA.1121.00106,2,2317,11723,-,9406
29,BUMA.1121.00017,2,941424,950794,+,9370
29,BUMA.1121.00082,2,1769880,1779123,+,9243
30,BUMA.1121.00049,2,407469,424576,+,17107
30,BUMA.1121.00055,2,906027,923369,-,17342
30,BUMA.1121.00011,2,370090,387151,+,17061
30,BUMA.1121.00110,2,646888,663948,-,17060
30,BUMA.1121.00109,2,2905611,2922988,-,17377
30,BUMA.1121.00077,2,1940508,1957569,-,17061
30,BUMA.1121.00027,2,2799200,2816321,+,17121
30,BUMA.1121.00026,2,1545698,1562794,-,17096
30,BUMA.1121.00021,2,2269918,2286967,+,17049
30,BUMA.1121.00023,2,1890157,1907206,+,17049
30,BUMA.1121.00022,2,514336,531619,+,17283
30,BUMA.1121.00034,2,955003,972180,+,17177
30,BUMA.1121.00025,2,2374882,2391966,-,17084
30,BUMA.1121.00031,2,937124,954263,+,17139
30,BUMA.1121.00007,2,1821623,1838920,+,17297
30,BUMA.1121.00097,2,1589431,1606768,+,17337
30,BUMA.1121.00008,2,939139,956336,+,17197
30,BUMA.1121.00059,2,1830598,1847740,-,17142
30,BUMA.1121.00002,2,1576717,1593830,-,17113
30,BUMA.1121.00004,2,939878,957045,+,17167
30,BUMA.1121.00005,2,3195383,3212476,+,17093
30,BUMA.1121.00111,2,1081580,1098613,+,17033
30,BUMA.1121.00006,2,1322877,1340215,+,17338
30,BUMA.1121.00009,2,410898,428171,+,17273
30,BUMA.1121.00094,2,1792062,1809515,+,17453
30,BUMA.1121.00101,2,1653731,1670951,-,17220
30,BUMA.1121.00066,2,1723758,1740925,+,17167
30,BUMA.1121.00095,2,2816251,2833668,-,17417
30,BUMA.1121.00112,2,2609597,2626943,-,17346
30,BUMA.1121.00042,2,599395,616557,-,17162
30,BUMA.1121.00032,2,1447562,1464699,+,17137
30,BUMA.1121.00090,2,2748939,2766060,+,17121
30,BUMA.1121.00020,2,939896,957073,+,17177
30,BUMA.1121.00089,2,1737268,1754722,+,17454
30,BUMA.1121.00051,2,1750662,1768238,+,17576
30,BUMA.1121.00001,2,435052,452103,-,17051
30,BUMA.1121.00045,2,1637149,1654278,+,17129
30,BUMA.1121.00043,2,536340,553419,-,17079
30,BUMA.1121.00063,2,1737946,1755155,+,17209
30,BUMA.1121.00079,2,1749949,1767401,+,17452
30,BUMA.1121.00071,2,1739349,1756579,+,17230
30,BUMA.1121.00086,2,1322029,1339269,+,17240
30,BUMA.1121.00024,2,1074975,1092142,+,17167
30,BUMA.1121.00010,2,335556,352659,-,17103
30,BUMA.1121.00040,2,882285,899624,-,17339
30,BUMA.1121.00093,2,1172622,1189915,-,17293
30,BUMA.1121.00091,2,1867912,1885063,-,17151
30,BUMA.1121.00107,2,2045952,2063323,-,17371
30,BUMA.1121.00088,2,1760578,1777907,+,17329
30,BUMA.1121.00047,2,2682042,2699594,+,17552
30,BUMA.1121.00019,2,939858,957035,+,17177
30,BUMA.1121.00019,2,1019016,1036193,+,17177
30,BUMA.1121.00087,2,1589379,1606669,+,17290
30,BUMA.1121.00039,2,2197215,2214263,-,17048
30,BUMA.1121.00030,2,1149614,1166790,-,17176
30,BUMA.1121.00016,2,1946654,1963761,-,17107
30,BUMA.1121.00092,2,1754628,1771922,+,17294
30,BUMA.1121.00085,2,408230,425562,+,17332
30,BUMA.1121.00046,2,1524936,1542279,-,17343
30,BUMA.1121.00003,2,2145546,2162587,-,17041
30,BUMA.1121.00054,2,1123000,1140329,+,17329
30,BUMA.1121.00015,2,915045,932400,-,17355
30,BUMA.1121.00105,2,659294,676428,-,17134
30,BUMA.1121.00052,2,1096787,1114109,+,17322
30,BUMA.1121.00053,2,2037579,2054880,+,17301
30,BUMA.1121.00057,2,333995,351152,-,17157
30,BUMA.1121.00108,2,1974277,1991384,+,17107
30,BUMA.1121.00050,2,964243,981586,-,17343
30,BUMA.1121.00104,2,1841559,1858779,+,17220
30,BUMA.1121.00014,2,1870869,1888021,+,17152
30,BUMA.1121.00036,2,573611,591019,+,17408
30,BUMA.1121.00038,2,1224037,1241376,+,17339
30,BUMA.1121.00098,2,2010643,2028062,+,17419
30,BUMA.1121.00078,2,1382035,1399138,-,17103
30,BUMA.1121.00029,2,2813468,2830503,-,17035
30,BUMA.1121.00099,2,2000785,2018127,+,17342
30,BUMA.1121.00103,2,296674,313942,+,17268
30,BUMA.1121.00102,2,1799477,1816746,+,17269
30,BUMA.1121.00028,2,981104,998291,+,17187
30,BUMA.1121.00075,2,2073173,2090298,+,17125
30,BUMA.1121.00044,2,1006108,1023284,+,17176
30,BUMA.1121.00076,2,2703926,2721052,+,17126
30,BUMA.1121.00074,2,2604071,2621363,-,17292
30,BUMA.1121.00073,2,1739305,1756517,+,17212
30,BUMA.1121.00083,2,407396,424631,+,17235
30,BUMA.1121.00035,2,2832041,2849077,-,17036
30,BUMA.1121.00072,2,1714333,1731491,+,17158
30,BUMA.1121.00056,2,2239587,2256770,-,17183
30,BUMA.1121.00081,2,983325,1000653,-,17328
30,BUMA.1121.00033,2,2538804,2555908,+,17104
30,BUMA.1121.00061,2,1726820,1744035,+,17215
30,BUMA.1121.00062,2,3145434,3162666,-,17232
30,BUMA.1121.00064,2,1659691,1676952,+,17261
30,BUMA.1121.00060,2,595646,612790,-,17144
30,BUMA.1121.00069,2,1711715,1728880,+,17165
30,BUMA.1121.00070,2,1718851,1736059,+,17208
30,BUMA.1121.00068,2,327856,345227,+,17371
30,BUMA.1121.00067,2,2218564,2235932,-,17368
30,BUMA.1121.00037,2,2108619,2125731,+,17112
30,BUMA.1121.00065,2,1788086,1805415,+,17329
30,BUMA.1121.00058,2,2365460,2382597,+,17137
30,BUMA.1121.00041,2,2705758,2723066,+,17308
30,BUMA.1121.00084,2,464141,481334,+,17193
30,BUMA.1121.00096,2,1959417,1976723,+,17306
30,BUMA.1121.00080,2,1751657,1769211,+,17554
30,BUMA.1121.00013,2,1703625,1720837,+,17212
30,BUMA.1121.00100,2,2885752,2903166,+,17414
30,BUMA.1121.00012,2,3190583,3207650,-,17067
30,BUMA.1121.00018,2,2040983,2058067,-,17084
30,BUMA.1121.00048,2,1722687,1740025,-,17338
30,BUMA.1121.00106,2,3175147,3192338,-,17191
30,BUMA.1121.00017,2,954982,972159,+,17177
30,BUMA.1121.00082,2,1783489,1800724,+,17235
31,BUMA.1121.00049,2,429619,445791,+,16172
31,BUMA.1121.00055,2,884865,901013,-,16148
31,BUMA.1121.00011,2,392226,408353,+,16127
31,BUMA.1121.00110,2,625701,641862,-,16161
31,BUMA.1121.00109,2,2883638,2899794,-,16156
31,BUMA.1121.00077,2,1919318,1935482,-,16164
31,BUMA.1121.00027,2,2821313,2837465,+,16152
31,BUMA.1121.00026,2,1524548,1540696,-,16148
31,BUMA.1121.00021,2,2291815,2307997,+,16182
31,BUMA.1121.00023,2,1913342,1929516,+,16174
31,BUMA.1121.00022,2,536624,552773,+,16149
31,BUMA.1121.00034,2,977185,993334,+,16149
31,BUMA.1121.00025,2,2353881,2370034,-,16153
31,BUMA.1121.00031,2,959167,975349,+,16182
31,BUMA.1121.00007,2,1843939,1860150,+,16211
31,BUMA.1121.00097,2,1611799,1627880,+,16081
31,BUMA.1121.00008,2,961341,977490,+,16149
31,BUMA.1121.00059,2,1809488,1825658,-,16170
31,BUMA.1121.00002,2,1555563,1571712,-,16149
31,BUMA.1121.00004,2,962050,978198,+,16148
31,BUMA.1121.00005,2,3217488,3233646,+,16158
31,BUMA.1121.00111,2,1103475,1119684,+,16209
31,BUMA.1121.00006,2,1345220,1361370,+,16150
31,BUMA.1121.00009,2,433215,449407,+,16192
31,BUMA.1121.00094,2,1814534,1830703,+,16169
31,BUMA.1121.00101,2,1632592,1648742,-,16150
31,BUMA.1121.00066,2,1745907,1762018,+,16111
31,BUMA.1121.00095,2,2795075,2811201,-,16126
31,BUMA.1121.00112,2,2588330,2604501,-,16171
31,BUMA.1121.00042,2,578245,594393,-,16148
31,BUMA.1121.00032,2,1469704,1485853,+,16149
31,BUMA.1121.00090,2,2771062,2787242,+,16180
31,BUMA.1121.00020,2,962078,978227,+,16149
31,BUMA.1121.00089,2,1759741,1775911,+,16170
31,BUMA.1121.00051,2,1773257,1789434,+,16177
31,BUMA.1121.00001,2,413901,430043,-,16142
31,BUMA.1121.00045,2,1659332,1675456,+,16124
31,BUMA.1121.00043,2,515146,531338,-,16192
31,BUMA.1121.00063,2,1760137,1776278,+,16141
31,BUMA.1121.00079,2,1772420,1788590,+,16170
31,BUMA.1121.00071,2,1761561,1777701,+,16140
31,BUMA.1121.00086,2,1344274,1360423,+,16149
31,BUMA.1121.00024,2,1097147,1113296,+,16149
31,BUMA.1121.00010,2,314402,330551,-,16149
31,BUMA.1121.00040,2,861131,877280,-,16149
31,BUMA.1121.00093,2,1151516,1167668,-,16152
31,BUMA.1121.00091,2,1846712,1862871,-,16159
31,BUMA.1121.00107,2,2024832,2040928,-,16096
31,BUMA.1121.00088,2,1782854,1799006,+,16152
31,BUMA.1121.00047,2,2704613,2720794,+,16181
31,BUMA.1121.00019,2,962040,978189,+,16149
31,BUMA.1121.00019,2,1041198,1057347,+,16149
31,BUMA.1121.00087,2,1611674,1627823,+,16149
31,BUMA.1121.00039,2,2176165,2192346,-,16181
31,BUMA.1121.00030,2,1128460,1144609,-,16149
31,BUMA.1121.00016,2,1925498,1941652,-,16154
31,BUMA.1121.00092,2,1776876,1793028,+,16152
31,BUMA.1121.00085,2,430546,446695,+,16149
31,BUMA.1121.00046,2,1503791,1519940,-,16149
31,BUMA.1121.00003,2,2124349,2140534,-,16185
31,BUMA.1121.00054,2,1145334,1161484,+,16150
31,BUMA.1121.00015,2,893891,910040,-,16149
31,BUMA.1121.00105,2,638162,654340,-,16178
31,BUMA.1121.00052,2,1119093,1135242,+,16149
31,BUMA.1121.00053,2,2060000,2076160,+,16160
31,BUMA.1121.00057,2,312855,329003,-,16148
31,BUMA.1121.00108,2,1996384,2012537,+,16153
31,BUMA.1121.00050,2,943098,959247,-,16149
31,BUMA.1121.00104,2,1863768,1879956,+,16188
31,BUMA.1121.00014,2,1892911,1909120,+,16209
31,BUMA.1121.00036,2,596038,612187,+,16149
31,BUMA.1121.00038,2,1246381,1262531,+,16150
31,BUMA.1121.00098,2,2033074,2049219,+,16145
31,BUMA.1121.00078,2,1360831,1376999,-,16168
31,BUMA.1121.00029,2,2792317,2808459,-,16142
31,BUMA.1121.00099,2,2023129,2039266,+,16137
31,BUMA.1121.00103,2,318981,335128,+,16147
31,BUMA.1121.00102,2,1821782,1837979,+,16197
31,BUMA.1121.00028,2,1003296,1019445,+,16149
31,BUMA.1121.00075,2,2095301,2111499,+,16198
31,BUMA.1121.00044,2,1028289,1044438,+,16149
31,BUMA.1121.00076,2,2726062,2742261,+,16199
31,BUMA.1121.00074,2,2582947,2599110,-,16163
31,BUMA.1121.00073,2,1761482,1777623,+,16141
31,BUMA.1121.00083,2,429613,445754,+,16141
31,BUMA.1121.00035,2,2810879,2827021,-,16142
31,BUMA.1121.00072,2,1736428,1752569,+,16141
31,BUMA.1121.00056,2,2218398,2234568,-,16170
31,BUMA.1121.00081,2,962170,978320,-,16150
31,BUMA.1121.00033,2,2560763,2576915,+,16152
31,BUMA.1121.00061,2,1749017,1765157,+,16140
31,BUMA.1121.00062,2,3124307,3140487,-,16180
31,BUMA.1121.00064,2,1681892,1698077,+,16185
31,BUMA.1121.00060,2,574475,590599,-,16124
31,BUMA.1121.00069,2,1733862,1749999,+,16137
31,BUMA.1121.00070,2,1741010,1757151,+,16141
31,BUMA.1121.00068,2,350252,366440,+,16188
31,BUMA.1121.00067,2,2197446,2213631,-,16185
31,BUMA.1121.00037,2,2130593,2146792,+,16199
31,BUMA.1121.00065,2,1810420,1826625,+,16205
31,BUMA.1121.00058,2,2387548,2403731,+,16183
31,BUMA.1121.00041,2,2729433,2745570,+,16137
31,BUMA.1121.00084,2,486334,502486,+,16152
31,BUMA.1121.00096,2,1981716,1998091,+,16375
31,BUMA.1121.00080,2,1774230,1790399,+,16169
31,BUMA.1121.00013,2,1725821,1741970,+,16149
31,BUMA.1121.00100,2,2908185,2924304,+,16119
31,BUMA.1121.00012,2,3169536,3185707,-,16171
31,BUMA.1121.00018,2,2019983,2036135,-,16152
31,BUMA.1121.00048,2,1701532,1717682,-,16150
31,BUMA.1121.00106,2,3153963,3170126,-,16163
31,BUMA.1121.00017,2,977164,993313,+,16149
31,BUMA.1121.00082,2,1805706,1821847,+,16141
32,BUMA.1121.00049,2,450385,453665,+,3280
32,BUMA.1121.00055,2,876991,880268,-,3277
32,BUMA.1121.00011,2,412841,416114,+,3273
32,BUMA.1121.00110,2,617832,621103,-,3271
32,BUMA.1121.00109,2,2875764,2879042,-,3278
32,BUMA.1121.00077,2,1911448,1914720,-,3272
32,BUMA.1121.00027,2,2842059,2845331,+,3272
32,BUMA.1121.00026,2,1516680,1519952,-,3272
32,BUMA.1121.00021,2,2312592,2315869,+,3277
32,BUMA.1121.00023,2,1934111,1937388,+,3277
32,BUMA.1121.00022,2,557368,560640,+,3272
32,BUMA.1121.00034,2,997929,1001201,+,3272
32,BUMA.1121.00025,2,2346007,2349285,-,3278
32,BUMA.1121.00031,2,979944,983221,+,3277
32,BUMA.1121.00007,2,1864745,1868023,+,3278
32,BUMA.1121.00097,2,1632474,1635759,+,3285
32,BUMA.1121.00008,2,982085,985357,+,3272
32,BUMA.1121.00059,2,1801608,1804886,-,3278
32,BUMA.1121.00002,2,1547700,1550972,-,3272
32,BUMA.1121.00004,2,982793,986065,+,3272
32,BUMA.1121.00005,2,3238240,3241517,+,3277
32,BUMA.1121.00111,2,1124279,1127556,+,3277
32,BUMA.1121.00006,2,1365965,1369237,+,3272
32,BUMA.1121.00009,2,454003,457279,+,3276
32,BUMA.1121.00094,2,1835298,1838555,+,3257
32,BUMA.1121.00101,2,1624725,1627997,-,3272
32,BUMA.1121.00066,2,1766581,1769861,+,3280
32,BUMA.1121.00095,2,2787190,2790463,-,3273
32,BUMA.1121.00112,2,2580520,2583803,-,3283
32,BUMA.1121.00042,2,570377,573649,-,3272
32,BUMA.1121.00032,2,1490448,1493720,+,3272
32,BUMA.1121.00090,2,2791837,2795114,+,3277
32,BUMA.1121.00020,2,982822,986094,+,3272
32,BUMA.1121.00089,2,1780506,1783763,+,3257
32,BUMA.1121.00051,2,1794028,1797285,+,3257
32,BUMA.1121.00001,2,406028,409305,-,3277
32,BUMA.1121.00045,2,1680051,1683329,+,3278
32,BUMA.1121.00043,2,507273,510550,-,3277
32,BUMA.1121.00063,2,1780872,1784152,+,3280
32,BUMA.1121.00079,2,1793184,1796461,+,3277
32,BUMA.1121.00071,2,1782233,1785513,+,3280
32,BUMA.1121.00086,2,1365018,1368290,+,3272
32,BUMA.1121.00024,2,1117891,1121163,+,3272
32,BUMA.1121.00010,2,306539,309811,-,3272
32,BUMA.1121.00040,2,853263,856535,-,3272
32,BUMA.1121.00093,2,1143664,1146921,-,3257
32,BUMA.1121.00091,2,1838838,1842115,-,3277
32,BUMA.1121.00107,2,2016948,2020237,-,3289
32,BUMA.1121.00088,2,1803600,1806880,+,3280
32,BUMA.1121.00047,2,2725389,2728646,+,3257
32,BUMA.1121.00019,2,982784,986056,+,3272
32,BUMA.1121.00019,2,1061942,1065214,+,3272
32,BUMA.1121.00087,2,1632418,1635690,+,3272
32,BUMA.1121.00039,2,2168292,2171569,-,3277
32,BUMA.1121.00030,2,1120592,1123864,-,3272
32,BUMA.1121.00016,2,1917610,1920902,-,3292
32,BUMA.1121.00092,2,1797622,1800879,+,3257
32,BUMA.1121.00085,2,451290,454562,+,3272
32,BUMA.1121.00046,2,1495923,1499195,-,3272
32,BUMA.1121.00003,2,2116468,2119752,-,3284
32,BUMA.1121.00054,2,1166079,1169351,+,3272
32,BUMA.1121.00015,2,886023,889295,-,3272
32,BUMA.1121.00105,2,630289,633566,-,3277
32,BUMA.1121.00052,2,1139837,1143109,+,3272
32,BUMA.1121.00053,2,2080756,2084028,+,3272
32,BUMA.1121.00057,2,304987,308259,-,3272
32,BUMA.1121.00108,2,2017132,2020417,+,3285
32,BUMA.1121.00050,2,935230,938502,-,3272
32,BUMA.1121.00104,2,1884550,1887830,+,3280
32,BUMA.1121.00014,2,1913715,1916992,+,3277
32,BUMA.1121.00036,2,616782,620054,+,3272
32,BUMA.1121.00038,2,1267126,1270398,+,3272
32,BUMA.1121.00098,2,2053815,2057093,+,3278
32,BUMA.1121.00078,2,1352962,1356234,-,3272
32,BUMA.1121.00029,2,2784444,2787721,-,3277
32,BUMA.1121.00099,2,2043863,2047145,+,3282
32,BUMA.1121.00103,2,339724,342991,+,3267
32,BUMA.1121.00102,2,1842575,1845847,+,3272
32,BUMA.1121.00028,2,1024040,1027312,+,3272
32,BUMA.1121.00075,2,2116092,2119372,+,3280
32,BUMA.1121.00044,2,1049033,1052305,+,3272
32,BUMA.1121.00076,2,2746855,2750135,+,3280
32,BUMA.1121.00074,2,2575074,2578351,-,3277
32,BUMA.1121.00073,2,1782217,1785497,+,3280
32,BUMA.1121.00083,2,450348,453628,+,3280
32,BUMA.1121.00035,2,2803006,2806283,-,3277
32,BUMA.1121.00072,2,1757163,1760443,+,3280
32,BUMA.1121.00056,2,2210545,2213802,-,3257
32,BUMA.1121.00081,2,954302,957574,-,3272
32,BUMA.1121.00033,2,2581509,2584786,+,3277
32,BUMA.1121.00061,2,1769751,1773031,+,3280
32,BUMA.1121.00062,2,3110222,3113479,-,3257
32,BUMA.1121.00064,2,1702671,1705928,+,3257
32,BUMA.1121.00060,2,566601,569879,-,3278
32,BUMA.1121.00069,2,1754535,1757815,+,3280
32,BUMA.1121.00070,2,1761745,1765025,+,3280
32,BUMA.1121.00068,2,371037,374310,+,3273
32,BUMA.1121.00067,2,2189573,2192850,-,3277
32,BUMA.1121.00037,2,2151387,2154664,+,3277
32,BUMA.1121.00065,2,1831221,1834498,+,3277
32,BUMA.1121.00058,2,2408325,2411605,+,3280
32,BUMA.1121.00041,2,2750165,2753437,+,3272
32,BUMA.1121.00084,2,507080,510352,+,3272
32,BUMA.1121.00096,2,2002686,2005971,+,3285
32,BUMA.1121.00080,2,1794992,1798249,+,3257
32,BUMA.1121.00013,2,1746565,1749837,+,3272
32,BUMA.1121.00100,2,2928901,2932185,+,3284
32,BUMA.1121.00012,2,3161663,3164940,-,3277
32,BUMA.1121.00018,2,2012110,2015387,-,3277
32,BUMA.1121.00048,2,1693664,1696936,-,3272
32,BUMA.1121.00106,2,3146088,3149368,-,3280
32,BUMA.1121.00017,2,997908,1001180,+,3272
32,BUMA.1121.00082,2,1826441,1829721,+,3280
33,BUMA.1121.00049,2,453667,458036,+,4369
33,BUMA.1121.00055,2,872614,876990,-,4376
33,BUMA.1121.00011,2,416116,420477,+,4361
33,BUMA.1121.00110,2,613461,617831,-,4370
33,BUMA.1121.00109,2,2871401,2875763,-,4362
33,BUMA.1121.00077,2,1907077,1911447,-,4370
33,BUMA.1121.00027,2,2845333,2849694,+,4361
33,BUMA.1121.00026,2,1512317,1516679,-,4362
33,BUMA.1121.00021,2,2315871,2320240,+,4369
33,BUMA.1121.00023,2,1937390,1941759,+,4369
33,BUMA.1121.00022,2,560642,565003,+,4361
33,BUMA.1121.00034,2,1001203,1005564,+,4361
33,BUMA.1121.00025,2,2341636,2346006,-,4370
33,BUMA.1121.00031,2,983223,987592,+,4369
33,BUMA.1121.00007,2,1868025,1872394,+,4369
33,BUMA.1121.00097,2,1635761,1640132,+,4371
33,BUMA.1121.00008,2,985359,989720,+,4361
33,BUMA.1121.00059,2,1797237,1801607,-,4370
33,BUMA.1121.00002,2,1543337,1547699,-,4362
33,BUMA.1121.00004,2,986067,990428,+,4361
33,BUMA.1121.00005,2,3241519,3245888,+,4369
33,BUMA.1121.00111,2,1127558,1131927,+,4369
33,BUMA.1121.00006,2,1369239,1373600,+,4361
33,BUMA.1121.00009,2,457281,461650,+,4369
33,BUMA.1121.00094,2,1838557,1842926,+,4369
33,BUMA.1121.00101,2,1620348,1624724,-,4376
33,BUMA.1121.00066,2,1769863,1774232,+,4369
33,BUMA.1121.00095,2,2782819,2787189,-,4370
33,BUMA.1121.00112,2,2576149,2580519,-,4370
33,BUMA.1121.00042,2,566014,570376,-,4362
33,BUMA.1121.00032,2,1493722,1498083,+,4361
33,BUMA.1121.00090,2,2795116,2799485,+,4369
33,BUMA.1121.00020,2,986096,990457,+,4361
33,BUMA.1121.00089,2,1783765,1788134,+,4369
33,BUMA.1121.00051,2,1797287,1801656,+,4369
33,BUMA.1121.00001,2,401666,406027,-,4361
33,BUMA.1121.00045,2,1683331,1687700,+,4369
33,BUMA.1121.00043,2,502902,507272,-,4370
33,BUMA.1121.00063,2,1784154,1788523,+,4369
33,BUMA.1121.00079,2,1796463,1800832,+,4369
33,BUMA.1121.00071,2,1785515,1789884,+,4369
33,BUMA.1121.00086,2,1368292,1372653,+,4361
33,BUMA.1121.00024,2,1121165,1125526,+,4361
33,BUMA.1121.00010,2,302176,306538,-,4362
33,BUMA.1121.00040,2,848900,853262,-,4362
33,BUMA.1121.00093,2,1139293,1143663,-,4370
33,BUMA.1121.00091,2,1834475,1838837,-,4362
33,BUMA.1121.00107,2,2012569,2016947,-,4378
33,BUMA.1121.00088,2,1806882,1811251,+,4369
33,BUMA.1121.00047,2,2728648,2733017,+,4369
33,BUMA.1121.00019,2,986058,990419,+,4361
33,BUMA.1121.00019,2,1065216,1069577,+,4361
33,BUMA.1121.00087,2,1635692,1640053,+,4361
33,BUMA.1121.00039,2,2163921,2168291,-,4370
33,BUMA.1121.00030,2,1116229,1120591,-,4362
33,BUMA.1121.00016,2,1911941,1916263,-,4322
33,BUMA.1121.00092,2,1800881,1805250,+,4369
33,BUMA.1121.00085,2,454564,458925,+,4361
33,BUMA.1121.00046,2,1491560,1495922,-,4362
33,BUMA.1121.00003,2,2112105,2116467,-,4362
33,BUMA.1121.00054,2,1169353,1173714,+,4361
33,BUMA.1121.00015,2,881660,886022,-,4362
33,BUMA.1121.00105,2,625918,630288,-,4370
33,BUMA.1121.00052,2,1143111,1147472,+,4361
33,BUMA.1121.00053,2,2084030,2088399,+,4369
33,BUMA.1121.00057,2,300624,304986,-,4362
33,BUMA.1121.00108,2,2020419,2024788,+,4369
33,BUMA.1121.00050,2,930867,935229,-,4362
33,BUMA.1121.00104,2,1887832,1892201,+,4369
33,BUMA.1121.00014,2,1916994,1921354,+,4360
33,BUMA.1121.00036,2,620056,624417,+,4361
33,BUMA.1121.00038,2,1270400,1274761,+,4361
33,BUMA.1121.00098,2,2057095,2061456,+,4361
33,BUMA.1121.00078,2,1348599,1352961,-,4362
33,BUMA.1121.00029,2,2780082,2784443,-,4361
33,BUMA.1121.00099,2,2047147,2051516,+,4369
33,BUMA.1121.00103,2,342993,347360,+,4367
33,BUMA.1121.00102,2,1845849,1850218,+,4369
33,BUMA.1121.00028,2,1027314,1031675,+,4361
33,BUMA.1121.00075,2,2119374,2123743,+,4369
33,BUMA.1121.00044,2,1052307,1056668,+,4361
33,BUMA.1121.00076,2,2750137,2754506,+,4369
33,BUMA.1121.00074,2,2570703,2575073,-,4370
33,BUMA.1121.00073,2,1785499,1789868,+,4369
33,BUMA.1121.00083,2,453630,457999,+,4369
33,BUMA.1121.00035,2,2798644,2803005,-,4361
33,BUMA.1121.00072,2,1760445,1764814,+,4369
33,BUMA.1121.00056,2,2206174,2210544,-,4370
33,BUMA.1121.00081,2,949939,954301,-,4362
33,BUMA.1121.00033,2,2584788,2589157,+,4369
33,BUMA.1121.00061,2,1773033,1777402,+,4369
33,BUMA.1121.00062,2,3105851,3110221,-,4370
33,BUMA.1121.00064,2,1705930,1710299,+,4369
33,BUMA.1121.00060,2,562230,566600,-,4370
33,BUMA.1121.00069,2,1757817,1762180,+,4363
33,BUMA.1121.00070,2,1765027,1769396,+,4369
33,BUMA.1121.00068,2,374312,378691,+,4379
33,BUMA.1121.00067,2,2185202,2189572,-,4370
33,BUMA.1121.00037,2,2154666,2159026,+,4360
33,BUMA.1121.00065,2,1834500,1838869,+,4369
33,BUMA.1121.00058,2,2411607,2415958,+,4351
33,BUMA.1121.00041,2,2753439,2757781,+,4342
33,BUMA.1121.00084,2,510354,514723,+,4369
33,BUMA.1121.00096,2,2005973,2010342,+,4369
33,BUMA.1121.00080,2,1798251,1802620,+,4369
33,BUMA.1121.00013,2,1749839,1754200,+,4361
33,BUMA.1121.00100,2,2932187,2936562,+,4375
33,BUMA.1121.00012,2,3157292,3161662,-,4370
33,BUMA.1121.00018,2,2007739,2012109,-,4370
33,BUMA.1121.00048,2,1689301,1693663,-,4362
33,BUMA.1121.00106,2,3141717,3146087,-,4370
33,BUMA.1121.00017,2,1001182,1005543,+,4361
33,BUMA.1121.00082,2,1829723,1834092,+,4369
34,BUMA.1121.00049,2,458730,462021,+,3291
34,BUMA.1121.00055,2,868630,871921,-,3291
34,BUMA.1121.00011,2,421171,424444,+,3273
34,BUMA.1121.00110,2,609508,612768,-,3260
34,BUMA.1121.00109,2,2867417,2870708,-,3291
34,BUMA.1121.00077,2,1903124,1906384,-,3260
34,BUMA.1121.00027,2,2850388,2853679,+,3291
34,BUMA.1121.00026,2,1508351,1511624,-,3273
34,BUMA.1121.00021,2,2320934,2324225,+,3291
34,BUMA.1121.00023,2,1942453,1945744,+,3291
34,BUMA.1121.00022,2,565697,568970,+,3273
34,BUMA.1121.00034,2,1006258,1009531,+,3273
34,BUMA.1121.00025,2,2337652,2340943,-,3291
34,BUMA.1121.00031,2,988286,991577,+,3291
34,BUMA.1121.00007,2,1873088,1876361,+,3273
34,BUMA.1121.00097,2,1640826,1644099,+,3273
34,BUMA.1121.00008,2,990414,993687,+,3273
34,BUMA.1121.00059,2,1793253,1796544,-,3291
34,BUMA.1121.00002,2,1538056,1541301,-,3245
34,BUMA.1121.00004,2,991122,994395,+,3273
34,BUMA.1121.00005,2,3246582,3249873,+,3291
34,BUMA.1121.00111,2,1132621,1135912,+,3291
34,BUMA.1121.00006,2,1374294,1377567,+,3273
34,BUMA.1121.00009,2,462344,465635,+,3291
34,BUMA.1121.00094,2,1843620,1846911,+,3291
34,BUMA.1121.00101,2,1616382,1619655,-,3273
34,BUMA.1121.00066,2,1774926,1778200,+,3274
34,BUMA.1121.00095,2,2778853,2782126,-,3273
34,BUMA.1121.00112,2,2572183,2575456,-,3273
34,BUMA.1121.00042,2,562048,565321,-,3273
34,BUMA.1121.00032,2,1498777,1502050,+,3273
34,BUMA.1121.00090,2,2800179,2803470,+,3291
34,BUMA.1121.00020,2,991151,994424,+,3273
34,BUMA.1121.00089,2,1788828,1792119,+,3291
34,BUMA.1121.00051,2,1802350,1805623,+,3273
34,BUMA.1121.00001,2,397682,400973,-,3291
34,BUMA.1121.00045,2,1688394,1691667,+,3273
34,BUMA.1121.00043,2,498918,502209,-,3291
34,BUMA.1121.00063,2,1789217,1792493,+,3276
34,BUMA.1121.00079,2,1801526,1804799,+,3273
34,BUMA.1121.00071,2,1790578,1793848,+,3270
34,BUMA.1121.00086,2,1373347,1376620,+,3273
34,BUMA.1121.00024,2,1126220,1129493,+,3273
34,BUMA.1121.00010,2,296898,300143,-,3245
34,BUMA.1121.00040,2,844934,848207,-,3273
34,BUMA.1121.00093,2,1135309,1138600,-,3291
34,BUMA.1121.00091,2,1830509,1833782,-,3273
34,BUMA.1121.00107,2,2008611,2011884,-,3273
34,BUMA.1121.00088,2,1811945,1815236,+,3291
34,BUMA.1121.00047,2,2733711,2736984,+,3273
34,BUMA.1121.00019,2,991113,994386,+,3273
34,BUMA.1121.00019,2,1070271,1073544,+,3273
34,BUMA.1121.00087,2,1640747,1644020,+,3273
34,BUMA.1121.00039,2,2159937,2163228,-,3291
34,BUMA.1121.00030,2,1112263,1115536,-,3273
34,BUMA.1121.00016,2,1907957,1911248,-,3291
34,BUMA.1121.00092,2,1805944,1809235,+,3291
34,BUMA.1121.00085,2,459619,462892,+,3273
34,BUMA.1121.00046,2,1487594,1490867,-,3273
34,BUMA.1121.00003,2,2108139,2111412,-,3273
34,BUMA.1121.00054,2,1174408,1177681,+,3273
34,BUMA.1121.00015,2,877694,880967,-,3273
34,BUMA.1121.00105,2,621952,625225,-,3273
34,BUMA.1121.00052,2,1148166,1151439,+,3273
34,BUMA.1121.00053,2,2089093,2092366,+,3273
34,BUMA.1121.00057,2,296640,299931,-,3291
34,BUMA.1121.00108,2,2025482,2028773,+,3291
34,BUMA.1121.00050,2,926901,930174,-,3273
34,BUMA.1121.00104,2,1892895,1896186,+,3291
34,BUMA.1121.00014,2,1922048,1925339,+,3291
34,BUMA.1121.00036,2,625111,628384,+,3273
34,BUMA.1121.00038,2,1275455,1278728,+,3273
34,BUMA.1121.00098,2,2062150,2065423,+,3273
34,BUMA.1121.00078,2,1344615,1347906,-,3291
34,BUMA.1121.00029,2,2776098,2779389,-,3291
34,BUMA.1121.00099,2,2052210,2055501,+,3291
34,BUMA.1121.00103,2,348054,351345,+,3291
34,BUMA.1121.00102,2,1850912,1854185,+,3273
34,BUMA.1121.00028,2,1032369,1035642,+,3273
34,BUMA.1121.00075,2,2124437,2127728,+,3291
34,BUMA.1121.00044,2,1057362,1060635,+,3273
34,BUMA.1121.00076,2,2755200,2758491,+,3291
34,BUMA.1121.00074,2,2566719,2570010,-,3291
34,BUMA.1121.00073,2,1790562,1793842,+,3280
34,BUMA.1121.00083,2,458693,461984,+,3291
34,BUMA.1121.00035,2,2794660,2797951,-,3291
34,BUMA.1121.00072,2,1765508,1768786,+,3278
34,BUMA.1121.00056,2,2202190,2205481,-,3291
34,BUMA.1121.00081,2,945973,949246,-,3273
34,BUMA.1121.00033,2,2589851,2593142,+,3291
34,BUMA.1121.00061,2,1778096,1781374,+,3278
34,BUMA.1121.00062,2,3101885,3105158,-,3273
34,BUMA.1121.00064,2,1710993,1714284,+,3291
34,BUMA.1121.00060,2,558264,561537,-,3273
34,BUMA.1121.00069,2,1762874,1766153,+,3279
34,BUMA.1121.00070,2,1770090,1773366,+,3276
34,BUMA.1121.00068,2,379385,382658,+,3273
34,BUMA.1121.00067,2,2181236,2184509,-,3273
34,BUMA.1121.00037,2,2159720,2163011,+,3291
34,BUMA.1121.00065,2,1839563,1842854,+,3291
34,BUMA.1121.00058,2,2416652,2419925,+,3273
34,BUMA.1121.00041,2,2758475,2761748,+,3273
34,BUMA.1121.00084,2,515417,518708,+,3291
34,BUMA.1121.00096,2,2011036,2014327,+,3291
34,BUMA.1121.00080,2,1803314,1806587,+,3273
34,BUMA.1121.00013,2,1754894,1758167,+,3273
34,BUMA.1121.00100,2,2937256,2940528,+,3272
34,BUMA.1121.00012,2,3153308,3156599,-,3291
34,BUMA.1121.00018,2,2003755,2007046,-,3291
34,BUMA.1121.00048,2,1685335,1688608,-,3273
34,BUMA.1121.00106,2,3137733,3141024,-,3291
34,BUMA.1121.00017,2,1006237,1009510,+,3273
34,BUMA.1121.00082,2,1834786,1838077,+,3291
35,BUMA.1121.00049,2,472532,476938,+,4406
35,BUMA.1121.00055,2,853703,858153,-,4450
35,BUMA.1121.00011,2,434927,439333,+,4406
35,BUMA.1121.00110,2,1723754,1728160,+,4406
35,BUMA.1121.00109,2,2851110,2855500,-,4390
35,BUMA.1121.00077,2,1888185,1892591,-,4406
35,BUMA.1121.00027,2,2863816,2868222,+,4406
35,BUMA.1121.00026,2,1661907,1666313,+,4406
35,BUMA.1121.00021,2,2334790,2339240,+,4450
35,BUMA.1121.00023,2,1956216,1960666,+,4450
35,BUMA.1121.00022,2,579944,584350,+,4406
35,BUMA.1121.00034,2,1020477,1024883,+,4406
35,BUMA.1121.00025,2,339770,344220,+,4450
35,BUMA.1121.00031,2,1002056,1006506,+,4450
35,BUMA.1121.00007,2,1886402,1890850,+,4448
35,BUMA.1121.00097,2,1654639,1659084,+,4445
35,BUMA.1121.00008,2,1004633,1009039,+,4406
35,BUMA.1121.00059,2,1778610,1783016,-,4406
35,BUMA.1121.00002,2,1522699,1527105,-,4406
35,BUMA.1121.00004,2,1005333,1009739,+,4406
35,BUMA.1121.00005,2,2103770,2108176,-,4406
35,BUMA.1121.00111,2,1146271,1150721,+,4450
35,BUMA.1121.00006,2,1388521,1392927,+,4406
35,BUMA.1121.00009,2,476044,480494,+,4450
35,BUMA.1121.00094,2,1857504,1861954,+,4450
35,BUMA.1121.00101,2,1601478,1605884,-,4406
35,BUMA.1121.00066,2,1788258,1792708,+,4450
35,BUMA.1121.00095,2,612898,617348,+,4450
35,BUMA.1121.00112,2,2557293,2561699,-,4406
35,BUMA.1121.00042,2,419877,424283,-,4406
35,BUMA.1121.00032,2,1513032,1517438,+,4406
35,BUMA.1121.00090,2,2814070,2818520,+,4450
35,BUMA.1121.00020,2,1005370,1009776,+,4406
35,BUMA.1121.00089,2,1802724,1807174,+,4450
35,BUMA.1121.00051,2,1816158,1820608,+,4450
35,BUMA.1121.00001,2,382932,387382,-,4450
35,BUMA.1121.00045,2,1702189,1706639,+,4450
35,BUMA.1121.00043,2,483932,488382,-,4450
35,BUMA.1121.00063,2,1802546,1806996,+,4450
35,BUMA.1121.00079,2,1815303,1819753,+,4450
35,BUMA.1121.00071,2,1803872,1808322,+,4450
35,BUMA.1121.00086,2,1387602,1392008,+,4406
35,BUMA.1121.00024,2,1140439,1144845,+,4406
35,BUMA.1121.00010,2,281534,285940,-,4406
35,BUMA.1121.00040,2,829567,833973,-,4406
35,BUMA.1121.00093,2,1120726,1125132,-,4406
35,BUMA.1121.00091,2,1815899,1820305,-,4406
35,BUMA.1121.00107,2,1993887,1998332,-,4445
35,BUMA.1121.00088,2,1825506,1829912,+,4406
35,BUMA.1121.00047,2,2747575,2752025,+,4450
35,BUMA.1121.00019,2,1084493,1088899,+,4406
35,BUMA.1121.00087,2,1654993,1659399,+,4406
35,BUMA.1121.00039,2,2144962,2149412,-,4450
35,BUMA.1121.00030,2,1096911,1101317,-,4406
35,BUMA.1121.00016,2,1892939,1897389,-,4450
35,BUMA.1121.00092,2,1819412,1823818,+,4406
35,BUMA.1121.00085,2,473819,478225,+,4406
35,BUMA.1121.00046,2,197763,202169,+,4406
35,BUMA.1121.00003,2,53885,58330,+,4445
35,BUMA.1121.00054,2,1188640,1193046,+,4406
35,BUMA.1121.00015,2,862234,866640,-,4406
35,BUMA.1121.00105,2,607351,611757,-,4406
35,BUMA.1121.00052,2,1162366,1166772,+,4406
35,BUMA.1121.00053,2,2102867,2107273,+,4406
35,BUMA.1121.00057,2,282063,286513,-,4450
35,BUMA.1121.00108,2,2039303,2043748,+,4445
35,BUMA.1121.00050,2,911518,915924,-,4406
35,BUMA.1121.00104,2,1906713,1911119,+,4406
35,BUMA.1121.00014,2,1935874,1940324,+,4450
35,BUMA.1121.00036,2,639332,643738,+,4406
35,BUMA.1121.00038,2,1289687,1294093,+,4406
35,BUMA.1121.00098,2,2075870,2080276,+,4406
35,BUMA.1121.00078,2,1329615,1334021,-,4406
35,BUMA.1121.00029,2,2761343,2765793,-,4450
35,BUMA.1121.00099,2,2065983,2070433,+,4450
35,BUMA.1121.00103,2,361716,366166,+,4450
35,BUMA.1121.00102,2,1864822,1869272,+,4450
35,BUMA.1121.00028,2,1046588,1050994,+,4406
35,BUMA.1121.00075,2,1009257,1013663,-,4406
35,BUMA.1121.00044,2,1071581,1075987,+,4406
35,BUMA.1121.00076,2,2768768,2773174,+,4406
35,BUMA.1121.00074,2,2551851,2556257,-,4406
35,BUMA.1121.00073,2,1803970,1808376,+,4406
35,BUMA.1121.00083,2,472112,476562,+,4450
35,BUMA.1121.00035,2,2779903,2784353,-,4450
35,BUMA.1121.00072,2,1778756,1783206,+,4450
35,BUMA.1121.00056,2,2187135,2191585,-,4450
35,BUMA.1121.00081,2,930608,935014,-,4406
35,BUMA.1121.00033,2,2603645,2608095,+,4450
35,BUMA.1121.00061,2,1791442,1795848,+,4406
35,BUMA.1121.00062,2,3086908,3091314,-,4406
35,BUMA.1121.00064,2,1724461,1728867,+,4406
35,BUMA.1121.00060,2,543300,547750,-,4450
35,BUMA.1121.00069,2,1776239,1780645,+,4406
35,BUMA.1121.00070,2,1783404,1787841,+,4437
35,BUMA.1121.00068,2,392826,397232,+,4406
35,BUMA.1121.00067,2,2166304,2170710,-,4406
35,BUMA.1121.00037,2,2173582,2178032,+,4450
35,BUMA.1121.00065,2,1853391,1857797,+,4406
35,BUMA.1121.00058,2,2430292,2434742,+,4450
35,BUMA.1121.00041,2,2771993,2776442,+,4449
35,BUMA.1121.00084,2,528988,533394,+,4406
35,BUMA.1121.00096,2,2024767,2029218,+,4451
35,BUMA.1121.00080,2,1817071,1821521,+,4450
35,BUMA.1121.00013,2,1769134,1773540,+,4406
35,BUMA.1121.00100,2,2950934,2955340,+,4406
35,BUMA.1121.00012,2,3138631,3143081,-,4450
35,BUMA.1121.00018,2,1988698,1993148,-,4450
35,BUMA.1121.00048,2,1669972,1674378,-,4406
35,BUMA.1121.00106,2,1097450,1101856,+,4406
35,BUMA.1121.00017,2,1020456,1024862,+,4406
35,BUMA.1121.00082,2,1848205,1852655,+,4450
36,BUMA.1121.00049,2,476939,481632,+,4693
36,BUMA.1121.00055,2,848989,853701,-,4712
36,BUMA.1121.00011,2,439334,444027,+,4693
36,BUMA.1121.00110,2,1728161,1732873,+,4712
36,BUMA.1121.00109,2,2845505,2850202,-,4697
36,BUMA.1121.00077,2,1883471,1888183,-,4712
36,BUMA.1121.00027,2,2868223,2872903,+,4680
36,BUMA.1121.00026,2,1666314,1671026,+,4712
36,BUMA.1121.00021,2,2339241,2343934,+,4693
36,BUMA.1121.00023,2,1960667,1965360,+,4693
36,BUMA.1121.00022,2,584351,589063,+,4712
36,BUMA.1121.00034,2,1024884,1029596,+,4712
36,BUMA.1121.00025,2,344221,348896,+,4675
36,BUMA.1121.00031,2,1006507,1011200,+,4693
36,BUMA.1121.00007,2,1890851,1895563,+,4712
36,BUMA.1121.00097,2,1659085,1663766,+,4681
36,BUMA.1121.00008,2,1009040,1013752,+,4712
36,BUMA.1121.00059,2,1773927,1778608,-,4681
36,BUMA.1121.00002,2,1517985,1522697,-,4712
36,BUMA.1121.00004,2,1009740,1014452,+,4712
36,BUMA.1121.00005,2,2099087,2103768,-,4681
36,BUMA.1121.00111,2,1150722,1155415,+,4693
36,BUMA.1121.00006,2,1392928,1397649,+,4721
36,BUMA.1121.00009,2,480495,485188,+,4693
36,BUMA.1121.00094,2,1861955,1866637,+,4682
36,BUMA.1121.00101,2,1596783,1601476,-,4693
36,BUMA.1121.00066,2,1792709,1797415,+,4706
36,BUMA.1121.00095,2,617349,622030,+,4681
36,BUMA.1121.00112,2,2552587,2557291,-,4704
36,BUMA.1121.00042,2,415162,419875,-,4713
36,BUMA.1121.00032,2,1517439,1522151,+,4712
36,BUMA.1121.00090,2,2818521,2823214,+,4693
36,BUMA.1121.00020,2,1009777,1014489,+,4712
36,BUMA.1121.00089,2,1807175,1811857,+,4682
36,BUMA.1121.00051,2,1820609,1825290,+,4681
36,BUMA.1121.00001,2,378249,382930,-,4681
36,BUMA.1121.00045,2,1706640,1711333,+,4693
36,BUMA.1121.00043,2,479237,483930,-,4693
36,BUMA.1121.00063,2,1806997,1811703,+,4706
36,BUMA.1121.00079,2,1819754,1824435,+,4681
36,BUMA.1121.00071,2,1808323,1813030,+,4707
36,BUMA.1121.00086,2,1392009,1396721,+,4712
36,BUMA.1121.00024,2,1144846,1149558,+,4712
36,BUMA.1121.00010,2,276820,281532,-,4712
36,BUMA.1121.00040,2,824853,829565,-,4712
36,BUMA.1121.00093,2,1116043,1120724,-,4681
36,BUMA.1121.00091,2,1811216,1815897,-,4681
36,BUMA.1121.00107,2,1989173,1993885,-,4712
36,BUMA.1121.00088,2,1829913,1834594,+,4681
36,BUMA.1121.00047,2,2752026,2756708,+,4682
36,BUMA.1121.00019,2,1088900,1093612,+,4712
36,BUMA.1121.00087,2,1659400,1664112,+,4712
36,BUMA.1121.00039,2,2140267,2144960,-,4693
36,BUMA.1121.00030,2,1092197,1096909,-,4712
36,BUMA.1121.00016,2,1888256,1892937,-,4681
36,BUMA.1121.00092,2,1823819,1828500,+,4681
36,BUMA.1121.00085,2,478226,482938,+,4712
36,BUMA.1121.00046,2,202170,206891,+,4721
36,BUMA.1121.00003,2,58331,63023,+,4692
36,BUMA.1121.00054,2,1193047,1197768,+,4721
36,BUMA.1121.00015,2,857512,862232,-,4720
36,BUMA.1121.00105,2,602656,607349,-,4693
36,BUMA.1121.00052,2,1166773,1171485,+,4712
36,BUMA.1121.00053,2,2107274,2111967,+,4693
36,BUMA.1121.00057,2,277349,282061,-,4712
36,BUMA.1121.00108,2,2043749,2048461,+,4712
36,BUMA.1121.00050,2,906796,911516,-,4720
36,BUMA.1121.00104,2,1911120,1915832,+,4712
36,BUMA.1121.00014,2,1940325,1945018,+,4693
36,BUMA.1121.00036,2,643739,648451,+,4712
36,BUMA.1121.00038,2,1294094,1298815,+,4721
36,BUMA.1121.00098,2,2080277,2084958,+,4681
36,BUMA.1121.00078,2,1324920,1329613,-,4693
36,BUMA.1121.00029,2,2756660,2761341,-,4681
36,BUMA.1121.00099,2,2070434,2075115,+,4681
36,BUMA.1121.00103,2,366167,370860,+,4693
36,BUMA.1121.00102,2,1869273,1873966,+,4693
36,BUMA.1121.00028,2,1050995,1055707,+,4712
36,BUMA.1121.00075,2,1004563,1009255,-,4692
36,BUMA.1121.00044,2,1075988,1080700,+,4712
36,BUMA.1121.00076,2,2773175,2777868,+,4693
36,BUMA.1121.00074,2,2547168,2551849,-,4681
36,BUMA.1121.00073,2,1808377,1813084,+,4707
36,BUMA.1121.00083,2,476563,481275,+,4712
36,BUMA.1121.00035,2,2775220,2779901,-,4681
36,BUMA.1121.00072,2,1783207,1787913,+,4706
36,BUMA.1121.00056,2,2182451,2187133,-,4682
36,BUMA.1121.00081,2,925886,930606,-,4720
36,BUMA.1121.00033,2,2608096,2612789,+,4693
36,BUMA.1121.00061,2,1795849,1800555,+,4706
36,BUMA.1121.00062,2,3082225,3086906,-,4681
36,BUMA.1121.00064,2,1728868,1733549,+,4681
36,BUMA.1121.00060,2,538605,543298,-,4693
36,BUMA.1121.00069,2,1780646,1785351,+,4705
36,BUMA.1121.00070,2,1787842,1792550,+,4708
36,BUMA.1121.00068,2,397233,401926,+,4693
36,BUMA.1121.00067,2,2161621,2166302,-,4681
36,BUMA.1121.00037,2,2178033,2182726,+,4693
36,BUMA.1121.00065,2,1857798,1862492,+,4694
36,BUMA.1121.00058,2,2434743,2439423,+,4680
36,BUMA.1121.00041,2,2776443,2781136,+,4693
36,BUMA.1121.00084,2,533395,538076,+,4681
36,BUMA.1121.00096,2,2029219,2033883,+,4664
36,BUMA.1121.00080,2,1821522,1826204,+,4682
36,BUMA.1121.00013,2,1773541,1778253,+,4712
36,BUMA.1121.00100,2,2955341,2960034,+,4693
36,BUMA.1121.00012,2,3133936,3138629,-,4693
36,BUMA.1121.00018,2,1984021,1988696,-,4675
36,BUMA.1121.00048,2,1665250,1669970,-,4720
36,BUMA.1121.00106,2,1101857,1106538,+,4681
36,BUMA.1121.00017,2,1024863,1029575,+,4712
36,BUMA.1121.00082,2,1852656,1857368,+,4712
79,BUMA.1121.00049,2,1147488,1152303,+,4815
79,BUMA.1121.00055,2,168074,172831,-,4757
79,BUMA.1121.00011,2,1122289,1127109,+,4820
79,BUMA.1121.00110,2,2467271,2472018,+,4747
79,BUMA.1121.00109,2,2119293,2124070,-,4777
79,BUMA.1121.00077,2,1143934,1148682,-,4748
79,BUMA.1121.00027,2,422970,427702,+,4732
79,BUMA.1121.00026,2,486511,491279,+,4768
79,BUMA.1121.00021,2,3001313,3006082,+,4769
79,BUMA.1121.00023,2,2643167,2647924,+,4757
79,BUMA.1121.00022,2,1768625,1773394,-,4769
79,BUMA.1121.00034,2,1880603,1885357,+,4754
79,BUMA.1121.00025,2,1031791,1036546,+,4755
79,BUMA.1121.00031,2,1688195,1692948,+,4753
79,BUMA.1121.00007,2,2628635,2633412,+,4777
79,BUMA.1121.00097,2,2341038,2345757,+,4719
79,BUMA.1121.00008,2,1864818,1869586,+,4768
79,BUMA.1121.00059,2,1092032,1096790,-,4758
79,BUMA.1121.00002,2,343170,347958,+,4788
79,BUMA.1121.00004,2,1865271,1870039,+,4768
79,BUMA.1121.00005,2,1415830,1420575,-,4745
79,BUMA.1121.00111,2,1835407,1840186,+,4779
79,BUMA.1121.00006,2,2096431,2101199,+,4768
79,BUMA.1121.00009,2,1164887,1169634,+,4747
79,BUMA.1121.00094,2,2544359,2549111,+,4752
79,BUMA.1121.00101,2,904646,909364,-,4718
79,BUMA.1121.00066,2,2473327,2478059,+,4732
79,BUMA.1121.00095,2,1368828,1373604,+,4776
79,BUMA.1121.00112,2,1862835,1867577,-,4742
79,BUMA.1121.00042,2,1823898,1828667,-,4769
79,BUMA.1121.00032,2,305650,310418,+,4768
79,BUMA.1121.00090,2,242755,247500,+,4745
79,BUMA.1121.00020,2,1865540,1870308,+,4768
79,BUMA.1121.00089,2,2490169,2494921,+,4752
79,BUMA.1121.00051,2,2503422,2508198,+,4776
79,BUMA.1121.00001,2,2896534,2901315,-,4781
79,BUMA.1121.00045,2,2387044,2391781,+,4737
79,BUMA.1121.00043,2,3051853,3056623,-,4770
79,BUMA.1121.00063,2,2482622,2487354,+,4732
79,BUMA.1121.00079,2,2503773,2508615,+,4842
79,BUMA.1121.00071,2,2489448,2494180,+,4732
79,BUMA.1121.00086,2,223481,228250,-,4769
79,BUMA.1121.00024,2,2000472,2005240,+,4768
79,BUMA.1121.00010,2,1195198,1199962,+,4764
79,BUMA.1121.00040,2,183487,188256,-,4769
79,BUMA.1121.00093,2,427295,432063,-,4768
79,BUMA.1121.00091,2,1125839,1130680,-,4841
79,BUMA.1121.00107,2,1285877,1290599,-,4722
79,BUMA.1121.00088,2,2514872,2519591,+,4719
79,BUMA.1121.00047,2,318027,322803,+,4776
79,BUMA.1121.00019,2,1944685,1949453,+,4768
79,BUMA.1121.00087,2,375014,379782,+,4768
79,BUMA.1121.00039,2,1459239,1464012,-,4773
79,BUMA.1121.00030,2,236646,241415,-,4769
79,BUMA.1121.00016,2,1202851,1207597,-,4746
79,BUMA.1121.00092,2,2505900,2510667,+,4767
79,BUMA.1121.00085,2,1386505,1391274,-,4769
79,BUMA.1121.00046,2,1239115,1243884,-,4769
79,BUMA.1121.00003,2,748237,752886,+,4649
79,BUMA.1121.00054,2,1896544,1901312,+,4768
79,BUMA.1121.00015,2,474568,479337,-,4769
79,BUMA.1121.00105,2,3125283,3130005,-,4722
79,BUMA.1121.00052,2,340164,344933,-,4769
79,BUMA.1121.00053,2,2791885,2796590,+,4705
79,BUMA.1121.00057,2,2731155,2735888,-,4733
79,BUMA.1121.00108,2,2751524,2756241,+,4717
79,BUMA.1121.00050,2,2191262,2196030,+,4768
79,BUMA.1121.00104,2,2594537,2599282,+,4745
79,BUMA.1121.00014,2,2622837,2627607,+,4770
79,BUMA.1121.00036,2,1434983,1439751,+,4768
79,BUMA.1121.00038,2,1997646,2002414,+,4768
79,BUMA.1121.00098,2,2763788,2768564,+,4776
79,BUMA.1121.00078,2,628059,632901,-,4842
79,BUMA.1121.00029,2,2015020,2019801,-,4781
79,BUMA.1121.00099,2,2749962,2754775,+,4813
79,BUMA.1121.00103,2,1145455,1150224,+,4769
79,BUMA.1121.00102,2,2535033,2539798,+,4765
79,BUMA.1121.00028,2,1906713,1911481,+,4768
79,BUMA.1121.00075,2,331746,336499,-,4753
79,BUMA.1121.00044,2,1931486,1936254,+,4768
79,BUMA.1121.00076,2,260943,265696,+,4753
79,BUMA.1121.00074,2,1864387,1869203,-,4816
79,BUMA.1121.00073,2,2489557,2494289,+,4732
79,BUMA.1121.00083,2,1159839,1164571,+,4732
79,BUMA.1121.00035,2,2092709,2097490,-,4781
79,BUMA.1121.00072,2,2464029,2468754,+,4725
79,BUMA.1121.00056,2,1496776,1501529,-,4753
79,BUMA.1121.00081,2,222319,227088,-,4769
79,BUMA.1121.00033,2,58440,63185,+,4745
79,BUMA.1121.00061,2,2472666,2477396,+,4730
79,BUMA.1121.00062,2,2399771,2404612,-,4841
79,BUMA.1121.00064,2,2411043,2415858,+,4815
79,BUMA.1121.00060,2,2873323,2878061,-,4738
79,BUMA.1121.00069,2,2455466,2460198,+,4732
79,BUMA.1121.00070,2,2468895,2473627,+,4732
79,BUMA.1121.00068,2,1095493,1100220,+,4727
79,BUMA.1121.00067,2,1419597,1424350,-,4753
79,BUMA.1121.00037,2,2857574,2862325,+,4751
79,BUMA.1121.00065,2,2578546,2583283,+,4737
79,BUMA.1121.00058,2,3112656,3117411,+,4755
79,BUMA.1121.00041,2,236163,240944,+,4781
79,BUMA.1121.00084,2,1219767,1224582,+,4815
79,BUMA.1121.00096,2,2819386,2824151,+,4765
79,BUMA.1121.00080,2,2559874,2564650,+,4776
79,BUMA.1121.00013,2,652948,657717,-,4769
79,BUMA.1121.00100,2,534722,539502,+,4780
79,BUMA.1121.00012,2,2422339,2427085,-,4746
79,BUMA.1121.00018,2,1296386,1301142,-,4756
79,BUMA.1121.00048,2,961768,966537,-,4769
79,BUMA.1121.00106,2,1785090,1789794,+,4704
79,BUMA.1121.00017,2,1880585,1885353,+,4768
79,BUMA.1121.00082,2,2535923,2540655,+,4732
80,BUMA.1121.00049,2,1152516,1155799,+,3283
80,BUMA.1121.00055,2,164582,167862,-,3280
80,BUMA.1121.00011,2,1127322,1130602,+,3280
80,BUMA.1121.00110,2,2472231,2475514,+,3283
80,BUMA.1121.00109,2,2115798,2119081,-,3283
80,BUMA.1121.00077,2,1140439,1143722,-,3283
80,BUMA.1121.00027,2,427915,431198,+,3283
80,BUMA.1121.00026,2,491492,494775,+,3283
80,BUMA.1121.00021,2,3006295,3009575,+,3280
80,BUMA.1121.00023,2,2648137,2651417,+,3280
80,BUMA.1121.00022,2,1765130,1768413,-,3283
80,BUMA.1121.00034,2,1885570,1888853,+,3283
80,BUMA.1121.00025,2,1036759,1040039,+,3280
80,BUMA.1121.00031,2,1693161,1696441,+,3280
80,BUMA.1121.00007,2,2633625,2636908,+,3283
80,BUMA.1121.00097,2,2345970,2349253,+,3283
80,BUMA.1121.00008,2,1869799,1873082,+,3283
80,BUMA.1121.00059,2,1088540,1091820,-,3280
80,BUMA.1121.00002,2,348171,351454,+,3283
80,BUMA.1121.00004,2,1870252,1873535,+,3283
80,BUMA.1121.00005,2,1412335,1415618,-,3283
80,BUMA.1121.00111,2,1840399,1843679,+,3280
80,BUMA.1121.00006,2,2101412,2104695,+,3283
80,BUMA.1121.00009,2,1169847,1173130,+,3283
80,BUMA.1121.00094,2,2549324,2552607,+,3283
80,BUMA.1121.00101,2,901151,904434,-,3283
80,BUMA.1121.00066,2,2478272,2481555,+,3283
80,BUMA.1121.00095,2,1373817,1377100,+,3283
80,BUMA.1121.00112,2,1859340,1862623,-,3283
80,BUMA.1121.00042,2,1820412,1823695,-,3283
80,BUMA.1121.00032,2,310631,313914,+,3283
80,BUMA.1121.00090,2,247729,250993,+,3264
80,BUMA.1121.00020,2,1870521,1873804,+,3283
80,BUMA.1121.00089,2,2495134,2498417,+,3283
80,BUMA.1121.00051,2,2508411,2511694,+,3283
80,BUMA.1121.00001,2,2893039,2896322,-,3283
80,BUMA.1121.00045,2,2391994,2395277,+,3283
80,BUMA.1121.00043,2,3048358,3051641,-,3283
80,BUMA.1121.00063,2,2487567,2490850,+,3283
80,BUMA.1121.00079,2,2508828,2512111,+,3283
80,BUMA.1121.00071,2,2494393,2497676,+,3283
80,BUMA.1121.00086,2,219986,223269,-,3283
80,BUMA.1121.00024,2,2005453,2008736,+,3283
80,BUMA.1121.00010,2,1200175,1203458,+,3283
80,BUMA.1121.00040,2,179992,183275,-,3283
80,BUMA.1121.00093,2,423800,427083,-,3283
80,BUMA.1121.00091,2,1122344,1125627,-,3283
80,BUMA.1121.00107,2,1282382,1285665,-,3283
80,BUMA.1121.00088,2,2519804,2523087,+,3283
80,BUMA.1121.00047,2,323016,326299,+,3283
80,BUMA.1121.00019,2,1949666,1952949,+,3283
80,BUMA.1121.00087,2,379995,383278,+,3283
80,BUMA.1121.00039,2,1455744,1459027,-,3283
80,BUMA.1121.00030,2,233151,236434,-,3283
80,BUMA.1121.00016,2,1199359,1202639,-,3280
80,BUMA.1121.00092,2,2510880,2514163,+,3283
80,BUMA.1121.00085,2,1383010,1386293,-,3283
80,BUMA.1121.00046,2,1235620,1238903,-,3283
80,BUMA.1121.00003,2,753099,756382,+,3283
80,BUMA.1121.00054,2,1901525,1904808,+,3283
80,BUMA.1121.00015,2,471073,474356,-,3283
80,BUMA.1121.00105,2,3121791,3125071,-,3280
80,BUMA.1121.00052,2,336669,339952,-,3283
80,BUMA.1121.00053,2,2796803,2800086,+,3283
80,BUMA.1121.00057,2,2727663,2730943,-,3280
80,BUMA.1121.00108,2,2756454,2759737,+,3283
80,BUMA.1121.00050,2,2196243,2199526,+,3283
80,BUMA.1121.00104,2,2599495,2602778,+,3283
80,BUMA.1121.00014,2,2627820,2631103,+,3283
80,BUMA.1121.00036,2,1439964,1443247,+,3283
80,BUMA.1121.00038,2,2002627,2005910,+,3283
80,BUMA.1121.00098,2,2768777,2772060,+,3283
80,BUMA.1121.00078,2,624564,627847,-,3283
80,BUMA.1121.00029,2,2011525,2014808,-,3283
80,BUMA.1121.00099,2,2754988,2758268,+,3280
80,BUMA.1121.00103,2,1150437,1153720,+,3283
80,BUMA.1121.00102,2,2540011,2543294,+,3283
80,BUMA.1121.00028,2,1911694,1914977,+,3283
80,BUMA.1121.00075,2,328251,331534,-,3283
80,BUMA.1121.00044,2,1936467,1939750,+,3283
80,BUMA.1121.00076,2,265909,269192,+,3283
80,BUMA.1121.00074,2,1860892,1864175,-,3283
80,BUMA.1121.00073,2,2494502,2497785,+,3283
80,BUMA.1121.00083,2,1164784,1168067,+,3283
80,BUMA.1121.00035,2,2089214,2092497,-,3283
80,BUMA.1121.00072,2,2468967,2472250,+,3283
80,BUMA.1121.00056,2,1493281,1496564,-,3283
80,BUMA.1121.00081,2,218824,222107,-,3283
80,BUMA.1121.00033,2,63398,66678,+,3280
80,BUMA.1121.00061,2,2477609,2480892,+,3283
80,BUMA.1121.00062,2,2396276,2399559,-,3283
80,BUMA.1121.00064,2,2416071,2419354,+,3283
80,BUMA.1121.00060,2,2869828,2873111,-,3283
80,BUMA.1121.00069,2,2460411,2463694,+,3283
80,BUMA.1121.00070,2,2473840,2477123,+,3283
80,BUMA.1121.00068,2,1100433,1103716,+,3283
80,BUMA.1121.00067,2,1416105,1419385,-,3280
80,BUMA.1121.00037,2,2862538,2865818,+,3280
80,BUMA.1121.00065,2,2583496,2586779,+,3283
80,BUMA.1121.00058,2,3117624,3120904,+,3280
80,BUMA.1121.00041,2,241157,244440,+,3283
80,BUMA.1121.00084,2,1224795,1228078,+,3283
80,BUMA.1121.00096,2,2824364,2827647,+,3283
80,BUMA.1121.00080,2,2564863,2568146,+,3283
80,BUMA.1121.00013,2,649453,652736,-,3283
80,BUMA.1121.00100,2,539715,542998,+,3283
80,BUMA.1121.00012,2,2418844,2422127,-,3283
80,BUMA.1121.00018,2,1292894,1296174,-,3280
80,BUMA.1121.00048,2,958273,961556,-,3283
80,BUMA.1121.00106,2,1790007,1793290,+,3283
80,BUMA.1121.00017,2,1885566,1888849,+,3283
80,BUMA.1121.00082,2,2540868,2544151,+,3283
81,BUMA.1121.00049,2,1158230,1163595,+,5365
81,BUMA.1121.00055,2,156820,162169,-,5349
81,BUMA.1121.00011,2,1133015,1138344,+,5329
81,BUMA.1121.00110,2,2477948,2483306,+,5358
81,BUMA.1121.00109,2,2108013,2113385,-,5372
81,BUMA.1121.00077,2,1132646,1138005,-,5359
81,BUMA.1121.00027,2,433629,438988,+,5359
81,BUMA.1121.00026,2,497206,502547,+,5341
81,BUMA.1121.00021,2,3012006,3017401,+,5395
81,BUMA.1121.00023,2,2653848,2659249,+,5401
81,BUMA.1121.00022,2,1757357,1762699,-,5342
81,BUMA.1121.00034,2,1891284,1896625,+,5341
81,BUMA.1121.00025,2,1042470,1047841,+,5371
81,BUMA.1121.00031,2,1698872,1704259,+,5387
81,BUMA.1121.00007,2,2639339,2644686,+,5347
81,BUMA.1121.00097,2,2351687,2357064,+,5377
81,BUMA.1121.00008,2,1875513,1880854,+,5341
81,BUMA.1121.00059,2,1080737,1086109,-,5372
81,BUMA.1121.00002,2,353885,359226,+,5341
81,BUMA.1121.00004,2,1875966,1881307,+,5341
81,BUMA.1121.00005,2,1404563,1409904,-,5341
81,BUMA.1121.00111,2,1846110,1851476,+,5366
81,BUMA.1121.00006,2,2107126,2112467,+,5341
81,BUMA.1121.00009,2,1175543,1180890,+,5347
81,BUMA.1121.00094,2,2555038,2560391,+,5353
81,BUMA.1121.00101,2,893386,898732,-,5346
81,BUMA.1121.00066,2,2483986,2489327,+,5341
81,BUMA.1121.00095,2,1379509,1384863,+,5354
81,BUMA.1121.00112,2,1851561,1856909,-,5348
81,BUMA.1121.00042,2,1812645,1817981,-,5336
81,BUMA.1121.00032,2,316345,321686,+,5341
81,BUMA.1121.00090,2,253424,258795,+,5371
81,BUMA.1121.00020,2,1876235,1881576,+,5341
81,BUMA.1121.00089,2,2500848,2506195,+,5347
81,BUMA.1121.00051,2,2514125,2519472,+,5347
81,BUMA.1121.00001,2,2885248,2890608,-,5360
81,BUMA.1121.00045,2,2397690,2403037,+,5347
81,BUMA.1121.00043,2,3040555,3045927,-,5372
81,BUMA.1121.00063,2,2493281,2498622,+,5341
81,BUMA.1121.00079,2,2514542,2519889,+,5347
81,BUMA.1121.00071,2,2500107,2505448,+,5341
81,BUMA.1121.00086,2,212213,217555,-,5342
81,BUMA.1121.00024,2,2011167,2016508,+,5341
81,BUMA.1121.00010,2,1205889,1211230,+,5341
81,BUMA.1121.00040,2,172219,177561,-,5342
81,BUMA.1121.00093,2,415997,421369,-,5372
81,BUMA.1121.00091,2,1114547,1119913,-,5366
81,BUMA.1121.00107,2,1274605,1279947,-,5342
81,BUMA.1121.00088,2,2525518,2530877,+,5359
81,BUMA.1121.00047,2,328730,334077,+,5347
81,BUMA.1121.00019,2,1955380,1960721,+,5341
81,BUMA.1121.00087,2,385709,391050,+,5341
81,BUMA.1121.00039,2,1447947,1453313,-,5366
81,BUMA.1121.00030,2,225379,230721,-,5342
81,BUMA.1121.00016,2,1191538,1196928,-,5390
81,BUMA.1121.00092,2,2516594,2521965,+,5371
81,BUMA.1121.00085,2,1375237,1380579,-,5342
81,BUMA.1121.00046,2,1227847,1233189,-,5342
81,BUMA.1121.00003,2,758819,764130,+,5311
81,BUMA.1121.00054,2,1907239,1912580,+,5341
81,BUMA.1121.00015,2,463300,468642,-,5342
81,BUMA.1121.00105,2,3114000,3119360,-,5360
81,BUMA.1121.00052,2,328896,334238,-,5342
81,BUMA.1121.00053,2,2802532,2807873,+,5341
81,BUMA.1121.00057,2,2719890,2725232,-,5342
81,BUMA.1121.00108,2,2762168,2767515,+,5347
81,BUMA.1121.00050,2,2201957,2207298,+,5341
81,BUMA.1121.00104,2,2605209,2610616,+,5407
81,BUMA.1121.00014,2,2633534,2638917,+,5383
81,BUMA.1121.00036,2,1445678,1451019,+,5341
81,BUMA.1121.00038,2,2008341,2013682,+,5341
81,BUMA.1121.00098,2,2774491,2779823,+,5332
81,BUMA.1121.00078,2,616788,622154,-,5366
81,BUMA.1121.00029,2,2003734,2009094,-,5360
81,BUMA.1121.00099,2,2760681,2766028,+,5347
81,BUMA.1121.00103,2,1156132,1161464,+,5332
81,BUMA.1121.00102,2,2545725,2551066,+,5341
81,BUMA.1121.00028,2,1917408,1922749,+,5341
81,BUMA.1121.00075,2,320460,325820,-,5360
81,BUMA.1121.00044,2,1942181,1947522,+,5341
81,BUMA.1121.00076,2,271623,276982,+,5359
81,BUMA.1121.00074,2,1853095,1858461,-,5366
81,BUMA.1121.00073,2,2500216,2505557,+,5341
81,BUMA.1121.00083,2,1170498,1175839,+,5341
81,BUMA.1121.00035,2,2081423,2086783,-,5360
81,BUMA.1121.00072,2,2474681,2480022,+,5341
81,BUMA.1121.00056,2,1485502,1490850,-,5348
81,BUMA.1121.00081,2,211051,216393,-,5342
81,BUMA.1121.00033,2,69109,74474,+,5365
81,BUMA.1121.00061,2,2483323,2488664,+,5341
81,BUMA.1121.00062,2,2388497,2393845,-,5348
81,BUMA.1121.00064,2,2421785,2427162,+,5377
81,BUMA.1121.00060,2,2862067,2867415,-,5348
81,BUMA.1121.00069,2,2466113,2471454,+,5341
81,BUMA.1121.00070,2,2479554,2484895,+,5341
81,BUMA.1121.00068,2,1106147,1111524,+,5377
81,BUMA.1121.00067,2,1408320,1413692,-,5372
81,BUMA.1121.00037,2,2868249,2873608,+,5359
81,BUMA.1121.00065,2,2589210,2594551,+,5341
81,BUMA.1121.00058,2,3123317,3128665,+,5348
81,BUMA.1121.00041,2,246871,252236,+,5365
81,BUMA.1121.00084,2,1230509,1235868,+,5359
81,BUMA.1121.00096,2,2830060,2835392,+,5332
81,BUMA.1121.00080,2,2570576,2575923,+,5347
81,BUMA.1121.00013,2,641680,647022,-,5342
81,BUMA.1121.00100,2,545429,550792,+,5363
81,BUMA.1121.00012,2,2411053,2416413,-,5360
81,BUMA.1121.00018,2,1285091,1290463,-,5372
81,BUMA.1121.00048,2,950500,955842,-,5342
81,BUMA.1121.00106,2,1795721,1801080,+,5359
81,BUMA.1121.00017,2,1891280,1896621,+,5341
81,BUMA.1121.00082,2,2546582,2551923,+,5341
82,BUMA.1121.00049,2,1168532,1181197,+,12665
82,BUMA.1121.00055,2,139155,151868,-,12713
82,BUMA.1121.00011,2,1143280,1155946,+,12666
82,BUMA.1121.00110,2,2488259,2500923,+,12664
82,BUMA.1121.00109,2,2090400,2103087,-,12687
82,BUMA.1121.00077,2,1115032,1127696,-,12664
82,BUMA.1121.00027,2,443902,456566,+,12664
82,BUMA.1121.00026,2,507500,520163,+,12663
82,BUMA.1121.00021,2,3022339,3035001,+,12662
82,BUMA.1121.00023,2,2664187,2676852,+,12665
82,BUMA.1121.00022,2,1739742,1752405,-,12663
82,BUMA.1121.00034,2,1901578,1914241,+,12663
82,BUMA.1121.00025,2,1052779,1065441,+,12662
82,BUMA.1121.00031,2,1709197,1721871,+,12674
82,BUMA.1121.00007,2,2649589,2662245,+,12656
82,BUMA.1121.00097,2,2361974,2374670,+,12696
82,BUMA.1121.00008,2,1885807,1898470,+,12663
82,BUMA.1121.00059,2,1061801,1074486,-,12685
82,BUMA.1121.00002,2,364179,376842,+,12663
82,BUMA.1121.00004,2,1886260,1898923,+,12663
82,BUMA.1121.00005,2,1386928,1399611,-,12683
82,BUMA.1121.00111,2,1856414,1869088,+,12674
82,BUMA.1121.00006,2,2117420,2130083,+,12663
82,BUMA.1121.00009,2,1185802,1198468,+,12666
82,BUMA.1121.00094,2,2565328,2578011,+,12683
82,BUMA.1121.00101,2,875796,888462,-,12666
82,BUMA.1121.00066,2,2494227,2506757,+,12530
82,BUMA.1121.00095,2,1389791,1402473,+,12682
82,BUMA.1121.00112,2,1833937,1846624,-,12687
82,BUMA.1121.00042,2,1795030,1807693,-,12663
82,BUMA.1121.00032,2,326639,339302,+,12663
82,BUMA.1121.00090,2,263733,276395,+,12662
82,BUMA.1121.00020,2,1886529,1899192,+,12663
82,BUMA.1121.00089,2,2511137,2523823,+,12686
82,BUMA.1121.00051,2,2524414,2537100,+,12686
82,BUMA.1121.00001,2,2867649,2880311,-,12662
82,BUMA.1121.00045,2,2407990,2420677,+,12687
82,BUMA.1121.00043,2,3022957,3035643,-,12686
82,BUMA.1121.00063,2,2503534,2516197,+,12663
82,BUMA.1121.00079,2,2524831,2537516,+,12685
82,BUMA.1121.00071,2,2510347,2523011,+,12664
82,BUMA.1121.00086,2,194598,207261,-,12663
82,BUMA.1121.00024,2,2021461,2034124,+,12663
82,BUMA.1121.00010,2,1216183,1228846,+,12663
82,BUMA.1121.00040,2,154604,167267,-,12663
82,BUMA.1121.00093,2,398371,411055,-,12684
82,BUMA.1121.00091,2,1096911,1109595,-,12684
82,BUMA.1121.00107,2,1257004,1269668,-,12664
82,BUMA.1121.00088,2,2535814,2548476,+,12662
82,BUMA.1121.00047,2,339019,351705,+,12686
82,BUMA.1121.00019,2,1965674,1978337,+,12663
82,BUMA.1121.00087,2,396003,408666,+,12663
82,BUMA.1121.00039,2,1430345,1443010,-,12665
82,BUMA.1121.00030,2,207764,220427,-,12663
82,BUMA.1121.00016,2,1173939,1186601,-,12662
82,BUMA.1121.00092,2,2526908,2539592,+,12684
82,BUMA.1121.00085,2,1357622,1370285,-,12663
82,BUMA.1121.00046,2,1210232,1222895,-,12663
82,BUMA.1121.00003,2,769043,781729,+,12686
82,BUMA.1121.00054,2,1917533,1930196,+,12663
82,BUMA.1121.00015,2,445685,458348,-,12663
82,BUMA.1121.00105,2,3096362,3109048,-,12686
82,BUMA.1121.00052,2,311281,323944,-,12663
82,BUMA.1121.00053,2,2812811,2825497,+,12686
82,BUMA.1121.00057,2,2702315,2714979,-,12664
82,BUMA.1121.00108,2,2772443,2785130,+,12687
82,BUMA.1121.00050,2,2212251,2224914,+,12663
82,BUMA.1121.00104,2,2615553,2628219,+,12666
82,BUMA.1121.00014,2,2643855,2656517,+,12662
82,BUMA.1121.00036,2,1455972,1468635,+,12663
82,BUMA.1121.00038,2,2018635,2031298,+,12663
82,BUMA.1121.00098,2,2784761,2797425,+,12664
82,BUMA.1121.00078,2,599173,611839,-,12666
82,BUMA.1121.00029,2,1986135,1998797,-,12662
82,BUMA.1121.00099,2,2770966,2783654,+,12688
82,BUMA.1121.00103,2,1166377,1179065,+,12688
82,BUMA.1121.00102,2,2556004,2568690,+,12686
82,BUMA.1121.00028,2,1927702,1940365,+,12663
82,BUMA.1121.00075,2,302872,315559,-,12687
82,BUMA.1121.00044,2,1952475,1965138,+,12663
82,BUMA.1121.00076,2,281884,294571,+,12687
82,BUMA.1121.00074,2,1834170,1846855,-,12685
82,BUMA.1121.00073,2,2510469,2523132,+,12663
82,BUMA.1121.00083,2,1180751,1193415,+,12664
82,BUMA.1121.00035,2,2063824,2076486,-,12662
82,BUMA.1121.00072,2,2484934,2497598,+,12664
82,BUMA.1121.00056,2,1467875,1480561,-,12686
82,BUMA.1121.00081,2,193436,206099,-,12663
82,BUMA.1121.00033,2,79412,92104,+,12692
82,BUMA.1121.00061,2,2493576,2506238,+,12662
82,BUMA.1121.00062,2,2370859,2383545,-,12686
82,BUMA.1121.00064,2,2433403,2446088,+,12685
82,BUMA.1121.00060,2,2844428,2857115,-,12687
82,BUMA.1121.00069,2,2476366,2489029,+,12663
82,BUMA.1121.00070,2,2489807,2502471,+,12664
82,BUMA.1121.00068,2,1116452,1129137,+,12685
82,BUMA.1121.00067,2,1389395,1402080,-,12685
82,BUMA.1121.00037,2,2878546,2891208,+,12662
82,BUMA.1121.00065,2,2599501,2612189,+,12688
82,BUMA.1121.00058,2,3133618,3146301,+,12683
82,BUMA.1121.00041,2,257174,269861,+,12687
82,BUMA.1121.00084,2,1240780,1253464,+,12684
82,BUMA.1121.00096,2,2840330,2853013,+,12683
82,BUMA.1121.00080,2,2580865,2593551,+,12686
82,BUMA.1121.00013,2,624065,636728,-,12663
82,BUMA.1121.00100,2,555720,568407,+,12687
82,BUMA.1121.00012,2,2393478,2406152,-,12674
82,BUMA.1121.00018,2,1267492,1280154,-,12662
82,BUMA.1121.00048,2,932885,945548,-,12663
82,BUMA.1121.00106,2,1806017,1818701,+,12684
82,BUMA.1121.00017,2,1901574,1914237,+,12663
82,BUMA.1121.00082,2,2556835,2569499,+,12664
83,BUMA.1121.00049,2,1181239,1184767,+,3528
83,BUMA.1121.00055,2,135585,139113,-,3528
83,BUMA.1121.00011,2,1155988,1159516,+,3528
83,BUMA.1121.00110,2,2500965,2504499,+,3534
83,BUMA.1121.00109,2,2086830,2090358,-,3528
83,BUMA.1121.00077,2,1111456,1114990,-,3534
83,BUMA.1121.00027,2,456608,460141,+,3533
83,BUMA.1121.00027,1,917657,921182,-,3525
83,BUMA.1121.00026,2,520205,523732,+,3527
83,BUMA.1121.00021,2,3035043,3038576,+,3533
83,BUMA.1121.00025,1,4037207,4040732,+,3525
83,BUMA.1121.00021,1,3376174,3379699,-,3525
83,BUMA.1121.00023,1,1096385,1099910,-,3525
83,BUMA.1121.00023,2,2676894,2680427,+,3533
83,BUMA.1121.00022,2,1736173,1739700,-,3527
83,BUMA.1121.00033,1,965164,968689,-,3525
83,BUMA.1121.00034,1,3064389,3067901,-,3512
83,BUMA.1121.00034,2,1914283,1917810,+,3527
83,BUMA.1121.00036,1,1082095,1085607,+,3512
83,BUMA.1121.00032,1,1094072,1097584,-,3512
83,BUMA.1121.00025,2,1065483,1069016,+,3533
83,BUMA.1121.00031,2,1721913,1725440,+,3527
83,BUMA.1121.00007,2,2662287,2665821,+,3534
83,BUMA.1121.00009,1,2802395,2805920,+,3525
83,BUMA.1121.00008,1,3038594,3042106,-,3512
83,BUMA.1121.00097,2,2374712,2378246,+,3534
83,BUMA.1121.00008,2,1898512,1902039,+,3527
83,BUMA.1121.00059,2,1058226,1061759,-,3533
83,BUMA.1121.00003,1,1264732,1268257,-,3525
83,BUMA.1121.00002,2,376884,380411,+,3527
83,BUMA.1121.00004,2,1898965,1902492,+,3527
83,BUMA.1121.00005,2,1383354,1386887,-,3533
83,BUMA.1121.00109,1,3134383,3137908,+,3525
83,BUMA.1121.00053,1,2537120,2540645,-,3525
83,BUMA.1121.00110,1,2040944,2044469,+,3525
83,BUMA.1121.00104,1,2470228,2473753,+,3525
83,BUMA.1121.00111,2,1869130,1872657,+,3527
83,BUMA.1121.00006,2,2130125,2133652,+,3527
83,BUMA.1121.00086,1,1713395,1716907,-,3512
83,BUMA.1121.00092,1,1001993,1005518,+,3525
83,BUMA.1121.00096,1,499356,502881,+,3525
83,BUMA.1121.00054,1,953,4437,-,3484
83,BUMA.1121.00054,1,3511037,3514549,-,3512
83,BUMA.1121.00097,1,1149402,1152927,+,3525
83,BUMA.1121.00093,1,3620627,3624152,-,3525
83,BUMA.1121.00009,2,1198510,1202029,+,3519
83,BUMA.1121.00106,1,2517666,2521191,-,3525
83,BUMA.1121.00094,2,2578053,2581585,+,3532
83,BUMA.1121.00101,2,872227,875754,-,3527
83,BUMA.1121.00066,2,2506799,2510332,+,3533
83,BUMA.1121.00010,1,2119115,2122627,+,3512
83,BUMA.1121.00095,2,1402515,1406043,+,3528
83,BUMA.1121.00035,1,3930258,3933783,-,3525
83,BUMA.1121.00112,2,1830362,1833895,-,3533
83,BUMA.1121.00042,2,1791461,1794988,-,3527
83,BUMA.1121.00108,1,3815271,3818796,-,3525
83,BUMA.1121.00028,1,3026988,3030500,-,3512
83,BUMA.1121.00094,1,2761649,2765174,-,3525
83,BUMA.1121.00032,2,339344,342871,+,3527
83,BUMA.1121.00102,1,2513963,2517488,+,3525
83,BUMA.1121.00090,2,276437,279970,+,3533
83,BUMA.1121.00020,2,1899234,1902761,+,3527
83,BUMA.1121.00111,1,2946666,2950191,-,3525
83,BUMA.1121.00089,2,2523865,2527399,+,3534
83,BUMA.1121.00089,1,2732686,2736211,-,3525
83,BUMA.1121.00051,2,2537142,2540676,+,3534
83,BUMA.1121.00084,1,3143047,3146572,-,3525
83,BUMA.1121.00029,1,2190343,2193868,+,3525
83,BUMA.1121.00001,2,2864074,2867607,-,3533
83,BUMA.1121.00012,1,1530001,1533526,-,3525
83,BUMA.1121.00087,1,1599963,1603475,+,3512
83,BUMA.1121.00045,2,2420719,2424247,+,3528
83,BUMA.1121.00043,2,3019388,3022915,-,3527
83,BUMA.1121.00043,1,2861654,2865179,-,3525
83,BUMA.1121.00046,1,2118097,2121609,+,3512
83,BUMA.1121.00037,1,1379012,1382537,-,3525
83,BUMA.1121.00080,1,2776444,2779969,-,3525
83,BUMA.1121.00079,1,2810847,2814372,-,3525
83,BUMA.1121.00045,1,1283804,1287329,+,3525
83,BUMA.1121.00063,2,2516239,2519763,+,3524
83,BUMA.1121.00071,1,2704573,2708098,-,3525
83,BUMA.1121.00056,1,1190467,1193992,+,3525
83,BUMA.1121.00079,2,2537558,2541092,+,3534
83,BUMA.1121.00071,2,2523053,2526577,+,3524
83,BUMA.1121.00086,2,191029,194556,-,3527
83,BUMA.1121.00024,2,2034166,2037693,+,3527
83,BUMA.1121.00010,2,1228888,1232415,+,3527
83,BUMA.1121.00040,2,151035,154562,-,3527
83,BUMA.1121.00093,2,394796,398329,-,3533
83,BUMA.1121.00065,1,2833081,2836606,-,3525
83,BUMA.1121.00058,1,1748560,1752085,+,3525
83,BUMA.1121.00007,1,1283603,1287128,+,3525
83,BUMA.1121.00091,2,1093344,1096869,-,3525
83,BUMA.1121.00107,2,1253434,1256962,-,3528
83,BUMA.1121.00067,1,1640968,1644493,+,3525
83,BUMA.1121.00090,1,853238,856763,-,3525
83,BUMA.1121.00088,2,2548518,2552046,+,3528
83,BUMA.1121.00047,2,351747,355281,+,3534
83,BUMA.1121.00051,1,2744639,2748164,-,3525
83,BUMA.1121.00020,1,3091801,3095313,-,3512
83,BUMA.1121.00019,2,1978379,1981906,+,3527
83,BUMA.1121.00103,1,1632331,1635856,+,3525
83,BUMA.1121.00087,2,408708,412235,+,3527
83,BUMA.1121.00039,2,1426770,1430303,-,3533
83,BUMA.1121.00048,1,421159,424671,+,3512
83,BUMA.1121.00047,1,172691,176216,+,3525
83,BUMA.1121.00042,1,1281434,1284946,+,3512
83,BUMA.1121.00055,1,2457191,2460716,-,3525
83,BUMA.1121.00031,1,106584,110109,-,3525
83,BUMA.1121.00040,1,3038985,3042497,-,3512
83,BUMA.1121.00030,2,204195,207722,-,3527
83,BUMA.1121.00044,1,2292559,2296071,-,3512
83,BUMA.1121.00016,2,1170364,1173897,-,3533
83,BUMA.1121.00088,1,3688584,3692109,-,3525
83,BUMA.1121.00069,1,2685049,2688574,-,3525
83,BUMA.1121.00092,2,2539634,2543167,+,3533
83,BUMA.1121.00085,2,1354053,1357580,-,3527
83,BUMA.1121.00064,1,2784472,2787997,-,3525
83,BUMA.1121.00046,2,1206663,1210190,-,3527
83,BUMA.1121.00003,2,781780,785299,+,3519
83,BUMA.1121.00105,1,2423011,2426536,+,3525
83,BUMA.1121.00054,2,1930238,1933765,+,3527
83,BUMA.1121.00015,1,2608108,2611620,+,3512
83,BUMA.1121.00015,2,442116,445643,-,3527
83,BUMA.1121.00105,2,3092792,3096320,-,3528
83,BUMA.1121.00059,1,2005585,2009110,-,3525
83,BUMA.1121.00052,2,307712,311239,-,3527
83,BUMA.1121.00026,1,2344964,2348476,+,3512
83,BUMA.1121.00053,2,2825539,2829063,+,3524
83,BUMA.1121.00022,1,3445338,3448848,-,3510
83,BUMA.1121.00057,2,2698740,2702273,-,3533
83,BUMA.1121.00052,1,2811731,2815243,-,3512
83,BUMA.1121.00108,2,2785172,2788700,+,3528
83,BUMA.1121.00101,1,3669944,3673469,+,3525
83,BUMA.1121.00001,1,1306049,1309574,+,3525
83,BUMA.1121.00050,2,2224956,2228483,+,3527
83,BUMA.1121.00038,1,628634,632146,+,3512
83,BUMA.1121.00104,2,2628261,2631789,+,3528
83,BUMA.1121.00014,2,2656559,2660092,+,3533
83,BUMA.1121.00036,2,1468677,1472204,+,3527
83,BUMA.1121.00038,2,2031340,2034867,+,3527
83,BUMA.1121.00068,1,1547347,1550872,-,3525
83,BUMA.1121.00098,2,2797467,2800995,+,3528
83,BUMA.1121.00078,2,595598,599131,-,3533
83,BUMA.1121.00099,1,3636334,3639859,+,3525
83,BUMA.1121.00029,2,1982560,1986093,-,3533
83,BUMA.1121.00091,1,1740939,1744464,+,3525
83,BUMA.1121.00099,2,2783696,2787230,+,3534
83,BUMA.1121.00098,1,1437927,1441452,-,3525
83,BUMA.1121.00103,2,1179107,1182641,+,3534
83,BUMA.1121.00013,1,3091857,3095369,-,3512
83,BUMA.1121.00049,1,3053808,3057333,+,3525
83,BUMA.1121.00102,2,2568732,2572266,+,3534
83,BUMA.1121.00028,2,1940407,1943934,+,3527
83,BUMA.1121.00072,1,2686542,2690067,-,3525
83,BUMA.1121.00076,1,2540408,2543933,+,3525
83,BUMA.1121.00075,2,299296,302830,-,3534
83,BUMA.1121.00044,2,1965180,1968707,+,3527
83,BUMA.1121.00076,2,294613,298147,+,3534
83,BUMA.1121.00074,2,1830595,1834128,-,3533
83,BUMA.1121.00073,2,2523174,2526698,+,3524
83,BUMA.1121.00083,2,1193457,1196990,+,3533
83,BUMA.1121.00035,2,2060249,2063782,-,3533
83,BUMA.1121.00072,2,2497640,2501173,+,3533
83,BUMA.1121.00083,1,2902714,2906239,+,3525
83,BUMA.1121.00056,2,1464299,1467833,-,3534
83,BUMA.1121.00078,1,3231392,3234917,+,3525
83,BUMA.1121.00081,2,189867,193394,-,3527
83,BUMA.1121.00095,1,2939009,2942534,+,3525
83,BUMA.1121.00077,1,1438762,1442287,-,3525
83,BUMA.1121.00063,1,2712486,2716011,-,3525
83,BUMA.1121.00061,1,2715693,2719218,-,3525
83,BUMA.1121.00033,2,92146,95679,+,3533
83,BUMA.1121.00061,2,2506280,2509813,+,3533
83,BUMA.1121.00050,1,630089,633601,-,3512
83,BUMA.1121.00081,1,628703,632215,+,3512
83,BUMA.1121.00074,1,1086425,1089950,+,3525
83,BUMA.1121.00062,1,1785183,1788708,+,3525
83,BUMA.1121.00062,2,2367284,2370817,-,3533
83,BUMA.1121.00064,2,2446130,2449664,+,3534
83,BUMA.1121.00060,2,2840858,2844386,-,3528
83,BUMA.1121.00060,1,3529057,3532582,+,3525
83,BUMA.1121.00070,1,2686787,2690312,-,3525
83,BUMA.1121.00069,2,2489071,2492604,+,3533
83,BUMA.1121.00075,1,2268550,2272075,-,3525
83,BUMA.1121.00070,2,2502513,2506037,+,3524
83,BUMA.1121.00041,1,4085302,4088827,-,3525
83,BUMA.1121.00068,2,1129179,1132707,+,3528
83,BUMA.1121.00073,1,2713878,2717403,-,3525
83,BUMA.1121.00017,1,2962054,2965566,-,3512
83,BUMA.1121.00067,2,1385820,1389353,-,3533
83,BUMA.1121.00066,1,2689359,2692884,-,3525
83,BUMA.1121.00037,2,2891250,2894783,+,3533
83,BUMA.1121.00065,2,2612231,2615765,+,3534
83,BUMA.1121.00058,2,3146343,3149871,+,3528
83,BUMA.1121.00107,1,2718284,2721809,-,3525
83,BUMA.1121.00085,1,2408677,2412189,-,3512
83,BUMA.1121.00030,1,2962124,2965636,-,3512
83,BUMA.1121.00041,2,269903,273436,+,3533
83,BUMA.1121.00084,2,1253506,1257034,+,3528
83,BUMA.1121.00096,2,2853064,2856583,+,3519
83,BUMA.1121.00112,1,62598,66123,+,3525
83,BUMA.1121.00080,2,2593593,2597127,+,3534
83,BUMA.1121.00002,1,2145974,2149486,+,3512
83,BUMA.1121.00082,1,2873121,2876646,-,3525
83,BUMA.1121.00014,1,4140876,4144401,+,3525
83,BUMA.1121.00013,2,620496,624023,-,3527
83,BUMA.1121.00100,2,568449,571983,+,3534
83,BUMA.1121.00012,2,2389903,2393436,-,3533
83,BUMA.1121.00011,1,2885837,2889362,+,3525
83,BUMA.1121.00019,1,2978321,2981833,-,3512
83,BUMA.1121.00057,1,3888446,3891971,-,3525
83,BUMA.1121.00018,2,1263917,1267450,-,3533
83,BUMA.1121.00018,1,3369020,3372545,-,3525
83,BUMA.1121.00048,2,929316,932843,-,3527
83,BUMA.1121.00039,1,2916548,2920073,-,3525
83,BUMA.1121.00016,1,889757,893282,-,3525
83,BUMA.1121.00106,2,1818743,1822271,+,3528
83,BUMA.1121.00017,2,1914279,1917806,+,3527
83,BUMA.1121.00004,1,3007113,3010625,-,3512
83,BUMA.1121.00004,1,3057169,3060681,-,3512
83,BUMA.1121.00004,1,3107225,3110737,-,3512
83,BUMA.1121.00082,2,2569541,2573074,+,3533
83,BUMA.1121.00005,1,1480839,1484337,-,3498
83,BUMA.1121.00100,1,2595042,2598567,+,3525
83,BUMA.1121.00006,1,628633,632145,+,3512
84,BUMA.1121.00049,2,1184783,1201428,+,16645
84,BUMA.1121.00055,2,118931,135569,-,16638
84,BUMA.1121.00011,2,1159532,1176165,+,16633
84,BUMA.1121.00110,2,2504515,2521160,+,16645
84,BUMA.1121.00109,2,2070211,2086814,-,16603
84,BUMA.1121.00077,2,1094793,1111440,-,16647
84,BUMA.1121.00027,2,460156,476801,+,16645
84,BUMA.1121.00026,2,523748,540369,+,16621
84,BUMA.1121.00021,2,3038592,3055256,+,16664
84,BUMA.1121.00023,2,2680443,2697073,+,16630
84,BUMA.1121.00022,2,1719536,1736157,-,16621
84,BUMA.1121.00034,2,1917826,1934447,+,16621
84,BUMA.1121.00025,2,1069032,1085660,+,16628
84,BUMA.1121.00031,2,1725456,1742107,+,16651
84,BUMA.1121.00007,2,2665837,2682475,+,16638
84,BUMA.1121.00097,2,2378272,2394713,+,16441
84,BUMA.1121.00008,2,1902055,1918676,+,16621
84,BUMA.1121.00059,2,1041537,1058200,-,16663
84,BUMA.1121.00002,2,380427,397048,+,16621
84,BUMA.1121.00004,2,1902508,1919129,+,16621
84,BUMA.1121.00005,2,1366673,1383338,-,16665
84,BUMA.1121.00111,2,1872673,1889324,+,16651
84,BUMA.1121.00006,2,2133668,2150289,+,16621
84,BUMA.1121.00009,2,1202054,1218719,+,16665
84,BUMA.1121.00094,2,2581601,2598245,+,16644
84,BUMA.1121.00101,2,855558,872211,-,16653
84,BUMA.1121.00066,2,2510348,2526984,+,16636
84,BUMA.1121.00095,2,1406059,1422730,+,16671
84,BUMA.1121.00112,2,1813686,1830346,-,16660
84,BUMA.1121.00042,2,1774824,1791445,-,16621
84,BUMA.1121.00032,2,342887,359508,+,16621
84,BUMA.1121.00090,2,279986,296636,+,16650
84,BUMA.1121.00020,2,1902777,1919398,+,16621
84,BUMA.1121.00089,2,2527415,2544054,+,16639
84,BUMA.1121.00051,2,2540692,2557331,+,16639
84,BUMA.1121.00001,2,2847410,2864058,-,16648
84,BUMA.1121.00045,2,2424263,2440886,+,16623
84,BUMA.1121.00043,2,3002706,3019372,-,16666
84,BUMA.1121.00063,2,2519788,2536424,+,16636
84,BUMA.1121.00079,2,2541108,2557746,+,16638
84,BUMA.1121.00071,2,2526602,2543237,+,16635
84,BUMA.1121.00086,2,174392,191013,-,16621
84,BUMA.1121.00024,2,2037709,2054330,+,16621
84,BUMA.1121.00010,2,1232431,1249050,+,16619
84,BUMA.1121.00040,2,134398,151019,-,16621
84,BUMA.1121.00093,2,378143,394770,-,16627
84,BUMA.1121.00091,2,1076673,1093319,-,16646
84,BUMA.1121.00107,2,1236726,1253418,-,16692
84,BUMA.1121.00088,2,2552062,2568703,+,16641
84,BUMA.1121.00047,2,355297,371936,+,16639
84,BUMA.1121.00019,2,1981922,1998543,+,16621
84,BUMA.1121.00087,2,412251,428872,+,16621
84,BUMA.1121.00039,2,1410092,1426754,-,16662
84,BUMA.1121.00030,2,187558,204179,-,16621
84,BUMA.1121.00016,2,1153698,1170348,-,16650
84,BUMA.1121.00092,2,2543193,2559820,+,16627
84,BUMA.1121.00085,2,1337416,1354037,-,16621
84,BUMA.1121.00046,2,1190026,1206647,-,16621
84,BUMA.1121.00003,2,785315,801979,+,16664
84,BUMA.1121.00054,2,1933781,1950402,+,16621
84,BUMA.1121.00015,2,425479,442100,-,16621
84,BUMA.1121.00105,2,3076119,3092776,-,16657
84,BUMA.1121.00052,2,291075,307696,-,16621
84,BUMA.1121.00053,2,2829088,2845699,+,16611
84,BUMA.1121.00057,2,2682056,2698725,-,16669
84,BUMA.1121.00108,2,2788716,2805377,+,16661
84,BUMA.1121.00050,2,2228499,2245120,+,16621
84,BUMA.1121.00104,2,2631805,2648450,+,16645
84,BUMA.1121.00014,2,2660108,2676749,+,16641
84,BUMA.1121.00036,2,1472220,1488841,+,16621
84,BUMA.1121.00038,2,2034883,2051504,+,16621
84,BUMA.1121.00098,2,2801011,2817680,+,16669
84,BUMA.1121.00078,2,578971,595582,-,16611
84,BUMA.1121.00029,2,1965894,1982544,-,16650
84,BUMA.1121.00099,2,2787246,2803865,+,16619
84,BUMA.1121.00103,2,1182667,1199293,+,16626
84,BUMA.1121.00102,2,2572282,2588941,+,16659
84,BUMA.1121.00028,2,1943950,1960571,+,16621
84,BUMA.1121.00075,2,282644,299280,-,16636
84,BUMA.1121.00044,2,1968723,1985344,+,16621
84,BUMA.1121.00076,2,298163,314801,+,16638
84,BUMA.1121.00074,2,1813933,1830579,-,16646
84,BUMA.1121.00073,2,2526723,2543361,+,16638
84,BUMA.1121.00083,2,1197005,1213652,+,16647
84,BUMA.1121.00035,2,2043583,2060233,-,16650
84,BUMA.1121.00072,2,2501189,2517825,+,16636
84,BUMA.1121.00056,2,1447644,1464283,-,16639
84,BUMA.1121.00081,2,173230,189851,-,16621
84,BUMA.1121.00033,2,95695,112325,+,16630
84,BUMA.1121.00061,2,2509829,2526467,+,16638
84,BUMA.1121.00062,2,2350622,2367268,-,16646
84,BUMA.1121.00064,2,2449680,2466309,+,16629
84,BUMA.1121.00060,2,2824219,2840842,-,16623
84,BUMA.1121.00069,2,2492620,2509258,+,16638
84,BUMA.1121.00070,2,2506062,2522700,+,16638
84,BUMA.1121.00068,2,1132723,1149404,+,16681
84,BUMA.1121.00067,2,1369158,1385804,-,16646
84,BUMA.1121.00037,2,2894799,2911453,+,16654
84,BUMA.1121.00065,2,2615780,2632447,+,16667
84,BUMA.1121.00058,2,3149887,3166525,+,16638
84,BUMA.1121.00041,2,273452,290078,+,16626
84,BUMA.1121.00084,2,1257050,1273691,+,16641
84,BUMA.1121.00096,2,2856599,2873234,+,16635
84,BUMA.1121.00080,2,2597143,2613782,+,16639
84,BUMA.1121.00013,2,603859,620480,-,16621
84,BUMA.1121.00100,2,571999,588667,+,16668
84,BUMA.1121.00012,2,2373237,2389887,-,16650
84,BUMA.1121.00018,2,1247273,1263901,-,16628
84,BUMA.1121.00048,2,912679,929300,-,16621
84,BUMA.1121.00106,2,1822287,1838933,+,16646
84,BUMA.1121.00017,2,1917822,1934443,+,16621
84,BUMA.1121.00082,2,2573089,2589736,+,16647
85,BUMA.1121.00049,2,1204601,1228980,+,24379
85,BUMA.1121.00055,2,91335,115758,-,24423
85,BUMA.1121.00011,2,1179338,1203721,+,24383
85,BUMA.1121.00110,2,2524361,2548710,+,24349
85,BUMA.1121.00109,2,2042669,2067064,-,24395
85,BUMA.1121.00077,2,1067245,1091592,-,24347
85,BUMA.1121.00027,2,479974,504244,+,24270
85,BUMA.1121.00021,2,3059756,3084153,+,24397
85,BUMA.1121.00023,2,2700260,2724676,+,24416
85,BUMA.1121.00022,2,1687890,1712201,-,24311
85,BUMA.1121.00034,2,145857,170182,-,24325
85,BUMA.1121.00025,2,1088856,1113230,+,24374
85,BUMA.1121.00031,2,1745280,1769629,+,24349
85,BUMA.1121.00007,2,2685641,2709949,+,24308
85,BUMA.1121.00097,2,2399250,2423627,+,24377
85,BUMA.1121.00008,2,145849,170174,-,24325
85,BUMA.1121.00059,2,1014045,1038364,-,24319
85,BUMA.1121.00002,2,404384,428708,+,24324
85,BUMA.1121.00004,2,145853,170178,-,24325
85,BUMA.1121.00005,2,1339089,1363486,-,24397
85,BUMA.1121.00111,2,1892511,1916973,+,24462
85,BUMA.1121.00006,2,2157631,2181920,+,24289
85,BUMA.1121.00009,2,1221899,1246207,+,24308
85,BUMA.1121.00094,2,2601480,2625884,+,24404
85,BUMA.1121.00101,2,827966,852327,-,24361
85,BUMA.1121.00066,2,2531489,2555827,+,24338
85,BUMA.1121.00095,2,1425938,1450357,+,24419
85,BUMA.1121.00112,2,1786083,1810478,-,24395
85,BUMA.1121.00042,2,1567105,1591480,+,24375
85,BUMA.1121.00090,2,301419,325828,+,24409
85,BUMA.1121.00020,2,145862,170187,-,24325
85,BUMA.1121.00089,2,2547290,2571737,+,24447
85,BUMA.1121.00051,2,2560567,2584919,+,24352
85,BUMA.1121.00001,2,2819838,2844230,-,24392
85,BUMA.1121.00045,2,2444098,2468438,+,24340
85,BUMA.1121.00043,2,2975125,2999519,-,24394
85,BUMA.1121.00063,2,2540900,2565238,+,24338
85,BUMA.1121.00079,2,2560982,2585339,+,24357
85,BUMA.1121.00071,2,2547727,2572065,+,24338
85,BUMA.1121.00086,2,142746,167050,-,24304
85,BUMA.1121.00024,2,145905,170230,-,24325
85,BUMA.1121.00010,2,1256382,1280666,+,24284
85,BUMA.1121.00040,2,2135890,2160200,+,24310
85,BUMA.1121.00093,2,350597,374970,-,24373
85,BUMA.1121.00091,2,1049135,1073486,-,24351
85,BUMA.1121.00107,2,1209076,1233483,-,24407
85,BUMA.1121.00088,2,2573500,2597952,+,24452
85,BUMA.1121.00047,2,375179,399535,+,24356
85,BUMA.1121.00019,2,145842,170167,-,24325
85,BUMA.1121.00087,2,436213,460516,+,24303
85,BUMA.1121.00039,2,1382568,1406919,-,24351
85,BUMA.1121.00030,2,1951598,1975922,+,24324
85,BUMA.1121.00016,2,1126099,1150509,-,24410
85,BUMA.1121.00092,2,2562993,2587365,+,24372
85,BUMA.1121.00085,2,1305735,1330067,-,24332
85,BUMA.1121.00046,2,962197,986507,+,24310
85,BUMA.1121.00003,2,805145,829570,+,24425
85,BUMA.1121.00054,2,1957744,1982033,+,24289
85,BUMA.1121.00015,2,393840,418144,-,24304
85,BUMA.1121.00105,2,3048632,3072946,-,24314
85,BUMA.1121.00052,2,259394,283726,-,24332
85,BUMA.1121.00053,2,2848879,2873187,+,24308
85,BUMA.1121.00057,2,2653295,2677570,-,24275
85,BUMA.1121.00108,2,2808585,2832985,+,24400
85,BUMA.1121.00050,2,127088,151406,-,24318
85,BUMA.1121.00104,2,2651623,2676037,+,24414
85,BUMA.1121.00014,2,2679924,2704333,+,24409
85,BUMA.1121.00038,2,2058846,2083135,+,24289
85,BUMA.1121.00098,2,2820852,2845206,+,24354
85,BUMA.1121.00078,2,551420,575784,-,24364
85,BUMA.1121.00029,2,1938322,1962714,-,24392
85,BUMA.1121.00099,2,2807059,2831364,+,24305
85,BUMA.1121.00103,2,1202473,1226848,+,24375
85,BUMA.1121.00102,2,2593724,2618157,+,24433
85,BUMA.1121.00028,2,145912,170237,-,24325
85,BUMA.1121.00075,2,252234,276558,-,24324
85,BUMA.1121.00044,2,197009,221334,-,24325
85,BUMA.1121.00076,2,320887,345210,+,24323
85,BUMA.1121.00074,2,1785039,1809447,-,24408
85,BUMA.1121.00073,2,2547868,2572200,+,24332
85,BUMA.1121.00083,2,1218159,1242501,+,24342
85,BUMA.1121.00035,2,2015992,2040403,-,24411
85,BUMA.1121.00072,2,2522324,2546657,+,24333
85,BUMA.1121.00056,2,1419960,1444408,-,24448
85,BUMA.1121.00081,2,141598,165888,-,24290
85,BUMA.1121.00033,2,115512,139907,+,24395
85,BUMA.1121.00061,2,2530974,2555306,+,24332
85,BUMA.1121.00062,2,2323032,2347449,-,24417
85,BUMA.1121.00064,2,2469517,2493917,+,24400
85,BUMA.1121.00060,2,2796667,2821007,-,24340
85,BUMA.1121.00069,2,2513735,2538076,+,24341
85,BUMA.1121.00070,2,2527199,2551531,+,24332
85,BUMA.1121.00068,2,1152564,1176850,+,24286
85,BUMA.1121.00067,2,1341610,1365964,-,24354
85,BUMA.1121.00037,2,2914640,2939057,+,24417
85,BUMA.1121.00065,2,2636926,2661327,+,24401
85,BUMA.1121.00058,2,3169740,3194057,+,24317
85,BUMA.1121.00041,2,293293,317572,+,24279
85,BUMA.1121.00084,2,1276892,1301221,+,24329
85,BUMA.1121.00096,2,2876414,2900767,+,24353
85,BUMA.1121.00080,2,2617004,2641352,+,24348
85,BUMA.1121.00013,2,572199,596510,-,24311
85,BUMA.1121.00100,2,593429,617849,+,24420
85,BUMA.1121.00012,2,2345689,2370050,-,24361
85,BUMA.1121.00018,2,1219663,1244077,-,24414
85,BUMA.1121.00048,2,881048,905338,-,24290
85,BUMA.1121.00106,2,1842141,1866614,+,24473
85,BUMA.1121.00017,2,145843,170168,-,24325
85,BUMA.1121.00082,2,2594243,2618585,+,24342
86,BUMA.1121.00049,2,1231269,1249160,+,17891
86,BUMA.1121.00055,2,71033,89046,-,18013
86,BUMA.1121.00011,2,1206010,1223967,+,17957
86,BUMA.1121.00110,2,2550996,2568870,+,17874
86,BUMA.1121.00109,2,2022421,2040380,-,17959
86,BUMA.1121.00077,2,1047083,1064958,-,17875
86,BUMA.1121.00027,2,506533,524459,+,17926
86,BUMA.1121.00021,2,3086442,3104417,+,17975
86,BUMA.1121.00023,2,2726965,2744927,+,17962
86,BUMA.1121.00022,2,1667685,1685605,-,17920
86,BUMA.1121.00034,2,125658,143572,-,17914
86,BUMA.1121.00025,2,1115519,1133496,+,17977
86,BUMA.1121.00031,2,1771915,1789859,+,17944
86,BUMA.1121.00007,2,2712238,2730338,+,18100
86,BUMA.1121.00097,2,2425910,2443945,+,18035
86,BUMA.1121.00008,2,125650,143564,-,17914
86,BUMA.1121.00059,2,993795,1011756,-,17961
86,BUMA.1121.00002,2,430993,448944,+,17951
86,BUMA.1121.00004,2,125654,143568,-,17914
86,BUMA.1121.00005,2,1318914,1336800,-,17886
86,BUMA.1121.00111,2,1919262,1937198,+,17936
86,BUMA.1121.00006,2,2184205,2202102,+,17897
86,BUMA.1121.00009,2,1248496,1266477,+,17981
86,BUMA.1121.00094,2,2628173,2646067,+,17894
86,BUMA.1121.00101,2,807719,825688,-,17969
86,BUMA.1121.00066,2,2558116,2576018,+,17902
86,BUMA.1121.00095,2,1452646,1470580,+,17934
86,BUMA.1121.00112,2,1765851,1783799,-,17948
86,BUMA.1121.00042,2,1593765,1611704,+,17939
86,BUMA.1121.00090,2,328117,346206,+,18089
86,BUMA.1121.00020,2,125663,143577,-,17914
86,BUMA.1121.00089,2,2574026,2591943,+,17917
86,BUMA.1121.00051,2,2587208,2605158,+,17950
86,BUMA.1121.00001,2,2799555,2817551,-,17996
86,BUMA.1121.00045,2,2470724,2488693,+,17969
86,BUMA.1121.00043,2,2954863,2972836,-,17973
86,BUMA.1121.00063,2,2567527,2585442,+,17915
86,BUMA.1121.00079,2,2587628,2605563,+,17935
86,BUMA.1121.00071,2,2574354,2592253,+,17899
86,BUMA.1121.00086,2,122541,140461,-,17920
86,BUMA.1121.00024,2,125706,143620,-,17914
86,BUMA.1121.00010,2,1282951,1300902,+,17951
86,BUMA.1121.00040,2,2162485,2180385,+,17900
86,BUMA.1121.00093,2,330328,348308,-,17980
86,BUMA.1121.00091,2,1028935,1046846,-,17911
86,BUMA.1121.00107,2,1188789,1206789,-,18000
86,BUMA.1121.00088,2,2600241,2618210,+,17969
86,BUMA.1121.00047,2,401824,419786,+,17962
86,BUMA.1121.00019,2,125643,143557,-,17914
86,BUMA.1121.00087,2,462801,480722,+,17921
86,BUMA.1121.00039,2,1362336,1380279,-,17943
86,BUMA.1121.00030,2,1978207,1996122,+,17915
86,BUMA.1121.00016,2,1105816,1123810,-,17994
86,BUMA.1121.00092,2,2589654,2607637,+,17983
86,BUMA.1121.00085,2,1285545,1303450,-,17905
86,BUMA.1121.00046,2,988792,1006689,+,17897
86,BUMA.1121.00003,2,831859,849833,+,17974
86,BUMA.1121.00054,2,1984318,2002215,+,17897
86,BUMA.1121.00015,2,373659,391555,-,17896
86,BUMA.1121.00105,2,3028344,3046343,-,17999
86,BUMA.1121.00052,2,239204,257109,-,17905
86,BUMA.1121.00053,2,2875476,2893419,+,17943
86,BUMA.1121.00057,2,2633080,2651006,-,17926
86,BUMA.1121.00108,2,2835268,2853234,+,17966
86,BUMA.1121.00050,2,106907,124803,-,17896
86,BUMA.1121.00104,2,2678326,2696265,+,17939
86,BUMA.1121.00014,2,2706619,2724563,+,17944
86,BUMA.1121.00038,2,2085420,2103317,+,17897
86,BUMA.1121.00098,2,2847492,2865466,+,17974
86,BUMA.1121.00078,2,531174,549145,-,17971
86,BUMA.1121.00029,2,1918015,1936035,-,18020
86,BUMA.1121.00099,2,2833653,2851519,+,17866
86,BUMA.1121.00103,2,1229137,1247129,+,17992
86,BUMA.1121.00102,2,2620446,2638394,+,17948
86,BUMA.1121.00028,2,125713,143627,-,17914
86,BUMA.1121.00075,2,232006,249945,-,17939
86,BUMA.1121.00044,2,176810,194724,-,17914
86,BUMA.1121.00076,2,347499,365439,+,17940
86,BUMA.1121.00074,2,1764801,1782750,-,17949
86,BUMA.1121.00073,2,2574489,2592382,+,17893
86,BUMA.1121.00083,2,1244790,1262717,+,17927
86,BUMA.1121.00035,2,1995709,2013705,-,17996
86,BUMA.1121.00072,2,2548946,2566861,+,17915
86,BUMA.1121.00056,2,1399757,1417671,-,17914
86,BUMA.1121.00081,2,121417,139313,-,17896
86,BUMA.1121.00033,2,142196,160143,+,17947
86,BUMA.1121.00061,2,2557595,2575489,+,17894
86,BUMA.1121.00062,2,2302888,2320743,-,17855
86,BUMA.1121.00064,2,2496206,2514152,+,17946
86,BUMA.1121.00060,2,2776412,2794380,-,17968
86,BUMA.1121.00069,2,2540359,2558267,+,17908
86,BUMA.1121.00070,2,2553820,2571712,+,17892
86,BUMA.1121.00068,2,1179139,1197044,+,17905
86,BUMA.1121.00067,2,1321372,1339321,-,17949
86,BUMA.1121.00037,2,2941346,2959266,+,17920
86,BUMA.1121.00065,2,2663616,2681564,+,17948
86,BUMA.1121.00058,2,3196346,3214293,+,17947
86,BUMA.1121.00041,2,319861,337866,+,18005
86,BUMA.1121.00084,2,1303510,1321413,+,17903
86,BUMA.1121.00096,2,2903056,2921044,+,17988
86,BUMA.1121.00080,2,2643641,2661591,+,17950
86,BUMA.1121.00013,2,552003,569914,-,17911
86,BUMA.1121.00100,2,620138,638155,+,18017
86,BUMA.1121.00012,2,2325467,2343400,-,17933
86,BUMA.1121.00018,2,1199374,1217374,-,18000
86,BUMA.1121.00048,2,860867,878763,-,17896
86,BUMA.1121.00106,2,1868903,1886832,+,17929
86,BUMA.1121.00017,2,125644,143558,-,17914
86,BUMA.1121.00082,2,2620874,2638801,+,17927
87,BUMA.1121.00049,2,1249161,1254327,+,5166
87,BUMA.1121.00055,2,65884,71031,-,5147
87,BUMA.1121.00011,2,1223968,1229133,+,5165
87,BUMA.1121.00110,2,2568871,2574019,+,5148
87,BUMA.1121.00109,2,2017254,2022419,-,5165
87,BUMA.1121.00077,2,1041934,1047081,-,5147
87,BUMA.1121.00027,2,524460,529626,+,5166
87,BUMA.1121.00021,2,3104418,3109584,+,5166
87,BUMA.1121.00023,2,2744928,2750076,+,5148
87,BUMA.1121.00022,2,1662518,1667683,-,5165
87,BUMA.1121.00034,2,120491,125656,-,5165
87,BUMA.1121.00025,2,1133497,1138645,+,5148
87,BUMA.1121.00031,2,1789860,1795026,+,5166
87,BUMA.1121.00007,2,2730339,2735505,+,5166
87,BUMA.1121.00097,2,2443946,2449112,+,5166
87,BUMA.1121.00008,2,120483,125648,-,5165
87,BUMA.1121.00059,2,988646,993793,-,5147
87,BUMA.1121.00002,2,448945,454111,+,5166
87,BUMA.1121.00004,2,120487,125652,-,5165
87,BUMA.1121.00005,2,1313756,1318912,-,5156
87,BUMA.1121.00111,2,1937199,1942347,+,5148
87,BUMA.1121.00006,2,2202103,2207269,+,5166
87,BUMA.1121.00009,2,1266478,1271644,+,5166
87,BUMA.1121.00094,2,2646068,2651216,+,5148
87,BUMA.1121.00101,2,802551,807717,-,5166
87,BUMA.1121.00066,2,2576019,2581176,+,5157
87,BUMA.1121.00095,2,1470581,1475747,+,5166
87,BUMA.1121.00112,2,1760702,1765849,-,5147
87,BUMA.1121.00042,2,1611705,1616811,+,5106
87,BUMA.1121.00090,2,346207,351355,+,5148
87,BUMA.1121.00020,2,120496,125661,-,5165
87,BUMA.1121.00089,2,2591944,2597092,+,5148
87,BUMA.1121.00051,2,2605159,2610307,+,5148
87,BUMA.1121.00001,2,2794388,2799553,-,5165
87,BUMA.1121.00045,2,2488694,2493860,+,5166
87,BUMA.1121.00043,2,2949696,2954861,-,5165
87,BUMA.1121.00063,2,2585443,2590609,+,5166
87,BUMA.1121.00079,2,2605564,2610712,+,5148
87,BUMA.1121.00071,2,2592254,2597405,+,5151
87,BUMA.1121.00086,2,117374,122539,-,5165
87,BUMA.1121.00024,2,120539,125704,-,5165
87,BUMA.1121.00010,2,1300903,1306069,+,5166
87,BUMA.1121.00040,2,2180386,2185552,+,5166
87,BUMA.1121.00093,2,325179,330326,-,5147
87,BUMA.1121.00091,2,1023768,1028933,-,5165
87,BUMA.1121.00107,2,1183604,1188787,-,5183
87,BUMA.1121.00088,2,2618211,2623359,+,5148
87,BUMA.1121.00047,2,419787,424935,+,5148
87,BUMA.1121.00019,2,120476,125641,-,5165
87,BUMA.1121.00087,2,480723,485889,+,5166
87,BUMA.1121.00039,2,1357187,1362334,-,5147
87,BUMA.1121.00030,2,1996123,2001289,+,5166
87,BUMA.1121.00016,2,1100649,1105814,-,5165
87,BUMA.1121.00092,2,2607638,2612786,+,5148
87,BUMA.1121.00085,2,1280378,1285543,-,5165
87,BUMA.1121.00046,2,1006690,1011856,+,5166
87,BUMA.1121.00003,2,849834,855000,+,5166
87,BUMA.1121.00054,2,2002216,2007382,+,5166
87,BUMA.1121.00015,2,368492,373657,-,5165
87,BUMA.1121.00105,2,3023195,3028342,-,5147
87,BUMA.1121.00052,2,234037,239202,-,5165
87,BUMA.1121.00053,2,2893420,2898568,+,5148
87,BUMA.1121.00057,2,2627913,2633078,-,5165
87,BUMA.1121.00108,2,2853235,2858401,+,5166
87,BUMA.1121.00050,2,101740,106905,-,5165
87,BUMA.1121.00104,2,2696266,2701414,+,5148
87,BUMA.1121.00014,2,2724564,2729730,+,5166
87,BUMA.1121.00038,2,2103318,2108484,+,5166
87,BUMA.1121.00098,2,2865467,2870633,+,5166
87,BUMA.1121.00078,2,526025,531172,-,5147
87,BUMA.1121.00029,2,1912848,1918013,-,5165
87,BUMA.1121.00099,2,2851520,2856686,+,5166
87,BUMA.1121.00103,2,1247130,1252278,+,5148
87,BUMA.1121.00102,2,2638395,2643543,+,5148
87,BUMA.1121.00028,2,120546,125711,-,5165
87,BUMA.1121.00075,2,226858,232004,-,5146
87,BUMA.1121.00044,2,171643,176808,-,5165
87,BUMA.1121.00076,2,365440,370588,+,5148
87,BUMA.1121.00074,2,1759652,1764799,-,5147
87,BUMA.1121.00073,2,2592383,2597549,+,5166
87,BUMA.1121.00083,2,1262718,1267884,+,5166
87,BUMA.1121.00035,2,1990542,1995707,-,5165
87,BUMA.1121.00072,2,2566862,2572028,+,5166
87,BUMA.1121.00056,2,1394608,1399755,-,5147
87,BUMA.1121.00081,2,116250,121415,-,5165
87,BUMA.1121.00033,2,160144,165292,+,5148
87,BUMA.1121.00061,2,2575490,2580656,+,5166
87,BUMA.1121.00062,2,2297739,2302886,-,5147
87,BUMA.1121.00064,2,2514153,2519301,+,5148
87,BUMA.1121.00060,2,2771245,2776410,-,5165
87,BUMA.1121.00069,2,2558268,2563430,+,5162
87,BUMA.1121.00070,2,2571713,2576871,+,5158
87,BUMA.1121.00068,2,1197045,1202193,+,5148
87,BUMA.1121.00067,2,1316223,1321370,-,5147
87,BUMA.1121.00037,2,2959267,2964433,+,5166
87,BUMA.1121.00065,2,2681565,2686731,+,5166
87,BUMA.1121.00058,2,39,5202,+,5163
87,BUMA.1121.00041,2,337867,343033,+,5166
87,BUMA.1121.00084,2,1321414,1326562,+,5148
87,BUMA.1121.00096,2,2921045,2926211,+,5166
87,BUMA.1121.00080,2,2661592,2666740,+,5148
87,BUMA.1121.00013,2,546836,552001,-,5165
87,BUMA.1121.00100,2,638156,643304,+,5148
87,BUMA.1121.00012,2,2320300,2325465,-,5165
87,BUMA.1121.00018,2,1194225,1199372,-,5147
87,BUMA.1121.00048,2,855700,860865,-,5165
87,BUMA.1121.00106,2,1886833,1891981,+,5148
87,BUMA.1121.00017,2,120477,125642,-,5165
87,BUMA.1121.00082,2,2638802,2643968,+,5166
88,BUMA.1121.00049,2,1259118,1265635,+,6517
88,BUMA.1121.00055,2,54571,60981,-,6410
88,BUMA.1121.00011,2,1234165,1240751,+,6586
88,BUMA.1121.00110,2,2579150,2585669,+,6519
88,BUMA.1121.00109,2,2005400,2011883,-,6483
88,BUMA.1121.00077,2,1030241,1036760,-,6519
88,BUMA.1121.00027,2,534543,540998,+,6455
88,BUMA.1121.00021,2,3114636,3121071,+,6435
88,BUMA.1121.00023,2,2755172,2761590,+,6418
88,BUMA.1121.00022,2,1651050,1657495,-,6445
88,BUMA.1121.00034,2,109136,115581,-,6445
88,BUMA.1121.00025,2,1143684,1150302,+,6618
88,BUMA.1121.00031,2,1800156,1806605,+,6449
88,BUMA.1121.00007,2,2740655,2747146,+,6491
88,BUMA.1121.00097,2,2454212,2460855,+,6643
88,BUMA.1121.00008,2,109198,115643,-,6445
88,BUMA.1121.00059,2,977263,983656,-,6393
88,BUMA.1121.00002,2,459045,465547,+,6502
88,BUMA.1121.00004,2,109192,115637,-,6445
88,BUMA.1121.00005,2,1302268,1308713,-,6445
88,BUMA.1121.00111,2,1947415,1953864,+,6449
88,BUMA.1121.00006,2,2212291,2218751,+,6460
88,BUMA.1121.00009,2,1276641,1283063,+,6422
88,BUMA.1121.00094,2,2656204,2662648,+,6444
88,BUMA.1121.00101,2,791005,797459,-,6454
88,BUMA.1121.00066,2,2585986,2592440,+,6454
88,BUMA.1121.00095,2,1480709,1487314,+,6605
88,BUMA.1121.00112,2,1749405,1755803,-,6398
88,BUMA.1121.00090,2,356347,362817,+,6470
88,BUMA.1121.00020,2,109191,115636,-,6445
88,BUMA.1121.00089,2,2602074,2608520,+,6446
88,BUMA.1121.00051,2,2615520,2621942,+,6422
88,BUMA.1121.00001,2,2782852,2789284,-,6432
88,BUMA.1121.00045,2,2498754,2505310,+,6556
88,BUMA.1121.00043,2,2938172,2944683,-,6511
88,BUMA.1121.00063,2,2595707,2602165,+,6458
88,BUMA.1121.00079,2,2615900,2622304,+,6404
88,BUMA.1121.00071,2,2602506,2608958,+,6452
88,BUMA.1121.00086,2,106099,112550,-,6451
88,BUMA.1121.00024,2,109191,115636,-,6445
88,BUMA.1121.00010,2,1310933,1317417,+,6484
88,BUMA.1121.00040,2,2190590,2197032,+,6442
88,BUMA.1121.00093,2,313637,320071,-,6434
88,BUMA.1121.00091,2,1012247,1018698,-,6451
88,BUMA.1121.00107,2,1172064,1178614,-,6550
88,BUMA.1121.00088,2,2628301,2634729,+,6428
88,BUMA.1121.00047,2,430129,436575,+,6446
88,BUMA.1121.00019,2,109184,115629,-,6445
88,BUMA.1121.00087,2,490713,497164,+,6451
88,BUMA.1121.00039,2,1345508,1352063,-,6555
88,BUMA.1121.00030,2,2006199,2012644,+,6445
88,BUMA.1121.00016,2,1089081,1095542,-,6461
88,BUMA.1121.00092,2,2617894,2624328,+,6434
88,BUMA.1121.00085,2,1268924,1275393,-,6469
88,BUMA.1121.00046,2,1016983,1023446,+,6463
88,BUMA.1121.00003,2,860186,866793,+,6607
88,BUMA.1121.00054,2,2012383,2018843,+,6460
88,BUMA.1121.00015,2,357067,363515,-,6448
88,BUMA.1121.00105,2,3011829,3018299,-,6470
88,BUMA.1121.00052,2,222583,229052,-,6469
88,BUMA.1121.00053,2,2903583,2910077,+,6494
88,BUMA.1121.00057,2,2616383,2622960,-,6577
88,BUMA.1121.00108,2,2863135,2869640,+,6505
88,BUMA.1121.00050,2,90147,96610,-,6463
88,BUMA.1121.00104,2,2706334,2712738,+,6404
88,BUMA.1121.00014,2,2734975,2741439,+,6464
88,BUMA.1121.00038,2,2113485,2119945,+,6460
88,BUMA.1121.00098,2,2875791,2882417,+,6626
88,BUMA.1121.00078,2,514149,520579,-,6430
88,BUMA.1121.00029,2,1901392,1907806,-,6414
88,BUMA.1121.00099,2,2861760,2868364,+,6604
88,BUMA.1121.00103,2,1257228,1263830,+,6602
88,BUMA.1121.00102,2,2648785,2655219,+,6434
88,BUMA.1121.00028,2,109170,115615,-,6445
88,BUMA.1121.00075,2,215450,221864,-,6414
88,BUMA.1121.00044,2,160302,166747,-,6445
88,BUMA.1121.00076,2,375554,381970,+,6416
88,BUMA.1121.00074,2,1748045,1754455,-,6410
88,BUMA.1121.00073,2,2602676,2609134,+,6458
88,BUMA.1121.00083,2,1273015,1279473,+,6458
88,BUMA.1121.00035,2,1979038,1985515,-,6477
88,BUMA.1121.00072,2,2577140,2583598,+,6458
88,BUMA.1121.00056,2,1383185,1389626,-,6441
88,BUMA.1121.00081,2,104789,111249,-,6460
88,BUMA.1121.00033,2,170280,176725,+,6445
88,BUMA.1121.00061,2,2585756,2592214,+,6458
88,BUMA.1121.00062,2,2286279,2292711,-,6432
88,BUMA.1121.00064,2,2524264,2530716,+,6452
88,BUMA.1121.00060,2,2759792,2766342,-,6550
88,BUMA.1121.00069,2,2568529,2574976,+,6447
88,BUMA.1121.00070,2,2581998,2588456,+,6458
88,BUMA.1121.00068,2,1207070,1213679,+,6609
88,BUMA.1121.00067,2,1303343,1309735,-,6392
88,BUMA.1121.00037,2,2969620,2977334,+,7714
88,BUMA.1121.00065,2,2691805,2698320,+,6515
88,BUMA.1121.00058,2,10168,16579,+,6411
88,BUMA.1121.00041,2,348016,354538,+,6522
88,BUMA.1121.00084,2,1331656,1338084,+,6428
88,BUMA.1121.00096,2,2930735,2937223,+,6488
88,BUMA.1121.00080,2,2671697,2678115,+,6418
88,BUMA.1121.00013,2,535382,541851,-,6469
88,BUMA.1121.00100,2,648416,655034,+,6618
88,BUMA.1121.00012,2,2308579,2315143,-,6564
88,BUMA.1121.00018,2,1182592,1189186,-,6594
88,BUMA.1121.00048,2,844239,850699,-,6460
88,BUMA.1121.00106,2,1897046,1903469,+,6423
88,BUMA.1121.00017,2,109136,115581,-,6445
88,BUMA.1121.00082,2,2649099,2655557,+,6458
89,BUMA.1121.00049,2,1265991,1283619,+,17628
89,BUMA.1121.00055,2,36624,54215,-,17591
89,BUMA.1121.00011,2,1241107,1258812,+,17705
89,BUMA.1121.00110,2,2586025,2603600,+,17575
89,BUMA.1121.00109,2,1987388,2005044,-,17656
89,BUMA.1121.00077,2,1012309,1029885,-,17576
89,BUMA.1121.00027,2,541354,558929,+,17575
89,BUMA.1121.00021,2,3121427,3138916,+,17489
89,BUMA.1121.00023,2,2761969,2779571,+,17602
89,BUMA.1121.00022,2,1631790,1649449,-,17659
89,BUMA.1121.00034,2,89921,107535,-,17614
89,BUMA.1121.00025,2,1150658,1168191,+,17533
89,BUMA.1121.00031,2,1806961,1824520,+,17559
89,BUMA.1121.00007,2,2747502,2765047,+,17545
89,BUMA.1121.00097,2,2461211,2478830,+,17619
89,BUMA.1121.00008,2,89983,107597,-,17614
89,BUMA.1121.00059,2,959404,976907,-,17503
89,BUMA.1121.00002,2,467147,484733,+,17586
89,BUMA.1121.00004,2,89977,107591,-,17614
89,BUMA.1121.00005,2,1284298,1301912,-,17614
89,BUMA.1121.00111,2,1954220,1971783,+,17563
89,BUMA.1121.00006,2,2220351,2238028,+,17677
89,BUMA.1121.00009,2,1283419,1301096,+,17677
89,BUMA.1121.00094,2,2663004,2680600,+,17596
89,BUMA.1121.00101,2,772967,790649,-,17682
89,BUMA.1121.00066,2,2592796,2610335,+,17539
89,BUMA.1121.00095,2,1487670,1505289,+,17619
89,BUMA.1121.00112,2,1731399,1749040,-,17641
89,BUMA.1121.00042,2,1618047,1635636,+,17589
89,BUMA.1121.00090,2,363173,380750,+,17577
89,BUMA.1121.00020,2,89969,107590,-,17621
89,BUMA.1121.00089,2,2608876,2626472,+,17596
89,BUMA.1121.00051,2,2622298,2639903,+,17605
89,BUMA.1121.00001,2,2764861,2782485,-,17624
89,BUMA.1121.00045,2,2505666,2523260,+,17594
89,BUMA.1121.00043,2,2920036,2937793,-,17757
89,BUMA.1121.00063,2,2602521,2620053,+,17532
89,BUMA.1121.00079,2,2622660,2640183,+,17523
89,BUMA.1121.00071,2,2609314,2626858,+,17544
89,BUMA.1121.00086,2,86881,104498,-,17617
89,BUMA.1121.00024,2,89976,107590,-,17614
89,BUMA.1121.00010,2,1319015,1336603,+,17588
89,BUMA.1121.00040,2,2198632,2216271,+,17639
89,BUMA.1121.00093,2,295787,313281,-,17494
89,BUMA.1121.00091,2,994323,1011880,-,17557
89,BUMA.1121.00107,2,1154000,1171708,-,17708
89,BUMA.1121.00088,2,2635085,2652668,+,17583
89,BUMA.1121.00047,2,436931,454446,+,17515
89,BUMA.1121.00019,2,89969,107583,-,17614
89,BUMA.1121.00087,2,498764,516382,+,17618
89,BUMA.1121.00039,2,1327592,1345152,-,17560
89,BUMA.1121.00030,2,2014244,2031838,+,17594
89,BUMA.1121.00016,2,1070992,1088725,-,17733
89,BUMA.1121.00092,2,2624684,2642178,+,17494
89,BUMA.1121.00085,2,1249710,1267323,-,17613
89,BUMA.1121.00046,2,1025046,1042744,+,17698
89,BUMA.1121.00003,2,867158,884889,+,17731
89,BUMA.1121.00054,2,2020443,2038120,+,17677
89,BUMA.1121.00015,2,337837,355466,-,17629
89,BUMA.1121.00105,2,2993904,3011473,-,17569
89,BUMA.1121.00052,2,203369,220982,-,17613
89,BUMA.1121.00053,2,2910433,2928008,+,17575
89,BUMA.1121.00057,2,2598425,2616027,-,17602
89,BUMA.1121.00108,2,2869996,2887632,+,17636
89,BUMA.1121.00050,2,70842,88546,-,17704
89,BUMA.1121.00104,2,2713094,2730661,+,17567
89,BUMA.1121.00014,2,2741795,2759354,+,17559
89,BUMA.1121.00036,2,1491470,1509041,+,17571
89,BUMA.1121.00038,2,2121545,2139229,+,17684
89,BUMA.1121.00098,2,2882773,2900330,+,17557
89,BUMA.1121.00078,2,496203,513793,-,17590
89,BUMA.1121.00029,2,1883387,1901025,-,17638
89,BUMA.1121.00099,2,2868720,2886317,+,17597
89,BUMA.1121.00103,2,1264186,1281779,+,17593
89,BUMA.1121.00102,2,2655575,2673199,+,17624
89,BUMA.1121.00028,2,89962,107569,-,17607
89,BUMA.1121.00075,2,197514,215094,-,17580
89,BUMA.1121.00044,2,141108,158701,-,17593
89,BUMA.1121.00076,2,382326,399898,+,17572
89,BUMA.1121.00074,2,1730158,1747689,-,17531
89,BUMA.1121.00073,2,2609490,2626999,+,17509
89,BUMA.1121.00083,2,1279829,1297373,+,17544
89,BUMA.1121.00035,2,1961068,1978671,-,17603
89,BUMA.1121.00072,2,2583954,2601491,+,17537
89,BUMA.1121.00056,2,1365278,1382829,-,17551
89,BUMA.1121.00081,2,85512,103188,-,17676
89,BUMA.1121.00033,2,177081,194590,+,17509
89,BUMA.1121.00061,2,2592570,2610101,+,17531
89,BUMA.1121.00062,2,2268355,2285923,-,17568
89,BUMA.1121.00064,2,2531072,2548622,+,17550
89,BUMA.1121.00060,2,2741835,2759436,-,17601
89,BUMA.1121.00069,2,2575343,2592879,+,17536
89,BUMA.1121.00070,2,2588812,2606334,+,17522
89,BUMA.1121.00068,2,1214035,1231677,+,17642
89,BUMA.1121.00067,2,1285413,1302987,-,17574
89,BUMA.1121.00037,2,2977690,2995251,+,17561
89,BUMA.1121.00065,2,2698676,2716229,+,17553
89,BUMA.1121.00058,2,16935,34557,+,17622
89,BUMA.1121.00041,2,354896,372371,+,17475
89,BUMA.1121.00084,2,1338440,1356040,+,17600
89,BUMA.1121.00096,2,2937579,2955146,+,17567
89,BUMA.1121.00080,2,2678471,2695995,+,17524
89,BUMA.1121.00013,2,516120,533784,-,17664
89,BUMA.1121.00100,2,655390,673048,+,17658
89,BUMA.1121.00012,2,2290628,2308223,-,17595
89,BUMA.1121.00018,2,1164696,1182236,-,17540
89,BUMA.1121.00048,2,824962,842638,-,17676
89,BUMA.1121.00106,2,1903825,1921443,+,17618
89,BUMA.1121.00017,2,89921,107535,-,17614
89,BUMA.1121.00082,2,2655913,2673457,+,17544
90,BUMA.1121.00049,2,1284208,1287224,+,3016
90,BUMA.1121.00055,2,33019,36034,-,3015
90,BUMA.1121.00011,2,1259401,1262417,+,3016
90,BUMA.1121.00110,2,2604189,2607205,+,3016
90,BUMA.1121.00109,2,1983783,1986798,-,3015
90,BUMA.1121.00077,2,1008713,1011719,-,3006
90,BUMA.1121.00027,2,559518,562534,+,3016
90,BUMA.1121.00021,2,642,3658,+,3016
90,BUMA.1121.00023,2,2780160,2783176,+,3016
90,BUMA.1121.00022,2,1628186,1631200,-,3014
90,BUMA.1121.00034,2,86317,89331,-,3014
90,BUMA.1121.00025,2,1168780,1171796,+,3016
90,BUMA.1121.00031,2,1825109,1828125,+,3016
90,BUMA.1121.00007,2,2765636,2768652,+,3016
90,BUMA.1121.00097,2,2479419,2482435,+,3016
90,BUMA.1121.00008,2,86379,89393,-,3014
90,BUMA.1121.00059,2,955799,958814,-,3015
90,BUMA.1121.00002,2,485322,488336,+,3014
90,BUMA.1121.00004,2,86373,89387,-,3014
90,BUMA.1121.00005,2,1280693,1283708,-,3015
90,BUMA.1121.00111,2,1972372,1975388,+,3016
90,BUMA.1121.00006,2,2238617,2241631,+,3014
90,BUMA.1121.00009,2,1301685,1304701,+,3016
90,BUMA.1121.00094,2,2681189,2684205,+,3016
90,BUMA.1121.00101,2,769373,772377,-,3004
90,BUMA.1121.00066,2,2610924,2613940,+,3016
90,BUMA.1121.00095,2,1505878,1508888,+,3010
90,BUMA.1121.00112,2,1727794,1730809,-,3015
90,BUMA.1121.00042,2,1636225,1639239,+,3014
90,BUMA.1121.00090,2,381339,384355,+,3016
90,BUMA.1121.00020,2,86365,89379,-,3014
90,BUMA.1121.00089,2,2627061,2630077,+,3016
90,BUMA.1121.00051,2,2640492,2643508,+,3016
90,BUMA.1121.00001,2,2761256,2764271,-,3015
90,BUMA.1121.00045,2,2523849,2526865,+,3016
90,BUMA.1121.00043,2,2916431,2919446,-,3015
90,BUMA.1121.00063,2,2620642,2623658,+,3016
90,BUMA.1121.00079,2,2640772,2643788,+,3016
90,BUMA.1121.00071,2,2627447,2630463,+,3016
90,BUMA.1121.00086,2,83277,86291,-,3014
90,BUMA.1121.00024,2,86372,89386,-,3014
90,BUMA.1121.00010,2,1337192,1340206,+,3014
90,BUMA.1121.00040,2,2216860,2219874,+,3014
90,BUMA.1121.00093,2,292182,295197,-,3015
90,BUMA.1121.00091,2,990718,993733,-,3015
90,BUMA.1121.00107,2,1150394,1153410,-,3016
90,BUMA.1121.00088,2,2653257,2656273,+,3016
90,BUMA.1121.00047,2,455035,458051,+,3016
90,BUMA.1121.00019,2,86365,89379,-,3014
90,BUMA.1121.00087,2,516971,519985,+,3014
90,BUMA.1121.00039,2,1323987,1327002,-,3015
90,BUMA.1121.00030,2,2032427,2035441,+,3014
90,BUMA.1121.00016,2,1067387,1070402,-,3015
90,BUMA.1121.00092,2,2642767,2645783,+,3016
90,BUMA.1121.00085,2,1246106,1249120,-,3014
90,BUMA.1121.00046,2,1043333,1046347,+,3014
90,BUMA.1121.00003,2,885478,888494,+,3016
90,BUMA.1121.00054,2,2038709,2041723,+,3014
90,BUMA.1121.00015,2,334233,337247,-,3014
90,BUMA.1121.00105,2,2990299,2993314,-,3015
90,BUMA.1121.00052,2,199765,202779,-,3014
90,BUMA.1121.00053,2,2928597,2931613,+,3016
90,BUMA.1121.00057,2,2594820,2597835,-,3015
90,BUMA.1121.00108,2,2888221,2891237,+,3016
90,BUMA.1121.00050,2,67238,70252,-,3014
90,BUMA.1121.00104,2,2731250,2734266,+,3016
90,BUMA.1121.00014,2,2759943,2762959,+,3016
90,BUMA.1121.00036,2,1509630,1512644,+,3014
90,BUMA.1121.00038,2,2139818,2142832,+,3014
90,BUMA.1121.00098,2,2900919,2903935,+,3016
90,BUMA.1121.00078,2,492598,495613,-,3015
90,BUMA.1121.00029,2,1879783,1882797,-,3014
90,BUMA.1121.00099,2,2886906,2889922,+,3016
90,BUMA.1121.00103,2,1282368,1285382,+,3014
90,BUMA.1121.00102,2,2673788,2676804,+,3016
90,BUMA.1121.00028,2,86358,89372,-,3014
90,BUMA.1121.00075,2,193909,196924,-,3015
90,BUMA.1121.00044,2,137504,140518,-,3014
90,BUMA.1121.00076,2,400487,403503,+,3016
90,BUMA.1121.00074,2,1726553,1729568,-,3015
90,BUMA.1121.00073,2,2627588,2630604,+,3016
90,BUMA.1121.00083,2,1297962,1300978,+,3016
90,BUMA.1121.00035,2,1957463,1960478,-,3015
90,BUMA.1121.00072,2,2602080,2605096,+,3016
90,BUMA.1121.00056,2,1361673,1364688,-,3015
90,BUMA.1121.00081,2,81908,84922,-,3014
90,BUMA.1121.00033,2,195179,198195,+,3016
90,BUMA.1121.00061,2,2610690,2613706,+,3016
90,BUMA.1121.00062,2,2264750,2267765,-,3015
90,BUMA.1121.00064,2,2549211,2552227,+,3016
90,BUMA.1121.00060,2,2738230,2741245,-,3015
90,BUMA.1121.00069,2,2593468,2596484,+,3016
90,BUMA.1121.00070,2,2606923,2609939,+,3016
90,BUMA.1121.00068,2,1232266,1235282,+,3016
90,BUMA.1121.00067,2,1281808,1284823,-,3015
90,BUMA.1121.00037,2,2995840,2998856,+,3016
90,BUMA.1121.00065,2,2716818,2719834,+,3016
90,BUMA.1121.00058,2,35146,38162,+,3016
90,BUMA.1121.00041,2,372960,375976,+,3016
90,BUMA.1121.00084,2,1356629,1359645,+,3016
90,BUMA.1121.00096,2,2955735,2958752,+,3017
90,BUMA.1121.00080,2,2696584,2699600,+,3016
90,BUMA.1121.00013,2,512516,515530,-,3014
90,BUMA.1121.00100,2,673637,676653,+,3016
90,BUMA.1121.00012,2,2287024,2290038,-,3014
90,BUMA.1121.00018,2,1161091,1164106,-,3015
90,BUMA.1121.00048,2,821358,824372,-,3014
90,BUMA.1121.00106,2,1922032,1925048,+,3016
90,BUMA.1121.00017,2,86317,89331,-,3014
90,BUMA.1121.00082,2,2674046,2677062,+,3016
91,BUMA.1121.00049,2,1287225,1301894,+,14669
91,BUMA.1121.00055,2,17113,33017,-,15904
91,BUMA.1121.00011,2,1262418,1277093,+,14675
91,BUMA.1121.00110,2,2607206,2621875,+,14669
91,BUMA.1121.00109,2,1969113,1983781,-,14668
91,BUMA.1121.00077,2,994034,1008711,-,14677
91,BUMA.1121.00027,2,562535,577191,+,14656
91,BUMA.1121.00021,2,3659,18308,+,14649
91,BUMA.1121.00023,2,2783177,2797816,+,14639
91,BUMA.1121.00025,2,1171797,1186448,+,14651
91,BUMA.1121.00031,2,1828126,1842777,+,14651
91,BUMA.1121.00007,2,2768653,2783322,+,14669
91,BUMA.1121.00097,2,2482436,2497105,+,14669
91,BUMA.1121.00059,2,941129,955797,-,14668
91,BUMA.1121.00005,2,1266023,1280691,-,14668
91,BUMA.1121.00111,2,1975389,1990058,+,14669
91,BUMA.1121.00009,2,1304702,1319381,+,14679
91,BUMA.1121.00094,2,2684206,2698875,+,14669
91,BUMA.1121.00101,2,754703,769371,-,14668
91,BUMA.1121.00066,2,2613941,2628609,+,14668
91,BUMA.1121.00095,2,1508890,1523563,+,14673
91,BUMA.1121.00112,2,1713118,1727792,-,14674
91,BUMA.1121.00090,2,384356,399007,+,14651
91,BUMA.1121.00089,2,2630078,2644747,+,14669
91,BUMA.1121.00051,2,2643509,2658178,+,14669
91,BUMA.1121.00001,2,2746604,2761254,-,14650
91,BUMA.1121.00045,2,2526866,2541535,+,14669
91,BUMA.1121.00043,2,2901793,2916429,-,14636
91,BUMA.1121.00063,2,2623659,2638327,+,14668
91,BUMA.1121.00079,2,2643789,2658458,+,14669
91,BUMA.1121.00071,2,2630464,2645132,+,14668
91,BUMA.1121.00093,2,277512,292180,-,14668
91,BUMA.1121.00091,2,976048,990716,-,14668
91,BUMA.1121.00107,2,1135724,1150392,-,14668
91,BUMA.1121.00088,2,2656274,2670943,+,14669
91,BUMA.1121.00047,2,458052,472721,+,14669
91,BUMA.1121.00039,2,1309336,1323985,-,14649
91,BUMA.1121.00016,2,1052724,1067385,-,14661
91,BUMA.1121.00092,2,2645784,2660453,+,14669
91,BUMA.1121.00003,2,888495,903160,+,14665
91,BUMA.1121.00105,2,2975629,2990297,-,14668
91,BUMA.1121.00053,2,2931614,2946283,+,14669
91,BUMA.1121.00057,2,2580160,2594818,-,14658
91,BUMA.1121.00108,2,2891238,2905907,+,14669
91,BUMA.1121.00104,2,2734267,2748936,+,14669
91,BUMA.1121.00014,2,2762960,2777610,+,14650
91,BUMA.1121.00098,2,2903936,2918617,+,14681
91,BUMA.1121.00078,2,477928,492596,-,14668
91,BUMA.1121.00029,2,1863533,1878199,-,14666
91,BUMA.1121.00099,2,2889923,2904592,+,14669
91,BUMA.1121.00103,2,1286970,1302890,+,15920
91,BUMA.1121.00102,2,2676805,2691474,+,14669
91,BUMA.1121.00075,2,179239,193907,-,14668
91,BUMA.1121.00076,2,403504,418173,+,14669
91,BUMA.1121.00074,2,1711883,1726551,-,14668
91,BUMA.1121.00073,2,2630605,2645273,+,14668
91,BUMA.1121.00083,2,1300979,1315647,+,14668
91,BUMA.1121.00035,2,1942811,1957461,-,14650
91,BUMA.1121.00072,2,2605097,2619765,+,14668
91,BUMA.1121.00056,2,1347003,1361671,-,14668
91,BUMA.1121.00033,2,198196,212841,+,14645
91,BUMA.1121.00061,2,2613707,2628375,+,14668
91,BUMA.1121.00062,2,2250080,2264748,-,14668
91,BUMA.1121.00064,2,2552228,2566897,+,14669
91,BUMA.1121.00060,2,2723560,2738228,-,14668
91,BUMA.1121.00069,2,2596485,2611153,+,14668
91,BUMA.1121.00070,2,2609940,2624608,+,14668
91,BUMA.1121.00068,2,1235283,1249950,+,14667
91,BUMA.1121.00067,2,1267138,1281806,-,14668
91,BUMA.1121.00037,2,2998857,3013505,+,14648
91,BUMA.1121.00065,2,2719835,2734511,+,14676
91,BUMA.1121.00058,2,38163,52832,+,14669
91,BUMA.1121.00041,2,375977,390644,+,14667
91,BUMA.1121.00084,2,1359646,1374315,+,14669
91,BUMA.1121.00096,2,2958753,2973422,+,14669
91,BUMA.1121.00080,2,2701182,2715866,+,14684
91,BUMA.1121.00100,2,676654,691322,+,14668
91,BUMA.1121.00012,2,2270774,2285440,-,14666
91,BUMA.1121.00018,2,1146439,1161089,-,14650
91,BUMA.1121.00106,2,1925049,1939718,+,14669
91,BUMA.1121.00082,2,2677063,2691731,+,14668
92,BUMA.1121.00049,2,1301904,1312980,+,11076
92,BUMA.1121.00055,2,6041,17103,-,11062
92,BUMA.1121.00011,2,1277103,1288188,+,11085
92,BUMA.1121.00110,2,2621885,2632980,+,11095
92,BUMA.1121.00109,2,1958026,1969103,-,11077
92,BUMA.1121.00077,2,982929,994024,-,11095
92,BUMA.1121.00027,2,577201,588269,+,11068
92,BUMA.1121.00021,2,18318,29388,+,11070
92,BUMA.1121.00023,2,2797826,2808895,+,11069
92,BUMA.1121.00025,2,1186458,1197533,+,11075
92,BUMA.1121.00031,2,1842787,1853866,+,11079
92,BUMA.1121.00007,2,2783332,2794410,+,11078
92,BUMA.1121.00097,2,2497115,2508184,+,11069
92,BUMA.1121.00059,2,930032,941119,-,11087
92,BUMA.1121.00005,2,1254926,1266013,-,11087
92,BUMA.1121.00111,2,1990068,2001137,+,11069
92,BUMA.1121.00009,2,1319391,1330478,+,11087
92,BUMA.1121.00094,2,2698885,2709972,+,11087
92,BUMA.1121.00101,2,743626,754693,-,11067
92,BUMA.1121.00066,2,2628619,2639688,+,11069
92,BUMA.1121.00095,2,1523573,1534637,+,11064
92,BUMA.1121.00112,2,1702040,1713108,-,11068
92,BUMA.1121.00090,2,399017,410086,+,11069
92,BUMA.1121.00089,2,2644757,2655826,+,11069
92,BUMA.1121.00051,2,2658188,2669257,+,11069
92,BUMA.1121.00001,2,2735525,2746594,-,11069
92,BUMA.1121.00045,2,2541545,2552650,+,11105
92,BUMA.1121.00043,2,2890714,2901783,-,11069
92,BUMA.1121.00063,2,2638337,2649406,+,11069
92,BUMA.1121.00079,2,2658468,2669545,+,11077
92,BUMA.1121.00071,2,2645142,2656211,+,11069
92,BUMA.1121.00093,2,266441,277502,-,11061
92,BUMA.1121.00091,2,964951,976038,-,11087
92,BUMA.1121.00107,2,1124607,1135714,-,11107
92,BUMA.1121.00088,2,2670953,2682031,+,11078
92,BUMA.1121.00047,2,472731,483800,+,11069
92,BUMA.1121.00039,2,1298257,1309326,-,11069
92,BUMA.1121.00016,2,1041645,1052714,-,11069
92,BUMA.1121.00092,2,2660463,2671524,+,11061
92,BUMA.1121.00003,2,903170,914248,+,11078
92,BUMA.1121.00105,2,2964525,2975619,-,11094
92,BUMA.1121.00053,2,2946293,2957380,+,11087
92,BUMA.1121.00057,2,2569081,2580150,-,11069
92,BUMA.1121.00108,2,2905917,2916995,+,11078
92,BUMA.1121.00104,2,2748946,2760015,+,11069
92,BUMA.1121.00014,2,2777620,2788699,+,11079
92,BUMA.1121.00098,2,2918627,2929714,+,11087
92,BUMA.1121.00078,2,466831,477918,-,11087
92,BUMA.1121.00029,2,1852455,1863523,-,11068
92,BUMA.1121.00099,2,2904602,2915689,+,11087
92,BUMA.1121.00103,2,1302900,1313969,+,11069
92,BUMA.1121.00102,2,2692797,2703855,+,11058
92,BUMA.1121.00075,2,168169,179229,-,11060
92,BUMA.1121.00076,2,418183,429243,+,11060
92,BUMA.1121.00074,2,1700797,1711873,-,11076
92,BUMA.1121.00073,2,2645283,2656352,+,11069
92,BUMA.1121.00083,2,1315657,1326726,+,11069
92,BUMA.1121.00035,2,1931732,1942801,-,11069
92,BUMA.1121.00072,2,2619775,2630844,+,11069
92,BUMA.1121.00056,2,1335924,1346993,-,11069
92,BUMA.1121.00033,2,212851,223920,+,11069
92,BUMA.1121.00061,2,2628385,2639454,+,11069
92,BUMA.1121.00062,2,2239001,2250070,-,11069
92,BUMA.1121.00064,2,2566907,2577983,+,11076
92,BUMA.1121.00060,2,2712445,2723550,-,11105
92,BUMA.1121.00069,2,2611163,2622232,+,11069
92,BUMA.1121.00070,2,2624618,2635687,+,11069
92,BUMA.1121.00068,2,1249960,1261038,+,11078
92,BUMA.1121.00067,2,1256041,1267128,-,11087
92,BUMA.1121.00037,2,3013515,3024594,+,11079
92,BUMA.1121.00065,2,2734521,2745599,+,11078
92,BUMA.1121.00058,2,52842,63902,+,11060
92,BUMA.1121.00041,2,390654,401750,+,11096
92,BUMA.1121.00084,2,1374325,1385352,+,11027
92,BUMA.1121.00096,2,2973432,2984502,+,11070
92,BUMA.1121.00080,2,2715876,2726945,+,11069
92,BUMA.1121.00100,2,691332,702410,+,11078
92,BUMA.1121.00012,2,2259695,2270764,-,11069
92,BUMA.1121.00018,2,1135354,1146429,-,11075
92,BUMA.1121.00106,2,1939728,1950815,+,11087
92,BUMA.1121.00082,2,2691741,2702810,+,11069
93,BUMA.1121.00049,2,1313029,1319109,+,6080
93,BUMA.1121.00055,2,1,5997,-,5996
93,BUMA.1121.00011,2,1288237,1294350,+,6113
93,BUMA.1121.00110,2,2633029,2639078,+,6049
93,BUMA.1121.00109,2,1951928,1957977,-,6049
93,BUMA.1121.00077,2,976831,982880,-,6049
93,BUMA.1121.00027,2,588318,594404,+,6086
93,BUMA.1121.00021,2,29437,35492,+,6055
93,BUMA.1121.00023,2,2808944,2814999,+,6055
93,BUMA.1121.00025,2,1197582,1203637,+,6055
93,BUMA.1121.00031,2,1853915,1859970,+,6055
93,BUMA.1121.00007,2,2794459,2800586,+,6127
93,BUMA.1121.00097,2,2508233,2514288,+,6055
93,BUMA.1121.00059,2,923928,929983,-,6055
93,BUMA.1121.00005,2,1248822,1254877,-,6055
93,BUMA.1121.00111,2,2001186,2007241,+,6055
93,BUMA.1121.00009,2,1330527,1336576,+,6049
93,BUMA.1121.00094,2,2710021,2716076,+,6055
93,BUMA.1121.00101,2,735881,741979,-,6098
93,BUMA.1121.00066,2,2639737,2645822,+,6085
93,BUMA.1121.00095,2,1534681,1540736,+,6055
93,BUMA.1121.00112,2,1695942,1701991,-,6049
93,BUMA.1121.00090,2,410135,416190,+,6055
93,BUMA.1121.00089,2,2655875,2661955,+,6080
93,BUMA.1121.00051,2,2669306,2675386,+,6080
93,BUMA.1121.00001,2,2729421,2735476,-,6055
93,BUMA.1121.00045,2,2552699,2558779,+,6080
93,BUMA.1121.00043,2,2884610,2890665,-,6055
93,BUMA.1121.00063,2,2649455,2655540,+,6085
93,BUMA.1121.00079,2,2669594,2675649,+,6055
93,BUMA.1121.00071,2,2656260,2662346,+,6086
93,BUMA.1121.00093,2,260337,266392,-,6055
93,BUMA.1121.00091,2,958847,964902,-,6055
93,BUMA.1121.00107,2,1118489,1124563,-,6074
93,BUMA.1121.00088,2,2682080,2688141,+,6061
93,BUMA.1121.00047,2,483849,489929,+,6080
93,BUMA.1121.00039,2,1292153,1298208,-,6055
93,BUMA.1121.00016,2,1035547,1041596,-,6049
93,BUMA.1121.00092,2,2671573,2677628,+,6055
93,BUMA.1121.00003,2,914297,920377,+,6080
93,BUMA.1121.00105,2,2958396,2964476,-,6080
93,BUMA.1121.00053,2,2957429,2963484,+,6055
93,BUMA.1121.00057,2,2562946,2569032,-,6086
93,BUMA.1121.00108,2,2917044,2923134,+,6090
93,BUMA.1121.00104,2,2760064,2766119,+,6055
93,BUMA.1121.00014,2,2788748,2794803,+,6055
93,BUMA.1121.00098,2,2929763,2935812,+,6049
93,BUMA.1121.00078,2,460727,466782,-,6055
93,BUMA.1121.00029,2,1846351,1852406,-,6055
93,BUMA.1121.00099,2,2915738,2921787,+,6049
93,BUMA.1121.00103,2,1315615,1321664,+,6049
93,BUMA.1121.00102,2,2703904,2709952,+,6048
93,BUMA.1121.00075,2,162065,168120,-,6055
93,BUMA.1121.00076,2,429292,435347,+,6055
93,BUMA.1121.00074,2,1694668,1700748,-,6080
93,BUMA.1121.00073,2,2656401,2662486,+,6085
93,BUMA.1121.00083,2,1326775,1332861,+,6086
93,BUMA.1121.00035,2,1925628,1931683,-,6055
93,BUMA.1121.00072,2,2630893,2636979,+,6086
93,BUMA.1121.00056,2,1329795,1335875,-,6080
93,BUMA.1121.00033,2,223969,230024,+,6055
93,BUMA.1121.00061,2,2639503,2645589,+,6086
93,BUMA.1121.00062,2,2232891,2238952,-,6061
93,BUMA.1121.00064,2,2578032,2584112,+,6080
93,BUMA.1121.00060,2,2706316,2712396,-,6080
93,BUMA.1121.00069,2,2622281,2628365,+,6084
93,BUMA.1121.00070,2,2635736,2641822,+,6086
93,BUMA.1121.00068,2,1261087,1267161,+,6074
93,BUMA.1121.00067,2,1249912,1255992,-,6080
93,BUMA.1121.00037,2,3024643,3030698,+,6055
93,BUMA.1121.00065,2,2745648,2751702,+,6054
93,BUMA.1121.00058,2,63951,70031,+,6080
93,BUMA.1121.00041,2,401799,407848,+,6049
93,BUMA.1121.00084,2,1385401,1391456,+,6055
93,BUMA.1121.00096,2,2984551,2990606,+,6055
93,BUMA.1121.00080,2,2726994,2733074,+,6080
93,BUMA.1121.00100,2,702459,708539,+,6080
93,BUMA.1121.00012,2,2253591,2259646,-,6055
93,BUMA.1121.00018,2,1129250,1135305,-,6055
93,BUMA.1121.00106,2,1950864,1956919,+,6055
93,BUMA.1121.00082,2,2702859,2708945,+,6086
94,BUMA.1121.00049,2,1335408,1347519,+,12111
94,BUMA.1121.00055,2,3128755,3140845,-,12090
94,BUMA.1121.00011,2,1310651,1322725,+,12074
94,BUMA.1121.00110,2,2655378,2667540,+,12162
94,BUMA.1121.00109,2,1923486,1935627,-,12141
94,BUMA.1121.00077,2,948367,960529,-,12162
94,BUMA.1121.00027,2,604197,616293,+,12096
94,BUMA.1121.00021,2,51791,63849,+,12058
94,BUMA.1121.00023,2,2831298,2843369,+,12071
94,BUMA.1121.00025,2,1219936,1232039,+,12103
94,BUMA.1121.00031,2,1876270,1888388,+,12118
94,BUMA.1121.00007,2,2816886,2829005,+,12119
94,BUMA.1121.00097,2,2530587,2542695,+,12108
94,BUMA.1121.00059,2,902067,914134,-,12067
94,BUMA.1121.00005,2,1220421,1232531,-,12110
94,BUMA.1121.00111,2,2027404,2039492,+,12088
94,BUMA.1121.00009,2,1352876,1364951,+,12075
94,BUMA.1121.00094,2,2732378,2744531,+,12153
94,BUMA.1121.00101,2,707525,719579,-,12054
94,BUMA.1121.00066,2,2655615,2667709,+,12094
94,BUMA.1121.00095,2,1557035,1569080,+,12045
94,BUMA.1121.00112,2,1667585,1679642,-,12057
94,BUMA.1121.00090,2,432490,444584,+,12094
94,BUMA.1121.00089,2,2678257,2690411,+,12154
94,BUMA.1121.00051,2,2691688,2703830,+,12142
94,BUMA.1121.00001,2,2701037,2713122,-,12085
94,BUMA.1121.00045,2,2575072,2587182,+,12110
94,BUMA.1121.00043,2,2856226,2868309,-,12083
94,BUMA.1121.00063,2,2665333,2677423,+,12090
94,BUMA.1121.00079,2,2691949,2704047,+,12098
94,BUMA.1121.00071,2,2672139,2684229,+,12090
94,BUMA.1121.00093,2,238474,250543,-,12069
94,BUMA.1121.00091,2,930452,942546,-,12094
94,BUMA.1121.00107,2,1090064,1102202,-,12138
94,BUMA.1121.00088,2,2697934,2710004,+,12070
94,BUMA.1121.00047,2,506231,518358,+,12127
94,BUMA.1121.00039,2,1263811,1275852,-,12041
94,BUMA.1121.00016,2,1007173,1019246,-,12073
94,BUMA.1121.00092,2,2687421,2699490,+,12069
94,BUMA.1121.00003,2,936650,948727,+,12077
94,BUMA.1121.00105,2,2929994,2942095,-,12101
94,BUMA.1121.00053,2,2979784,2991852,+,12068
94,BUMA.1121.00057,2,2541061,2553152,-,12091
94,BUMA.1121.00108,2,2939434,2951496,+,12062
94,BUMA.1121.00104,2,2782418,2794523,+,12105
94,BUMA.1121.00014,2,2811103,2823204,+,12101
94,BUMA.1121.00098,2,2952112,2964212,+,12100
94,BUMA.1121.00078,2,432308,444426,-,12118
94,BUMA.1121.00029,2,1817977,1830050,-,12073
94,BUMA.1121.00099,2,2938073,2950176,+,12103
94,BUMA.1121.00103,2,1337963,1350046,+,12083
94,BUMA.1121.00102,2,2726252,2738317,+,12065
94,BUMA.1121.00075,2,133665,145765,-,12100
94,BUMA.1121.00076,2,451646,463746,+,12100
94,BUMA.1121.00074,2,1666263,1678360,-,12097
94,BUMA.1121.00073,2,2672279,2684373,+,12094
94,BUMA.1121.00083,2,1342654,1354748,+,12094
94,BUMA.1121.00035,2,1897242,1909327,-,12085
94,BUMA.1121.00072,2,2646772,2658871,+,12099
94,BUMA.1121.00056,2,1301338,1313492,-,12154
94,BUMA.1121.00033,2,246320,258414,+,12094
94,BUMA.1121.00061,2,2655382,2667457,+,12075
94,BUMA.1121.00062,2,2204498,2216590,-,12092
94,BUMA.1121.00064,2,2600412,2612581,+,12169
94,BUMA.1121.00060,2,2677912,2690022,-,12110
94,BUMA.1121.00069,2,2638158,2650248,+,12090
94,BUMA.1121.00070,2,2651615,2663709,+,12094
94,BUMA.1121.00068,2,1283456,1295563,+,12107
94,BUMA.1121.00067,2,1228002,1240118,-,12116
94,BUMA.1121.00037,2,3046998,3059065,+,12067
94,BUMA.1121.00065,2,2768000,2780088,+,12088
94,BUMA.1121.00058,2,86331,98426,+,12095
94,BUMA.1121.00041,2,424148,436231,+,12083
94,BUMA.1121.00084,2,1407756,1419840,+,12084
94,BUMA.1121.00096,2,3006906,3018992,+,12086
94,BUMA.1121.00080,2,2749376,2761538,+,12162
94,BUMA.1121.00100,2,724832,736946,+,12114
94,BUMA.1121.00012,2,2225226,2237291,-,12065
94,BUMA.1121.00018,2,1100847,1112950,-,12103
94,BUMA.1121.00106,2,1973219,1985289,+,12070
94,BUMA.1121.00082,2,2718738,2730832,+,12094
95,BUMA.1121.00049,2,1348901,1353013,+,4112
95,BUMA.1121.00055,2,3123273,3127373,-,4100
95,BUMA.1121.00011,2,1324107,1328193,+,4086
95,BUMA.1121.00110,2,2668922,2673032,+,4110
95,BUMA.1121.00109,2,1917998,1922104,-,4106
95,BUMA.1121.00077,2,942876,946985,-,4109
95,BUMA.1121.00027,2,617675,621778,+,4103
95,BUMA.1121.00021,2,65239,69358,+,4119
95,BUMA.1121.00023,2,2844751,2848862,+,4111
95,BUMA.1121.00025,2,1233429,1237508,+,4079
95,BUMA.1121.00031,2,1889770,1893873,+,4103
95,BUMA.1121.00007,2,2830387,2834519,+,4132
95,BUMA.1121.00097,2,2544077,2548161,+,4084
95,BUMA.1121.00059,2,896590,900683,-,4093
95,BUMA.1121.00005,2,1214882,1219039,-,4157
95,BUMA.1121.00111,2,2040874,2044932,+,4058
95,BUMA.1121.00009,2,1366333,1370420,+,4087
95,BUMA.1121.00094,2,2745901,2749958,+,4057
95,BUMA.1121.00101,2,702063,706155,-,4092
95,BUMA.1121.00066,2,2669091,2673163,+,4072
95,BUMA.1121.00095,2,1570468,1574529,+,4061
95,BUMA.1121.00112,2,1662094,1666203,-,4109
95,BUMA.1121.00090,2,445966,450077,+,4111
95,BUMA.1121.00089,2,2691781,2695838,+,4057
95,BUMA.1121.00051,2,2705199,2709256,+,4057
95,BUMA.1121.00001,2,2695537,2699655,-,4118
95,BUMA.1121.00045,2,2588564,2592652,+,4088
95,BUMA.1121.00043,2,2850734,2854844,-,4110
95,BUMA.1121.00063,2,2678805,2682877,+,4072
95,BUMA.1121.00079,2,2705417,2709474,+,4057
95,BUMA.1121.00071,2,2685611,2689683,+,4072
95,BUMA.1121.00093,2,232981,237092,-,4111
95,BUMA.1121.00091,2,924983,929070,-,4087
95,BUMA.1121.00107,2,1084579,1088675,-,4096
95,BUMA.1121.00088,2,2711374,2715469,+,4095
95,BUMA.1121.00088,2,2716239,2720332,+,4093
95,BUMA.1121.00047,2,519728,523840,+,4112
95,BUMA.1121.00039,2,1258305,1262429,-,4124
95,BUMA.1121.00016,2,1001697,1005791,-,4094
95,BUMA.1121.00092,2,2700872,2704984,+,4112
95,BUMA.1121.00003,2,950097,954192,+,4095
95,BUMA.1121.00105,2,2924548,2928612,-,4064
95,BUMA.1121.00053,2,2993234,2997334,+,4100
95,BUMA.1121.00057,2,2535608,2539679,-,4071
95,BUMA.1121.00108,2,2952857,2956956,+,4099
95,BUMA.1121.00104,2,2795905,2800017,+,4112
95,BUMA.1121.00014,2,2824586,2828673,+,4087
95,BUMA.1121.00098,2,2965602,2969702,+,4100
95,BUMA.1121.00078,2,426807,430935,-,4128
95,BUMA.1121.00029,2,1812517,1816595,-,4078
95,BUMA.1121.00099,2,2951566,2955686,+,4120
95,BUMA.1121.00103,2,1351436,1355560,+,4124
95,BUMA.1121.00102,2,2739707,2743809,+,4102
95,BUMA.1121.00075,2,128207,132284,-,4077
95,BUMA.1121.00076,2,465128,469207,+,4079
95,BUMA.1121.00074,2,1660771,1664881,-,4110
95,BUMA.1121.00073,2,2685755,2689827,+,4072
95,BUMA.1121.00083,2,1356130,1360202,+,4072
95,BUMA.1121.00035,2,1891782,1895860,-,4078
95,BUMA.1121.00072,2,2660244,2664316,+,4072
95,BUMA.1121.00056,2,1295912,1299968,-,4056
95,BUMA.1121.00033,2,259796,263883,+,4087
95,BUMA.1121.00061,2,2668839,2672910,+,4071
95,BUMA.1121.00062,2,2199007,2203116,-,4109
95,BUMA.1121.00064,2,2613963,2618075,+,4112
95,BUMA.1121.00060,2,2672443,2676530,-,4087
95,BUMA.1121.00069,2,2651630,2655701,+,4071
95,BUMA.1121.00070,2,2665091,2669163,+,4072
95,BUMA.1121.00068,2,1296933,1301064,+,4131
95,BUMA.1121.00067,2,1222536,1226629,-,4093
95,BUMA.1121.00037,2,3060447,3064542,+,4095
95,BUMA.1121.00065,2,2781470,2785608,+,4138
95,BUMA.1121.00058,2,99808,103926,+,4118
95,BUMA.1121.00041,2,437613,441708,+,4095
95,BUMA.1121.00084,2,1421210,1425346,+,4136
95,BUMA.1121.00096,2,3020362,3024494,+,4132
95,BUMA.1121.00080,2,2762908,2766965,+,4057
95,BUMA.1121.00100,2,738316,742404,+,4088
95,BUMA.1121.00012,2,2219774,2223844,-,4070
95,BUMA.1121.00018,2,1095380,1099458,-,4078
95,BUMA.1121.00106,2,1986659,1990778,+,4119
95,BUMA.1121.00082,2,2732214,2736286,+,4072
96,BUMA.1121.00049,2,1353783,1369498,+,15715
96,BUMA.1121.00055,2,3106769,3122502,-,15733
96,BUMA.1121.00011,2,1328963,1344671,+,15708
96,BUMA.1121.00110,2,2673802,2689504,+,15702
96,BUMA.1121.00109,2,1901521,1917227,-,15706
96,BUMA.1121.00077,2,926405,942105,-,15700
96,BUMA.1121.00027,2,622548,638278,+,15730
96,BUMA.1121.00021,2,70128,87209,+,17081
96,BUMA.1121.00023,2,2849632,2866723,+,17091
96,BUMA.1121.00025,2,1238278,1253998,+,15720
96,BUMA.1121.00031,2,1894643,1910368,+,15725
96,BUMA.1121.00007,2,2835289,2851003,+,15714
96,BUMA.1121.00097,2,2548932,2564655,+,15723
96,BUMA.1121.00059,2,880119,895819,-,15700
96,BUMA.1121.00005,2,1198369,1214111,-,15742
96,BUMA.1121.00111,2,2045702,2061422,+,15720
96,BUMA.1121.00009,2,1371190,1386890,+,15700
96,BUMA.1121.00094,2,2750728,2767782,+,17054
96,BUMA.1121.00101,2,685584,701292,-,15708
96,BUMA.1121.00066,2,2673933,2689639,+,15706
96,BUMA.1121.00095,2,1575299,1591007,+,15708
96,BUMA.1121.00112,2,1645615,1661323,-,15708
96,BUMA.1121.00090,2,450847,466564,+,15717
96,BUMA.1121.00089,2,2696608,2713662,+,17054
96,BUMA.1121.00051,2,2710026,2727079,+,17053
96,BUMA.1121.00001,2,2677687,2694766,-,17079
96,BUMA.1121.00045,2,2593423,2609125,+,15702
96,BUMA.1121.00043,2,2833063,2849963,-,16900
96,BUMA.1121.00063,2,2683647,2699352,+,15705
96,BUMA.1121.00079,2,2710244,2727297,+,17053
96,BUMA.1121.00071,2,2690453,2706157,+,15704
96,BUMA.1121.00093,2,216480,232210,-,15730
96,BUMA.1121.00091,2,908503,924211,-,15708
96,BUMA.1121.00107,2,1068109,1083808,-,15699
96,BUMA.1121.00088,2,2721102,2736822,+,15720
96,BUMA.1121.00047,2,524610,541663,+,17053
96,BUMA.1121.00039,2,1240453,1257534,-,17081
96,BUMA.1121.00016,2,983861,1000926,-,17065
96,BUMA.1121.00092,2,2705754,2721484,+,15730
96,BUMA.1121.00003,2,954962,970694,+,15732
96,BUMA.1121.00105,2,2908071,2923777,-,15706
96,BUMA.1121.00053,2,2998104,3013825,+,15721
96,BUMA.1121.00057,2,2519131,2534837,-,15706
96,BUMA.1121.00108,2,2957726,2973427,+,15701
96,BUMA.1121.00104,2,2800787,2816499,+,15712
96,BUMA.1121.00014,2,2829443,2845163,+,15720
96,BUMA.1121.00098,2,2970472,2986180,+,15708
96,BUMA.1121.00078,2,410322,426035,-,15713
96,BUMA.1121.00029,2,1796021,1811746,-,15725
96,BUMA.1121.00099,2,2956456,2972164,+,15708
96,BUMA.1121.00103,2,1356330,1371945,+,15615
96,BUMA.1121.00102,2,2744579,2760287,+,15708
96,BUMA.1121.00075,2,111736,127436,-,15700
96,BUMA.1121.00076,2,469977,485677,+,15700
96,BUMA.1121.00074,2,1644280,1660000,-,15720
96,BUMA.1121.00073,2,2690597,2706302,+,15705
96,BUMA.1121.00083,2,1360972,1376678,+,15706
96,BUMA.1121.00035,2,1875286,1891011,-,15725
96,BUMA.1121.00072,2,2665086,2680792,+,15706
96,BUMA.1121.00056,2,1278087,1295141,-,17054
96,BUMA.1121.00033,2,264653,280364,+,15711
96,BUMA.1121.00061,2,2673681,2689387,+,15706
96,BUMA.1121.00062,2,2182530,2198236,-,15706
96,BUMA.1121.00064,2,2618845,2634565,+,15720
96,BUMA.1121.00060,2,2655969,2671671,-,15702
96,BUMA.1121.00069,2,2656472,2672178,+,15706
96,BUMA.1121.00070,2,2669933,2685638,+,15705
96,BUMA.1121.00068,2,1301835,1317564,+,15729
96,BUMA.1121.00067,2,1206048,1221765,-,15717
96,BUMA.1121.00037,2,3065312,3081027,+,15715
96,BUMA.1121.00065,2,2786378,2802083,+,15705
96,BUMA.1121.00058,2,104696,120411,+,15715
96,BUMA.1121.00041,2,442478,458195,+,15717
96,BUMA.1121.00084,2,1426116,1441837,+,15721
96,BUMA.1121.00096,2,3025264,3040972,+,15708
96,BUMA.1121.00080,2,2767735,2784789,+,17054
96,BUMA.1121.00100,2,743174,758874,+,15700
96,BUMA.1121.00012,2,2201924,2219003,-,17079
96,BUMA.1121.00018,2,1078889,1094609,-,15720
96,BUMA.1121.00106,2,1991548,2008630,+,17082
96,BUMA.1121.00082,2,2737056,2752762,+,15706
97,BUMA.1121.00049,2,1369680,1377850,+,8170
97,BUMA.1121.00055,2,3098418,3106587,-,8169
97,BUMA.1121.00011,2,1344853,1353023,+,8170
97,BUMA.1121.00110,2,2689686,2697856,+,8170
97,BUMA.1121.00109,2,1893170,1901339,-,8169
97,BUMA.1121.00077,2,918054,926223,-,8169
97,BUMA.1121.00027,2,638460,646630,+,8170
97,BUMA.1121.00021,2,87391,95561,+,8170
97,BUMA.1121.00023,2,2866894,2875075,+,8181
97,BUMA.1121.00025,2,1254180,1262341,+,8161
97,BUMA.1121.00031,2,1910550,1918721,+,8171
97,BUMA.1121.00007,2,2851185,2859355,+,8170
97,BUMA.1121.00097,2,2564837,2573007,+,8170
97,BUMA.1121.00059,2,871768,879937,-,8169
97,BUMA.1121.00005,2,1190018,1198187,-,8169
97,BUMA.1121.00111,2,2061604,2069774,+,8170
97,BUMA.1121.00009,2,1387072,1395242,+,8170
97,BUMA.1121.00094,2,2767964,2776134,+,8170
97,BUMA.1121.00101,2,677233,685402,-,8169
97,BUMA.1121.00066,2,2689821,2697991,+,8170
97,BUMA.1121.00095,2,1591189,1599359,+,8170
97,BUMA.1121.00112,2,1637264,1645433,-,8169
97,BUMA.1121.00090,2,466746,474914,+,8168
97,BUMA.1121.00089,2,2713844,2722014,+,8170
97,BUMA.1121.00051,2,2728602,2736788,+,8186
97,BUMA.1121.00001,2,2669335,2677505,-,8170
97,BUMA.1121.00045,2,2609307,2617477,+,8170
97,BUMA.1121.00043,2,2824712,2832881,-,8169
97,BUMA.1121.00063,2,2699534,2707704,+,8170
97,BUMA.1121.00079,2,2727479,2735647,+,8168
97,BUMA.1121.00071,2,2706339,2714509,+,8170
97,BUMA.1121.00093,2,208129,216298,-,8169
97,BUMA.1121.00091,2,900152,908321,-,8169
97,BUMA.1121.00107,2,1059758,1067927,-,8169
97,BUMA.1121.00088,2,2737004,2745174,+,8170
97,BUMA.1121.00047,2,541845,550015,+,8170
97,BUMA.1121.00039,2,1232104,1240271,-,8167
97,BUMA.1121.00016,2,975509,983679,-,8170
97,BUMA.1121.00092,2,2721666,2729836,+,8170
97,BUMA.1121.00003,2,970876,979046,+,8170
97,BUMA.1121.00105,2,2899720,2907889,-,8169
97,BUMA.1121.00053,2,3014007,3022177,+,8170
97,BUMA.1121.00057,2,2510780,2518949,-,8169
97,BUMA.1121.00108,2,2973609,2981775,+,8166
97,BUMA.1121.00104,2,2816681,2824851,+,8170
97,BUMA.1121.00014,2,2845345,2853516,+,8171
97,BUMA.1121.00098,2,2986362,2994532,+,8170
97,BUMA.1121.00078,2,401971,410141,-,8170
97,BUMA.1121.00029,2,1787670,1795839,-,8169
97,BUMA.1121.00099,2,2972346,2980516,+,8170
97,BUMA.1121.00103,2,1372127,1380297,+,8170
97,BUMA.1121.00102,2,2760469,2768639,+,8170
97,BUMA.1121.00075,2,103385,111555,-,8170
97,BUMA.1121.00076,2,485858,494029,+,8171
97,BUMA.1121.00074,2,1635929,1644098,-,8169
97,BUMA.1121.00073,2,2706484,2714654,+,8170
97,BUMA.1121.00083,2,1376860,1385030,+,8170
97,BUMA.1121.00035,2,1866934,1875104,-,8170
97,BUMA.1121.00072,2,2680973,2689144,+,8171
97,BUMA.1121.00056,2,1269736,1277905,-,8169
97,BUMA.1121.00033,2,280546,288713,+,8167
97,BUMA.1121.00061,2,2689569,2697739,+,8170
97,BUMA.1121.00062,2,2174179,2182348,-,8169
97,BUMA.1121.00064,2,2634747,2642917,+,8170
97,BUMA.1121.00060,2,2647618,2655787,-,8169
97,BUMA.1121.00069,2,2672360,2680530,+,8170
97,BUMA.1121.00070,2,2685820,2693990,+,8170
97,BUMA.1121.00068,2,1317739,1325918,+,8179
97,BUMA.1121.00067,2,1197697,1205866,-,8169
97,BUMA.1121.00037,2,3081209,3089379,+,8170
97,BUMA.1121.00065,2,2802265,2810435,+,8170
97,BUMA.1121.00058,2,120593,128763,+,8170
97,BUMA.1121.00041,2,458377,466547,+,8170
97,BUMA.1121.00084,2,1442019,1450189,+,8170
97,BUMA.1121.00096,2,3041154,3049324,+,8170
97,BUMA.1121.00080,2,2784971,2793141,+,8170
97,BUMA.1121.00100,2,759056,767226,+,8170
97,BUMA.1121.00012,2,2193573,2201742,-,8169
97,BUMA.1121.00018,2,1070547,1078707,-,8160
97,BUMA.1121.00106,2,2008812,2016982,+,8170
97,BUMA.1121.00082,2,2752944,2761114,+,8170
98,BUMA.1121.00049,2,1389904,1393450,+,3546
98,BUMA.1121.00055,2,3077539,3081085,-,3546
98,BUMA.1121.00110,2,2718701,2722248,+,3547
98,BUMA.1121.00109,2,1872292,1875839,-,3547
98,BUMA.1121.00077,2,893662,897209,-,3547
98,BUMA.1121.00027,2,660297,663842,+,3545
98,BUMA.1121.00021,2,113232,116778,+,3546
98,BUMA.1121.00023,2,2888886,2892433,+,3547
98,BUMA.1121.00025,2,1278800,1282347,+,3547
98,BUMA.1121.00031,2,1932450,1935996,+,3546
98,BUMA.1121.00007,2,2877026,2880573,+,3547
98,BUMA.1121.00097,2,2589366,2592913,+,3547
98,BUMA.1121.00111,2,2080132,2083679,+,3547
98,BUMA.1121.00009,2,1410611,1414158,+,3547
98,BUMA.1121.00094,2,2793505,2797051,+,3546
98,BUMA.1121.00066,2,2712857,2716404,+,3547
98,BUMA.1121.00112,2,1613046,1616593,-,3547
98,BUMA.1121.00090,2,493898,497444,+,3546
98,BUMA.1121.00089,2,2739385,2742931,+,3546
98,BUMA.1121.00051,2,2754158,2757704,+,3546
98,BUMA.1121.00001,2,2651978,2655523,-,3545
98,BUMA.1121.00043,2,2808387,2811933,-,3546
98,BUMA.1121.00063,2,2722250,2725797,+,3547
98,BUMA.1121.00079,2,2750894,2754440,+,3546
98,BUMA.1121.00071,2,2729055,2732602,+,3547
98,BUMA.1121.00107,2,1039209,1042756,-,3547
98,BUMA.1121.00088,2,2762545,2766091,+,3546
98,BUMA.1121.00047,2,567387,570933,+,3546
98,BUMA.1121.00039,2,1211376,1214922,-,3546
98,BUMA.1121.00016,2,958153,961699,-,3546
98,BUMA.1121.00057,2,2487496,2491043,-,3547
98,BUMA.1121.00108,2,2999447,3002993,+,3546
98,BUMA.1121.00104,2,2835693,2839239,+,3546
98,BUMA.1121.00014,2,2867245,2870791,+,3546
98,BUMA.1121.00078,2,379094,382647,-,3553
98,BUMA.1121.00029,2,1770312,1773858,-,3546
98,BUMA.1121.00075,2,80453,83999,-,3546
98,BUMA.1121.00076,2,513414,516960,+,3546
98,BUMA.1121.00074,2,1621538,1625084,-,3546
98,BUMA.1121.00073,2,2729081,2732628,+,3547
98,BUMA.1121.00083,2,1404766,1408313,+,3547
98,BUMA.1121.00035,2,1849576,1853122,-,3546
98,BUMA.1121.00072,2,2706065,2709612,+,3547
98,BUMA.1121.00056,2,1248818,1252364,-,3546
98,BUMA.1121.00033,2,302523,306067,+,3544
98,BUMA.1121.00061,2,2712117,2715667,+,3550
98,BUMA.1121.00064,2,2653760,2657306,+,3546
98,BUMA.1121.00069,2,2698293,2701840,+,3547
98,BUMA.1121.00070,2,2708412,2711959,+,3547
98,BUMA.1121.00068,2,1341930,1345477,+,3547
98,BUMA.1121.00067,2,1176779,1180325,-,3546
98,BUMA.1121.00037,2,3103190,3106736,+,3546
98,BUMA.1121.00065,2,2829820,2833367,+,3547
98,BUMA.1121.00058,2,146094,149640,+,3546
98,BUMA.1121.00041,2,484767,488313,+,3546
98,BUMA.1121.00084,2,1467560,1471106,+,3546
98,BUMA.1121.00096,2,3066656,3070202,+,3546
98,BUMA.1121.00080,2,2810511,2814057,+,3546
98,BUMA.1121.00100,2,784559,788106,+,3547
98,BUMA.1121.00012,2,2176215,2179761,-,3546
98,BUMA.1121.00018,2,1050540,1054087,-,3547
98,BUMA.1121.00106,2,2027824,2031370,+,3546
98,BUMA.1121.00082,2,2780850,2784397,+,3547
99,BUMA.1121.00049,2,1402269,1417685,+,15416
99,BUMA.1121.00055,2,3048953,3064788,-,15835
99,BUMA.1121.00011,2,1388523,1403937,+,15414
99,BUMA.1121.00110,2,2750461,2765872,+,15411
99,BUMA.1121.00109,2,1846356,1861771,-,15415
99,BUMA.1121.00077,2,850043,865451,-,15408
99,BUMA.1121.00027,2,693339,708748,+,15409
99,BUMA.1121.00023,2,2925434,2941269,+,15835
99,BUMA.1121.00031,2,1971590,1987425,+,15835
99,BUMA.1121.00007,2,2891113,2906529,+,15416
99,BUMA.1121.00097,2,2621127,2636540,+,15413
99,BUMA.1121.00059,2,828200,843614,-,15414
99,BUMA.1121.00005,2,1125950,1141366,-,15416
99,BUMA.1121.00009,2,1424684,1440517,+,15833
99,BUMA.1121.00094,2,2805069,2820483,+,15414
99,BUMA.1121.00101,2,626384,641799,-,15415
99,BUMA.1121.00066,2,2745583,2760995,+,15412
99,BUMA.1121.00095,2,1654443,1669845,+,15402
99,BUMA.1121.00112,2,1562772,1578185,-,15413
99,BUMA.1121.00090,2,530432,546267,+,15835
99,BUMA.1121.00089,2,2750949,2766363,+,15414
99,BUMA.1121.00051,2,2765722,2781136,+,15414
99,BUMA.1121.00001,2,2619069,2634904,-,15835
99,BUMA.1121.00045,2,2672079,2687495,+,15416
99,BUMA.1121.00063,2,2754664,2770076,+,15412
99,BUMA.1121.00079,2,2762458,2777872,+,15414
99,BUMA.1121.00071,2,2761470,2776882,+,15412
99,BUMA.1121.00093,2,156580,171981,-,15401
99,BUMA.1121.00091,2,835695,851110,-,15415
99,BUMA.1121.00107,2,1013267,1028682,-,15415
99,BUMA.1121.00088,2,2775321,2790735,+,15414
99,BUMA.1121.00047,2,578951,594362,+,15411
99,BUMA.1121.00039,2,1165548,1182718,-,17170
99,BUMA.1121.00092,2,2765984,2781385,+,15401
99,BUMA.1121.00105,2,2849930,2865345,-,15415
99,BUMA.1121.00053,2,3070109,3085525,+,15416
99,BUMA.1121.00057,2,2442589,2458000,-,15411
99,BUMA.1121.00108,2,3014053,3029466,+,15413
99,BUMA.1121.00104,2,2848057,2863891,+,15834
99,BUMA.1121.00014,2,2908864,2926034,+,17170
99,BUMA.1121.00098,2,3041636,3057050,+,15414
99,BUMA.1121.00078,2,334179,349595,-,15416
99,BUMA.1121.00029,2,1732400,1748235,-,15835
99,BUMA.1121.00099,2,3036346,3051759,+,15413
99,BUMA.1121.00103,2,1451159,1466574,+,15415
99,BUMA.1121.00102,2,2818472,2834306,+,15834
99,BUMA.1121.00075,2,54515,69929,-,15414
99,BUMA.1121.00076,2,527485,542899,+,15414
99,BUMA.1121.00074,2,1598107,1613522,-,15415
99,BUMA.1121.00073,2,2762119,2777531,+,15412
99,BUMA.1121.00083,2,1437810,1453222,+,15412
99,BUMA.1121.00035,2,1813018,1828853,-,15835
99,BUMA.1121.00072,2,2738999,2754411,+,15412
99,BUMA.1121.00056,2,1225387,1240801,-,15414
99,BUMA.1121.00061,2,2744670,2760082,+,15412
99,BUMA.1121.00062,2,2123493,2138908,-,15415
99,BUMA.1121.00064,2,2666536,2681951,+,15415
99,BUMA.1121.00060,2,2577600,2593016,-,15416
99,BUMA.1121.00069,2,2710981,2726393,+,15412
99,BUMA.1121.00070,2,2741446,2756858,+,15412
99,BUMA.1121.00068,2,1359649,1375067,+,15418
99,BUMA.1121.00067,2,1153349,1168763,-,15414
99,BUMA.1121.00065,2,2864737,2880152,+,15415
99,BUMA.1121.00058,2,163817,179651,+,15834
99,BUMA.1121.00041,2,516523,531936,+,15413
99,BUMA.1121.00084,2,1479124,1494538,+,15414
99,BUMA.1121.00096,2,3102061,3117475,+,15414
99,BUMA.1121.00080,2,2822075,2837489,+,15414
99,BUMA.1121.00100,2,802283,817700,+,15417
99,BUMA.1121.00106,2,2040189,2056023,+,15834
99,BUMA.1121.00082,2,2813894,2829306,+,15412
100,BUMA.1121.00049,2,1426833,1431405,+,4572
100,BUMA.1121.00055,2,3037457,3042029,-,4572
100,BUMA.1121.00011,2,1410861,1415430,+,4569
100,BUMA.1121.00110,2,2772796,2777366,+,4570
100,BUMA.1121.00109,2,1834873,1839442,-,4569
100,BUMA.1121.00077,2,838549,843118,-,4569
100,BUMA.1121.00023,2,2948195,2952762,+,4567
100,BUMA.1121.00031,2,1994351,1998919,+,4568
100,BUMA.1121.00097,2,2643453,2648024,+,4571
100,BUMA.1121.00059,2,815489,820061,-,4572
100,BUMA.1121.00005,2,1113323,1117891,-,4568
100,BUMA.1121.00009,2,1447442,1452014,+,4572
100,BUMA.1121.00101,2,614886,619458,-,4572
100,BUMA.1121.00112,2,1551289,1555858,-,4569
100,BUMA.1121.00090,2,553192,557760,+,4568
100,BUMA.1121.00001,2,2607576,2612143,-,4567
100,BUMA.1121.00045,2,2694407,2698982,+,4575
100,BUMA.1121.00093,2,143869,148442,-,4573
100,BUMA.1121.00091,2,824201,828768,-,4567
100,BUMA.1121.00107,2,1001786,1006356,-,4570
100,BUMA.1121.00039,2,1154054,1158621,-,4567
100,BUMA.1121.00092,2,2789522,2794096,+,4574
100,BUMA.1121.00053,2,3092253,3096822,+,4569
100,BUMA.1121.00108,2,3036386,3040958,+,4572
100,BUMA.1121.00104,2,2870816,2875389,+,4573
100,BUMA.1121.00014,2,2932960,2937528,+,4568
100,BUMA.1121.00098,2,3063963,3068535,+,4572
100,BUMA.1121.00078,2,322684,327252,-,4568
100,BUMA.1121.00029,2,1720907,1725474,-,4567
100,BUMA.1121.00099,2,3058672,3063242,+,4570
100,BUMA.1121.00103,2,1473498,1478068,+,4570
100,BUMA.1121.00102,2,2842511,2847081,+,4570
100,BUMA.1121.00074,2,1586607,1591180,-,4573
100,BUMA.1121.00035,2,1801525,1806092,-,4567
100,BUMA.1121.00064,2,2688876,2693449,+,4573
100,BUMA.1121.00060,2,2566113,2570687,-,4574
100,BUMA.1121.00068,2,1381990,1386563,+,4573
100,BUMA.1121.00065,2,2886995,2891568,+,4573
100,BUMA.1121.00041,2,538863,543431,+,4568
100,BUMA.1121.00096,2,3124403,3128973,+,4570
100,BUMA.1121.00100,2,824624,829194,+,4570
100,BUMA.1121.00106,2,2062948,2067521,+,4573
101,BUMA.1121.00049,2,1435433,1442721,+,7288
101,BUMA.1121.00055,2,3023703,3030980,-,7277
101,BUMA.1121.00011,2,1419460,1426760,+,7300
101,BUMA.1121.00110,2,2781394,2788646,+,7252
101,BUMA.1121.00109,2,1823580,1830844,-,7264
101,BUMA.1121.00077,2,827268,834520,-,7252
101,BUMA.1121.00027,2,712967,720255,+,7288
101,BUMA.1121.00026,2,767714,775014,-,7300
101,BUMA.1121.00021,2,123787,131076,+,7289
101,BUMA.1121.00023,2,2956790,2964079,+,7289
101,BUMA.1121.00022,2,1944617,1951905,-,7288
101,BUMA.1121.00034,2,1701989,1709277,+,7288
101,BUMA.1121.00025,2,1289356,1296646,+,7290
101,BUMA.1121.00031,2,2002947,2010236,+,7289
101,BUMA.1121.00007,2,2911270,2918558,+,7288
101,BUMA.1121.00097,2,2652052,2659365,+,7313
101,BUMA.1121.00008,2,1686220,1693508,+,7288
101,BUMA.1121.00059,2,804160,811460,-,7300
101,BUMA.1121.00002,2,165791,173079,+,7288
101,BUMA.1121.00004,2,1686689,1693977,+,7288
101,BUMA.1121.00005,2,1102018,1109294,-,7276
101,BUMA.1121.00111,2,2090234,2097535,+,7301
101,BUMA.1121.00006,2,1918797,1926097,+,7300
101,BUMA.1121.00009,2,1456042,1463342,+,7300
101,BUMA.1121.00094,2,2824703,2831992,+,7289
101,BUMA.1121.00101,2,603558,610857,-,7299
101,BUMA.1121.00066,2,2765214,2772502,+,7288
101,BUMA.1121.00095,2,1674588,1681876,+,7288
101,BUMA.1121.00112,2,1539960,1547260,-,7300
101,BUMA.1121.00042,2,1362387,1369687,+,7300
101,BUMA.1121.00032,2,127063,134351,+,7288
101,BUMA.1121.00090,2,561788,569077,+,7289
101,BUMA.1121.00020,2,1686954,1694242,+,7288
101,BUMA.1121.00089,2,2770583,2777872,+,7289
101,BUMA.1121.00051,2,2785356,2792645,+,7289
101,BUMA.1121.00001,2,2596258,2603547,-,7289
101,BUMA.1121.00045,2,2703016,2710323,+,7307
101,BUMA.1121.00043,2,2794089,2801378,-,7289
101,BUMA.1121.00063,2,2774295,2781583,+,7288
101,BUMA.1121.00079,2,2782092,2789380,+,7288
101,BUMA.1121.00071,2,2781101,2788389,+,7288
101,BUMA.1121.00086,2,399616,406904,-,7288
101,BUMA.1121.00024,2,1821904,1829180,+,7276
101,BUMA.1121.00010,2,1017972,1025260,+,7288
101,BUMA.1121.00040,2,355481,362769,-,7288
101,BUMA.1121.00093,2,132551,139840,-,7289
101,BUMA.1121.00091,2,812871,820172,-,7301
101,BUMA.1121.00107,2,990456,997757,-,7301
101,BUMA.1121.00088,2,2794955,2802255,+,7300
101,BUMA.1121.00047,2,598582,605871,+,7289
101,BUMA.1121.00019,2,1766099,1773387,+,7288
101,BUMA.1121.00087,2,196422,203710,+,7288
101,BUMA.1121.00039,2,1142736,1150025,-,7289
101,BUMA.1121.00030,2,412733,420021,-,7288
101,BUMA.1121.00016,2,943854,951143,-,7289
101,BUMA.1121.00092,2,2798124,2805413,+,7289
101,BUMA.1121.00085,2,1563949,1571237,-,7288
101,BUMA.1121.00046,2,1414126,1421414,-,7288
101,BUMA.1121.00003,2,989989,997277,+,7288
101,BUMA.1121.00054,2,1718918,1726218,+,7300
101,BUMA.1121.00015,2,649461,656749,-,7288
101,BUMA.1121.00105,2,2838409,2845709,-,7300
101,BUMA.1121.00052,2,517587,524875,-,7288
101,BUMA.1121.00053,2,3100852,3108153,+,7301
101,BUMA.1121.00057,2,2431081,2438369,-,7288
101,BUMA.1121.00108,2,3044988,3052252,+,7264
101,BUMA.1121.00050,2,2013740,2021028,+,7288
101,BUMA.1121.00104,2,2879417,2886706,+,7289
101,BUMA.1121.00014,2,2941556,2948845,+,7289
101,BUMA.1121.00036,2,1256255,1263543,+,7288
101,BUMA.1121.00038,2,1819991,1827291,+,7300
101,BUMA.1121.00098,2,3072563,3079852,+,7289
101,BUMA.1121.00078,2,311353,318653,-,7300
101,BUMA.1121.00029,2,1709589,1716878,-,7289
101,BUMA.1121.00099,2,3067270,3074582,+,7312
101,BUMA.1121.00103,2,1482015,1489315,+,7300
101,BUMA.1121.00102,2,2851111,2858400,+,7289
101,BUMA.1121.00028,2,1728152,1735440,+,7288
101,BUMA.1121.00075,2,42993,50294,-,7301
101,BUMA.1121.00044,2,1752880,1760168,+,7288
101,BUMA.1121.00076,2,547119,554420,+,7301
101,BUMA.1121.00074,2,1575277,1582578,-,7301
101,BUMA.1121.00073,2,2781750,2789038,+,7288
101,BUMA.1121.00083,2,1457441,1464729,+,7288
101,BUMA.1121.00035,2,1790207,1797496,-,7289
101,BUMA.1121.00072,2,2758630,2765918,+,7288
101,BUMA.1121.00056,2,1213877,1221166,-,7289
101,BUMA.1121.00081,2,397412,404712,-,7300
101,BUMA.1121.00033,2,313076,320365,+,7289
101,BUMA.1121.00061,2,2764301,2771589,+,7288
101,BUMA.1121.00062,2,2111969,2119270,-,7301
101,BUMA.1121.00064,2,2697477,2704778,+,7301
101,BUMA.1121.00060,2,2554771,2562079,-,7308
101,BUMA.1121.00069,2,2730612,2737900,+,7288
101,BUMA.1121.00070,2,2761077,2768365,+,7288
101,BUMA.1121.00068,2,1390591,1397879,+,7288
101,BUMA.1121.00067,2,1141825,1149126,-,7301
101,BUMA.1121.00037,2,3113745,3121034,+,7289
101,BUMA.1121.00065,2,2895596,2902921,+,7325
101,BUMA.1121.00058,2,183869,191170,+,7301
101,BUMA.1121.00041,2,547461,554761,+,7300
101,BUMA.1121.00084,2,1498758,1506058,+,7300
101,BUMA.1121.00096,2,3133001,3140326,+,7325
101,BUMA.1121.00080,2,2841709,2848998,+,7289
101,BUMA.1121.00013,2,830415,837703,-,7288
101,BUMA.1121.00100,2,833193,840457,+,7264
101,BUMA.1121.00012,2,2161915,2169204,-,7289
101,BUMA.1121.00018,2,1036242,1043531,-,7289
101,BUMA.1121.00048,2,1136813,1144113,-,7300
101,BUMA.1121.00106,2,2071549,2078838,+,7289
101,BUMA.1121.00017,2,1701978,1709266,+,7288
101,BUMA.1121.00082,2,2833525,2840813,+,7288
102,BUMA.1121.00049,2,1444411,1465582,+,21171
102,BUMA.1121.00055,2,3000800,3022013,-,21213
102,BUMA.1121.00011,2,1428450,1449693,+,21243
102,BUMA.1121.00110,2,2790336,2811639,+,21303
102,BUMA.1121.00109,2,1800547,1821890,-,21343
102,BUMA.1121.00077,2,804323,825578,-,21255
102,BUMA.1121.00027,2,721945,743142,+,21197
102,BUMA.1121.00026,2,744819,766026,-,21207
102,BUMA.1121.00021,2,132766,154058,+,21292
102,BUMA.1121.00023,2,2965769,2986998,+,21229
102,BUMA.1121.00022,2,1921762,1942929,-,21167
102,BUMA.1121.00034,2,1710966,1732173,+,21207
102,BUMA.1121.00025,2,1298336,1319675,+,21339
102,BUMA.1121.00031,2,2011926,2033176,+,21250
102,BUMA.1121.00007,2,2920248,2941241,+,20993
102,BUMA.1121.00097,2,2661055,2682346,+,21291
102,BUMA.1121.00008,2,1695197,1716394,+,21197
102,BUMA.1121.00059,2,781305,802470,-,21165
102,BUMA.1121.00002,2,174768,195955,+,21187
102,BUMA.1121.00004,2,1695666,1716873,+,21207
102,BUMA.1121.00005,2,1079080,1100328,-,21248
102,BUMA.1121.00111,2,2099225,2120492,+,21267
102,BUMA.1121.00006,2,1927786,1949084,+,21298
102,BUMA.1121.00009,2,1465032,1486296,+,21264
102,BUMA.1121.00094,2,2833682,2854954,+,21272
102,BUMA.1121.00101,2,580641,601868,-,21227
102,BUMA.1121.00066,2,2774192,2795459,+,21267
102,BUMA.1121.00095,2,1683566,1704770,+,21204
102,BUMA.1121.00112,2,1516971,1538270,-,21299
102,BUMA.1121.00042,2,1371376,1392593,+,21217
102,BUMA.1121.00032,2,136040,157237,+,21197
102,BUMA.1121.00090,2,570767,592106,+,21339
102,BUMA.1121.00020,2,1695931,1717128,+,21197
102,BUMA.1121.00089,2,2779562,2800847,+,21285
102,BUMA.1121.00051,2,2794335,2815551,+,21216
102,BUMA.1121.00001,2,2573334,2594568,-,21234
102,BUMA.1121.00045,2,2712013,2733242,+,21229
102,BUMA.1121.00043,2,2771134,2792399,-,21265
102,BUMA.1121.00063,2,2783273,2804540,+,21267
102,BUMA.1121.00079,2,2791070,2812334,+,21264
102,BUMA.1121.00071,2,2790079,2811346,+,21267
102,BUMA.1121.00086,2,376721,397928,-,21207
102,BUMA.1121.00024,2,1830869,1852066,+,21197
102,BUMA.1121.00010,2,1026949,1048136,+,21187
102,BUMA.1121.00040,2,332586,353793,-,21207
102,BUMA.1121.00093,2,109658,130861,-,21203
102,BUMA.1121.00091,2,789945,811181,-,21236
102,BUMA.1121.00107,2,967443,988766,-,21323
102,BUMA.1121.00088,2,2803945,2825201,+,21256
102,BUMA.1121.00047,2,607561,628768,+,21207
102,BUMA.1121.00019,2,1775076,1796273,+,21197
102,BUMA.1121.00087,2,205399,226606,+,21207
102,BUMA.1121.00039,2,1119818,1141046,-,21228
102,BUMA.1121.00030,2,389838,411045,-,21207
102,BUMA.1121.00016,2,920918,942164,-,21246
102,BUMA.1121.00092,2,2807103,2828307,+,21204
102,BUMA.1121.00085,2,1541013,1562261,-,21248
102,BUMA.1121.00046,2,1391161,1412438,-,21277
102,BUMA.1121.00003,2,998967,1020308,+,21341
102,BUMA.1121.00054,2,1727907,1749204,+,21297
102,BUMA.1121.00015,2,626586,647773,-,21187
102,BUMA.1121.00105,2,2815462,2836719,-,21257
102,BUMA.1121.00052,2,494651,515899,-,21248
102,BUMA.1121.00053,2,3109843,3131195,+,21352
102,BUMA.1121.00057,2,2408241,2429391,-,21150
102,BUMA.1121.00108,2,3053942,3075212,+,21270
102,BUMA.1121.00050,2,2022717,2043984,+,21267
102,BUMA.1121.00104,2,2888396,2909559,+,21163
102,BUMA.1121.00014,2,2950535,2971837,+,21302
102,BUMA.1121.00036,2,1265232,1286449,+,21217
102,BUMA.1121.00038,2,1828980,1850277,+,21297
102,BUMA.1121.00098,2,3081542,3102810,+,21268
102,BUMA.1121.00078,2,288502,309663,-,21161
102,BUMA.1121.00029,2,1686696,1707899,-,21203
102,BUMA.1121.00099,2,3076272,3097529,+,21257
102,BUMA.1121.00103,2,1491005,1512224,+,21219
102,BUMA.1121.00102,2,2860090,2881323,+,21233
102,BUMA.1121.00028,2,1737129,1758336,+,21207
102,BUMA.1121.00075,2,20101,41303,-,21202
102,BUMA.1121.00044,2,1761857,1783064,+,21207
102,BUMA.1121.00076,2,556110,577314,+,21204
102,BUMA.1121.00074,2,1552287,1573587,-,21300
102,BUMA.1121.00073,2,2790728,2811990,+,21262
102,BUMA.1121.00083,2,1466419,1487686,+,21267
102,BUMA.1121.00035,2,1767303,1788517,-,21214
102,BUMA.1121.00072,2,2767608,2788873,+,21265
102,BUMA.1121.00056,2,1190903,1212187,-,21284
102,BUMA.1121.00081,2,374427,395724,-,21297
102,BUMA.1121.00033,2,322055,343219,+,21164
102,BUMA.1121.00061,2,2773279,2794544,+,21265
102,BUMA.1121.00062,2,2089023,2110279,-,21256
102,BUMA.1121.00064,2,2706468,2727711,+,21243
102,BUMA.1121.00060,2,2531853,2553081,-,21228
102,BUMA.1121.00069,2,2739590,2760831,+,21241
102,BUMA.1121.00070,2,2770055,2791300,+,21245
102,BUMA.1121.00068,2,1399569,1420723,+,21154
102,BUMA.1121.00067,2,1118782,1140135,-,21353
102,BUMA.1121.00037,2,3122724,3144050,+,21326
102,BUMA.1121.00065,2,2904611,2925864,+,21253
102,BUMA.1121.00058,2,192860,214163,+,21303
102,BUMA.1121.00041,2,556451,577754,+,21303
102,BUMA.1121.00084,2,1507748,1529073,+,21325
102,BUMA.1121.00096,2,3142016,3163304,+,21288
102,BUMA.1121.00080,2,2850688,2871976,+,21288
102,BUMA.1121.00013,2,807479,828727,-,21248
102,BUMA.1121.00100,2,842147,863358,+,21211
102,BUMA.1121.00012,2,2138993,2160225,-,21232
102,BUMA.1121.00018,2,1013234,1034552,-,21318
102,BUMA.1121.00048,2,1113827,1135125,-,21298
102,BUMA.1121.00106,2,2080528,2101697,+,21169
102,BUMA.1121.00017,2,1710955,1732162,+,21207
102,BUMA.1121.00082,2,2842503,2863770,+,21267
103,BUMA.1121.00049,2,1473668,1484332,+,10664
103,BUMA.1121.00055,2,2980715,2991406,-,10691
103,BUMA.1121.00011,2,1457808,1468498,+,10690
103,BUMA.1121.00110,2,2819826,2830570,+,10744
103,BUMA.1121.00109,2,1780250,1791048,-,10798
103,BUMA.1121.00077,2,785392,796137,-,10745
103,BUMA.1121.00027,2,751240,761926,+,10686
103,BUMA.1121.00026,2,724797,735538,-,10741
103,BUMA.1121.00021,2,162215,172957,+,10742
103,BUMA.1121.00023,2,2997782,3008516,+,10734
103,BUMA.1121.00022,2,1903032,1913706,-,10674
103,BUMA.1121.00034,2,1740229,1750981,+,10752
103,BUMA.1121.00025,2,1327784,1338506,+,10722
103,BUMA.1121.00031,2,2041389,2052143,+,10754
103,BUMA.1121.00007,2,2949358,2960052,+,10694
103,BUMA.1121.00097,2,2691800,2702503,+,10703
103,BUMA.1121.00008,2,1724450,1735218,+,10768
103,BUMA.1121.00059,2,762487,773188,-,10701
103,BUMA.1121.00002,2,204011,214796,+,10785
103,BUMA.1121.00004,2,1724929,1735657,+,10728
103,BUMA.1121.00005,2,1060249,1070999,-,10750
103,BUMA.1121.00111,2,2128652,2139343,+,10691
103,BUMA.1121.00006,2,1957152,1967981,+,10829
103,BUMA.1121.00009,2,1494462,1505183,+,10721
103,BUMA.1121.00094,2,2863042,2873767,+,10725
103,BUMA.1121.00101,2,561877,572540,-,10663
103,BUMA.1121.00066,2,2803647,2814319,+,10672
103,BUMA.1121.00095,2,1712889,1723717,+,10828
103,BUMA.1121.00112,2,1498197,1508884,-,10687
103,BUMA.1121.00042,2,1401874,1412604,+,10730
103,BUMA.1121.00032,2,165293,176021,+,10728
103,BUMA.1121.00090,2,600221,610921,+,10700
103,BUMA.1121.00020,2,1725184,1735904,+,10720
103,BUMA.1121.00089,2,2808935,2819660,+,10725
103,BUMA.1121.00051,2,2823639,2834331,+,10692
103,BUMA.1121.00001,2,2554490,2565201,-,10711
103,BUMA.1121.00045,2,2741398,2752124,+,10726
103,BUMA.1121.00043,2,2752378,2763040,-,10662
103,BUMA.1121.00063,2,2812628,2823279,+,10651
103,BUMA.1121.00079,2,2820409,2831076,+,10667
103,BUMA.1121.00071,2,2819522,2830169,+,10647
103,BUMA.1121.00086,2,357922,368665,-,10743
103,BUMA.1121.00024,2,1860122,1870842,+,10720
103,BUMA.1121.00010,2,1056192,1066985,+,10793
103,BUMA.1121.00040,2,313742,324524,-,10782
103,BUMA.1121.00093,2,90802,101542,-,10740
103,BUMA.1121.00091,2,771089,781843,-,10754
103,BUMA.1121.00107,2,948534,959321,-,10787
103,BUMA.1121.00088,2,2833275,2843940,+,10665
103,BUMA.1121.00047,2,636868,647584,+,10716
103,BUMA.1121.00019,2,1804329,1815049,+,10720
103,BUMA.1121.00087,2,234662,245404,+,10742
103,BUMA.1121.00039,2,1101029,1111721,-,10692
103,BUMA.1121.00030,2,371029,381782,-,10753
103,BUMA.1121.00016,2,902047,912754,-,10707
103,BUMA.1121.00092,2,2836423,2847162,+,10739
103,BUMA.1121.00085,2,1522177,1532945,-,10768
103,BUMA.1121.00046,2,1372327,1383093,-,10766
103,BUMA.1121.00003,2,1025557,1036321,+,10764
103,BUMA.1121.00054,2,1757272,1768101,+,10829
103,BUMA.1121.00015,2,607752,618518,-,10766
103,BUMA.1121.00105,2,2795430,2806139,-,10709
103,BUMA.1121.00052,2,475815,486583,-,10768
103,BUMA.1121.00053,2,3139270,3149923,+,10653
103,BUMA.1121.00057,2,2389456,2400114,-,10658
103,BUMA.1121.00108,2,3084614,3095405,+,10791
103,BUMA.1121.00050,2,2052052,2062818,+,10766
103,BUMA.1121.00104,2,2917691,2928370,+,10679
103,BUMA.1121.00014,2,2979966,2990696,+,10730
103,BUMA.1121.00036,2,1294505,1305294,+,10789
103,BUMA.1121.00038,2,1858345,1869174,+,10829
103,BUMA.1121.00098,2,3110930,3121756,+,10826
103,BUMA.1121.00078,2,269642,280365,-,10723
103,BUMA.1121.00029,2,1667813,1678533,-,10720
103,BUMA.1121.00099,2,3105589,3116274,+,10685
103,BUMA.1121.00103,2,1520379,1531145,+,10766
103,BUMA.1121.00102,2,2889390,2900010,+,10620
103,BUMA.1121.00028,2,1766392,1777112,+,10720
103,BUMA.1121.00075,2,34,10771,-,10737
103,BUMA.1121.00044,2,1791120,1801872,+,10752
103,BUMA.1121.00076,2,586644,597373,+,10729
103,BUMA.1121.00074,2,1533502,1544179,-,10677
103,BUMA.1121.00073,2,2820127,2830772,+,10645
103,BUMA.1121.00083,2,1495874,1506547,+,10673
103,BUMA.1121.00035,2,1748509,1759188,-,10679
103,BUMA.1121.00072,2,2797053,2807672,+,10619
103,BUMA.1121.00056,2,1172089,1182815,-,10726
103,BUMA.1121.00081,2,355537,366359,-,10822
103,BUMA.1121.00033,2,351342,362059,+,10717
103,BUMA.1121.00061,2,2802661,2813301,+,10640
103,BUMA.1121.00062,2,2068918,2079670,-,10752
103,BUMA.1121.00064,2,2735839,2746584,+,10745
103,BUMA.1121.00060,2,2512938,2523697,-,10759
103,BUMA.1121.00069,2,2768938,2779605,+,10667
103,BUMA.1121.00070,2,2799435,2810081,+,10646
103,BUMA.1121.00068,2,1428932,1439604,+,10672
103,BUMA.1121.00067,2,1099914,1110635,-,10721
103,BUMA.1121.00037,2,3152171,3162854,+,10683
103,BUMA.1121.00065,2,2933972,2944682,+,10710
103,BUMA.1121.00058,2,222286,233002,+,10716
103,BUMA.1121.00041,2,585846,596570,+,10724
103,BUMA.1121.00084,2,1537145,1547886,+,10741
103,BUMA.1121.00096,2,3171461,3182228,+,10767
103,BUMA.1121.00080,2,2880070,2890770,+,10700
103,BUMA.1121.00013,2,788627,799411,-,10784
103,BUMA.1121.00100,2,871463,882300,+,10837
103,BUMA.1121.00012,2,2120190,2130877,-,10687
103,BUMA.1121.00018,2,994407,1005125,-,10718
103,BUMA.1121.00048,2,1094929,1105759,-,10830
103,BUMA.1121.00106,2,2109829,2120522,+,10693
103,BUMA.1121.00017,2,1740218,1750970,+,10752
103,BUMA.1121.00082,2,2871958,2882631,+,10673
104,BUMA.1121.00049,2,1484334,1508668,+,24334
104,BUMA.1121.00055,2,2956388,2980714,-,24326
104,BUMA.1121.00011,2,1468500,1492803,+,24303
104,BUMA.1121.00110,2,2830572,2854880,+,24308
104,BUMA.1121.00109,2,1755925,1780249,-,24324
104,BUMA.1121.00077,2,761083,785391,-,24308
104,BUMA.1121.00027,2,761928,786240,+,24312
104,BUMA.1121.00026,2,700477,724796,-,24319
104,BUMA.1121.00021,2,172959,197393,+,24434
104,BUMA.1121.00023,2,3008518,3032918,+,24400
104,BUMA.1121.00022,2,1878712,1903031,-,24319
104,BUMA.1121.00034,2,1750983,1775301,+,24318
104,BUMA.1121.00025,2,1338508,1362943,+,24435
104,BUMA.1121.00031,2,2052145,2076561,+,24416
104,BUMA.1121.00007,2,2960054,2984387,+,24333
104,BUMA.1121.00097,2,2702505,2726860,+,24355
104,BUMA.1121.00008,2,1735220,1759538,+,24318
104,BUMA.1121.00059,2,738116,762486,-,24370
104,BUMA.1121.00002,2,214798,239116,+,24318
104,BUMA.1121.00004,2,1735659,1759977,+,24318
104,BUMA.1121.00005,2,1035929,1060248,-,24319
104,BUMA.1121.00111,2,2139345,2163779,+,24434
104,BUMA.1121.00006,2,1967983,1992289,+,24306
104,BUMA.1121.00009,2,1505185,1529522,+,24337
104,BUMA.1121.00094,2,2873769,2898131,+,24362
104,BUMA.1121.00101,2,537509,561876,-,24367
104,BUMA.1121.00066,2,2814321,2838647,+,24326
104,BUMA.1121.00095,2,1723719,1748036,+,24317
104,BUMA.1121.00112,2,1473912,1498196,-,24284
104,BUMA.1121.00042,2,1412606,1436924,+,24318
104,BUMA.1121.00032,2,176023,200341,+,24318
104,BUMA.1121.00090,2,610923,635355,+,24432
104,BUMA.1121.00020,2,1735906,1760224,+,24318
104,BUMA.1121.00089,2,2819662,2844017,+,24355
104,BUMA.1121.00051,2,2834333,2858682,+,24349
104,BUMA.1121.00001,2,2530044,2554489,-,24445
104,BUMA.1121.00045,2,2752126,2776525,+,24399
104,BUMA.1121.00043,2,2727985,2752377,-,24392
104,BUMA.1121.00063,2,2823281,2847607,+,24326
104,BUMA.1121.00079,2,2831078,2855446,+,24368
104,BUMA.1121.00071,2,2830171,2854509,+,24338
104,BUMA.1121.00086,2,333602,357921,-,24319
104,BUMA.1121.00024,2,1870844,1895177,+,24333
104,BUMA.1121.00010,2,1066987,1091305,+,24318
104,BUMA.1121.00040,2,289435,313741,-,24306
104,BUMA.1121.00093,2,66458,90801,-,24343
104,BUMA.1121.00091,2,746793,771088,-,24295
104,BUMA.1121.00107,2,924210,948533,-,24323
104,BUMA.1121.00088,2,2843942,2868241,+,24299
104,BUMA.1121.00047,2,647586,671902,+,24316
104,BUMA.1121.00019,2,1815051,1839369,+,24318
104,BUMA.1121.00087,2,245406,269724,+,24318
104,BUMA.1121.00039,2,1076599,1101028,-,24429
104,BUMA.1121.00030,2,346709,371028,-,24319
104,BUMA.1121.00016,2,877644,902046,-,24402
104,BUMA.1121.00092,2,2847164,2871506,+,24342
104,BUMA.1121.00085,2,1497869,1522176,-,24307
104,BUMA.1121.00046,2,1348019,1372326,-,24307
104,BUMA.1121.00003,2,1036323,1060701,+,24378
104,BUMA.1121.00054,2,1768103,1792409,+,24306
104,BUMA.1121.00015,2,583444,607751,-,24307
104,BUMA.1121.00105,2,2770971,2795429,-,24458
104,BUMA.1121.00052,2,451507,475814,-,24307
104,BUMA.1121.00053,2,3149925,3174312,+,24387
104,BUMA.1121.00057,2,2365076,2389455,-,24379
104,BUMA.1121.00108,2,3095407,3119735,+,24328
104,BUMA.1121.00050,2,2062820,2087126,+,24306
104,BUMA.1121.00104,2,2928372,2952772,+,24400
104,BUMA.1121.00014,2,2990698,3015134,+,24436
104,BUMA.1121.00036,2,1305296,1329614,+,24318
104,BUMA.1121.00038,2,1869176,1893482,+,24306
104,BUMA.1121.00098,2,3121758,3146098,+,24340
104,BUMA.1121.00078,2,245319,269641,-,24322
104,BUMA.1121.00029,2,1643399,1667812,-,24413
104,BUMA.1121.00099,2,3116276,3140608,+,24332
104,BUMA.1121.00103,2,1531147,1555509,+,24362
104,BUMA.1121.00102,2,2900012,2924395,+,24383
104,BUMA.1121.00028,2,1777114,1801432,+,24318
104,BUMA.1121.00075,2,3123590,3147867,-,24277
104,BUMA.1121.00044,2,1801874,1826191,+,24317
104,BUMA.1121.00076,2,597375,621701,+,24326
104,BUMA.1121.00074,2,1509113,1533501,-,24388
104,BUMA.1121.00073,2,2830774,2855118,+,24344
104,BUMA.1121.00083,2,1506549,1530904,+,24355
104,BUMA.1121.00035,2,1724111,1748508,-,24397
104,BUMA.1121.00072,2,2807674,2832010,+,24336
104,BUMA.1121.00056,2,1147732,1172088,-,24356
104,BUMA.1121.00081,2,331229,355536,-,24307
104,BUMA.1121.00033,2,362061,386455,+,24394
104,BUMA.1121.00061,2,2813303,2837628,+,24325
104,BUMA.1121.00062,2,2044567,2068917,-,24350
104,BUMA.1121.00064,2,2746586,2770921,+,24335
104,BUMA.1121.00060,2,2488537,2512937,-,24400
104,BUMA.1121.00069,2,2779607,2803960,+,24353
104,BUMA.1121.00070,2,2810083,2834423,+,24340
104,BUMA.1121.00068,2,1439606,1463994,+,24388
104,BUMA.1121.00067,2,1075582,1099913,-,24331
104,BUMA.1121.00037,2,3162856,3187248,+,24392
104,BUMA.1121.00065,2,2944684,2969022,+,24338
104,BUMA.1121.00058,2,233004,257406,+,24402
104,BUMA.1121.00041,2,596572,620889,+,24317
104,BUMA.1121.00084,2,1547888,1572215,+,24327
104,BUMA.1121.00096,2,3182230,3206564,+,24334
104,BUMA.1121.00080,2,2890772,2915138,+,24366
104,BUMA.1121.00013,2,764319,788626,-,24307
104,BUMA.1121.00100,2,882302,906589,+,24287
104,BUMA.1121.00012,2,2095756,2120189,-,24433
104,BUMA.1121.00018,2,969971,994406,-,24435
104,BUMA.1121.00048,2,1070621,1094928,-,24307
104,BUMA.1121.00106,2,2120524,2144854,+,24330
104,BUMA.1121.00017,2,1750972,1775290,+,24318
104,BUMA.1121.00082,2,2882633,2906988,+,24355
105,BUMA.1121.00049,2,1512796,1515846,+,3050
105,BUMA.1121.00055,2,2948668,2951719,-,3051
105,BUMA.1121.00011,2,1498167,1501218,+,3051
105,BUMA.1121.00110,2,2859008,2862059,+,3051
105,BUMA.1121.00077,2,753904,756955,-,3051
105,BUMA.1121.00027,2,790367,793418,+,3051
105,BUMA.1121.00097,2,2730988,2734039,+,3051
105,BUMA.1121.00005,2,1028750,1031801,-,3051
105,BUMA.1121.00111,2,2167916,2170973,+,3057
105,BUMA.1121.00009,2,1533647,1536698,+,3051
105,BUMA.1121.00101,2,530330,533381,-,3051
105,BUMA.1121.00066,2,2842509,2845560,+,3051
105,BUMA.1121.00095,2,1753400,1756457,+,3057
105,BUMA.1121.00112,2,1466733,1469784,-,3051
105,BUMA.1121.00045,2,2780653,2783690,+,3037
105,BUMA.1121.00043,2,2720806,2723857,-,3051
105,BUMA.1121.00063,2,2852276,2855327,+,3051
105,BUMA.1121.00071,2,2858383,2861434,+,3051
105,BUMA.1121.00093,2,59279,62330,-,3051
105,BUMA.1121.00091,2,739614,742665,-,3051
105,BUMA.1121.00107,2,917047,920098,-,3051
105,BUMA.1121.00088,2,2872369,2875419,+,3050
105,BUMA.1121.00016,2,870465,873516,-,3051
105,BUMA.1121.00092,2,2875634,2878685,+,3051
105,BUMA.1121.00003,2,1064829,1067880,+,3051
105,BUMA.1121.00053,2,3178440,3181491,+,3051
105,BUMA.1121.00057,2,2357357,2360407,-,3050
105,BUMA.1121.00108,2,3123863,3126914,+,3051
105,BUMA.1121.00104,2,2956900,2959950,+,3050
105,BUMA.1121.00098,2,3150226,3153276,+,3050
105,BUMA.1121.00078,2,238140,241191,-,3051
105,BUMA.1121.00099,2,3144736,3147787,+,3051
105,BUMA.1121.00103,2,1560281,1563347,+,3066
105,BUMA.1121.00102,2,2928523,2931574,+,3051
105,BUMA.1121.00073,2,2858996,2862047,+,3051
105,BUMA.1121.00083,2,1535573,1538624,+,3051
105,BUMA.1121.00072,2,2836679,2839730,+,3051
105,BUMA.1121.00033,2,390581,393632,+,3051
105,BUMA.1121.00061,2,2841502,2844553,+,3051
105,BUMA.1121.00062,2,2037389,2040439,-,3050
105,BUMA.1121.00064,2,2775049,2778100,+,3051
105,BUMA.1121.00060,2,2481372,2484409,-,3037
105,BUMA.1121.00069,2,2808629,2811680,+,3051
105,BUMA.1121.00070,2,2838297,2841348,+,3051
105,BUMA.1121.00068,2,1469358,1472413,+,3055
105,BUMA.1121.00067,2,1068403,1071454,-,3051
105,BUMA.1121.00037,2,3193848,3196899,+,3051
105,BUMA.1121.00084,2,1576343,1579393,+,3050
105,BUMA.1121.00096,2,3210691,3213741,+,3050
105,BUMA.1121.00106,2,2148982,2152032,+,3050
105,BUMA.1121.00082,2,2911657,2914708,+,3051
106,BUMA.1121.00049,2,1520288,1526901,+,6613
106,BUMA.1121.00055,2,2937618,2944226,-,6608
106,BUMA.1121.00011,2,1505660,1512271,+,6611
106,BUMA.1121.00110,2,2866501,2873116,+,6615
106,BUMA.1121.00109,2,1746556,1753166,-,6610
106,BUMA.1121.00077,2,742846,749461,-,6615
106,BUMA.1121.00027,2,797858,804420,+,6562
106,BUMA.1121.00026,2,378165,384781,+,6616
106,BUMA.1121.00021,2,198916,205526,+,6610
106,BUMA.1121.00023,2,3034403,3040995,+,6592
106,BUMA.1121.00022,2,1359446,1366062,+,6616
106,BUMA.1121.00034,2,1938363,1944979,+,6616
106,BUMA.1121.00025,2,1364466,1371078,+,6612
106,BUMA.1121.00031,2,2079320,2085932,+,6612
106,BUMA.1121.00007,2,2985910,2992520,+,6610
106,BUMA.1121.00097,2,2738481,2745090,+,6609
106,BUMA.1121.00008,2,1922592,1929208,+,6616
106,BUMA.1121.00059,2,729980,736593,-,6613
106,BUMA.1121.00002,2,751817,758433,-,6616
106,BUMA.1121.00004,2,1923045,1929660,+,6615
106,BUMA.1121.00005,2,1017707,1024318,-,6611
106,BUMA.1121.00111,2,2175415,2182025,+,6610
106,BUMA.1121.00006,2,178487,185103,-,6616
106,BUMA.1121.00009,2,1541153,1547764,+,6611
106,BUMA.1121.00094,2,2899654,2906277,+,6623
106,BUMA.1121.00101,2,519278,525888,-,6610
106,BUMA.1121.00066,2,2850002,2856615,+,6613
106,BUMA.1121.00095,2,1760894,1767503,+,6609
106,BUMA.1121.00112,2,1455700,1462291,-,6591
106,BUMA.1121.00042,2,1930291,1936907,-,6616
106,BUMA.1121.00032,2,363424,370040,+,6616
106,BUMA.1121.00090,2,636878,643490,+,6612
106,BUMA.1121.00020,2,1923314,1929930,+,6616
106,BUMA.1121.00089,2,2845540,2852162,+,6622
106,BUMA.1121.00051,2,2860205,2866815,+,6610
106,BUMA.1121.00001,2,2521910,2528521,-,6611
106,BUMA.1121.00045,2,2788132,2794736,+,6604
106,BUMA.1121.00043,2,2709791,2716402,-,6611
106,BUMA.1121.00063,2,2859759,2866372,+,6613
106,BUMA.1121.00079,2,2856968,2863578,+,6610
106,BUMA.1121.00071,2,2865749,2872362,+,6613
106,BUMA.1121.00086,2,2167295,2173911,+,6616
106,BUMA.1121.00024,2,2058246,2064862,+,6616
106,BUMA.1121.00010,2,1605061,1611677,-,6616
106,BUMA.1121.00040,2,2004777,2011392,+,6615
106,BUMA.1121.00093,2,48228,54838,-,6610
106,BUMA.1121.00091,2,728560,735172,-,6612
106,BUMA.1121.00107,2,905992,912605,-,6613
106,BUMA.1121.00088,2,2879861,2886474,+,6613
106,BUMA.1121.00047,2,673425,680035,+,6610
106,BUMA.1121.00019,2,2002459,2009075,+,6616
106,BUMA.1121.00087,2,781905,788521,-,6616
106,BUMA.1121.00039,2,1068464,1075076,-,6612
106,BUMA.1121.00030,2,177025,183641,-,6616
106,BUMA.1121.00016,2,859450,866061,-,6611
106,BUMA.1121.00092,2,2883126,2889736,+,6610
106,BUMA.1121.00085,2,979947,986562,+,6615
106,BUMA.1121.00046,2,831092,837708,+,6616
106,BUMA.1121.00003,2,1072322,1078937,+,6615
106,BUMA.1121.00054,2,2303934,2310549,-,6615
106,BUMA.1121.00015,2,68296,74912,+,6616
106,BUMA.1121.00105,2,2762835,2769448,-,6613
106,BUMA.1121.00052,2,1668476,1675091,+,6615
106,BUMA.1121.00053,2,3185933,3192542,+,6609
106,BUMA.1121.00057,2,2346302,2352915,-,6613
106,BUMA.1121.00108,2,3131361,3137971,+,6610
106,BUMA.1121.00050,2,275941,282557,-,6616
106,BUMA.1121.00104,2,2964392,2971005,+,6613
106,BUMA.1121.00014,2,3017893,3024494,+,6601
106,BUMA.1121.00036,2,1774785,1781401,-,6616
106,BUMA.1121.00038,2,178505,185121,-,6616
106,BUMA.1121.00098,2,3157721,3164333,+,6612
106,BUMA.1121.00078,2,227091,233700,-,6609
106,BUMA.1121.00029,2,1635265,1641876,-,6611
106,BUMA.1121.00099,2,3152229,3158840,+,6611
106,BUMA.1121.00103,2,1567789,1574400,+,6611
106,BUMA.1121.00102,2,2936016,2942625,+,6609
106,BUMA.1121.00028,2,1964487,1971103,+,6616
106,BUMA.1121.00075,2,3113006,3119620,-,6614
106,BUMA.1121.00044,2,1989260,1995876,+,6616
106,BUMA.1121.00076,2,625672,632287,+,6615
106,BUMA.1121.00074,2,1500979,1507590,-,6611
106,BUMA.1121.00073,2,2866481,2873094,+,6613
106,BUMA.1121.00083,2,1543066,1549679,+,6613
106,BUMA.1121.00035,2,1715977,1722588,-,6611
106,BUMA.1121.00072,2,2844172,2850785,+,6613
106,BUMA.1121.00056,2,1139587,1146209,-,6622
106,BUMA.1121.00081,2,2138465,2145081,+,6616
106,BUMA.1121.00033,2,398036,404647,+,6611
106,BUMA.1121.00061,2,2848995,2855608,+,6613
106,BUMA.1121.00062,2,2026334,2032947,-,6613
106,BUMA.1121.00064,2,2782541,2789154,+,6613
106,BUMA.1121.00060,2,2470326,2476930,-,6604
106,BUMA.1121.00069,2,2816066,2822679,+,6613
106,BUMA.1121.00070,2,2845790,2852403,+,6613
106,BUMA.1121.00068,2,1476856,1483455,+,6599
106,BUMA.1121.00067,2,1057351,1063962,-,6611
106,BUMA.1121.00037,2,3201341,3207929,+,6588
106,BUMA.1121.00065,2,2970545,2977155,+,6610
106,BUMA.1121.00058,2,258929,265543,+,6614
106,BUMA.1121.00041,2,622411,629028,+,6617
106,BUMA.1121.00084,2,1583835,1590449,+,6614
106,BUMA.1121.00096,2,3218188,3224799,+,6611
106,BUMA.1121.00080,2,2916661,2923271,+,6610
106,BUMA.1121.00013,2,245936,252551,+,6615
106,BUMA.1121.00100,2,908112,914721,+,6609
106,BUMA.1121.00012,2,2087660,2094271,-,6611
106,BUMA.1121.00018,2,961836,968448,-,6612
106,BUMA.1121.00048,2,552520,559136,+,6616
106,BUMA.1121.00106,2,2156474,2163082,+,6608
106,BUMA.1121.00017,2,1938359,1944975,+,6616
106,BUMA.1121.00082,2,2919150,2925763,+,6613
107,BUMA.1121.00049,2,1526903,1530186,+,3283
107,BUMA.1121.00055,2,2934333,2937617,-,3284
107,BUMA.1121.00011,2,1512273,1515556,+,3283
107,BUMA.1121.00110,2,2873118,2876401,+,3283
107,BUMA.1121.00109,2,1743271,1746555,-,3284
107,BUMA.1121.00077,2,739561,742845,-,3284
107,BUMA.1121.00027,2,804422,807705,+,3283
107,BUMA.1121.00026,2,384783,388067,+,3284
107,BUMA.1121.00021,2,205528,208811,+,3283
107,BUMA.1121.00023,2,3040997,3044280,+,3283
107,BUMA.1121.00022,2,1366064,1369348,+,3284
107,BUMA.1121.00034,2,1944981,1948265,+,3284
107,BUMA.1121.00025,2,1371080,1374363,+,3283
107,BUMA.1121.00031,2,2085934,2089217,+,3283
107,BUMA.1121.00007,2,2992522,2995805,+,3283
107,BUMA.1121.00097,2,2745092,2748375,+,3283
107,BUMA.1121.00008,2,1929210,1932494,+,3284
107,BUMA.1121.00059,2,726695,729979,-,3284
107,BUMA.1121.00002,2,748531,751816,-,3285
107,BUMA.1121.00004,2,1929662,1932946,+,3284
107,BUMA.1121.00005,2,1014422,1017706,-,3284
107,BUMA.1121.00111,2,2182027,2185310,+,3283
107,BUMA.1121.00006,2,175201,178486,-,3285
107,BUMA.1121.00009,2,1547766,1551049,+,3283
107,BUMA.1121.00094,2,2906279,2909562,+,3283
107,BUMA.1121.00101,2,515993,519277,-,3284
107,BUMA.1121.00066,2,2856617,2859900,+,3283
107,BUMA.1121.00095,2,1767505,1770788,+,3283
107,BUMA.1121.00112,2,1452415,1455699,-,3284
107,BUMA.1121.00042,2,1927005,1930290,-,3285
107,BUMA.1121.00032,2,370042,373326,+,3284
107,BUMA.1121.00090,2,643492,646775,+,3283
107,BUMA.1121.00020,2,1929932,1933216,+,3284
107,BUMA.1121.00089,2,2852164,2855447,+,3283
107,BUMA.1121.00051,2,2866817,2870100,+,3283
107,BUMA.1121.00001,2,2518625,2521909,-,3284
107,BUMA.1121.00045,2,2794738,2798021,+,3283
107,BUMA.1121.00043,2,2706506,2709790,-,3284
107,BUMA.1121.00063,2,2866374,2869657,+,3283
107,BUMA.1121.00079,2,2863580,2866863,+,3283
107,BUMA.1121.00071,2,2872364,2875647,+,3283
107,BUMA.1121.00086,2,2173913,2177197,+,3284
107,BUMA.1121.00024,2,2064864,2068148,+,3284
107,BUMA.1121.00010,2,1601775,1605060,-,3285
107,BUMA.1121.00040,2,2011394,2014678,+,3284
107,BUMA.1121.00093,2,44943,48227,-,3284
107,BUMA.1121.00091,2,725275,728559,-,3284
107,BUMA.1121.00107,2,902707,905991,-,3284
107,BUMA.1121.00088,2,2886476,2889759,+,3283
107,BUMA.1121.00047,2,680037,683320,+,3283
107,BUMA.1121.00019,2,2009077,2012361,+,3284
107,BUMA.1121.00087,2,778619,781904,-,3285
107,BUMA.1121.00039,2,1065179,1068463,-,3284
107,BUMA.1121.00030,2,173739,177024,-,3285
107,BUMA.1121.00016,2,856165,859449,-,3284
107,BUMA.1121.00092,2,2889738,2893021,+,3283
107,BUMA.1121.00085,2,986564,989848,+,3284
107,BUMA.1121.00046,2,837710,840994,+,3284
107,BUMA.1121.00003,2,1078939,1082222,+,3283
107,BUMA.1121.00054,2,2300648,2303933,-,3285
107,BUMA.1121.00015,2,74914,78198,+,3284
107,BUMA.1121.00105,2,2759550,2762834,-,3284
107,BUMA.1121.00052,2,1675093,1678377,+,3284
107,BUMA.1121.00053,2,3192544,3195827,+,3283
107,BUMA.1121.00057,2,2343017,2346301,-,3284
107,BUMA.1121.00108,2,3137973,3141262,+,3289
107,BUMA.1121.00050,2,272655,275940,-,3285
107,BUMA.1121.00104,2,2971007,2974290,+,3283
107,BUMA.1121.00014,2,3024496,3027770,+,3274
107,BUMA.1121.00036,2,1771499,1774784,-,3285
107,BUMA.1121.00038,2,175219,178504,-,3285
107,BUMA.1121.00098,2,3164335,3167618,+,3283
107,BUMA.1121.00078,2,223805,227090,-,3285
107,BUMA.1121.00029,2,1631980,1635264,-,3284
107,BUMA.1121.00099,2,3158842,3162125,+,3283
107,BUMA.1121.00103,2,1574402,1577685,+,3283
107,BUMA.1121.00102,2,2942627,2945910,+,3283
107,BUMA.1121.00028,2,1971105,1974389,+,3284
107,BUMA.1121.00075,2,3109721,3113005,-,3284
107,BUMA.1121.00044,2,1995878,1999162,+,3284
107,BUMA.1121.00076,2,632289,635572,+,3283
107,BUMA.1121.00074,2,1497694,1500978,-,3284
107,BUMA.1121.00073,2,2873096,2876379,+,3283
107,BUMA.1121.00083,2,1549681,1552964,+,3283
107,BUMA.1121.00035,2,1712692,1715976,-,3284
107,BUMA.1121.00072,2,2850787,2854070,+,3283
107,BUMA.1121.00056,2,1136302,1139586,-,3284
107,BUMA.1121.00081,2,2145083,2148367,+,3284
107,BUMA.1121.00033,2,404649,407932,+,3283
107,BUMA.1121.00061,2,2855610,2858893,+,3283
107,BUMA.1121.00062,2,2023049,2026333,-,3284
107,BUMA.1121.00064,2,2789156,2792439,+,3283
107,BUMA.1121.00060,2,2467041,2470325,-,3284
107,BUMA.1121.00069,2,2822681,2825964,+,3283
107,BUMA.1121.00070,2,2852405,2855688,+,3283
107,BUMA.1121.00068,2,1483457,1486740,+,3283
107,BUMA.1121.00067,2,1054066,1057350,-,3284
107,BUMA.1121.00037,2,26,3309,+,3283
107,BUMA.1121.00065,2,2977157,2980440,+,3283
107,BUMA.1121.00058,2,265545,268828,+,3283
107,BUMA.1121.00041,2,629030,632314,+,3284
107,BUMA.1121.00084,2,1590451,1593734,+,3283
107,BUMA.1121.00096,2,3224801,3228083,+,3282
107,BUMA.1121.00080,2,2923273,2926556,+,3283
107,BUMA.1121.00013,2,252553,255837,+,3284
107,BUMA.1121.00100,2,914723,918006,+,3283
107,BUMA.1121.00012,2,2084375,2087659,-,3284
107,BUMA.1121.00018,2,958551,961835,-,3284
107,BUMA.1121.00048,2,559138,562422,+,3284
107,BUMA.1121.00106,2,2163084,2166367,+,3283
107,BUMA.1121.00017,2,1944977,1948261,+,3284
107,BUMA.1121.00082,2,2925765,2929048,+,3283
108,BUMA.1121.00049,2,1531321,1539162,+,7841
108,BUMA.1121.00055,2,2925364,2933199,-,7835
108,BUMA.1121.00011,2,1516691,1524499,+,7808
108,BUMA.1121.00110,2,2877536,2885343,+,7807
108,BUMA.1121.00109,2,1734336,1742137,-,7801
108,BUMA.1121.00077,2,730620,738427,-,7807
108,BUMA.1121.00027,2,808840,816667,+,7827
108,BUMA.1121.00026,2,389088,396897,+,7809
108,BUMA.1121.00021,2,209693,217505,+,7812
108,BUMA.1121.00023,2,3045162,3052971,+,7809
108,BUMA.1121.00022,2,1370357,1378166,+,7809
108,BUMA.1121.00034,2,1949286,1957095,+,7809
108,BUMA.1121.00025,2,1375245,1383048,+,7803
108,BUMA.1121.00031,2,2090099,2097911,+,7812
108,BUMA.1121.00007,2,2996883,3004720,+,7837
108,BUMA.1121.00097,2,2749477,2757297,+,7820
108,BUMA.1121.00008,2,1933515,1941324,+,7809
108,BUMA.1121.00059,2,717736,725561,-,7825
108,BUMA.1121.00002,2,739702,747511,-,7809
108,BUMA.1121.00004,2,1933967,1941776,+,7809
108,BUMA.1121.00005,2,1005611,1013415,-,7804
108,BUMA.1121.00111,2,2186447,2194256,+,7809
108,BUMA.1121.00006,2,166372,174181,-,7809
108,BUMA.1121.00009,2,1552184,1559993,+,7809
108,BUMA.1121.00094,2,2910697,2918505,+,7808
108,BUMA.1121.00101,2,507193,514983,-,7790
108,BUMA.1121.00066,2,2861037,2868855,+,7818
108,BUMA.1121.00095,2,1771925,1779684,+,7759
108,BUMA.1121.00112,2,1443641,1451408,-,7767
108,BUMA.1121.00042,2,1918176,1925985,-,7809
108,BUMA.1121.00032,2,374347,382156,+,7809
108,BUMA.1121.00090,2,647657,655461,+,7804
108,BUMA.1121.00020,2,1934237,1942046,+,7809
108,BUMA.1121.00089,2,2856582,2864399,+,7817
108,BUMA.1121.00051,2,2871235,2879063,+,7828
108,BUMA.1121.00001,2,2509972,2517744,-,7772
108,BUMA.1121.00045,2,2799158,2806997,+,7839
108,BUMA.1121.00043,2,2697867,2705696,-,7829
108,BUMA.1121.00063,2,2870794,2878612,+,7818
108,BUMA.1121.00079,2,2867998,2875835,+,7837
108,BUMA.1121.00071,2,2876784,2884602,+,7818
108,BUMA.1121.00086,2,2178206,2186015,+,7809
108,BUMA.1121.00024,2,2069169,2076978,+,7809
108,BUMA.1121.00010,2,1592946,1600755,-,7809
108,BUMA.1121.00040,2,2015699,2023507,+,7808
108,BUMA.1121.00093,2,35996,43807,-,7811
108,BUMA.1121.00091,2,716465,724268,-,7803
108,BUMA.1121.00107,2,893782,901603,-,7821
108,BUMA.1121.00088,2,2890894,2898703,+,7809
108,BUMA.1121.00047,2,684455,692269,+,7814
108,BUMA.1121.00019,2,2013382,2021191,+,7809
108,BUMA.1121.00087,2,769802,777611,-,7809
108,BUMA.1121.00039,2,1056499,1064298,-,7799
108,BUMA.1121.00030,2,164910,172719,-,7809
108,BUMA.1121.00016,2,847536,855355,-,7819
108,BUMA.1121.00092,2,2894158,2901969,+,7811
108,BUMA.1121.00085,2,990869,998678,+,7809
108,BUMA.1121.00046,2,842015,849824,+,7809
108,BUMA.1121.00003,2,1083359,1091180,+,7821
108,BUMA.1121.00054,2,2291819,2299628,-,7809
108,BUMA.1121.00015,2,79219,87019,+,7800
108,BUMA.1121.00105,2,2750590,2758416,-,7826
108,BUMA.1121.00052,2,1679398,1687207,+,7809
108,BUMA.1121.00053,2,3196964,3204814,+,7850
108,BUMA.1121.00057,2,2334048,2341883,-,7835
108,BUMA.1121.00108,2,3142397,3150174,+,7777
108,BUMA.1121.00050,2,263826,271635,-,7809
108,BUMA.1121.00104,2,2975425,2983249,+,7824
108,BUMA.1121.00014,2,3028905,3036642,+,7737
108,BUMA.1121.00036,2,1762682,1770491,-,7809
108,BUMA.1121.00038,2,166390,174199,-,7809
108,BUMA.1121.00098,2,3169213,3177020,+,7807
108,BUMA.1121.00078,2,214851,222671,-,7820
108,BUMA.1121.00029,2,1623327,1631099,-,7772
108,BUMA.1121.00099,2,3163262,3171075,+,7813
108,BUMA.1121.00103,2,1578736,1586588,+,7852
108,BUMA.1121.00102,2,2947047,2954879,+,7832
108,BUMA.1121.00028,2,1975410,1983219,+,7809
108,BUMA.1121.00075,2,3100763,3108587,-,7824
108,BUMA.1121.00044,2,2000183,2007992,+,7809
108,BUMA.1121.00076,2,636707,644531,+,7824
108,BUMA.1121.00074,2,1488749,1496560,-,7811
108,BUMA.1121.00073,2,2877516,2885334,+,7818
108,BUMA.1121.00083,2,1554099,1561919,+,7820
108,BUMA.1121.00035,2,1704039,1711811,-,7772
108,BUMA.1121.00072,2,2855207,2863025,+,7818
108,BUMA.1121.00056,2,1127351,1135168,-,7817
108,BUMA.1121.00081,2,2149388,2157197,+,7809
108,BUMA.1121.00033,2,409067,416895,+,7828
108,BUMA.1121.00061,2,2860030,2867848,+,7818
108,BUMA.1121.00062,2,2014112,2021915,-,7803
108,BUMA.1121.00064,2,2793574,2801384,+,7810
108,BUMA.1121.00060,2,2458066,2465905,-,7839
108,BUMA.1121.00069,2,2827099,2834919,+,7820
108,BUMA.1121.00070,2,2856825,2864643,+,7818
108,BUMA.1121.00068,2,1487877,1495676,+,7799
108,BUMA.1121.00067,2,1045121,1052932,-,7811
108,BUMA.1121.00037,2,4191,11993,+,7802
108,BUMA.1121.00065,2,2981577,2989402,+,7825
108,BUMA.1121.00058,2,269963,277796,+,7833
108,BUMA.1121.00041,2,633451,641312,+,7861
108,BUMA.1121.00084,2,1594869,1602660,+,7791
108,BUMA.1121.00096,2,3229218,3237041,+,7823
108,BUMA.1121.00080,2,2927691,2935520,+,7829
108,BUMA.1121.00013,2,256858,264667,+,7809
108,BUMA.1121.00100,2,919141,926908,+,7767
108,BUMA.1121.00012,2,2075684,2083494,-,7810
108,BUMA.1121.00018,2,949867,957670,-,7803
108,BUMA.1121.00048,2,563443,571252,+,7809
108,BUMA.1121.00106,2,2167502,2175342,+,7840
108,BUMA.1121.00017,2,1949282,1957091,+,7809
108,BUMA.1121.00082,2,2930183,2938003,+,7820
109,BUMA.1121.00049,2,1539163,1552386,+,13223
109,BUMA.1121.00055,2,2912392,2925362,-,12970
109,BUMA.1121.00011,2,1524500,1537648,+,13148
109,BUMA.1121.00110,2,2885344,2898555,+,13211
109,BUMA.1121.00109,2,1721175,1734334,-,13159
109,BUMA.1121.00077,2,717408,730618,-,13210
109,BUMA.1121.00027,2,816668,829845,+,13177
109,BUMA.1121.00021,2,217506,230683,+,13177
109,BUMA.1121.00023,2,3052972,3065966,+,12994
109,BUMA.1121.00025,2,1383049,1396170,+,13121
109,BUMA.1121.00031,2,2097912,2110979,+,13067
109,BUMA.1121.00007,2,3004721,3017860,+,13139
109,BUMA.1121.00097,2,2757298,2770466,+,13168
109,BUMA.1121.00059,2,704486,717734,-,13248
109,BUMA.1121.00005,2,992487,1005609,-,13122
109,BUMA.1121.00111,2,2194257,2207427,+,13170
109,BUMA.1121.00009,2,1559994,1573203,+,13209
109,BUMA.1121.00094,2,2918506,2931668,+,13162
109,BUMA.1121.00101,2,493918,507191,-,13273
109,BUMA.1121.00066,2,2868856,2881995,+,13139
109,BUMA.1121.00095,2,1779685,1792849,+,13164
109,BUMA.1121.00112,2,1430432,1443639,-,13207
109,BUMA.1121.00090,2,655462,668638,+,13176
109,BUMA.1121.00089,2,2864400,2877574,+,13174
109,BUMA.1121.00051,2,2879064,2892314,+,13250
109,BUMA.1121.00001,2,2496783,2509970,-,13187
109,BUMA.1121.00045,2,2806998,2820196,+,13198
109,BUMA.1121.00043,2,2683321,2697865,-,14544
109,BUMA.1121.00063,2,2878613,2891776,+,13163
109,BUMA.1121.00079,2,2875836,2889095,+,13259
109,BUMA.1121.00071,2,2884603,2897758,+,13155
109,BUMA.1121.00093,2,22762,35994,-,13232
109,BUMA.1121.00091,2,703334,716463,-,13129
109,BUMA.1121.00107,2,880546,893780,-,13234
109,BUMA.1121.00088,2,2898704,2911872,+,13168
109,BUMA.1121.00047,2,692270,705502,+,13232
109,BUMA.1121.00039,2,1043489,1056497,-,13008
109,BUMA.1121.00016,2,834383,847534,-,13151
109,BUMA.1121.00092,2,2901970,2915203,+,13233
109,BUMA.1121.00003,2,1091181,1104355,+,13174
109,BUMA.1121.00105,2,2737415,2750588,-,13173
109,BUMA.1121.00053,2,3204815,3217986,+,13171
109,BUMA.1121.00057,2,2320852,2334046,-,13194
109,BUMA.1121.00108,2,3150175,3163342,+,13167
109,BUMA.1121.00104,2,2983250,2996363,+,13113
109,BUMA.1121.00014,2,3036643,3049691,+,13048
109,BUMA.1121.00098,2,3177021,3190226,+,13205
109,BUMA.1121.00078,2,201713,214849,-,13136
109,BUMA.1121.00029,2,1610156,1623325,-,13169
109,BUMA.1121.00099,2,3171076,3184301,+,13225
109,BUMA.1121.00103,2,1586589,1599769,+,13180
109,BUMA.1121.00102,2,2954880,2968167,+,13287
109,BUMA.1121.00075,2,3087630,3100761,-,13131
109,BUMA.1121.00076,2,644532,657664,+,13132
109,BUMA.1121.00074,2,1475474,1488747,-,13273
109,BUMA.1121.00073,2,2885335,2898503,+,13168
109,BUMA.1121.00083,2,1561920,1575089,+,13169
109,BUMA.1121.00035,2,1690858,1704037,-,13179
109,BUMA.1121.00072,2,2863026,2876183,+,13157
109,BUMA.1121.00056,2,1114176,1127349,-,13173
109,BUMA.1121.00033,2,416896,429908,+,13012
109,BUMA.1121.00061,2,2867849,2881010,+,13161
109,BUMA.1121.00062,2,2000908,2014110,-,13202
109,BUMA.1121.00064,2,2801385,2814641,+,13256
109,BUMA.1121.00060,2,2444867,2458064,-,13197
109,BUMA.1121.00069,2,2834920,2848077,+,13157
109,BUMA.1121.00070,2,2864644,2877803,+,13159
109,BUMA.1121.00068,2,1495677,1508842,+,13165
109,BUMA.1121.00067,2,1031864,1045119,-,13255
109,BUMA.1121.00037,2,11994,25051,+,13057
109,BUMA.1121.00065,2,2989403,3002605,+,13202
109,BUMA.1121.00058,2,277797,291077,+,13280
109,BUMA.1121.00041,2,641313,654496,+,13183
109,BUMA.1121.00084,2,1602661,1615841,+,13180
109,BUMA.1121.00096,2,3237042,3250264,+,13222
109,BUMA.1121.00080,2,2935521,2948811,+,13290
109,BUMA.1121.00100,2,926909,939996,+,13087
109,BUMA.1121.00012,2,2062545,2075682,-,13137
109,BUMA.1121.00018,2,936745,949865,-,13120
109,BUMA.1121.00106,2,2175343,2188545,+,13202
109,BUMA.1121.00082,2,2938004,2951173,+,13169
110,BUMA.1121.00049,2,1552387,1568114,+,15727
110,BUMA.1121.00055,2,2896685,2912390,-,15705
110,BUMA.1121.00011,2,1537649,1553388,+,15739
110,BUMA.1121.00110,2,2898556,2914229,+,15673
110,BUMA.1121.00109,2,1705534,1721173,-,15639
110,BUMA.1121.00077,2,701731,717406,-,15675
110,BUMA.1121.00027,2,829846,845560,+,15714
110,BUMA.1121.00021,2,230684,246383,+,15699
110,BUMA.1121.00023,2,3065967,3081685,+,15718
110,BUMA.1121.00025,2,1396171,1411892,+,15721
110,BUMA.1121.00031,2,2110980,2126701,+,15721
110,BUMA.1121.00007,2,3017861,3033579,+,15718
110,BUMA.1121.00097,2,2770467,2786179,+,15712
110,BUMA.1121.00059,2,688784,704484,-,15700
110,BUMA.1121.00005,2,976770,992485,-,15715
110,BUMA.1121.00111,2,2207428,2223107,+,15679
110,BUMA.1121.00009,2,1573204,1588908,+,15704
110,BUMA.1121.00094,2,2931669,2947360,+,15691
110,BUMA.1121.00101,2,478202,493916,-,15714
110,BUMA.1121.00066,2,2881996,2897694,+,15698
110,BUMA.1121.00095,2,1792850,1808578,+,15728
110,BUMA.1121.00112,2,1414700,1430430,-,15730
110,BUMA.1121.00090,2,668639,684361,+,15722
110,BUMA.1121.00089,2,2877575,2893266,+,15691
110,BUMA.1121.00051,2,2892315,2908038,+,15723
110,BUMA.1121.00001,2,2481061,2496781,-,15720
110,BUMA.1121.00045,2,2820197,2835937,+,15740
110,BUMA.1121.00043,2,2667600,2683319,-,15719
110,BUMA.1121.00063,2,2891777,2907491,+,15714
110,BUMA.1121.00079,2,2889096,2904802,+,15706
110,BUMA.1121.00071,2,2897759,2913473,+,15714
110,BUMA.1121.00093,2,7032,22760,-,15728
110,BUMA.1121.00091,2,687677,703332,-,15655
110,BUMA.1121.00107,2,864820,880544,-,15724
110,BUMA.1121.00088,2,2911873,2927580,+,15707
110,BUMA.1121.00047,2,705503,721228,+,15725
110,BUMA.1121.00039,2,1027787,1043487,-,15700
110,BUMA.1121.00016,2,818693,834381,-,15688
110,BUMA.1121.00092,2,2915204,2930933,+,15729
110,BUMA.1121.00003,2,1104356,1120067,+,15711
110,BUMA.1121.00105,2,2721691,2737413,-,15722
110,BUMA.1121.00053,2,15,15754,+,15739
110,BUMA.1121.00057,2,2305151,2320850,-,15699
110,BUMA.1121.00108,2,3163343,3179040,+,15697
110,BUMA.1121.00104,2,2996364,3012093,+,15729
110,BUMA.1121.00014,2,3049692,3065405,+,15713
110,BUMA.1121.00098,2,3190227,3205965,+,15738
110,BUMA.1121.00078,2,186017,201711,-,15694
110,BUMA.1121.00029,2,1594436,1610154,-,15718
110,BUMA.1121.00099,2,3184302,3199994,+,15692
110,BUMA.1121.00103,2,1599770,1615480,+,15710
110,BUMA.1121.00102,2,2968168,2983885,+,15717
110,BUMA.1121.00075,2,3071901,3087628,-,15727
110,BUMA.1121.00076,2,657665,673394,+,15729
110,BUMA.1121.00074,2,1459772,1475472,-,15700
110,BUMA.1121.00073,2,2898504,2914218,+,15714
110,BUMA.1121.00083,2,1575090,1590804,+,15714
110,BUMA.1121.00035,2,1675145,1690856,-,15711
110,BUMA.1121.00072,2,2876184,2891898,+,15714
110,BUMA.1121.00056,2,1098484,1114174,-,15690
110,BUMA.1121.00033,2,429909,445629,+,15720
110,BUMA.1121.00061,2,2881011,2896724,+,15713
110,BUMA.1121.00062,2,1985185,2000906,-,15721
110,BUMA.1121.00064,2,2814642,2830343,+,15701
110,BUMA.1121.00060,2,2429126,2444865,-,15739
110,BUMA.1121.00069,2,2848078,2863782,+,15704
110,BUMA.1121.00070,2,2877804,2893517,+,15713
110,BUMA.1121.00068,2,1508843,1524602,+,15759
110,BUMA.1121.00067,2,1016181,1031862,-,15681
110,BUMA.1121.00037,2,25052,40777,+,15725
110,BUMA.1121.00065,2,3002606,3018321,+,15715
110,BUMA.1121.00058,2,291078,306792,+,15714
110,BUMA.1121.00041,2,654497,670251,+,15754
110,BUMA.1121.00084,2,1615842,1631580,+,15738
110,BUMA.1121.00096,2,3250265,3265977,+,15712
110,BUMA.1121.00080,2,2948812,2964536,+,15724
110,BUMA.1121.00100,2,939997,955708,+,15711
110,BUMA.1121.00012,2,2046830,2062543,-,15713
110,BUMA.1121.00018,2,921023,936743,-,15720
110,BUMA.1121.00106,2,2188546,2204254,+,15708
110,BUMA.1121.00082,2,2951174,2966888,+,15714
111,BUMA.1121.00049,2,1568115,1572536,+,4421
111,BUMA.1121.00055,2,2892262,2896683,-,4421
111,BUMA.1121.00011,2,1553389,1557810,+,4421
111,BUMA.1121.00110,2,2914230,2918651,+,4421
111,BUMA.1121.00109,2,1701111,1705532,-,4421
111,BUMA.1121.00077,2,697307,701729,-,4422
111,BUMA.1121.00027,2,845561,849982,+,4421
111,BUMA.1121.00021,2,246384,250805,+,4421
111,BUMA.1121.00023,2,3081686,3086107,+,4421
111,BUMA.1121.00007,2,3033580,3037989,+,4409
111,BUMA.1121.00097,2,2786180,2790601,+,4421
111,BUMA.1121.00059,2,684361,688782,-,4421
111,BUMA.1121.00005,2,972348,976768,-,4420
111,BUMA.1121.00111,2,2223108,2227529,+,4421
111,BUMA.1121.00009,2,1588909,1593330,+,4421
111,BUMA.1121.00094,2,2947361,2951782,+,4421
111,BUMA.1121.00101,2,473779,478200,-,4421
111,BUMA.1121.00066,2,2897695,2902116,+,4421
111,BUMA.1121.00095,2,1808579,1813000,+,4421
111,BUMA.1121.00112,2,1410277,1414698,-,4421
111,BUMA.1121.00090,2,684362,688783,+,4421
111,BUMA.1121.00089,2,2893267,2897688,+,4421
111,BUMA.1121.00051,2,2908039,2912459,+,4420
111,BUMA.1121.00001,2,2476638,2481059,-,4421
111,BUMA.1121.00045,2,2835938,2840359,+,4421
111,BUMA.1121.00043,2,2663177,2667598,-,4421
111,BUMA.1121.00063,2,2907492,2911913,+,4421
111,BUMA.1121.00079,2,2904803,2909222,+,4419
111,BUMA.1121.00071,2,2913474,2917895,+,4421
111,BUMA.1121.00093,2,2609,7030,-,4421
111,BUMA.1121.00091,2,683254,687675,-,4421
111,BUMA.1121.00107,2,860397,864818,-,4421
111,BUMA.1121.00088,2,2927581,2932002,+,4421
111,BUMA.1121.00047,2,721229,725650,+,4421
111,BUMA.1121.00039,2,1023364,1027785,-,4421
111,BUMA.1121.00092,2,2930934,2935355,+,4421
111,BUMA.1121.00003,2,1120068,1124489,+,4421
111,BUMA.1121.00105,2,2717268,2721689,-,4421
111,BUMA.1121.00053,2,15755,20176,+,4421
111,BUMA.1121.00057,2,2300728,2305149,-,4421
111,BUMA.1121.00108,2,3179041,3183462,+,4421
111,BUMA.1121.00104,2,3012094,3016515,+,4421
111,BUMA.1121.00098,2,10,4446,+,4436
111,BUMA.1121.00078,2,181596,186015,-,4419
111,BUMA.1121.00029,2,1590013,1594434,-,4421
111,BUMA.1121.00099,2,3199995,3204416,+,4421
111,BUMA.1121.00103,2,1615481,1619902,+,4421
111,BUMA.1121.00102,2,2983886,2988307,+,4421
111,BUMA.1121.00075,2,3067478,3071899,-,4421
111,BUMA.1121.00076,2,673395,677816,+,4421
111,BUMA.1121.00074,2,1455349,1459770,-,4421
111,BUMA.1121.00073,2,2914219,2918640,+,4421
111,BUMA.1121.00083,2,1590805,1595226,+,4421
111,BUMA.1121.00035,2,1670722,1675143,-,4421
111,BUMA.1121.00072,2,2891899,2896320,+,4421
111,BUMA.1121.00056,2,1094061,1098482,-,4421
111,BUMA.1121.00033,2,445630,450051,+,4421
111,BUMA.1121.00061,2,2896725,2901146,+,4421
111,BUMA.1121.00062,2,1980762,1985183,-,4421
111,BUMA.1121.00064,2,2830344,2834765,+,4421
111,BUMA.1121.00060,2,2424703,2429124,-,4421
111,BUMA.1121.00069,2,2863783,2868204,+,4421
111,BUMA.1121.00070,2,2893518,2897939,+,4421
111,BUMA.1121.00068,2,1524603,1529024,+,4421
111,BUMA.1121.00067,2,1011758,1016179,-,4421
111,BUMA.1121.00065,2,3018322,3022743,+,4421
111,BUMA.1121.00058,2,306793,311214,+,4421
111,BUMA.1121.00041,2,670252,674673,+,4421
111,BUMA.1121.00084,2,1631581,1636002,+,4421
111,BUMA.1121.00096,2,3265978,3270399,+,4421
111,BUMA.1121.00080,2,2964537,2968958,+,4421
111,BUMA.1121.00100,2,955709,960130,+,4421
111,BUMA.1121.00012,2,2042407,2046828,-,4421
111,BUMA.1121.00106,2,2204255,2208676,+,4421
111,BUMA.1121.00082,2,2966889,2971310,+,4421
112,BUMA.1121.00049,2,1575527,1583430,+,7903
112,BUMA.1121.00055,2,2881358,2889271,-,7913
112,BUMA.1121.00011,2,1560801,1568717,+,7916
112,BUMA.1121.00110,2,2921642,2929554,+,7912
112,BUMA.1121.00109,2,1690207,1698120,-,7913
112,BUMA.1121.00077,2,686402,694316,-,7914
112,BUMA.1121.00027,2,852973,860886,+,7913
112,BUMA.1121.00021,2,253796,261698,+,7902
112,BUMA.1121.00023,2,3089095,3097000,+,7905
112,BUMA.1121.00025,2,1414944,1422846,+,7902
112,BUMA.1121.00031,2,2129753,2137655,+,7902
112,BUMA.1121.00007,2,3040980,3048883,+,7903
112,BUMA.1121.00097,2,2793592,2801508,+,7916
112,BUMA.1121.00059,2,673458,681370,-,7912
112,BUMA.1121.00005,2,961492,969357,-,7865
112,BUMA.1121.00111,2,2230517,2238422,+,7905
112,BUMA.1121.00009,2,1596321,1604236,+,7915
112,BUMA.1121.00094,2,2954773,2962691,+,7918
112,BUMA.1121.00101,2,462873,470788,-,7915
112,BUMA.1121.00066,2,2905107,2913021,+,7914
112,BUMA.1121.00095,2,1815978,1823880,+,7902
112,BUMA.1121.00112,2,1399371,1407286,-,7915
112,BUMA.1121.00090,2,691774,699676,+,7902
112,BUMA.1121.00089,2,2900679,2908596,+,7917
112,BUMA.1121.00051,2,2915450,2923366,+,7916
112,BUMA.1121.00001,2,2465746,2473647,-,7901
112,BUMA.1121.00045,2,2843350,2851265,+,7915
112,BUMA.1121.00043,2,2652285,2660190,-,7905
112,BUMA.1121.00063,2,2914904,2922818,+,7914
112,BUMA.1121.00079,2,2912213,2920128,+,7915
112,BUMA.1121.00071,2,2920886,2928800,+,7914
112,BUMA.1121.00093,2,3137158,3145073,-,7915
112,BUMA.1121.00091,2,672351,680263,-,7912
112,BUMA.1121.00107,2,849490,857406,-,7916
112,BUMA.1121.00088,2,2934993,2942910,+,7917
112,BUMA.1121.00047,2,728641,736557,+,7916
112,BUMA.1121.00039,2,1012472,1020373,-,7901
112,BUMA.1121.00016,2,807739,815640,-,7901
112,BUMA.1121.00092,2,2938346,2946262,+,7916
112,BUMA.1121.00003,2,1127445,1135362,+,7917
112,BUMA.1121.00105,2,2706361,2714277,-,7916
112,BUMA.1121.00053,2,23167,31071,+,7904
112,BUMA.1121.00057,2,2289821,2297737,-,7916
112,BUMA.1121.00108,2,3186453,3194326,+,7873
112,BUMA.1121.00104,2,3019506,3027408,+,7902
112,BUMA.1121.00014,2,3068457,3076359,+,7902
112,BUMA.1121.00098,2,7437,15339,+,7902
112,BUMA.1121.00078,2,170690,178605,-,7915
112,BUMA.1121.00029,2,1579121,1587022,-,7901
112,BUMA.1121.00099,2,3207407,3215323,+,7916
112,BUMA.1121.00103,2,1622893,1630810,+,7917
112,BUMA.1121.00102,2,2991298,2999214,+,7916
112,BUMA.1121.00075,2,3056587,3064487,-,7900
112,BUMA.1121.00076,2,680807,688709,+,7902
112,BUMA.1121.00074,2,1444442,1452358,-,7916
112,BUMA.1121.00073,2,2921631,2929545,+,7914
112,BUMA.1121.00083,2,1598217,1606131,+,7914
112,BUMA.1121.00035,2,1659830,1667731,-,7901
112,BUMA.1121.00072,2,2899311,2907225,+,7914
112,BUMA.1121.00056,2,1083154,1091070,-,7916
112,BUMA.1121.00033,2,453039,460943,+,7904
112,BUMA.1121.00061,2,2904137,2912051,+,7914
112,BUMA.1121.00062,2,1969855,1977771,-,7916
112,BUMA.1121.00064,2,2837756,2845673,+,7917
112,BUMA.1121.00060,2,2413798,2421712,-,7914
112,BUMA.1121.00069,2,2871195,2879109,+,7914
112,BUMA.1121.00070,2,2900930,2908844,+,7914
112,BUMA.1121.00068,2,1532015,1539917,+,7902
112,BUMA.1121.00067,2,1000852,1008767,-,7915
112,BUMA.1121.00037,2,43829,51731,+,7902
112,BUMA.1121.00065,2,3025734,3033636,+,7902
112,BUMA.1121.00058,2,314205,322121,+,7916
112,BUMA.1121.00041,2,677664,685578,+,7914
112,BUMA.1121.00084,2,1638993,1646910,+,7917
112,BUMA.1121.00096,2,3273390,3281287,+,7897
112,BUMA.1121.00080,2,2971949,2979865,+,7916
112,BUMA.1121.00100,2,963121,971036,+,7915
112,BUMA.1121.00012,2,2031515,2039416,-,7901
112,BUMA.1121.00018,2,910069,917970,-,7901
112,BUMA.1121.00106,2,2211667,2219583,+,7916
112,BUMA.1121.00082,2,2974301,2982215,+,7914
113,BUMA.1121.00049,2,1583431,1598469,+,15038
113,BUMA.1121.00055,2,2866607,2881356,-,14749
113,BUMA.1121.00011,2,1568718,1583535,+,14817
113,BUMA.1121.00110,2,2929555,2944320,+,14765
113,BUMA.1121.00109,2,1675341,1690205,-,14864
113,BUMA.1121.00077,2,671540,686400,-,14860
113,BUMA.1121.00027,2,860887,875638,+,14751
113,BUMA.1121.00021,2,261699,276439,+,14740
113,BUMA.1121.00023,2,3097001,3111717,+,14716
113,BUMA.1121.00025,2,1422847,1437509,+,14662
113,BUMA.1121.00031,2,2137656,2152323,+,14667
113,BUMA.1121.00007,2,3048884,3063665,+,14781
113,BUMA.1121.00097,2,2801509,2816290,+,14781
113,BUMA.1121.00059,2,658455,673456,-,15001
113,BUMA.1121.00005,2,946489,961490,-,15001
113,BUMA.1121.00111,2,2238423,2253303,+,14880
113,BUMA.1121.00009,2,1604237,1618836,+,14599
113,BUMA.1121.00094,2,2962692,2977577,+,14885
113,BUMA.1121.00101,2,447988,462871,-,14883
113,BUMA.1121.00066,2,2913022,2927629,+,14607
113,BUMA.1121.00095,2,1823881,1838707,+,14826
113,BUMA.1121.00112,2,1384518,1399369,-,14851
113,BUMA.1121.00090,2,699677,714533,+,14856
113,BUMA.1121.00089,2,2908597,2923522,+,14925
113,BUMA.1121.00051,2,2923367,2938225,+,14858
113,BUMA.1121.00001,2,2451100,2465744,-,14644
113,BUMA.1121.00045,2,2851266,2865890,+,14624
113,BUMA.1121.00043,2,2637517,2652283,-,14766
113,BUMA.1121.00063,2,2922819,2937440,+,14621
113,BUMA.1121.00079,2,2920129,2934993,+,14864
113,BUMA.1121.00071,2,2928801,2943393,+,14592
113,BUMA.1121.00093,2,3122379,3137156,-,14777
113,BUMA.1121.00091,2,657536,672349,-,14813
113,BUMA.1121.00107,2,834682,849488,-,14806
113,BUMA.1121.00088,2,2942911,2957753,+,14842
113,BUMA.1121.00047,2,736558,751644,+,15086
113,BUMA.1121.00039,2,997696,1012470,-,14774
113,BUMA.1121.00016,2,793099,807737,-,14638
113,BUMA.1121.00092,2,2946263,2961041,+,14778
113,BUMA.1121.00003,2,1135363,1150171,+,14808
113,BUMA.1121.00105,2,2691418,2706359,-,14941
113,BUMA.1121.00053,2,31072,45909,+,14837
113,BUMA.1121.00057,2,2274894,2289819,-,14925
113,BUMA.1121.00108,2,26,14777,+,14751
113,BUMA.1121.00104,2,3027409,3042215,+,14806
113,BUMA.1121.00014,2,3076360,3091134,+,14774
113,BUMA.1121.00098,2,15340,30293,+,14953
113,BUMA.1121.00078,2,155898,170688,-,14790
113,BUMA.1121.00029,2,1564506,1579119,-,14613
113,BUMA.1121.00099,2,3215324,3230159,+,14835
113,BUMA.1121.00103,2,1630811,1645788,+,14977
113,BUMA.1121.00102,2,2999215,3014250,+,15035
113,BUMA.1121.00075,2,3041709,3056585,-,14876
113,BUMA.1121.00076,2,688710,703508,+,14798
113,BUMA.1121.00074,2,1429650,1444440,-,14790
113,BUMA.1121.00073,2,2929546,2944154,+,14608
113,BUMA.1121.00083,2,1606132,1620766,+,14634
113,BUMA.1121.00035,2,1645226,1659828,-,14602
113,BUMA.1121.00072,2,2907226,2921833,+,14607
113,BUMA.1121.00056,2,1068228,1083152,-,14924
113,BUMA.1121.00033,2,460944,475900,+,14956
113,BUMA.1121.00061,2,2912052,2926620,+,14568
113,BUMA.1121.00062,2,1955175,1969853,-,14678
113,BUMA.1121.00064,2,2845674,2860547,+,14873
113,BUMA.1121.00060,2,2399186,2413796,-,14610
113,BUMA.1121.00069,2,2879110,2893701,+,14591
113,BUMA.1121.00070,2,2908845,2923445,+,14600
113,BUMA.1121.00068,2,1539918,1554579,+,14661
113,BUMA.1121.00067,2,986125,1000850,-,14725
113,BUMA.1121.00037,2,51732,66608,+,14876
113,BUMA.1121.00065,2,3033637,3048371,+,14734
113,BUMA.1121.00058,2,322122,336894,+,14772
113,BUMA.1121.00041,2,685579,700384,+,14805
113,BUMA.1121.00084,2,1646911,1661951,+,15040
113,BUMA.1121.00096,2,3281288,3296071,+,14783
113,BUMA.1121.00080,2,2979866,2994847,+,14981
113,BUMA.1121.00100,2,971037,985893,+,14856
113,BUMA.1121.00012,2,2016808,2031513,-,14705
113,BUMA.1121.00018,2,895414,910067,-,14653
113,BUMA.1121.00106,2,2219584,2234507,+,14923
113,BUMA.1121.00082,2,2982216,2996850,+,14634
114,BUMA.1121.00049,2,1600537,1606764,+,6227
114,BUMA.1121.00055,2,2859941,2866156,-,6215
114,BUMA.1121.00011,2,1585603,1591797,+,6194
114,BUMA.1121.00110,2,2946389,2952597,+,6208
114,BUMA.1121.00109,2,1666177,1672412,-,6235
114,BUMA.1121.00077,2,663264,669473,-,6209
114,BUMA.1121.00027,2,876089,882333,+,6244
114,BUMA.1121.00021,2,278507,284685,+,6178
114,BUMA.1121.00023,2,3113785,3120008,+,6223
114,BUMA.1121.00025,2,1439577,1445747,+,6170
114,BUMA.1121.00031,2,2154391,2160599,+,6208
114,BUMA.1121.00007,2,3065734,3071743,+,6009
114,BUMA.1121.00097,2,2818356,2824536,+,6180
114,BUMA.1121.00059,2,651832,658004,-,6172
114,BUMA.1121.00005,2,938215,944420,-,6205
114,BUMA.1121.00111,2,2255371,2261555,+,6184
114,BUMA.1121.00009,2,1620904,1627110,+,6206
114,BUMA.1121.00094,2,2978028,2984249,+,6221
114,BUMA.1121.00101,2,439737,445919,-,6182
114,BUMA.1121.00066,2,2928080,2934290,+,6210
114,BUMA.1121.00095,2,1840775,1846925,+,6150
114,BUMA.1121.00112,2,1376229,1382450,-,6221
114,BUMA.1121.00090,2,716601,722803,+,6202
114,BUMA.1121.00089,2,2923973,2930195,+,6222
114,BUMA.1121.00051,2,2938676,2944895,+,6219
114,BUMA.1121.00001,2,2442836,2449032,-,6196
114,BUMA.1121.00045,2,2867957,2874163,+,6206
114,BUMA.1121.00043,2,2629247,2635449,-,6202
114,BUMA.1121.00063,2,2937891,2944127,+,6236
114,BUMA.1121.00079,2,2935444,2941686,+,6242
114,BUMA.1121.00071,2,2943844,2950073,+,6229
114,BUMA.1121.00093,2,3114144,3120310,-,6166
114,BUMA.1121.00091,2,650820,657085,-,6265
114,BUMA.1121.00107,2,826456,832624,-,6168
114,BUMA.1121.00088,2,2958204,2964378,+,6174
114,BUMA.1121.00047,2,752095,758315,+,6220
114,BUMA.1121.00039,2,989435,995628,-,6193
114,BUMA.1121.00016,2,784834,791031,-,6197
114,BUMA.1121.00092,2,2963110,2969276,+,6166
114,BUMA.1121.00003,2,1150625,1156825,+,6200
114,BUMA.1121.00105,2,2684731,2690967,-,6236
114,BUMA.1121.00053,2,47978,54200,+,6222
114,BUMA.1121.00057,2,2268202,2274443,-,6241
114,BUMA.1121.00108,2,16845,23077,+,6232
114,BUMA.1121.00104,2,3044285,3050504,+,6219
114,BUMA.1121.00014,2,3093202,3099410,+,6208
114,BUMA.1121.00098,2,32362,38594,+,6232
114,BUMA.1121.00078,2,147645,153829,-,6184
114,BUMA.1121.00029,2,1556242,1562438,-,6196
114,BUMA.1121.00099,2,3232227,3238447,+,6220
114,BUMA.1121.00103,2,1647857,1654081,+,6224
114,BUMA.1121.00102,2,3016320,3022513,+,6193
114,BUMA.1121.00075,2,3033400,3039639,-,6239
114,BUMA.1121.00076,2,705578,711824,+,6246
114,BUMA.1121.00074,2,1421383,1427582,-,6199
114,BUMA.1121.00073,2,2944605,2950833,+,6228
114,BUMA.1121.00083,2,1621217,1627465,+,6248
114,BUMA.1121.00035,2,1636962,1643158,-,6196
114,BUMA.1121.00072,2,2922284,2928512,+,6228
114,BUMA.1121.00056,2,1061555,1067777,-,6222
114,BUMA.1121.00033,2,477968,484164,+,6196
114,BUMA.1121.00061,2,2927071,2933298,+,6227
114,BUMA.1121.00062,2,1948537,1954724,-,6187
114,BUMA.1121.00064,2,2862615,2868814,+,6199
114,BUMA.1121.00060,2,2390913,2397119,-,6206
114,BUMA.1121.00069,2,2894152,2900397,+,6245
114,BUMA.1121.00070,2,2923896,2930123,+,6227
114,BUMA.1121.00068,2,1555033,1561228,+,6195
114,BUMA.1121.00067,2,979508,985674,-,6166
114,BUMA.1121.00037,2,68676,74872,+,6196
114,BUMA.1121.00065,2,3050441,3056654,+,6213
114,BUMA.1121.00058,2,337345,343580,+,6235
114,BUMA.1121.00041,2,700835,707044,+,6209
114,BUMA.1121.00084,2,1662402,1668575,+,6173
114,BUMA.1121.00096,2,3298138,3304365,+,6227
114,BUMA.1121.00080,2,2995298,3001517,+,6219
114,BUMA.1121.00100,2,986347,992530,+,6183
114,BUMA.1121.00012,2,2008538,2014740,-,6202
114,BUMA.1121.00018,2,887176,893346,-,6170
114,BUMA.1121.00106,2,2236575,2242808,+,6233
114,BUMA.1121.00082,2,2997301,3003549,+,6248
115,BUMA.1121.00049,2,1607004,1611951,+,4947
115,BUMA.1121.00055,2,2854748,2859686,-,4938
115,BUMA.1121.00011,2,1592051,1596979,+,4928
115,BUMA.1121.00110,2,2952851,2957789,+,4938
115,BUMA.1121.00109,2,1661026,1665942,-,4916
115,BUMA.1121.00077,2,658072,663009,-,4937
115,BUMA.1121.00027,2,882578,887516,+,4938
115,BUMA.1121.00021,2,284935,289882,+,4947
115,BUMA.1121.00023,2,3120248,3125196,+,4948
115,BUMA.1121.00025,2,1445987,1450935,+,4948
115,BUMA.1121.00031,2,2160839,2165783,+,4944
115,BUMA.1121.00007,2,3072004,3076906,+,4902
115,BUMA.1121.00097,2,2824782,2829720,+,4938
115,BUMA.1121.00059,2,646631,651587,-,4956
115,BUMA.1121.00005,2,933037,937975,-,4938
115,BUMA.1121.00111,2,2261787,2266708,+,4921
115,BUMA.1121.00009,2,1627364,1632302,+,4938
115,BUMA.1121.00094,2,2984494,2989432,+,4938
115,BUMA.1121.00101,2,434544,439466,-,4922
115,BUMA.1121.00066,2,2934543,2939482,+,4939
115,BUMA.1121.00095,2,1847177,1852116,+,4939
115,BUMA.1121.00112,2,1371060,1375954,-,4894
115,BUMA.1121.00090,2,723043,727991,+,4948
115,BUMA.1121.00089,2,2930440,2935379,+,4939
115,BUMA.1121.00051,2,2945141,2950071,+,4930
115,BUMA.1121.00001,2,2436285,2441241,-,4956
115,BUMA.1121.00045,2,2874392,2879342,+,4950
115,BUMA.1121.00043,2,2622706,2627652,-,4946
115,BUMA.1121.00063,2,2944381,2949320,+,4939
115,BUMA.1121.00079,2,2941930,2946878,+,4948
115,BUMA.1121.00071,2,2950326,2955261,+,4935
115,BUMA.1121.00093,2,3108941,3113897,-,4956
115,BUMA.1121.00091,2,645641,650579,-,4938
115,BUMA.1121.00107,2,821266,826205,-,4939
115,BUMA.1121.00088,2,2964618,2969566,+,4948
115,BUMA.1121.00047,2,758561,763500,+,4939
115,BUMA.1121.00039,2,982893,987840,-,4947
115,BUMA.1121.00016,2,778293,783239,-,4946
115,BUMA.1121.00092,2,2969522,2974479,+,4957
115,BUMA.1121.00003,2,1157090,1162028,+,4938
115,BUMA.1121.00105,2,2679546,2684484,-,4938
115,BUMA.1121.00053,2,54430,59378,+,4948
115,BUMA.1121.00057,2,2263008,2267946,-,4938
115,BUMA.1121.00108,2,23364,28301,+,4937
115,BUMA.1121.00104,2,3050744,3055682,+,4938
115,BUMA.1121.00014,2,3099650,3104603,+,4953
115,BUMA.1121.00098,2,38849,43776,+,4927
115,BUMA.1121.00078,2,142472,147415,-,4943
115,BUMA.1121.00029,2,1549691,1554647,-,4956
115,BUMA.1121.00099,2,3238731,3243669,+,4938
115,BUMA.1121.00103,2,1654323,1659247,+,4924
115,BUMA.1121.00102,2,3022753,3027683,+,4930
115,BUMA.1121.00075,2,3028222,3033159,-,4937
115,BUMA.1121.00076,2,712064,717002,+,4938
115,BUMA.1121.00074,2,1416164,1421138,-,4974
115,BUMA.1121.00073,2,2951088,2956027,+,4939
115,BUMA.1121.00083,2,1627720,1632659,+,4939
115,BUMA.1121.00035,2,1631765,1636721,-,4956
115,BUMA.1121.00072,2,2928767,2933706,+,4939
115,BUMA.1121.00056,2,1056371,1061309,-,4938
115,BUMA.1121.00033,2,484404,489352,+,4948
115,BUMA.1121.00061,2,2933548,2938487,+,4939
115,BUMA.1121.00062,2,1943344,1948291,-,4947
115,BUMA.1121.00064,2,2869058,2874015,+,4957
115,BUMA.1121.00060,2,2385734,2390683,-,4949
115,BUMA.1121.00069,2,2900652,2905591,+,4939
115,BUMA.1121.00070,2,2930378,2935317,+,4939
115,BUMA.1121.00068,2,1561517,1566483,+,4966
115,BUMA.1121.00067,2,974315,979262,-,4947
115,BUMA.1121.00037,2,76466,81413,+,4947
115,BUMA.1121.00065,2,3056898,3061843,+,4945
115,BUMA.1121.00058,2,343834,348773,+,4939
115,BUMA.1121.00041,2,707288,712227,+,4939
115,BUMA.1121.00084,2,1668821,1673777,+,4956
115,BUMA.1121.00096,2,3304609,3309556,+,4947
115,BUMA.1121.00080,2,3001763,3006702,+,4939
115,BUMA.1121.00100,2,992774,997710,+,4936
115,BUMA.1121.00012,2,2003350,2008297,-,4947
115,BUMA.1121.00018,2,881988,886935,-,4947
115,BUMA.1121.00106,2,2243048,2247996,+,4948
115,BUMA.1121.00082,2,3003804,3008743,+,4939
116,BUMA.1121.00049,2,1613160,1635422,+,22262
116,BUMA.1121.00055,2,2831287,2853502,-,22215
116,BUMA.1121.00011,2,1598186,1620400,+,22214
116,BUMA.1121.00110,2,2958996,2981194,+,22198
116,BUMA.1121.00109,2,1637549,1659826,-,22277
116,BUMA.1121.00077,2,634668,656865,-,22197
116,BUMA.1121.00027,2,888748,910949,+,22201
116,BUMA.1121.00021,2,291099,313283,+,22184
116,BUMA.1121.00023,2,3126397,3148653,+,22256
116,BUMA.1121.00022,2,1379804,1401991,+,22187
116,BUMA.1121.00034,2,1958712,1980926,+,22214
116,BUMA.1121.00025,2,1452136,1474353,+,22217
116,BUMA.1121.00031,2,2166998,2189181,+,22183
116,BUMA.1121.00007,2,3078174,3100398,+,22224
116,BUMA.1121.00097,2,2830928,2853167,+,22239
116,BUMA.1121.00008,2,1942941,1965164,+,22223
116,BUMA.1121.00059,2,623131,645378,-,22247
116,BUMA.1121.00002,2,715983,738085,-,22102
116,BUMA.1121.00004,2,1943393,1965606,+,22213
116,BUMA.1121.00005,2,909652,931830,-,22178
116,BUMA.1121.00111,2,2267909,2290111,+,22202
116,BUMA.1121.00006,2,142559,164755,-,22196
116,BUMA.1121.00009,2,1633494,1655719,+,22225
116,BUMA.1121.00094,2,2990640,3012833,+,22193
116,BUMA.1121.00101,2,411029,433330,-,22301
116,BUMA.1121.00066,2,2940716,2962919,+,22203
116,BUMA.1121.00095,2,1853316,1875536,+,22220
116,BUMA.1121.00112,2,1347543,1369780,-,22237
116,BUMA.1121.00042,2,1455190,1478703,+,23513
116,BUMA.1121.00032,2,383773,405987,+,22214
116,BUMA.1121.00090,2,729192,751412,+,22220
116,BUMA.1121.00020,2,1943663,1965886,+,22223
116,BUMA.1121.00089,2,2936587,2958789,+,22202
116,BUMA.1121.00051,2,2951279,2973461,+,22182
116,BUMA.1121.00001,2,2412857,2435076,-,22219
116,BUMA.1121.00045,2,2880558,2902749,+,22191
116,BUMA.1121.00043,2,2599268,2621505,-,22237
116,BUMA.1121.00063,2,2950554,2972757,+,22203
116,BUMA.1121.00079,2,2948086,2970277,+,22191
116,BUMA.1121.00071,2,2956495,2978698,+,22203
116,BUMA.1121.00086,2,2187635,2209822,+,22187
116,BUMA.1121.00024,2,2078595,2100809,+,22214
116,BUMA.1121.00010,2,1567646,1589739,-,22093
116,BUMA.1121.00040,2,2025123,2047337,+,22214
116,BUMA.1121.00093,2,3085504,3107691,-,22187
116,BUMA.1121.00091,2,622222,644434,-,22212
116,BUMA.1121.00107,2,797902,820059,-,22157
116,BUMA.1121.00088,2,2970775,2992965,+,22190
116,BUMA.1121.00047,2,764709,786902,+,22193
116,BUMA.1121.00019,2,2022808,2045031,+,22223
116,BUMA.1121.00087,2,745995,768182,-,22187
116,BUMA.1121.00039,2,959499,981692,-,22193
116,BUMA.1121.00030,2,141079,163293,-,22214
116,BUMA.1121.00016,2,754889,777084,-,22195
116,BUMA.1121.00092,2,2975732,2997919,+,22187
116,BUMA.1121.00085,2,1000295,1022500,+,22205
116,BUMA.1121.00046,2,851441,873628,+,22187
116,BUMA.1121.00003,2,1163236,1185469,+,22233
116,BUMA.1121.00054,2,2268006,2290202,-,22196
116,BUMA.1121.00015,2,88638,110843,+,22205
116,BUMA.1121.00105,2,2656072,2678337,-,22265
116,BUMA.1121.00052,2,1688824,1711029,+,22205
116,BUMA.1121.00053,2,60578,82780,+,22202
116,BUMA.1121.00057,2,2239591,2261776,-,22185
116,BUMA.1121.00108,2,29503,51722,+,22219
116,BUMA.1121.00050,2,240022,262209,-,22187
116,BUMA.1121.00104,2,3056891,3079132,+,22241
116,BUMA.1121.00014,2,3105818,3128002,+,22184
116,BUMA.1121.00036,2,1738866,1761062,-,22196
116,BUMA.1121.00038,2,142577,164773,-,22196
116,BUMA.1121.00098,2,44999,67161,+,22162
116,BUMA.1121.00078,2,119054,141261,-,22207
116,BUMA.1121.00029,2,1526253,1548490,-,22237
116,BUMA.1121.00099,2,3244879,3267089,+,22210
116,BUMA.1121.00103,2,1660454,1682630,+,22176
116,BUMA.1121.00102,2,3028890,3051083,+,22193
116,BUMA.1121.00028,2,1984836,2007050,+,22214
116,BUMA.1121.00075,2,3004811,3027022,-,22211
116,BUMA.1121.00044,2,2009609,2031823,+,22214
116,BUMA.1121.00076,2,718202,740418,+,22216
116,BUMA.1121.00074,2,1392642,1414904,-,22262
116,BUMA.1121.00073,2,2957263,2979466,+,22203
116,BUMA.1121.00083,2,1633898,1656101,+,22203
116,BUMA.1121.00035,2,1608318,1630556,-,22238
116,BUMA.1121.00072,2,2934941,2957144,+,22203
116,BUMA.1121.00056,2,1032961,1055163,-,22202
116,BUMA.1121.00081,2,2158814,2181010,+,22196
116,BUMA.1121.00033,2,490545,512763,+,22218
116,BUMA.1121.00061,2,2939726,2961929,+,22203
116,BUMA.1121.00062,2,1919912,1942135,-,22223
116,BUMA.1121.00064,2,2875261,2897475,+,22214
116,BUMA.1121.00060,2,2362327,2384518,-,22191
116,BUMA.1121.00069,2,2906830,2929032,+,22202
116,BUMA.1121.00070,2,2936551,2958754,+,22203
116,BUMA.1121.00068,2,1567690,1589919,+,22229
116,BUMA.1121.00067,2,950865,973106,-,22241
116,BUMA.1121.00037,2,82614,104825,+,22211
116,BUMA.1121.00065,2,3063052,3085262,+,22210
116,BUMA.1121.00058,2,349982,372169,+,22187
116,BUMA.1121.00041,2,713434,735636,+,22202
116,BUMA.1121.00084,2,1675030,1697283,+,22253
116,BUMA.1121.00096,2,3310794,3332995,+,22201
116,BUMA.1121.00080,2,3007909,3030093,+,22184
116,BUMA.1121.00013,2,266284,288949,+,22665
116,BUMA.1121.00100,2,998968,1021173,+,22205
116,BUMA.1121.00012,2,1979897,2002120,-,22223
116,BUMA.1121.00018,2,858571,880787,-,22216
116,BUMA.1121.00048,2,572869,595065,+,22196
116,BUMA.1121.00106,2,2249205,2271395,+,22190
116,BUMA.1121.00017,2,1958708,1980922,+,22214
116,BUMA.1121.00082,2,3009982,3032185,+,22203
117,BUMA.1121.00049,2,1635755,1659558,+,23803
117,BUMA.1121.00055,2,2807252,2830953,-,23701
117,BUMA.1121.00011,2,1620733,1644456,+,23723
117,BUMA.1121.00110,2,2981524,3005067,+,23543
117,BUMA.1121.00109,2,1613493,1637215,-,23722
117,BUMA.1121.00077,2,610795,634337,-,23542
117,BUMA.1121.00027,2,911282,934949,+,23667
117,BUMA.1121.00021,2,313616,337312,+,23696
117,BUMA.1121.00023,2,3148982,3172736,+,23754
117,BUMA.1121.00022,2,1402320,1425879,+,23559
117,BUMA.1121.00034,2,1981255,2004806,+,23551
117,BUMA.1121.00025,2,1474686,1498119,+,23433
117,BUMA.1121.00031,2,2189514,2213207,+,23693
117,BUMA.1121.00007,2,3100731,3124416,+,23685
117,BUMA.1121.00097,2,2853500,2877229,+,23729
117,BUMA.1121.00008,2,1965493,1989044,+,23551
117,BUMA.1121.00059,2,599076,622797,-,23721
117,BUMA.1121.00002,2,692095,715653,-,23558
117,BUMA.1121.00004,2,1965935,1989486,+,23551
117,BUMA.1121.00005,2,885655,909319,-,23664
117,BUMA.1121.00111,2,2290444,2314179,+,23735
117,BUMA.1121.00006,2,118687,142229,-,23542
117,BUMA.1121.00009,2,1656052,1679735,+,23683
117,BUMA.1121.00094,2,3013166,3036769,+,23603
117,BUMA.1121.00101,2,387007,410696,-,23689
117,BUMA.1121.00066,2,2963252,2986966,+,23714
117,BUMA.1121.00095,2,1875869,1899402,+,23533
117,BUMA.1121.00112,2,1323347,1347209,-,23862
117,BUMA.1121.00042,2,1480372,1503929,+,23557
117,BUMA.1121.00032,2,406316,429867,+,23551
117,BUMA.1121.00090,2,751745,775510,+,23765
117,BUMA.1121.00020,2,1966215,1989766,+,23551
117,BUMA.1121.00089,2,2959122,2984034,+,24912
117,BUMA.1121.00051,2,2973794,2998777,+,24983
117,BUMA.1121.00001,2,2388787,2412523,-,23736
117,BUMA.1121.00045,2,2903082,2926638,+,23556
117,BUMA.1121.00043,2,2575178,2598934,-,23756
117,BUMA.1121.00063,2,2973090,2996811,+,23721
117,BUMA.1121.00079,2,2970610,2995568,+,24958
117,BUMA.1121.00071,2,2979031,3002742,+,23711
117,BUMA.1121.00086,2,2210151,2233710,+,23559
117,BUMA.1121.00024,2,2101138,2124689,+,23551
117,BUMA.1121.00010,2,1543758,1567316,-,23558
117,BUMA.1121.00040,2,2047666,2071249,+,23583
117,BUMA.1121.00093,2,3061352,3085170,-,23818
117,BUMA.1121.00091,2,598263,621889,-,23626
117,BUMA.1121.00107,2,774178,797569,-,23391
117,BUMA.1121.00088,2,2993298,3017024,+,23726
117,BUMA.1121.00047,2,787235,812097,+,24862
117,BUMA.1121.00019,2,2045360,2068911,+,23551
117,BUMA.1121.00087,2,722107,745665,-,23558
117,BUMA.1121.00039,2,935627,959165,-,23538
117,BUMA.1121.00030,2,117199,140749,-,23550
117,BUMA.1121.00016,2,730812,754555,-,23743
117,BUMA.1121.00092,2,2998252,3022071,+,23819
117,BUMA.1121.00085,2,1022829,1046388,+,23559
117,BUMA.1121.00046,2,873957,897540,+,23583
117,BUMA.1121.00003,2,1185802,1209367,+,23565
117,BUMA.1121.00054,2,2244134,2267676,-,23542
117,BUMA.1121.00015,2,111172,134747,+,23575
117,BUMA.1121.00105,2,2632047,2655738,-,23691
117,BUMA.1121.00052,2,1711358,1734864,+,23506
117,BUMA.1121.00053,2,83113,106669,+,23556
117,BUMA.1121.00057,2,2215479,2239257,-,23778
117,BUMA.1121.00108,2,52055,75591,+,23536
117,BUMA.1121.00050,2,216110,239692,-,23582
117,BUMA.1121.00104,2,3079465,3103260,+,23795
117,BUMA.1121.00014,2,3128335,3151878,+,23543
117,BUMA.1121.00036,2,1714978,1738536,-,23558
117,BUMA.1121.00038,2,118705,142247,-,23542
117,BUMA.1121.00098,2,67494,91233,+,23739
117,BUMA.1121.00078,2,95122,118720,-,23598
117,BUMA.1121.00029,2,1502183,1525919,-,23736
117,BUMA.1121.00099,2,1,23576,+,23575
117,BUMA.1121.00103,2,1682962,1706670,+,23708
117,BUMA.1121.00102,2,3051416,3075240,+,23824
117,BUMA.1121.00028,2,2007379,2030930,+,23551
117,BUMA.1121.00075,2,2980712,3004472,-,23760
117,BUMA.1121.00044,2,2032152,2055703,+,23551
117,BUMA.1121.00076,2,740756,764518,+,23762
117,BUMA.1121.00074,2,1368489,1392308,-,23819
117,BUMA.1121.00073,2,2979799,3003514,+,23715
117,BUMA.1121.00083,2,1656434,1680155,+,23721
117,BUMA.1121.00035,2,1584271,1607984,-,23713
117,BUMA.1121.00072,2,2957477,2981188,+,23711
117,BUMA.1121.00056,2,1007716,1032627,-,24911
117,BUMA.1121.00081,2,2181339,2204882,+,23543
117,BUMA.1121.00033,2,513096,536808,+,23712
117,BUMA.1121.00061,2,2962262,2985983,+,23721
117,BUMA.1121.00062,2,1895760,1919578,-,23818
117,BUMA.1121.00064,2,2897808,2921595,+,23787
117,BUMA.1121.00060,2,2338438,2361993,-,23555
117,BUMA.1121.00069,2,2929365,2953082,+,23717
117,BUMA.1121.00070,2,2959087,2982805,+,23718
117,BUMA.1121.00068,2,1590252,1613921,+,23669
117,BUMA.1121.00067,2,926689,950531,-,23842
117,BUMA.1121.00037,2,105158,128706,+,23548
117,BUMA.1121.00065,2,3085595,3109245,+,23650
117,BUMA.1121.00058,2,372502,396056,+,23554
117,BUMA.1121.00041,2,735969,759648,+,23679
117,BUMA.1121.00084,2,1697616,1721388,+,23772
117,BUMA.1121.00096,2,3333328,3356868,+,23540
117,BUMA.1121.00080,2,3030426,3055418,+,24992
117,BUMA.1121.00013,2,289278,312837,+,23559
117,BUMA.1121.00100,2,1021505,1045222,+,23717
117,BUMA.1121.00012,2,1955754,1979563,-,23809
117,BUMA.1121.00018,2,834805,858237,-,23432
117,BUMA.1121.00048,2,595394,618937,+,23543
117,BUMA.1121.00106,2,2271728,2295405,+,23677
117,BUMA.1121.00017,2,1981251,2004802,+,23551
117,BUMA.1121.00082,2,3032518,3056239,+,23721
118,BUMA.1121.00049,2,1659559,1664569,+,5010
118,BUMA.1121.00055,2,2802217,2807250,-,5033
118,BUMA.1121.00011,2,1644457,1649490,+,5033
118,BUMA.1121.00110,2,3005068,3010084,+,5016
118,BUMA.1121.00109,2,1608481,1613491,-,5010
118,BUMA.1121.00077,2,605779,610793,-,5014
118,BUMA.1121.00027,2,934950,939984,+,5034
118,BUMA.1121.00021,2,337313,342323,+,5010
118,BUMA.1121.00023,2,3172737,3177747,+,5010
118,BUMA.1121.00022,2,1425880,1430930,+,5050
118,BUMA.1121.00034,2,2004807,2009857,+,5050
118,BUMA.1121.00025,2,1498120,1503130,+,5010
118,BUMA.1121.00031,2,2213208,2218219,+,5011
118,BUMA.1121.00007,2,3124417,3129462,+,5045
118,BUMA.1121.00097,2,2877230,2882240,+,5010
118,BUMA.1121.00008,2,1989045,1994095,+,5050
118,BUMA.1121.00059,2,594031,599074,-,5043
118,BUMA.1121.00002,2,687043,692093,-,5050
118,BUMA.1121.00004,2,1989487,1994537,+,5050
118,BUMA.1121.00005,2,880643,885653,-,5010
118,BUMA.1121.00111,2,2314180,2319190,+,5010
118,BUMA.1121.00006,2,113635,118685,-,5050
118,BUMA.1121.00009,2,1679736,1684780,+,5044
118,BUMA.1121.00094,2,3036770,3041827,+,5057
118,BUMA.1121.00101,2,381988,387005,-,5017
118,BUMA.1121.00066,2,2986967,2991987,+,5020
118,BUMA.1121.00095,2,1899403,1904412,+,5009
118,BUMA.1121.00112,2,1318336,1323345,-,5009
118,BUMA.1121.00042,2,1503930,1508980,+,5050
118,BUMA.1121.00032,2,429868,434918,+,5050
118,BUMA.1121.00090,2,775511,780521,+,5010
118,BUMA.1121.00020,2,1989767,1994817,+,5050
118,BUMA.1121.00089,2,2984035,2989078,+,5043
118,BUMA.1121.00051,2,2998778,3003821,+,5043
118,BUMA.1121.00001,2,2383775,2388785,-,5010
118,BUMA.1121.00045,2,2926639,2931696,+,5057
118,BUMA.1121.00043,2,2570166,2575176,-,5010
118,BUMA.1121.00063,2,2996812,3001835,+,5023
118,BUMA.1121.00079,2,2995569,3000613,+,5044
118,BUMA.1121.00071,2,3002743,3007769,+,5026
118,BUMA.1121.00086,2,2233711,2238761,+,5050
118,BUMA.1121.00024,2,2124690,2129740,+,5050
118,BUMA.1121.00010,2,1538706,1543756,-,5050
118,BUMA.1121.00040,2,2071250,2076300,+,5050
118,BUMA.1121.00093,2,3056334,3061350,-,5016
118,BUMA.1121.00091,2,593217,598261,-,5044
118,BUMA.1121.00107,2,769141,774176,-,5035
118,BUMA.1121.00088,2,3017025,3022036,+,5011
118,BUMA.1121.00047,2,812098,817137,+,5039
118,BUMA.1121.00019,2,2068912,2073962,+,5050
118,BUMA.1121.00087,2,717055,722105,-,5050
118,BUMA.1121.00039,2,930615,935625,-,5010
118,BUMA.1121.00030,2,112147,117197,-,5050
118,BUMA.1121.00016,2,725800,730810,-,5010
118,BUMA.1121.00092,2,3022072,3027088,+,5016
118,BUMA.1121.00085,2,1046389,1051439,+,5050
118,BUMA.1121.00046,2,897541,902591,+,5050
118,BUMA.1121.00003,2,1209368,1214411,+,5043
118,BUMA.1121.00054,2,2239082,2244132,-,5050
118,BUMA.1121.00015,2,134748,139798,+,5050
118,BUMA.1121.00105,2,2626996,2632045,-,5049
118,BUMA.1121.00052,2,39,5104,+,5065
118,BUMA.1121.00053,2,106670,111704,+,5034
118,BUMA.1121.00057,2,2210443,2215477,-,5034
118,BUMA.1121.00108,2,75592,80636,+,5044
118,BUMA.1121.00050,2,211058,216108,-,5050
118,BUMA.1121.00104,2,3103261,3108271,+,5010
118,BUMA.1121.00014,2,3151879,3156890,+,5011
118,BUMA.1121.00036,2,1709926,1714976,-,5050
118,BUMA.1121.00038,2,113653,118703,-,5050
118,BUMA.1121.00098,2,91234,96268,+,5034
118,BUMA.1121.00078,2,90071,95120,-,5049
118,BUMA.1121.00029,2,1497171,1502181,-,5010
118,BUMA.1121.00099,2,23577,28621,+,5044
118,BUMA.1121.00103,2,1706671,1711682,+,5011
118,BUMA.1121.00102,2,3075241,3080286,+,5045
118,BUMA.1121.00028,2,2030931,2035981,+,5050
118,BUMA.1121.00075,2,2975694,2980710,-,5016
118,BUMA.1121.00044,2,2055704,2060754,+,5050
118,BUMA.1121.00076,2,764519,769536,+,5017
118,BUMA.1121.00074,2,1363476,1368487,-,5011
118,BUMA.1121.00073,2,3003515,3008539,+,5024
118,BUMA.1121.00083,2,1680156,1685189,+,5033
118,BUMA.1121.00035,2,1579259,1584269,-,5010
118,BUMA.1121.00072,2,2981189,2986209,+,5020
118,BUMA.1121.00056,2,1002671,1007714,-,5043
118,BUMA.1121.00081,2,2204883,2209933,+,5050
118,BUMA.1121.00033,2,536809,541819,+,5010
118,BUMA.1121.00061,2,2985984,2991005,+,5021
118,BUMA.1121.00062,2,1890748,1895758,-,5010
118,BUMA.1121.00064,2,2921596,2926607,+,5011
118,BUMA.1121.00060,2,2333379,2338436,-,5057
118,BUMA.1121.00069,2,2953083,2958103,+,5020
118,BUMA.1121.00070,2,2982806,2987826,+,5020
118,BUMA.1121.00068,2,1613922,1618968,+,5046
118,BUMA.1121.00067,2,921676,926687,-,5011
118,BUMA.1121.00037,2,128707,133717,+,5010
118,BUMA.1121.00065,2,3109246,3114256,+,5010
118,BUMA.1121.00058,2,396057,401100,+,5043
118,BUMA.1121.00041,2,759649,764665,+,5016
118,BUMA.1121.00084,2,1721389,1726399,+,5010
118,BUMA.1121.00096,2,3356869,3361895,+,5026
118,BUMA.1121.00080,2,3055419,3060462,+,5043
118,BUMA.1121.00013,2,312838,317888,+,5050
118,BUMA.1121.00100,2,1045223,1050270,+,5047
118,BUMA.1121.00012,2,1950742,1955752,-,5010
118,BUMA.1121.00018,2,829793,834803,-,5010
118,BUMA.1121.00048,2,618938,623988,+,5050
118,BUMA.1121.00106,2,2295406,2300416,+,5010
118,BUMA.1121.00017,2,2004803,2009853,+,5050
118,BUMA.1121.00082,2,3056240,3061273,+,5033
119,BUMA.1121.00049,2,1664571,1672832,+,8261
119,BUMA.1121.00055,2,2793962,2802216,-,8254
119,BUMA.1121.00011,2,1649492,1657835,+,8343
119,BUMA.1121.00110,2,3010086,3018353,+,8267
119,BUMA.1121.00109,2,1600199,1608480,-,8281
119,BUMA.1121.00077,2,597507,605778,-,8271
119,BUMA.1121.00027,2,939986,948239,+,8253
119,BUMA.1121.00021,2,342325,350617,+,8292
119,BUMA.1121.00023,2,3177749,3186071,+,8322
119,BUMA.1121.00022,2,1430932,1439217,+,8285
119,BUMA.1121.00034,2,2009859,2018214,+,8355
119,BUMA.1121.00025,2,1503132,1511456,+,8324
119,BUMA.1121.00031,2,2218221,2226510,+,8289
119,BUMA.1121.00007,2,3129464,3137792,+,8328
119,BUMA.1121.00097,2,2882242,2890512,+,8270
119,BUMA.1121.00008,2,1994097,2002452,+,8355
119,BUMA.1121.00059,2,585778,594030,-,8252
119,BUMA.1121.00002,2,678722,687042,-,8320
119,BUMA.1121.00004,2,1994539,2002894,+,8355
119,BUMA.1121.00005,2,872367,880642,-,8275
119,BUMA.1121.00111,2,2319192,2327490,+,8298
119,BUMA.1121.00006,2,105324,113634,-,8310
119,BUMA.1121.00009,2,1684782,1693099,+,8317
119,BUMA.1121.00094,2,3041829,3050109,+,8280
119,BUMA.1121.00101,2,373705,381987,-,8282
119,BUMA.1121.00066,2,2991989,3000240,+,8251
119,BUMA.1121.00095,2,1904414,1912673,+,8259
119,BUMA.1121.00112,2,1310015,1318335,-,8320
119,BUMA.1121.00042,2,1508982,1517302,+,8320
119,BUMA.1121.00032,2,434920,443275,+,8355
119,BUMA.1121.00090,2,780523,788818,+,8295
119,BUMA.1121.00020,2,1994819,2003174,+,8355
119,BUMA.1121.00089,2,2989080,2997323,+,8243
119,BUMA.1121.00051,2,3003823,3012066,+,8243
119,BUMA.1121.00001,2,2375469,2383774,-,8305
119,BUMA.1121.00045,2,2931698,2939984,+,8286
119,BUMA.1121.00043,2,2561887,2570165,-,8278
119,BUMA.1121.00063,2,3001837,3010073,+,8236
119,BUMA.1121.00079,2,3000615,3008857,+,8242
119,BUMA.1121.00071,2,3007771,3016009,+,8238
119,BUMA.1121.00086,2,2238763,2247084,+,8321
119,BUMA.1121.00024,2,2129742,2138097,+,8355
119,BUMA.1121.00010,2,1530385,1538705,-,8320
119,BUMA.1121.00040,2,2076302,2084631,+,8329
119,BUMA.1121.00093,2,3048087,3056333,-,8246
119,BUMA.1121.00091,2,584952,593216,-,8264
119,BUMA.1121.00107,2,760906,769140,-,8234
119,BUMA.1121.00088,2,3022038,3030286,+,8248
119,BUMA.1121.00047,2,817139,825394,+,8255
119,BUMA.1121.00019,2,2073964,2082319,+,8355
119,BUMA.1121.00087,2,708732,717054,-,8322
119,BUMA.1121.00039,2,922326,930614,-,8288
119,BUMA.1121.00030,2,103790,112146,-,8356
119,BUMA.1121.00016,2,717514,725799,-,8285
119,BUMA.1121.00092,2,3027090,3035335,+,8245
119,BUMA.1121.00085,2,1051441,1059770,+,8329
119,BUMA.1121.00046,2,902593,910922,+,8329
119,BUMA.1121.00003,2,1214413,1222730,+,8317
119,BUMA.1121.00054,2,2230771,2239081,-,8310
119,BUMA.1121.00015,2,139800,148129,+,8329
119,BUMA.1121.00105,2,2618692,2626995,-,8303
119,BUMA.1121.00052,2,5106,13435,+,8329
119,BUMA.1121.00053,2,111706,119955,+,8249
119,BUMA.1121.00057,2,2202189,2210442,-,8253
119,BUMA.1121.00108,2,80638,88908,+,8270
119,BUMA.1121.00050,2,202727,211057,-,8330
119,BUMA.1121.00104,2,3108273,3116534,+,8261
119,BUMA.1121.00014,2,3156892,3165181,+,8289
119,BUMA.1121.00036,2,1701608,1709925,-,8317
119,BUMA.1121.00038,2,105342,113652,-,8310
119,BUMA.1121.00098,2,96270,104575,+,8305
119,BUMA.1121.00078,2,81788,90070,-,8282
119,BUMA.1121.00029,2,1488875,1497170,-,8295
119,BUMA.1121.00099,2,28623,36923,+,8300
119,BUMA.1121.00103,2,1711684,1719933,+,8249
119,BUMA.1121.00102,2,3080288,3088592,+,8304
119,BUMA.1121.00028,2,2035983,2044338,+,8355
119,BUMA.1121.00075,2,2967352,2975693,-,8341
119,BUMA.1121.00044,2,2060756,2069111,+,8355
119,BUMA.1121.00076,2,769538,777878,+,8340
119,BUMA.1121.00074,2,1355232,1363475,-,8243
119,BUMA.1121.00073,2,3008541,3016762,+,8221
119,BUMA.1121.00083,2,1685191,1693443,+,8252
119,BUMA.1121.00035,2,1570963,1579258,-,8295
119,BUMA.1121.00072,2,2986211,2994449,+,8238
119,BUMA.1121.00056,2,994426,1002670,-,8244
119,BUMA.1121.00081,2,2209935,2218244,+,8309
119,BUMA.1121.00033,2,541821,550085,+,8264
119,BUMA.1121.00061,2,2991007,2999258,+,8251
119,BUMA.1121.00062,2,1882461,1890747,-,8286
119,BUMA.1121.00064,2,2926609,2934842,+,8233
119,BUMA.1121.00060,2,2325091,2333378,-,8287
119,BUMA.1121.00069,2,2958105,2966341,+,8236
119,BUMA.1121.00070,2,2987828,2996049,+,8221
119,BUMA.1121.00068,2,1618970,1627257,+,8287
119,BUMA.1121.00067,2,913427,921675,-,8248
119,BUMA.1121.00037,2,133719,142047,+,8328
119,BUMA.1121.00065,2,3114258,3122525,+,8267
119,BUMA.1121.00058,2,401102,409402,+,8300
119,BUMA.1121.00041,2,764667,772892,+,8225
119,BUMA.1121.00084,2,1726401,1734650,+,8249
119,BUMA.1121.00096,2,1,8222,+,8221
119,BUMA.1121.00080,2,3060464,3068707,+,8243
119,BUMA.1121.00013,2,317890,326214,+,8324
119,BUMA.1121.00100,2,1050272,1058537,+,8265
119,BUMA.1121.00012,2,1942454,1950741,-,8287
119,BUMA.1121.00018,2,821462,829792,-,8330
119,BUMA.1121.00048,2,623990,632299,+,8309
119,BUMA.1121.00106,2,2300418,2308655,+,8237
119,BUMA.1121.00017,2,2009855,2018210,+,8355
119,BUMA.1121.00082,2,3061275,3069527,+,8252
120,BUMA.1121.00049,2,1675447,1681462,+,6015
120,BUMA.1121.00055,2,2785292,2791312,-,6020
120,BUMA.1121.00011,2,1660436,1666486,+,6050
120,BUMA.1121.00110,2,3020977,3026942,+,5965
120,BUMA.1121.00109,2,1591651,1597606,-,5955
120,BUMA.1121.00077,2,588919,594884,-,5965
120,BUMA.1121.00027,2,950897,956937,+,6040
120,BUMA.1121.00021,2,353283,359225,+,5942
120,BUMA.1121.00023,2,3188738,3194753,+,6015
120,BUMA.1121.00022,2,1441827,1447735,+,5908
120,BUMA.1121.00034,2,2020819,2026727,+,5908
120,BUMA.1121.00025,2,1514068,1520078,+,6010
120,BUMA.1121.00031,2,2229170,2235200,+,6030
120,BUMA.1121.00007,2,3140452,3146435,+,5983
120,BUMA.1121.00097,2,2893134,2899105,+,5971
120,BUMA.1121.00008,2,2005057,2010965,+,5908
120,BUMA.1121.00059,2,577160,583133,-,5973
120,BUMA.1121.00002,2,670211,676119,-,5908
120,BUMA.1121.00004,2,2005499,2011407,+,5908
120,BUMA.1121.00005,2,863794,869759,-,5965
120,BUMA.1121.00111,2,2330176,2336171,+,5995
120,BUMA.1121.00006,2,96808,102716,-,5908
120,BUMA.1121.00009,2,1695749,1701729,+,5980
120,BUMA.1121.00094,2,3052716,3058684,+,5968
120,BUMA.1121.00101,2,365245,371231,-,5986
120,BUMA.1121.00066,2,3002855,3008848,+,5993
120,BUMA.1121.00095,2,1915297,1921241,+,5944
120,BUMA.1121.00112,2,1301404,1307361,-,5957
120,BUMA.1121.00042,2,1519906,1525814,+,5908
120,BUMA.1121.00032,2,445880,451788,+,5908
120,BUMA.1121.00090,2,791479,797472,+,5993
120,BUMA.1121.00020,2,2005779,2011687,+,5908
120,BUMA.1121.00089,2,2999930,3005892,+,5962
120,BUMA.1121.00051,2,3014661,3020618,+,5957
120,BUMA.1121.00001,2,2366831,2372820,-,5989
120,BUMA.1121.00045,2,2942637,2948627,+,5990
120,BUMA.1121.00043,2,2553250,2559245,-,5995
120,BUMA.1121.00063,2,3012688,3018681,+,5993
120,BUMA.1121.00079,2,3011464,3017426,+,5962
120,BUMA.1121.00071,2,3018624,3024617,+,5993
120,BUMA.1121.00086,2,2249688,2255596,+,5908
120,BUMA.1121.00024,2,2140702,2146610,+,5908
120,BUMA.1121.00010,2,1521874,1527782,-,5908
120,BUMA.1121.00040,2,2087235,2093143,+,5908
120,BUMA.1121.00093,2,3039492,3045485,-,5993
120,BUMA.1121.00091,2,576349,582346,-,5997
120,BUMA.1121.00107,2,752290,758280,-,5990
120,BUMA.1121.00088,2,3032901,3038875,+,5974
120,BUMA.1121.00047,2,828001,833996,+,5995
120,BUMA.1121.00019,2,2084924,2090832,+,5908
120,BUMA.1121.00087,2,700221,706129,-,5908
120,BUMA.1121.00039,2,913697,919664,-,5967
120,BUMA.1121.00030,2,95278,101186,-,5908
120,BUMA.1121.00016,2,708839,714864,-,6025
120,BUMA.1121.00092,2,3037944,3043937,+,5993
120,BUMA.1121.00085,2,1062380,1068288,+,5908
120,BUMA.1121.00046,2,913532,919440,+,5908
120,BUMA.1121.00003,2,1225285,1231226,+,5941
120,BUMA.1121.00054,2,2222255,2228163,-,5908
120,BUMA.1121.00015,2,150744,156652,+,5908
120,BUMA.1121.00105,2,2610092,2616078,-,5986
120,BUMA.1121.00052,2,16045,21953,+,5908
120,BUMA.1121.00053,2,122578,128571,+,5993
120,BUMA.1121.00057,2,2193605,2199583,-,5978
120,BUMA.1121.00108,2,91559,97471,+,5912
120,BUMA.1121.00050,2,194210,200118,-,5908
120,BUMA.1121.00104,2,3119149,3125166,+,6017
120,BUMA.1121.00014,2,3167847,3173842,+,5995
120,BUMA.1121.00036,2,1693097,1699005,-,5908
120,BUMA.1121.00038,2,96826,102734,-,5908
120,BUMA.1121.00098,2,107187,114485,+,7298
120,BUMA.1121.00078,2,73210,79180,-,5970
120,BUMA.1121.00029,2,1480242,1486216,-,5974
120,BUMA.1121.00099,2,39598,45572,+,5974
120,BUMA.1121.00103,2,1722576,1728567,+,5991
120,BUMA.1121.00102,2,3091247,3097220,+,5973
120,BUMA.1121.00028,2,2046943,2052851,+,5908
120,BUMA.1121.00075,2,2958728,2964746,-,6018
120,BUMA.1121.00044,2,2071716,2077624,+,5908
120,BUMA.1121.00076,2,780485,786504,+,6019
120,BUMA.1121.00074,2,1346586,1352581,-,5995
120,BUMA.1121.00073,2,3019377,3025370,+,5993
120,BUMA.1121.00083,2,1696058,1702051,+,5993
120,BUMA.1121.00035,2,1562345,1568314,-,5969
120,BUMA.1121.00072,2,2997010,3002987,+,5977
120,BUMA.1121.00056,2,985858,991820,-,5962
120,BUMA.1121.00081,2,2220853,2226761,+,5908
120,BUMA.1121.00033,2,552735,558744,+,6009
120,BUMA.1121.00061,2,3001873,3007859,+,5986
120,BUMA.1121.00062,2,1873854,1879847,-,5993
120,BUMA.1121.00064,2,2937494,2943499,+,6005
120,BUMA.1121.00060,2,2316449,2322439,-,5990
120,BUMA.1121.00069,2,2968956,2974948,+,5992
120,BUMA.1121.00070,2,2998664,3004656,+,5992
120,BUMA.1121.00068,2,1629869,1635790,+,5921
120,BUMA.1121.00067,2,904781,910776,-,5995
120,BUMA.1121.00037,2,144702,150697,+,5995
120,BUMA.1121.00065,2,3125134,3131112,+,5978
120,BUMA.1121.00058,2,412015,418028,+,6013
120,BUMA.1121.00041,2,775457,781441,+,5984
120,BUMA.1121.00084,2,1737251,1743241,+,5990
120,BUMA.1121.00096,2,10853,16789,+,5936
120,BUMA.1121.00080,2,3071314,3077281,+,5967
120,BUMA.1121.00013,2,328824,334732,+,5908
120,BUMA.1121.00100,2,1061146,1067132,+,5986
120,BUMA.1121.00012,2,1933764,1939774,-,6010
120,BUMA.1121.00018,2,812841,818851,-,6010
120,BUMA.1121.00048,2,634908,640816,+,5908
120,BUMA.1121.00106,2,2311262,2317274,+,6012
120,BUMA.1121.00017,2,2020815,2026723,+,5908
120,BUMA.1121.00082,2,3072142,3078135,+,5993
121,BUMA.1121.00049,2,1694866,1699163,+,4297
121,BUMA.1121.00055,2,2767486,2771836,-,4350
121,BUMA.1121.00011,2,1679870,1684207,+,4337
121,BUMA.1121.00110,2,3041619,3045939,+,4320
121,BUMA.1121.00109,2,1573947,1578259,-,4312
121,BUMA.1121.00077,2,569920,574239,-,4319
121,BUMA.1121.00027,2,970329,974646,+,4317
121,BUMA.1121.00021,2,372680,377006,+,4326
121,BUMA.1121.00023,2,3208171,3212499,+,4328
121,BUMA.1121.00022,2,1460507,1464849,+,4342
121,BUMA.1121.00034,2,2039499,2043841,+,4342
121,BUMA.1121.00025,2,1533493,1537819,+,4326
121,BUMA.1121.00031,2,2248608,2252936,+,4328
121,BUMA.1121.00007,2,3159816,3164121,+,4305
121,BUMA.1121.00097,2,2912556,2916909,+,4353
121,BUMA.1121.00008,2,2023737,2028079,+,4342
121,BUMA.1121.00059,2,559411,563740,-,4329
121,BUMA.1121.00002,2,653110,657453,-,4343
121,BUMA.1121.00004,2,2024179,2028521,+,4342
121,BUMA.1121.00005,2,844763,849061,-,4298
121,BUMA.1121.00111,2,2349596,2353921,+,4325
121,BUMA.1121.00006,2,79699,84042,-,4343
121,BUMA.1121.00009,2,1715108,1719419,+,4311
121,BUMA.1121.00094,2,3072082,3076393,+,4311
121,BUMA.1121.00101,2,347531,351842,-,4311
121,BUMA.1121.00066,2,3022280,3026608,+,4328
121,BUMA.1121.00095,2,1934672,1938981,+,4309
121,BUMA.1121.00112,2,1283722,1288034,-,4312
121,BUMA.1121.00042,2,1538586,1542933,+,4347
121,BUMA.1121.00032,2,464560,468902,+,4342
121,BUMA.1121.00090,2,810910,815238,+,4328
121,BUMA.1121.00020,2,2024459,2028801,+,4342
121,BUMA.1121.00089,2,3019290,3023601,+,4311
121,BUMA.1121.00051,2,3034015,3038326,+,4311
121,BUMA.1121.00001,2,2349076,2353405,-,4329
121,BUMA.1121.00045,2,2962035,2966376,+,4341
121,BUMA.1121.00043,2,2535483,2539810,-,4327
121,BUMA.1121.00063,2,3032127,3036445,+,4318
121,BUMA.1121.00079,2,3030821,3035132,+,4311
121,BUMA.1121.00071,2,3038053,3042364,+,4311
121,BUMA.1121.00086,2,2268368,2272710,+,4342
121,BUMA.1121.00024,2,2159382,2163724,+,4342
121,BUMA.1121.00010,2,1504773,1509116,-,4343
121,BUMA.1121.00040,2,2105915,2110257,+,4342
121,BUMA.1121.00093,2,3021743,3026072,-,4329
121,BUMA.1121.00091,2,558652,562950,-,4298
121,BUMA.1121.00107,2,734579,738884,-,4305
121,BUMA.1121.00088,2,3052271,3056559,+,4288
121,BUMA.1121.00047,2,847382,851679,+,4297
121,BUMA.1121.00019,2,2103604,2107946,+,4342
121,BUMA.1121.00087,2,683106,687449,-,4343
121,BUMA.1121.00039,2,895927,900256,-,4329
121,BUMA.1121.00030,2,78163,82506,-,4343
121,BUMA.1121.00016,2,691101,695413,-,4312
121,BUMA.1121.00092,2,3057359,3061685,+,4326
121,BUMA.1121.00085,2,1081055,1085395,+,4340
121,BUMA.1121.00046,2,932207,936547,+,4340
121,BUMA.1121.00003,2,1231517,1235815,+,4298
121,BUMA.1121.00054,2,2205146,2209489,-,4343
121,BUMA.1121.00015,2,169419,173752,+,4333
121,BUMA.1121.00105,2,2592372,2596701,-,4329
121,BUMA.1121.00052,2,34720,39060,+,4340
121,BUMA.1121.00053,2,141992,146328,+,4336
121,BUMA.1121.00057,2,2175842,2180175,-,4333
121,BUMA.1121.00108,2,110864,115180,+,4316
121,BUMA.1121.00050,2,177102,181445,-,4343
121,BUMA.1121.00104,2,3138571,3142868,+,4297
121,BUMA.1121.00014,2,3188564,3192891,+,4327
121,BUMA.1121.00036,2,1675989,1680332,-,4343
121,BUMA.1121.00038,2,79717,84060,-,4343
121,BUMA.1121.00098,2,127890,132209,+,4319
121,BUMA.1121.00078,2,55494,59827,-,4333
121,BUMA.1121.00029,2,1462494,1466823,-,4329
121,BUMA.1121.00099,2,60308,64627,+,4319
121,BUMA.1121.00103,2,1741992,1746348,+,4356
121,BUMA.1121.00102,2,3110628,3114956,+,4328
121,BUMA.1121.00028,2,2065623,2069965,+,4342
121,BUMA.1121.00075,2,2940951,2945270,-,4319
121,BUMA.1121.00044,2,2090396,2094738,+,4342
121,BUMA.1121.00076,2,799975,804293,+,4318
121,BUMA.1121.00074,2,1328858,1333156,-,4298
121,BUMA.1121.00073,2,3038806,3043117,+,4311
121,BUMA.1121.00083,2,1715493,1719815,+,4322
121,BUMA.1121.00035,2,1544582,1548911,-,4329
121,BUMA.1121.00072,2,3016423,3020751,+,4328
121,BUMA.1121.00056,2,968148,972460,-,4312
121,BUMA.1121.00081,2,2239529,2243869,+,4340
121,BUMA.1121.00033,2,572137,576463,+,4326
121,BUMA.1121.00061,2,3021291,3025619,+,4328
121,BUMA.1121.00062,2,1856091,1860420,-,4329
121,BUMA.1121.00064,2,2956904,2961201,+,4297
121,BUMA.1121.00060,2,2298699,2303041,-,4342
121,BUMA.1121.00069,2,2988377,2992703,+,4326
121,BUMA.1121.00070,2,3018065,3022376,+,4311
121,BUMA.1121.00068,2,1636074,1640365,+,4291
121,BUMA.1121.00067,2,887053,891351,-,4298
121,BUMA.1121.00037,2,164124,168450,+,4326
121,BUMA.1121.00065,2,3144489,3148787,+,4298
121,BUMA.1121.00058,2,431444,435741,+,4297
121,BUMA.1121.00041,2,794862,799181,+,4319
121,BUMA.1121.00084,2,1756639,1760936,+,4297
121,BUMA.1121.00096,2,30244,34554,+,4310
121,BUMA.1121.00080,2,3090678,3094988,+,4310
121,BUMA.1121.00013,2,347499,351839,+,4340
121,BUMA.1121.00100,2,1080533,1084829,+,4296
121,BUMA.1121.00012,2,1916003,1920330,-,4327
121,BUMA.1121.00018,2,795072,799400,-,4328
121,BUMA.1121.00048,2,653584,657924,+,4340
121,BUMA.1121.00106,2,2330681,2334969,+,4288
121,BUMA.1121.00017,2,2039495,2043837,+,4342
121,BUMA.1121.00082,2,3091577,3095899,+,4322
122,BUMA.1121.00049,2,1702774,1709767,+,6993
122,BUMA.1121.00055,2,2756504,2763695,-,7191
122,BUMA.1121.00011,2,1687877,1694964,+,7087
122,BUMA.1121.00110,2,3049711,3056720,+,7009
122,BUMA.1121.00109,2,1563115,1570080,-,6965
122,BUMA.1121.00077,2,559051,566058,-,7007
122,BUMA.1121.00027,2,978271,985261,+,6990
122,BUMA.1121.00021,2,380574,387712,+,7138
122,BUMA.1121.00023,2,3216101,3223226,+,7125
122,BUMA.1121.00022,2,1468488,1475696,+,7208
122,BUMA.1121.00034,2,2047516,2054708,+,7192
122,BUMA.1121.00025,2,1541401,1548587,+,7186
122,BUMA.1121.00031,2,2256527,2263697,+,7170
122,BUMA.1121.00007,2,3167816,3174783,+,6967
122,BUMA.1121.00097,2,2920615,2927682,+,7067
122,BUMA.1121.00008,2,2031736,2038904,+,7168
122,BUMA.1121.00059,2,548465,555636,-,7171
122,BUMA.1121.00002,2,642446,649446,-,7000
122,BUMA.1121.00004,2,2032187,2039395,+,7208
122,BUMA.1121.00005,2,833941,841167,-,7226
122,BUMA.1121.00111,2,2357566,2364878,+,7312
122,BUMA.1121.00006,2,68818,76016,-,7198
122,BUMA.1121.00009,2,1723171,1730239,+,7068
122,BUMA.1121.00094,2,3079972,3087242,+,7270
122,BUMA.1121.00101,2,336857,343911,-,7054
122,BUMA.1121.00066,2,3030363,3037752,+,7389
122,BUMA.1121.00095,2,1942821,1950086,+,7265
122,BUMA.1121.00112,2,1273124,1280161,-,7037
122,BUMA.1121.00042,2,1546662,1553724,+,7062
122,BUMA.1121.00032,2,472559,479743,+,7184
122,BUMA.1121.00090,2,818860,826136,+,7276
122,BUMA.1121.00020,2,2032458,2039634,+,7176
122,BUMA.1121.00089,2,3027156,3034435,+,7279
122,BUMA.1121.00051,2,3041943,3049168,+,7225
122,BUMA.1121.00001,2,2338242,2345490,-,7248
122,BUMA.1121.00045,2,2969979,2976975,+,6996
122,BUMA.1121.00043,2,2524653,2531764,-,7111
122,BUMA.1121.00063,2,3040200,3047572,+,7372
122,BUMA.1121.00079,2,3038805,3045996,+,7191
122,BUMA.1121.00071,2,3046117,3053480,+,7363
122,BUMA.1121.00086,2,2276331,2283515,+,7184
122,BUMA.1121.00024,2,2167381,2174557,+,7176
122,BUMA.1121.00010,2,1494151,1501127,-,6976
122,BUMA.1121.00040,2,2113920,2121176,+,7256
122,BUMA.1121.00093,2,3010780,3018056,-,7276
122,BUMA.1121.00091,2,547797,554957,-,7160
122,BUMA.1121.00107,2,723747,730849,-,7102
122,BUMA.1121.00088,2,3060189,3067418,+,7229
122,BUMA.1121.00047,2,855382,862615,+,7233
122,BUMA.1121.00019,2,2111603,2118787,+,7184
122,BUMA.1121.00087,2,672326,679486,-,7160
122,BUMA.1121.00039,2,885001,892234,-,7233
122,BUMA.1121.00030,2,67315,74507,-,7192
122,BUMA.1121.00016,2,680403,687459,-,7056
122,BUMA.1121.00092,2,3065373,3072739,+,7366
122,BUMA.1121.00085,2,1089160,1096382,+,7222
122,BUMA.1121.00046,2,940245,947603,+,7358
122,BUMA.1121.00003,2,1239566,1246673,+,7107
122,BUMA.1121.00054,2,2194265,2201463,-,7198
122,BUMA.1121.00015,2,177507,184685,+,7178
122,BUMA.1121.00105,2,2581516,2588499,-,6983
122,BUMA.1121.00052,2,42825,50047,+,7222
122,BUMA.1121.00053,2,150069,157254,+,7185
122,BUMA.1121.00057,2,2164685,2172083,-,7398
122,BUMA.1121.00108,2,118861,125897,+,7036
122,BUMA.1121.00050,2,165999,173405,-,7406
122,BUMA.1121.00104,2,1,7226,+,7225
122,BUMA.1121.00014,2,3196502,3203670,+,7168
122,BUMA.1121.00036,2,1665059,1672315,-,7256
122,BUMA.1121.00038,2,68828,76034,-,7206
122,BUMA.1121.00098,2,136008,143111,+,7103
122,BUMA.1121.00078,2,44405,51641,-,7236
122,BUMA.1121.00029,2,1451658,1458934,-,7276
122,BUMA.1121.00099,2,69739,76826,+,7087
122,BUMA.1121.00103,2,1750044,1757240,+,7196
122,BUMA.1121.00102,2,3118687,3125864,+,7177
122,BUMA.1121.00028,2,2073622,2080814,+,7192
122,BUMA.1121.00075,2,2930007,2937263,-,7256
122,BUMA.1121.00044,2,2098404,2105596,+,7192
122,BUMA.1121.00076,2,807974,815295,+,7321
122,BUMA.1121.00074,2,1316730,1323927,-,7197
122,BUMA.1121.00073,2,3046872,3054110,+,7238
122,BUMA.1121.00083,2,1723570,1730943,+,7373
122,BUMA.1121.00035,2,1533855,1540993,-,7138
122,BUMA.1121.00072,2,3024506,3031887,+,7381
122,BUMA.1121.00056,2,957571,964594,-,7023
122,BUMA.1121.00081,2,2247553,2254751,+,7198
122,BUMA.1121.00033,2,580172,587519,+,7347
122,BUMA.1121.00061,2,3029374,3036763,+,7389
122,BUMA.1121.00062,2,1844723,1852163,-,7440
122,BUMA.1121.00064,2,2964793,2972072,+,7279
122,BUMA.1121.00060,2,2288149,2295113,-,6964
122,BUMA.1121.00069,2,2996458,3003644,+,7186
122,BUMA.1121.00070,2,3026131,3033494,+,7363
122,BUMA.1121.00068,2,1643896,1650967,+,7071
122,BUMA.1121.00067,2,874838,882067,-,7229
122,BUMA.1121.00037,2,172123,179312,+,7189
122,BUMA.1121.00065,2,3152516,3159697,+,7181
122,BUMA.1121.00058,2,439552,446709,+,7157
122,BUMA.1121.00041,2,802884,809894,+,7010
122,BUMA.1121.00084,2,1764542,1771805,+,7263
122,BUMA.1121.00096,2,38298,45475,+,7177
122,BUMA.1121.00080,2,3098678,3105909,+,7231
122,BUMA.1121.00013,2,355630,362766,+,7136
122,BUMA.1121.00100,2,1088537,1095742,+,7205
122,BUMA.1121.00012,2,1905014,1912218,-,7204
122,BUMA.1121.00018,2,784323,791509,-,7186
122,BUMA.1121.00048,2,661608,668814,+,7206
122,BUMA.1121.00106,2,2338640,2345907,+,7267
122,BUMA.1121.00017,2,2047511,2054703,+,7192
122,BUMA.1121.00082,2,3099654,3107043,+,7389
123,BUMA.1121.00049,2,1710857,1717127,+,6270
123,BUMA.1121.00055,2,2749183,2755414,-,6231
123,BUMA.1121.00011,2,1696055,1702316,+,6261
123,BUMA.1121.00110,2,3057810,3063923,+,6113
123,BUMA.1121.00109,2,1555901,1562024,-,6123
123,BUMA.1121.00077,2,551722,557961,-,6239
123,BUMA.1121.00027,2,986352,992575,+,6223
123,BUMA.1121.00021,2,388802,395081,+,6279
123,BUMA.1121.00023,2,3224316,3230485,+,6169
123,BUMA.1121.00022,2,1476786,1483027,+,6241
123,BUMA.1121.00034,2,2055798,2061859,+,6061
123,BUMA.1121.00025,2,1549677,1555936,+,6259
123,BUMA.1121.00031,2,2264787,2271056,+,6269
123,BUMA.1121.00007,2,3175874,3182045,+,6171
123,BUMA.1121.00097,2,2928777,2934918,+,6141
123,BUMA.1121.00008,2,2039994,2046055,+,6061
123,BUMA.1121.00059,2,541253,547374,-,6121
123,BUMA.1121.00002,2,635075,641356,-,6281
123,BUMA.1121.00004,2,2040485,2046556,+,6071
123,BUMA.1121.00005,2,826627,832850,-,6223
123,BUMA.1121.00111,2,2365968,2372236,+,6268
123,BUMA.1121.00006,2,61537,67728,-,6191
123,BUMA.1121.00009,2,1731330,1737453,+,6123
123,BUMA.1121.00094,2,3088332,3094583,+,6251
123,BUMA.1121.00101,2,329625,335766,-,6141
123,BUMA.1121.00066,2,3038843,3045016,+,6173
123,BUMA.1121.00095,2,1951176,1957257,+,6081
123,BUMA.1121.00112,2,1265880,1272033,-,6153
123,BUMA.1121.00042,2,1554814,1561015,+,6201
123,BUMA.1121.00032,2,480833,486914,+,6081
123,BUMA.1121.00090,2,827226,833434,+,6208
123,BUMA.1121.00020,2,2040724,2046785,+,6061
123,BUMA.1121.00089,2,3035525,3041776,+,6251
123,BUMA.1121.00051,2,3050258,3056385,+,6127
123,BUMA.1121.00001,2,2330995,2337152,-,6157
123,BUMA.1121.00045,2,2978066,2984300,+,6234
123,BUMA.1121.00043,2,2517254,2523563,-,6309
123,BUMA.1121.00063,2,3048663,3054836,+,6173
123,BUMA.1121.00079,2,3047086,3053511,+,6425
123,BUMA.1121.00071,2,3054571,3060744,+,6173
123,BUMA.1121.00086,2,2284605,2290736,+,6131
123,BUMA.1121.00024,2,2175647,2181728,+,6081
123,BUMA.1121.00010,2,1486960,1493061,-,6101
123,BUMA.1121.00040,2,2122266,2128517,+,6251
123,BUMA.1121.00093,2,3003528,3009689,-,6161
123,BUMA.1121.00091,2,540498,546701,-,6203
123,BUMA.1121.00107,2,716467,722652,-,6185
123,BUMA.1121.00088,2,3068509,3074740,+,6231
123,BUMA.1121.00047,2,863705,870166,+,6461
123,BUMA.1121.00019,2,2119877,2125938,+,6061
123,BUMA.1121.00087,2,665155,671236,-,6081
123,BUMA.1121.00039,2,877772,883911,-,6139
123,BUMA.1121.00030,2,60164,66225,-,6061
123,BUMA.1121.00016,2,672998,679313,-,6315
123,BUMA.1121.00092,2,3073830,3079991,+,6161
123,BUMA.1121.00085,2,1097472,1103803,+,6331
123,BUMA.1121.00046,2,948693,954824,+,6131
123,BUMA.1121.00003,2,1247768,1253922,+,6154
123,BUMA.1121.00054,2,2186984,2193175,-,6191
123,BUMA.1121.00015,2,185775,191856,+,6081
123,BUMA.1121.00105,2,2574314,2580425,-,6111
123,BUMA.1121.00052,2,51137,57462,+,6325
123,BUMA.1121.00053,2,158350,164553,+,6203
123,BUMA.1121.00057,2,2157441,2163594,-,6153
123,BUMA.1121.00108,2,126988,133149,+,6161
123,BUMA.1121.00050,2,158778,164909,-,6131
123,BUMA.1121.00104,2,8317,14514,+,6197
123,BUMA.1121.00014,2,3204760,3210979,+,6219
123,BUMA.1121.00036,2,1657778,1663969,-,6191
123,BUMA.1121.00038,2,61537,67738,-,6201
123,BUMA.1121.00098,2,144201,150364,+,6163
123,BUMA.1121.00078,2,37092,43315,-,6223
123,BUMA.1121.00078,2,3296552,3302820,-,6268
123,BUMA.1121.00029,2,1444211,1450568,-,6357
123,BUMA.1121.00099,2,77921,84034,+,6113
123,BUMA.1121.00103,2,1758335,1764555,+,6220
123,BUMA.1121.00102,2,3126960,3133361,+,6401
123,BUMA.1121.00028,2,2081904,2087985,+,6081
123,BUMA.1121.00075,2,2922569,2928916,-,6347
123,BUMA.1121.00044,2,2106686,2112747,+,6061
123,BUMA.1121.00076,2,816386,822763,+,6377
123,BUMA.1121.00074,2,1309348,1315639,-,6291
123,BUMA.1121.00073,2,3055201,3061374,+,6173
123,BUMA.1121.00083,2,1732034,1738207,+,6173
123,BUMA.1121.00035,2,1526548,1532765,-,6217
123,BUMA.1121.00072,2,3032977,3039150,+,6173
123,BUMA.1121.00056,2,950270,956481,-,6211
123,BUMA.1121.00081,2,2255841,2262032,+,6191
123,BUMA.1121.00033,2,588614,594785,+,6171
123,BUMA.1121.00061,2,3037854,3044026,+,6172
123,BUMA.1121.00062,2,1837482,1843633,-,6151
123,BUMA.1121.00064,2,2973163,2979294,+,6131
123,BUMA.1121.00060,2,2280804,2287058,-,6254
123,BUMA.1121.00069,2,3004735,3010908,+,6173
123,BUMA.1121.00070,2,3034585,3040757,+,6172
123,BUMA.1121.00068,2,1652057,1658198,+,6141
123,BUMA.1121.00067,2,867571,873748,-,6177
123,BUMA.1121.00037,2,180402,186621,+,6219
123,BUMA.1121.00065,2,3160788,3167019,+,6231
123,BUMA.1121.00058,2,447800,454073,+,6273
123,BUMA.1121.00041,2,810984,817165,+,6181
123,BUMA.1121.00084,2,1772896,1779007,+,6111
123,BUMA.1121.00096,2,46570,52699,+,6129
123,BUMA.1121.00080,2,3106999,3113335,+,6336
123,BUMA.1121.00013,2,363856,370037,+,6181
123,BUMA.1121.00100,2,1096837,1103020,+,6183
123,BUMA.1121.00012,2,1897740,1903919,-,6179
123,BUMA.1121.00018,2,776874,783233,-,6359
123,BUMA.1121.00048,2,669904,676095,+,6191
123,BUMA.1121.00106,2,2346998,2353119,+,6121
123,BUMA.1121.00017,2,2055793,2061854,+,6061
123,BUMA.1121.00082,2,3108134,3114307,+,6173
124,BUMA.1121.00049,2,1723429,1726598,+,3169
124,BUMA.1121.00055,2,2741024,2744193,-,3169
124,BUMA.1121.00011,2,1707305,1710474,+,3169
124,BUMA.1121.00110,2,3068901,3072070,+,3169
124,BUMA.1121.00109,2,1546299,1549468,-,3169
124,BUMA.1121.00077,2,543574,546743,-,3169
124,BUMA.1121.00027,2,997564,1000733,+,3169
124,BUMA.1121.00026,2,548224,551393,+,3169
124,BUMA.1121.00021,2,400071,403240,+,3169
124,BUMA.1121.00023,2,3235474,3238643,+,3169
124,BUMA.1121.00022,2,1490919,1494088,+,3169
124,BUMA.1121.00034,2,2069752,2072921,+,3169
124,BUMA.1121.00025,2,1560924,1564093,+,3169
124,BUMA.1121.00031,2,2276045,2279214,+,3169
124,BUMA.1121.00007,2,3187034,3190203,+,3169
124,BUMA.1121.00097,2,2939907,2943076,+,3169
124,BUMA.1121.00008,2,2053948,2057117,+,3169
124,BUMA.1121.00059,2,533094,536263,-,3169
124,BUMA.1121.00002,2,622424,625593,-,3169
124,BUMA.1121.00004,2,2054449,2057618,+,3169
124,BUMA.1121.00005,2,818468,821637,-,3169
124,BUMA.1121.00111,2,2378537,2381706,+,3169
124,BUMA.1121.00006,2,49234,52403,-,3169
124,BUMA.1121.00009,2,1742391,1745560,+,3169
124,BUMA.1121.00094,2,3099575,3102744,+,3169
124,BUMA.1121.00101,2,321465,324634,-,3169
124,BUMA.1121.00066,2,3050005,3053174,+,3169
124,BUMA.1121.00095,2,1962246,1965415,+,3169
124,BUMA.1121.00112,2,1257721,1260890,-,3169
124,BUMA.1121.00042,2,1763801,1766970,-,3169
124,BUMA.1121.00032,2,494807,497976,+,3169
124,BUMA.1121.00090,2,838434,841603,+,3169
124,BUMA.1121.00020,2,2055918,2059087,+,3169
124,BUMA.1121.00089,2,3046768,3049937,+,3169
124,BUMA.1121.00051,2,3061372,3064541,+,3169
124,BUMA.1121.00001,2,2322793,2325962,-,3169
124,BUMA.1121.00045,2,2989289,2992458,+,3169
124,BUMA.1121.00043,2,2509095,2512264,-,3169
124,BUMA.1121.00063,2,3059825,3062994,+,3169
124,BUMA.1121.00079,2,3058499,3061668,+,3169
124,BUMA.1121.00071,2,3065733,3068902,+,3169
124,BUMA.1121.00086,2,2298629,2301798,+,3169
124,BUMA.1121.00024,2,2189621,2192790,+,3169
124,BUMA.1121.00010,2,1474313,1477482,-,3169
124,BUMA.1121.00040,2,123366,126535,-,3169
124,BUMA.1121.00093,2,2995369,2998538,-,3169
124,BUMA.1121.00091,2,532339,535508,-,3169
124,BUMA.1121.00107,2,706716,709885,-,3169
124,BUMA.1121.00088,2,3081042,3084211,+,3169
124,BUMA.1121.00047,2,875158,878327,+,3169
124,BUMA.1121.00019,2,2135071,2138240,+,3169
124,BUMA.1121.00087,2,654093,657262,-,3169
124,BUMA.1121.00039,2,869624,872793,-,3169
124,BUMA.1121.00030,2,49101,52270,-,3169
124,BUMA.1121.00016,2,664839,668008,-,3169
124,BUMA.1121.00092,2,3084980,3088149,+,3169
124,BUMA.1121.00085,2,1111696,1114865,+,3169
124,BUMA.1121.00046,2,1179008,1182177,-,3169
124,BUMA.1121.00003,2,1258915,1262084,+,3169
124,BUMA.1121.00054,2,2174681,2177850,-,3169
124,BUMA.1121.00015,2,199749,202918,+,3169
124,BUMA.1121.00105,2,2566155,2569324,-,3169
124,BUMA.1121.00052,2,65355,68524,+,3169
124,BUMA.1121.00053,2,169542,172711,+,3169
124,BUMA.1121.00057,2,2149282,2152451,-,3169
124,BUMA.1121.00108,2,138087,141256,+,3169
124,BUMA.1121.00050,2,2252968,2256137,+,3169
124,BUMA.1121.00104,2,20816,23985,+,3169
124,BUMA.1121.00014,2,3215967,3219136,+,3169
124,BUMA.1121.00036,2,1646715,1649884,-,3169
124,BUMA.1121.00038,2,49234,52403,-,3169
124,BUMA.1121.00098,2,155353,158522,+,3169
124,BUMA.1121.00078,2,27344,30513,-,3169
124,BUMA.1121.00078,2,3286840,3289989,-,3149
124,BUMA.1121.00029,2,1436027,1439196,-,3169
124,BUMA.1121.00099,2,88975,92144,+,3169
124,BUMA.1121.00103,2,1769544,1772713,+,3169
124,BUMA.1121.00102,2,3138350,3141519,+,3169
124,BUMA.1121.00028,2,2095878,2099047,+,3169
124,BUMA.1121.00075,2,2914410,2917579,-,3169
124,BUMA.1121.00044,2,368,3537,+,3169
124,BUMA.1121.00076,2,827752,830921,+,3169
124,BUMA.1121.00074,2,1299876,1303045,-,3169
124,BUMA.1121.00073,2,3066363,3069532,+,3169
124,BUMA.1121.00083,2,1743196,1746365,+,3169
124,BUMA.1121.00035,2,1518328,1521497,-,3169
124,BUMA.1121.00072,2,3044139,3047308,+,3169
124,BUMA.1121.00056,2,942108,945277,-,3169
124,BUMA.1121.00081,2,2271165,2274334,+,3169
124,BUMA.1121.00033,2,599775,602944,+,3169
124,BUMA.1121.00061,2,3049015,3052184,+,3169
124,BUMA.1121.00062,2,1829323,1832492,-,3169
124,BUMA.1121.00064,2,2985600,2988769,+,3169
124,BUMA.1121.00060,2,2272645,2275814,-,3169
124,BUMA.1121.00069,2,3015897,3019066,+,3169
124,BUMA.1121.00070,2,3045746,3048915,+,3169
124,BUMA.1121.00068,2,1663187,1666356,+,3169
124,BUMA.1121.00067,2,859414,862583,-,3169
124,BUMA.1121.00037,2,191610,194779,+,3169
124,BUMA.1121.00065,2,3172012,3175181,+,3169
124,BUMA.1121.00058,2,459062,462231,+,3169
124,BUMA.1121.00041,2,822157,825326,+,3169
124,BUMA.1121.00084,2,1785308,1788477,+,3169
124,BUMA.1121.00096,2,57692,60861,+,3169
124,BUMA.1121.00080,2,3119913,3123082,+,3169
124,BUMA.1121.00013,2,377930,381099,+,3169
124,BUMA.1121.00100,2,1108009,1111178,+,3169
124,BUMA.1121.00012,2,1889592,1892761,-,3169
124,BUMA.1121.00018,2,768716,771885,-,3169
124,BUMA.1121.00048,2,685229,688398,+,3169
124,BUMA.1121.00106,2,2359421,2362590,+,3169
124,BUMA.1121.00017,2,2069747,2072916,+,3169
124,BUMA.1121.00082,2,3119296,3122465,+,3169
125,BUMA.1121.00049,2,1727839,1733677,+,5838
125,BUMA.1121.00055,2,2733945,2739783,-,5838
125,BUMA.1121.00011,2,1711713,1717533,+,5820
125,BUMA.1121.00110,2,3073299,3079131,+,5832
125,BUMA.1121.00109,2,1539220,1545071,-,5851
125,BUMA.1121.00077,2,536513,542346,-,5833
125,BUMA.1121.00027,2,1001962,1007803,+,5841
125,BUMA.1121.00026,2,552622,558464,+,5842
125,BUMA.1121.00021,2,404481,410310,+,5829
125,BUMA.1121.00023,2,3239884,3245729,+,5845
125,BUMA.1121.00022,2,1495317,1501159,+,5842
125,BUMA.1121.00034,2,2074150,2079992,+,5842
125,BUMA.1121.00025,2,1565334,1571132,+,5798
125,BUMA.1121.00031,2,2280455,2286287,+,5832
125,BUMA.1121.00007,2,3191432,3197288,+,5856
125,BUMA.1121.00097,2,2944305,2950146,+,5841
125,BUMA.1121.00008,2,2058346,2064188,+,5842
125,BUMA.1121.00059,2,526024,531866,-,5842
125,BUMA.1121.00002,2,615353,621196,-,5843
125,BUMA.1121.00004,2,2058847,2064689,+,5842
125,BUMA.1121.00005,2,811398,817240,-,5842
125,BUMA.1121.00111,2,2382947,2388776,+,5829
125,BUMA.1121.00006,2,42163,48006,-,5843
125,BUMA.1121.00009,2,1746801,1752639,+,5838
125,BUMA.1121.00094,2,3103985,3109814,+,5829
125,BUMA.1121.00101,2,314395,320237,-,5842
125,BUMA.1121.00066,2,3054403,3060244,+,5841
125,BUMA.1121.00095,2,1966644,1972475,+,5831
125,BUMA.1121.00112,2,1250666,1256493,-,5827
125,BUMA.1121.00042,2,1756730,1762573,-,5843
125,BUMA.1121.00032,2,499205,505047,+,5842
125,BUMA.1121.00090,2,842844,848673,+,5829
125,BUMA.1121.00020,2,2060316,2066158,+,5842
125,BUMA.1121.00089,2,3051178,3057007,+,5829
125,BUMA.1121.00051,2,3065770,3071611,+,5841
125,BUMA.1121.00001,2,2315711,2321552,-,5841
125,BUMA.1121.00045,2,2993687,2999528,+,5841
125,BUMA.1121.00043,2,2502025,2507854,-,5829
125,BUMA.1121.00063,2,3064223,3070064,+,5841
125,BUMA.1121.00079,2,3062909,3068747,+,5838
125,BUMA.1121.00071,2,3070131,3075972,+,5841
125,BUMA.1121.00086,2,2303027,2308869,+,5842
125,BUMA.1121.00024,2,2194019,2199861,+,5842
125,BUMA.1121.00010,2,1467242,1473085,-,5843
125,BUMA.1121.00040,2,116295,122138,-,5843
125,BUMA.1121.00093,2,2988299,2994141,-,5842
125,BUMA.1121.00091,2,525269,531111,-,5842
125,BUMA.1121.00107,2,699646,705488,-,5842
125,BUMA.1121.00088,2,3085440,3091272,+,5832
125,BUMA.1121.00047,2,879568,885397,+,5829
125,BUMA.1121.00019,2,2139469,2145311,+,5842
125,BUMA.1121.00087,2,647022,652865,-,5843
125,BUMA.1121.00039,2,862554,868383,-,5829
125,BUMA.1121.00030,2,42030,47873,-,5843
125,BUMA.1121.00016,2,657769,663598,-,5829
125,BUMA.1121.00092,2,3089378,3095219,+,5841
125,BUMA.1121.00085,2,1116094,1121936,+,5842
125,BUMA.1121.00046,2,1171937,1177780,-,5843
125,BUMA.1121.00003,2,1263325,1269155,+,5830
125,BUMA.1121.00054,2,2167610,2173453,-,5843
125,BUMA.1121.00015,2,204147,209989,+,5842
125,BUMA.1121.00105,2,2559076,2564914,-,5838
125,BUMA.1121.00052,2,69753,75595,+,5842
125,BUMA.1121.00053,2,173950,179779,+,5829
125,BUMA.1121.00057,2,2142212,2148054,-,5842
125,BUMA.1121.00108,2,142495,148324,+,5829
125,BUMA.1121.00050,2,2257366,2263208,+,5842
125,BUMA.1121.00104,2,25214,31055,+,5841
125,BUMA.1121.00014,2,3220377,3226209,+,5832
125,BUMA.1121.00036,2,1639644,1645487,-,5843
125,BUMA.1121.00038,2,42163,48006,-,5843
125,BUMA.1121.00098,2,159751,165592,+,5841
125,BUMA.1121.00078,2,20276,26119,-,5843
125,BUMA.1121.00078,2,3279790,3285616,-,5826
125,BUMA.1121.00029,2,1428957,1434786,-,5829
125,BUMA.1121.00099,2,93373,99214,+,5841
125,BUMA.1121.00103,2,1773942,1779783,+,5841
125,BUMA.1121.00102,2,3142758,3148587,+,5829
125,BUMA.1121.00028,2,2100276,2106118,+,5842
125,BUMA.1121.00075,2,2907331,2913169,-,5838
125,BUMA.1121.00044,2,4766,10608,+,5842
125,BUMA.1121.00076,2,832162,838000,+,5838
125,BUMA.1121.00074,2,1292815,1298648,-,5833
125,BUMA.1121.00073,2,3070761,3076602,+,5841
125,BUMA.1121.00083,2,1747594,1753435,+,5841
125,BUMA.1121.00035,2,1511258,1517087,-,5829
125,BUMA.1121.00072,2,3048537,3054378,+,5841
125,BUMA.1121.00056,2,935038,940867,-,5829
125,BUMA.1121.00081,2,2275563,2281405,+,5842
125,BUMA.1121.00033,2,604185,610014,+,5829
125,BUMA.1121.00061,2,3053413,3059254,+,5841
125,BUMA.1121.00062,2,1822262,1828095,-,5833
125,BUMA.1121.00064,2,2990010,2995830,+,5820
125,BUMA.1121.00060,2,2265575,2271417,-,5842
125,BUMA.1121.00069,2,3020295,3026136,+,5841
125,BUMA.1121.00070,2,3050144,3055985,+,5841
125,BUMA.1121.00068,2,1667585,1673426,+,5841
125,BUMA.1121.00067,2,852344,858186,-,5842
125,BUMA.1121.00037,2,196020,201852,+,5832
125,BUMA.1121.00065,2,3176422,3182251,+,5829
125,BUMA.1121.00058,2,463472,469292,+,5820
125,BUMA.1121.00041,2,826567,832396,+,5829
125,BUMA.1121.00084,2,1789706,1795547,+,5841
125,BUMA.1121.00096,2,62102,67931,+,5829
125,BUMA.1121.00080,2,3124311,3130152,+,5841
125,BUMA.1121.00013,2,382328,388170,+,5842
125,BUMA.1121.00100,2,1112407,1118233,+,5826
125,BUMA.1121.00012,2,1882522,1888351,-,5829
125,BUMA.1121.00018,2,761678,767476,-,5798
125,BUMA.1121.00048,2,689627,695469,+,5842
125,BUMA.1121.00106,2,2363831,2369669,+,5838
125,BUMA.1121.00017,2,2074145,2079987,+,5842
125,BUMA.1121.00082,2,3123694,3129535,+,5841
126,BUMA.1121.00049,2,1733679,1752573,+,18894
126,BUMA.1121.00055,2,2714908,2733944,-,19036
126,BUMA.1121.00011,2,1717535,1736517,+,18982
126,BUMA.1121.00110,2,3079133,3098035,+,18902
126,BUMA.1121.00109,2,1520346,1539219,-,18873
126,BUMA.1121.00077,2,517610,536512,-,18902
126,BUMA.1121.00027,2,1007805,1026795,+,18990
126,BUMA.1121.00026,2,558466,577368,+,18902
126,BUMA.1121.00021,2,410312,429193,+,18881
126,BUMA.1121.00023,2,15,18776,+,18761
126,BUMA.1121.00022,2,1501161,1520084,+,18923
126,BUMA.1121.00034,2,2079994,2098917,+,18923
126,BUMA.1121.00025,2,1571134,1589932,+,18798
126,BUMA.1121.00031,2,2286289,2305112,+,18823
126,BUMA.1121.00007,2,3197290,3216234,+,18944
126,BUMA.1121.00097,2,2950148,2969006,+,18858
126,BUMA.1121.00008,2,2064190,2083125,+,18935
126,BUMA.1121.00059,2,507145,526023,-,18878
126,BUMA.1121.00002,2,596440,615352,-,18912
126,BUMA.1121.00004,2,2064691,2083626,+,18935
126,BUMA.1121.00005,2,792452,811397,-,18945
126,BUMA.1121.00111,2,2388778,2407622,+,18844
126,BUMA.1121.00006,2,23100,42162,-,19062
126,BUMA.1121.00009,2,1752641,1771528,+,18887
126,BUMA.1121.00094,2,3109816,3128600,+,18784
126,BUMA.1121.00101,2,295425,314394,-,18969
126,BUMA.1121.00066,2,3060246,3079000,+,18754
126,BUMA.1121.00095,2,1972477,1991387,+,18910
126,BUMA.1121.00112,2,1231789,1250665,-,18876
126,BUMA.1121.00042,2,1737840,1756729,-,18889
126,BUMA.1121.00032,2,505049,523972,+,18923
126,BUMA.1121.00090,2,848675,867523,+,18848
126,BUMA.1121.00020,2,2066160,2085095,+,18935
126,BUMA.1121.00089,2,3057009,3075794,+,18785
126,BUMA.1121.00051,2,3071613,3090459,+,18846
126,BUMA.1121.00001,2,2296888,2315710,-,18822
126,BUMA.1121.00045,2,2999530,3018575,+,19045
126,BUMA.1121.00043,2,2483171,2502024,-,18853
126,BUMA.1121.00063,2,3070066,3088839,+,18773
126,BUMA.1121.00079,2,3068749,3087614,+,18865
126,BUMA.1121.00071,2,3075974,3094726,+,18752
126,BUMA.1121.00086,2,2308871,2327791,+,18920
126,BUMA.1121.00024,2,2199863,2218810,+,18947
126,BUMA.1121.00010,2,1448329,1467241,-,18912
126,BUMA.1121.00040,2,97349,116294,-,18945
126,BUMA.1121.00093,2,2969473,2988298,-,18825
126,BUMA.1121.00091,2,506418,525268,-,18850
126,BUMA.1121.00107,2,680763,699645,-,18882
126,BUMA.1121.00088,2,3091274,3110148,+,18874
126,BUMA.1121.00047,2,885399,904289,+,18890
126,BUMA.1121.00019,2,2145313,2164248,+,18935
126,BUMA.1121.00087,2,628100,647021,-,18921
126,BUMA.1121.00039,2,843778,862553,-,18775
126,BUMA.1121.00030,2,23105,42029,-,18924
126,BUMA.1121.00016,2,639000,657768,-,18768
126,BUMA.1121.00092,2,3095221,3114045,+,18824
126,BUMA.1121.00085,2,1121938,1140888,+,18950
126,BUMA.1121.00046,2,1152913,1171936,-,19023
126,BUMA.1121.00003,2,1269157,1288070,+,18913
126,BUMA.1121.00054,2,2148549,2167609,-,19060
126,BUMA.1121.00015,2,209991,229031,+,19040
126,BUMA.1121.00105,2,2540234,2559075,-,18841
126,BUMA.1121.00052,2,75597,94547,+,18950
126,BUMA.1121.00053,2,179781,198578,+,18797
126,BUMA.1121.00057,2,2123253,2142211,-,18958
126,BUMA.1121.00108,2,148326,167331,+,19005
126,BUMA.1121.00050,2,2263210,2282232,+,19022
126,BUMA.1121.00104,2,31057,49975,+,18918
126,BUMA.1121.00014,2,3226211,3245065,+,18854
126,BUMA.1121.00036,2,1620707,1639643,-,18936
126,BUMA.1121.00038,2,23100,42162,-,19062
126,BUMA.1121.00098,2,165594,184567,+,18973
126,BUMA.1121.00078,2,1510,20275,-,18765
126,BUMA.1121.00078,2,3260943,3279789,-,18846
126,BUMA.1121.00029,2,1410094,1428956,-,18862
126,BUMA.1121.00099,2,99216,118191,+,18975
126,BUMA.1121.00103,2,1779785,1798684,+,18899
126,BUMA.1121.00102,2,3148589,3167443,+,18854
126,BUMA.1121.00028,2,2106120,2125067,+,18947
126,BUMA.1121.00075,2,2888426,2907330,-,18904
126,BUMA.1121.00044,2,10610,29533,+,18923
126,BUMA.1121.00076,2,838002,856905,+,18903
126,BUMA.1121.00074,2,1273824,1292814,-,18990
126,BUMA.1121.00073,2,3076604,3095377,+,18773
126,BUMA.1121.00083,2,1753437,1772284,+,18847
126,BUMA.1121.00035,2,1492351,1511257,-,18906
126,BUMA.1121.00072,2,3054380,3073139,+,18759
126,BUMA.1121.00056,2,916251,935037,-,18786
126,BUMA.1121.00081,2,2281407,2300468,+,19061
126,BUMA.1121.00033,2,610016,628896,+,18880
126,BUMA.1121.00061,2,3059256,3077993,+,18737
126,BUMA.1121.00062,2,1803458,1822261,-,18803
126,BUMA.1121.00064,2,2995832,3014724,+,18892
126,BUMA.1121.00060,2,2246528,2265574,-,19046
126,BUMA.1121.00069,2,3026138,3044888,+,18750
126,BUMA.1121.00070,2,3055987,3074760,+,18773
126,BUMA.1121.00068,2,1673428,1692307,+,18879
126,BUMA.1121.00067,2,833394,852343,-,18949
126,BUMA.1121.00037,2,201854,220648,+,18794
126,BUMA.1121.00065,2,3182253,3201224,+,18971
126,BUMA.1121.00058,2,469294,488182,+,18888
126,BUMA.1121.00041,2,832398,851279,+,18881
126,BUMA.1121.00084,2,1795549,1814393,+,18844
126,BUMA.1121.00096,2,67933,86886,+,18953
126,BUMA.1121.00080,2,3130154,3149026,+,18872
126,BUMA.1121.00013,2,388172,407140,+,18968
126,BUMA.1121.00100,2,1118235,1137171,+,18936
126,BUMA.1121.00012,2,1863690,1882521,-,18831
126,BUMA.1121.00018,2,742878,761677,-,18799
126,BUMA.1121.00048,2,695471,714532,+,19061
126,BUMA.1121.00106,2,2369671,2388525,+,18854
126,BUMA.1121.00017,2,2079989,2098912,+,18923
126,BUMA.1121.00082,2,3129537,3148310,+,18773
127,BUMA.1121.00049,2,1754321,1770674,+,16353
127,BUMA.1121.00055,2,2696945,2713161,-,16216
127,BUMA.1121.00011,2,1738265,1754433,+,16168
127,BUMA.1121.00110,2,3099783,3116014,+,16231
127,BUMA.1121.00109,2,1502340,1518599,-,16259
127,BUMA.1121.00077,2,499623,515863,-,16240
127,BUMA.1121.00027,2,1028543,1044641,+,16098
127,BUMA.1121.00026,2,579116,595222,+,16106
127,BUMA.1121.00021,2,430941,447205,+,16264
127,BUMA.1121.00023,2,20524,36866,+,16342
127,BUMA.1121.00022,2,1521832,1537951,+,16119
127,BUMA.1121.00034,2,2100665,2116778,+,16113
127,BUMA.1121.00025,2,1591680,1607945,+,16265
127,BUMA.1121.00031,2,2306860,2323265,+,16405
127,BUMA.1121.00007,2,3217982,3234218,+,16236
127,BUMA.1121.00097,2,2970754,2986998,+,16244
127,BUMA.1121.00008,2,2084873,2100986,+,16113
127,BUMA.1121.00059,2,489115,505398,-,16283
127,BUMA.1121.00002,2,578580,594693,-,16113
127,BUMA.1121.00004,2,2085374,2101487,+,16113
127,BUMA.1121.00005,2,774591,790705,-,16114
127,BUMA.1121.00111,2,2409370,2425609,+,16239
127,BUMA.1121.00006,2,5240,21353,-,16113
127,BUMA.1121.00009,2,1773276,1789460,+,16184
127,BUMA.1121.00094,2,3130348,3146591,+,16243
127,BUMA.1121.00101,2,277535,293678,-,16143
127,BUMA.1121.00066,2,3080748,3096944,+,16196
127,BUMA.1121.00095,2,1993134,2009294,+,16160
127,BUMA.1121.00112,2,1213799,1230042,-,16243
127,BUMA.1121.00042,2,1719980,1736093,-,16113
127,BUMA.1121.00032,2,525720,541833,+,16113
127,BUMA.1121.00090,2,869271,885557,+,16286
127,BUMA.1121.00020,2,2086843,2102956,+,16113
127,BUMA.1121.00089,2,3077542,3093795,+,16253
127,BUMA.1121.00051,2,3092207,3108430,+,16223
127,BUMA.1121.00001,2,2278904,2295141,-,16237
127,BUMA.1121.00045,2,3020323,3036494,+,16171
127,BUMA.1121.00043,2,2465264,2481424,-,16160
127,BUMA.1121.00063,2,3090587,3106776,+,16189
127,BUMA.1121.00079,2,3089362,3105661,+,16299
127,BUMA.1121.00071,2,3096474,3112669,+,16195
127,BUMA.1121.00086,2,2329539,2345664,+,16125
127,BUMA.1121.00024,2,2220558,2236671,+,16113
127,BUMA.1121.00010,2,1430469,1446582,-,16113
127,BUMA.1121.00040,2,79507,95620,-,16113
127,BUMA.1121.00093,2,2951599,2967726,-,16127
127,BUMA.1121.00091,2,488441,504671,-,16230
127,BUMA.1121.00107,2,662820,679016,-,16196
127,BUMA.1121.00088,2,3111896,3128093,+,16197
127,BUMA.1121.00047,2,906037,922269,+,16232
127,BUMA.1121.00019,2,2165996,2182109,+,16113
127,BUMA.1121.00087,2,610228,626353,-,16125
127,BUMA.1121.00039,2,825878,842031,-,16153
127,BUMA.1121.00030,2,5245,21358,-,16113
127,BUMA.1121.00016,2,621045,637253,-,16208
127,BUMA.1121.00092,2,3115793,3131920,+,16127
127,BUMA.1121.00085,2,1142636,1158748,+,16112
127,BUMA.1121.00046,2,1135053,1151166,-,16113
127,BUMA.1121.00003,2,1289818,1305939,+,16121
127,BUMA.1121.00054,2,2130689,2146802,-,16113
127,BUMA.1121.00015,2,230779,246892,+,16113
127,BUMA.1121.00105,2,2522285,2538487,-,16202
127,BUMA.1121.00052,2,96295,112407,+,16112
127,BUMA.1121.00053,2,200326,216498,+,16172
127,BUMA.1121.00057,2,2105379,2121506,-,16127
127,BUMA.1121.00108,2,169079,185453,+,16374
127,BUMA.1121.00050,2,2283980,2300093,+,16113
127,BUMA.1121.00104,2,51723,68025,+,16302
127,BUMA.1121.00014,2,3246813,3263218,+,16405
127,BUMA.1121.00036,2,1602841,1618960,-,16119
127,BUMA.1121.00038,2,5240,21353,-,16113
127,BUMA.1121.00098,2,186315,202579,+,16264
127,BUMA.1121.00078,2,3242985,3259196,-,16211
127,BUMA.1121.00029,2,1392159,1408347,-,16188
127,BUMA.1121.00099,2,119939,136088,+,16149
127,BUMA.1121.00103,2,1800432,1816648,+,16216
127,BUMA.1121.00102,2,3169191,3185316,+,16125
127,BUMA.1121.00028,2,2126815,2142928,+,16113
127,BUMA.1121.00075,2,2870535,2886679,-,16144
127,BUMA.1121.00044,2,31281,47394,+,16113
127,BUMA.1121.00076,2,858653,874800,+,16147
127,BUMA.1121.00074,2,1255852,1272077,-,16225
127,BUMA.1121.00073,2,3097125,3113321,+,16196
127,BUMA.1121.00083,2,1774032,1790228,+,16196
127,BUMA.1121.00035,2,1474367,1490604,-,16237
127,BUMA.1121.00072,2,3074887,3091083,+,16196
127,BUMA.1121.00056,2,898251,914504,-,16253
127,BUMA.1121.00081,2,2302216,2318329,+,16113
127,BUMA.1121.00033,2,630644,646970,+,16326
127,BUMA.1121.00061,2,3079741,3095937,+,16196
127,BUMA.1121.00062,2,1785468,1801711,-,16243
127,BUMA.1121.00064,2,3016472,3032662,+,16190
127,BUMA.1121.00060,2,2228610,2244781,-,16171
127,BUMA.1121.00069,2,3046636,3062832,+,16196
127,BUMA.1121.00070,2,3076508,3092704,+,16196
127,BUMA.1121.00068,2,1694055,1710256,+,16201
127,BUMA.1121.00067,2,815478,831647,-,16169
127,BUMA.1121.00037,2,222396,238710,+,16314
127,BUMA.1121.00065,2,3202972,3219133,+,16161
127,BUMA.1121.00058,2,489930,506197,+,16267
127,BUMA.1121.00041,2,853027,869368,+,16341
127,BUMA.1121.00084,2,1816141,1832407,+,16266
127,BUMA.1121.00096,2,88634,104821,+,16187
127,BUMA.1121.00080,2,3150774,3167012,+,16238
127,BUMA.1121.00013,2,408888,424994,+,16106
127,BUMA.1121.00100,2,1138919,1155296,+,16377
127,BUMA.1121.00012,2,1845769,1861943,-,16174
127,BUMA.1121.00018,2,724887,741131,-,16244
127,BUMA.1121.00048,2,716280,732393,+,16113
127,BUMA.1121.00106,2,2390273,2406519,+,16246
127,BUMA.1121.00017,2,2100660,2116773,+,16113
127,BUMA.1121.00082,2,3150058,3166254,+,16196
128,BUMA.1121.00049,2,1779147,1790995,+,11848
128,BUMA.1121.00055,2,2676617,2688457,-,11840
128,BUMA.1121.00011,2,1763158,1775084,+,11926
128,BUMA.1121.00110,2,3124872,3136753,+,11881
128,BUMA.1121.00109,2,1482063,1493824,-,11761
128,BUMA.1121.00077,2,478883,490765,-,11882
128,BUMA.1121.00027,2,1053212,1065046,+,11834
128,BUMA.1121.00026,2,605205,617013,+,11808
128,BUMA.1121.00021,2,457702,469519,+,11817
128,BUMA.1121.00023,2,47336,59209,+,11873
128,BUMA.1121.00022,2,1547869,1559684,+,11815
128,BUMA.1121.00034,2,6152,17989,+,11837
128,BUMA.1121.00025,2,1616777,1628559,+,11782
128,BUMA.1121.00031,2,2333442,2345252,+,11810
128,BUMA.1121.00007,2,6153,17976,+,11823
128,BUMA.1121.00097,2,2996739,3008578,+,11839
128,BUMA.1121.00008,2,6152,17989,+,11837
128,BUMA.1121.00059,2,468664,480484,-,11820
128,BUMA.1121.00002,2,556802,568658,-,11856
128,BUMA.1121.00004,2,6152,17989,+,11837
128,BUMA.1121.00005,2,752506,764297,-,11791
128,BUMA.1121.00111,2,2435882,2447720,+,11838
128,BUMA.1121.00006,2,2308857,2320657,-,11800
128,BUMA.1121.00009,2,1797863,1809633,+,11770
128,BUMA.1121.00094,2,1751,13662,+,11911
128,BUMA.1121.00101,2,257379,269130,-,11751
128,BUMA.1121.00066,2,1751,13663,+,11912
128,BUMA.1121.00095,2,2017797,2029653,+,11856
128,BUMA.1121.00112,2,1193634,1205432,-,11798
128,BUMA.1121.00042,2,1698255,1710038,-,11783
128,BUMA.1121.00032,2,551777,563607,+,11830
128,BUMA.1121.00090,2,896187,907948,+,11761
128,BUMA.1121.00020,2,6152,17982,+,11830
128,BUMA.1121.00089,2,1751,13641,+,11890
128,BUMA.1121.00051,2,1751,13669,+,11918
128,BUMA.1121.00001,2,2257140,2268940,-,11800
128,BUMA.1121.00045,2,3044950,3056747,+,11797
128,BUMA.1121.00043,2,2443485,2455315,-,11830
128,BUMA.1121.00063,2,1751,13649,+,11898
128,BUMA.1121.00079,2,1751,13655,+,11904
128,BUMA.1121.00071,2,1751,13624,+,11873
128,BUMA.1121.00086,2,2889,14690,+,11801
128,BUMA.1121.00024,2,6152,17989,+,11837
128,BUMA.1121.00010,2,1408691,1420547,-,11856
128,BUMA.1121.00040,2,59345,71166,-,11821
128,BUMA.1121.00093,2,2931430,2943218,-,11788
128,BUMA.1121.00091,2,466669,478440,-,11771
128,BUMA.1121.00107,2,642540,654336,-,11796
128,BUMA.1121.00088,2,3136564,3148454,+,11890
128,BUMA.1121.00047,2,930896,942738,+,11842
128,BUMA.1121.00019,2,6152,17982,+,11830
128,BUMA.1121.00087,2,588508,600309,-,11801
128,BUMA.1121.00039,2,803990,815800,-,11810
128,BUMA.1121.00030,2,2103769,2115606,-,11837
128,BUMA.1121.00016,2,599196,610998,-,11802
128,BUMA.1121.00092,2,1751,13539,+,11788
128,BUMA.1121.00085,2,1167080,1178881,+,11801
128,BUMA.1121.00046,2,1113641,1125480,-,11839
128,BUMA.1121.00003,2,1314300,1326192,+,11892
128,BUMA.1121.00054,2,2108949,2120749,-,11800
128,BUMA.1121.00015,2,255224,267028,+,11804
128,BUMA.1121.00105,2,2500351,2512167,-,11816
128,BUMA.1121.00052,2,120739,132540,+,11801
128,BUMA.1121.00053,2,225512,237279,+,11767
128,BUMA.1121.00057,2,2084864,2096691,-,11827
128,BUMA.1121.00108,2,193886,205636,+,11750
128,BUMA.1121.00050,2,2309665,2321527,+,11862
128,BUMA.1121.00104,2,76603,88447,+,11844
128,BUMA.1121.00014,2,40,11886,+,11846
128,BUMA.1121.00036,2,1581100,1592922,-,11822
128,BUMA.1121.00038,2,2210058,2221858,-,11800
128,BUMA.1121.00098,2,210988,222838,+,11850
128,BUMA.1121.00078,2,3222568,3234359,-,11791
128,BUMA.1121.00029,2,1368944,1380779,-,11835
128,BUMA.1121.00099,2,144790,156605,+,11815
128,BUMA.1121.00103,2,1825129,1836875,+,11746
128,BUMA.1121.00102,2,4014,15835,+,11821
128,BUMA.1121.00028,2,6152,17989,+,11837
128,BUMA.1121.00075,2,2850191,2862035,-,11844
128,BUMA.1121.00044,2,57339,69176,+,11837
128,BUMA.1121.00076,2,883575,895419,+,11844
128,BUMA.1121.00074,2,1235485,1247230,-,11745
128,BUMA.1121.00073,2,1751,13638,+,11887
128,BUMA.1121.00083,2,1798694,1810610,+,11916
128,BUMA.1121.00035,2,1452515,1464392,-,11877
128,BUMA.1121.00072,2,1751,13613,+,11862
128,BUMA.1121.00056,2,877958,889848,-,11890
128,BUMA.1121.00081,2,2889,14689,+,11800
128,BUMA.1121.00033,2,655381,667176,+,11795
128,BUMA.1121.00061,2,1751,13662,+,11911
128,BUMA.1121.00062,2,1764738,1776595,-,11857
128,BUMA.1121.00064,2,1751,13637,+,11886
128,BUMA.1121.00060,2,2208374,2220171,-,11797
128,BUMA.1121.00069,2,1751,13663,+,11912
128,BUMA.1121.00070,2,1751,13634,+,11883
128,BUMA.1121.00068,2,1718867,1730617,+,11750
128,BUMA.1121.00067,2,794956,806782,-,11826
128,BUMA.1121.00037,2,247395,259212,+,11817
128,BUMA.1121.00065,2,1751,13565,+,11814
128,BUMA.1121.00058,2,516058,527948,+,11890
128,BUMA.1121.00041,2,878125,889965,+,11840
128,BUMA.1121.00084,2,1840828,1852682,+,11854
128,BUMA.1121.00096,2,113272,125078,+,11806
128,BUMA.1121.00080,2,1751,13620,+,11869
128,BUMA.1121.00013,2,433328,445122,+,11794
128,BUMA.1121.00100,2,1165691,1177624,+,11933
128,BUMA.1121.00012,2,1823955,1835758,-,11803
128,BUMA.1121.00018,2,704476,716258,-,11782
128,BUMA.1121.00048,2,742332,754132,+,11800
128,BUMA.1121.00106,2,2416669,2428527,+,11858
128,BUMA.1121.00017,2,6152,17989,+,11837
128,BUMA.1121.00082,2,1751,13667,+,11916
129,BUMA.1121.00049,2,1794339,1798930,+,4591
129,BUMA.1121.00055,2,2668687,2673278,-,4591
129,BUMA.1121.00011,2,1778415,1783004,+,4589
129,BUMA.1121.00110,2,3140084,3144685,+,4601
129,BUMA.1121.00109,2,1474131,1478732,-,4601
129,BUMA.1121.00077,2,470952,475553,-,4601
129,BUMA.1121.00027,2,1068377,1072969,+,4592
129,BUMA.1121.00026,2,620329,624922,+,4593
129,BUMA.1121.00021,2,472850,477441,+,4591
129,BUMA.1121.00023,2,62540,67131,+,4591
129,BUMA.1121.00022,2,1563015,1567608,+,4593
129,BUMA.1121.00034,2,21320,25913,+,4593
129,BUMA.1121.00025,2,1631890,1636481,+,4591
129,BUMA.1121.00031,2,2348583,2353174,+,4591
129,BUMA.1121.00007,2,21322,25920,+,4598
129,BUMA.1121.00097,2,3011924,3016517,+,4593
129,BUMA.1121.00008,2,21320,25913,+,4593
129,BUMA.1121.00059,2,460742,465333,-,4591
129,BUMA.1121.00002,2,548878,553471,-,4593
129,BUMA.1121.00004,2,21320,25913,+,4593
129,BUMA.1121.00005,2,744577,749175,-,4598
129,BUMA.1121.00111,2,2451051,2455642,+,4591
129,BUMA.1121.00006,2,2300933,2305526,-,4593
129,BUMA.1121.00009,2,1812921,1817511,+,4590
129,BUMA.1121.00094,2,16993,21578,+,4585
129,BUMA.1121.00101,2,249468,254048,-,4580
129,BUMA.1121.00066,2,16994,21585,+,4591
129,BUMA.1121.00095,2,2032999,2037574,+,4575
129,BUMA.1121.00112,2,1185712,1190303,-,4591
129,BUMA.1121.00042,2,1690346,1694939,-,4593
129,BUMA.1121.00032,2,566938,571531,+,4593
129,BUMA.1121.00090,2,911279,915870,+,4591
129,BUMA.1121.00020,2,21313,25906,+,4593
129,BUMA.1121.00089,2,16972,21557,+,4585
129,BUMA.1121.00051,2,17000,21585,+,4585
129,BUMA.1121.00001,2,2249218,2253809,-,4591
129,BUMA.1121.00045,2,3060078,3064671,+,4593
129,BUMA.1121.00043,2,2435563,2440154,-,4591
129,BUMA.1121.00063,2,16980,21571,+,4591
129,BUMA.1121.00079,2,17001,21586,+,4585
129,BUMA.1121.00071,2,16955,21546,+,4591
129,BUMA.1121.00086,2,18021,22614,+,4593
129,BUMA.1121.00024,2,21320,25913,+,4593
129,BUMA.1121.00010,2,1400767,1405360,-,4593
129,BUMA.1121.00040,2,51421,56014,-,4593
129,BUMA.1121.00093,2,2923506,2928099,-,4593
129,BUMA.1121.00091,2,458745,463338,-,4593
129,BUMA.1121.00107,2,634619,639209,-,4590
129,BUMA.1121.00088,2,3151785,3156376,+,4591
129,BUMA.1121.00047,2,946069,950654,+,4585
129,BUMA.1121.00019,2,21313,25906,+,4593
129,BUMA.1121.00087,2,580584,585177,-,4593
129,BUMA.1121.00039,2,796068,800659,-,4591
129,BUMA.1121.00030,2,2095845,2100438,-,4593
129,BUMA.1121.00016,2,591274,595865,-,4591
129,BUMA.1121.00092,2,16870,21463,+,4593
129,BUMA.1121.00085,2,1182212,1186805,+,4593
129,BUMA.1121.00046,2,1105717,1110310,-,4593
129,BUMA.1121.00003,2,1329514,1334120,+,4606
129,BUMA.1121.00054,2,2101025,2105618,-,4593
129,BUMA.1121.00015,2,270359,274952,+,4593
129,BUMA.1121.00105,2,2492429,2497020,-,4591
129,BUMA.1121.00052,2,135871,140464,+,4593
129,BUMA.1121.00053,2,240625,245216,+,4591
129,BUMA.1121.00057,2,2076940,2081533,-,4593
129,BUMA.1121.00108,2,208991,213582,+,4591
129,BUMA.1121.00050,2,3275,7868,+,4593
129,BUMA.1121.00104,2,91778,96371,+,4593
129,BUMA.1121.00014,2,15217,19808,+,4591
129,BUMA.1121.00036,2,1573176,1577769,-,4593
129,BUMA.1121.00038,2,2202134,2206727,-,4593
129,BUMA.1121.00098,2,226184,230777,+,4593
129,BUMA.1121.00078,2,3214637,3219230,-,4593
129,BUMA.1121.00029,2,1361022,1365613,-,4591
129,BUMA.1121.00099,2,159936,164527,+,4591
129,BUMA.1121.00103,2,1840221,1844817,+,4596
129,BUMA.1121.00102,2,19166,23757,+,4591
129,BUMA.1121.00028,2,21320,25913,+,4593
129,BUMA.1121.00075,2,2842267,2846860,-,4593
129,BUMA.1121.00044,2,72507,77100,+,4593
129,BUMA.1121.00076,2,898750,903343,+,4593
129,BUMA.1121.00074,2,1227563,1232154,-,4591
129,BUMA.1121.00073,2,16969,21560,+,4591
129,BUMA.1121.00083,2,1813941,1818532,+,4591
129,BUMA.1121.00035,2,1444593,1449184,-,4591
129,BUMA.1121.00072,2,16944,21535,+,4591
129,BUMA.1121.00056,2,870042,874627,-,4585
129,BUMA.1121.00081,2,18020,22613,+,4593
129,BUMA.1121.00033,2,670507,675098,+,4591
129,BUMA.1121.00061,2,16993,21584,+,4591
129,BUMA.1121.00062,2,1756814,1761407,-,4593
129,BUMA.1121.00064,2,16968,21568,+,4600
129,BUMA.1121.00060,2,2200450,2205043,-,4593
129,BUMA.1121.00069,2,16994,21585,+,4591
129,BUMA.1121.00070,2,16965,21556,+,4591
129,BUMA.1121.00068,2,1733947,1738543,+,4596
129,BUMA.1121.00067,2,787034,791625,-,4591
129,BUMA.1121.00037,2,262543,267134,+,4591
129,BUMA.1121.00065,2,16896,21487,+,4591
129,BUMA.1121.00058,2,531279,535870,+,4591
129,BUMA.1121.00041,2,893311,897918,+,4607
129,BUMA.1121.00084,2,1856013,1860604,+,4591
129,BUMA.1121.00096,2,128400,132991,+,4591
129,BUMA.1121.00080,2,16951,21542,+,4591
129,BUMA.1121.00013,2,448453,453046,+,4593
129,BUMA.1121.00100,2,1180955,1185555,+,4600
129,BUMA.1121.00012,2,1816033,1820624,-,4591
129,BUMA.1121.00018,2,696554,701145,-,4591
129,BUMA.1121.00048,2,757463,762056,+,4593
129,BUMA.1121.00106,2,2431849,2436447,+,4598
129,BUMA.1121.00017,2,21320,25913,+,4593
129,BUMA.1121.00082,2,16998,21589,+,4591
130,BUMA.1121.00049,2,1798932,1811179,+,12247
130,BUMA.1121.00055,2,2656468,2668686,-,12218
130,BUMA.1121.00011,2,1783006,1795256,+,12250
130,BUMA.1121.00110,2,3144687,3156911,+,12224
130,BUMA.1121.00109,2,1461918,1474130,-,12212
130,BUMA.1121.00077,2,458728,470951,-,12223
130,BUMA.1121.00027,2,1072971,1085197,+,12226
130,BUMA.1121.00026,2,624924,637132,+,12208
130,BUMA.1121.00021,2,477443,489729,+,12286
130,BUMA.1121.00023,2,67133,79446,+,12313
130,BUMA.1121.00022,2,1567610,1579818,+,12208
130,BUMA.1121.00034,2,25915,38123,+,12208
130,BUMA.1121.00025,2,1636483,1648750,+,12267
130,BUMA.1121.00031,2,2353176,2365426,+,12250
130,BUMA.1121.00007,2,25922,38169,+,12247
130,BUMA.1121.00097,2,3016519,3028749,+,12230
130,BUMA.1121.00008,2,25915,38123,+,12208
130,BUMA.1121.00059,2,448509,460741,-,12232
130,BUMA.1121.00002,2,536668,548877,-,12209
130,BUMA.1121.00004,2,25915,38123,+,12208
130,BUMA.1121.00005,2,732347,744576,-,12229
130,BUMA.1121.00111,2,2455644,2467876,+,12232
130,BUMA.1121.00006,2,2288723,2300932,-,12209
130,BUMA.1121.00009,2,1817513,1829706,+,12193
130,BUMA.1121.00094,2,21580,33811,+,12231
130,BUMA.1121.00101,2,237253,249467,-,12214
130,BUMA.1121.00066,2,21587,33798,+,12211
130,BUMA.1121.00095,2,2037576,2049799,+,12223
130,BUMA.1121.00112,2,1173454,1185711,-,12257
130,BUMA.1121.00042,2,1678135,1690345,-,12210
130,BUMA.1121.00032,2,571533,583741,+,12208
130,BUMA.1121.00090,2,915872,928121,+,12249
130,BUMA.1121.00020,2,25908,38116,+,12208
130,BUMA.1121.00089,2,21559,33790,+,12231
130,BUMA.1121.00051,2,21587,33818,+,12231
130,BUMA.1121.00001,2,2236966,2249217,-,12251
130,BUMA.1121.00045,2,3064673,3076900,+,12227
130,BUMA.1121.00043,2,2423321,2435562,-,12241
130,BUMA.1121.00063,2,21573,33793,+,12220
130,BUMA.1121.00079,2,21588,33816,+,12228
130,BUMA.1121.00071,2,21548,33768,+,12220
130,BUMA.1121.00086,2,22616,34824,+,12208
130,BUMA.1121.00024,2,25915,38123,+,12208
130,BUMA.1121.00010,2,1388558,1400766,-,12208
130,BUMA.1121.00040,2,39211,51420,-,12209
130,BUMA.1121.00093,2,2911399,2923505,-,12106
130,BUMA.1121.00091,2,446508,458744,-,12236
130,BUMA.1121.00107,2,622373,634618,-,12245
130,BUMA.1121.00088,2,3156378,3168624,+,12246
130,BUMA.1121.00047,2,950656,962887,+,12231
130,BUMA.1121.00019,2,25908,38116,+,12208
130,BUMA.1121.00087,2,568374,580583,-,12209
130,BUMA.1121.00039,2,783807,796067,-,12260
130,BUMA.1121.00030,2,2083635,2095844,-,12209
130,BUMA.1121.00016,2,579022,591273,-,12251
130,BUMA.1121.00092,2,21465,33570,+,12105
130,BUMA.1121.00085,2,1186807,1199015,+,12208
130,BUMA.1121.00046,2,1093507,1105716,-,12209
130,BUMA.1121.00003,2,1347891,1360136,+,12245
130,BUMA.1121.00054,2,2088815,2101024,-,12209
130,BUMA.1121.00015,2,274954,287162,+,12208
130,BUMA.1121.00105,2,2480169,2492428,-,12259
130,BUMA.1121.00052,2,140466,152674,+,12208
130,BUMA.1121.00053,2,245218,257468,+,12250
130,BUMA.1121.00057,2,2064712,2076939,-,12227
130,BUMA.1121.00108,2,213584,225816,+,12232
130,BUMA.1121.00050,2,7870,20078,+,12208
130,BUMA.1121.00104,2,96373,108619,+,12246
130,BUMA.1121.00014,2,19810,32051,+,12241
130,BUMA.1121.00036,2,1560966,1573175,-,12209
130,BUMA.1121.00038,2,2189924,2202133,-,12209
130,BUMA.1121.00098,2,230779,243007,+,12228
130,BUMA.1121.00078,2,3202408,3214636,-,12228
130,BUMA.1121.00029,2,1348770,1361021,-,12251
130,BUMA.1121.00099,2,164529,176776,+,12247
130,BUMA.1121.00103,2,1844819,1857052,+,12233
130,BUMA.1121.00102,2,23759,35959,+,12200
130,BUMA.1121.00028,2,25915,38123,+,12208
130,BUMA.1121.00075,2,2830042,2842266,-,12224
130,BUMA.1121.00044,2,77102,89310,+,12208
130,BUMA.1121.00076,2,903345,915568,+,12223
130,BUMA.1121.00074,2,1215331,1227562,-,12231
130,BUMA.1121.00073,2,21562,33782,+,12220
130,BUMA.1121.00083,2,1818534,1830754,+,12220
130,BUMA.1121.00035,2,1432350,1444592,-,12242
130,BUMA.1121.00072,2,21537,33757,+,12220
130,BUMA.1121.00056,2,857809,870041,-,12232
130,BUMA.1121.00081,2,22615,34823,+,12208
130,BUMA.1121.00033,2,675100,687330,+,12230
130,BUMA.1121.00061,2,21586,33806,+,12220
130,BUMA.1121.00062,2,1744569,1756813,-,12244
130,BUMA.1121.00064,2,21570,33805,+,12235
130,BUMA.1121.00060,2,2188221,2200449,-,12228
130,BUMA.1121.00069,2,21587,33807,+,12220
130,BUMA.1121.00070,2,21558,33778,+,12220
130,BUMA.1121.00068,2,1738545,1750671,+,12126
130,BUMA.1121.00067,2,774802,787033,-,12231
130,BUMA.1121.00037,2,267136,279412,+,12276
130,BUMA.1121.00065,2,21489,33701,+,12212
130,BUMA.1121.00058,2,535872,548122,+,12250
130,BUMA.1121.00041,2,908945,921155,+,12210
130,BUMA.1121.00084,2,1860606,1872829,+,12223
130,BUMA.1121.00096,2,132993,145219,+,12226
130,BUMA.1121.00080,2,21544,33776,+,12232
130,BUMA.1121.00013,2,453048,465256,+,12208
130,BUMA.1121.00100,2,1185557,1197768,+,12211
130,BUMA.1121.00012,2,1803790,1816032,-,12242
130,BUMA.1121.00018,2,684276,696553,-,12277
130,BUMA.1121.00048,2,762058,774266,+,12208
130,BUMA.1121.00106,2,2436449,2448678,+,12229
130,BUMA.1121.00017,2,25915,38123,+,12208
130,BUMA.1121.00082,2,21591,33811,+,12220
131,BUMA.1121.00049,2,1812447,1826980,+,14533
131,BUMA.1121.00055,2,2640795,2655201,-,14406
131,BUMA.1121.00011,2,1796524,1810906,+,14382
131,BUMA.1121.00110,2,3158179,3172545,+,14366
131,BUMA.1121.00109,2,1446355,1460651,-,14296
131,BUMA.1121.00077,2,443095,457461,-,14366
131,BUMA.1121.00027,2,1086465,1100884,+,14419
131,BUMA.1121.00026,2,638400,652850,+,14450
131,BUMA.1121.00021,2,490997,505393,+,14396
131,BUMA.1121.00023,2,80714,95021,+,14307
131,BUMA.1121.00022,2,1582329,1596788,+,14459
131,BUMA.1121.00034,2,40634,54943,+,14309
131,BUMA.1121.00025,2,1650018,1664501,+,14483
131,BUMA.1121.00031,2,2366694,2381243,+,14549
131,BUMA.1121.00007,2,39437,53728,+,14291
131,BUMA.1121.00097,2,3030017,3044593,+,14576
131,BUMA.1121.00008,2,40634,55005,+,14371
131,BUMA.1121.00059,2,432712,447242,-,14530
131,BUMA.1121.00002,2,519719,534159,-,14440
131,BUMA.1121.00004,2,40634,54999,+,14365
131,BUMA.1121.00005,2,716697,731080,-,14383
131,BUMA.1121.00111,2,2469144,2483597,+,14453
131,BUMA.1121.00006,2,2273042,2287456,-,14414
131,BUMA.1121.00009,2,1830974,1845388,+,14414
131,BUMA.1121.00094,2,35079,49512,+,14433
131,BUMA.1121.00101,2,221605,235986,-,14381
131,BUMA.1121.00066,2,35066,49504,+,14438
131,BUMA.1121.00095,2,2051067,2065491,+,14424
131,BUMA.1121.00112,2,1157704,1172187,-,14483
131,BUMA.1121.00042,2,1662451,1676868,-,14417
131,BUMA.1121.00032,2,586252,600652,+,14400
131,BUMA.1121.00090,2,929389,943770,+,14381
131,BUMA.1121.00020,2,40627,54991,+,14364
131,BUMA.1121.00089,2,35058,49499,+,14441
131,BUMA.1121.00051,2,35086,49638,+,14552
131,BUMA.1121.00001,2,2221083,2235699,-,14616
131,BUMA.1121.00045,2,3078168,3092598,+,14430
131,BUMA.1121.00043,2,2407621,2422054,-,14433
131,BUMA.1121.00063,2,35061,49499,+,14438
131,BUMA.1121.00079,2,35084,49541,+,14457
131,BUMA.1121.00071,2,35036,49474,+,14438
131,BUMA.1121.00086,2,37335,51867,+,14532
131,BUMA.1121.00024,2,40634,54998,+,14364
131,BUMA.1121.00010,2,1371588,1386049,-,14461
131,BUMA.1121.00040,2,23472,37944,-,14472
131,BUMA.1121.00093,2,2895615,2910132,-,14517
131,BUMA.1121.00091,2,430754,445259,-,14505
131,BUMA.1121.00107,2,606706,621106,-,14400
131,BUMA.1121.00088,2,3169892,3184328,+,14436
131,BUMA.1121.00047,2,964155,978656,+,14501
131,BUMA.1121.00019,2,40627,54991,+,14364
131,BUMA.1121.00087,2,551395,565863,-,14468
131,BUMA.1121.00039,2,768088,782540,-,14452
131,BUMA.1121.00030,2,2066816,2081124,-,14308
131,BUMA.1121.00016,2,563357,577755,-,14398
131,BUMA.1121.00092,2,34838,49299,+,14461
131,BUMA.1121.00085,2,1200283,1214733,+,14450
131,BUMA.1121.00046,2,1077754,1092240,-,14486
131,BUMA.1121.00003,2,1361404,1376007,+,14603
131,BUMA.1121.00054,2,2073134,2087548,-,14414
131,BUMA.1121.00015,2,288430,302823,+,14393
131,BUMA.1121.00105,2,2464544,2478902,-,14358
131,BUMA.1121.00052,2,153942,168392,+,14450
131,BUMA.1121.00053,2,258736,273191,+,14455
131,BUMA.1121.00057,2,2048978,2063445,-,14467
131,BUMA.1121.00108,2,227084,241454,+,14370
131,BUMA.1121.00050,2,21346,35834,+,14488
131,BUMA.1121.00104,2,109887,124356,+,14469
131,BUMA.1121.00014,2,33319,47776,+,14457
131,BUMA.1121.00036,2,1544029,1558455,-,14426
131,BUMA.1121.00038,2,2174243,2188657,-,14414
131,BUMA.1121.00098,2,244275,258770,+,14495
131,BUMA.1121.00078,2,3186683,3201141,-,14458
131,BUMA.1121.00029,2,1333059,1347503,-,14444
131,BUMA.1121.00099,2,178044,192437,+,14393
131,BUMA.1121.00103,2,1858320,1872778,+,14458
131,BUMA.1121.00102,2,37227,51807,+,14580
131,BUMA.1121.00028,2,40634,54984,+,14350
131,BUMA.1121.00075,2,2814205,2828775,-,14570
131,BUMA.1121.00044,2,91821,106130,+,14309
131,BUMA.1121.00076,2,916836,931413,+,14577
131,BUMA.1121.00074,2,1199674,1214064,-,14390
131,BUMA.1121.00073,2,35050,49488,+,14438
131,BUMA.1121.00083,2,1832022,1846460,+,14438
131,BUMA.1121.00035,2,1416609,1431083,-,14474
131,BUMA.1121.00072,2,35025,49463,+,14438
131,BUMA.1121.00056,2,842053,856542,-,14489
131,BUMA.1121.00081,2,36091,50498,+,14407
131,BUMA.1121.00033,2,688598,702910,+,14312
131,BUMA.1121.00061,2,35074,49512,+,14438
131,BUMA.1121.00062,2,1728886,1743302,-,14416
131,BUMA.1121.00064,2,35073,49531,+,14458
131,BUMA.1121.00060,2,2172531,2186954,-,14423
131,BUMA.1121.00069,2,35075,49506,+,14431
131,BUMA.1121.00070,2,35046,49484,+,14438
131,BUMA.1121.00068,2,1751939,1766248,+,14309
131,BUMA.1121.00067,2,759086,773535,-,14449
131,BUMA.1121.00037,2,280680,295124,+,14444
131,BUMA.1121.00065,2,34969,49395,+,14426
131,BUMA.1121.00058,2,549390,563847,+,14457
131,BUMA.1121.00041,2,922423,936939,+,14516
131,BUMA.1121.00084,2,1874097,1888557,+,14460
131,BUMA.1121.00096,2,146487,161023,+,14536
131,BUMA.1121.00080,2,35044,49542,+,14498
131,BUMA.1121.00013,2,466524,481143,+,14619
131,BUMA.1121.00100,2,1199036,1213552,+,14516
131,BUMA.1121.00012,2,1788124,1802523,-,14399
131,BUMA.1121.00018,2,668540,683009,-,14469
131,BUMA.1121.00048,2,775534,789948,+,14414
131,BUMA.1121.00106,2,2449946,2464471,+,14525
131,BUMA.1121.00017,2,40634,54943,+,14309
131,BUMA.1121.00082,2,35079,49517,+,14438
132,BUMA.1121.00049,2,1830698,1836847,+,6149
132,BUMA.1121.00109,2,1436479,1442622,-,6143
132,BUMA.1121.00104,2,128074,134223,+,6149
133,BUMA.1121.00049,2,1836850,1840291,+,3441
133,BUMA.1121.00104,2,134226,137669,+,3443
134,BUMA.1121.00049,2,1846042,1858089,+,12047
134,BUMA.1121.00104,2,141073,153120,+,12047
135,BUMA.1121.00049,2,1861918,1869042,+,7124
135,BUMA.1121.00055,2,2626666,2633836,-,7170
135,BUMA.1121.00011,2,1817878,1825040,+,7162
135,BUMA.1121.00110,2,3174759,3181880,+,7121
135,BUMA.1121.00109,2,1409483,1416608,-,7125
135,BUMA.1121.00077,2,433759,440881,-,7122
135,BUMA.1121.00027,2,1100907,1108030,+,7123
135,BUMA.1121.00026,2,652873,660005,+,7132
135,BUMA.1121.00021,2,512352,519459,+,7107
135,BUMA.1121.00023,2,101980,109102,+,7122
135,BUMA.1121.00022,2,1596811,1603955,+,7144
135,BUMA.1121.00034,2,54966,62086,+,7120
135,BUMA.1121.00025,2,1671460,1678569,+,7109
135,BUMA.1121.00031,2,2388201,2395325,+,7124
135,BUMA.1121.00007,2,60687,67836,+,7149
135,BUMA.1121.00097,2,3044616,3051724,+,7108
135,BUMA.1121.00008,2,55028,62148,+,7120
135,BUMA.1121.00059,2,423350,430499,-,7149
135,BUMA.1121.00002,2,512575,519696,-,7121
135,BUMA.1121.00004,2,55022,62142,+,7120
135,BUMA.1121.00005,2,702601,709738,-,7137
135,BUMA.1121.00111,2,2490556,2497665,+,7109
135,BUMA.1121.00006,2,2265874,2273019,-,7145
135,BUMA.1121.00009,2,1847601,1854725,+,7124
135,BUMA.1121.00094,2,51725,58810,+,7085
135,BUMA.1121.00101,2,207537,214646,-,7109
135,BUMA.1121.00066,2,49525,56615,+,7090
135,BUMA.1121.00112,2,1148346,1155482,-,7136
135,BUMA.1121.00042,2,1655271,1662428,-,7157
135,BUMA.1121.00032,2,600675,607795,+,7120
135,BUMA.1121.00090,2,950729,957874,+,7145
135,BUMA.1121.00020,2,55014,62134,+,7120
135,BUMA.1121.00089,2,51712,58797,+,7085
135,BUMA.1121.00051,2,51851,58936,+,7085
135,BUMA.1121.00001,2,2207003,2214125,-,7122
135,BUMA.1121.00045,2,3094812,3101960,+,7148
135,BUMA.1121.00043,2,2393546,2400668,-,7122
135,BUMA.1121.00063,2,49522,56609,+,7087
135,BUMA.1121.00079,2,51755,58842,+,7087
135,BUMA.1121.00071,2,49497,56586,+,7089
135,BUMA.1121.00086,2,51890,59046,+,7156
135,BUMA.1121.00024,2,55021,62141,+,7120
135,BUMA.1121.00010,2,1364444,1371565,-,7121
135,BUMA.1121.00040,2,16328,23449,-,7121
135,BUMA.1121.00093,2,2886250,2893401,-,7151
135,BUMA.1121.00091,2,421415,428540,-,7125
135,BUMA.1121.00088,2,1796,8922,+,7126
135,BUMA.1121.00047,2,980870,987991,+,7121
135,BUMA.1121.00019,2,55014,62134,+,7120
135,BUMA.1121.00087,2,544215,551372,-,7157
135,BUMA.1121.00039,2,754016,761129,-,7113
135,BUMA.1121.00030,2,2059672,2066793,-,7121
135,BUMA.1121.00016,2,549266,556400,-,7134
135,BUMA.1121.00092,2,51513,58663,+,7150
135,BUMA.1121.00085,2,1214756,1221864,+,7108
135,BUMA.1121.00046,2,1070598,1077731,-,7133
135,BUMA.1121.00003,2,1381404,1388516,+,7112
135,BUMA.1121.00054,2,2065966,2073111,-,7145
135,BUMA.1121.00015,2,302846,309990,+,7144
135,BUMA.1121.00105,2,2450452,2457586,-,7134
135,BUMA.1121.00052,2,168415,175523,+,7108
135,BUMA.1121.00053,2,275405,282531,+,7126
135,BUMA.1121.00057,2,2041831,2048955,-,7124
135,BUMA.1121.00108,2,241477,248623,+,7146
135,BUMA.1121.00050,2,35857,42989,+,7132
135,BUMA.1121.00104,2,156949,164076,+,7127
135,BUMA.1121.00014,2,54734,61858,+,7124
135,BUMA.1121.00036,2,1536873,1544006,-,7133
135,BUMA.1121.00038,2,2167075,2174220,-,7145
135,BUMA.1121.00098,2,258793,265907,+,7114
135,BUMA.1121.00078,2,3172625,3179724,-,7099
135,BUMA.1121.00029,2,1318980,1326101,-,7121
135,BUMA.1121.00099,2,192460,199595,+,7135
135,BUMA.1121.00103,2,1874992,1882091,+,7099
135,BUMA.1121.00102,2,51830,58920,+,7090
135,BUMA.1121.00028,2,55007,62127,+,7120
135,BUMA.1121.00075,2,2804866,2811991,-,7125
135,BUMA.1121.00044,2,106153,113273,+,7120
135,BUMA.1121.00076,2,933627,940751,+,7124
135,BUMA.1121.00074,2,1190336,1197460,-,7124
135,BUMA.1121.00073,2,49511,56601,+,7090
135,BUMA.1121.00083,2,1846483,1853573,+,7090
135,BUMA.1121.00035,2,1402540,1409650,-,7110
135,BUMA.1121.00072,2,49485,56572,+,7087
135,BUMA.1121.00056,2,832754,839840,-,7086
135,BUMA.1121.00081,2,50521,57665,+,7144
135,BUMA.1121.00033,2,709867,717003,+,7136
135,BUMA.1121.00061,2,49535,56625,+,7090
135,BUMA.1121.00062,2,1719585,1726673,-,7088
135,BUMA.1121.00064,2,51744,58880,+,7136
135,BUMA.1121.00060,2,2163168,2170317,-,7149
135,BUMA.1121.00069,2,49529,56619,+,7090
135,BUMA.1121.00070,2,49505,56595,+,7090
135,BUMA.1121.00068,2,1768462,1775574,+,7112
135,BUMA.1121.00067,2,749786,756872,-,7086
135,BUMA.1121.00037,2,302077,309189,+,7112
135,BUMA.1121.00065,2,49418,56504,+,7086
135,BUMA.1121.00058,2,566061,573173,+,7112
135,BUMA.1121.00041,2,939153,946265,+,7112
135,BUMA.1121.00084,2,1890770,1897906,+,7136
135,BUMA.1121.00096,2,163237,170349,+,7112
135,BUMA.1121.00080,2,51756,58843,+,7087
135,BUMA.1121.00013,2,481166,488274,+,7108
135,BUMA.1121.00100,2,1215765,1222898,+,7133
135,BUMA.1121.00012,2,1774031,1781165,-,7134
135,BUMA.1121.00018,2,654473,661583,-,7110
135,BUMA.1121.00048,2,789971,797115,+,7144
135,BUMA.1121.00106,2,2466685,2473798,+,7113
135,BUMA.1121.00017,2,54966,62086,+,7120
135,BUMA.1121.00082,2,49540,56630,+,7090
136,BUMA.1121.00049,2,1869044,1876059,+,7015
136,BUMA.1121.00055,2,2619732,2626665,-,6933
136,BUMA.1121.00011,2,1825042,1832057,+,7015
136,BUMA.1121.00110,2,3181882,3188897,+,7015
136,BUMA.1121.00109,2,1402543,1409482,-,6939
136,BUMA.1121.00077,2,426743,433758,-,7015
136,BUMA.1121.00027,2,1108032,1115046,+,7014
136,BUMA.1121.00026,2,660007,667018,+,7011
136,BUMA.1121.00021,2,519461,526475,+,7014
136,BUMA.1121.00023,2,109104,116118,+,7014
136,BUMA.1121.00022,2,1603957,1610968,+,7011
136,BUMA.1121.00034,2,62088,69099,+,7011
136,BUMA.1121.00025,2,1678571,1685585,+,7014
136,BUMA.1121.00031,2,2395327,2402341,+,7014
136,BUMA.1121.00007,2,67838,74846,+,7008
136,BUMA.1121.00097,2,3051726,3058735,+,7009
136,BUMA.1121.00008,2,62150,69161,+,7011
136,BUMA.1121.00059,2,416319,423349,-,7030
136,BUMA.1121.00002,2,505562,512574,-,7012
136,BUMA.1121.00004,2,62144,69155,+,7011
136,BUMA.1121.00005,2,695578,702600,-,7022
136,BUMA.1121.00111,2,2497667,2504681,+,7014
136,BUMA.1121.00006,2,2258861,2265873,-,7012
136,BUMA.1121.00009,2,1854727,1861741,+,7014
136,BUMA.1121.00094,2,58812,65751,+,6939
136,BUMA.1121.00101,2,200521,207536,-,7015
136,BUMA.1121.00066,2,56617,63631,+,7014
136,BUMA.1121.00095,2,2065956,2072906,+,6950
136,BUMA.1121.00112,2,1141330,1148345,-,7015
136,BUMA.1121.00042,2,1648258,1655270,-,7012
136,BUMA.1121.00032,2,607797,614808,+,7011
136,BUMA.1121.00090,2,957876,964890,+,7014
136,BUMA.1121.00020,2,62136,69147,+,7011
136,BUMA.1121.00089,2,58799,65738,+,6939
136,BUMA.1121.00051,2,58938,65877,+,6939
136,BUMA.1121.00001,2,2199987,2207002,-,7015
136,BUMA.1121.00045,2,3101962,3108976,+,7014
136,BUMA.1121.00043,2,2386530,2393545,-,7015
136,BUMA.1121.00063,2,56611,63625,+,7014
136,BUMA.1121.00079,2,58844,65783,+,6939
136,BUMA.1121.00071,2,56588,63602,+,7014
136,BUMA.1121.00086,2,59048,66059,+,7011
136,BUMA.1121.00024,2,62143,69154,+,7011
136,BUMA.1121.00010,2,1357431,1364443,-,7012
136,BUMA.1121.00040,2,9315,16327,-,7012
136,BUMA.1121.00093,2,2879233,2886249,-,7016
136,BUMA.1121.00091,2,414399,421414,-,7015
136,BUMA.1121.00107,2,599290,606241,-,6951
136,BUMA.1121.00088,2,8924,15945,+,7021
136,BUMA.1121.00047,2,987993,994932,+,6939
136,BUMA.1121.00019,2,62136,69147,+,7011
136,BUMA.1121.00087,2,537202,544214,-,7012
136,BUMA.1121.00039,2,747000,754015,-,7015
136,BUMA.1121.00030,2,2052659,2059671,-,7012
136,BUMA.1121.00016,2,542250,549265,-,7015
136,BUMA.1121.00092,2,58665,65680,+,7015
136,BUMA.1121.00085,2,1221866,1228877,+,7011
136,BUMA.1121.00046,2,1063585,1070597,-,7012
136,BUMA.1121.00003,2,1388518,1395532,+,7014
136,BUMA.1121.00054,2,2058953,2065965,-,7012
136,BUMA.1121.00015,2,309992,317003,+,7011
136,BUMA.1121.00105,2,2443436,2450451,-,7015
136,BUMA.1121.00052,2,175525,182536,+,7011
136,BUMA.1121.00053,2,282533,289547,+,7014
136,BUMA.1121.00057,2,2034815,2041830,-,7015
136,BUMA.1121.00108,2,248625,255639,+,7014
136,BUMA.1121.00050,2,42991,50002,+,7011
136,BUMA.1121.00104,2,164078,171093,+,7015
136,BUMA.1121.00014,2,61860,68874,+,7014
136,BUMA.1121.00036,2,1529860,1536872,-,7012
136,BUMA.1121.00038,2,2160062,2167074,-,7012
136,BUMA.1121.00098,2,265909,272923,+,7014
136,BUMA.1121.00078,2,3165609,3172624,-,7015
136,BUMA.1121.00029,2,1311964,1318979,-,7015
136,BUMA.1121.00099,2,199597,206611,+,7014
136,BUMA.1121.00103,2,1882093,1889113,+,7020
136,BUMA.1121.00102,2,58922,65944,+,7022
136,BUMA.1121.00028,2,62129,69140,+,7011
136,BUMA.1121.00075,2,2797849,2804865,-,7016
136,BUMA.1121.00044,2,113275,120286,+,7011
136,BUMA.1121.00076,2,940753,947768,+,7015
136,BUMA.1121.00074,2,1183320,1190335,-,7015
136,BUMA.1121.00073,2,56603,63617,+,7014
136,BUMA.1121.00083,2,1853575,1860589,+,7014
136,BUMA.1121.00035,2,1395524,1402539,-,7015
136,BUMA.1121.00072,2,56574,63588,+,7014
136,BUMA.1121.00056,2,825813,832753,-,6940
136,BUMA.1121.00081,2,57667,64678,+,7011
136,BUMA.1121.00033,2,717005,724019,+,7014
136,BUMA.1121.00061,2,56627,63641,+,7014
136,BUMA.1121.00062,2,1712561,1719584,-,7023
136,BUMA.1121.00064,2,58882,65814,+,6932
136,BUMA.1121.00060,2,2156152,2163167,-,7015
136,BUMA.1121.00069,2,56621,63635,+,7014
136,BUMA.1121.00070,2,56597,63611,+,7014
136,BUMA.1121.00068,2,1775576,1782586,+,7010
136,BUMA.1121.00067,2,742852,749785,-,6933
136,BUMA.1121.00037,2,309191,316205,+,7014
136,BUMA.1121.00065,2,56506,63520,+,7014
136,BUMA.1121.00058,2,573175,580189,+,7014
136,BUMA.1121.00041,2,946267,953289,+,7022
136,BUMA.1121.00084,2,1897908,1904922,+,7014
136,BUMA.1121.00096,2,170351,177365,+,7014
136,BUMA.1121.00080,2,58845,65859,+,7014
136,BUMA.1121.00013,2,488276,495287,+,7011
136,BUMA.1121.00100,2,1222900,1229914,+,7014
136,BUMA.1121.00012,2,1767015,1774030,-,7015
136,BUMA.1121.00018,2,647457,654472,-,7015
136,BUMA.1121.00048,2,797117,804128,+,7011
136,BUMA.1121.00106,2,2473800,2480765,+,6965
136,BUMA.1121.00017,2,62088,69099,+,7011
136,BUMA.1121.00082,2,56632,63646,+,7014
137,BUMA.1121.00049,2,1877189,1883576,+,6387
137,BUMA.1121.00055,2,2612206,2618592,-,6386
137,BUMA.1121.00011,2,1833181,1839567,+,6386
137,BUMA.1121.00110,2,3190029,3196415,+,6386
137,BUMA.1121.00109,2,1393718,1401419,-,7701
137,BUMA.1121.00077,2,419226,425612,-,6386
137,BUMA.1121.00027,2,1116177,1122564,+,6387
137,BUMA.1121.00026,2,668134,674509,+,6375
137,BUMA.1121.00021,2,527606,533992,+,6386
137,BUMA.1121.00023,2,117249,123635,+,6386
137,BUMA.1121.00022,2,1612084,1618446,+,6362
137,BUMA.1121.00034,2,70215,76577,+,6362
137,BUMA.1121.00025,2,1686716,1693102,+,6386
137,BUMA.1121.00031,2,2403480,2409866,+,6386
137,BUMA.1121.00007,2,75971,82358,+,6387
137,BUMA.1121.00097,2,3059850,3066236,+,6386
137,BUMA.1121.00008,2,70277,76639,+,6362
137,BUMA.1121.00059,2,407364,413751,-,6387
137,BUMA.1121.00002,2,498085,504447,-,6362
137,BUMA.1121.00004,2,70271,76633,+,6362
137,BUMA.1121.00005,2,688077,694464,-,6387
137,BUMA.1121.00111,2,2505820,2512206,+,6386
137,BUMA.1121.00006,2,2251372,2257746,-,6374
137,BUMA.1121.00009,2,1862873,1869258,+,6385
137,BUMA.1121.00094,2,66876,73263,+,6387
137,BUMA.1121.00101,2,193007,199393,-,6386
137,BUMA.1121.00066,2,64762,71149,+,6387
137,BUMA.1121.00095,2,2074029,2080416,+,6387
137,BUMA.1121.00112,2,1119621,1125996,-,6375
137,BUMA.1121.00042,2,1640822,1647143,-,6321
137,BUMA.1121.00032,2,615924,622286,+,6362
137,BUMA.1121.00090,2,966029,972415,+,6386
137,BUMA.1121.00020,2,70263,76625,+,6362
137,BUMA.1121.00089,2,66863,73250,+,6387
137,BUMA.1121.00051,2,67002,73389,+,6387
137,BUMA.1121.00001,2,2192455,2198841,-,6386
137,BUMA.1121.00045,2,3124319,3130694,+,6375
137,BUMA.1121.00043,2,2378999,2385384,-,6385
137,BUMA.1121.00063,2,64756,71143,+,6387
137,BUMA.1121.00079,2,66908,73295,+,6387
137,BUMA.1121.00071,2,64733,71120,+,6387
137,BUMA.1121.00086,2,67175,73537,+,6362
137,BUMA.1121.00024,2,70270,76632,+,6362
137,BUMA.1121.00010,2,1349954,1356316,-,6362
137,BUMA.1121.00040,2,1826,8200,-,6374
137,BUMA.1121.00093,2,2871717,2878104,-,6387
137,BUMA.1121.00091,2,406874,413261,-,6387
137,BUMA.1121.00107,2,591788,598174,-,6386
137,BUMA.1121.00088,2,17070,23456,+,6386
137,BUMA.1121.00047,2,996057,1002444,+,6387
137,BUMA.1121.00019,2,70263,76625,+,6362
137,BUMA.1121.00087,2,529725,536087,-,6362
137,BUMA.1121.00039,2,738129,744500,-,6371
137,BUMA.1121.00030,2,2045182,2051544,-,6362
137,BUMA.1121.00016,2,534733,541119,-,6386
137,BUMA.1121.00092,2,66810,73197,+,6387
137,BUMA.1121.00085,2,1229993,1236366,+,6373
137,BUMA.1121.00046,2,1056096,1062470,-,6374
137,BUMA.1121.00003,2,1396664,1403049,+,6385
137,BUMA.1121.00054,2,2051464,2057838,-,6374
137,BUMA.1121.00015,2,318119,324493,+,6374
137,BUMA.1121.00105,2,2435919,2442306,-,6387
137,BUMA.1121.00052,2,183652,190025,+,6373
137,BUMA.1121.00053,2,290680,297066,+,6386
137,BUMA.1121.00057,2,2027298,2033685,-,6387
137,BUMA.1121.00108,2,256764,263150,+,6386
137,BUMA.1121.00050,2,51118,57492,+,6374
137,BUMA.1121.00104,2,172223,178610,+,6387
137,BUMA.1121.00014,2,70013,76400,+,6387
137,BUMA.1121.00036,2,1522383,1528745,-,6362
137,BUMA.1121.00038,2,2152573,2158947,-,6374
137,BUMA.1121.00098,2,274048,280435,+,6387
137,BUMA.1121.00078,2,3158108,3164494,-,6386
137,BUMA.1121.00029,2,1304424,1310810,-,6386
137,BUMA.1121.00099,2,207735,214121,+,6386
137,BUMA.1121.00103,2,1890235,1896621,+,6386
137,BUMA.1121.00102,2,67092,73478,+,6386
137,BUMA.1121.00028,2,70256,76618,+,6362
137,BUMA.1121.00075,2,2790341,2796727,-,6386
137,BUMA.1121.00044,2,121402,127764,+,6362
137,BUMA.1121.00076,2,948891,955277,+,6386
137,BUMA.1121.00074,2,1175813,1182200,-,6387
137,BUMA.1121.00073,2,64747,71134,+,6387
137,BUMA.1121.00083,2,1861720,1868107,+,6387
137,BUMA.1121.00035,2,1387984,1394370,-,6386
137,BUMA.1121.00072,2,64719,71106,+,6387
137,BUMA.1121.00056,2,818302,824689,-,6387
137,BUMA.1121.00081,2,65794,72168,+,6374
137,BUMA.1121.00033,2,725142,731528,+,6386
137,BUMA.1121.00061,2,64772,71159,+,6387
137,BUMA.1121.00062,2,1705059,1711445,-,6386
137,BUMA.1121.00064,2,66939,73326,+,6387
137,BUMA.1121.00060,2,2134435,2140810,-,6375
137,BUMA.1121.00069,2,64765,71152,+,6387
137,BUMA.1121.00070,2,64740,71127,+,6387
137,BUMA.1121.00068,2,1783710,1790079,+,6369
137,BUMA.1121.00067,2,735335,741722,-,6387
137,BUMA.1121.00037,2,317336,323722,+,6386
137,BUMA.1121.00065,2,64668,71055,+,6387
137,BUMA.1121.00058,2,581320,587706,+,6386
137,BUMA.1121.00041,2,954405,960791,+,6386
137,BUMA.1121.00084,2,1906053,1912439,+,6386
137,BUMA.1121.00096,2,178487,184873,+,6386
137,BUMA.1121.00080,2,66980,73367,+,6387
137,BUMA.1121.00013,2,496403,502776,+,6373
137,BUMA.1121.00100,2,1231038,1237424,+,6386
137,BUMA.1121.00012,2,1759491,1765877,-,6386
137,BUMA.1121.00018,2,639941,646327,-,6386
137,BUMA.1121.00048,2,805244,811618,+,6374
137,BUMA.1121.00106,2,2481895,2488282,+,6387
137,BUMA.1121.00017,2,70215,76577,+,6362
137,BUMA.1121.00082,2,64777,71164,+,6387
138,BUMA.1121.00049,2,1887042,1891183,+,4141
138,BUMA.1121.00055,2,2604628,2608762,-,4134
138,BUMA.1121.00011,2,1843035,1847155,+,4120
138,BUMA.1121.00110,2,3199842,3203971,+,4129
138,BUMA.1121.00109,2,1386162,1390283,-,4121
138,BUMA.1121.00077,2,411670,415799,-,4129
138,BUMA.1121.00027,2,1126015,1130152,+,4137
138,BUMA.1121.00026,2,677890,682025,+,4135
138,BUMA.1121.00021,2,537468,541603,+,4135
138,BUMA.1121.00023,2,127072,131207,+,4135
138,BUMA.1121.00022,2,1621836,1625971,+,4135
138,BUMA.1121.00034,2,79967,84102,+,4135
138,BUMA.1121.00025,2,1696553,1700688,+,4135
138,BUMA.1121.00031,2,2413317,2417435,+,4118
138,BUMA.1121.00007,2,85785,89923,+,4138
138,BUMA.1121.00097,2,3069716,3073835,+,4119
138,BUMA.1121.00008,2,80029,84164,+,4135
138,BUMA.1121.00059,2,399766,403907,-,4141
138,BUMA.1121.00002,2,490553,494688,-,4135
138,BUMA.1121.00004,2,80023,84158,+,4135
138,BUMA.1121.00005,2,680516,684650,-,4134
138,BUMA.1121.00111,2,2515650,2519785,+,4135
138,BUMA.1121.00006,2,2243847,2247982,-,4135
138,BUMA.1121.00009,2,1872683,1876841,+,4158
138,BUMA.1121.00094,2,76690,80832,+,4142
138,BUMA.1121.00101,2,185445,189581,-,4136
138,BUMA.1121.00066,2,74598,78727,+,4129
138,BUMA.1121.00095,2,2083843,2087976,+,4133
138,BUMA.1121.00112,2,1112056,1116197,-,4141
138,BUMA.1121.00032,2,625676,629811,+,4135
138,BUMA.1121.00090,2,975866,980004,+,4138
138,BUMA.1121.00020,2,80015,84150,+,4135
138,BUMA.1121.00089,2,76677,80819,+,4142
138,BUMA.1121.00051,2,76816,80958,+,4142
138,BUMA.1121.00001,2,2184859,2188997,-,4138
138,BUMA.1121.00045,2,3134119,3138260,+,4141
138,BUMA.1121.00043,2,2371467,2375602,-,4135
138,BUMA.1121.00063,2,74591,78712,+,4121
138,BUMA.1121.00079,2,76721,80863,+,4142
138,BUMA.1121.00071,2,74569,78690,+,4121
138,BUMA.1121.00086,2,76927,81062,+,4135
138,BUMA.1121.00024,2,80022,84157,+,4135
138,BUMA.1121.00010,2,1342422,1346557,-,4135
138,BUMA.1121.00040,2,2222090,2226169,-,4079
138,BUMA.1121.00093,2,2864113,2868253,-,4140
138,BUMA.1121.00091,2,399304,403438,-,4134
138,BUMA.1121.00107,2,584194,588322,-,4128
138,BUMA.1121.00088,2,26914,31056,+,4142
138,BUMA.1121.00047,2,1005871,1010012,+,4141
138,BUMA.1121.00019,2,80015,84150,+,4135
138,BUMA.1121.00087,2,522200,526335,-,4135
138,BUMA.1121.00039,2,730541,734662,-,4121
138,BUMA.1121.00030,2,2037657,2041792,-,4135
138,BUMA.1121.00016,2,527147,531282,-,4135
138,BUMA.1121.00092,2,76661,80801,+,4140
138,BUMA.1121.00085,2,1239756,1243891,+,4135
138,BUMA.1121.00046,2,1048563,1052698,-,4135
138,BUMA.1121.00003,2,1406484,1410604,+,4120
138,BUMA.1121.00054,2,2043939,2048074,-,4135
138,BUMA.1121.00015,2,327883,332018,+,4135
138,BUMA.1121.00105,2,2428325,2432466,-,4141
138,BUMA.1121.00052,2,193415,197550,+,4135
138,BUMA.1121.00053,2,300510,304645,+,4135
138,BUMA.1121.00057,2,2019725,2023847,-,4122
138,BUMA.1121.00108,2,266577,270715,+,4138
138,BUMA.1121.00050,2,60889,65024,+,4135
138,BUMA.1121.00104,2,182067,186208,+,4141
138,BUMA.1121.00014,2,79858,83976,+,4118
138,BUMA.1121.00036,2,1514858,1518993,-,4135
138,BUMA.1121.00038,2,2145048,2149183,-,4135
138,BUMA.1121.00098,2,283909,288028,+,4119
138,BUMA.1121.00078,2,3150549,3154663,-,4114
138,BUMA.1121.00029,2,1296828,1300966,-,4138
138,BUMA.1121.00099,2,217570,221704,+,4134
138,BUMA.1121.00103,2,1900062,1904198,+,4136
138,BUMA.1121.00102,2,76905,81054,+,4149
138,BUMA.1121.00028,2,80008,84143,+,4135
138,BUMA.1121.00075,2,2782741,2786883,-,4142
138,BUMA.1121.00044,2,131154,135289,+,4135
138,BUMA.1121.00076,2,958735,962877,+,4142
138,BUMA.1121.00074,2,1168215,1172356,-,4141
138,BUMA.1121.00073,2,74585,78714,+,4129
138,BUMA.1121.00083,2,1871558,1875680,+,4122
138,BUMA.1121.00035,2,1380381,1384519,-,4138
138,BUMA.1121.00072,2,74555,78676,+,4121
138,BUMA.1121.00056,2,810733,814875,-,4142
138,BUMA.1121.00081,2,75558,79693,+,4135
138,BUMA.1121.00033,2,734925,739060,+,4135
138,BUMA.1121.00061,2,74609,78730,+,4121
138,BUMA.1121.00062,2,1697466,1701608,-,4142
138,BUMA.1121.00064,2,76783,80924,+,4141
138,BUMA.1121.00060,2,2126869,2131010,-,4141
138,BUMA.1121.00069,2,74601,78730,+,4129
138,BUMA.1121.00070,2,74578,78707,+,4129
138,BUMA.1121.00068,2,1793506,1797626,+,4120
138,BUMA.1121.00067,2,727737,731878,-,4141
138,BUMA.1121.00037,2,327173,331317,+,4144
138,BUMA.1121.00065,2,74491,78622,+,4131
138,BUMA.1121.00058,2,591157,595298,+,4141
138,BUMA.1121.00041,2,964227,968358,+,4131
138,BUMA.1121.00084,2,1915897,1920039,+,4142
138,BUMA.1121.00096,2,188300,192407,+,4107
138,BUMA.1121.00080,2,76794,80936,+,4142
138,BUMA.1121.00013,2,506166,510301,+,4135
138,BUMA.1121.00100,2,1239590,1243703,+,4113
138,BUMA.1121.00012,2,1751896,1756031,-,4135
138,BUMA.1121.00018,2,632355,636490,-,4135
138,BUMA.1121.00048,2,815008,819143,+,4135
138,BUMA.1121.00106,2,2491747,2495888,+,4141
138,BUMA.1121.00017,2,79967,84102,+,4135
138,BUMA.1121.00082,2,74615,78737,+,4122
139,BUMA.1121.00049,2,1891205,1896808,+,5603
139,BUMA.1121.00055,2,2598999,2604606,-,5607
139,BUMA.1121.00109,2,1380532,1386140,-,5608
139,BUMA.1121.00021,2,541625,547229,+,5604
139,BUMA.1121.00025,2,1700710,1706314,+,5604
139,BUMA.1121.00031,2,2417457,2423060,+,5603
139,BUMA.1121.00007,2,89950,95549,+,5599
139,BUMA.1121.00097,2,3073857,3079461,+,5604
139,BUMA.1121.00059,2,394137,399744,-,5607
139,BUMA.1121.00111,2,2519807,2525411,+,5604
139,BUMA.1121.00094,2,80854,86459,+,5605
139,BUMA.1121.00112,2,1106430,1112034,-,5604
139,BUMA.1121.00089,2,80841,86447,+,5606
139,BUMA.1121.00051,2,80980,86586,+,5606
139,BUMA.1121.00045,2,3138282,3143886,+,5604
139,BUMA.1121.00043,2,2365840,2371445,-,5605
139,BUMA.1121.00079,2,80885,86491,+,5606
139,BUMA.1121.00093,2,2858484,2864091,-,5607
139,BUMA.1121.00091,2,393708,399282,-,5574
139,BUMA.1121.00107,2,578567,584172,-,5605
139,BUMA.1121.00088,2,31078,36684,+,5606
139,BUMA.1121.00047,2,1010034,1015640,+,5606
139,BUMA.1121.00039,2,722211,730505,-,8294
139,BUMA.1121.00016,2,521521,527125,-,5604
139,BUMA.1121.00092,2,80823,86429,+,5606
139,BUMA.1121.00105,2,2422696,2428303,-,5607
139,BUMA.1121.00108,2,270737,276341,+,5604
139,BUMA.1121.00104,2,186230,191836,+,5606
139,BUMA.1121.00014,2,83998,89602,+,5604
139,BUMA.1121.00098,2,288050,293654,+,5604
139,BUMA.1121.00099,2,221731,227330,+,5599
139,BUMA.1121.00103,2,1904225,1909824,+,5599
139,BUMA.1121.00102,2,81077,86682,+,5605
139,BUMA.1121.00075,2,2777146,2782719,-,5573
139,BUMA.1121.00076,2,962899,968471,+,5572
139,BUMA.1121.00074,2,1162586,1168193,-,5607
139,BUMA.1121.00056,2,805104,810711,-,5607
139,BUMA.1121.00062,2,1691837,1697444,-,5607
139,BUMA.1121.00064,2,80946,86552,+,5606
139,BUMA.1121.00060,2,2121242,2126847,-,5605
139,BUMA.1121.00067,2,722108,727715,-,5607
139,BUMA.1121.00037,2,331339,336943,+,5604
139,BUMA.1121.00058,2,595320,600926,+,5606
139,BUMA.1121.00084,2,1920061,1925667,+,5606
139,BUMA.1121.00096,2,192429,198026,+,5597
139,BUMA.1121.00080,2,80958,86564,+,5606
139,BUMA.1121.00018,2,626728,632333,-,5605
139,BUMA.1121.00106,2,2495910,2501516,+,5606
140,BUMA.1121.00049,2,1910760,1915391,+,4631
140,BUMA.1121.00055,2,2580510,2585140,-,4630
140,BUMA.1121.00011,2,1869300,1873930,+,4630
140,BUMA.1121.00110,2,3226107,3230738,+,4631
140,BUMA.1121.00109,2,1361958,1366589,-,4631
140,BUMA.1121.00077,2,384905,389536,-,4631
140,BUMA.1121.00027,2,1152285,1156915,+,4630
140,BUMA.1121.00021,2,561094,565727,+,4633
140,BUMA.1121.00023,2,154631,159263,+,4632
140,BUMA.1121.00025,2,1720179,1724811,+,4632
140,BUMA.1121.00031,2,2436925,2441559,+,4634
140,BUMA.1121.00007,2,110666,115294,+,4628
140,BUMA.1121.00097,2,3093323,3097970,+,4647
140,BUMA.1121.00059,2,375634,380269,-,4635
140,BUMA.1121.00005,2,652433,657064,-,4631
140,BUMA.1121.00111,2,2539272,2543904,+,4632
140,BUMA.1121.00009,2,1899005,1903636,+,4631
140,BUMA.1121.00094,2,100354,104984,+,4630
140,BUMA.1121.00101,2,158679,163309,-,4630
140,BUMA.1121.00066,2,98742,103373,+,4631
140,BUMA.1121.00095,2,2110113,2114743,+,4630
140,BUMA.1121.00112,2,1087931,1092559,-,4628
140,BUMA.1121.00090,2,1002138,1006771,+,4633
140,BUMA.1121.00089,2,100342,104972,+,4630
140,BUMA.1121.00051,2,100487,105116,+,4629
140,BUMA.1121.00001,2,2158093,2162724,-,4631
140,BUMA.1121.00045,2,3157757,3162347,+,4590
140,BUMA.1121.00043,2,2344755,2349387,-,4632
140,BUMA.1121.00063,2,91911,96543,+,4632
140,BUMA.1121.00079,2,100392,105021,+,4629
140,BUMA.1121.00071,2,92598,97230,+,4632
140,BUMA.1121.00093,2,2839947,2844577,-,4630
140,BUMA.1121.00091,2,375171,379801,-,4630
140,BUMA.1121.00107,2,560595,565190,-,4595
140,BUMA.1121.00088,2,51785,56415,+,4630
140,BUMA.1121.00047,2,1029541,1034170,+,4629
140,BUMA.1121.00039,2,703666,708298,-,4632
140,BUMA.1121.00016,2,503018,507650,-,4632
140,BUMA.1121.00092,2,100336,104934,+,4598
140,BUMA.1121.00003,2,1432791,1437380,+,4589
140,BUMA.1121.00105,2,2404135,2408765,-,4630
140,BUMA.1121.00053,2,326779,331410,+,4631
140,BUMA.1121.00057,2,1992955,1997587,-,4632
140,BUMA.1121.00108,2,290230,294862,+,4632
140,BUMA.1121.00104,2,205773,210403,+,4630
140,BUMA.1121.00014,2,103469,109339,+,5870
140,BUMA.1121.00098,2,307527,312125,+,4598
140,BUMA.1121.00078,2,3123765,3128397,-,4632
140,BUMA.1121.00029,2,1270062,1274693,-,4631
140,BUMA.1121.00099,2,241192,245791,+,4599
140,BUMA.1121.00103,2,1923715,1928345,+,4630
140,BUMA.1121.00102,2,100563,105192,+,4629
140,BUMA.1121.00075,2,2757345,2761974,-,4629
140,BUMA.1121.00076,2,983645,988274,+,4629
140,BUMA.1121.00074,2,1144087,1148718,-,4631
140,BUMA.1121.00073,2,100252,104843,+,4591
140,BUMA.1121.00083,2,1897823,1902455,+,4632
140,BUMA.1121.00035,2,1353614,1358246,-,4632
140,BUMA.1121.00072,2,91396,96028,+,4632
140,BUMA.1121.00056,2,786579,791209,-,4630
140,BUMA.1121.00033,2,768137,772768,+,4631
140,BUMA.1121.00061,2,91171,95803,+,4632
140,BUMA.1121.00062,2,1673354,1677985,-,4631
140,BUMA.1121.00064,2,100420,105051,+,4631
140,BUMA.1121.00060,2,2102781,2107371,-,4590
140,BUMA.1121.00069,2,99819,104451,+,4632
140,BUMA.1121.00070,2,100277,104909,+,4632
140,BUMA.1121.00068,2,1819756,1824388,+,4632
140,BUMA.1121.00067,2,703582,708213,-,4631
140,BUMA.1121.00037,2,350808,356755,+,5947
140,BUMA.1121.00065,2,100776,105367,+,4591
140,BUMA.1121.00058,2,614863,619495,+,4632
140,BUMA.1121.00041,2,990504,995135,+,4631
140,BUMA.1121.00084,2,1939414,1944044,+,4630
140,BUMA.1121.00096,2,211898,216529,+,4631
140,BUMA.1121.00080,2,100465,105093,+,4628
140,BUMA.1121.00100,2,1265851,1271795,+,5944
140,BUMA.1121.00012,2,1723797,1728428,-,4631
140,BUMA.1121.00018,2,608231,612863,-,4632
140,BUMA.1121.00106,2,2515390,2520020,+,4630
140,BUMA.1121.00082,2,100874,105506,+,4632
141,BUMA.1121.00049,2,1916339,1928626,+,12287
141,BUMA.1121.00055,2,2567059,2579395,-,12336
141,BUMA.1121.00011,2,1875382,1887695,+,12313
141,BUMA.1121.00110,2,3231686,3243998,+,12312
141,BUMA.1121.00109,2,1348266,1360591,-,12325
141,BUMA.1121.00077,2,371480,383790,-,12310
141,BUMA.1121.00027,2,1158031,1170353,+,12322
141,BUMA.1121.00021,2,567179,579490,+,12311
141,BUMA.1121.00023,2,160673,172984,+,12311
141,BUMA.1121.00025,2,1726263,1738574,+,12311
141,BUMA.1121.00031,2,2443011,2455322,+,12311
141,BUMA.1121.00007,2,116662,128974,+,12312
141,BUMA.1121.00097,2,3099422,3111757,+,12335
141,BUMA.1121.00059,2,362195,374519,-,12324
141,BUMA.1121.00005,2,638657,650982,-,12325
141,BUMA.1121.00111,2,2545356,2557668,+,12312
141,BUMA.1121.00009,2,1905046,1917358,+,12312
141,BUMA.1121.00094,2,105426,117749,+,12323
141,BUMA.1121.00101,2,144915,157228,-,12313
141,BUMA.1121.00066,2,104489,116800,+,12311
141,BUMA.1121.00095,2,2116279,2128592,+,12313
141,BUMA.1121.00112,2,1074146,1086480,-,12334
141,BUMA.1121.00090,2,1008187,1020498,+,12311
141,BUMA.1121.00089,2,106592,118915,+,12323
141,BUMA.1121.00051,2,106736,119059,+,12323
141,BUMA.1121.00001,2,2144960,2157272,-,12312
141,BUMA.1121.00045,2,3163966,3176289,+,12323
141,BUMA.1121.00043,2,2330992,2343304,-,12312
141,BUMA.1121.00063,2,97659,109970,+,12311
141,BUMA.1121.00079,2,106683,119006,+,12323
141,BUMA.1121.00071,2,98346,110657,+,12311
141,BUMA.1121.00093,2,2826172,2838496,-,12324
141,BUMA.1121.00091,2,361480,373804,-,12324
141,BUMA.1121.00107,2,546870,559195,-,12325
141,BUMA.1121.00088,2,57699,70022,+,12323
141,BUMA.1121.00047,2,1035790,1048113,+,12323
141,BUMA.1121.00039,2,689903,702215,-,12312
141,BUMA.1121.00016,2,489256,501567,-,12311
141,BUMA.1121.00092,2,106418,118741,+,12323
141,BUMA.1121.00003,2,1438999,1451322,+,12323
141,BUMA.1121.00105,2,2391200,2403524,-,12324
141,BUMA.1121.00053,2,332778,345089,+,12311
141,BUMA.1121.00057,2,1979516,1991840,-,12324
141,BUMA.1121.00108,2,296230,308554,+,12324
141,BUMA.1121.00104,2,211771,224059,+,12288
141,BUMA.1121.00014,2,110791,123102,+,12311
141,BUMA.1121.00098,2,313525,325849,+,12324
141,BUMA.1121.00078,2,3110243,3122566,-,12323
141,BUMA.1121.00029,2,1256930,1269242,-,12312
141,BUMA.1121.00099,2,247191,259503,+,12312
141,BUMA.1121.00103,2,1929293,1941618,+,12325
141,BUMA.1121.00102,2,106644,118966,+,12322
141,BUMA.1121.00075,2,2743738,2756062,-,12324
141,BUMA.1121.00076,2,989558,1001881,+,12323
141,BUMA.1121.00074,2,1130648,1142972,-,12324
141,BUMA.1121.00073,2,106000,118311,+,12311
141,BUMA.1121.00083,2,1903571,1915882,+,12311
141,BUMA.1121.00035,2,1340481,1352793,-,12312
141,BUMA.1121.00072,2,97144,109455,+,12311
141,BUMA.1121.00056,2,772720,785044,-,12324
141,BUMA.1121.00033,2,774220,786530,+,12310
141,BUMA.1121.00061,2,96919,109230,+,12311
141,BUMA.1121.00062,2,1660335,1672659,-,12324
141,BUMA.1121.00064,2,106167,118454,+,12287
141,BUMA.1121.00060,2,2088839,2101163,-,12324
141,BUMA.1121.00069,2,105567,117878,+,12311
141,BUMA.1121.00070,2,106025,118336,+,12311
141,BUMA.1121.00068,2,1825672,1837979,+,12307
141,BUMA.1121.00067,2,690143,702467,-,12324
141,BUMA.1121.00037,2,358123,370434,+,12311
141,BUMA.1121.00065,2,107070,119382,+,12312
141,BUMA.1121.00058,2,620863,633186,+,12323
141,BUMA.1121.00041,2,996671,1009005,+,12334
141,BUMA.1121.00084,2,1945076,1957399,+,12323
141,BUMA.1121.00096,2,217813,230136,+,12323
141,BUMA.1121.00080,2,106713,119036,+,12323
141,BUMA.1121.00012,2,1710284,1722598,-,12314
141,BUMA.1121.00018,2,594468,606780,-,12312
141,BUMA.1121.00106,2,2521136,2533459,+,12323
141,BUMA.1121.00082,2,106622,118933,+,12311
142,BUMA.1121.00049,2,1929228,1940449,+,11221
142,BUMA.1121.00055,2,2555237,2566457,-,11220
142,BUMA.1121.00011,2,1888297,1899518,+,11221
142,BUMA.1121.00110,2,3244600,3255790,+,11190
142,BUMA.1121.00109,2,1336444,1347664,-,11220
142,BUMA.1121.00077,2,359690,370878,-,11188
142,BUMA.1121.00027,2,1170955,1182176,+,11221
142,BUMA.1121.00021,2,580092,591313,+,11221
142,BUMA.1121.00023,2,173586,184807,+,11221
142,BUMA.1121.00025,2,1739176,1750397,+,11221
142,BUMA.1121.00031,2,2455924,2467144,+,11220
142,BUMA.1121.00007,2,129576,140796,+,11220
142,BUMA.1121.00097,2,3112359,3123565,+,11206
142,BUMA.1121.00059,2,350373,361593,-,11220
142,BUMA.1121.00005,2,626844,638055,-,11211
142,BUMA.1121.00111,2,2558270,2569491,+,11221
142,BUMA.1121.00009,2,1917960,1929181,+,11221
142,BUMA.1121.00094,2,118351,129572,+,11221
142,BUMA.1121.00101,2,133093,144313,-,11220
142,BUMA.1121.00066,2,117402,128623,+,11221
142,BUMA.1121.00095,2,2129194,2140415,+,11221
142,BUMA.1121.00112,2,1062324,1073544,-,11220
142,BUMA.1121.00090,2,1021100,1032321,+,11221
142,BUMA.1121.00089,2,119517,130738,+,11221
142,BUMA.1121.00051,2,119661,130882,+,11221
142,BUMA.1121.00001,2,2133138,2144358,-,11220
142,BUMA.1121.00045,2,3176891,3188112,+,11221
142,BUMA.1121.00043,2,2319170,2330390,-,11220
142,BUMA.1121.00063,2,110572,121787,+,11215
142,BUMA.1121.00079,2,119608,130827,+,11219
142,BUMA.1121.00071,2,111259,122480,+,11221
142,BUMA.1121.00093,2,2814350,2825570,-,11220
142,BUMA.1121.00091,2,349658,360878,-,11220
142,BUMA.1121.00107,2,535048,546268,-,11220
142,BUMA.1121.00088,2,70624,81845,+,11221
142,BUMA.1121.00047,2,1048715,1059936,+,11221
142,BUMA.1121.00039,2,678081,689301,-,11220
142,BUMA.1121.00016,2,477435,488654,-,11219
142,BUMA.1121.00092,2,119343,130564,+,11221
142,BUMA.1121.00003,2,1451924,1463145,+,11221
142,BUMA.1121.00105,2,2379378,2390598,-,11220
142,BUMA.1121.00053,2,345691,356912,+,11221
142,BUMA.1121.00057,2,1967694,1978914,-,11220
142,BUMA.1121.00108,2,309156,320377,+,11221
142,BUMA.1121.00104,2,224661,235882,+,11221
142,BUMA.1121.00014,2,123704,134925,+,11221
142,BUMA.1121.00098,2,326451,337672,+,11221
142,BUMA.1121.00078,2,3098421,3109641,-,11220
142,BUMA.1121.00029,2,1245109,1256328,-,11219
142,BUMA.1121.00099,2,260105,271326,+,11221
142,BUMA.1121.00103,2,1942220,1953441,+,11221
142,BUMA.1121.00102,2,119568,130774,+,11206
142,BUMA.1121.00075,2,2731916,2743136,-,11220
142,BUMA.1121.00076,2,1002483,1013704,+,11221
142,BUMA.1121.00074,2,1118826,1130046,-,11220
142,BUMA.1121.00073,2,118913,130134,+,11221
142,BUMA.1121.00083,2,1916484,1927705,+,11221
142,BUMA.1121.00035,2,1328659,1339879,-,11220
142,BUMA.1121.00072,2,110057,121278,+,11221
142,BUMA.1121.00056,2,760898,772118,-,11220
142,BUMA.1121.00033,2,787132,798352,+,11220
142,BUMA.1121.00061,2,109832,121044,+,11212
142,BUMA.1121.00062,2,1648513,1659733,-,11220
142,BUMA.1121.00064,2,119056,130277,+,11221
142,BUMA.1121.00060,2,2077017,2088237,-,11220
142,BUMA.1121.00069,2,118480,129701,+,11221
142,BUMA.1121.00070,2,118938,130159,+,11221
142,BUMA.1121.00068,2,1838581,1849801,+,11220
142,BUMA.1121.00067,2,678321,689541,-,11220
142,BUMA.1121.00037,2,371036,382257,+,11221
142,BUMA.1121.00065,2,119984,131205,+,11221
142,BUMA.1121.00058,2,633788,645009,+,11221
142,BUMA.1121.00041,2,1009607,1020828,+,11221
142,BUMA.1121.00084,2,1958001,1969222,+,11221
142,BUMA.1121.00096,2,230738,241959,+,11221
142,BUMA.1121.00080,2,119638,130859,+,11221
142,BUMA.1121.00012,2,1698465,1709682,-,11217
142,BUMA.1121.00018,2,582646,593866,-,11220
142,BUMA.1121.00106,2,2534061,2545282,+,11221
142,BUMA.1121.00082,2,119535,130756,+,11221
143,BUMA.1121.00049,2,1940835,1959981,+,19146
143,BUMA.1121.00055,2,2535616,2554762,-,19146
143,BUMA.1121.00011,2,1900060,1919203,+,19143
143,BUMA.1121.00110,2,23,19169,+,19146
143,BUMA.1121.00109,2,1316768,1335914,-,19146
143,BUMA.1121.00077,2,340103,359250,-,19147
143,BUMA.1121.00027,2,1182622,1201768,+,19146
143,BUMA.1121.00021,2,591603,610749,+,19146
143,BUMA.1121.00023,2,185211,204357,+,19146
143,BUMA.1121.00025,2,1750945,1770092,+,19147
143,BUMA.1121.00031,2,2467590,2486736,+,19146
143,BUMA.1121.00007,2,141170,160316,+,19146
143,BUMA.1121.00097,2,3124053,3143199,+,19146
143,BUMA.1121.00059,2,330715,349861,-,19146
143,BUMA.1121.00005,2,607229,626371,-,19142
143,BUMA.1121.00111,2,2569967,2589114,+,19147
143,BUMA.1121.00009,2,1929639,1948791,+,19152
143,BUMA.1121.00094,2,130066,149265,+,19199
143,BUMA.1121.00101,2,113495,132641,-,19146
143,BUMA.1121.00066,2,129046,148192,+,19146
143,BUMA.1121.00095,2,2140939,2160073,+,19134
143,BUMA.1121.00112,2,1042781,1061927,-,19146
143,BUMA.1121.00090,2,1032797,1051943,+,19146
143,BUMA.1121.00089,2,131232,150378,+,19146
143,BUMA.1121.00051,2,131561,150707,+,19146
143,BUMA.1121.00001,2,2113528,2132674,-,19146
143,BUMA.1121.00045,2,3188546,3207692,+,19146
143,BUMA.1121.00043,2,2299788,2318934,-,19146
143,BUMA.1121.00063,2,122216,141362,+,19146
143,BUMA.1121.00079,2,131507,150653,+,19146
143,BUMA.1121.00071,2,122950,142096,+,19146
143,BUMA.1121.00093,2,2794794,2813940,-,19146
143,BUMA.1121.00091,2,330090,349236,-,19146
143,BUMA.1121.00107,2,515498,534644,-,19146
143,BUMA.1121.00088,2,82405,101551,+,19146
143,BUMA.1121.00047,2,1060424,1080927,+,20503
143,BUMA.1121.00039,2,658549,677695,-,19146
143,BUMA.1121.00016,2,457976,477121,-,19145
143,BUMA.1121.00092,2,130974,150120,+,19146
143,BUMA.1121.00003,2,1463740,1482886,+,19146
143,BUMA.1121.00105,2,2359816,2378962,-,19146
143,BUMA.1121.00053,2,357430,376585,+,19155
143,BUMA.1121.00057,2,1948108,1967254,-,19146
143,BUMA.1121.00108,2,320811,339957,+,19146
143,BUMA.1121.00104,2,236202,255348,+,19146
143,BUMA.1121.00014,2,135443,154586,+,19143
143,BUMA.1121.00098,2,338160,357306,+,19146
143,BUMA.1121.00078,2,3078757,3097897,-,19140
143,BUMA.1121.00029,2,1225487,1244633,-,19146
143,BUMA.1121.00099,2,271724,290870,+,19146
143,BUMA.1121.00103,2,1953647,1972784,+,19137
143,BUMA.1121.00102,2,131286,150432,+,19146
143,BUMA.1121.00075,2,2712354,2731500,-,19146
143,BUMA.1121.00076,2,1014120,1033266,+,19146
143,BUMA.1121.00074,2,1099210,1118356,-,19146
143,BUMA.1121.00073,2,130604,149750,+,19146
143,BUMA.1121.00083,2,1928175,1947321,+,19146
143,BUMA.1121.00035,2,1309031,1328177,-,19146
143,BUMA.1121.00072,2,121686,140830,+,19144
143,BUMA.1121.00056,2,741300,760446,-,19146
143,BUMA.1121.00033,2,798713,817850,+,19137
143,BUMA.1121.00061,2,121514,140660,+,19146
143,BUMA.1121.00062,2,1628987,1648133,-,19146
143,BUMA.1121.00064,2,130699,149845,+,19146
143,BUMA.1121.00060,2,2057563,2076709,-,19146
143,BUMA.1121.00069,2,130171,149317,+,19146
143,BUMA.1121.00070,2,130629,149775,+,19146
143,BUMA.1121.00068,2,1850241,1869386,+,19145
143,BUMA.1121.00067,2,658705,677851,-,19146
143,BUMA.1121.00037,2,382727,403228,+,20501
143,BUMA.1121.00065,2,131633,150781,+,19148
143,BUMA.1121.00058,2,645431,664577,+,19146
143,BUMA.1121.00041,2,1021340,1040480,+,19140
143,BUMA.1121.00084,2,1969602,1988748,+,19146
143,BUMA.1121.00096,2,242165,261311,+,19146
143,BUMA.1121.00080,2,131495,150641,+,19146
143,BUMA.1121.00012,2,1678867,1698013,-,19146
143,BUMA.1121.00018,2,562946,582092,-,19146
143,BUMA.1121.00106,2,2545746,2564892,+,19146
143,BUMA.1121.00082,2,131226,150372,+,19146
144,BUMA.1121.00049,2,1959982,1968439,+,8457
144,BUMA.1121.00055,2,2527159,2535614,-,8455
144,BUMA.1121.00110,2,19170,27626,+,8456
144,BUMA.1121.00109,2,1308285,1316766,-,8481
144,BUMA.1121.00077,2,331647,340101,-,8454
144,BUMA.1121.00027,2,1201769,1210239,+,8470
144,BUMA.1121.00021,2,610750,619204,+,8454
144,BUMA.1121.00023,2,204358,212812,+,8454
144,BUMA.1121.00025,2,1770093,1778547,+,8454
144,BUMA.1121.00031,2,2486737,2495191,+,8454
144,BUMA.1121.00007,2,160317,168786,+,8469
144,BUMA.1121.00059,2,322244,330713,-,8469
144,BUMA.1121.00005,2,598776,607227,-,8451
144,BUMA.1121.00111,2,2589115,2597575,+,8460
144,BUMA.1121.00094,2,149266,157724,+,8458
144,BUMA.1121.00066,2,148193,156649,+,8456
144,BUMA.1121.00112,2,1034307,1042779,-,8472
144,BUMA.1121.00090,2,1051944,1060398,+,8454
144,BUMA.1121.00089,2,150379,158837,+,8458
144,BUMA.1121.00051,2,150708,159166,+,8458
144,BUMA.1121.00001,2,2105073,2113526,-,8453
144,BUMA.1121.00043,2,2291333,2299786,-,8453
144,BUMA.1121.00063,2,141363,149819,+,8456
144,BUMA.1121.00079,2,150654,159112,+,8458
144,BUMA.1121.00071,2,142097,150553,+,8456
144,BUMA.1121.00093,2,2786341,2794792,-,8451
144,BUMA.1121.00091,2,321623,330088,-,8465
144,BUMA.1121.00107,2,507027,515496,-,8469
144,BUMA.1121.00088,2,101552,110022,+,8470
144,BUMA.1121.00047,2,1080928,1089384,+,8456
144,BUMA.1121.00039,2,650088,658547,-,8459
144,BUMA.1121.00016,2,449520,457974,-,8454
144,BUMA.1121.00092,2,150121,158573,+,8452
144,BUMA.1121.00105,2,2351358,2359814,-,8456
144,BUMA.1121.00053,2,376586,385060,+,8474
144,BUMA.1121.00057,2,1939648,1948106,-,8458
144,BUMA.1121.00104,2,255349,263806,+,8457
144,BUMA.1121.00014,2,154587,163046,+,8459
144,BUMA.1121.00098,2,357307,365767,+,8460
144,BUMA.1121.00078,2,3070301,3078755,-,8454
144,BUMA.1121.00029,2,1217032,1225485,-,8453
144,BUMA.1121.00099,2,290871,299341,+,8470
144,BUMA.1121.00102,2,150433,158914,+,8481
144,BUMA.1121.00075,2,2703896,2712352,-,8456
144,BUMA.1121.00076,2,1033267,1041724,+,8457
144,BUMA.1121.00074,2,1090739,1099208,-,8469
144,BUMA.1121.00083,2,1947322,1955778,+,8456
144,BUMA.1121.00035,2,1300576,1309029,-,8453
144,BUMA.1121.00072,2,140831,149289,+,8458
144,BUMA.1121.00056,2,732841,741298,-,8457
144,BUMA.1121.00033,2,817851,826302,+,8451
144,BUMA.1121.00062,2,1620516,1628985,-,8469
144,BUMA.1121.00064,2,149846,158304,+,8458
144,BUMA.1121.00068,2,1869387,1877860,+,8473
144,BUMA.1121.00067,2,650234,658703,-,8469
144,BUMA.1121.00037,2,403229,411683,+,8454
144,BUMA.1121.00065,2,150782,159238,+,8456
144,BUMA.1121.00041,2,1040481,1048950,+,8469
144,BUMA.1121.00084,2,1988749,1997219,+,8470
144,BUMA.1121.00080,2,150642,159100,+,8458
144,BUMA.1121.00012,2,1670406,1678865,-,8459
144,BUMA.1121.00018,2,554491,562944,-,8453
144,BUMA.1121.00106,2,2564893,2573363,+,8470
144,BUMA.1121.00082,2,150373,158829,+,8456
145,BUMA.1121.00049,2,1969230,1998897,+,29667
145,BUMA.1121.00055,2,2496991,2526367,-,29376
145,BUMA.1121.00011,2,1976931,2006453,+,29522
145,BUMA.1121.00110,2,28416,57781,+,29365
145,BUMA.1121.00109,2,1278043,1307495,-,29452
145,BUMA.1121.00077,2,301493,330855,-,29362
145,BUMA.1121.00027,2,1211027,1240654,+,29627
145,BUMA.1121.00021,2,619994,649498,+,29504
145,BUMA.1121.00023,2,213603,243102,+,29499
145,BUMA.1121.00025,2,1779336,1808994,+,29658
145,BUMA.1121.00031,2,2495980,2525635,+,29655
145,BUMA.1121.00007,2,169576,199097,+,29521
145,BUMA.1121.00097,2,3200904,3230406,+,29502
145,BUMA.1121.00059,2,291939,321452,-,29513
145,BUMA.1121.00005,2,568472,597972,-,29500
145,BUMA.1121.00111,2,2598365,2627995,+,29630
145,BUMA.1121.00009,2,2006502,2035993,+,29491
145,BUMA.1121.00094,2,158527,187974,+,29447
145,BUMA.1121.00101,2,26330,55787,-,29457
145,BUMA.1121.00066,2,157441,186937,+,29496
145,BUMA.1121.00095,2,2217772,2247264,+,29492
145,BUMA.1121.00112,2,1004096,1033516,-,29420
145,BUMA.1121.00090,2,1061189,1090688,+,29499
145,BUMA.1121.00089,2,159639,189086,+,29447
145,BUMA.1121.00051,2,159969,189434,+,29465
145,BUMA.1121.00001,2,2074614,2104282,-,29668
145,BUMA.1121.00045,2,6634,36112,+,29478
145,BUMA.1121.00043,2,2260870,2290544,-,29674
145,BUMA.1121.00063,2,150611,180109,+,29498
145,BUMA.1121.00079,2,159915,189393,+,29478
145,BUMA.1121.00071,2,151345,180806,+,29461
145,BUMA.1121.00093,2,2756098,2785554,-,29456
145,BUMA.1121.00091,2,291332,320832,-,29500
145,BUMA.1121.00107,2,476715,506236,-,29521
145,BUMA.1121.00088,2,110810,140298,+,29488
145,BUMA.1121.00047,2,1090175,1119691,+,29516
145,BUMA.1121.00039,2,619676,649299,-,29623
145,BUMA.1121.00016,2,419092,448731,-,29639
145,BUMA.1121.00092,2,159360,188815,+,29455
145,BUMA.1121.00003,2,1540585,1570232,+,29647
145,BUMA.1121.00105,2,2321072,2350568,-,29496
145,BUMA.1121.00053,2,385848,415373,+,29525
145,BUMA.1121.00057,2,1909392,1938856,-,29464
145,BUMA.1121.00108,2,397672,427130,+,29458
145,BUMA.1121.00104,2,264597,294244,+,29647
145,BUMA.1121.00014,2,163836,193491,+,29655
145,BUMA.1121.00098,2,366557,396024,+,29467
145,BUMA.1121.00078,2,3040058,3069511,-,29453
145,BUMA.1121.00029,2,1186573,1216241,-,29668
145,BUMA.1121.00099,2,300130,329616,+,29486
145,BUMA.1121.00103,2,2030503,2059990,+,29487
145,BUMA.1121.00102,2,159706,189220,+,29514
145,BUMA.1121.00075,2,2672189,2701656,-,29467
145,BUMA.1121.00076,2,1043964,1073430,+,29466
145,BUMA.1121.00074,2,1060454,1089951,-,29497
145,BUMA.1121.00073,2,150419,179917,+,29498
145,BUMA.1121.00083,2,1956570,1986072,+,29502
145,BUMA.1121.00035,2,1270117,1299785,-,29668
145,BUMA.1121.00072,2,150081,179548,+,29467
145,BUMA.1121.00056,2,702591,732039,-,29448
145,BUMA.1121.00033,2,827090,856671,+,29581
145,BUMA.1121.00061,2,141327,170825,+,29498
145,BUMA.1121.00062,2,1590115,1619724,-,29609
145,BUMA.1121.00064,2,159108,188564,+,29456
145,BUMA.1121.00060,2,1970367,1999846,-,29479
145,BUMA.1121.00069,2,149991,179487,+,29496
145,BUMA.1121.00070,2,150449,179948,+,29499
145,BUMA.1121.00068,2,1878651,1908178,+,29527
145,BUMA.1121.00067,2,619995,649446,-,29451
145,BUMA.1121.00037,2,412473,442098,+,29625
145,BUMA.1121.00065,2,160029,189720,+,29691
145,BUMA.1121.00058,2,722273,751747,+,29474
145,BUMA.1121.00041,2,1049740,1079216,+,29476
145,BUMA.1121.00084,2,1998007,2027621,+,29614
145,BUMA.1121.00096,2,319023,348545,+,29522
145,BUMA.1121.00080,2,159903,189368,+,29465
145,BUMA.1121.00100,2,1272847,1302329,+,29482
145,BUMA.1121.00012,2,1639931,1669617,-,29686
145,BUMA.1121.00018,2,524044,553702,-,29658
145,BUMA.1121.00106,2,2574155,2603658,+,29503
145,BUMA.1121.00082,2,159621,189123,+,29502
146,BUMA.1121.00049,2,2000554,2005946,+,5392
146,BUMA.1121.00055,2,2490029,2495390,-,5361
146,BUMA.1121.00011,2,2008033,2013398,+,5365
146,BUMA.1121.00110,2,59378,64772,+,5394
146,BUMA.1121.00109,2,1271034,1276409,-,5375
146,BUMA.1121.00077,2,294566,299959,-,5393
146,BUMA.1121.00027,2,1242159,1247549,+,5390
146,BUMA.1121.00026,2,368571,373963,-,5392
146,BUMA.1121.00021,2,651012,656377,+,5365
146,BUMA.1121.00023,2,244630,249995,+,5365
146,BUMA.1121.00022,2,1350962,1356354,-,5392
146,BUMA.1121.00025,2,1810571,1815965,+,5394
146,BUMA.1121.00031,2,2527226,2532581,+,5355
146,BUMA.1121.00007,2,200603,205997,+,5394
146,BUMA.1121.00097,2,3231869,3237263,+,5394
146,BUMA.1121.00059,2,285108,290469,-,5361
146,BUMA.1121.00002,2,761524,766917,+,5393
146,BUMA.1121.00005,2,561714,567107,-,5393
146,BUMA.1121.00111,2,2629509,2634864,+,5355
146,BUMA.1121.00006,2,189254,194647,+,5393
146,BUMA.1121.00009,2,2037584,2042977,+,5393
146,BUMA.1121.00094,2,189415,194646,+,5231
146,BUMA.1121.00101,2,19570,24963,-,5393
146,BUMA.1121.00066,2,188252,193615,+,5363
146,BUMA.1121.00095,2,2248733,2254125,+,5392
146,BUMA.1121.00112,2,997151,1002515,-,5364
146,BUMA.1121.00042,2,1941109,1946502,+,5393
146,BUMA.1121.00090,2,1092223,1097588,+,5365
146,BUMA.1121.00089,2,190527,195758,+,5231
146,BUMA.1121.00051,2,190874,196107,+,5233
146,BUMA.1121.00001,2,2067680,2073037,-,5357
146,BUMA.1121.00045,2,37556,42921,+,5365
146,BUMA.1121.00043,2,2253985,2259349,-,5364
146,BUMA.1121.00063,2,181394,186757,+,5363
146,BUMA.1121.00079,2,190833,196066,+,5233
146,BUMA.1121.00071,2,182337,187700,+,5363
146,BUMA.1121.00086,2,2158811,2164203,-,5392
146,BUMA.1121.00010,2,1614769,1620162,+,5393
146,BUMA.1121.00040,2,1995191,2000583,-,5392
146,BUMA.1121.00093,2,2749145,2754509,-,5364
146,BUMA.1121.00091,2,284525,289916,-,5391
146,BUMA.1121.00107,2,469808,475200,-,5392
146,BUMA.1121.00088,2,141741,147106,+,5365
146,BUMA.1121.00047,2,1121132,1126363,+,5231
146,BUMA.1121.00087,2,791617,797010,+,5393
146,BUMA.1121.00039,2,612730,618113,-,5383
146,BUMA.1121.00016,2,412162,417515,-,5353
146,BUMA.1121.00092,2,190404,195769,+,5365
146,BUMA.1121.00085,2,970383,975775,-,5392
146,BUMA.1121.00046,2,821535,826927,-,5392
146,BUMA.1121.00003,2,1571865,1577259,+,5394
146,BUMA.1121.00054,2,2314700,2320093,+,5393
146,BUMA.1121.00015,2,58739,64131,-,5392
146,BUMA.1121.00105,2,2314153,2319515,-,5362
146,BUMA.1121.00052,2,1658912,1664304,-,5392
146,BUMA.1121.00053,2,416971,422362,+,5391
146,BUMA.1121.00057,2,1902476,1907866,-,5390
146,BUMA.1121.00108,2,428456,433850,+,5394
146,BUMA.1121.00050,2,286722,292115,+,5393
146,BUMA.1121.00104,2,295819,301212,+,5393
146,BUMA.1121.00014,2,195068,200423,+,5355
146,BUMA.1121.00036,2,1784494,1789887,+,5393
146,BUMA.1121.00038,2,189272,194665,+,5393
146,BUMA.1121.00098,2,397396,402761,+,5365
146,BUMA.1121.00078,2,3033057,3038450,-,5393
146,BUMA.1121.00029,2,1178285,1184996,-,6711
146,BUMA.1121.00099,2,331146,336540,+,5394
146,BUMA.1121.00103,2,2061402,2066796,+,5394
146,BUMA.1121.00102,2,190817,196181,+,5364
146,BUMA.1121.00075,2,2665227,2670620,-,5393
146,BUMA.1121.00076,2,1074999,1080393,+,5394
146,BUMA.1121.00074,2,1053479,1058872,-,5393
146,BUMA.1121.00073,2,181431,186794,+,5363
146,BUMA.1121.00083,2,1987641,1993004,+,5363
146,BUMA.1121.00035,2,1263176,1268533,-,5357
146,BUMA.1121.00072,2,180837,186200,+,5363
146,BUMA.1121.00056,2,695920,701150,-,5230
146,BUMA.1121.00081,2,2128922,2134314,-,5392
146,BUMA.1121.00033,2,858248,863603,+,5355
146,BUMA.1121.00061,2,172200,177563,+,5363
146,BUMA.1121.00062,2,1583249,1588639,-,5390
146,BUMA.1121.00064,2,190097,195462,+,5365
146,BUMA.1121.00060,2,1963559,1968923,-,5364
146,BUMA.1121.00069,2,180874,186237,+,5363
146,BUMA.1121.00070,2,181461,186824,+,5363
146,BUMA.1121.00068,2,1909811,1915037,+,5226
146,BUMA.1121.00067,2,613125,618518,-,5393
146,BUMA.1121.00037,2,443661,449016,+,5355
146,BUMA.1121.00065,2,191331,196695,+,5364
146,BUMA.1121.00058,2,753219,758584,+,5365
146,BUMA.1121.00041,2,1080817,1086211,+,5394
146,BUMA.1121.00084,2,2029087,2034451,+,5364
146,BUMA.1121.00096,2,350193,355585,+,5392
146,BUMA.1121.00080,2,190809,196042,+,5233
146,BUMA.1121.00013,2,236372,241764,-,5392
146,BUMA.1121.00100,2,1303806,1309040,+,5234
146,BUMA.1121.00012,2,1633048,1638401,-,5353
146,BUMA.1121.00018,2,517074,522467,-,5393
146,BUMA.1121.00048,2,543026,548418,-,5392
146,BUMA.1121.00106,2,2605262,2610627,+,5365
146,BUMA.1121.00082,2,190692,196055,+,5363
147,BUMA.1121.00049,2,2005988,2009599,+,3611
147,BUMA.1121.00055,2,2486354,2489973,-,3619
147,BUMA.1121.00011,2,2013440,2017071,+,3631
147,BUMA.1121.00110,2,64814,68432,+,3618
147,BUMA.1121.00109,2,1267374,1270978,-,3604
147,BUMA.1121.00077,2,290906,294510,-,3604
147,BUMA.1121.00027,2,1247591,1251202,+,3611
147,BUMA.1121.00026,2,364890,368515,-,3625
147,BUMA.1121.00021,2,656419,660006,+,3587
147,BUMA.1121.00023,2,250037,253676,+,3639
147,BUMA.1121.00022,2,1347281,1350906,-,3625
147,BUMA.1121.00025,2,1816007,1819621,+,3614
147,BUMA.1121.00031,2,2533549,2537144,+,3595
147,BUMA.1121.00007,2,206039,209643,+,3604
147,BUMA.1121.00097,2,3237307,3240903,+,3596
147,BUMA.1121.00059,2,281435,285052,-,3617
147,BUMA.1121.00002,2,766959,770598,+,3639
147,BUMA.1121.00005,2,558061,561658,-,3597
147,BUMA.1121.00111,2,2635832,2639419,+,3587
147,BUMA.1121.00006,2,194689,198328,+,3639
147,BUMA.1121.00009,2,2043019,2046634,+,3615
147,BUMA.1121.00094,2,194688,198319,+,3631
147,BUMA.1121.00101,2,15908,19514,-,3606
147,BUMA.1121.00066,2,193657,197268,+,3611
147,BUMA.1121.00095,2,2254167,2257791,+,3624
147,BUMA.1121.00112,2,993505,997109,-,3604
147,BUMA.1121.00042,2,1946544,1950183,+,3639
147,BUMA.1121.00090,2,1097630,1101269,+,3639
147,BUMA.1121.00089,2,195800,199431,+,3631
147,BUMA.1121.00051,2,196149,199760,+,3611
147,BUMA.1121.00001,2,2064034,2067631,-,3597
147,BUMA.1121.00045,2,42963,46588,+,3625
147,BUMA.1121.00043,2,2250336,2253943,-,3607
147,BUMA.1121.00063,2,186799,190410,+,3611
147,BUMA.1121.00079,2,196108,199717,+,3609
147,BUMA.1121.00071,2,187742,191353,+,3611
147,BUMA.1121.00086,2,2155112,2158755,-,3643
147,BUMA.1121.00010,2,1620204,1623843,+,3639
147,BUMA.1121.00040,2,1991510,1995135,-,3625
147,BUMA.1121.00093,2,2745515,2749103,-,3588
147,BUMA.1121.00091,2,280889,284483,-,3594
147,BUMA.1121.00107,2,466148,469766,-,3618
147,BUMA.1121.00088,2,147148,150752,+,3604
147,BUMA.1121.00047,2,1126405,1130036,+,3631
147,BUMA.1121.00087,2,797052,800709,+,3657
147,BUMA.1121.00039,2,606821,610408,-,3587
147,BUMA.1121.00016,2,406221,409808,-,3587
147,BUMA.1121.00092,2,195811,199399,+,3588
147,BUMA.1121.00085,2,966712,970327,-,3615
147,BUMA.1121.00046,2,817917,821479,-,3562
147,BUMA.1121.00003,2,1577301,1580898,+,3597
147,BUMA.1121.00054,2,2320135,2323774,+,3639
147,BUMA.1121.00015,2,55058,58683,-,3625
147,BUMA.1121.00105,2,2310500,2314097,-,3597
147,BUMA.1121.00052,2,1655241,1658856,-,3615
147,BUMA.1121.00053,2,422404,426035,+,3631
147,BUMA.1121.00057,2,1898823,1902420,-,3597
147,BUMA.1121.00108,2,433892,437503,+,3611
147,BUMA.1121.00050,2,292157,295733,+,3576
147,BUMA.1121.00104,2,301254,304865,+,3611
147,BUMA.1121.00014,2,201391,204998,+,3607
147,BUMA.1121.00036,2,1789929,1793577,+,3648
147,BUMA.1121.00038,2,194707,198346,+,3639
147,BUMA.1121.00098,2,402803,406397,+,3594
147,BUMA.1121.00078,2,3029376,3033015,-,3639
147,BUMA.1121.00029,2,1174639,1178236,-,3597
147,BUMA.1121.00099,2,336582,340200,+,3618
147,BUMA.1121.00103,2,2066838,2070445,+,3607
147,BUMA.1121.00102,2,196223,199855,+,3632
147,BUMA.1121.00075,2,2661574,2665185,-,3611
147,BUMA.1121.00076,2,1080435,1084046,+,3611
147,BUMA.1121.00074,2,1049840,1053437,-,3597
147,BUMA.1121.00073,2,186836,190447,+,3611
147,BUMA.1121.00083,2,1993046,1996657,+,3611
147,BUMA.1121.00035,2,1259530,1263127,-,3597
147,BUMA.1121.00072,2,186242,189853,+,3611
147,BUMA.1121.00056,2,692247,695864,-,3617
147,BUMA.1121.00081,2,2125241,2128866,-,3625
147,BUMA.1121.00033,2,864571,868168,+,3597
147,BUMA.1121.00061,2,177605,181216,+,3611
147,BUMA.1121.00062,2,1579596,1583193,-,3597
147,BUMA.1121.00064,2,195504,199101,+,3597
147,BUMA.1121.00060,2,1959892,1963517,-,3625
147,BUMA.1121.00069,2,186279,189890,+,3611
147,BUMA.1121.00070,2,186866,190477,+,3611
147,BUMA.1121.00068,2,1915086,1918684,+,3598
147,BUMA.1121.00067,2,609486,613083,-,3597
147,BUMA.1121.00037,2,449984,453591,+,3607
147,BUMA.1121.00065,2,196737,200348,+,3611
147,BUMA.1121.00058,2,758626,762248,+,3622
147,BUMA.1121.00041,2,1086253,1089888,+,3635
147,BUMA.1121.00084,2,2034493,2038129,+,3636
147,BUMA.1121.00096,2,355627,359227,+,3600
147,BUMA.1121.00080,2,196084,199695,+,3611
147,BUMA.1121.00013,2,232701,236316,-,3615
147,BUMA.1121.00100,2,1309082,1312714,+,3632
147,BUMA.1121.00012,2,1628034,1631641,-,3607
147,BUMA.1121.00018,2,513418,517032,-,3614
147,BUMA.1121.00048,2,539345,542970,-,3625
147,BUMA.1121.00106,2,2610669,2614266,+,3597
147,BUMA.1121.00082,2,196097,199708,+,3611
148,BUMA.1121.00049,2,2017193,2025425,+,8232
148,BUMA.1121.00055,2,2470513,2478831,-,8318
148,BUMA.1121.00011,2,2024658,2032975,+,8317
148,BUMA.1121.00110,2,76039,84303,+,8264
148,BUMA.1121.00109,2,1251461,1259783,-,8322
148,BUMA.1121.00077,2,275035,283298,-,8263
148,BUMA.1121.00027,2,1258763,1267083,+,8320
148,BUMA.1121.00026,2,349056,357361,-,8305
148,BUMA.1121.00021,2,667483,675803,+,8320
148,BUMA.1121.00023,2,261204,269524,+,8320
148,BUMA.1121.00022,2,1330139,1339757,-,9618
148,BUMA.1121.00034,2,179902,189524,+,9622
148,BUMA.1121.00025,2,1827102,1835422,+,8320
148,BUMA.1121.00031,2,2544684,2553004,+,8320
148,BUMA.1121.00007,2,217171,225488,+,8317
148,BUMA.1121.00097,2,3287,11607,+,8320
148,BUMA.1121.00008,2,179894,189516,+,9622
148,BUMA.1121.00059,2,265568,273887,-,8319
148,BUMA.1121.00002,2,778125,787743,+,9618
148,BUMA.1121.00004,2,179898,189520,+,9622
148,BUMA.1121.00005,2,542225,550544,-,8319
148,BUMA.1121.00111,2,2646919,2655239,+,8320
148,BUMA.1121.00006,2,205856,214161,+,8305
148,BUMA.1121.00009,2,2054170,2062490,+,8320
148,BUMA.1121.00094,2,205883,214201,+,8318
148,BUMA.1121.00101,2,41,8375,-,8334
148,BUMA.1121.00066,2,204772,213093,+,8321
148,BUMA.1121.00095,2,2265303,2273623,+,8320
148,BUMA.1121.00112,2,977636,985953,-,8317
148,BUMA.1121.00042,2,1957699,1966004,+,8305
148,BUMA.1121.00090,2,1108841,1117161,+,8320
148,BUMA.1121.00020,2,179907,189529,+,9622
148,BUMA.1121.00089,2,206987,215304,+,8317
148,BUMA.1121.00051,2,207300,215618,+,8318
148,BUMA.1121.00001,2,2048198,2056518,-,8320
148,BUMA.1121.00045,2,55703,64020,+,8317
148,BUMA.1121.00043,2,2234475,2242795,-,8320
148,BUMA.1121.00063,2,197880,206201,+,8321
148,BUMA.1121.00079,2,207272,215591,+,8319
148,BUMA.1121.00071,2,198856,207177,+,8321
148,BUMA.1121.00086,2,2137978,2147596,-,9618
148,BUMA.1121.00024,2,179950,189572,+,9622
148,BUMA.1121.00010,2,1631370,1640988,+,9618
148,BUMA.1121.00040,2,1975652,1983957,-,8305
148,BUMA.1121.00093,2,2729619,2737938,-,8319
148,BUMA.1121.00091,2,264966,273285,-,8319
148,BUMA.1121.00107,2,450319,458638,-,8319
148,BUMA.1121.00088,2,158296,166614,+,8318
148,BUMA.1121.00047,2,1137612,1145929,+,8317
148,BUMA.1121.00019,2,179887,189509,+,9622
148,BUMA.1121.00087,2,808224,817842,+,9618
148,BUMA.1121.00039,2,591004,599322,-,8318
148,BUMA.1121.00030,2,1932255,1941877,-,9622
148,BUMA.1121.00016,2,390275,398595,-,8320
148,BUMA.1121.00092,2,206969,215288,+,8319
148,BUMA.1121.00085,2,950859,959164,-,8305
148,BUMA.1121.00046,2,802101,810406,-,8305
148,BUMA.1121.00003,2,1588473,1596790,+,8317
148,BUMA.1121.00054,2,5980,14285,+,8305
148,BUMA.1121.00015,2,39228,47533,-,8305
148,BUMA.1121.00105,2,2294642,2302959,-,8317
148,BUMA.1121.00052,2,1639388,1647693,-,8305
148,BUMA.1121.00053,2,433600,441920,+,8320
148,BUMA.1121.00057,2,1882928,1891249,-,8321
148,BUMA.1121.00108,2,445007,453327,+,8320
148,BUMA.1121.00050,2,303243,311548,+,8305
148,BUMA.1121.00104,2,312433,320751,+,8318
148,BUMA.1121.00014,2,212533,220853,+,8320
148,BUMA.1121.00036,2,1801118,1810735,+,9617
148,BUMA.1121.00038,2,205874,214179,+,8305
148,BUMA.1121.00098,2,413842,422161,+,8319
148,BUMA.1121.00078,2,3013571,3021891,-,8320
148,BUMA.1121.00029,2,1158796,1167116,-,8320
148,BUMA.1121.00099,2,347768,356089,+,8321
148,BUMA.1121.00103,2,2078023,2086342,+,8319
148,BUMA.1121.00102,2,207407,215724,+,8317
148,BUMA.1121.00028,2,179957,189579,+,9622
148,BUMA.1121.00075,2,2645714,2654033,-,8319
148,BUMA.1121.00044,2,231054,240676,+,9622
148,BUMA.1121.00076,2,1091596,1099915,+,8319
148,BUMA.1121.00074,2,1033998,1042263,-,8265
148,BUMA.1121.00073,2,197918,206236,+,8318
148,BUMA.1121.00083,2,2004161,2012482,+,8321
148,BUMA.1121.00035,2,1243676,1252007,-,8331
148,BUMA.1121.00072,2,197285,205605,+,8320
148,BUMA.1121.00056,2,676373,684690,-,8317
148,BUMA.1121.00081,2,2109407,2117712,-,8305
148,BUMA.1121.00033,2,875673,883992,+,8319
148,BUMA.1121.00061,2,188720,197041,+,8321
148,BUMA.1121.00062,2,1563719,1572038,-,8319
148,BUMA.1121.00064,2,206637,214955,+,8318
148,BUMA.1121.00060,2,1942459,1950776,-,8317
148,BUMA.1121.00069,2,197378,205699,+,8321
148,BUMA.1121.00070,2,197951,206272,+,8321
148,BUMA.1121.00068,2,1926319,1934641,+,8322
148,BUMA.1121.00067,2,593612,601933,-,8321
148,BUMA.1121.00037,2,461130,469453,+,8323
148,BUMA.1121.00065,2,207938,216256,+,8318
148,BUMA.1121.00058,2,769823,778143,+,8320
148,BUMA.1121.00041,2,1097438,1105756,+,8318
148,BUMA.1121.00084,2,2045673,2053992,+,8319
148,BUMA.1121.00096,2,366804,375122,+,8318
148,BUMA.1121.00080,2,207237,215556,+,8319
148,BUMA.1121.00013,2,216861,225166,-,8305
148,BUMA.1121.00100,2,1320293,1328611,+,8318
148,BUMA.1121.00012,2,1612176,1620496,-,8320
148,BUMA.1121.00018,2,497609,505929,-,8320
148,BUMA.1121.00048,2,523511,531816,-,8305
148,BUMA.1121.00106,2,2621813,2630132,+,8319
148,BUMA.1121.00017,2,179888,189510,+,9622
148,BUMA.1121.00082,2,207212,215533,+,8321
149,BUMA.1121.00049,2,2025427,2039549,+,14122
149,BUMA.1121.00055,2,2456391,2470512,-,14121
149,BUMA.1121.00011,2,2032977,2047103,+,14126
149,BUMA.1121.00110,2,84305,98412,+,14107
149,BUMA.1121.00109,2,1237392,1251460,-,14068
149,BUMA.1121.00077,2,260928,275034,-,14106
149,BUMA.1121.00027,2,1267085,1281210,+,14125
149,BUMA.1121.00026,2,334934,349055,-,14121
149,BUMA.1121.00021,2,675805,689929,+,14124
149,BUMA.1121.00023,2,269526,283650,+,14124
149,BUMA.1121.00022,2,1316017,1330138,-,14121
149,BUMA.1121.00034,2,189526,203647,+,14121
149,BUMA.1121.00025,2,1835424,1849548,+,14124
149,BUMA.1121.00031,2,2553006,2567133,+,14127
149,BUMA.1121.00007,2,225490,239615,+,14125
149,BUMA.1121.00097,2,11609,25734,+,14125
149,BUMA.1121.00008,2,189518,203639,+,14121
149,BUMA.1121.00059,2,251442,265567,-,14125
149,BUMA.1121.00002,2,787745,801866,+,14121
149,BUMA.1121.00004,2,189522,203643,+,14121
149,BUMA.1121.00005,2,528104,542224,-,14120
149,BUMA.1121.00111,2,2655241,2669364,+,14123
149,BUMA.1121.00006,2,214163,228284,+,14121
149,BUMA.1121.00009,2,2062492,2076614,+,14122
149,BUMA.1121.00094,2,214203,228328,+,14125
149,BUMA.1121.00101,2,3234879,3248948,-,14069
149,BUMA.1121.00066,2,213095,227219,+,14124
149,BUMA.1121.00095,2,2273625,2287751,+,14126
149,BUMA.1121.00112,2,963510,977635,-,14125
149,BUMA.1121.00042,2,1966006,1980127,+,14121
149,BUMA.1121.00090,2,1117163,1131287,+,14124
149,BUMA.1121.00020,2,189531,203652,+,14121
149,BUMA.1121.00089,2,215306,229431,+,14125
149,BUMA.1121.00051,2,215620,229745,+,14125
149,BUMA.1121.00001,2,2034073,2048197,-,14124
149,BUMA.1121.00045,2,64022,78147,+,14125
149,BUMA.1121.00043,2,2220350,2234474,-,14124
149,BUMA.1121.00063,2,206203,220328,+,14125
149,BUMA.1121.00079,2,215593,229717,+,14124
149,BUMA.1121.00071,2,207179,221304,+,14125
149,BUMA.1121.00086,2,2123856,2137977,-,14121
149,BUMA.1121.00024,2,189574,203695,+,14121
149,BUMA.1121.00010,2,1640990,1655111,+,14121
149,BUMA.1121.00040,2,1961530,1975651,-,14121
149,BUMA.1121.00093,2,2715493,2729618,-,14125
149,BUMA.1121.00091,2,250846,264965,-,14119
149,BUMA.1121.00107,2,436195,450318,-,14123
149,BUMA.1121.00088,2,166616,180741,+,14125
149,BUMA.1121.00047,2,1145931,1160056,+,14125
149,BUMA.1121.00019,2,189511,203632,+,14121
149,BUMA.1121.00087,2,817844,831965,+,14121
149,BUMA.1121.00039,2,576881,591003,-,14122
149,BUMA.1121.00030,2,1918133,1932254,-,14121
149,BUMA.1121.00016,2,376144,390274,-,14130
149,BUMA.1121.00092,2,215290,229415,+,14125
149,BUMA.1121.00085,2,936737,950858,-,14121
149,BUMA.1121.00046,2,787979,802100,-,14121
149,BUMA.1121.00003,2,1596792,1610916,+,14124
149,BUMA.1121.00054,2,14287,28408,+,14121
149,BUMA.1121.00015,2,25106,39227,-,14121
149,BUMA.1121.00105,2,2280516,2294641,-,14125
149,BUMA.1121.00052,2,1625266,1639387,-,14121
149,BUMA.1121.00053,2,441922,456046,+,14124
149,BUMA.1121.00057,2,1868802,1882927,-,14125
149,BUMA.1121.00108,2,453329,467453,+,14124
149,BUMA.1121.00050,2,311550,325671,+,14121
149,BUMA.1121.00104,2,320753,334877,+,14124
149,BUMA.1121.00014,2,220855,234979,+,14124
149,BUMA.1121.00036,2,1810737,1824858,+,14121
149,BUMA.1121.00038,2,214181,228302,+,14121
149,BUMA.1121.00098,2,422163,436295,+,14132
149,BUMA.1121.00078,2,2999449,3013570,-,14121
149,BUMA.1121.00029,2,1144671,1158795,-,14124
149,BUMA.1121.00099,2,356091,370215,+,14124
149,BUMA.1121.00103,2,2086344,2100470,+,14126
149,BUMA.1121.00102,2,215726,229848,+,14122
149,BUMA.1121.00028,2,189581,203702,+,14121
149,BUMA.1121.00075,2,2631589,2645713,-,14124
149,BUMA.1121.00044,2,240678,254799,+,14121
149,BUMA.1121.00076,2,1099917,1114042,+,14125
149,BUMA.1121.00074,2,1019872,1033997,-,14125
149,BUMA.1121.00073,2,206238,220362,+,14124
149,BUMA.1121.00083,2,2012484,2026609,+,14125
149,BUMA.1121.00035,2,1229551,1243675,-,14124
149,BUMA.1121.00072,2,205607,219729,+,14122
149,BUMA.1121.00056,2,662247,676372,-,14125
149,BUMA.1121.00081,2,2095285,2109406,-,14121
149,BUMA.1121.00033,2,883994,898118,+,14124
149,BUMA.1121.00061,2,197043,211167,+,14124
149,BUMA.1121.00062,2,1549596,1563718,-,14122
149,BUMA.1121.00064,2,214957,229082,+,14125
149,BUMA.1121.00060,2,1928333,1942458,-,14125
149,BUMA.1121.00069,2,205701,219824,+,14123
149,BUMA.1121.00070,2,206274,220398,+,14124
149,BUMA.1121.00068,2,1934643,1948765,+,14122
149,BUMA.1121.00067,2,579486,593611,-,14125
149,BUMA.1121.00037,2,469455,483579,+,14124
149,BUMA.1121.00065,2,216258,230383,+,14125
149,BUMA.1121.00058,2,778145,792270,+,14125
149,BUMA.1121.00041,2,1105758,1119862,+,14104
149,BUMA.1121.00084,2,2053994,2068119,+,14125
149,BUMA.1121.00096,2,375124,389249,+,14125
149,BUMA.1121.00080,2,215558,229683,+,14125
149,BUMA.1121.00013,2,202739,216860,-,14121
149,BUMA.1121.00100,2,1328613,1342744,+,14131
149,BUMA.1121.00012,2,1598053,1612175,-,14122
149,BUMA.1121.00018,2,483484,497608,-,14124
149,BUMA.1121.00048,2,509389,523510,-,14121
149,BUMA.1121.00106,2,2630134,2644259,+,14125
149,BUMA.1121.00017,2,189512,203633,+,14121
149,BUMA.1121.00082,2,215535,229660,+,14125
150,BUMA.1121.00049,2,2043526,2064522,+,20996
150,BUMA.1121.00055,2,2431437,2452402,-,20965
150,BUMA.1121.00011,2,2051092,2072154,+,21062
150,BUMA.1121.00110,2,102401,123390,+,20989
150,BUMA.1121.00109,2,1212428,1233427,-,20999
150,BUMA.1121.00077,2,235947,256937,-,20990
150,BUMA.1121.00027,2,1285187,1306218,+,21031
150,BUMA.1121.00026,2,309945,330963,-,21018
150,BUMA.1121.00021,2,693918,714896,+,20978
150,BUMA.1121.00023,2,287639,308599,+,20960
150,BUMA.1121.00022,2,1291070,1312040,-,20970
150,BUMA.1121.00034,2,209216,230182,+,20966
150,BUMA.1121.00025,2,1853537,1874491,+,20954
150,BUMA.1121.00031,2,2571122,2592080,+,20958
150,BUMA.1121.00007,2,243591,264587,+,20996
150,BUMA.1121.00097,2,29711,50662,+,20951
150,BUMA.1121.00008,2,209208,230174,+,20966
150,BUMA.1121.00059,2,226495,247453,-,20958
150,BUMA.1121.00002,2,805843,826813,+,20970
150,BUMA.1121.00004,2,209212,230178,+,20966
150,BUMA.1121.00005,2,503149,524152,-,21003
150,BUMA.1121.00111,2,2673353,2694330,+,20977
150,BUMA.1121.00006,2,232261,253237,+,20976
150,BUMA.1121.00009,2,2080602,2101624,+,21022
150,BUMA.1121.00094,2,232317,253310,+,20993
150,BUMA.1121.00101,2,3209841,3230890,-,21049
150,BUMA.1121.00066,2,231208,252207,+,20999
150,BUMA.1121.00095,2,2291740,2312712,+,20972
150,BUMA.1121.00112,2,938524,959521,-,20997
150,BUMA.1121.00042,2,1984098,2005074,+,20976
150,BUMA.1121.00032,2,633623,654589,+,20966
150,BUMA.1121.00090,2,1135276,1156230,+,20954
150,BUMA.1121.00020,2,209221,230187,+,20966
150,BUMA.1121.00089,2,233420,254427,+,21007
150,BUMA.1121.00051,2,233734,254729,+,20995
150,BUMA.1121.00001,2,2009099,2030084,-,20985
150,BUMA.1121.00045,2,82148,103130,+,20982
150,BUMA.1121.00043,2,2195426,2216361,-,20935
150,BUMA.1121.00063,2,224314,245280,+,20966
150,BUMA.1121.00079,2,233692,254660,+,20968
150,BUMA.1121.00071,2,225283,246269,+,20986
150,BUMA.1121.00086,2,2098915,2119879,-,20964
150,BUMA.1121.00024,2,209264,230224,+,20960
150,BUMA.1121.00010,2,1659088,1680058,+,20970
150,BUMA.1121.00040,2,1936529,1957553,-,21024
150,BUMA.1121.00093,2,2690526,2711504,-,20978
150,BUMA.1121.00091,2,225914,246869,-,20955
150,BUMA.1121.00107,2,411282,432206,-,20924
150,BUMA.1121.00088,2,184742,205734,+,20992
150,BUMA.1121.00047,2,1164045,1185022,+,20977
150,BUMA.1121.00019,2,209201,230167,+,20966
150,BUMA.1121.00087,2,835942,856906,+,20964
150,BUMA.1121.00039,2,551877,572880,-,21003
150,BUMA.1121.00030,2,1891598,1912563,-,20965
150,BUMA.1121.00016,2,351151,372155,-,21004
150,BUMA.1121.00092,2,233404,254382,+,20978
150,BUMA.1121.00085,2,911802,932760,-,20958
150,BUMA.1121.00046,2,763038,784002,-,20964
150,BUMA.1121.00003,2,1614893,1635905,+,21012
150,BUMA.1121.00054,2,32385,53361,+,20976
150,BUMA.1121.00015,2,153,21129,-,20976
150,BUMA.1121.00105,2,2255561,2276539,-,20978
150,BUMA.1121.00052,2,1600331,1621289,-,20958
150,BUMA.1121.00053,2,460023,481054,+,21031
150,BUMA.1121.00057,2,1843790,1864825,-,21035
150,BUMA.1121.00108,2,471430,492403,+,20973
150,BUMA.1121.00050,2,329648,350612,+,20964
150,BUMA.1121.00104,2,338854,359852,+,20998
150,BUMA.1121.00014,2,238968,259914,+,20946
150,BUMA.1121.00036,2,1828835,1849817,+,20982
150,BUMA.1121.00038,2,232279,253255,+,20976
150,BUMA.1121.00098,2,440284,461288,+,21004
150,BUMA.1121.00078,2,2974471,2995472,-,21001
150,BUMA.1121.00029,2,1119721,1140682,-,20961
150,BUMA.1121.00099,2,374204,395191,+,20987
150,BUMA.1121.00103,2,2104459,2125464,+,21005
150,BUMA.1121.00102,2,233837,254847,+,21010
150,BUMA.1121.00028,2,209271,230231,+,20960
150,BUMA.1121.00075,2,2606653,2627615,-,20962
150,BUMA.1121.00044,2,260368,281334,+,20966
150,BUMA.1121.00076,2,1118019,1138980,+,20961
150,BUMA.1121.00074,2,994915,1015895,-,20980
150,BUMA.1121.00073,2,224350,245327,+,20977
150,BUMA.1121.00083,2,2030598,2051595,+,20997
150,BUMA.1121.00035,2,1204565,1225562,-,20997
150,BUMA.1121.00072,2,223702,244696,+,20994
150,BUMA.1121.00056,2,637250,658258,-,21008
150,BUMA.1121.00081,2,2070333,2091308,-,20975
150,BUMA.1121.00033,2,902119,923085,+,20966
150,BUMA.1121.00061,2,215156,236141,+,20985
150,BUMA.1121.00062,2,1524632,1545607,-,20975
150,BUMA.1121.00064,2,233071,254044,+,20973
150,BUMA.1121.00060,2,1903337,1924332,-,20995
150,BUMA.1121.00069,2,223805,244798,+,20993
150,BUMA.1121.00070,2,224386,245363,+,20977
150,BUMA.1121.00068,2,1952754,1973754,+,21000
150,BUMA.1121.00067,2,554523,575497,-,20974
150,BUMA.1121.00037,2,487568,508534,+,20966
150,BUMA.1121.00065,2,234372,255342,+,20970
150,BUMA.1121.00058,2,796259,817209,+,20950
150,BUMA.1121.00041,2,1123839,1144865,+,21026
150,BUMA.1121.00084,2,2072096,2093051,+,20955
150,BUMA.1121.00096,2,393232,414244,+,21012
150,BUMA.1121.00080,2,233672,254655,+,20983
150,BUMA.1121.00013,2,177804,198762,-,20958
150,BUMA.1121.00100,2,1346733,1367783,+,21050
150,BUMA.1121.00012,2,1573109,1594064,-,20955
150,BUMA.1121.00018,2,458534,479495,-,20961
150,BUMA.1121.00048,2,484436,505412,-,20976
150,BUMA.1121.00106,2,2648236,2669213,+,20977
150,BUMA.1121.00017,2,209202,230168,+,20966
150,BUMA.1121.00082,2,233649,254646,+,20997
151,BUMA.1121.00049,2,2064810,2099365,+,34555
151,BUMA.1121.00055,2,2396670,2431134,-,34464
151,BUMA.1121.00011,2,2072457,2106970,+,34513
151,BUMA.1121.00110,2,123693,158019,+,34326
151,BUMA.1121.00109,2,1177603,1212125,-,34522
151,BUMA.1121.00077,2,201306,235644,-,34338
151,BUMA.1121.00027,2,1306506,1340953,+,34447
151,BUMA.1121.00026,2,275142,309657,-,34515
151,BUMA.1121.00021,2,715199,749652,+,34453
151,BUMA.1121.00023,2,308902,343549,+,34647
151,BUMA.1121.00022,2,1255986,1290782,-,34796
151,BUMA.1121.00034,2,230470,265175,+,34705
151,BUMA.1121.00025,2,1874794,1909291,+,34497
151,BUMA.1121.00031,2,2592383,2626893,+,34510
151,BUMA.1121.00007,2,264890,299301,+,34411
151,BUMA.1121.00097,2,50965,85373,+,34408
151,BUMA.1121.00008,2,230462,265118,+,34656
151,BUMA.1121.00059,2,191652,226192,-,34540
151,BUMA.1121.00002,2,827101,861624,+,34523
151,BUMA.1121.00004,2,230466,265133,+,34667
151,BUMA.1121.00005,2,468559,502861,-,34302
151,BUMA.1121.00111,2,2694618,2728928,+,34310
151,BUMA.1121.00006,2,253525,288588,+,35063
151,BUMA.1121.00009,2,2101912,2136619,+,34707
151,BUMA.1121.00094,2,253613,288210,+,34597
151,BUMA.1121.00101,2,3175142,3209538,-,34396
151,BUMA.1121.00066,2,252495,287053,+,34558
151,BUMA.1121.00095,2,2313015,2347498,+,34483
151,BUMA.1121.00112,2,903872,938221,-,34349
151,BUMA.1121.00042,2,2005362,2039922,+,34560
151,BUMA.1121.00032,2,654877,689512,+,34635
151,BUMA.1121.00090,2,1156533,1191120,+,34587
151,BUMA.1121.00020,2,230475,265155,+,34680
151,BUMA.1121.00089,2,254730,289311,+,34581
151,BUMA.1121.00051,2,255032,289604,+,34572
151,BUMA.1121.00001,2,1974224,2008796,-,34572
151,BUMA.1121.00045,2,103433,138028,+,34595
151,BUMA.1121.00043,2,2160284,2195123,-,34839
151,BUMA.1121.00063,2,245583,280140,+,34557
151,BUMA.1121.00079,2,254963,289476,+,34513
151,BUMA.1121.00071,2,246557,281088,+,34531
151,BUMA.1121.00086,2,2063901,2098627,-,34726
151,BUMA.1121.00024,2,230512,265070,+,34558
151,BUMA.1121.00010,2,1680346,1715100,+,34754
151,BUMA.1121.00040,2,1901644,1936241,-,34597
151,BUMA.1121.00093,2,2655685,2690238,-,34553
151,BUMA.1121.00091,2,191185,225611,-,34426
151,BUMA.1121.00107,2,376562,410994,-,34432
151,BUMA.1121.00088,2,206037,240631,+,34594
151,BUMA.1121.00047,2,1185325,1220129,+,34804
151,BUMA.1121.00019,2,230455,265125,+,34670
151,BUMA.1121.00087,2,857194,891514,+,34320
151,BUMA.1121.00039,2,516993,551574,-,34581
151,BUMA.1121.00030,2,1856640,1891310,-,34670
151,BUMA.1121.00016,2,316354,350863,-,34509
151,BUMA.1121.00092,2,254670,289223,+,34553
151,BUMA.1121.00085,2,876857,911514,-,34657
151,BUMA.1121.00046,2,727792,762750,-,34958
151,BUMA.1121.00003,2,1636193,1670719,+,34526
151,BUMA.1121.00054,2,53649,88747,+,35098
151,BUMA.1121.00015,2,2202755,2237368,-,34613
151,BUMA.1121.00105,2,2220873,2255258,-,34385
151,BUMA.1121.00052,2,1565408,1600043,-,34635
151,BUMA.1121.00053,2,481342,516218,+,34876
151,BUMA.1121.00057,2,1809027,1843502,-,34475
151,BUMA.1121.00108,2,492691,527041,+,34350
151,BUMA.1121.00050,2,350900,385710,+,34810
151,BUMA.1121.00104,2,360140,394779,+,34639
151,BUMA.1121.00014,2,260217,294670,+,34453
151,BUMA.1121.00036,2,1850105,1884824,+,34719
151,BUMA.1121.00038,2,253543,288628,+,35085
151,BUMA.1121.00098,2,461591,496028,+,34437
151,BUMA.1121.00078,2,2939906,2974168,-,34262
151,BUMA.1121.00029,2,1084882,1119418,-,34536
151,BUMA.1121.00099,2,395494,429848,+,34354
151,BUMA.1121.00103,2,2125767,2160102,+,34335
151,BUMA.1121.00102,2,255135,290093,+,34958
151,BUMA.1121.00028,2,230519,265122,+,34603
151,BUMA.1121.00075,2,2571850,2606350,-,34500
151,BUMA.1121.00044,2,281622,316285,+,34663
151,BUMA.1121.00076,2,1139283,1173813,+,34530
151,BUMA.1121.00074,2,959982,994612,-,34630
151,BUMA.1121.00073,2,245615,280076,+,34461
151,BUMA.1121.00083,2,2051898,2086473,+,34575
151,BUMA.1121.00035,2,1169692,1204262,-,34570
151,BUMA.1121.00072,2,244999,279521,+,34522
151,BUMA.1121.00056,2,602360,636947,-,34587
151,BUMA.1121.00081,2,2034919,2070045,-,35126
151,BUMA.1121.00033,2,923388,958038,+,34650
151,BUMA.1121.00061,2,236444,270997,+,34553
151,BUMA.1121.00062,2,1489816,1524329,-,34513
151,BUMA.1121.00064,2,254347,289043,+,34696
151,BUMA.1121.00060,2,1868461,1903034,-,34573
151,BUMA.1121.00069,2,245101,279655,+,34554
151,BUMA.1121.00070,2,245651,280120,+,34469
151,BUMA.1121.00068,2,1974042,2008622,+,34580
151,BUMA.1121.00067,2,519754,554220,-,34466
151,BUMA.1121.00037,2,508837,543445,+,34608
151,BUMA.1121.00065,2,255630,290115,+,34485
151,BUMA.1121.00058,2,817512,852026,+,34514
151,BUMA.1121.00041,2,1145168,1179675,+,34507
151,BUMA.1121.00084,2,2093354,2127838,+,34484
151,BUMA.1121.00096,2,414547,448958,+,34411
151,BUMA.1121.00080,2,254958,289426,+,34468
151,BUMA.1121.00013,2,142915,177516,-,34601
151,BUMA.1121.00100,2,1368086,1402708,+,34622
151,BUMA.1121.00012,2,1538181,1572806,-,34625
151,BUMA.1121.00018,2,423735,458231,-,34496
151,BUMA.1121.00048,2,448959,484148,-,35189
151,BUMA.1121.00106,2,2669501,2703968,+,34467
151,BUMA.1121.00017,2,230456,265154,+,34698
151,BUMA.1121.00082,2,254949,289516,+,34567
152,BUMA.1121.00049,2,2099471,2110134,+,10663
152,BUMA.1121.00055,2,2385916,2396564,-,10648
152,BUMA.1121.00011,2,2107076,2117889,+,10813
152,BUMA.1121.00110,2,158125,168909,+,10784
152,BUMA.1121.00109,2,1166742,1177497,-,10755
152,BUMA.1121.00077,2,190410,201200,-,10790
152,BUMA.1121.00027,2,1341059,1351893,+,10834
152,BUMA.1121.00026,2,850561,861162,+,10601
152,BUMA.1121.00021,2,749758,760441,+,10683
152,BUMA.1121.00023,2,343655,354410,+,10755
152,BUMA.1121.00022,2,1245297,1255880,-,10583
152,BUMA.1121.00034,2,265281,275864,+,10583
152,BUMA.1121.00025,2,1909397,1920145,+,10748
152,BUMA.1121.00031,2,2626999,2637678,+,10679
152,BUMA.1121.00007,2,299407,310142,+,10735
152,BUMA.1121.00097,2,85479,96264,+,10785
152,BUMA.1121.00008,2,265224,275807,+,10583
152,BUMA.1121.00059,2,180854,191546,-,10692
152,BUMA.1121.00002,2,861730,872313,+,10583
152,BUMA.1121.00004,2,265239,275822,+,10583
152,BUMA.1121.00005,2,457656,468453,-,10797
152,BUMA.1121.00111,2,2729034,2739677,+,10643
152,BUMA.1121.00006,2,288694,299277,+,10583
152,BUMA.1121.00009,2,2136725,2147515,+,10790
152,BUMA.1121.00094,2,288316,298881,+,10565
152,BUMA.1121.00101,2,3164283,3175036,-,10753
152,BUMA.1121.00066,2,287159,297919,+,10760
152,BUMA.1121.00095,2,2347604,2358328,+,10724
152,BUMA.1121.00112,2,892994,903766,-,10772
152,BUMA.1121.00032,2,689618,700201,+,10583
152,BUMA.1121.00090,2,1191226,1201988,+,10762
152,BUMA.1121.00020,2,265261,275844,+,10583
152,BUMA.1121.00089,2,289417,299992,+,10575
152,BUMA.1121.00051,2,289710,300311,+,10601
152,BUMA.1121.00001,2,1963073,1974118,-,11045
152,BUMA.1121.00045,2,138134,149040,+,10906
152,BUMA.1121.00043,2,2149514,2160178,-,10664
152,BUMA.1121.00063,2,280246,290966,+,10720
152,BUMA.1121.00079,2,289582,300167,+,10585
152,BUMA.1121.00071,2,281194,291945,+,10751
152,BUMA.1121.00086,2,2053206,2063795,-,10589
152,BUMA.1121.00024,2,265176,275759,+,10583
152,BUMA.1121.00010,2,1715206,1725789,+,10583
152,BUMA.1121.00040,2,1890951,1901538,-,10587
152,BUMA.1121.00093,2,2644887,2655579,-,10692
152,BUMA.1121.00091,2,180397,191079,-,10682
152,BUMA.1121.00107,2,365681,376456,-,10775
152,BUMA.1121.00088,2,240737,251441,+,10704
152,BUMA.1121.00047,2,1220235,1230804,+,10569
152,BUMA.1121.00019,2,265231,275814,+,10583
152,BUMA.1121.00087,2,891620,902209,+,10589
152,BUMA.1121.00039,2,506176,516887,-,10711
152,BUMA.1121.00030,2,1845951,1856534,-,10583
152,BUMA.1121.00016,2,305489,316248,-,10759
152,BUMA.1121.00092,2,289329,300021,+,10692
152,BUMA.1121.00085,2,866156,876751,-,10595
152,BUMA.1121.00046,2,717103,727686,-,10583
152,BUMA.1121.00003,2,1670825,1681355,+,10530
152,BUMA.1121.00054,2,88853,99436,+,10583
152,BUMA.1121.00015,2,2192060,2202649,-,10589
152,BUMA.1121.00105,2,2210073,2220767,-,10694
152,BUMA.1121.00052,2,1554707,1565302,-,10595
152,BUMA.1121.00053,2,516324,527030,+,10706
152,BUMA.1121.00057,2,1798120,1808921,-,10801
152,BUMA.1121.00108,2,527147,537969,+,10822
152,BUMA.1121.00050,2,385816,396399,+,10583
152,BUMA.1121.00104,2,394885,405543,+,10658
152,BUMA.1121.00014,2,294776,305479,+,10703
152,BUMA.1121.00036,2,1884930,1895513,+,10583
152,BUMA.1121.00038,2,288734,299317,+,10583
152,BUMA.1121.00098,2,496134,506973,+,10839
152,BUMA.1121.00078,2,2929154,2939800,-,10646
152,BUMA.1121.00029,2,1073704,1084776,-,11072
152,BUMA.1121.00099,2,429954,440738,+,10784
152,BUMA.1121.00103,2,2160208,2170828,+,10620
152,BUMA.1121.00102,2,290199,300855,+,10656
152,BUMA.1121.00028,2,265228,275811,+,10583
152,BUMA.1121.00075,2,2561103,2571744,-,10641
152,BUMA.1121.00044,2,316391,326974,+,10583
152,BUMA.1121.00076,2,1173919,1184593,+,10674
152,BUMA.1121.00074,2,949254,959876,-,10622
152,BUMA.1121.00073,2,280182,290971,+,10789
152,BUMA.1121.00083,2,2086579,2097368,+,10789
152,BUMA.1121.00035,2,1158517,1169586,-,11069
152,BUMA.1121.00072,2,279627,290405,+,10778
152,BUMA.1121.00056,2,591679,602254,-,10575
152,BUMA.1121.00081,2,2024230,2034813,-,10583
152,BUMA.1121.00033,2,958144,968964,+,10820
152,BUMA.1121.00061,2,271103,281854,+,10751
152,BUMA.1121.00062,2,1478985,1489710,-,10725
152,BUMA.1121.00064,2,289149,299792,+,10643
152,BUMA.1121.00060,2,1857453,1868355,-,10902
152,BUMA.1121.00069,2,279761,290522,+,10761
152,BUMA.1121.00070,2,280226,291015,+,10789
152,BUMA.1121.00068,2,2008728,2019434,+,10706
152,BUMA.1121.00067,2,509031,519648,-,10617
152,BUMA.1121.00037,2,543551,554359,+,10808
152,BUMA.1121.00065,2,290221,300896,+,10675
152,BUMA.1121.00058,2,852132,862833,+,10701
152,BUMA.1121.00041,2,1179781,1190486,+,10705
152,BUMA.1121.00084,2,2127944,2138654,+,10710
152,BUMA.1121.00096,2,449064,459929,+,10865
152,BUMA.1121.00080,2,289532,300109,+,10577
152,BUMA.1121.00013,2,132214,142809,-,10595
152,BUMA.1121.00100,2,1402814,1413599,+,10785
152,BUMA.1121.00012,2,1527375,1538075,-,10700
152,BUMA.1121.00018,2,412881,423629,-,10748
152,BUMA.1121.00048,2,438270,448853,-,10583
152,BUMA.1121.00106,2,2704074,2714801,+,10727
152,BUMA.1121.00017,2,265260,275843,+,10583
152,BUMA.1121.00082,2,289622,300411,+,10789
153,BUMA.1121.00049,2,2113746,2123996,+,10250
153,BUMA.1121.00055,2,2372252,2382390,-,10138
153,BUMA.1121.00011,2,2121369,2131490,+,10121
153,BUMA.1121.00110,2,172379,182544,+,10165
153,BUMA.1121.00109,2,1152993,1163251,-,10258
153,BUMA.1121.00077,2,176785,186940,-,10155
153,BUMA.1121.00027,2,1355134,1365353,+,10219
153,BUMA.1121.00026,2,864692,874803,+,10111
153,BUMA.1121.00021,2,763921,774073,+,10152
153,BUMA.1121.00023,2,357967,368099,+,10132
153,BUMA.1121.00022,2,1231736,1241818,-,10082
153,BUMA.1121.00034,2,279352,289500,+,10148
153,BUMA.1121.00025,2,1923632,1933903,+,10271
153,BUMA.1121.00031,2,2641186,2651426,+,10240
153,BUMA.1121.00007,2,313651,323713,+,10062
153,BUMA.1121.00097,2,99772,109948,+,10176
153,BUMA.1121.00008,2,279295,289407,+,10112
153,BUMA.1121.00059,2,167026,177242,-,10216
153,BUMA.1121.00002,2,875837,885936,+,10099
153,BUMA.1121.00004,2,279310,289463,+,10153
153,BUMA.1121.00005,2,442767,454154,-,11387
153,BUMA.1121.00111,2,2743178,2753346,+,10168
153,BUMA.1121.00006,2,302786,312891,+,10105
153,BUMA.1121.00009,2,2151069,2161288,+,10219
153,BUMA.1121.00094,2,302410,312603,+,10193
153,BUMA.1121.00101,2,3150693,3160803,-,10110
153,BUMA.1121.00066,2,301153,311435,+,10282
153,BUMA.1121.00095,2,2361819,2371962,+,10143
153,BUMA.1121.00112,2,879241,889478,-,10237
153,BUMA.1121.00042,2,2044662,2054815,+,10153
153,BUMA.1121.00032,2,703689,713813,+,10124
153,BUMA.1121.00090,2,1205496,1215640,+,10144
153,BUMA.1121.00020,2,279332,289456,+,10124
153,BUMA.1121.00089,2,303539,313702,+,10163
153,BUMA.1121.00051,2,303799,313970,+,10171
153,BUMA.1121.00001,2,1949227,1959509,-,10282
153,BUMA.1121.00045,2,152573,162696,+,10123
153,BUMA.1121.00043,2,2135796,2146027,-,10231
153,BUMA.1121.00063,2,294200,304550,+,10350
153,BUMA.1121.00079,2,303648,313933,+,10285
153,BUMA.1121.00071,2,295179,305471,+,10292
153,BUMA.1121.00086,2,2039610,2049692,-,10082
153,BUMA.1121.00024,2,279247,289335,+,10088
153,BUMA.1121.00010,2,1729305,1739404,+,10099
153,BUMA.1121.00040,2,1877353,1887470,-,10117
153,BUMA.1121.00093,2,2631207,2641336,-,10129
153,BUMA.1121.00091,2,166700,176888,-,10188
153,BUMA.1121.00107,2,351970,362102,-,10132
153,BUMA.1121.00088,2,255011,265232,+,10221
153,BUMA.1121.00047,2,1234292,1244451,+,10159
153,BUMA.1121.00019,2,279302,289420,+,10118
153,BUMA.1121.00087,2,905723,915664,+,9941
153,BUMA.1121.00039,2,492512,502633,-,10121
153,BUMA.1121.00030,2,1832298,1842463,-,10165
153,BUMA.1121.00016,2,291654,302009,-,10355
153,BUMA.1121.00092,2,303572,313700,+,10128
153,BUMA.1121.00085,2,852513,862661,-,10148
153,BUMA.1121.00046,2,703472,713608,-,10136
153,BUMA.1121.00003,2,1684849,1695152,+,10303
153,BUMA.1121.00054,2,102945,113050,+,10105
153,BUMA.1121.00015,2,2178413,2188537,-,10124
153,BUMA.1121.00105,2,2196323,2206550,-,10227
153,BUMA.1121.00052,2,1541064,1551212,-,10148
153,BUMA.1121.00053,2,530553,540693,+,10140
153,BUMA.1121.00057,2,1784610,1794879,-,10269
153,BUMA.1121.00108,2,541436,551532,+,10096
153,BUMA.1121.00050,2,399894,410029,+,10135
153,BUMA.1121.00104,2,409127,419321,+,10194
153,BUMA.1121.00014,2,308959,319220,+,10261
153,BUMA.1121.00036,2,1899029,1909146,+,10117
153,BUMA.1121.00038,2,302826,312925,+,10099
153,BUMA.1121.00098,2,510749,520893,+,10144
153,BUMA.1121.00078,2,2915464,2925656,-,10192
153,BUMA.1121.00029,2,1059902,1070182,-,10280
153,BUMA.1121.00099,2,444260,454435,+,10175
153,BUMA.1121.00103,2,2174371,2184526,+,10155
153,BUMA.1121.00102,2,304455,314667,+,10212
153,BUMA.1121.00028,2,279299,289417,+,10118
153,BUMA.1121.00075,2,2547543,2557667,-,10124
153,BUMA.1121.00044,2,330462,340616,+,10154
153,BUMA.1121.00076,2,1188008,1198124,+,10116
153,BUMA.1121.00074,2,935439,945661,-,10222
153,BUMA.1121.00073,2,294205,304508,+,10303
153,BUMA.1121.00083,2,2100602,2110986,+,10384
153,BUMA.1121.00035,2,1144730,1155002,-,10272
153,BUMA.1121.00072,2,293639,303818,+,10179
153,BUMA.1121.00056,2,577962,588132,-,10170
153,BUMA.1121.00081,2,2010615,2020721,-,10106
153,BUMA.1121.00033,2,972465,982603,+,10138
153,BUMA.1121.00061,2,285088,295364,+,10276
153,BUMA.1121.00062,2,1465249,1475456,-,10207
153,BUMA.1121.00064,2,303315,313455,+,10140
153,BUMA.1121.00060,2,1843790,1853920,-,10130
153,BUMA.1121.00069,2,293755,303971,+,10216
153,BUMA.1121.00070,2,294249,304505,+,10256
153,BUMA.1121.00068,2,2022936,2033138,+,10202
153,BUMA.1121.00067,2,495358,505466,-,10108
153,BUMA.1121.00037,2,557870,568134,+,10264
153,BUMA.1121.00065,2,304494,314741,+,10247
153,BUMA.1121.00058,2,866396,876616,+,10220
153,BUMA.1121.00041,2,1194037,1204199,+,10162
153,BUMA.1121.00084,2,2142210,2152401,+,10191
153,BUMA.1121.00096,2,463487,473694,+,10207
153,BUMA.1121.00080,2,303604,313770,+,10166
153,BUMA.1121.00013,2,118576,128712,-,10136
153,BUMA.1121.00100,2,1417059,1427330,+,10271
153,BUMA.1121.00012,2,1513763,1523902,-,10139
153,BUMA.1121.00018,2,399128,409394,-,10266
153,BUMA.1121.00048,2,424655,434761,-,10106
153,BUMA.1121.00106,2,2718385,2728587,+,10202
153,BUMA.1121.00017,2,279331,289479,+,10148
153,BUMA.1121.00082,2,303645,314029,+,10384
154,BUMA.1121.00049,2,2127550,2136000,+,8450
154,BUMA.1121.00055,2,2360262,2368712,-,8450
154,BUMA.1121.00011,2,2135029,2143478,+,8449
154,BUMA.1121.00110,2,186019,194480,+,8461
154,BUMA.1121.00109,2,1141006,1149456,-,8450
154,BUMA.1121.00077,2,164850,173310,-,8460
154,BUMA.1121.00027,2,1368893,1377347,+,8454
154,BUMA.1121.00026,2,878343,886764,+,8421
154,BUMA.1121.00021,2,778968,787418,+,8450
154,BUMA.1121.00023,2,371640,380082,+,8442
154,BUMA.1121.00022,2,1219746,1228196,-,8450
154,BUMA.1121.00034,2,293040,301490,+,8450
154,BUMA.1121.00025,2,1937444,1945894,+,8450
154,BUMA.1121.00031,2,2654967,2663418,+,8451
154,BUMA.1121.00007,2,327263,335712,+,8449
154,BUMA.1121.00097,2,113499,121949,+,8450
154,BUMA.1121.00008,2,292947,301397,+,8450
154,BUMA.1121.00059,2,155033,163489,-,8456
154,BUMA.1121.00002,2,889476,897926,+,8450
154,BUMA.1121.00004,2,293003,301453,+,8450
154,BUMA.1121.00005,2,430760,439229,-,8469
154,BUMA.1121.00111,2,2756887,2765337,+,8450
154,BUMA.1121.00006,2,316431,324881,+,8450
154,BUMA.1121.00009,2,2164829,2173279,+,8450
154,BUMA.1121.00094,2,316125,324563,+,8438
154,BUMA.1121.00101,2,3134479,3142921,-,8442
154,BUMA.1121.00066,2,314972,323427,+,8455
154,BUMA.1121.00095,2,2375514,2383921,+,8407
154,BUMA.1121.00112,2,867243,875692,-,8449
154,BUMA.1121.00042,2,2058355,2066776,+,8421
154,BUMA.1121.00032,2,717353,725803,+,8450
154,BUMA.1121.00090,2,1219181,1227631,+,8450
154,BUMA.1121.00020,2,292996,301446,+,8450
154,BUMA.1121.00089,2,317256,325723,+,8467
154,BUMA.1121.00051,2,317511,325977,+,8466
154,BUMA.1121.00001,2,1937236,1945686,-,8450
154,BUMA.1121.00045,2,166235,174685,+,8450
154,BUMA.1121.00043,2,2123790,2132255,-,8465
154,BUMA.1121.00063,2,308087,316541,+,8454
154,BUMA.1121.00079,2,317474,325929,+,8455
154,BUMA.1121.00071,2,309008,317463,+,8455
154,BUMA.1121.00086,2,2027596,2036070,-,8474
154,BUMA.1121.00024,2,292875,301325,+,8450
154,BUMA.1121.00010,2,1742944,1751394,+,8450
154,BUMA.1121.00040,2,1865363,1873813,-,8450
154,BUMA.1121.00093,2,2619218,2627668,-,8450
154,BUMA.1121.00091,2,154710,163160,-,8450
154,BUMA.1121.00107,2,339972,348422,-,8450
154,BUMA.1121.00088,2,268769,277219,+,8450
154,BUMA.1121.00047,2,1247992,1256459,+,8467
154,BUMA.1121.00019,2,292960,301410,+,8450
154,BUMA.1121.00087,2,919204,927679,+,8475
154,BUMA.1121.00039,2,480521,488971,-,8450
154,BUMA.1121.00030,2,1820308,1828758,-,8450
154,BUMA.1121.00016,2,279655,288106,-,8451
154,BUMA.1121.00092,2,317239,325689,+,8450
154,BUMA.1121.00085,2,840541,848973,-,8432
154,BUMA.1121.00046,2,691498,699932,-,8434
154,BUMA.1121.00003,2,1702931,1711392,+,8461
154,BUMA.1121.00054,2,116590,125040,+,8450
154,BUMA.1121.00015,2,2166423,2174873,-,8450
154,BUMA.1121.00105,2,2184347,2192785,-,8438
154,BUMA.1121.00052,2,1529092,1537524,-,8432
154,BUMA.1121.00053,2,545688,554137,+,8449
154,BUMA.1121.00057,2,1772620,1781070,-,8450
154,BUMA.1121.00108,2,555071,563520,+,8449
154,BUMA.1121.00050,2,413569,422003,+,8434
154,BUMA.1121.00104,2,422861,431311,+,8450
154,BUMA.1121.00014,2,322761,331212,+,8451
154,BUMA.1121.00036,2,1912686,1921136,+,8450
154,BUMA.1121.00038,2,316465,324915,+,8450
154,BUMA.1121.00098,2,524442,532902,+,8460
154,BUMA.1121.00078,2,2903466,2911924,-,8458
154,BUMA.1121.00029,2,1047911,1056361,-,8450
154,BUMA.1121.00099,2,459298,467747,+,8449
154,BUMA.1121.00103,2,2188065,2196515,+,8450
154,BUMA.1121.00102,2,318206,326656,+,8450
154,BUMA.1121.00028,2,292957,301407,+,8450
154,BUMA.1121.00075,2,2535554,2544004,-,8450
154,BUMA.1121.00044,2,344156,352606,+,8450
154,BUMA.1121.00076,2,1201663,1210113,+,8450
154,BUMA.1121.00074,2,923450,931900,-,8450
154,BUMA.1121.00073,2,308045,316500,+,8455
154,BUMA.1121.00083,2,2114523,2122978,+,8455
154,BUMA.1121.00035,2,1132739,1141189,-,8450
154,BUMA.1121.00072,2,307339,315794,+,8455
154,BUMA.1121.00056,2,566160,574408,-,8248
154,BUMA.1121.00081,2,1998625,2007075,-,8450
154,BUMA.1121.00033,2,986144,994594,+,8450
154,BUMA.1121.00061,2,298901,307367,+,8466
154,BUMA.1121.00062,2,1453281,1461719,-,8438
154,BUMA.1121.00064,2,317002,325452,+,8450
154,BUMA.1121.00060,2,1831801,1840251,-,8450
154,BUMA.1121.00069,2,307492,315947,+,8455
154,BUMA.1121.00070,2,308042,316497,+,8455
154,BUMA.1121.00068,2,2036677,2045127,+,8450
154,BUMA.1121.00067,2,483369,491819,-,8450
154,BUMA.1121.00037,2,571675,580125,+,8450
154,BUMA.1121.00065,2,318280,326730,+,8450
154,BUMA.1121.00058,2,880153,888603,+,8450
154,BUMA.1121.00041,2,1207740,1216190,+,8450
154,BUMA.1121.00084,2,2155938,2164393,+,8455
154,BUMA.1121.00096,2,477242,485703,+,8461
154,BUMA.1121.00080,2,317311,325778,+,8467
154,BUMA.1121.00013,2,106604,115036,-,8432
154,BUMA.1121.00100,2,1430909,1439359,+,8450
154,BUMA.1121.00012,2,1501772,1510222,-,8450
154,BUMA.1121.00018,2,387137,395587,-,8450
154,BUMA.1121.00048,2,412665,421115,-,8450
154,BUMA.1121.00106,2,2732126,2740576,+,8450
154,BUMA.1121.00017,2,293019,301469,+,8450
154,BUMA.1121.00082,2,317566,326021,+,8455
155,BUMA.1121.00049,2,2138025,2143143,+,5118
155,BUMA.1121.00055,2,2353095,2358250,-,5155
155,BUMA.1121.00011,2,2145503,2150828,+,5325
155,BUMA.1121.00110,2,196464,201567,+,5103
155,BUMA.1121.00109,2,1133722,1138982,-,5260
155,BUMA.1121.00077,2,157762,162866,-,5104
155,BUMA.1121.00027,2,1379462,1384616,+,5154
155,BUMA.1121.00026,2,888876,894000,+,5124
155,BUMA.1121.00021,2,789497,794612,+,5115
155,BUMA.1121.00023,2,382224,387357,+,5133
155,BUMA.1121.00022,2,1212558,1217701,-,5143
155,BUMA.1121.00034,2,303530,308690,+,5160
155,BUMA.1121.00025,2,1947985,1953091,+,5106
155,BUMA.1121.00031,2,2665524,2670747,+,5223
155,BUMA.1121.00007,2,337701,343219,+,5518
155,BUMA.1121.00097,2,123950,129218,+,5268
155,BUMA.1121.00008,2,303383,308534,+,5151
155,BUMA.1121.00059,2,147822,152983,-,5161
155,BUMA.1121.00002,2,900017,905132,+,5115
155,BUMA.1121.00004,2,303502,308662,+,5160
155,BUMA.1121.00005,2,423479,428664,-,5185
155,BUMA.1121.00111,2,2767513,2772612,+,5099
155,BUMA.1121.00006,2,326921,332054,+,5133
155,BUMA.1121.00009,2,2175250,2180896,+,5646
155,BUMA.1121.00094,2,326601,331725,+,5124
155,BUMA.1121.00101,2,3127330,3132527,-,5197
155,BUMA.1121.00066,2,325482,330661,+,5179
155,BUMA.1121.00095,2,2385889,2391178,+,5289
155,BUMA.1121.00112,2,860097,865228,-,5131
155,BUMA.1121.00042,2,2068897,2074021,+,5124
155,BUMA.1121.00032,2,727843,733003,+,5160
155,BUMA.1121.00090,2,1229813,1234982,+,5169
155,BUMA.1121.00020,2,303486,308637,+,5151
155,BUMA.1121.00089,2,327737,332864,+,5127
155,BUMA.1121.00051,2,328000,333127,+,5127
155,BUMA.1121.00001,2,1929991,1935143,-,5152
155,BUMA.1121.00045,2,176716,181768,+,5052
155,BUMA.1121.00043,2,2116506,2121631,-,5125
155,BUMA.1121.00063,2,318629,323745,+,5116
155,BUMA.1121.00079,2,327933,333084,+,5151
155,BUMA.1121.00071,2,319535,324675,+,5140
155,BUMA.1121.00086,2,2020438,2025586,-,5148
155,BUMA.1121.00024,2,303365,308534,+,5169
155,BUMA.1121.00010,2,1753458,1758573,+,5115
155,BUMA.1121.00040,2,1858163,1863297,-,5134
155,BUMA.1121.00093,2,2611958,2617110,-,5152
155,BUMA.1121.00091,2,147549,152686,-,5137
155,BUMA.1121.00107,2,332802,338008,-,5206
155,BUMA.1121.00088,2,279288,284421,+,5133
155,BUMA.1121.00047,2,1258482,1263624,+,5142
155,BUMA.1121.00019,2,303450,308601,+,5151
155,BUMA.1121.00087,2,929617,934765,+,5148
155,BUMA.1121.00039,2,473210,478443,-,5233
155,BUMA.1121.00030,2,1813108,1818269,-,5161
155,BUMA.1121.00016,2,272362,277496,-,5134
155,BUMA.1121.00092,2,327798,332949,+,5151
155,BUMA.1121.00085,2,833374,838499,-,5125
155,BUMA.1121.00046,2,684352,689477,-,5125
155,BUMA.1121.00003,2,1713415,1718656,+,5241
155,BUMA.1121.00054,2,127080,132213,+,5133
155,BUMA.1121.00015,2,2159241,2164375,-,5134
155,BUMA.1121.00105,2,2177198,2182308,-,5110
155,BUMA.1121.00052,2,1521925,1527050,-,5125
155,BUMA.1121.00053,2,556162,561313,+,5151
155,BUMA.1121.00057,2,1765315,1770515,-,5200
155,BUMA.1121.00108,2,565500,570624,+,5124
155,BUMA.1121.00050,2,424090,429214,+,5124
155,BUMA.1121.00104,2,433336,438454,+,5118
155,BUMA.1121.00014,2,333336,338523,+,5187
155,BUMA.1121.00036,2,1923299,1928441,+,5142
155,BUMA.1121.00038,2,326955,332088,+,5133
155,BUMA.1121.00098,2,534871,539989,+,5118
155,BUMA.1121.00078,2,2896258,2901377,-,5119
155,BUMA.1121.00029,2,1040597,1045752,-,5155
155,BUMA.1121.00099,2,469745,475013,+,5268
155,BUMA.1121.00103,2,2198570,2203688,+,5118
155,BUMA.1121.00102,2,328639,333748,+,5109
155,BUMA.1121.00028,2,303447,308616,+,5169
155,BUMA.1121.00075,2,2528420,2533539,-,5119
155,BUMA.1121.00044,2,354646,359806,+,5160
155,BUMA.1121.00076,2,1212129,1217247,+,5118
155,BUMA.1121.00074,2,916298,921444,-,5146
155,BUMA.1121.00073,2,318571,323668,+,5097
155,BUMA.1121.00083,2,2125066,2130274,+,5208
155,BUMA.1121.00035,2,1125446,1130598,-,5152
155,BUMA.1121.00072,2,317842,323050,+,5208
155,BUMA.1121.00056,2,559018,564146,-,5128
155,BUMA.1121.00081,2,1991452,1996586,-,5134
155,BUMA.1121.00033,2,996697,1001825,+,5128
155,BUMA.1121.00061,2,309444,314531,+,5087
155,BUMA.1121.00062,2,1446135,1451260,-,5125
155,BUMA.1121.00064,2,327477,332613,+,5136
155,BUMA.1121.00060,2,1824709,1829762,-,5053
155,BUMA.1121.00069,2,318035,323160,+,5125
155,BUMA.1121.00070,2,318569,323665,+,5096
155,BUMA.1121.00068,2,2047164,2052345,+,5181
155,BUMA.1121.00067,2,476115,481324,-,5209
155,BUMA.1121.00037,2,582210,587343,+,5133
155,BUMA.1121.00065,2,328734,333879,+,5145
155,BUMA.1121.00058,2,890637,895755,+,5118
155,BUMA.1121.00041,2,1218134,1223252,+,5118
155,BUMA.1121.00084,2,2166481,2171632,+,5151
155,BUMA.1121.00096,2,487675,492952,+,5277
155,BUMA.1121.00080,2,327792,332919,+,5127
155,BUMA.1121.00013,2,99437,104562,-,5125
155,BUMA.1121.00100,2,1441513,1446694,+,5181
155,BUMA.1121.00012,2,1494587,1499730,-,5143
155,BUMA.1121.00018,2,379940,385047,-,5107
155,BUMA.1121.00048,2,405492,410626,-,5134
155,BUMA.1121.00106,2,2742580,2747725,+,5145
155,BUMA.1121.00017,2,303509,308669,+,5160
155,BUMA.1121.00082,2,328109,333317,+,5208
156,BUMA.1121.00049,2,2143145,2147642,+,4497
156,BUMA.1121.00055,2,2348595,2353094,-,4499
156,BUMA.1121.00011,2,2150830,2155328,+,4498
156,BUMA.1121.00110,2,201569,206067,+,4498
156,BUMA.1121.00109,2,1129222,1133721,-,4499
156,BUMA.1121.00077,2,153262,157761,-,4499
156,BUMA.1121.00027,2,1384618,1389109,+,4491
156,BUMA.1121.00026,2,894002,898500,+,4498
156,BUMA.1121.00021,2,794614,799112,+,4498
156,BUMA.1121.00023,2,387359,391857,+,4498
156,BUMA.1121.00022,2,1208058,1212557,-,4499
156,BUMA.1121.00034,2,308692,313190,+,4498
156,BUMA.1121.00025,2,1953093,1957591,+,4498
156,BUMA.1121.00031,2,2670749,2675247,+,4498
156,BUMA.1121.00007,2,343221,347718,+,4497
156,BUMA.1121.00097,2,129220,133718,+,4498
156,BUMA.1121.00008,2,308536,313034,+,4498
156,BUMA.1121.00059,2,143323,147821,-,4498
156,BUMA.1121.00002,2,905134,909632,+,4498
156,BUMA.1121.00004,2,308664,313162,+,4498
156,BUMA.1121.00005,2,418980,423478,-,4498
156,BUMA.1121.00111,2,2772614,2777112,+,4498
156,BUMA.1121.00006,2,332056,336554,+,4498
156,BUMA.1121.00009,2,2180898,2185393,+,4495
156,BUMA.1121.00094,2,331727,336225,+,4498
156,BUMA.1121.00101,2,3122833,3127329,-,4496
156,BUMA.1121.00066,2,330663,335160,+,4497
156,BUMA.1121.00095,2,2391180,2395687,+,4507
156,BUMA.1121.00112,2,820203,824634,-,4431
156,BUMA.1121.00042,2,2074023,2078521,+,4498
156,BUMA.1121.00032,2,733005,737503,+,4498
156,BUMA.1121.00090,2,1234984,1239482,+,4498
156,BUMA.1121.00020,2,308639,313137,+,4498
156,BUMA.1121.00089,2,332866,337362,+,4496
156,BUMA.1121.00051,2,333129,337625,+,4496
156,BUMA.1121.00001,2,1925491,1929990,-,4499
156,BUMA.1121.00045,2,181770,186268,+,4498
156,BUMA.1121.00043,2,2112006,2116505,-,4499
156,BUMA.1121.00063,2,323747,328244,+,4497
156,BUMA.1121.00079,2,333086,337584,+,4498
156,BUMA.1121.00071,2,324677,329174,+,4497
156,BUMA.1121.00086,2,2015938,2020437,-,4499
156,BUMA.1121.00024,2,308536,313034,+,4498
156,BUMA.1121.00010,2,1758575,1763073,+,4498
156,BUMA.1121.00040,2,1853648,1858162,-,4514
156,BUMA.1121.00093,2,2607459,2611957,-,4498
156,BUMA.1121.00091,2,143050,147548,-,4498
156,BUMA.1121.00107,2,328302,332801,-,4499
156,BUMA.1121.00088,2,284423,288921,+,4498
156,BUMA.1121.00047,2,1263626,1268124,+,4498
156,BUMA.1121.00019,2,308603,313101,+,4498
156,BUMA.1121.00087,2,934767,939265,+,4498
156,BUMA.1121.00039,2,468710,473209,-,4499
156,BUMA.1121.00030,2,1808608,1813107,-,4499
156,BUMA.1121.00016,2,267862,272361,-,4499
156,BUMA.1121.00092,2,332951,337448,+,4497
156,BUMA.1121.00085,2,828874,833373,-,4499
156,BUMA.1121.00046,2,679852,684351,-,4499
156,BUMA.1121.00003,2,1718658,1723153,+,4495
156,BUMA.1121.00054,2,132215,136713,+,4498
156,BUMA.1121.00015,2,2154741,2159240,-,4499
156,BUMA.1121.00105,2,2172699,2177197,-,4498
156,BUMA.1121.00052,2,1517425,1521924,-,4499
156,BUMA.1121.00053,2,561315,565812,+,4497
156,BUMA.1121.00057,2,1760821,1765314,-,4493
156,BUMA.1121.00108,2,570626,575124,+,4498
156,BUMA.1121.00050,2,429216,433714,+,4498
156,BUMA.1121.00104,2,438456,442953,+,4497
156,BUMA.1121.00014,2,338525,343023,+,4498
156,BUMA.1121.00036,2,1928443,1932941,+,4498
156,BUMA.1121.00038,2,332090,336588,+,4498
156,BUMA.1121.00098,2,539991,544488,+,4497
156,BUMA.1121.00078,2,2891759,2896257,-,4498
156,BUMA.1121.00029,2,1036096,1040596,-,4500
156,BUMA.1121.00099,2,475015,479513,+,4498
156,BUMA.1121.00103,2,2203690,2208184,+,4494
156,BUMA.1121.00102,2,333750,338247,+,4497
156,BUMA.1121.00028,2,308618,313116,+,4498
156,BUMA.1121.00075,2,2523921,2528419,-,4498
156,BUMA.1121.00044,2,359808,364306,+,4498
156,BUMA.1121.00076,2,1217249,1221746,+,4497
156,BUMA.1121.00074,2,911799,916297,-,4498
156,BUMA.1121.00073,2,323670,328167,+,4497
156,BUMA.1121.00083,2,2130276,2134773,+,4497
156,BUMA.1121.00035,2,1120946,1125445,-,4499
156,BUMA.1121.00072,2,323052,327549,+,4497
156,BUMA.1121.00056,2,554520,559017,-,4497
156,BUMA.1121.00081,2,1986952,1991451,-,4499
156,BUMA.1121.00033,2,1001827,1006325,+,4498
156,BUMA.1121.00061,2,314533,319030,+,4497
156,BUMA.1121.00062,2,1441636,1446134,-,4498
156,BUMA.1121.00064,2,332615,337112,+,4497
156,BUMA.1121.00060,2,1820209,1824708,-,4499
156,BUMA.1121.00069,2,323162,327659,+,4497
156,BUMA.1121.00070,2,323667,328164,+,4497
156,BUMA.1121.00068,2,2052347,2056845,+,4498
156,BUMA.1121.00067,2,471616,476114,-,4498
156,BUMA.1121.00037,2,587345,591843,+,4498
156,BUMA.1121.00065,2,333881,338378,+,4497
156,BUMA.1121.00058,2,895757,900255,+,4498
156,BUMA.1121.00041,2,1223254,1227751,+,4497
156,BUMA.1121.00084,2,2171634,2176132,+,4498
156,BUMA.1121.00096,2,492954,497451,+,4497
156,BUMA.1121.00080,2,332921,337417,+,4496
156,BUMA.1121.00013,2,94937,99436,-,4499
156,BUMA.1121.00100,2,1446696,1451194,+,4498
156,BUMA.1121.00012,2,1490087,1494586,-,4499
156,BUMA.1121.00018,2,375440,379939,-,4499
156,BUMA.1121.00048,2,400992,405491,-,4499
156,BUMA.1121.00106,2,2747727,2752225,+,4498
156,BUMA.1121.00017,2,308671,313169,+,4498
156,BUMA.1121.00082,2,333319,337816,+,4497
157,BUMA.1121.00049,2,2148331,2161350,+,13019
157,BUMA.1121.00055,2,2334869,2347907,-,13038
157,BUMA.1121.00011,2,2156017,2169044,+,13027
157,BUMA.1121.00110,2,206756,219798,+,13042
157,BUMA.1121.00109,2,1115517,1128534,-,13017
157,BUMA.1121.00077,2,139532,152574,-,13042
157,BUMA.1121.00027,2,1389798,1402835,+,13037
157,BUMA.1121.00026,2,899189,912141,+,12952
157,BUMA.1121.00021,2,799801,812833,+,13032
157,BUMA.1121.00023,2,392546,405580,+,13034
157,BUMA.1121.00022,2,1194418,1207370,-,12952
157,BUMA.1121.00034,2,313879,326820,+,12941
157,BUMA.1121.00025,2,1959221,1972185,+,12964
157,BUMA.1121.00031,2,2675936,2688969,+,13033
157,BUMA.1121.00007,2,348407,361433,+,13026
157,BUMA.1121.00097,2,134407,147451,+,13044
157,BUMA.1121.00008,2,313723,326664,+,12941
157,BUMA.1121.00059,2,129607,142635,-,13028
157,BUMA.1121.00002,2,910321,923272,+,12951
157,BUMA.1121.00004,2,313851,326792,+,12941
157,BUMA.1121.00005,2,405260,418292,-,13032
157,BUMA.1121.00111,2,2777801,2790834,+,13033
157,BUMA.1121.00006,2,337243,350195,+,12952
157,BUMA.1121.00009,2,2186082,2199105,+,13023
157,BUMA.1121.00094,2,336914,349951,+,13037
157,BUMA.1121.00101,2,3109112,3122145,-,13033
157,BUMA.1121.00066,2,335849,348885,+,13036
157,BUMA.1121.00095,2,2396376,2409408,+,13032
157,BUMA.1121.00112,2,806482,819515,-,13033
157,BUMA.1121.00042,2,2079210,2092162,+,12952
157,BUMA.1121.00032,2,738192,751133,+,12941
157,BUMA.1121.00090,2,1240171,1253197,+,13026
157,BUMA.1121.00020,2,313826,326767,+,12941
157,BUMA.1121.00089,2,338051,351073,+,13022
157,BUMA.1121.00051,2,338314,351336,+,13022
157,BUMA.1121.00001,2,1911770,1924803,-,13033
157,BUMA.1121.00045,2,186957,200002,+,13045
157,BUMA.1121.00043,2,2098284,2111318,-,13034
157,BUMA.1121.00063,2,328933,341970,+,13037
157,BUMA.1121.00079,2,338273,351292,+,13019
157,BUMA.1121.00071,2,329863,342900,+,13037
157,BUMA.1121.00086,2,2002298,2015250,-,12952
157,BUMA.1121.00024,2,313723,326664,+,12941
157,BUMA.1121.00010,2,1763762,1776714,+,12952
157,BUMA.1121.00040,2,1838794,1851735,-,12941
157,BUMA.1121.00093,2,2593761,2606771,-,13010
157,BUMA.1121.00091,2,129325,142362,-,13037
157,BUMA.1121.00107,2,314571,327614,-,13043
157,BUMA.1121.00088,2,289610,302636,+,13026
157,BUMA.1121.00047,2,1268813,1281835,+,13022
157,BUMA.1121.00019,2,313790,326731,+,12941
157,BUMA.1121.00087,2,939954,952906,+,12952
157,BUMA.1121.00039,2,454988,468022,-,13034
157,BUMA.1121.00030,2,1794979,1807920,-,12941
157,BUMA.1121.00016,2,254140,267174,-,13034
157,BUMA.1121.00092,2,338137,351147,+,13010
157,BUMA.1121.00085,2,815234,828186,-,12952
157,BUMA.1121.00046,2,666212,679164,-,12952
157,BUMA.1121.00003,2,1723842,1736873,+,13031
157,BUMA.1121.00054,2,137402,150354,+,12952
157,BUMA.1121.00015,2,2141101,2154053,-,12952
157,BUMA.1121.00105,2,2158978,2172011,-,13033
157,BUMA.1121.00052,2,1503785,1516737,-,12952
157,BUMA.1121.00053,2,566501,579534,+,13033
157,BUMA.1121.00057,2,1747097,1760133,-,13036
157,BUMA.1121.00108,2,575813,588846,+,13033
157,BUMA.1121.00050,2,434403,447355,+,12952
157,BUMA.1121.00104,2,443642,456661,+,13019
157,BUMA.1121.00014,2,343712,356746,+,13034
157,BUMA.1121.00036,2,1933630,1946582,+,12952
157,BUMA.1121.00038,2,337277,350229,+,12952
157,BUMA.1121.00098,2,545177,558210,+,13033
157,BUMA.1121.00078,2,2878033,2891071,-,13038
157,BUMA.1121.00029,2,1022375,1035408,-,13033
157,BUMA.1121.00099,2,480202,493236,+,13034
157,BUMA.1121.00103,2,2208873,2221918,+,13045
157,BUMA.1121.00102,2,338936,351973,+,13037
157,BUMA.1121.00028,2,313805,326746,+,12941
157,BUMA.1121.00075,2,2510201,2523233,-,13032
157,BUMA.1121.00044,2,364995,377936,+,12941
157,BUMA.1121.00076,2,1222435,1235467,+,13032
157,BUMA.1121.00074,2,898087,911111,-,13024
157,BUMA.1121.00073,2,328856,341893,+,13037
157,BUMA.1121.00083,2,2135462,2148499,+,13037
157,BUMA.1121.00035,2,1107225,1120258,-,13033
157,BUMA.1121.00072,2,328238,341273,+,13035
157,BUMA.1121.00056,2,540810,553832,-,13022
157,BUMA.1121.00081,2,1973312,1986264,-,12952
157,BUMA.1121.00033,2,1007947,1020963,+,13016
157,BUMA.1121.00061,2,319719,332756,+,13037
157,BUMA.1121.00062,2,1427489,1440948,-,13459
157,BUMA.1121.00064,2,337801,350825,+,13024
157,BUMA.1121.00060,2,1806476,1819521,-,13045
157,BUMA.1121.00069,2,328348,341385,+,13037
157,BUMA.1121.00070,2,328853,341890,+,13037
157,BUMA.1121.00068,2,2057534,2070556,+,13022
157,BUMA.1121.00067,2,457895,470928,-,13033
157,BUMA.1121.00037,2,592532,605565,+,13033
157,BUMA.1121.00065,2,339067,352113,+,13046
157,BUMA.1121.00058,2,900944,913963,+,13019
157,BUMA.1121.00041,2,1228440,1241473,+,13033
157,BUMA.1121.00084,2,2176821,2189843,+,13022
157,BUMA.1121.00096,2,498140,511153,+,13013
157,BUMA.1121.00080,2,338106,351128,+,13022
157,BUMA.1121.00013,2,81297,94249,-,12952
157,BUMA.1121.00100,2,1451883,1464894,+,13011
157,BUMA.1121.00012,2,1476367,1489399,-,13032
157,BUMA.1121.00018,2,360848,373812,-,12964
157,BUMA.1121.00048,2,387352,400304,-,12952
157,BUMA.1121.00106,2,2752914,2765933,+,13019
157,BUMA.1121.00017,2,313858,326799,+,12941
157,BUMA.1121.00082,2,338505,351542,+,13037
158,BUMA.1121.00049,2,2162217,2167201,+,4984
158,BUMA.1121.00055,2,2329004,2334001,-,4997
158,BUMA.1121.00011,2,2169912,2174919,+,5007
158,BUMA.1121.00110,2,220666,225642,+,4976
158,BUMA.1121.00109,2,1109650,1114649,-,4999
158,BUMA.1121.00077,2,133688,138663,-,4975
158,BUMA.1121.00027,2,1403702,1408698,+,4996
158,BUMA.1121.00026,2,1114101,1119097,+,4996
158,BUMA.1121.00021,2,813700,818695,+,4995
158,BUMA.1121.00023,2,406448,411451,+,5003
158,BUMA.1121.00022,2,2267672,2272668,+,4996
158,BUMA.1121.00034,2,1382091,1387083,-,4992
158,BUMA.1121.00025,2,1973052,1978022,+,4970
158,BUMA.1121.00031,2,2689836,2694844,+,5008
158,BUMA.1121.00007,2,362300,367306,+,5006
158,BUMA.1121.00097,2,148318,153335,+,5017
158,BUMA.1121.00008,2,1366266,1371257,-,4991
158,BUMA.1121.00059,2,123745,128739,-,4994
158,BUMA.1121.00004,2,1366942,1371933,-,4991
158,BUMA.1121.00005,2,399388,404392,-,5004
158,BUMA.1121.00111,2,2791701,2796684,+,4983
158,BUMA.1121.00006,2,687574,692570,+,4996
158,BUMA.1121.00009,2,2199972,2204968,+,4996
158,BUMA.1121.00094,2,350818,355814,+,4996
158,BUMA.1121.00101,2,3103248,3108244,-,4996
158,BUMA.1121.00066,2,349752,354748,+,4996
158,BUMA.1121.00095,2,2410275,2415271,+,4996
158,BUMA.1121.00112,2,800654,805614,-,4960
158,BUMA.1121.00042,2,1144081,1149078,-,4997
158,BUMA.1121.00090,2,1254064,1259033,+,4969
158,BUMA.1121.00020,2,1367027,1372019,-,4992
158,BUMA.1121.00089,2,351940,356937,+,4997
158,BUMA.1121.00051,2,352203,357199,+,4996
158,BUMA.1121.00001,2,1905899,1910902,-,5003
158,BUMA.1121.00045,2,200869,205877,+,5008
158,BUMA.1121.00043,2,2092420,2097416,-,4996
158,BUMA.1121.00063,2,342837,347833,+,4996
158,BUMA.1121.00079,2,352159,357158,+,4999
158,BUMA.1121.00071,2,343767,348763,+,4996
158,BUMA.1121.00086,2,722854,727850,+,4996
158,BUMA.1121.00024,2,1502043,1507035,-,4992
158,BUMA.1121.00040,2,654012,659007,+,4995
158,BUMA.1121.00093,2,2587897,2592893,-,4996
158,BUMA.1121.00091,2,123449,128457,-,5008
158,BUMA.1121.00107,2,308685,313703,-,5018
158,BUMA.1121.00088,2,303503,308513,+,5010
158,BUMA.1121.00047,2,1282702,1287698,+,4996
158,BUMA.1121.00019,2,1446162,1451154,-,4992
158,BUMA.1121.00087,2,2227096,2232092,-,4996
158,BUMA.1121.00039,2,449150,454120,-,4970
158,BUMA.1121.00030,2,734714,739705,+,4991
158,BUMA.1121.00016,2,248267,253272,-,5005
158,BUMA.1121.00092,2,352014,357010,+,4996
158,BUMA.1121.00003,2,1737741,1742736,+,4995
158,BUMA.1121.00054,2,487724,492719,+,4995
158,BUMA.1121.00105,2,2153114,2158110,-,4996
158,BUMA.1121.00053,2,580401,585419,+,5018
158,BUMA.1121.00057,2,1739638,1744633,-,4995
158,BUMA.1121.00108,2,589713,594710,+,4997
158,BUMA.1121.00104,2,457528,462527,+,4999
158,BUMA.1121.00014,2,357613,362621,+,5008
158,BUMA.1121.00036,2,935492,940488,-,4996
158,BUMA.1121.00038,2,687609,692605,+,4996
158,BUMA.1121.00098,2,560675,565693,+,5018
158,BUMA.1121.00078,2,2872169,2877165,-,4996
158,BUMA.1121.00029,2,1016496,1021507,-,5011
158,BUMA.1121.00099,2,494103,499109,+,5006
158,BUMA.1121.00103,2,2222785,2227760,+,4975
158,BUMA.1121.00102,2,352840,357844,+,5004
158,BUMA.1121.00028,2,1408252,1413244,-,4992
158,BUMA.1121.00075,2,2504326,2509333,-,5007
158,BUMA.1121.00044,2,1433192,1438183,-,4991
158,BUMA.1121.00076,2,1236334,1241341,+,5007
158,BUMA.1121.00074,2,892222,897219,-,4997
158,BUMA.1121.00073,2,342760,347756,+,4996
158,BUMA.1121.00083,2,2149366,2154362,+,4996
158,BUMA.1121.00035,2,1101354,1106357,-,5003
158,BUMA.1121.00072,2,342140,347136,+,4996
158,BUMA.1121.00056,2,534945,539942,-,4997
158,BUMA.1121.00081,2,1630944,1635940,-,4996
158,BUMA.1121.00033,2,1021830,1026834,+,5004
158,BUMA.1121.00061,2,333623,338619,+,4996
158,BUMA.1121.00062,2,1421593,1426621,-,5028
158,BUMA.1121.00064,2,351692,356691,+,4999
158,BUMA.1121.00060,2,1800600,1805608,-,5008
158,BUMA.1121.00069,2,342252,347248,+,4996
158,BUMA.1121.00070,2,342757,347753,+,4996
158,BUMA.1121.00068,2,2071424,2076428,+,5004
158,BUMA.1121.00067,2,452048,457027,-,4979
158,BUMA.1121.00037,2,606432,611432,+,5000
158,BUMA.1121.00065,2,352980,357955,+,4975
158,BUMA.1121.00058,2,914830,919829,+,4999
158,BUMA.1121.00041,2,1242340,1247347,+,5007
158,BUMA.1121.00084,2,2190710,2195710,+,5000
158,BUMA.1121.00096,2,512021,517027,+,5006
158,BUMA.1121.00080,2,351995,356990,+,4995
158,BUMA.1121.00013,2,1154140,1159136,+,4996
158,BUMA.1121.00100,2,1465762,1470751,+,4989
158,BUMA.1121.00012,2,1468899,1473903,-,5004
158,BUMA.1121.00018,2,355010,359980,-,4970
158,BUMA.1121.00048,2,44938,49934,-,4996
158,BUMA.1121.00106,2,2766800,2771799,+,4999
158,BUMA.1121.00017,2,1382084,1387076,-,4992
158,BUMA.1121.00082,2,352409,357405,+,4996
159,BUMA.1121.00049,2,2167867,2171188,+,3321
159,BUMA.1121.00055,2,2325013,2328347,-,3334
159,BUMA.1121.00011,2,2175585,2178920,+,3335
159,BUMA.1121.00110,2,226443,229760,+,3317
159,BUMA.1121.00109,2,1105673,1108993,-,3320
159,BUMA.1121.00077,2,129571,132887,-,3316
159,BUMA.1121.00027,2,1409436,1412771,+,3335
159,BUMA.1121.00026,2,1119826,1123153,+,3327
159,BUMA.1121.00021,2,819352,822673,+,3321
159,BUMA.1121.00023,2,412117,415438,+,3321
159,BUMA.1121.00022,2,2273388,2276709,+,3321
159,BUMA.1121.00034,2,1378060,1381380,-,3320
159,BUMA.1121.00025,2,1978691,1982012,+,3321
159,BUMA.1121.00031,2,2695501,2698822,+,3321
159,BUMA.1121.00007,2,367990,371239,+,3249
159,BUMA.1121.00097,2,154046,157381,+,3335
159,BUMA.1121.00008,2,1362235,1365555,-,3320
159,BUMA.1121.00059,2,119678,122998,-,3320
159,BUMA.1121.00004,2,1362911,1366231,-,3320
159,BUMA.1121.00005,2,395244,398578,-,3334
159,BUMA.1121.00111,2,2797353,2800666,+,3313
159,BUMA.1121.00006,2,693290,696611,+,3321
159,BUMA.1121.00009,2,2205634,2208955,+,3321
159,BUMA.1121.00094,2,356606,359927,+,3321
159,BUMA.1121.00101,2,3099266,3102600,-,3334
159,BUMA.1121.00066,2,355405,358740,+,3335
159,BUMA.1121.00095,2,2416045,2419380,+,3335
159,BUMA.1121.00112,2,796609,799943,-,3334
159,BUMA.1121.00042,2,1140005,1143325,-,3320
159,BUMA.1121.00090,2,1259702,1263015,+,3313
159,BUMA.1121.00020,2,1362996,1366316,-,3320
159,BUMA.1121.00089,2,357729,361050,+,3321
159,BUMA.1121.00051,2,357991,361312,+,3321
159,BUMA.1121.00001,2,1901873,1905221,-,3348
159,BUMA.1121.00045,2,206570,209906,+,3336
159,BUMA.1121.00043,2,2088415,2091763,-,3348
159,BUMA.1121.00063,2,348490,351825,+,3335
159,BUMA.1121.00079,2,357977,361297,+,3320
159,BUMA.1121.00071,2,349420,352755,+,3335
159,BUMA.1121.00086,2,728570,731891,+,3321
159,BUMA.1121.00024,2,1498012,1501332,-,3320
159,BUMA.1121.00040,2,659736,663057,+,3321
159,BUMA.1121.00093,2,2583866,2587186,-,3320
159,BUMA.1121.00091,2,119382,122702,-,3320
159,BUMA.1121.00107,2,304699,308019,-,3320
159,BUMA.1121.00088,2,309233,312568,+,3335
159,BUMA.1121.00047,2,1288499,1291834,+,3335
159,BUMA.1121.00019,2,1442131,1445451,-,3320
159,BUMA.1121.00087,2,2223056,2226376,-,3320
159,BUMA.1121.00039,2,443573,446911,-,3338
159,BUMA.1121.00030,2,740416,743737,+,3321
159,BUMA.1121.00016,2,244209,247571,-,3362
159,BUMA.1121.00092,2,357721,361042,+,3321
159,BUMA.1121.00003,2,1743400,1746737,+,3337
159,BUMA.1121.00054,2,493439,496760,+,3321
159,BUMA.1121.00105,2,2149137,2152457,-,3320
159,BUMA.1121.00053,2,586247,589568,+,3321
159,BUMA.1121.00057,2,1735584,1738918,-,3334
159,BUMA.1121.00108,2,595394,598729,+,3335
159,BUMA.1121.00104,2,463247,466568,+,3321
159,BUMA.1121.00014,2,363278,366599,+,3321
159,BUMA.1121.00036,2,931452,934772,-,3320
159,BUMA.1121.00038,2,693325,696646,+,3321
159,BUMA.1121.00098,2,566431,569759,+,3328
159,BUMA.1121.00078,2,2868097,2871431,-,3334
159,BUMA.1121.00029,2,1012493,1015827,-,3334
159,BUMA.1121.00099,2,499802,503123,+,3321
159,BUMA.1121.00103,2,2228480,2231793,+,3313
159,BUMA.1121.00102,2,358501,361822,+,3321
159,BUMA.1121.00028,2,1404222,1407541,-,3319
159,BUMA.1121.00075,2,2500263,2503597,-,3334
159,BUMA.1121.00044,2,1429161,1432481,-,3320
159,BUMA.1121.00076,2,1242079,1245414,+,3335
159,BUMA.1121.00074,2,888186,891520,-,3334
159,BUMA.1121.00073,2,348413,351748,+,3335
159,BUMA.1121.00083,2,2155019,2158354,+,3335
159,BUMA.1121.00035,2,1097337,1100685,-,3348
159,BUMA.1121.00072,2,347793,351128,+,3335
159,BUMA.1121.00056,2,530833,534153,-,3320
159,BUMA.1121.00081,2,1626904,1630224,-,3320
159,BUMA.1121.00033,2,1027494,1030815,+,3321
159,BUMA.1121.00061,2,339276,342611,+,3335
159,BUMA.1121.00062,2,1417593,1420927,-,3334
159,BUMA.1121.00064,2,357348,360683,+,3335
159,BUMA.1121.00069,2,347905,351240,+,3335
159,BUMA.1121.00070,2,348410,351745,+,3335
159,BUMA.1121.00067,2,447891,451211,-,3320
159,BUMA.1121.00037,2,612089,615410,+,3321
159,BUMA.1121.00065,2,358666,361987,+,3321
159,BUMA.1121.00058,2,920540,923861,+,3321
159,BUMA.1121.00041,2,1248202,1251537,+,3335
159,BUMA.1121.00084,2,2196439,2199774,+,3335
159,BUMA.1121.00096,2,517720,521042,+,3322
159,BUMA.1121.00080,2,357764,361085,+,3321
159,BUMA.1121.00013,2,1159838,1163159,+,3321
159,BUMA.1121.00100,2,1471408,1474743,+,3335
159,BUMA.1121.00012,2,1464868,1468230,-,3362
159,BUMA.1121.00018,2,351021,354341,-,3320
159,BUMA.1121.00048,2,40898,44218,-,3320
159,BUMA.1121.00106,2,2772537,2775858,+,3321
159,BUMA.1121.00017,2,1378053,1381373,-,3320
159,BUMA.1121.00082,2,358062,361397,+,3335
160,BUMA.1121.00049,2,2172079,2175505,+,3426
160,BUMA.1121.00055,2,2320655,2324122,-,3467
160,BUMA.1121.00011,2,2179811,2183225,+,3414
160,BUMA.1121.00110,2,230655,233974,+,3319
160,BUMA.1121.00109,2,1101379,1104782,-,3403
160,BUMA.1121.00077,2,125356,128676,-,3320
160,BUMA.1121.00027,2,1413662,1417061,+,3399
160,BUMA.1121.00026,2,1124044,1127440,+,3396
160,BUMA.1121.00021,2,823564,826994,+,3430
160,BUMA.1121.00023,2,416329,419808,+,3479
160,BUMA.1121.00022,2,2277600,2280996,+,3396
160,BUMA.1121.00034,2,1373772,1377169,-,3397
160,BUMA.1121.00025,2,1982903,1986304,+,3401
160,BUMA.1121.00031,2,2699713,2703142,+,3429
160,BUMA.1121.00007,2,372130,375612,+,3482
160,BUMA.1121.00097,2,158272,161724,+,3452
160,BUMA.1121.00008,2,1357947,1361344,-,3397
160,BUMA.1121.00059,2,115362,118787,-,3425
160,BUMA.1121.00004,2,1358623,1362020,-,3397
160,BUMA.1121.00005,2,362825,366235,-,3410
160,BUMA.1121.00111,2,2801593,2805037,+,3444
160,BUMA.1121.00006,2,697502,700898,+,3396
160,BUMA.1121.00009,2,2209846,2213429,+,3583
160,BUMA.1121.00094,2,360818,364249,+,3431
160,BUMA.1121.00101,2,3094886,3098374,-,3488
160,BUMA.1121.00066,2,359631,363026,+,3395
160,BUMA.1121.00095,2,2420270,2423680,+,3410
160,BUMA.1121.00112,2,792242,795718,-,3476
160,BUMA.1121.00042,2,1135717,1139114,-,3397
160,BUMA.1121.00090,2,1263956,1267442,+,3486
160,BUMA.1121.00020,2,1358708,1362105,-,3397
160,BUMA.1121.00089,2,361941,365371,+,3430
160,BUMA.1121.00051,2,362203,365749,+,3546
160,BUMA.1121.00001,2,1897432,1900982,-,3550
160,BUMA.1121.00045,2,210797,214279,+,3482
160,BUMA.1121.00043,2,2084005,2087533,-,3528
160,BUMA.1121.00063,2,352716,356115,+,3399
160,BUMA.1121.00079,2,362188,365739,+,3551
160,BUMA.1121.00071,2,353646,357045,+,3399
160,BUMA.1121.00086,2,732782,736178,+,3396
160,BUMA.1121.00024,2,1493724,1497121,-,3397
160,BUMA.1121.00040,2,663948,667344,+,3396
160,BUMA.1121.00093,2,2579503,2582975,-,3472
160,BUMA.1121.00091,2,80797,84243,-,3446
160,BUMA.1121.00107,2,300355,303808,-,3453
160,BUMA.1121.00088,2,313459,316904,+,3445
160,BUMA.1121.00047,2,1292725,1296235,+,3510
160,BUMA.1121.00019,2,1437843,1441240,-,3397
160,BUMA.1121.00087,2,2218768,2222165,-,3397
160,BUMA.1121.00039,2,439265,442682,-,3417
160,BUMA.1121.00030,2,744628,748024,+,3396
160,BUMA.1121.00016,2,239764,243318,-,3554
160,BUMA.1121.00092,2,361933,365405,+,3472
160,BUMA.1121.00046,2,326264,329661,-,3397
160,BUMA.1121.00003,2,1747628,1751027,+,3399
160,BUMA.1121.00054,2,497651,501047,+,3396
160,BUMA.1121.00015,2,1801170,1804567,-,3397
160,BUMA.1121.00105,2,2144797,2148246,-,3449
160,BUMA.1121.00053,2,590459,593904,+,3445
160,BUMA.1121.00057,2,1731286,1734693,-,3407
160,BUMA.1121.00108,2,599620,603056,+,3436
160,BUMA.1121.00050,2,784026,787422,+,3396
160,BUMA.1121.00104,2,467466,470869,+,3403
160,BUMA.1121.00014,2,367490,370905,+,3415
160,BUMA.1121.00036,2,927164,930561,-,3397
160,BUMA.1121.00038,2,697537,700933,+,3396
160,BUMA.1121.00098,2,570657,574095,+,3438
160,BUMA.1121.00078,2,2863726,2867206,-,3480
160,BUMA.1121.00029,2,1008093,1011602,-,3509
160,BUMA.1121.00099,2,504014,507462,+,3448
160,BUMA.1121.00103,2,2232720,2236152,+,3432
160,BUMA.1121.00102,2,362713,366178,+,3465
160,BUMA.1121.00028,2,1399934,1403331,-,3397
160,BUMA.1121.00075,2,2495958,2499372,-,3414
160,BUMA.1121.00044,2,1424873,1428270,-,3397
160,BUMA.1121.00076,2,1246305,1249721,+,3416
160,BUMA.1121.00074,2,883891,887295,-,3404
160,BUMA.1121.00073,2,352639,356038,+,3399
160,BUMA.1121.00083,2,2159245,2162644,+,3399
160,BUMA.1121.00035,2,1092938,1096446,-,3508
160,BUMA.1121.00072,2,352019,355418,+,3399
160,BUMA.1121.00056,2,526511,529942,-,3431
160,BUMA.1121.00081,2,1622616,1626013,-,3397
160,BUMA.1121.00033,2,1031706,1035112,+,3406
160,BUMA.1121.00061,2,343502,346901,+,3399
160,BUMA.1121.00062,2,1413294,1416701,-,3407
160,BUMA.1121.00064,2,361574,365075,+,3501
160,BUMA.1121.00069,2,352131,355530,+,3399
160,BUMA.1121.00070,2,352636,356035,+,3399
160,BUMA.1121.00067,2,443513,447000,-,3487
160,BUMA.1121.00037,2,616301,619716,+,3415
160,BUMA.1121.00065,2,362878,366404,+,3526
160,BUMA.1121.00058,2,924752,928218,+,3466
160,BUMA.1121.00041,2,1252428,1255907,+,3479
160,BUMA.1121.00084,2,2200665,2204102,+,3437
160,BUMA.1121.00096,2,521933,525392,+,3459
160,BUMA.1121.00080,2,361976,365455,+,3479
160,BUMA.1121.00013,2,1164050,1167446,+,3396
160,BUMA.1121.00100,2,1475634,1479030,+,3396
160,BUMA.1121.00012,2,1460525,1463977,-,3452
160,BUMA.1121.00018,2,346728,350130,-,3402
160,BUMA.1121.00048,2,36610,40007,-,3397
160,BUMA.1121.00106,2,2776756,2780222,+,3466
160,BUMA.1121.00017,2,1373765,1377162,-,3397
160,BUMA.1121.00082,2,362288,365687,+,3399
161,BUMA.1121.00049,2,2176746,2180435,+,3689
161,BUMA.1121.00055,2,2315691,2319415,-,3724
161,BUMA.1121.00011,2,2184466,2188195,+,3729
161,BUMA.1121.00110,2,235215,238909,+,3694
161,BUMA.1121.00109,2,1096448,1100139,-,3691
161,BUMA.1121.00077,2,120422,124116,-,3694
161,BUMA.1121.00027,2,1418302,1421996,+,3694
161,BUMA.1121.00026,2,1128681,1132377,+,3696
161,BUMA.1121.00021,2,828235,831934,+,3699
161,BUMA.1121.00023,2,421049,424753,+,3704
161,BUMA.1121.00022,2,2282237,2285933,+,3696
161,BUMA.1121.00034,2,1368836,1372532,-,3696
161,BUMA.1121.00025,2,1987545,1991244,+,3699
161,BUMA.1121.00031,2,2704383,2708087,+,3704
161,BUMA.1121.00007,2,376853,380542,+,3689
161,BUMA.1121.00097,2,162965,166677,+,3712
161,BUMA.1121.00008,2,1353011,1356707,-,3696
161,BUMA.1121.00059,2,110433,114122,-,3689
161,BUMA.1121.00004,2,1353687,1357383,-,3696
161,BUMA.1121.00005,2,357881,361585,-,3704
161,BUMA.1121.00111,2,2806278,2809972,+,3694
161,BUMA.1121.00006,2,702139,705835,+,3696
161,BUMA.1121.00009,2,2214670,2218372,+,3702
161,BUMA.1121.00094,2,365490,369196,+,3706
161,BUMA.1121.00101,2,3089965,3093646,-,3681
161,BUMA.1121.00066,2,364267,367966,+,3699
161,BUMA.1121.00095,2,2424923,2428606,+,3683
161,BUMA.1121.00112,2,787313,791002,-,3689
161,BUMA.1121.00042,2,1130781,1134477,-,3696
161,BUMA.1121.00090,2,1268683,1272382,+,3699
161,BUMA.1121.00020,2,1353772,1357468,-,3696
161,BUMA.1121.00089,2,366612,370318,+,3706
161,BUMA.1121.00051,2,366990,370686,+,3696
161,BUMA.1121.00001,2,1892483,1896192,-,3709
161,BUMA.1121.00045,2,215520,219258,+,3738
161,BUMA.1121.00043,2,2079056,2082765,-,3709
161,BUMA.1121.00063,2,357356,361055,+,3699
161,BUMA.1121.00079,2,366980,370679,+,3699
161,BUMA.1121.00071,2,358286,361985,+,3699
161,BUMA.1121.00086,2,737419,741115,+,3696
161,BUMA.1121.00024,2,1488788,1492484,-,3696
161,BUMA.1121.00040,2,668585,672280,+,3695
161,BUMA.1121.00093,2,2574557,2578263,-,3706
161,BUMA.1121.00091,2,75843,79557,-,3714
161,BUMA.1121.00107,2,295434,299115,-,3681
161,BUMA.1121.00088,2,318145,321851,+,3706
161,BUMA.1121.00047,2,1297476,1301180,+,3704
161,BUMA.1121.00019,2,1432907,1436603,-,3696
161,BUMA.1121.00087,2,2213832,2217528,-,3696
161,BUMA.1121.00039,2,434326,438025,-,3699
161,BUMA.1121.00030,2,749265,752961,+,3696
161,BUMA.1121.00016,2,234825,238524,-,3699
161,BUMA.1121.00092,2,366646,370352,+,3706
161,BUMA.1121.00046,2,321334,325030,-,3696
161,BUMA.1121.00003,2,1752268,1755965,+,3697
161,BUMA.1121.00054,2,502288,505984,+,3696
161,BUMA.1121.00015,2,1796234,1799930,-,3696
161,BUMA.1121.00105,2,2139868,2143557,-,3689
161,BUMA.1121.00053,2,595145,598849,+,3704
161,BUMA.1121.00057,2,1726352,1730046,-,3694
161,BUMA.1121.00108,2,604297,607984,+,3687
161,BUMA.1121.00050,2,788657,792353,+,3696
161,BUMA.1121.00104,2,472110,475809,+,3699
161,BUMA.1121.00014,2,372146,375850,+,3704
161,BUMA.1121.00036,2,922228,925924,-,3696
161,BUMA.1121.00038,2,702174,705870,+,3696
161,BUMA.1121.00098,2,575336,579037,+,3701
161,BUMA.1121.00078,2,2858780,2862486,-,3706
161,BUMA.1121.00029,2,1003149,1006853,-,3704
161,BUMA.1121.00099,2,508703,512418,+,3715
161,BUMA.1121.00103,2,2237393,2241094,+,3701
161,BUMA.1121.00102,2,367419,371125,+,3706
161,BUMA.1121.00028,2,1394998,1398694,-,3696
161,BUMA.1121.00075,2,2491012,2494718,-,3706
161,BUMA.1121.00044,2,1419937,1423633,-,3696
161,BUMA.1121.00076,2,1250962,1254668,+,3706
161,BUMA.1121.00074,2,878962,882651,-,3689
161,BUMA.1121.00073,2,357279,360978,+,3699
161,BUMA.1121.00083,2,2163885,2167584,+,3699
161,BUMA.1121.00035,2,1087989,1091698,-,3709
161,BUMA.1121.00072,2,356659,360358,+,3699
161,BUMA.1121.00056,2,521565,525271,-,3706
161,BUMA.1121.00081,2,1617680,1621376,-,3696
161,BUMA.1121.00033,2,1036353,1040057,+,3704
161,BUMA.1121.00061,2,348142,351841,+,3699
161,BUMA.1121.00062,2,1408338,1412002,-,3664
161,BUMA.1121.00064,2,366316,370022,+,3706
161,BUMA.1121.00069,2,356771,360470,+,3699
161,BUMA.1121.00070,2,357276,360975,+,3699
161,BUMA.1121.00068,2,2077229,2080916,+,3687
161,BUMA.1121.00067,2,438577,442273,-,3696
161,BUMA.1121.00037,2,620957,624661,+,3704
161,BUMA.1121.00065,2,367645,371321,+,3676
161,BUMA.1121.00058,2,929459,933148,+,3689
161,BUMA.1121.00041,2,1257148,1260893,+,3745
161,BUMA.1121.00084,2,2205343,2209049,+,3706
161,BUMA.1121.00096,2,526635,530321,+,3686
161,BUMA.1121.00080,2,366696,370385,+,3689
161,BUMA.1121.00013,2,1168687,1172383,+,3696
161,BUMA.1121.00100,2,1480272,1483955,+,3683
161,BUMA.1121.00012,2,1455586,1459285,-,3699
161,BUMA.1121.00018,2,341789,345488,-,3699
161,BUMA.1121.00048,2,31674,35370,-,3696
161,BUMA.1121.00106,2,2781463,2785162,+,3699
161,BUMA.1121.00017,2,1368829,1372525,-,3696
161,BUMA.1121.00082,2,366928,370627,+,3699
162,BUMA.1121.00049,2,2181143,2184929,+,3786
162,BUMA.1121.00055,2,2311525,2314983,-,3458
162,BUMA.1121.00011,2,2188903,2192682,+,3779
162,BUMA.1121.00110,2,239617,243372,+,3755
162,BUMA.1121.00109,2,1091954,1095739,-,3785
162,BUMA.1121.00077,2,115959,119713,-,3754
162,BUMA.1121.00027,2,1422704,1426467,+,3763
162,BUMA.1121.00026,2,1133085,1136858,+,3773
162,BUMA.1121.00021,2,832642,836419,+,3777
162,BUMA.1121.00023,2,425461,429239,+,3778
162,BUMA.1121.00022,2,2286641,2290414,+,3773
162,BUMA.1121.00034,2,1364355,1368127,-,3772
162,BUMA.1121.00025,2,1991952,1995729,+,3777
162,BUMA.1121.00031,2,2708795,2712571,+,3776
162,BUMA.1121.00007,2,381250,385036,+,3786
162,BUMA.1121.00097,2,167385,171172,+,3787
162,BUMA.1121.00008,2,1348530,1352302,-,3772
162,BUMA.1121.00059,2,105961,109724,-,3763
162,BUMA.1121.00004,2,1349206,1352978,-,3772
162,BUMA.1121.00005,2,353384,357172,-,3788
162,BUMA.1121.00111,2,2810680,2814457,+,3777
162,BUMA.1121.00006,2,706543,710316,+,3773
162,BUMA.1121.00009,2,2219093,2222868,+,3775
162,BUMA.1121.00094,2,369904,373671,+,3767
162,BUMA.1121.00101,2,3085479,3089257,-,3778
162,BUMA.1121.00066,2,368674,372131,+,3457
162,BUMA.1121.00095,2,2429314,2433078,+,3764
162,BUMA.1121.00112,2,782827,786605,-,3778
162,BUMA.1121.00042,2,1126300,1130072,-,3772
162,BUMA.1121.00090,2,1273090,1276854,+,3764
162,BUMA.1121.00020,2,1349291,1353063,-,3772
162,BUMA.1121.00089,2,371026,374793,+,3767
162,BUMA.1121.00051,2,371394,374851,+,3457
162,BUMA.1121.00001,2,1887998,1891774,-,3776
162,BUMA.1121.00045,2,219966,223756,+,3790
162,BUMA.1121.00043,2,2074558,2078347,-,3789
162,BUMA.1121.00063,2,361763,365220,+,3457
162,BUMA.1121.00079,2,371394,375158,+,3764
162,BUMA.1121.00071,2,362693,366150,+,3457
162,BUMA.1121.00086,2,741823,745596,+,3773
162,BUMA.1121.00024,2,1484307,1488079,-,3772
162,BUMA.1121.00040,2,672988,676752,+,3764
162,BUMA.1121.00093,2,2570392,2573848,-,3456
162,BUMA.1121.00091,2,71678,75135,-,3457
162,BUMA.1121.00107,2,290932,294717,-,3785
162,BUMA.1121.00088,2,322559,326314,+,3755
162,BUMA.1121.00047,2,1301888,1305354,+,3466
162,BUMA.1121.00019,2,1428426,1432198,-,3772
162,BUMA.1121.00087,2,2209351,2213123,-,3772
162,BUMA.1121.00039,2,429841,433618,-,3777
162,BUMA.1121.00030,2,753669,757442,+,3773
162,BUMA.1121.00016,2,230352,234116,-,3764
162,BUMA.1121.00092,2,371060,374517,+,3457
162,BUMA.1121.00046,2,316853,320625,-,3772
162,BUMA.1121.00003,2,1756681,1760445,+,3764
162,BUMA.1121.00054,2,506692,510465,+,3773
162,BUMA.1121.00015,2,1791753,1795525,-,3772
162,BUMA.1121.00105,2,2135405,2139160,-,3755
162,BUMA.1121.00053,2,599557,603014,+,3457
162,BUMA.1121.00057,2,1721880,1725643,-,3763
162,BUMA.1121.00108,2,608692,612456,+,3764
162,BUMA.1121.00050,2,793061,796834,+,3773
162,BUMA.1121.00104,2,476524,480291,+,3767
162,BUMA.1121.00014,2,376558,380335,+,3777
162,BUMA.1121.00036,2,917747,921519,-,3772
162,BUMA.1121.00038,2,706578,710351,+,3773
162,BUMA.1121.00098,2,579745,583531,+,3786
162,BUMA.1121.00078,2,2854317,2858072,-,3755
162,BUMA.1121.00029,2,998664,1002440,-,3776
162,BUMA.1121.00099,2,513126,516912,+,3786
162,BUMA.1121.00103,2,2241802,2245588,+,3786
162,BUMA.1121.00102,2,371833,375597,+,3764
162,BUMA.1121.00028,2,1390517,1394289,-,3772
162,BUMA.1121.00075,2,2486845,2490304,-,3459
162,BUMA.1121.00044,2,1415456,1419228,-,3772
162,BUMA.1121.00076,2,1255376,1258836,+,3460
162,BUMA.1121.00074,2,874477,878254,-,3777
162,BUMA.1121.00073,2,361686,365143,+,3457
162,BUMA.1121.00083,2,2168292,2171749,+,3457
162,BUMA.1121.00035,2,1083504,1087280,-,3776
162,BUMA.1121.00072,2,361066,364523,+,3457
162,BUMA.1121.00056,2,517090,520856,-,3766
162,BUMA.1121.00081,2,1613199,1616971,-,3772
162,BUMA.1121.00033,2,1040765,1044527,+,3762
162,BUMA.1121.00061,2,352549,356006,+,3457
162,BUMA.1121.00062,2,1404173,1407630,-,3457
162,BUMA.1121.00064,2,370730,374440,+,3710
162,BUMA.1121.00069,2,361178,364635,+,3457
162,BUMA.1121.00070,2,361683,365140,+,3457
162,BUMA.1121.00068,2,2081624,2085402,+,3778
162,BUMA.1121.00067,2,434412,437868,-,3456
162,BUMA.1121.00037,2,625369,629133,+,3764
162,BUMA.1121.00065,2,372029,375495,+,3466
162,BUMA.1121.00058,2,933856,937620,+,3764
162,BUMA.1121.00041,2,1261601,1265058,+,3457
162,BUMA.1121.00084,2,2209757,2213512,+,3755
162,BUMA.1121.00096,2,531037,534823,+,3786
162,BUMA.1121.00080,2,371093,374870,+,3777
162,BUMA.1121.00013,2,1173091,1176864,+,3773
162,BUMA.1121.00100,2,1484663,1488413,+,3750
162,BUMA.1121.00012,2,1451123,1454878,-,3755
162,BUMA.1121.00018,2,337304,341080,-,3776
162,BUMA.1121.00048,2,27193,30965,-,3772
162,BUMA.1121.00106,2,2785877,2789641,+,3764
162,BUMA.1121.00017,2,1364348,1368120,-,3772
162,BUMA.1121.00082,2,371335,374792,+,3457
163,BUMA.1121.00049,2,2192980,2212209,+,19229
163,BUMA.1121.00055,2,2284283,2303461,-,19178
163,BUMA.1121.00011,2,2200685,2221132,+,20447
163,BUMA.1121.00110,2,251345,270702,+,19357
163,BUMA.1121.00109,2,1063735,1083995,-,20260
163,BUMA.1121.00077,2,88660,107985,-,19325
163,BUMA.1121.00027,2,1434474,1453670,+,19196
163,BUMA.1121.00026,2,1144837,1164031,+,19194
163,BUMA.1121.00021,2,844436,863632,+,19196
163,BUMA.1121.00023,2,437230,456466,+,19236
163,BUMA.1121.00022,2,2298393,2317641,+,19248
163,BUMA.1121.00034,2,1337126,1356384,-,19258
163,BUMA.1121.00025,2,2003745,2022973,+,19228
163,BUMA.1121.00031,2,2720577,2739741,+,19164
163,BUMA.1121.00007,2,393060,412368,+,19308
163,BUMA.1121.00097,2,179209,199633,+,20424
163,BUMA.1121.00008,2,1321301,1340559,-,19258
163,BUMA.1121.00059,2,78747,97954,-,19207
163,BUMA.1121.00004,2,1321985,1341235,-,19250
163,BUMA.1121.00005,2,326103,345383,-,19280
163,BUMA.1121.00111,2,2822465,2841707,+,19242
163,BUMA.1121.00006,2,718241,737455,+,19214
163,BUMA.1121.00009,2,2230868,2251190,+,20322
163,BUMA.1121.00094,2,381704,400857,+,19153
163,BUMA.1121.00101,2,3058280,3077451,-,19171
163,BUMA.1121.00066,2,380164,399356,+,19192
163,BUMA.1121.00095,2,2441094,2460331,+,19237
163,BUMA.1121.00112,2,755581,774793,-,19212
163,BUMA.1121.00042,2,1099095,1118320,-,19225
163,BUMA.1121.00090,2,1284880,1304081,+,19201
163,BUMA.1121.00020,2,1322062,1341320,-,19258
163,BUMA.1121.00089,2,382826,401981,+,19155
163,BUMA.1121.00051,2,382874,402043,+,19169
163,BUMA.1121.00001,2,1860825,1879989,-,19164
163,BUMA.1121.00045,2,231763,250958,+,19195
163,BUMA.1121.00043,2,2047427,2066540,-,19113
163,BUMA.1121.00063,2,373253,392460,+,19207
163,BUMA.1121.00079,2,383200,402425,+,19225
163,BUMA.1121.00071,2,374183,393347,+,19164
163,BUMA.1121.00086,2,753575,772879,+,19304
163,BUMA.1121.00024,2,1457078,1476336,-,19258
163,BUMA.1121.00040,2,684731,703975,+,19244
163,BUMA.1121.00093,2,2543095,2562373,-,19278
163,BUMA.1121.00091,2,44425,63677,-,19252
163,BUMA.1121.00107,2,262400,282915,-,20515
163,BUMA.1121.00088,2,334356,353549,+,19193
163,BUMA.1121.00047,2,1313352,1332511,+,19159
163,BUMA.1121.00019,2,1401197,1420455,-,19258
163,BUMA.1121.00087,2,2182067,2201371,-,19304
163,BUMA.1121.00039,2,402626,421834,-,19208
163,BUMA.1121.00030,2,765412,784670,+,19258
163,BUMA.1121.00016,2,203146,222343,-,19197
163,BUMA.1121.00092,2,382535,401821,+,19286
163,BUMA.1121.00046,2,289649,308873,-,19224
163,BUMA.1121.00003,2,1768454,1787677,+,19223
163,BUMA.1121.00054,2,518390,537604,+,19214
163,BUMA.1121.00015,2,1764578,1783764,-,19186
163,BUMA.1121.00105,2,2108134,2127380,-,19246
163,BUMA.1121.00053,2,611056,631488,+,20432
163,BUMA.1121.00057,2,1694660,1713872,-,19212
163,BUMA.1121.00108,2,620489,639783,+,19294
163,BUMA.1121.00050,2,804813,824037,+,19224
163,BUMA.1121.00104,2,488291,507482,+,19191
163,BUMA.1121.00014,2,388341,407523,+,19182
163,BUMA.1121.00036,2,890414,909758,-,19344
163,BUMA.1121.00038,2,718276,737490,+,19214
163,BUMA.1121.00098,2,591549,610716,+,19167
163,BUMA.1121.00078,2,2825847,2846319,-,20472
163,BUMA.1121.00029,2,971491,990655,-,19164
163,BUMA.1121.00099,2,524931,544225,+,19294
163,BUMA.1121.00103,2,2253598,2272814,+,19216
163,BUMA.1121.00102,2,383598,403988,+,20390
163,BUMA.1121.00028,2,1363288,1382546,-,19258
163,BUMA.1121.00075,2,2458415,2478811,-,20396
163,BUMA.1121.00044,2,1388227,1407485,-,19258
163,BUMA.1121.00076,2,1266869,1287266,+,20397
163,BUMA.1121.00074,2,847270,866443,-,19173
163,BUMA.1121.00073,2,373176,392383,+,19207
163,BUMA.1121.00083,2,2179782,2198989,+,19207
163,BUMA.1121.00035,2,1056299,1075495,-,19196
163,BUMA.1121.00072,2,372556,391760,+,19204
163,BUMA.1121.00056,2,489901,509056,-,19155
163,BUMA.1121.00081,2,1586059,1605273,-,19214
163,BUMA.1121.00033,2,1052534,1071675,+,19141
163,BUMA.1121.00061,2,364035,383204,+,19169
163,BUMA.1121.00062,2,1376931,1396130,-,19199
163,BUMA.1121.00069,2,372668,391875,+,19207
163,BUMA.1121.00070,2,373173,392380,+,19207
163,BUMA.1121.00068,2,2093396,2112647,+,19251
163,BUMA.1121.00067,2,407228,426405,-,19177
163,BUMA.1121.00037,2,647794,666987,+,19193
163,BUMA.1121.00065,2,383525,403995,+,20470
163,BUMA.1121.00058,2,945611,964721,+,19110
163,BUMA.1121.00041,2,1273109,1292324,+,19215
163,BUMA.1121.00084,2,2221563,2240690,+,19127
163,BUMA.1121.00096,2,542840,563190,+,20350
163,BUMA.1121.00080,2,382873,402060,+,19187
163,BUMA.1121.00013,2,1184843,1204091,+,19248
163,BUMA.1121.00100,2,1496175,1516677,+,20502
163,BUMA.1121.00012,2,1424007,1443105,-,19098
163,BUMA.1121.00018,2,310059,329287,-,19228
163,BUMA.1121.00048,2,38,19267,-,19229
163,BUMA.1121.00106,2,2797674,2816859,+,19185
163,BUMA.1121.00017,2,1337119,1356377,-,19258
163,BUMA.1121.00082,2,382825,402032,+,19207
164,BUMA.1121.00049,2,2212419,2248170,+,35751
164,BUMA.1121.00055,2,2248194,2284073,-,35879
164,BUMA.1121.00011,2,2221342,2257148,+,35806
164,BUMA.1121.00110,2,270912,306583,+,35671
164,BUMA.1121.00109,2,1027819,1063525,-,35706
164,BUMA.1121.00077,2,52785,88450,-,35665
164,BUMA.1121.00027,2,1453880,1489697,+,35817
164,BUMA.1121.00026,2,1164241,1199943,+,35702
164,BUMA.1121.00021,2,863842,899609,+,35767
164,BUMA.1121.00023,2,456676,492391,+,35715
164,BUMA.1121.00022,2,2317851,2353251,+,35400
164,BUMA.1121.00034,2,1301477,1336916,-,35439
164,BUMA.1121.00025,2,2023183,2059001,+,35818
164,BUMA.1121.00031,2,2739951,2775692,+,35741
164,BUMA.1121.00007,2,412578,448416,+,35838
164,BUMA.1121.00097,2,199843,235543,+,35700
164,BUMA.1121.00008,2,1285652,1321091,-,35439
164,BUMA.1121.00059,2,42775,78537,-,35762
164,BUMA.1121.00004,2,1286336,1321775,-,35439
164,BUMA.1121.00005,2,290177,325893,-,35716
164,BUMA.1121.00111,2,2841917,2877710,+,35793
164,BUMA.1121.00006,2,737665,773145,+,35480
164,BUMA.1121.00009,2,2251400,2287197,+,35797
164,BUMA.1121.00094,2,401067,436778,+,35711
164,BUMA.1121.00101,2,3022373,3058070,-,35697
164,BUMA.1121.00066,2,399566,435379,+,35813
164,BUMA.1121.00095,2,2460541,2496219,+,35678
164,BUMA.1121.00112,2,719677,755371,-,35694
164,BUMA.1121.00042,2,1063245,1098885,-,35640
164,BUMA.1121.00090,2,1304291,1340082,+,35791
164,BUMA.1121.00020,2,1286413,1321852,-,35439
164,BUMA.1121.00089,2,402191,437907,+,35716
164,BUMA.1121.00051,2,402253,438110,+,35857
164,BUMA.1121.00001,2,1824857,1860615,-,35758
164,BUMA.1121.00045,2,251168,286861,+,35693
164,BUMA.1121.00043,2,2011490,2047217,-,35727
164,BUMA.1121.00063,2,392670,428485,+,35815
164,BUMA.1121.00079,2,402635,438473,+,35838
164,BUMA.1121.00071,2,393557,429325,+,35768
164,BUMA.1121.00086,2,773089,808551,+,35462
164,BUMA.1121.00024,2,1421429,1456868,-,35439
164,BUMA.1121.00040,2,704185,739667,+,35482
164,BUMA.1121.00093,2,2507201,2542885,-,35684
164,BUMA.1121.00091,2,8519,44215,-,35696
164,BUMA.1121.00107,2,226461,262190,-,35729
164,BUMA.1121.00088,2,353759,389510,+,35751
164,BUMA.1121.00047,2,1332721,1368607,+,35886
164,BUMA.1121.00019,2,1365548,1400987,-,35439
164,BUMA.1121.00087,2,2146396,2181857,-,35461
164,BUMA.1121.00039,2,366649,402416,-,35767
164,BUMA.1121.00030,2,784880,820320,+,35440
164,BUMA.1121.00016,2,167252,202936,-,35684
164,BUMA.1121.00092,2,402031,437716,+,35685
164,BUMA.1121.00046,2,253928,289439,-,35511
164,BUMA.1121.00003,2,1787887,1823650,+,35763
164,BUMA.1121.00054,2,537814,573294,+,35480
164,BUMA.1121.00015,2,1728880,1764368,-,35488
164,BUMA.1121.00105,2,2072223,2107924,-,35701
164,BUMA.1121.00053,2,631698,667467,+,35769
164,BUMA.1121.00057,2,1658680,1694450,-,35770
164,BUMA.1121.00108,2,639993,675780,+,35787
164,BUMA.1121.00050,2,824247,859759,+,35512
164,BUMA.1121.00104,2,507692,543453,+,35761
164,BUMA.1121.00014,2,407733,443483,+,35750
164,BUMA.1121.00036,2,854757,890204,-,35447
164,BUMA.1121.00038,2,737700,773180,+,35480
164,BUMA.1121.00098,2,610926,646659,+,35733
164,BUMA.1121.00078,2,2789807,2825637,-,35830
164,BUMA.1121.00029,2,935465,971281,-,35816
164,BUMA.1121.00099,2,544435,580252,+,35817
164,BUMA.1121.00103,2,2273024,2308799,+,35775
164,BUMA.1121.00102,2,404198,439935,+,35737
164,BUMA.1121.00028,2,1327639,1363078,-,35439
164,BUMA.1121.00075,2,2422456,2458205,-,35749
164,BUMA.1121.00044,2,1352578,1388017,-,35439
164,BUMA.1121.00076,2,1287476,1323234,+,35758
164,BUMA.1121.00074,2,811379,847060,-,35681
164,BUMA.1121.00073,2,392593,428410,+,35817
164,BUMA.1121.00083,2,2199199,2235019,+,35820
164,BUMA.1121.00035,2,1020370,1056089,-,35719
164,BUMA.1121.00072,2,391970,427790,+,35820
164,BUMA.1121.00056,2,453976,489691,-,35715
164,BUMA.1121.00081,2,1550370,1585849,-,35479
164,BUMA.1121.00033,2,1071885,1107714,+,35829
164,BUMA.1121.00061,2,383414,419187,+,35773
164,BUMA.1121.00062,2,1341044,1376721,-,35677
164,BUMA.1121.00069,2,392085,427885,+,35800
164,BUMA.1121.00070,2,392590,428410,+,35820
164,BUMA.1121.00068,2,2112857,2148558,+,35701
164,BUMA.1121.00067,2,371316,407018,-,35702
164,BUMA.1121.00037,2,667197,702953,+,35756
164,BUMA.1121.00065,2,404205,439959,+,35754
164,BUMA.1121.00058,2,964931,1000667,+,35736
164,BUMA.1121.00041,2,1292534,1328481,+,35947
164,BUMA.1121.00084,2,2240900,2276651,+,35751
164,BUMA.1121.00096,2,563400,599161,+,35761
164,BUMA.1121.00080,2,402270,438163,+,35893
164,BUMA.1121.00013,2,1204301,1239767,+,35466
164,BUMA.1121.00100,2,1516887,1552573,+,35686
164,BUMA.1121.00012,2,1388039,1423797,-,35758
164,BUMA.1121.00018,2,274025,309849,-,35824
164,BUMA.1121.00048,2,2289718,2325197,-,35479
164,BUMA.1121.00106,2,2817069,2852779,+,35710
164,BUMA.1121.00017,2,1301470,1336909,-,35439
164,BUMA.1121.00082,2,402242,438062,+,35820
165,BUMA.1121.00049,2,2249270,2254735,+,5465
165,BUMA.1121.00055,2,2241616,2247093,-,5477
165,BUMA.1121.00011,2,2258245,2263692,+,5447
165,BUMA.1121.00110,2,307669,313146,+,5477
165,BUMA.1121.00109,2,1021241,1026721,-,5480
165,BUMA.1121.00077,2,46221,51698,-,5477
165,BUMA.1121.00027,2,1490797,1496268,+,5471
165,BUMA.1121.00026,2,1201019,1206483,+,5464
165,BUMA.1121.00021,2,900685,906162,+,5477
165,BUMA.1121.00023,2,493467,498932,+,5465
165,BUMA.1121.00022,2,2345,7823,+,5478
165,BUMA.1121.00034,2,1294937,1300400,-,5463
165,BUMA.1121.00025,2,2060077,2065530,+,5453
165,BUMA.1121.00031,2,2776768,2782245,+,5477
165,BUMA.1121.00007,2,449506,454992,+,5486
165,BUMA.1121.00097,2,236640,242102,+,5462
165,BUMA.1121.00008,2,1279112,1284575,-,5463
165,BUMA.1121.00059,2,36215,41674,-,5459
165,BUMA.1121.00004,2,1279796,1285259,-,5463
165,BUMA.1121.00005,2,283635,289100,-,5465
165,BUMA.1121.00111,2,2878786,2884263,+,5477
165,BUMA.1121.00006,2,774221,779678,+,5457
165,BUMA.1121.00009,2,2288297,2293747,+,5450
165,BUMA.1121.00094,2,437878,443325,+,5447
165,BUMA.1121.00101,2,3015829,3021312,-,5483
165,BUMA.1121.00066,2,436479,441944,+,5465
165,BUMA.1121.00095,2,2497309,2502798,+,5489
165,BUMA.1121.00112,2,713114,718586,-,5472
165,BUMA.1121.00042,2,1056710,1062168,-,5458
165,BUMA.1121.00090,2,1341158,1346635,+,5477
165,BUMA.1121.00020,2,1279873,1285336,-,5463
165,BUMA.1121.00089,2,439007,444454,+,5447
165,BUMA.1121.00051,2,439210,444657,+,5447
165,BUMA.1121.00001,2,1818306,1823780,-,5474
165,BUMA.1121.00045,2,287958,293438,+,5480
165,BUMA.1121.00043,2,2004942,2010413,-,5471
165,BUMA.1121.00063,2,429585,435050,+,5465
165,BUMA.1121.00079,2,439573,445028,+,5455
165,BUMA.1121.00071,2,430425,435890,+,5465
165,BUMA.1121.00086,2,809627,815096,+,5469
165,BUMA.1121.00024,2,1414889,1420352,-,5463
165,BUMA.1121.00040,2,740743,746200,+,5457
165,BUMA.1121.00093,2,2500653,2506100,-,5447
165,BUMA.1121.00091,2,1960,7428,-,5468
165,BUMA.1121.00107,2,219870,225360,-,5490
165,BUMA.1121.00088,2,390610,396075,+,5465
165,BUMA.1121.00047,2,1369707,1375154,+,5447
165,BUMA.1121.00019,2,1359008,1364471,-,5463
165,BUMA.1121.00087,2,2139850,2145319,-,5469
165,BUMA.1121.00039,2,360142,365572,-,5430
165,BUMA.1121.00030,2,821396,826859,+,5463
165,BUMA.1121.00016,2,160684,166161,-,5477
165,BUMA.1121.00092,2,438816,444263,+,5447
165,BUMA.1121.00046,2,247394,252851,-,5457
165,BUMA.1121.00003,2,1824781,1830252,+,5471
165,BUMA.1121.00054,2,574370,579827,+,5457
165,BUMA.1121.00015,2,1722340,1727803,-,5463
165,BUMA.1121.00105,2,2065657,2071122,-,5465
165,BUMA.1121.00053,2,668543,674008,+,5465
165,BUMA.1121.00057,2,1652114,1657579,-,5465
165,BUMA.1121.00108,2,676870,682332,+,5462
165,BUMA.1121.00050,2,860835,866292,+,5457
165,BUMA.1121.00104,2,544553,550018,+,5465
165,BUMA.1121.00014,2,444559,450036,+,5477
165,BUMA.1121.00036,2,848211,853680,-,5469
165,BUMA.1121.00038,2,774256,779713,+,5457
165,BUMA.1121.00098,2,647759,653243,+,5484
165,BUMA.1121.00078,2,2783259,2788730,-,5471
165,BUMA.1121.00029,2,928929,934388,-,5459
165,BUMA.1121.00099,2,581362,586848,+,5486
165,BUMA.1121.00103,2,2309889,2315402,+,5513
165,BUMA.1121.00102,2,441011,446476,+,5465
165,BUMA.1121.00028,2,1321099,1326562,-,5463
165,BUMA.1121.00075,2,2415884,2421355,-,5471
165,BUMA.1121.00044,2,1346038,1351501,-,5463
165,BUMA.1121.00076,2,1324334,1329799,+,5465
165,BUMA.1121.00074,2,804831,810278,-,5447
165,BUMA.1121.00073,2,429510,434975,+,5465
165,BUMA.1121.00083,2,2236119,2241584,+,5465
165,BUMA.1121.00035,2,1013819,1019293,-,5474
165,BUMA.1121.00072,2,428890,434355,+,5465
165,BUMA.1121.00056,2,447428,452875,-,5447
165,BUMA.1121.00081,2,1543836,1549293,-,5457
165,BUMA.1121.00033,2,1108790,1114274,+,5484
165,BUMA.1121.00061,2,420287,425752,+,5465
165,BUMA.1121.00062,2,1334460,1339943,-,5483
165,BUMA.1121.00069,2,428980,434445,+,5465
165,BUMA.1121.00070,2,429510,434975,+,5465
165,BUMA.1121.00068,2,2149655,2155141,+,5486
165,BUMA.1121.00067,2,364756,370215,-,5459
165,BUMA.1121.00037,2,704043,709527,+,5484
165,BUMA.1121.00065,2,441049,446529,+,5480
165,BUMA.1121.00058,2,1001767,1007214,+,5447
165,BUMA.1121.00041,2,1329557,1335020,+,5463
165,BUMA.1121.00084,2,2277751,2283222,+,5471
165,BUMA.1121.00096,2,600260,605757,+,5497
165,BUMA.1121.00080,2,439263,444710,+,5447
165,BUMA.1121.00013,2,1240843,1246306,+,5463
165,BUMA.1121.00100,2,1553704,1559182,+,5478
165,BUMA.1121.00012,2,1381497,1386962,-,5465
165,BUMA.1121.00018,2,267495,272948,-,5453
165,BUMA.1121.00048,2,2283184,2288641,-,5457
165,BUMA.1121.00106,2,2853879,2859350,+,5471
165,BUMA.1121.00017,2,1294930,1300393,-,5463
165,BUMA.1121.00082,2,439162,444627,+,5465
166,BUMA.1121.00049,2,2258136,2263984,+,5848
166,BUMA.1121.00055,2,2232347,2238211,-,5864
166,BUMA.1121.00011,2,2267092,2272897,+,5805
166,BUMA.1121.00110,2,316552,322431,+,5879
166,BUMA.1121.00109,2,1011989,1017836,-,5847
166,BUMA.1121.00077,2,36937,42816,-,5879
166,BUMA.1121.00027,2,1499674,1505577,+,5903
166,BUMA.1121.00026,2,1209873,1215745,+,5872
166,BUMA.1121.00021,2,909562,915370,+,5808
166,BUMA.1121.00023,2,502310,508118,+,5808
166,BUMA.1121.00022,2,11192,17024,+,5832
166,BUMA.1121.00034,2,1285725,1291569,-,5844
166,BUMA.1121.00025,2,2068930,2074738,+,5808
166,BUMA.1121.00031,2,2785643,2791451,+,5808
166,BUMA.1121.00007,2,458393,464189,+,5796
166,BUMA.1121.00097,2,245508,251313,+,5805
166,BUMA.1121.00008,2,1269900,1275744,-,5844
166,BUMA.1121.00059,2,27019,32815,-,5796
166,BUMA.1121.00004,2,1270585,1276428,-,5843
166,BUMA.1121.00005,2,274420,280228,-,5808
166,BUMA.1121.00111,2,2887670,2893489,+,5819
166,BUMA.1121.00006,2,783047,788889,+,5842
166,BUMA.1121.00009,2,2297153,2303000,+,5847
166,BUMA.1121.00094,2,446715,452523,+,5808
166,BUMA.1121.00101,2,3006611,3012424,-,5813
166,BUMA.1121.00066,2,445350,451224,+,5874
166,BUMA.1121.00095,2,2506204,2512012,+,5808
166,BUMA.1121.00112,2,703987,709795,-,5808
166,BUMA.1121.00042,2,1047457,1053321,-,5864
166,BUMA.1121.00090,2,1350035,1355843,+,5808
166,BUMA.1121.00020,2,1270661,1276505,-,5844
166,BUMA.1121.00089,2,447844,453652,+,5808
166,BUMA.1121.00051,2,448047,453854,+,5807
166,BUMA.1121.00001,2,1809099,1814907,-,5808
166,BUMA.1121.00045,2,296844,302652,+,5808
166,BUMA.1121.00043,2,1995735,2001543,-,5808
166,BUMA.1121.00063,2,438456,444327,+,5871
166,BUMA.1121.00079,2,448434,454241,+,5807
166,BUMA.1121.00071,2,439296,445170,+,5874
166,BUMA.1121.00086,2,818465,824297,+,5832
166,BUMA.1121.00024,2,1405677,1411521,-,5844
166,BUMA.1121.00040,2,749569,755421,+,5852
166,BUMA.1121.00093,2,2491381,2497248,-,5867
166,BUMA.1121.00091,2,3237544,3243371,-,5827
166,BUMA.1121.00107,2,210650,216469,-,5819
166,BUMA.1121.00088,2,399476,405304,+,5828
166,BUMA.1121.00047,2,1378544,1384352,+,5808
166,BUMA.1121.00019,2,1349796,1355640,-,5844
166,BUMA.1121.00087,2,2130638,2136482,-,5844
166,BUMA.1121.00039,2,350933,356751,-,5818
166,BUMA.1121.00030,2,830228,836060,+,5832
166,BUMA.1121.00016,2,151477,157285,-,5808
166,BUMA.1121.00092,2,447669,453556,+,5887
166,BUMA.1121.00046,2,238172,244026,-,5854
166,BUMA.1121.00003,2,1833658,1839479,+,5821
166,BUMA.1121.00054,2,583196,589037,+,5841
166,BUMA.1121.00015,2,1713118,1718972,-,5854
166,BUMA.1121.00105,2,2056449,2062257,-,5808
166,BUMA.1121.00053,2,677399,683217,+,5818
166,BUMA.1121.00057,2,1642835,1648709,-,5874
166,BUMA.1121.00108,2,685732,691589,+,5857
166,BUMA.1121.00050,2,869661,875503,+,5842
166,BUMA.1121.00104,2,553425,559273,+,5848
166,BUMA.1121.00014,2,453436,459244,+,5808
166,BUMA.1121.00036,2,838999,844843,-,5844
166,BUMA.1121.00038,2,783082,788924,+,5842
166,BUMA.1121.00098,2,656638,662445,+,5807
166,BUMA.1121.00078,2,2774051,2779859,-,5808
166,BUMA.1121.00029,2,919711,925530,-,5819
166,BUMA.1121.00099,2,590249,596057,+,5808
166,BUMA.1121.00103,2,2318808,2324613,+,5805
166,BUMA.1121.00102,2,449882,455726,+,5844
166,BUMA.1121.00028,2,1311887,1317731,-,5844
166,BUMA.1121.00075,2,2406662,2412478,-,5816
166,BUMA.1121.00044,2,1336826,1342670,-,5844
166,BUMA.1121.00076,2,1333206,1339011,+,5805
166,BUMA.1121.00074,2,795608,801426,-,5818
166,BUMA.1121.00073,2,438381,444252,+,5871
166,BUMA.1121.00083,2,2244990,2250864,+,5874
166,BUMA.1121.00035,2,1004612,1010420,-,5808
166,BUMA.1121.00072,2,437761,443635,+,5874
166,BUMA.1121.00056,2,438231,444039,-,5808
166,BUMA.1121.00081,2,1534614,1540468,-,5854
166,BUMA.1121.00033,2,1117674,1123482,+,5808
166,BUMA.1121.00061,2,429150,435022,+,5872
166,BUMA.1121.00062,2,1325207,1331061,-,5854
166,BUMA.1121.00064,2,374442,380221,+,5779
166,BUMA.1121.00060,2,1791173,1796981,-,5808
166,BUMA.1121.00069,2,437851,443725,+,5874
166,BUMA.1121.00070,2,438381,444255,+,5874
166,BUMA.1121.00068,2,2158547,2164344,+,5797
166,BUMA.1121.00067,2,355543,361351,-,5808
166,BUMA.1121.00037,2,712927,718657,+,5730
166,BUMA.1121.00065,2,449932,455740,+,5808
166,BUMA.1121.00058,2,1010620,1016438,+,5818
166,BUMA.1121.00041,2,1338426,1344263,+,5837
166,BUMA.1121.00084,2,2286624,2292462,+,5838
166,BUMA.1121.00096,2,609163,614967,+,5804
166,BUMA.1121.00080,2,448100,453907,+,5807
166,BUMA.1121.00013,2,1249675,1255557,+,5882
166,BUMA.1121.00100,2,1562588,1568404,+,5816
166,BUMA.1121.00012,2,1372283,1378091,-,5808
166,BUMA.1121.00018,2,258289,264096,-,5807
166,BUMA.1121.00048,2,2273962,2279816,-,5854
166,BUMA.1121.00106,2,2862756,2868564,+,5808
166,BUMA.1121.00017,2,1285718,1291562,-,5844
166,BUMA.1121.00082,2,448033,453907,+,5874
337,BUMA.1121.00027,1,950656,959219,+,8563
337,BUMA.1121.00025,1,3999239,4007803,-,8564
337,BUMA.1121.00021,1,3409245,3417811,+,8566
337,BUMA.1121.00023,1,1129637,1138201,+,8564
337,BUMA.1121.00024,1,2989078,2997617,+,8539
337,BUMA.1121.00033,1,998212,1006682,+,8470
337,BUMA.1121.00034,1,3097686,3106225,+,8539
337,BUMA.1121.00036,1,1043773,1052319,-,8546
337,BUMA.1121.00032,1,1113759,1122298,+,8539
337,BUMA.1121.00009,1,2763207,2771795,-,8588
337,BUMA.1121.00008,1,3071891,3080430,+,8539
337,BUMA.1121.00003,1,1297703,1306268,+,8565
337,BUMA.1121.00109,1,3095132,3103721,-,8589
337,BUMA.1121.00053,1,2570386,2578950,+,8564
337,BUMA.1121.00110,1,2003240,2011812,-,8572
337,BUMA.1121.00104,1,2432200,2440760,-,8560
337,BUMA.1121.00086,1,1746687,1755233,+,8546
337,BUMA.1121.00092,1,964046,972473,-,8427
337,BUMA.1121.00096,1,461325,469898,-,8573
337,BUMA.1121.00054,1,34514,42987,+,8473
337,BUMA.1121.00054,1,3530985,3539355,+,8370
337,BUMA.1121.00097,1,1111571,1120137,-,8566
337,BUMA.1121.00093,1,3653504,3662063,+,8559
337,BUMA.1121.00106,1,2550575,2559141,+,8566
337,BUMA.1121.00010,1,2094380,2102926,-,8546
337,BUMA.1121.00035,1,3963458,3972022,+,8564
337,BUMA.1121.00108,1,3848147,3856689,+,8542
337,BUMA.1121.00028,1,3060285,3068824,+,8539
337,BUMA.1121.00094,1,2794747,2803313,+,8566
337,BUMA.1121.00102,1,2474187,2482751,-,8564
337,BUMA.1121.00111,1,2979793,2988357,+,8564
337,BUMA.1121.00089,1,2765748,2774314,+,8566
337,BUMA.1121.00084,1,3176091,3184657,+,8566
337,BUMA.1121.00029,1,2152469,2161038,-,8569
337,BUMA.1121.00012,1,1563129,1571693,+,8564
337,BUMA.1121.00087,1,1561637,1570183,-,8546
337,BUMA.1121.00043,1,2894843,2903407,+,8564
337,BUMA.1121.00046,1,2079799,2088270,-,8471
337,BUMA.1121.00037,1,1413424,1421994,+,8570
337,BUMA.1121.00080,1,2809563,2818128,+,8565
337,BUMA.1121.00079,1,2843962,2852527,+,8565
337,BUMA.1121.00045,1,1245876,1254442,-,8566
337,BUMA.1121.00071,1,2737272,2745837,+,8565
337,BUMA.1121.00056,1,1152532,1161098,-,8566
337,BUMA.1121.00065,1,2866025,2874579,+,8554
337,BUMA.1121.00058,1,1710783,1719322,-,8539
337,BUMA.1121.00007,1,1245498,1254065,-,8567
337,BUMA.1121.00067,1,1602785,1611351,-,8566
337,BUMA.1121.00090,1,886173,894737,+,8564
337,BUMA.1121.00051,1,2777734,2786299,+,8565
337,BUMA.1121.00020,1,3125098,3133637,+,8539
337,BUMA.1121.00103,1,1594477,1603043,-,8566
337,BUMA.1121.00048,1,382605,391078,-,8473
337,BUMA.1121.00047,1,134553,143113,-,8560
337,BUMA.1121.00042,1,1243535,1252088,-,8553
337,BUMA.1121.00055,1,2489986,2498550,+,8564
337,BUMA.1121.00031,1,139589,148159,+,8570
337,BUMA.1121.00040,1,3072305,3080851,+,8546
337,BUMA.1121.00044,1,2325856,2334395,+,8539
337,BUMA.1121.00088,1,3721860,3730424,+,8564
337,BUMA.1121.00069,1,2717829,2726395,+,8566
337,BUMA.1121.00064,1,2817358,2825924,+,8566
337,BUMA.1121.00105,1,2383890,2392454,-,8564
337,BUMA.1121.00015,1,2569822,2578295,-,8473
337,BUMA.1121.00059,1,2038567,2047131,+,8564
337,BUMA.1121.00026,1,2321035,2329581,-,8546
337,BUMA.1121.00022,1,3478626,3487172,+,8546
337,BUMA.1121.00052,1,2831440,2839986,+,8546
337,BUMA.1121.00101,1,3632039,3640600,-,8561
337,BUMA.1121.00001,1,1268158,1276722,-,8564
337,BUMA.1121.00038,1,590080,598553,-,8473
337,BUMA.1121.00068,1,1582797,1591363,+,8566
337,BUMA.1121.00099,1,3598098,3606651,-,8553
337,BUMA.1121.00091,1,1702856,1711422,-,8566
337,BUMA.1121.00098,1,1470851,1479411,+,8560
337,BUMA.1121.00013,1,3123559,3132105,+,8546
337,BUMA.1121.00049,1,3015755,3024322,-,8567
337,BUMA.1121.00072,1,2719376,2727942,+,8566
337,BUMA.1121.00076,1,2502146,2510688,-,8542
337,BUMA.1121.00083,1,2864823,2873389,-,8566
337,BUMA.1121.00078,1,3193474,3202022,-,8548
337,BUMA.1121.00095,1,2901108,2909652,-,8544
337,BUMA.1121.00077,1,1471409,1479981,+,8572
337,BUMA.1121.00063,1,2745318,2753884,+,8566
337,BUMA.1121.00061,1,2748473,2757039,+,8566
337,BUMA.1121.00050,1,663427,671898,+,8471
337,BUMA.1121.00081,1,590149,598622,-,8473
337,BUMA.1121.00074,1,1048451,1057017,-,8566
337,BUMA.1121.00062,1,1747203,1755755,-,8552
337,BUMA.1121.00060,1,3491094,3499660,-,8566
337,BUMA.1121.00070,1,2719596,2728160,+,8564
337,BUMA.1121.00075,1,2301613,2310155,+,8542
337,BUMA.1121.00041,1,4118132,4126704,+,8572
337,BUMA.1121.00073,1,2746709,2755274,+,8565
337,BUMA.1121.00017,1,2995351,3003890,+,8539
337,BUMA.1121.00066,1,2722187,2730752,+,8565
337,BUMA.1121.00107,1,2751171,2759718,+,8547
337,BUMA.1121.00085,1,2428386,2436932,+,8546
337,BUMA.1121.00030,1,2995421,3003960,+,8539
337,BUMA.1121.00112,1,24805,33371,-,8566
337,BUMA.1121.00002,1,2121239,2129785,-,8546
337,BUMA.1121.00082,1,2905971,2914537,+,8566
337,BUMA.1121.00014,1,4102686,4111256,-,8570
337,BUMA.1121.00011,1,2848043,2856603,-,8560
337,BUMA.1121.00019,1,3011618,3020157,+,8539
337,BUMA.1121.00057,1,3921326,3929892,+,8566
337,BUMA.1121.00018,1,3402056,3410620,+,8564
337,BUMA.1121.00039,1,2949614,2958178,+,8564
337,BUMA.1121.00016,1,922949,931505,+,8556
337,BUMA.1121.00004,1,3140525,3149064,+,8539
337,BUMA.1121.00005,1,1513973,1522537,+,8564
337,BUMA.1121.00100,1,2556684,2565249,-,8565
337,BUMA.1121.00006,1,590079,598552,-,8473
338,BUMA.1121.00027,1,959635,967474,+,7839
338,BUMA.1121.00025,1,3990978,3998823,-,7845
338,BUMA.1121.00021,1,3418245,3426072,+,7827
338,BUMA.1121.00023,1,1138617,1146464,+,7847
338,BUMA.1121.00024,1,2998033,3005899,+,7866
338,BUMA.1121.00033,1,1007098,1014895,+,7797
338,BUMA.1121.00034,1,3106641,3114507,+,7866
338,BUMA.1121.00036,1,1035491,1043357,-,7866
338,BUMA.1121.00032,1,1122714,1130580,+,7866
338,BUMA.1121.00009,1,2754952,2762791,-,7839
338,BUMA.1121.00008,1,3080846,3088712,+,7866
338,BUMA.1121.00003,1,1306702,1314518,+,7816
338,BUMA.1121.00109,1,3086869,3094697,-,7828
338,BUMA.1121.00053,1,2579366,2587212,+,7846
338,BUMA.1121.00110,1,1994958,2002805,-,7847
338,BUMA.1121.00104,1,2423947,2431784,-,7837
338,BUMA.1121.00086,1,1755649,1763515,+,7866
338,BUMA.1121.00092,1,955792,963630,-,7838
338,BUMA.1121.00096,1,453062,460890,-,7828
338,BUMA.1121.00054,1,43403,51269,+,7866
338,BUMA.1121.00097,1,1103316,1111136,-,7820
338,BUMA.1121.00093,1,3662479,3670317,+,7838
338,BUMA.1121.00106,1,2559557,2567397,+,7840
338,BUMA.1121.00010,1,2086088,2093964,-,7876
338,BUMA.1121.00035,1,3972438,3980283,+,7845
338,BUMA.1121.00108,1,3857105,3864953,+,7848
338,BUMA.1121.00028,1,3069240,3077106,+,7866
338,BUMA.1121.00094,1,2803729,2811566,+,7837
338,BUMA.1121.00102,1,2465925,2473771,-,7846
338,BUMA.1121.00111,1,2988773,2996618,+,7845
338,BUMA.1121.00089,1,2774730,2782567,+,7837
338,BUMA.1121.00084,1,3185073,3192912,+,7839
338,BUMA.1121.00029,1,2144208,2152053,-,7845
338,BUMA.1121.00012,1,1572109,1579954,+,7845
338,BUMA.1121.00087,1,1553355,1561221,-,7866
338,BUMA.1121.00043,1,2903823,2911670,+,7847
338,BUMA.1121.00046,1,2071517,2079383,-,7866
338,BUMA.1121.00037,1,1422410,1430255,+,7845
338,BUMA.1121.00080,1,2818544,2826374,+,7830
338,BUMA.1121.00079,1,2852943,2860773,+,7830
338,BUMA.1121.00045,1,1237614,1245460,-,7846
338,BUMA.1121.00071,1,2746271,2754089,+,7818
338,BUMA.1121.00056,1,1144279,1152116,-,7837
338,BUMA.1121.00065,1,2874995,2882834,+,7839
338,BUMA.1121.00058,1,1702528,1710367,-,7839
338,BUMA.1121.00007,1,1237226,1245063,-,7837
338,BUMA.1121.00067,1,1594538,1602369,-,7831
338,BUMA.1121.00090,1,895153,902998,+,7845
338,BUMA.1121.00051,1,2786715,2794545,+,7830
338,BUMA.1121.00020,1,3134053,3141919,+,7866
338,BUMA.1121.00103,1,1586188,1594042,-,7854
338,BUMA.1121.00048,1,374323,382189,-,7866
338,BUMA.1121.00047,1,126306,134137,-,7831
338,BUMA.1121.00042,1,1235263,1243119,-,7856
338,BUMA.1121.00055,1,2498966,2506803,+,7837
338,BUMA.1121.00031,1,148575,156420,+,7845
338,BUMA.1121.00040,1,3081267,3089133,+,7866
338,BUMA.1121.00044,1,2334811,2342677,+,7866
338,BUMA.1121.00088,1,3730858,3738679,+,7821
338,BUMA.1121.00069,1,2726829,2734647,+,7818
338,BUMA.1121.00064,1,2826340,2834180,+,7840
338,BUMA.1121.00105,1,2375634,2383455,-,7821
338,BUMA.1121.00015,1,2561540,2569406,-,7866
338,BUMA.1121.00059,1,2047547,2055386,+,7839
338,BUMA.1121.00026,1,2312763,2320619,-,7856
338,BUMA.1121.00022,1,3487588,3495454,+,7866
338,BUMA.1121.00052,1,2840402,2848268,+,7866
338,BUMA.1121.00101,1,3623784,3631623,-,7839
338,BUMA.1121.00001,1,1259897,1267742,-,7845
338,BUMA.1121.00038,1,581798,589664,-,7866
338,BUMA.1121.00068,1,1591779,1599626,+,7847
338,BUMA.1121.00099,1,3589843,3597663,-,7820
338,BUMA.1121.00091,1,1694603,1702440,-,7837
338,BUMA.1121.00098,1,1479827,1487673,+,7846
338,BUMA.1121.00013,1,3132521,3140387,+,7866
338,BUMA.1121.00049,1,3007501,3015339,-,7838
338,BUMA.1121.00072,1,2728358,2736195,+,7837
338,BUMA.1121.00076,1,2493885,2501730,-,7845
338,BUMA.1121.00083,1,2856570,2864407,-,7837
338,BUMA.1121.00078,1,3185191,3193058,-,7867
338,BUMA.1121.00095,1,2892845,2900692,-,7847
338,BUMA.1121.00077,1,1480415,1488263,+,7848
338,BUMA.1121.00063,1,2754300,2762137,+,7837
338,BUMA.1121.00061,1,2757455,2765292,+,7837
338,BUMA.1121.00050,1,672314,680180,+,7866
338,BUMA.1121.00081,1,581867,589733,-,7866
338,BUMA.1121.00074,1,1040197,1048035,-,7838
338,BUMA.1121.00062,1,1738948,1746768,-,7820
338,BUMA.1121.00060,1,3482832,3490678,-,7846
338,BUMA.1121.00070,1,2728576,2736412,+,7836
338,BUMA.1121.00075,1,2310571,2318416,+,7845
338,BUMA.1121.00041,1,4127120,4134966,+,7846
338,BUMA.1121.00073,1,2755690,2763527,+,7837
338,BUMA.1121.00017,1,3004306,3012172,+,7866
338,BUMA.1121.00066,1,2731168,2739005,+,7837
338,BUMA.1121.00107,1,2760134,2767982,+,7848
338,BUMA.1121.00085,1,2437348,2445214,+,7866
338,BUMA.1121.00030,1,3004376,3012242,+,7866
338,BUMA.1121.00112,1,16541,24389,-,7848
338,BUMA.1121.00002,1,2112948,2120823,-,7875
338,BUMA.1121.00082,1,2914953,2922790,+,7837
338,BUMA.1121.00014,1,4094425,4102270,-,7845
338,BUMA.1121.00011,1,2839781,2847627,-,7846
338,BUMA.1121.00019,1,3020573,3028439,+,7866
338,BUMA.1121.00057,1,3930308,3938153,+,7845
338,BUMA.1121.00018,1,3411036,3418881,+,7845
338,BUMA.1121.00039,1,2958594,2966439,+,7845
338,BUMA.1121.00016,1,931921,939766,+,7845
338,BUMA.1121.00004,1,3149480,3157346,+,7866
338,BUMA.1121.00005,1,1522953,1530810,+,7857
338,BUMA.1121.00100,1,2548423,2556249,-,7826
338,BUMA.1121.00006,1,581797,589663,-,7866
339,BUMA.1121.00027,1,968364,983449,+,15085
339,BUMA.1121.00025,1,3974994,3990088,-,15094
339,BUMA.1121.00021,1,3426962,3442083,+,15121
339,BUMA.1121.00023,1,1147354,1162448,+,15094
339,BUMA.1121.00024,1,3006789,3021883,+,15094
339,BUMA.1121.00033,1,1017146,1032240,+,15094
339,BUMA.1121.00034,1,3115397,3130491,+,15094
339,BUMA.1121.00036,1,1019507,1034601,-,15094
339,BUMA.1121.00032,1,1131470,1146564,+,15094
339,BUMA.1121.00009,1,2738980,2754062,-,15082
339,BUMA.1121.00008,1,3089602,3104696,+,15094
339,BUMA.1121.00003,1,1315408,1330492,+,15084
339,BUMA.1121.00109,1,3070883,3085979,-,15096
339,BUMA.1121.00053,1,2588102,2603170,+,15068
339,BUMA.1121.00110,1,1978975,1994065,-,15090
339,BUMA.1121.00104,1,2407963,2423057,-,15094
339,BUMA.1121.00086,1,1764270,1779364,+,15094
339,BUMA.1121.00092,1,939817,954902,-,15085
339,BUMA.1121.00096,1,437043,452172,-,15129
339,BUMA.1121.00054,1,52159,67253,+,15094
339,BUMA.1121.00097,1,1087339,1102426,-,15087
339,BUMA.1121.00093,1,3671207,3686292,+,15085
339,BUMA.1121.00106,1,2568287,2583384,+,15097
339,BUMA.1121.00010,1,2070104,2085198,-,15094
339,BUMA.1121.00035,1,3981173,3996258,+,15085
339,BUMA.1121.00108,1,3865843,3880937,+,15094
339,BUMA.1121.00028,1,3077996,3093090,+,15094
339,BUMA.1121.00094,1,2812456,2827536,+,15080
339,BUMA.1121.00102,1,2449978,2465035,-,15057
339,BUMA.1121.00111,1,2997508,3012602,+,15094
339,BUMA.1121.00089,1,2783457,2798537,+,15080
339,BUMA.1121.00084,1,3193802,3208887,+,15085
339,BUMA.1121.00029,1,2128368,2143453,-,15085
339,BUMA.1121.00012,1,1580844,1595965,+,15121
339,BUMA.1121.00087,1,1537506,1552600,-,15094
339,BUMA.1121.00043,1,2912560,2927672,+,15112
339,BUMA.1121.00046,1,2055533,2070627,-,15094
339,BUMA.1121.00037,1,1431145,1446239,+,15094
339,BUMA.1121.00080,1,2827264,2842344,+,15080
339,BUMA.1121.00079,1,2861663,2876742,+,15079
339,BUMA.1121.00045,1,1221642,1236724,-,15082
339,BUMA.1121.00071,1,2754979,2770047,+,15068
339,BUMA.1121.00056,1,1128309,1143389,-,15080
339,BUMA.1121.00065,1,2883724,2898818,+,15094
339,BUMA.1121.00058,1,1686541,1701638,-,15097
339,BUMA.1121.00007,1,1221252,1236336,-,15084
339,BUMA.1121.00067,1,1578565,1593648,-,15083
339,BUMA.1121.00090,1,903888,918982,+,15094
339,BUMA.1121.00051,1,2795435,2810515,+,15080
339,BUMA.1121.00020,1,3142809,3157903,+,15094
339,BUMA.1121.00103,1,1528790,1543885,-,15095
339,BUMA.1121.00048,1,358339,373433,-,15094
339,BUMA.1121.00047,1,110336,125416,-,15080
339,BUMA.1121.00042,1,1219279,1234373,-,15094
339,BUMA.1121.00055,1,2507693,2522778,+,15085
339,BUMA.1121.00031,1,157310,172412,+,15102
339,BUMA.1121.00040,1,3090023,3105117,+,15094
339,BUMA.1121.00044,1,2343567,2358661,+,15094
339,BUMA.1121.00088,1,3739569,3754666,+,15097
339,BUMA.1121.00069,1,2735537,2750601,+,15064
339,BUMA.1121.00064,1,2835070,2850167,+,15097
339,BUMA.1121.00105,1,2359662,2374744,-,15082
339,BUMA.1121.00015,1,2545556,2560650,-,15094
339,BUMA.1121.00059,1,2056271,2071368,+,15097
339,BUMA.1121.00026,1,2296914,2312008,-,15094
339,BUMA.1121.00022,1,3496344,3511460,+,15116
339,BUMA.1121.00052,1,2849023,2864117,+,15094
339,BUMA.1121.00101,1,3607809,3622894,-,15085
339,BUMA.1121.00001,1,1243922,1259007,-,15085
339,BUMA.1121.00038,1,565814,580908,-,15094
339,BUMA.1121.00068,1,1600516,1615604,+,15088
339,BUMA.1121.00099,1,3573859,3588953,-,15094
339,BUMA.1121.00091,1,1678618,1693713,-,15095
339,BUMA.1121.00098,1,1488563,1503658,+,15095
339,BUMA.1121.00013,1,3141142,3156236,+,15094
339,BUMA.1121.00049,1,2991506,3006611,-,15105
339,BUMA.1121.00072,1,2737085,2752101,+,15016
339,BUMA.1121.00076,1,2477901,2492995,-,15094
339,BUMA.1121.00083,1,2840607,2855680,-,15073
339,BUMA.1121.00078,1,3169216,3184301,-,15085
339,BUMA.1121.00095,1,2876861,2891955,-,15094
339,BUMA.1121.00077,1,1489156,1504244,+,15088
339,BUMA.1121.00063,1,2763027,2778074,+,15047
339,BUMA.1121.00061,1,2766182,2781255,+,15073
339,BUMA.1121.00050,1,681070,696164,+,15094
339,BUMA.1121.00081,1,565883,580977,-,15094
339,BUMA.1121.00074,1,1024210,1039307,-,15097
339,BUMA.1121.00062,1,1722975,1738058,-,15083
339,BUMA.1121.00060,1,3466860,3481942,-,15082
339,BUMA.1121.00070,1,2737302,2752368,+,15066
339,BUMA.1121.00075,1,2319306,2334399,+,15093
339,BUMA.1121.00041,1,621,15689,+,15068
339,BUMA.1121.00073,1,2764417,2779490,+,15073
339,BUMA.1121.00017,1,3013062,3028156,+,15094
339,BUMA.1121.00066,1,2739895,2754965,+,15070
339,BUMA.1121.00107,1,2768872,2783966,+,15094
339,BUMA.1121.00085,1,2445969,2461063,+,15094
339,BUMA.1121.00030,1,3013132,3028226,+,15094
339,BUMA.1121.00112,1,566,15651,-,15085
339,BUMA.1121.00002,1,2096964,2112058,-,15094
339,BUMA.1121.00082,1,2923680,2938753,+,15073
339,BUMA.1121.00014,1,4078433,4093535,-,15102
339,BUMA.1121.00011,1,2823807,2838891,-,15084
339,BUMA.1121.00019,1,3029329,3044423,+,15094
339,BUMA.1121.00057,1,3939043,3954116,+,15073
339,BUMA.1121.00018,1,3419771,3434865,+,15094
339,BUMA.1121.00039,1,2967329,2982423,+,15094
339,BUMA.1121.00016,1,940656,955768,+,15112
339,BUMA.1121.00004,1,3158236,3173330,+,15094
339,BUMA.1121.00005,1,1531700,1546743,+,15043
339,BUMA.1121.00100,1,2532490,2547524,-,15034
339,BUMA.1121.00006,1,565813,580907,-,15094
340,BUMA.1121.00027,1,983962,1014810,+,30848
340,BUMA.1121.00025,1,3943449,3974481,-,31032
340,BUMA.1121.00021,1,3442596,3473440,+,30844
340,BUMA.1121.00023,1,1162961,1193826,+,30865
340,BUMA.1121.00024,1,3022396,3052948,+,30552
340,BUMA.1121.00033,1,1032753,1063602,+,30849
340,BUMA.1121.00034,1,3131004,3161556,+,30552
340,BUMA.1121.00036,1,988297,1018994,-,30697
340,BUMA.1121.00032,1,1147077,1177629,+,30552
340,BUMA.1121.00009,1,2707445,2738467,-,31022
340,BUMA.1121.00008,1,3105209,3135761,+,30552
340,BUMA.1121.00003,1,1331005,1361842,+,30837
340,BUMA.1121.00109,1,3039357,3070369,-,31012
340,BUMA.1121.00053,1,2603684,2634549,+,30865
340,BUMA.1121.00110,1,1947439,1978461,-,31022
340,BUMA.1121.00104,1,2376424,2407449,-,31025
340,BUMA.1121.00086,1,1779877,1810408,+,30531
340,BUMA.1121.00092,1,908288,939304,-,31016
340,BUMA.1121.00096,1,405490,436530,-,31040
340,BUMA.1121.00054,1,67766,98318,+,30552
340,BUMA.1121.00097,1,1055814,1086825,-,31011
340,BUMA.1121.00093,1,3686805,3717654,+,30849
340,BUMA.1121.00106,1,2583902,2614752,+,30850
340,BUMA.1121.00010,1,2038881,2069591,-,30710
340,BUMA.1121.00035,1,3996771,4027621,+,30850
340,BUMA.1121.00108,1,3881450,3912280,+,30830
340,BUMA.1121.00028,1,3093603,3124155,+,30552
340,BUMA.1121.00094,1,2828050,2858900,+,30850
340,BUMA.1121.00102,1,2418449,2449465,-,31016
340,BUMA.1121.00111,1,3013115,3043972,+,30857
340,BUMA.1121.00089,1,2799051,2829901,+,30850
340,BUMA.1121.00084,1,3209401,3240251,+,30850
340,BUMA.1121.00029,1,2096840,2127855,-,31015
340,BUMA.1121.00012,1,1596478,1627328,+,30850
340,BUMA.1121.00087,1,1506296,1536993,-,30697
340,BUMA.1121.00043,1,2928185,2959035,+,30850
340,BUMA.1121.00046,1,2024302,2055020,-,30718
340,BUMA.1121.00037,1,1446752,1477602,+,30850
340,BUMA.1121.00080,1,2842858,2873707,+,30849
340,BUMA.1121.00079,1,2877256,2908104,+,30848
340,BUMA.1121.00045,1,1190105,1221129,-,31024
340,BUMA.1121.00071,1,2770560,2801410,+,30850
340,BUMA.1121.00056,1,1096779,1127795,-,31016
340,BUMA.1121.00065,1,2899331,2930177,+,30846
340,BUMA.1121.00058,1,1655018,1686028,-,31010
340,BUMA.1121.00007,1,1189707,1220738,-,31031
340,BUMA.1121.00067,1,1547041,1578051,-,31010
340,BUMA.1121.00090,1,919495,950345,+,30850
340,BUMA.1121.00051,1,2811029,2841887,+,30858
340,BUMA.1121.00020,1,3158416,3188968,+,30552
340,BUMA.1121.00103,1,1497238,1528276,-,31038
340,BUMA.1121.00048,1,327108,357826,-,30718
340,BUMA.1121.00047,1,78806,109822,-,31016
340,BUMA.1121.00042,1,1188048,1218766,-,30718
340,BUMA.1121.00055,1,2523291,2554164,+,30873
340,BUMA.1121.00031,1,172926,203775,+,30849
340,BUMA.1121.00040,1,3105630,3136179,+,30549
340,BUMA.1121.00044,1,2359174,2389726,+,30552
340,BUMA.1121.00088,1,3755180,3786030,+,30850
340,BUMA.1121.00069,1,2751114,2781964,+,30850
340,BUMA.1121.00064,1,2850680,2881524,+,30844
340,BUMA.1121.00105,1,2328133,2359149,-,31016
340,BUMA.1121.00015,1,2514325,2545043,-,30718
340,BUMA.1121.00059,1,2071881,2102732,+,30851
340,BUMA.1121.00026,1,2265683,2296401,-,30718
340,BUMA.1121.00022,1,3511973,3542504,+,30531
340,BUMA.1121.00052,1,2864630,2895182,+,30552
340,BUMA.1121.00101,1,3576250,3607296,-,31046
340,BUMA.1121.00001,1,1212393,1243409,-,31016
340,BUMA.1121.00038,1,534583,565301,-,30718
340,BUMA.1121.00068,1,1616118,1646959,+,30841
340,BUMA.1121.00099,1,3542288,3573346,-,31058
340,BUMA.1121.00091,1,1647106,1678105,-,30999
340,BUMA.1121.00098,1,1504171,1535022,+,30851
340,BUMA.1121.00013,1,3156749,3187289,+,30540
340,BUMA.1121.00049,1,2959997,2990992,-,30995
340,BUMA.1121.00072,1,2752614,2783464,+,30850
340,BUMA.1121.00076,1,2446334,2477388,-,31054
340,BUMA.1121.00083,1,2809078,2840094,-,31016
340,BUMA.1121.00078,1,3137687,3168703,-,31016
340,BUMA.1121.00095,1,2845363,2876347,-,30984
340,BUMA.1121.00077,1,1504758,1535614,+,30856
340,BUMA.1121.00063,1,2778592,2809437,+,30845
340,BUMA.1121.00061,1,2781768,2812618,+,30850
340,BUMA.1121.00050,1,696677,727229,+,30552
340,BUMA.1121.00081,1,534652,565370,-,30718
340,BUMA.1121.00074,1,992686,1023696,-,31010
340,BUMA.1121.00062,1,1691451,1722461,-,31010
340,BUMA.1121.00060,1,3435323,3466347,-,31024
340,BUMA.1121.00070,1,2752881,2783731,+,30850
340,BUMA.1121.00075,1,2334912,2365798,+,30886
340,BUMA.1121.00041,1,16202,47048,+,30846
340,BUMA.1121.00073,1,2780003,2810853,+,30850
340,BUMA.1121.00017,1,3028669,3059221,+,30552
340,BUMA.1121.00066,1,2755478,2786328,+,30850
340,BUMA.1121.00107,1,2784479,2815325,+,30846
340,BUMA.1121.00085,1,2461576,2492128,+,30552
340,BUMA.1121.00030,1,3028739,3059289,+,30550
340,BUMA.1121.00112,1,4197744,4228716,-,30972
340,BUMA.1121.00002,1,2065741,2096451,-,30710
340,BUMA.1121.00082,1,2939266,2970116,+,30850
340,BUMA.1121.00014,1,4046902,4077919,-,31017
340,BUMA.1121.00011,1,2792269,2823293,-,31024
340,BUMA.1121.00019,1,3044936,3075488,+,30552
340,BUMA.1121.00057,1,3954629,3985479,+,30850
340,BUMA.1121.00018,1,3435378,3466244,+,30866
340,BUMA.1121.00039,1,2982936,3013786,+,30850
340,BUMA.1121.00016,1,956281,987129,+,30848
340,BUMA.1121.00004,1,3173843,3204395,+,30552
340,BUMA.1121.00005,1,1547256,1578106,+,30850
340,BUMA.1121.00100,1,2499741,2530793,-,31052
340,BUMA.1121.00006,1,534583,565300,-,30717
341,BUMA.1121.00027,1,1020662,1027261,+,6599
341,BUMA.1121.00025,1,3931212,3937793,-,6581
341,BUMA.1121.00021,1,3479370,3486003,+,6633
341,BUMA.1121.00023,1,1199612,1206285,+,6673
341,BUMA.1121.00024,1,3060017,3066613,+,6596
341,BUMA.1121.00033,1,1069417,1075975,+,6558
341,BUMA.1121.00034,1,3168625,3175214,+,6589
341,BUMA.1121.00036,1,2547918,2554499,+,6581
341,BUMA.1121.00032,1,1184698,1191287,+,6589
341,BUMA.1121.00009,1,2695165,2701772,-,6607
341,BUMA.1121.00008,1,3142830,3149419,+,6589
341,BUMA.1121.00003,1,1369341,1375957,+,6616
341,BUMA.1121.00109,1,3025768,3032289,-,6521
341,BUMA.1121.00053,1,2640394,2647016,+,6622
341,BUMA.1121.00110,1,1935172,1941806,-,6634
341,BUMA.1121.00104,1,2364151,2370778,-,6627
341,BUMA.1121.00086,1,245218,251807,-,6589
341,BUMA.1121.00092,1,895981,902609,-,6628
341,BUMA.1121.00096,1,393225,399846,-,6621
341,BUMA.1121.00054,1,107958,114554,+,6596
341,BUMA.1121.00097,1,1043418,1050101,-,6683
341,BUMA.1121.00093,1,3723498,3730126,+,6628
341,BUMA.1121.00106,1,2620545,2627249,+,6704
341,BUMA.1121.00010,1,2025348,2031944,-,6596
341,BUMA.1121.00035,1,4033436,4040027,+,6591
341,BUMA.1121.00108,1,3918055,3924641,+,6586
341,BUMA.1121.00028,1,3131224,3137813,+,6589
341,BUMA.1121.00094,1,2864721,2871311,+,6590
341,BUMA.1121.00102,1,2406233,2412799,-,6566
341,BUMA.1121.00111,1,3051342,3057906,+,6564
341,BUMA.1121.00089,1,2835728,2842318,+,6590
341,BUMA.1121.00084,1,3246110,3252747,+,6637
341,BUMA.1121.00029,1,2084578,2091176,-,6598
341,BUMA.1121.00012,1,1633115,1639700,+,6585
341,BUMA.1121.00087,1,3064775,3071364,+,6589
341,BUMA.1121.00043,1,2964822,2971470,+,6648
341,BUMA.1121.00046,1,2010802,2017398,-,6596
341,BUMA.1121.00037,1,1483375,1489926,+,6551
341,BUMA.1121.00080,1,2879604,2886193,+,6589
341,BUMA.1121.00079,1,2913938,2920539,+,6601
341,BUMA.1121.00045,1,1177831,1184416,-,6585
341,BUMA.1121.00071,1,2807212,2813766,+,6554
341,BUMA.1121.00056,1,1084527,1091117,-,6590
341,BUMA.1121.00065,1,2935969,2942558,+,6589
341,BUMA.1121.00058,1,1642779,1649388,-,6609
341,BUMA.1121.00007,1,1177593,1184095,-,6502
341,BUMA.1121.00067,1,1534736,1541347,-,6611
341,BUMA.1121.00090,1,956125,962771,+,6646
341,BUMA.1121.00051,1,2847819,2854445,+,6626
341,BUMA.1121.00020,1,3196044,3202633,+,6589
341,BUMA.1121.00103,1,1485128,1491603,-,6475
341,BUMA.1121.00048,1,311044,317640,-,6596
341,BUMA.1121.00047,1,66488,73102,-,6614
341,BUMA.1121.00042,1,1174584,1181160,-,6576
341,BUMA.1121.00055,1,2559916,2566429,+,6513
341,BUMA.1121.00031,1,209512,216098,+,6586
341,BUMA.1121.00040,1,3143275,3149871,+,6596
341,BUMA.1121.00044,1,2396795,2403384,+,6589
341,BUMA.1121.00088,1,3791826,3798424,+,6598
341,BUMA.1121.00069,1,2787770,2794391,+,6621
341,BUMA.1121.00064,1,2887331,2893890,+,6559
341,BUMA.1121.00105,1,2315861,2322488,-,6627
341,BUMA.1121.00015,1,2500825,2507421,-,6596
341,BUMA.1121.00059,1,2108575,2115156,+,6581
341,BUMA.1121.00026,1,2252219,2258788,-,6569
341,BUMA.1121.00022,1,1894600,1901182,-,6582
341,BUMA.1121.00052,1,2902258,2908802,+,6544
341,BUMA.1121.00101,1,3564110,3570605,-,6495
341,BUMA.1121.00001,1,1200173,1206771,-,6598
341,BUMA.1121.00038,1,518519,525115,-,6596
341,BUMA.1121.00068,1,1652893,1659477,+,6584
341,BUMA.1121.00099,1,3529995,3536574,-,6579
341,BUMA.1121.00091,1,1634867,1641478,-,6611
341,BUMA.1121.00098,1,1540789,1547423,+,6634
341,BUMA.1121.00013,1,3194379,3200916,+,6537
341,BUMA.1121.00049,1,2947708,2954323,-,6615
341,BUMA.1121.00072,1,2789259,2795935,+,6676
341,BUMA.1121.00076,1,2433979,2440618,-,6639
341,BUMA.1121.00083,1,2796740,2803433,-,6693
341,BUMA.1121.00078,1,3125303,3131961,-,6658
341,BUMA.1121.00095,1,2832971,2839531,-,6560
341,BUMA.1121.00077,1,1541405,1548039,+,6634
341,BUMA.1121.00063,1,2815247,2821915,+,6668
341,BUMA.1121.00061,1,2818428,2825079,+,6651
341,BUMA.1121.00050,1,734298,740894,+,6596
341,BUMA.1121.00081,1,518588,525184,-,6596
341,BUMA.1121.00074,1,980374,986985,-,6611
341,BUMA.1121.00062,1,1679200,1685806,-,6606
341,BUMA.1121.00060,1,3423049,3429634,-,6585
341,BUMA.1121.00070,1,2789541,2796196,+,6655
341,BUMA.1121.00075,1,2371665,2378297,+,6632
341,BUMA.1121.00041,1,52971,59597,+,6626
341,BUMA.1121.00073,1,2816663,2823316,+,6653
341,BUMA.1121.00017,1,3066290,3072879,+,6589
341,BUMA.1121.00066,1,2792129,2798783,+,6654
341,BUMA.1121.00107,1,2821161,2827764,+,6603
341,BUMA.1121.00085,1,2499204,2505748,+,6544
341,BUMA.1121.00030,1,3066358,3072947,+,6589
341,BUMA.1121.00112,1,4185439,4192012,-,6573
341,BUMA.1121.00002,1,2052206,2058802,-,6596
341,BUMA.1121.00082,1,2975926,2982619,+,6693
341,BUMA.1121.00014,1,4034674,4041323,-,6649
341,BUMA.1121.00011,1,2780014,2786579,-,6565
341,BUMA.1121.00019,1,3082557,3089146,+,6589
341,BUMA.1121.00057,1,3991310,3997933,+,6623
341,BUMA.1121.00018,1,3472050,3478631,+,6581
341,BUMA.1121.00039,1,3019594,3026175,+,6581
341,BUMA.1121.00016,1,992894,999489,+,6595
341,BUMA.1121.00004,1,3211464,3218053,+,6589
341,BUMA.1121.00005,1,1583900,1590576,+,6676
341,BUMA.1121.00100,1,2487399,2494037,-,6638
341,BUMA.1121.00006,1,518519,525115,-,6596
342,BUMA.1121.00027,1,1078046,1081642,+,3596
342,BUMA.1121.00025,1,3924956,3928522,-,3566
342,BUMA.1121.00021,1,3488693,3492241,+,3548
342,BUMA.1121.00023,1,1208975,1212523,+,3548
342,BUMA.1121.00024,1,3175024,3178590,-,3566
342,BUMA.1121.00033,1,1078665,1082208,+,3543
342,BUMA.1121.00034,1,3276576,3280142,-,3566
342,BUMA.1121.00036,1,2558819,2562367,+,3548
342,BUMA.1121.00032,1,1299698,1303264,-,3566
342,BUMA.1121.00009,1,2688803,2692475,-,3672
342,BUMA.1121.00008,1,3257830,3261396,-,3566
342,BUMA.1121.00003,1,1378647,1382237,+,3590
342,BUMA.1121.00109,1,3019516,3023079,-,3563
342,BUMA.1121.00053,1,2651301,2654876,+,3575
342,BUMA.1121.00110,1,1928802,1932482,-,3680
342,BUMA.1121.00104,1,2357880,2361461,-,3581
342,BUMA.1121.00086,1,237374,240913,-,3539
342,BUMA.1121.00092,1,889728,893291,-,3563
342,BUMA.1121.00096,1,386963,390535,-,3572
342,BUMA.1121.00054,1,221659,225189,-,3530
342,BUMA.1121.00097,1,1037138,1040728,-,3590
342,BUMA.1121.00093,1,3732816,3736379,+,3563
342,BUMA.1121.00106,1,2629939,2633511,+,3572
342,BUMA.1121.00010,1,2017488,2021063,-,3575
342,BUMA.1121.00035,1,4042717,4046262,+,3545
342,BUMA.1121.00108,1,3927331,3930876,+,3545
342,BUMA.1121.00028,1,3246224,3249790,-,3566
342,BUMA.1121.00094,1,2874001,2877591,+,3590
342,BUMA.1121.00102,1,2399986,2403543,-,3557
342,BUMA.1121.00111,1,3060596,3064177,+,3581
342,BUMA.1121.00089,1,2845008,2848598,+,3590
342,BUMA.1121.00084,1,3255437,3259018,+,3581
342,BUMA.1121.00029,1,2078352,2081888,-,3536
342,BUMA.1121.00012,1,1642390,1645935,+,3545
342,BUMA.1121.00087,1,3075651,3079190,+,3539
342,BUMA.1121.00043,1,2974160,2977696,+,3536
342,BUMA.1121.00046,1,1897581,1901111,+,3530
342,BUMA.1121.00037,1,1492616,1496182,+,3566
342,BUMA.1121.00080,1,2888883,2892473,+,3590
342,BUMA.1121.00079,1,2923229,2926810,+,3581
342,BUMA.1121.00045,1,1171551,1175141,-,3590
342,BUMA.1121.00071,1,2816456,2820019,+,3563
342,BUMA.1121.00056,1,1078247,1081837,-,3590
342,BUMA.1121.00065,1,2945248,2948802,+,3554
342,BUMA.1121.00058,1,1636517,1640089,-,3572
342,BUMA.1121.00007,1,1169784,1173312,-,3528
342,BUMA.1121.00067,1,1528474,1532046,-,3572
342,BUMA.1121.00090,1,965461,969015,+,3554
342,BUMA.1121.00051,1,2857135,2860725,+,3590
342,BUMA.1121.00020,1,3311044,3314610,-,3566
342,BUMA.1121.00103,1,1478928,1482438,-,3510
342,BUMA.1121.00048,1,200411,203941,+,3530
342,BUMA.1121.00047,1,60199,63798,-,3599
342,BUMA.1121.00042,1,1166763,1170303,-,3540
342,BUMA.1121.00055,1,2570712,2574266,+,3554
342,BUMA.1121.00031,1,218788,222282,+,3494
342,BUMA.1121.00040,1,3154155,3157711,+,3556
342,BUMA.1121.00044,1,2504746,2508312,-,3566
342,BUMA.1121.00088,1,3801114,3804704,+,3590
342,BUMA.1121.00069,1,2797081,2800642,+,3561
342,BUMA.1121.00064,1,2896580,2900143,+,3563
342,BUMA.1121.00105,1,2309599,2313171,-,3572
342,BUMA.1121.00015,1,2396266,2399811,+,3545
342,BUMA.1121.00059,1,2117846,2121427,+,3581
342,BUMA.1121.00026,1,2244372,2247938,-,3566
342,BUMA.1121.00022,1,1886746,1890294,-,3548
342,BUMA.1121.00052,1,2913086,2916661,+,3575
342,BUMA.1121.00101,1,3557740,3561420,-,3680
342,BUMA.1121.00001,1,1193931,1197483,-,3552
342,BUMA.1121.00038,1,407884,411414,+,3530
342,BUMA.1121.00068,1,1662167,1665704,+,3537
342,BUMA.1121.00099,1,3522105,3525713,-,3608
342,BUMA.1121.00091,1,1628605,1632177,-,3572
342,BUMA.1121.00098,1,1550113,1553667,+,3554
342,BUMA.1121.00013,1,3205200,3208757,+,3557
342,BUMA.1121.00049,1,2941428,2945018,-,3590
342,BUMA.1121.00072,1,2798625,2802206,+,3581
342,BUMA.1121.00076,1,2427708,2431289,-,3581
342,BUMA.1121.00083,1,2790469,2794050,-,3581
342,BUMA.1121.00078,1,3119047,3122613,-,3566
342,BUMA.1121.00095,1,2826582,2830281,-,3699
342,BUMA.1121.00077,1,1550729,1554410,+,3681
342,BUMA.1121.00063,1,2824605,2828162,+,3557
342,BUMA.1121.00061,1,2827769,2831335,+,3566
342,BUMA.1121.00050,1,850586,854116,-,3530
342,BUMA.1121.00081,1,407953,411483,+,3530
342,BUMA.1121.00074,1,974121,977684,-,3563
342,BUMA.1121.00062,1,1672929,1676510,-,3581
342,BUMA.1121.00060,1,3416769,3420359,-,3590
342,BUMA.1121.00070,1,2798886,2802448,+,3562
342,BUMA.1121.00075,1,2380987,2384567,+,3580
342,BUMA.1121.00041,1,62287,65903,+,3616
342,BUMA.1121.00073,1,2826006,2829569,+,3563
342,BUMA.1121.00017,1,3174241,3177807,-,3566
342,BUMA.1121.00066,1,2801473,2805054,+,3581
342,BUMA.1121.00107,1,2830454,2834098,+,3644
342,BUMA.1121.00085,1,2510032,2513607,+,3575
342,BUMA.1121.00030,1,3174309,3177875,-,3566
342,BUMA.1121.00112,1,4179176,4182748,-,3572
342,BUMA.1121.00002,1,2044344,2047919,-,3575
342,BUMA.1121.00082,1,2985309,2988890,+,3581
342,BUMA.1121.00014,1,4028481,4031984,-,3503
342,BUMA.1121.00011,1,2773878,2777324,-,3446
342,BUMA.1121.00019,1,3197557,3201123,-,3566
342,BUMA.1121.00057,1,4000623,4004204,+,3581
342,BUMA.1121.00018,1,3481321,3484878,+,3557
342,BUMA.1121.00039,1,3028865,3032413,+,3548
342,BUMA.1121.00016,1,1002160,1005740,+,3580
342,BUMA.1121.00004,1,3326464,3330030,-,3566
342,BUMA.1121.00005,1,1593266,1596810,+,3544
342,BUMA.1121.00100,1,2438804,2442376,-,3572
342,BUMA.1121.00006,1,407884,411414,+,3530
343,BUMA.1121.00027,1,1084996,1090426,+,5430
343,BUMA.1121.00025,1,3916284,3921598,-,5314
343,BUMA.1121.00021,1,3495600,3500998,+,5398
343,BUMA.1121.00023,1,1215882,1221280,+,5398
343,BUMA.1121.00024,1,3166264,3171669,-,5405
343,BUMA.1121.00033,1,1085561,1090874,+,5313
343,BUMA.1121.00034,1,3267816,3273221,-,5405
343,BUMA.1121.00036,1,2565723,2571127,+,5404
343,BUMA.1121.00032,1,1290938,1296343,-,5405
343,BUMA.1121.00009,1,2681608,2687041,-,5433
343,BUMA.1121.00008,1,3249070,3254475,-,5405
343,BUMA.1121.00003,1,1385591,1391032,+,5441
343,BUMA.1121.00109,1,3012317,3017759,-,5442
343,BUMA.1121.00053,1,2658230,2663662,+,5432
343,BUMA.1121.00110,1,1920016,1925449,-,5433
343,BUMA.1121.00104,1,2349095,2354527,-,5432
343,BUMA.1121.00086,1,228614,234019,-,5405
343,BUMA.1121.00092,1,882534,887966,-,5432
343,BUMA.1121.00096,1,378175,383608,-,5433
343,BUMA.1121.00054,1,212899,218304,-,5405
343,BUMA.1121.00097,1,1029948,1035381,-,5433
343,BUMA.1121.00093,1,3738142,3743573,+,5431
343,BUMA.1121.00106,1,2636865,2642296,+,5431
343,BUMA.1121.00010,1,2008723,2014128,-,5405
343,BUMA.1121.00035,1,4049620,4054933,+,5313
343,BUMA.1121.00108,1,3932634,3938066,+,5432
343,BUMA.1121.00028,1,3237464,3242869,-,5405
343,BUMA.1121.00094,1,2880942,2886373,+,5431
343,BUMA.1121.00102,1,2391200,2396633,-,5433
343,BUMA.1121.00111,1,3067530,3072928,+,5398
343,BUMA.1121.00089,1,2851951,2857382,+,5431
343,BUMA.1121.00084,1,3262377,3267811,+,5434
343,BUMA.1121.00029,1,2069681,2074995,-,5314
343,BUMA.1121.00012,1,1649293,1654691,+,5398
343,BUMA.1121.00087,1,3082546,3087950,+,5404
343,BUMA.1121.00043,1,2981054,2986367,+,5313
343,BUMA.1121.00046,1,1904467,1909871,+,5404
343,BUMA.1121.00037,1,1499541,1504939,+,5398
343,BUMA.1121.00080,1,2895826,2901257,+,5431
343,BUMA.1121.00079,1,2930164,2935595,+,5431
343,BUMA.1121.00045,1,1162765,1168198,-,5433
343,BUMA.1121.00071,1,2823373,2828804,+,5431
343,BUMA.1121.00056,1,1069463,1074895,-,5432
343,BUMA.1121.00065,1,2952155,2957586,+,5431
343,BUMA.1121.00058,1,1627732,1633164,-,5432
343,BUMA.1121.00007,1,1162594,1168027,-,5433
343,BUMA.1121.00067,1,1521285,1526717,-,5432
343,BUMA.1121.00090,1,972368,977766,+,5398
343,BUMA.1121.00051,1,2864078,2869507,+,5429
343,BUMA.1121.00020,1,3302284,3307689,-,5405
343,BUMA.1121.00103,1,1470141,1475574,-,5433
343,BUMA.1121.00048,1,207299,212703,+,5404
343,BUMA.1121.00047,1,51415,56847,-,5432
343,BUMA.1121.00042,1,1158003,1163408,-,5405
343,BUMA.1121.00055,1,2577620,2583018,+,5398
343,BUMA.1121.00031,1,225641,231039,+,5398
343,BUMA.1121.00040,1,3161067,3166471,+,5404
343,BUMA.1121.00044,1,2495986,2501391,-,5405
343,BUMA.1121.00088,1,3808063,3813497,+,5434
343,BUMA.1121.00069,1,2803996,2809427,+,5431
343,BUMA.1121.00064,1,2901901,2907332,+,5431
343,BUMA.1121.00105,1,2302407,2307842,-,5435
343,BUMA.1121.00015,1,2403167,2408571,+,5404
343,BUMA.1121.00059,1,2124780,2130211,+,5431
343,BUMA.1121.00026,1,2235611,2241016,-,5405
343,BUMA.1121.00022,1,1877987,1883392,-,5405
343,BUMA.1121.00052,1,2920017,2925421,+,5404
343,BUMA.1121.00101,1,3550550,3555983,-,5433
343,BUMA.1121.00001,1,1185260,1190574,-,5314
343,BUMA.1121.00038,1,414770,420174,+,5404
343,BUMA.1121.00068,1,1667462,1672894,+,5432
343,BUMA.1121.00099,1,3514912,3520343,-,5431
343,BUMA.1121.00091,1,1619818,1625251,-,5433
343,BUMA.1121.00098,1,1555425,1560857,+,5432
343,BUMA.1121.00013,1,3212113,3217517,+,5404
343,BUMA.1121.00049,1,2932643,2938075,-,5432
343,BUMA.1121.00072,1,2805560,2810991,+,5431
343,BUMA.1121.00076,1,2418922,2424355,-,5433
343,BUMA.1121.00083,1,2781684,2787116,-,5432
343,BUMA.1121.00078,1,3110293,3115692,-,5399
343,BUMA.1121.00095,1,2817808,2823228,-,5420
343,BUMA.1121.00077,1,1557763,1563195,+,5432
343,BUMA.1121.00063,1,2831511,2836942,+,5431
343,BUMA.1121.00061,1,2834683,2840114,+,5431
343,BUMA.1121.00050,1,841826,847231,-,5405
343,BUMA.1121.00081,1,414839,420243,+,5404
343,BUMA.1121.00074,1,966932,972364,-,5432
343,BUMA.1121.00062,1,1664144,1669576,-,5432
343,BUMA.1121.00060,1,3407983,3413416,-,5433
343,BUMA.1121.00070,1,2805802,2811233,+,5431
343,BUMA.1121.00075,1,2387920,2393352,+,5432
343,BUMA.1121.00041,1,69262,74694,+,5432
343,BUMA.1121.00073,1,2832918,2838349,+,5431
343,BUMA.1121.00017,1,3165481,3170886,-,5405
343,BUMA.1121.00066,1,2808401,2813832,+,5431
343,BUMA.1121.00107,1,2835856,2841288,+,5432
343,BUMA.1121.00085,1,2516963,2522367,+,5404
343,BUMA.1121.00030,1,3165549,3170954,-,5405
343,BUMA.1121.00112,1,4171986,4177419,-,5433
343,BUMA.1121.00002,1,2035584,2040989,-,5405
343,BUMA.1121.00082,1,2992244,2997675,+,5431
343,BUMA.1121.00014,1,4019724,4025123,-,5399
343,BUMA.1121.00011,1,2766688,2772121,-,5433
343,BUMA.1121.00019,1,3188797,3194202,-,5405
343,BUMA.1121.00057,1,1,5379,+,5378
343,BUMA.1121.00018,1,3488237,3493550,+,5313
343,BUMA.1121.00039,1,3035766,3041164,+,5398
343,BUMA.1121.00016,1,1009093,1014406,+,5313
343,BUMA.1121.00004,1,3317704,3323109,-,5405
343,BUMA.1121.00005,1,1600164,1605596,+,5432
343,BUMA.1121.00100,1,2430009,2435451,-,5442
343,BUMA.1121.00006,1,414770,420174,+,5404
344,BUMA.1121.00027,1,1091001,1101912,+,10911
344,BUMA.1121.00025,1,3906045,3915709,-,9664
344,BUMA.1121.00021,1,3501573,3511278,+,9705
344,BUMA.1121.00023,1,1221855,1231580,+,9725
344,BUMA.1121.00024,1,3156057,3165689,-,9632
344,BUMA.1121.00033,1,1091449,1101139,+,9690
344,BUMA.1121.00034,1,3257609,3267241,-,9632
344,BUMA.1121.00036,1,2571702,2581350,+,9648
344,BUMA.1121.00032,1,1280731,1290363,-,9632
344,BUMA.1121.00009,1,2671322,2681028,-,9706
344,BUMA.1121.00008,1,3238863,3248495,-,9632
344,BUMA.1121.00003,1,1391605,1401197,+,9592
344,BUMA.1121.00109,1,3002036,3011742,-,9706
344,BUMA.1121.00053,1,2664237,2673884,+,9647
344,BUMA.1121.00110,1,1909820,1919441,-,9621
344,BUMA.1121.00104,1,2337587,2348520,-,10933
344,BUMA.1121.00086,1,218413,228039,-,9626
344,BUMA.1121.00092,1,872337,881959,-,9622
344,BUMA.1121.00096,1,367812,377600,-,9788
344,BUMA.1121.00054,1,202710,212324,-,9614
344,BUMA.1121.00097,1,1019755,1029373,-,9618
344,BUMA.1121.00093,1,3744148,3753770,+,9622
344,BUMA.1121.00106,1,2642861,2652532,+,9671
344,BUMA.1121.00010,1,1998528,2008148,-,9620
344,BUMA.1121.00035,1,4055508,4065319,+,9811
344,BUMA.1121.00108,1,3938641,3948283,+,9642
344,BUMA.1121.00028,1,3227257,3236889,-,9632
344,BUMA.1121.00094,1,2886948,2896540,+,9592
344,BUMA.1121.00102,1,2380998,2390625,-,9627
344,BUMA.1121.00111,1,3073503,3083161,+,9658
344,BUMA.1121.00089,1,2857957,2867549,+,9592
344,BUMA.1121.00084,1,3268386,3277998,+,9612
344,BUMA.1121.00029,1,2059279,2069106,-,9827
344,BUMA.1121.00012,1,1655266,1664939,+,9673
344,BUMA.1121.00087,1,3088525,3098151,+,9626
344,BUMA.1121.00043,1,2986942,2996660,+,9718
344,BUMA.1121.00046,1,1910446,1920090,+,9644
344,BUMA.1121.00037,1,1505514,1515174,+,9660
344,BUMA.1121.00080,1,2901832,2911430,+,9598
344,BUMA.1121.00079,1,2936170,2945762,+,9592
344,BUMA.1121.00045,1,1152561,1162190,-,9629
344,BUMA.1121.00071,1,2829379,2840256,+,10877
344,BUMA.1121.00056,1,1059296,1068888,-,9592
344,BUMA.1121.00065,1,2958161,2967832,+,9671
344,BUMA.1121.00058,1,1617525,1627157,-,9632
344,BUMA.1121.00007,1,1152346,1162014,-,9668
344,BUMA.1121.00067,1,1511082,1520710,-,9628
344,BUMA.1121.00090,1,978341,988040,+,9699
344,BUMA.1121.00051,1,2870082,2879674,+,9592
344,BUMA.1121.00020,1,3292077,3301709,-,9632
344,BUMA.1121.00103,1,1459942,1469566,-,9624
344,BUMA.1121.00048,1,213278,222892,+,9614
344,BUMA.1121.00047,1,41248,50840,-,9592
344,BUMA.1121.00042,1,1147804,1157428,-,9624
344,BUMA.1121.00055,1,2583593,2593192,+,9599
344,BUMA.1121.00031,1,231614,241277,+,9663
344,BUMA.1121.00040,1,3167046,3176688,+,9642
344,BUMA.1121.00044,1,2485779,2495411,-,9632
344,BUMA.1121.00088,1,3814072,3823684,+,9612
344,BUMA.1121.00069,1,2810002,2820913,+,10911
344,BUMA.1121.00064,1,2907907,2917523,+,9616
344,BUMA.1121.00105,1,2290903,2300535,-,9632
344,BUMA.1121.00015,1,2409146,2418771,+,9625
344,BUMA.1121.00059,1,2130786,2140396,+,9610
344,BUMA.1121.00026,1,2225410,2235036,-,9626
344,BUMA.1121.00022,1,1867786,1877412,-,9626
344,BUMA.1121.00052,1,2925996,2935622,+,9626
344,BUMA.1121.00101,1,3540382,3549975,-,9593
344,BUMA.1121.00001,1,1174943,1184685,-,9742
344,BUMA.1121.00038,1,420749,430363,+,9614
344,BUMA.1121.00068,1,1673471,1683093,+,9622
344,BUMA.1121.00099,1,3504722,3514337,-,9615
344,BUMA.1121.00091,1,1609577,1619243,-,9666
344,BUMA.1121.00098,1,1561437,1571018,+,9581
344,BUMA.1121.00013,1,3218092,3227718,+,9626
344,BUMA.1121.00049,1,2922442,2932068,-,9626
344,BUMA.1121.00072,1,2811566,2822489,+,10923
344,BUMA.1121.00076,1,2407372,2418347,-,10975
344,BUMA.1121.00083,1,2770186,2781109,-,10923
344,BUMA.1121.00078,1,3100132,3109718,-,9586
344,BUMA.1121.00095,1,2807632,2817233,-,9601
344,BUMA.1121.00077,1,1563770,1573389,+,9619
344,BUMA.1121.00063,1,2837517,2848407,+,10890
344,BUMA.1121.00061,1,2840689,2851562,+,10873
344,BUMA.1121.00050,1,831607,841251,-,9644
344,BUMA.1121.00081,1,420818,430432,+,9614
344,BUMA.1121.00074,1,956735,966357,-,9622
344,BUMA.1121.00062,1,1653920,1663569,-,9649
344,BUMA.1121.00060,1,3397779,3407408,-,9629
344,BUMA.1121.00070,1,2811808,2822643,+,10835
344,BUMA.1121.00075,1,2393927,2404899,+,10972
344,BUMA.1121.00041,1,75269,84885,+,9616
344,BUMA.1121.00073,1,2838924,2849816,+,10892
344,BUMA.1121.00017,1,3155274,3164906,-,9632
344,BUMA.1121.00066,1,2814407,2825330,+,10923
344,BUMA.1121.00107,1,2841863,2851445,+,9582
344,BUMA.1121.00085,1,2522942,2532568,+,9626
344,BUMA.1121.00030,1,3155342,3164974,-,9632
344,BUMA.1121.00112,1,4161805,4171411,-,9606
344,BUMA.1121.00002,1,2025389,2035009,-,9620
344,BUMA.1121.00082,1,2998250,3009173,+,10923
344,BUMA.1121.00014,1,4009498,4019149,-,9651
344,BUMA.1121.00011,1,2756407,2766108,-,9701
344,BUMA.1121.00019,1,3178590,3188222,-,9632
344,BUMA.1121.00057,1,5954,16865,+,10911
344,BUMA.1121.00018,1,3494125,3503789,+,9664
344,BUMA.1121.00039,1,3041739,3051454,+,9715
344,BUMA.1121.00016,1,1014981,1024742,+,9761
344,BUMA.1121.00004,1,3307497,3317129,-,9632
344,BUMA.1121.00005,1,1606171,1615788,+,9617
344,BUMA.1121.00100,1,2419782,2429434,-,9652
344,BUMA.1121.00006,1,420749,430363,+,9614
345,BUMA.1121.00027,1,1101914,1105359,+,3445
345,BUMA.1121.00025,1,3902597,3906044,-,3447
345,BUMA.1121.00021,1,3511280,3514726,+,3446
345,BUMA.1121.00023,1,1231582,1235028,+,3446
345,BUMA.1121.00024,1,3152612,3156056,-,3444
345,BUMA.1121.00033,1,1101141,1104587,+,3446
345,BUMA.1121.00034,1,3254164,3257608,-,3444
345,BUMA.1121.00036,1,2582625,2586019,+,3394
345,BUMA.1121.00032,1,1277286,1280730,-,3444
345,BUMA.1121.00009,1,2667874,2671321,-,3447
345,BUMA.1121.00008,1,3235418,3238862,-,3444
345,BUMA.1121.00003,1,1401199,1404644,+,3445
345,BUMA.1121.00109,1,2998588,3002035,-,3447
345,BUMA.1121.00053,1,2673886,2677330,+,3444
345,BUMA.1121.00110,1,1906372,1909819,-,3447
345,BUMA.1121.00104,1,2334140,2337586,-,3446
345,BUMA.1121.00086,1,214968,218412,-,3444
345,BUMA.1121.00092,1,868890,872336,-,3446
345,BUMA.1121.00096,1,364365,367811,-,3446
345,BUMA.1121.00054,1,199265,202709,-,3444
345,BUMA.1121.00097,1,1016307,1019754,-,3447
345,BUMA.1121.00093,1,3753772,3757217,+,3445
345,BUMA.1121.00106,1,2652534,2655979,+,3445
345,BUMA.1121.00010,1,1995083,1998527,-,3444
345,BUMA.1121.00035,1,4065321,4068767,+,3446
345,BUMA.1121.00108,1,3948285,3951730,+,3445
345,BUMA.1121.00028,1,3223812,3227256,-,3444
345,BUMA.1121.00094,1,2896542,2899988,+,3446
345,BUMA.1121.00102,1,2377551,2380997,-,3446
345,BUMA.1121.00111,1,3083163,3086609,+,3446
345,BUMA.1121.00089,1,2867551,2870997,+,3446
345,BUMA.1121.00084,1,3278000,3281445,+,3445
345,BUMA.1121.00029,1,2055831,2059278,-,3447
345,BUMA.1121.00012,1,1664941,1668387,+,3446
345,BUMA.1121.00087,1,3098153,3101596,+,3443
345,BUMA.1121.00043,1,2996662,3000108,+,3446
345,BUMA.1121.00046,1,1920092,1923535,+,3443
345,BUMA.1121.00037,1,1515176,1518622,+,3446
345,BUMA.1121.00080,1,2911432,2914878,+,3446
345,BUMA.1121.00079,1,2945764,2949210,+,3446
345,BUMA.1121.00045,1,1149114,1152560,-,3446
345,BUMA.1121.00071,1,2840258,2843703,+,3445
345,BUMA.1121.00056,1,1055848,1059295,-,3447
345,BUMA.1121.00065,1,2967834,2971280,+,3446
345,BUMA.1121.00058,1,1614077,1617524,-,3447
345,BUMA.1121.00007,1,1148899,1152345,-,3446
345,BUMA.1121.00067,1,1507635,1511081,-,3446
345,BUMA.1121.00090,1,988042,991488,+,3446
345,BUMA.1121.00051,1,2879676,2883122,+,3446
345,BUMA.1121.00020,1,3288632,3292076,-,3444
345,BUMA.1121.00103,1,1456494,1459941,-,3447
345,BUMA.1121.00048,1,222894,226337,+,3443
345,BUMA.1121.00047,1,37800,41247,-,3447
345,BUMA.1121.00042,1,1144359,1147803,-,3444
345,BUMA.1121.00055,1,2593194,2596639,+,3445
345,BUMA.1121.00031,1,241279,244725,+,3446
345,BUMA.1121.00040,1,3176690,3180133,+,3443
345,BUMA.1121.00044,1,2482334,2485778,-,3444
345,BUMA.1121.00088,1,3823686,3827131,+,3445
345,BUMA.1121.00069,1,2820915,2824359,+,3444
345,BUMA.1121.00064,1,2917525,2920970,+,3445
345,BUMA.1121.00105,1,2287455,2290902,-,3447
345,BUMA.1121.00015,1,2418773,2422216,+,3443
345,BUMA.1121.00059,1,2140398,2143843,+,3445
345,BUMA.1121.00026,1,2221965,2225409,-,3444
345,BUMA.1121.00022,1,1864341,1867785,-,3444
345,BUMA.1121.00052,1,2935624,2939067,+,3443
345,BUMA.1121.00101,1,3536934,3540381,-,3447
345,BUMA.1121.00001,1,1171495,1174942,-,3447
345,BUMA.1121.00038,1,430365,433808,+,3443
345,BUMA.1121.00068,1,1683095,1686541,+,3446
345,BUMA.1121.00099,1,3501275,3504721,-,3446
345,BUMA.1121.00091,1,1606133,1609575,-,3442
345,BUMA.1121.00098,1,1571020,1574465,+,3445
345,BUMA.1121.00013,1,3227720,3231163,+,3443
345,BUMA.1121.00049,1,2918995,2922441,-,3446
345,BUMA.1121.00072,1,2822491,2825936,+,3445
345,BUMA.1121.00076,1,2403925,2407371,-,3446
345,BUMA.1121.00083,1,2766739,2770185,-,3446
345,BUMA.1121.00078,1,3096686,3100131,-,3445
345,BUMA.1121.00095,1,2804185,2807631,-,3446
345,BUMA.1121.00077,1,1573391,1576837,+,3446
345,BUMA.1121.00063,1,2848409,2851853,+,3444
345,BUMA.1121.00061,1,2851564,2855008,+,3444
345,BUMA.1121.00050,1,828162,831606,-,3444
345,BUMA.1121.00081,1,430434,433877,+,3443
345,BUMA.1121.00074,1,953288,956734,-,3446
345,BUMA.1121.00062,1,1650472,1653919,-,3447
345,BUMA.1121.00060,1,3394332,3397778,-,3446
345,BUMA.1121.00070,1,2822645,2826089,+,3444
345,BUMA.1121.00075,1,2404901,2408346,+,3445
345,BUMA.1121.00041,1,84887,88333,+,3446
345,BUMA.1121.00073,1,2849818,2853262,+,3444
345,BUMA.1121.00017,1,3151829,3155273,-,3444
345,BUMA.1121.00066,1,2825332,2828777,+,3445
345,BUMA.1121.00107,1,2851447,2854892,+,3445
345,BUMA.1121.00085,1,2532570,2536013,+,3443
345,BUMA.1121.00030,1,3151897,3155341,-,3444
345,BUMA.1121.00112,1,4158358,4161804,-,3446
345,BUMA.1121.00002,1,2021944,2025388,-,3444
345,BUMA.1121.00082,1,3009175,3012620,+,3445
345,BUMA.1121.00014,1,4006050,4009497,-,3447
345,BUMA.1121.00011,1,2752960,2756406,-,3446
345,BUMA.1121.00019,1,3175145,3178589,-,3444
345,BUMA.1121.00057,1,16867,20312,+,3445
345,BUMA.1121.00018,1,3503791,3507237,+,3446
345,BUMA.1121.00039,1,3051456,3054902,+,3446
345,BUMA.1121.00016,1,1024744,1028190,+,3446
345,BUMA.1121.00004,1,3304052,3307496,-,3444
345,BUMA.1121.00005,1,1615790,1619234,+,3444
345,BUMA.1121.00100,1,2416335,2419781,-,3446
345,BUMA.1121.00006,1,430365,433808,+,3443
346,BUMA.1121.00027,1,1106948,1120782,+,13834
346,BUMA.1121.00025,1,3887223,3901008,-,13785
346,BUMA.1121.00021,1,3516315,3530108,+,13793
346,BUMA.1121.00023,1,1236617,1250427,+,13810
346,BUMA.1121.00024,1,3137218,3151023,-,13805
346,BUMA.1121.00033,1,1106176,1119970,+,13794
346,BUMA.1121.00034,1,3238770,3252575,-,13805
346,BUMA.1121.00036,1,2587608,2601401,+,13793
346,BUMA.1121.00032,1,1261892,1275697,-,13805
346,BUMA.1121.00009,1,2652490,2666285,-,13795
346,BUMA.1121.00008,1,3220024,3233829,-,13805
346,BUMA.1121.00003,1,1406233,1420053,+,13820
346,BUMA.1121.00109,1,2983223,2996999,-,13776
346,BUMA.1121.00053,1,2678919,2692727,+,13808
346,BUMA.1121.00110,1,1890984,1904783,-,13799
346,BUMA.1121.00104,1,2318736,2332551,-,13815
346,BUMA.1121.00086,1,199580,213379,-,13799
346,BUMA.1121.00092,1,853489,867301,-,13812
346,BUMA.1121.00096,1,348980,362776,-,13796
346,BUMA.1121.00054,1,183883,197676,-,13793
346,BUMA.1121.00097,1,1000872,1014718,-,13846
346,BUMA.1121.00093,1,3758806,3772619,+,13813
346,BUMA.1121.00106,1,2657568,2671421,+,13853
346,BUMA.1121.00010,1,1979665,1993494,-,13829
346,BUMA.1121.00035,1,4070356,4084186,+,13830
346,BUMA.1121.00108,1,3953319,3967155,+,13836
346,BUMA.1121.00028,1,3208418,3222223,-,13805
346,BUMA.1121.00094,1,2901577,2915396,+,13819
346,BUMA.1121.00102,1,2362119,2375962,-,13843
346,BUMA.1121.00111,1,3088198,3102042,+,13844
346,BUMA.1121.00089,1,2872586,2886412,+,13826
346,BUMA.1121.00084,1,3283034,3296893,+,13859
346,BUMA.1121.00029,1,2040446,2054242,-,13796
346,BUMA.1121.00012,1,1669976,1683753,+,13777
346,BUMA.1121.00087,1,3103185,3116984,+,13799
346,BUMA.1121.00043,1,3001697,3015487,+,13790
346,BUMA.1121.00046,1,1925124,1938917,+,13793
346,BUMA.1121.00037,1,1520211,1534018,+,13807
346,BUMA.1121.00080,1,2916467,2930241,+,13774
346,BUMA.1121.00079,1,2950799,2964572,+,13773
346,BUMA.1121.00045,1,1133724,1147525,-,13801
346,BUMA.1121.00071,1,2845292,2859105,+,13813
346,BUMA.1121.00056,1,1040434,1054259,-,13825
346,BUMA.1121.00065,1,2972869,2986715,+,13846
346,BUMA.1121.00058,1,1598659,1612488,-,13829
346,BUMA.1121.00007,1,1133516,1147310,-,13794
346,BUMA.1121.00067,1,1492275,1506046,-,13771
346,BUMA.1121.00090,1,993077,1006907,+,13830
346,BUMA.1121.00051,1,2884711,2898486,+,13775
346,BUMA.1121.00020,1,3273238,3287043,-,13805
346,BUMA.1121.00103,1,1441129,1454905,-,13776
346,BUMA.1121.00048,1,227926,241719,+,13793
346,BUMA.1121.00047,1,22438,36211,-,13773
346,BUMA.1121.00042,1,1128965,1142770,-,13805
346,BUMA.1121.00055,1,2598228,2612032,+,13804
346,BUMA.1121.00031,1,246314,260121,+,13807
346,BUMA.1121.00040,1,3181722,3195515,+,13793
346,BUMA.1121.00044,1,2466940,2480745,-,13805
346,BUMA.1121.00088,1,3828720,3842545,+,13825
346,BUMA.1121.00069,1,2825948,2839750,+,13802
346,BUMA.1121.00064,1,2922559,2936331,+,13772
346,BUMA.1121.00105,1,2272005,2285866,-,13861
346,BUMA.1121.00015,1,2423805,2437598,+,13793
346,BUMA.1121.00059,1,2145432,2159238,+,13806
346,BUMA.1121.00026,1,2206565,2220376,-,13811
346,BUMA.1121.00022,1,1848947,1862752,-,13805
346,BUMA.1121.00052,1,2940656,2954449,+,13793
346,BUMA.1121.00101,1,3521522,3535345,-,13823
346,BUMA.1121.00001,1,1156077,1169906,-,13829
346,BUMA.1121.00038,1,435397,449190,+,13793
346,BUMA.1121.00068,1,1688130,1701912,+,13782
346,BUMA.1121.00099,1,3485864,3499686,-,13822
346,BUMA.1121.00091,1,1590726,1604544,-,13818
346,BUMA.1121.00098,1,1576054,1589817,+,13763
346,BUMA.1121.00013,1,3232752,3246545,+,13793
346,BUMA.1121.00049,1,2903591,2917406,-,13815
346,BUMA.1121.00072,1,2827525,2841331,+,13806
346,BUMA.1121.00076,1,2388479,2402336,-,13857
346,BUMA.1121.00083,1,2751338,2765150,-,13812
346,BUMA.1121.00078,1,3081317,3095097,-,13780
346,BUMA.1121.00095,1,2788761,2802596,-,13835
346,BUMA.1121.00077,1,1578426,1592226,+,13800
346,BUMA.1121.00063,1,2853442,2867255,+,13813
346,BUMA.1121.00061,1,2856597,2870409,+,13812
346,BUMA.1121.00050,1,812780,826573,-,13793
346,BUMA.1121.00081,1,435466,449259,+,13793
346,BUMA.1121.00074,1,937910,951699,-,13789
346,BUMA.1121.00062,1,1635116,1648883,-,13767
346,BUMA.1121.00060,1,3378936,3392743,-,13807
346,BUMA.1121.00070,1,2827678,2841478,+,13800
346,BUMA.1121.00075,1,2409935,2423793,+,13858
346,BUMA.1121.00041,1,89922,103738,+,13816
346,BUMA.1121.00073,1,2854851,2868651,+,13800
346,BUMA.1121.00017,1,3136435,3150240,-,13805
346,BUMA.1121.00066,1,2830366,2844179,+,13813
346,BUMA.1121.00107,1,2856481,2870267,+,13786
346,BUMA.1121.00085,1,2537602,2551395,+,13793
346,BUMA.1121.00030,1,3136503,3150308,-,13805
346,BUMA.1121.00112,1,4142958,4156769,-,13811
346,BUMA.1121.00002,1,2006526,2020355,-,13829
346,BUMA.1121.00082,1,3014209,3028022,+,13813
346,BUMA.1121.00014,1,3990655,4004461,-,13806
346,BUMA.1121.00011,1,2737554,2751371,-,13817
346,BUMA.1121.00019,1,3159751,3173556,-,13805
346,BUMA.1121.00057,1,21901,35716,+,13815
346,BUMA.1121.00018,1,3508826,3522606,+,13780
346,BUMA.1121.00039,1,3056491,3070280,+,13789
346,BUMA.1121.00016,1,1029779,1043617,+,13838
346,BUMA.1121.00004,1,3288658,3302463,-,13805
346,BUMA.1121.00005,1,1620823,1634589,+,13766
346,BUMA.1121.00100,1,2400920,2414746,-,13826
346,BUMA.1121.00006,1,435397,449190,+,13793
347,BUMA.1121.00027,1,1120815,1125163,+,4348
347,BUMA.1121.00025,1,3882841,3887190,-,4349
347,BUMA.1121.00021,1,3530141,3534488,+,4347
347,BUMA.1121.00023,1,1250460,1254808,+,4348
347,BUMA.1121.00024,1,3131244,3135591,-,4347
347,BUMA.1121.00033,1,1120003,1124352,+,4349
347,BUMA.1121.00034,1,3232796,3237143,-,4347
347,BUMA.1121.00036,1,2603028,2607374,+,4346
347,BUMA.1121.00032,1,1255918,1260265,-,4347
347,BUMA.1121.00009,1,2648110,2652457,-,4347
347,BUMA.1121.00008,1,3214050,3218397,-,4347
347,BUMA.1121.00003,1,1420086,1424432,+,4346
347,BUMA.1121.00109,1,2978843,2983190,-,4347
347,BUMA.1121.00053,1,2692760,2697109,+,4349
347,BUMA.1121.00110,1,1886604,1890951,-,4347
347,BUMA.1121.00104,1,2314355,2318703,-,4348
347,BUMA.1121.00086,1,193606,197953,-,4347
347,BUMA.1121.00092,1,849108,853456,-,4348
347,BUMA.1121.00096,1,344600,348947,-,4347
347,BUMA.1121.00054,1,177909,182256,-,4347
347,BUMA.1121.00097,1,996492,1000839,-,4347
347,BUMA.1121.00093,1,3772652,3776999,+,4347
347,BUMA.1121.00106,1,2671454,2675802,+,4348
347,BUMA.1121.00010,1,1973697,1978044,-,4347
347,BUMA.1121.00035,1,4084219,4088568,+,4349
347,BUMA.1121.00108,1,3967188,3971534,+,4346
347,BUMA.1121.00028,1,3202444,3206791,-,4347
347,BUMA.1121.00094,1,2915429,2919775,+,4346
347,BUMA.1121.00102,1,2357738,2362086,-,4348
347,BUMA.1121.00111,1,3102075,3106424,+,4349
347,BUMA.1121.00089,1,2886445,2890791,+,4346
347,BUMA.1121.00084,1,3296926,3301275,+,4349
347,BUMA.1121.00029,1,2036064,2040413,-,4349
347,BUMA.1121.00012,1,1683786,1688133,+,4347
347,BUMA.1121.00087,1,3118612,3122958,+,4346
347,BUMA.1121.00043,1,3015520,3019867,+,4347
347,BUMA.1121.00046,1,1940545,1944891,+,4346
347,BUMA.1121.00037,1,1534051,1538398,+,4347
347,BUMA.1121.00080,1,2930274,2934621,+,4347
347,BUMA.1121.00079,1,2964605,2968952,+,4347
347,BUMA.1121.00045,1,1129342,1133691,-,4349
347,BUMA.1121.00071,1,2859138,2863484,+,4346
347,BUMA.1121.00056,1,1036054,1040401,-,4347
347,BUMA.1121.00065,1,2986748,2991095,+,4347
347,BUMA.1121.00058,1,1592684,1597032,-,4348
347,BUMA.1121.00007,1,1127543,1131889,-,4346
347,BUMA.1121.00067,1,1487894,1492242,-,4348
347,BUMA.1121.00090,1,1006940,1011287,+,4347
347,BUMA.1121.00051,1,2898519,2902866,+,4347
347,BUMA.1121.00020,1,3267264,3271611,-,4347
347,BUMA.1121.00103,1,1436749,1441096,-,4347
347,BUMA.1121.00048,1,243347,247693,+,4346
347,BUMA.1121.00047,1,18057,22405,-,4348
347,BUMA.1121.00042,1,1124584,1128932,-,4348
347,BUMA.1121.00055,1,2612065,2616411,+,4346
347,BUMA.1121.00031,1,260154,264503,+,4349
347,BUMA.1121.00040,1,3197143,3201489,+,4346
347,BUMA.1121.00044,1,2460966,2465313,-,4347
347,BUMA.1121.00088,1,3842578,3846925,+,4347
347,BUMA.1121.00069,1,2839783,2844130,+,4347
347,BUMA.1121.00064,1,2936364,2940711,+,4347
347,BUMA.1121.00105,1,2267625,2271972,-,4347
347,BUMA.1121.00015,1,2439226,2443572,+,4346
347,BUMA.1121.00059,1,2159271,2163619,+,4348
347,BUMA.1121.00026,1,2202184,2206532,-,4348
347,BUMA.1121.00022,1,1842973,1847320,-,4347
347,BUMA.1121.00052,1,2956077,2960423,+,4346
347,BUMA.1121.00101,1,3517141,3521489,-,4348
347,BUMA.1121.00001,1,1151695,1156044,-,4349
347,BUMA.1121.00038,1,450818,455164,+,4346
347,BUMA.1121.00068,1,1701945,1706292,+,4347
347,BUMA.1121.00099,1,3481484,3485831,-,4347
347,BUMA.1121.00091,1,1586345,1590693,-,4348
347,BUMA.1121.00098,1,1589850,1594196,+,4346
347,BUMA.1121.00013,1,3248173,3252519,+,4346
347,BUMA.1121.00049,1,2899210,2903558,-,4348
347,BUMA.1121.00072,1,2841364,2845711,+,4347
347,BUMA.1121.00076,1,2384098,2388446,-,4348
347,BUMA.1121.00083,1,2746957,2751305,-,4348
347,BUMA.1121.00078,1,3076937,3081284,-,4347
347,BUMA.1121.00095,1,2784381,2788728,-,4347
347,BUMA.1121.00077,1,1592259,1596605,+,4346
347,BUMA.1121.00063,1,2867288,2871635,+,4347
347,BUMA.1121.00061,1,2870442,2874789,+,4347
347,BUMA.1121.00050,1,806806,811153,-,4347
347,BUMA.1121.00081,1,450887,455233,+,4346
347,BUMA.1121.00074,1,933529,937877,-,4348
347,BUMA.1121.00062,1,1630735,1635083,-,4348
347,BUMA.1121.00060,1,3374554,3378903,-,4349
347,BUMA.1121.00070,1,2841511,2845858,+,4347
347,BUMA.1121.00075,1,2423826,2428172,+,4346
347,BUMA.1121.00041,1,103771,108117,+,4346
347,BUMA.1121.00073,1,2868684,2873031,+,4347
347,BUMA.1121.00017,1,3130461,3134808,-,4347
347,BUMA.1121.00066,1,2844212,2848559,+,4347
347,BUMA.1121.00107,1,2870300,2874647,+,4347
347,BUMA.1121.00085,1,2553023,2557369,+,4346
347,BUMA.1121.00030,1,3130529,3134876,-,4347
347,BUMA.1121.00112,1,4138577,4142925,-,4348
347,BUMA.1121.00002,1,2000551,2004898,-,4347
347,BUMA.1121.00082,1,3028055,3032402,+,4347
347,BUMA.1121.00014,1,3986273,3990622,-,4349
347,BUMA.1121.00011,1,2733173,2737521,-,4348
347,BUMA.1121.00019,1,3153777,3158124,-,4347
347,BUMA.1121.00057,1,35749,40095,+,4346
347,BUMA.1121.00018,1,3522639,3526988,+,4349
347,BUMA.1121.00039,1,3070313,3074660,+,4347
347,BUMA.1121.00016,1,1043650,1047999,+,4349
347,BUMA.1121.00004,1,3282684,3287031,-,4347
347,BUMA.1121.00005,1,1634622,1638968,+,4346
347,BUMA.1121.00100,1,2396540,2400887,-,4347
347,BUMA.1121.00006,1,450818,455164,+,4346
348,BUMA.1121.00027,1,1126210,1135069,+,8859
348,BUMA.1121.00025,1,3872929,3881794,-,8865
348,BUMA.1121.00021,1,3535531,3544384,+,8853
348,BUMA.1121.00023,1,1255855,1264714,+,8859
348,BUMA.1121.00024,1,3121397,3130258,-,8861
348,BUMA.1121.00033,1,1125393,1134251,+,8858
348,BUMA.1121.00034,1,3222949,3231810,-,8861
348,BUMA.1121.00036,1,2608361,2617222,+,8861
348,BUMA.1121.00032,1,1246071,1254932,-,8861
348,BUMA.1121.00009,1,2638199,2647055,-,8856
348,BUMA.1121.00008,1,3204203,3213064,-,8861
348,BUMA.1121.00003,1,1425495,1434356,+,8861
348,BUMA.1121.00109,1,2968934,2977795,-,8861
348,BUMA.1121.00053,1,2698156,2707019,+,8863
348,BUMA.1121.00110,1,1876695,1885556,-,8861
348,BUMA.1121.00104,1,2304601,2313458,-,8857
348,BUMA.1121.00086,1,183759,192620,-,8861
348,BUMA.1121.00092,1,839201,848060,-,8859
348,BUMA.1121.00096,1,334689,343552,-,8863
348,BUMA.1121.00054,1,168062,176923,-,8861
348,BUMA.1121.00097,1,986581,995444,-,8863
348,BUMA.1121.00093,1,3778048,3786907,+,8859
348,BUMA.1121.00106,1,2676698,2685555,+,8857
348,BUMA.1121.00010,1,1963850,1972711,-,8861
348,BUMA.1121.00035,1,4089609,4098467,+,8858
348,BUMA.1121.00108,1,3972583,3981446,+,8863
348,BUMA.1121.00028,1,3192597,3201458,-,8861
348,BUMA.1121.00094,1,2920824,2929685,+,8861
348,BUMA.1121.00102,1,2347829,2356690,-,8861
348,BUMA.1121.00111,1,3107465,3116324,+,8859
348,BUMA.1121.00089,1,2891840,2900701,+,8861
348,BUMA.1121.00084,1,3302171,3311028,+,8857
348,BUMA.1121.00029,1,2026165,2035023,-,8858
348,BUMA.1121.00012,1,1689176,1698035,+,8859
348,BUMA.1121.00087,1,3123945,3132806,+,8861
348,BUMA.1121.00043,1,3020910,3029775,+,8865
348,BUMA.1121.00046,1,1945878,1954739,+,8861
348,BUMA.1121.00037,1,1539447,1548306,+,8859
348,BUMA.1121.00080,1,2935669,2944530,+,8861
348,BUMA.1121.00079,1,2970000,2978860,+,8860
348,BUMA.1121.00045,1,1119432,1128295,-,8863
348,BUMA.1121.00071,1,2864533,2873394,+,8861
348,BUMA.1121.00056,1,1026145,1035006,-,8861
348,BUMA.1121.00065,1,2992144,3001003,+,8859
348,BUMA.1121.00058,1,1582778,1591637,-,8859
348,BUMA.1121.00007,1,1117627,1126488,-,8861
348,BUMA.1121.00067,1,1477987,1486846,-,8859
348,BUMA.1121.00090,1,1012336,1021195,+,8859
348,BUMA.1121.00051,1,2903914,2912775,+,8861
348,BUMA.1121.00020,1,3257417,3266278,-,8861
348,BUMA.1121.00103,1,1426838,1435701,-,8863
348,BUMA.1121.00048,1,248680,257541,+,8861
348,BUMA.1121.00047,1,8148,17009,-,8861
348,BUMA.1121.00047,1,4083079,4091933,-,8854
348,BUMA.1121.00042,1,1114737,1123598,-,8861
348,BUMA.1121.00055,1,2617398,2626257,+,8859
348,BUMA.1121.00031,1,265544,274403,+,8859
348,BUMA.1121.00040,1,3202476,3211337,+,8861
348,BUMA.1121.00044,1,2451119,2459980,-,8861
348,BUMA.1121.00088,1,3847974,3856835,+,8861
348,BUMA.1121.00069,1,2845179,2854040,+,8861
348,BUMA.1121.00064,1,2941760,2950619,+,8859
348,BUMA.1121.00105,1,2257718,2266577,-,8859
348,BUMA.1121.00015,1,2444559,2453420,+,8861
348,BUMA.1121.00059,1,2164515,2173371,+,8856
348,BUMA.1121.00026,1,2192337,2201198,-,8861
348,BUMA.1121.00022,1,1833126,1841987,-,8861
348,BUMA.1121.00052,1,2961410,2970271,+,8861
348,BUMA.1121.00101,1,3507232,3516093,-,8861
348,BUMA.1121.00001,1,1141796,1150654,-,8858
348,BUMA.1121.00038,1,456151,465012,+,8861
348,BUMA.1121.00068,1,1707341,1716202,+,8861
348,BUMA.1121.00099,1,3471580,3480443,-,8863
348,BUMA.1121.00091,1,1576438,1585297,-,8859
348,BUMA.1121.00098,1,1595245,1604106,+,8861
348,BUMA.1121.00013,1,3253506,3262367,+,8861
348,BUMA.1121.00049,1,2889457,2898313,-,8856
348,BUMA.1121.00072,1,2846760,2855621,+,8861
348,BUMA.1121.00076,1,2374189,2383050,-,8861
348,BUMA.1121.00083,1,2737048,2745909,-,8861
348,BUMA.1121.00078,1,3067032,3075890,-,8858
348,BUMA.1121.00095,1,2774472,2783333,-,8861
348,BUMA.1121.00077,1,1597654,1606516,+,8862
348,BUMA.1121.00063,1,2872684,2881545,+,8861
348,BUMA.1121.00061,1,2875838,2884699,+,8861
348,BUMA.1121.00050,1,796959,805820,-,8861
348,BUMA.1121.00081,1,456220,465081,+,8861
348,BUMA.1121.00074,1,923622,932481,-,8859
348,BUMA.1121.00062,1,1620828,1629687,-,8859
348,BUMA.1121.00060,1,3364644,3373507,-,8863
348,BUMA.1121.00070,1,2846907,2855768,+,8861
348,BUMA.1121.00075,1,2429221,2438082,+,8861
348,BUMA.1121.00041,1,109166,118029,+,8863
348,BUMA.1121.00073,1,2874080,2882941,+,8861
348,BUMA.1121.00017,1,3120614,3129475,-,8861
348,BUMA.1121.00066,1,2849608,2858469,+,8861
348,BUMA.1121.00107,1,2875696,2884557,+,8861
348,BUMA.1121.00085,1,2558356,2567217,+,8861
348,BUMA.1121.00030,1,3120682,3129543,-,8861
348,BUMA.1121.00112,1,4128668,4137529,-,8861
348,BUMA.1121.00002,1,1990704,1999565,-,8861
348,BUMA.1121.00082,1,3033451,3042312,+,8861
348,BUMA.1121.00014,1,3976373,3985232,-,8859
348,BUMA.1121.00011,1,2723258,2732126,-,8868
348,BUMA.1121.00019,1,3143930,3152791,-,8861
348,BUMA.1121.00057,1,41144,50003,+,8859
348,BUMA.1121.00018,1,3528035,3536900,+,8865
348,BUMA.1121.00039,1,3075703,3084562,+,8859
348,BUMA.1121.00016,1,1049053,1057912,+,8859
348,BUMA.1121.00004,1,3272837,3281698,-,8861
348,BUMA.1121.00005,1,1640022,1648883,+,8861
348,BUMA.1121.00100,1,2386629,2395492,-,8863
348,BUMA.1121.00006,1,456151,465012,+,8861
349,BUMA.1121.00027,1,1135736,1142774,+,7038
349,BUMA.1121.00025,1,3865223,3872262,-,7039
349,BUMA.1121.00021,1,3545051,3552090,+,7039
349,BUMA.1121.00023,1,1265381,1272420,+,7039
349,BUMA.1121.00024,1,3112212,3119251,-,7039
349,BUMA.1121.00033,1,1147370,1154409,+,7039
349,BUMA.1121.00034,1,3213764,3220803,-,7039
349,BUMA.1121.00036,1,2619368,2626407,+,7039
349,BUMA.1121.00032,1,1236886,1243925,-,7039
349,BUMA.1121.00009,1,2621565,2628604,-,7039
349,BUMA.1121.00008,1,3195018,3202057,-,7039
349,BUMA.1121.00003,1,1435022,1442061,+,7039
349,BUMA.1121.00109,1,2961229,2968268,-,7039
349,BUMA.1121.00053,1,2707685,2714722,+,7037
349,BUMA.1121.00110,1,1868992,1876029,-,7037
349,BUMA.1121.00104,1,2296896,2303935,-,7039
349,BUMA.1121.00086,1,174574,181613,-,7039
349,BUMA.1121.00092,1,831495,838534,-,7039
349,BUMA.1121.00096,1,326998,334037,-,7039
349,BUMA.1121.00054,1,157913,164952,-,7039
349,BUMA.1121.00097,1,978876,985915,-,7039
349,BUMA.1121.00093,1,3787574,3794613,+,7039
349,BUMA.1121.00106,1,2697014,2704053,+,7039
349,BUMA.1121.00010,1,1954666,1961705,-,7039
349,BUMA.1121.00035,1,4099134,4106173,+,7039
349,BUMA.1121.00108,1,3982111,3989150,+,7039
349,BUMA.1121.00028,1,3183412,3190451,-,7039
349,BUMA.1121.00094,1,2930352,2937391,+,7039
349,BUMA.1121.00102,1,2340126,2347163,-,7037
349,BUMA.1121.00111,1,3116991,3124030,+,7039
349,BUMA.1121.00089,1,2901368,2908407,+,7039
349,BUMA.1121.00084,1,3311695,3318734,+,7039
349,BUMA.1121.00029,1,2018459,2025498,-,7039
349,BUMA.1121.00012,1,1698702,1705741,+,7039
349,BUMA.1121.00087,1,3137487,3144526,+,7039
349,BUMA.1121.00043,1,3030442,3037481,+,7039
349,BUMA.1121.00046,1,1957849,1964888,+,7039
349,BUMA.1121.00037,1,1548973,1556012,+,7039
349,BUMA.1121.00080,1,2945197,2952236,+,7039
349,BUMA.1121.00079,1,2979526,2986565,+,7039
349,BUMA.1121.00045,1,1111727,1118766,-,7039
349,BUMA.1121.00071,1,2874061,2881100,+,7039
349,BUMA.1121.00056,1,1018439,1025478,-,7039
349,BUMA.1121.00065,1,3011288,3018327,+,7039
349,BUMA.1121.00058,1,1575072,1582111,-,7039
349,BUMA.1121.00007,1,1109922,1116961,-,7039
349,BUMA.1121.00067,1,1470282,1477321,-,7039
349,BUMA.1121.00090,1,1021862,1028901,+,7039
349,BUMA.1121.00051,1,2913442,2920481,+,7039
349,BUMA.1121.00020,1,3248232,3255271,-,7039
349,BUMA.1121.00103,1,1419133,1426172,-,7039
349,BUMA.1121.00048,1,260650,267689,+,7039
349,BUMA.1121.00047,1,464,7481,-,7017
349,BUMA.1121.00047,1,4075373,4082412,-,7039
349,BUMA.1121.00042,1,1103729,1110768,-,7039
349,BUMA.1121.00055,1,2626923,2633962,+,7039
349,BUMA.1121.00031,1,275070,282109,+,7039
349,BUMA.1121.00040,1,3213482,3220459,+,6977
349,BUMA.1121.00044,1,2441934,2448973,-,7039
349,BUMA.1121.00088,1,3919835,3926874,+,7039
349,BUMA.1121.00069,1,2854707,2861746,+,7039
349,BUMA.1121.00064,1,2951286,2958325,+,7039
349,BUMA.1121.00105,1,2250013,2257052,-,7039
349,BUMA.1121.00015,1,2456530,2463569,+,7039
349,BUMA.1121.00059,1,2174038,2181077,+,7039
349,BUMA.1121.00026,1,2183035,2190074,-,7039
349,BUMA.1121.00022,1,3549767,3556806,+,7039
349,BUMA.1121.00052,1,2973730,2980769,+,7039
349,BUMA.1121.00101,1,3499527,3506566,-,7039
349,BUMA.1121.00001,1,1134090,1141129,-,7039
349,BUMA.1121.00038,1,468122,475161,+,7039
349,BUMA.1121.00068,1,1728783,1735804,+,7021
349,BUMA.1121.00099,1,3463875,3470914,-,7039
349,BUMA.1121.00091,1,1557942,1564979,-,7037
349,BUMA.1121.00098,1,1604772,1611811,+,7039
349,BUMA.1121.00013,1,3265826,3272865,+,7039
349,BUMA.1121.00049,1,2867338,2874377,-,7039
349,BUMA.1121.00072,1,2856288,2863326,+,7038
349,BUMA.1121.00076,1,2366486,2373523,-,7037
349,BUMA.1121.00083,1,2729342,2736381,-,7039
349,BUMA.1121.00078,1,3053531,3060465,-,6934
349,BUMA.1121.00095,1,2766779,2773806,-,7027
349,BUMA.1121.00077,1,1607181,1614218,+,7037
349,BUMA.1121.00063,1,2882212,2889251,+,7039
349,BUMA.1121.00061,1,2885366,2892405,+,7039
349,BUMA.1121.00050,1,786810,793849,-,7039
349,BUMA.1121.00081,1,468191,475230,+,7039
349,BUMA.1121.00074,1,915917,922956,-,7039
349,BUMA.1121.00062,1,1603923,1610962,-,7039
349,BUMA.1121.00060,1,3356939,3363978,-,7039
349,BUMA.1121.00070,1,2856435,2863473,+,7038
349,BUMA.1121.00075,1,2438748,2445785,+,7037
349,BUMA.1121.00041,1,177129,184166,+,7037
349,BUMA.1121.00073,1,2883608,2890646,+,7038
349,BUMA.1121.00017,1,3111429,3118468,-,7039
349,BUMA.1121.00066,1,2859136,2866175,+,7039
349,BUMA.1121.00107,1,2885223,2892262,+,7039
349,BUMA.1121.00085,1,2570676,2577715,+,7039
349,BUMA.1121.00030,1,3111497,3118536,-,7039
349,BUMA.1121.00112,1,4120981,4128002,-,7021
349,BUMA.1121.00002,1,1981519,1988558,-,7039
349,BUMA.1121.00082,1,3042979,3050018,+,7039
349,BUMA.1121.00014,1,3968667,3975706,-,7039
349,BUMA.1121.00011,1,2700950,2707971,-,7021
349,BUMA.1121.00019,1,3134745,3141784,-,7039
349,BUMA.1121.00057,1,50669,57706,+,7037
349,BUMA.1121.00018,1,3537567,3544606,+,7039
349,BUMA.1121.00039,1,3085229,3092268,+,7039
349,BUMA.1121.00016,1,1058578,1065617,+,7039
349,BUMA.1121.00004,1,3263652,3270691,-,7039
349,BUMA.1121.00005,1,1659181,1666220,+,7039
349,BUMA.1121.00100,1,2378924,2385963,-,7039
349,BUMA.1121.00006,1,468122,475161,+,7039
350,BUMA.1121.00027,1,1145968,1157021,+,11053
350,BUMA.1121.00025,1,3851063,3862126,-,11063
350,BUMA.1121.00021,1,3555187,3566250,+,11063
350,BUMA.1121.00023,1,1275538,1286601,+,11063
350,BUMA.1121.00024,1,3098011,3109039,-,11028
350,BUMA.1121.00033,1,1157568,1168597,+,11029
350,BUMA.1121.00034,1,3199563,3210591,-,11028
350,BUMA.1121.00036,1,2629615,2640643,+,11028
350,BUMA.1121.00032,1,1222685,1233713,-,11028
350,BUMA.1121.00009,1,2607373,2618426,-,11053
350,BUMA.1121.00008,1,3180817,3191845,-,11028
350,BUMA.1121.00003,1,1445234,1456297,+,11063
350,BUMA.1121.00109,1,2947004,2958065,-,11061
350,BUMA.1121.00053,1,2717860,2728900,+,11040
350,BUMA.1121.00110,1,1854813,1865867,-,11054
350,BUMA.1121.00104,1,2282668,2293723,-,11055
350,BUMA.1121.00086,1,160380,171408,-,11028
350,BUMA.1121.00092,1,817212,828242,-,11030
350,BUMA.1121.00096,1,312770,323824,-,11054
350,BUMA.1121.00054,1,143722,154740,-,11018
350,BUMA.1121.00097,1,964683,975745,-,11062
350,BUMA.1121.00093,1,3797866,3808896,+,11030
350,BUMA.1121.00106,1,2707205,2718260,+,11055
350,BUMA.1121.00010,1,1940521,1951549,-,11028
350,BUMA.1121.00035,1,4109346,4120401,+,11055
350,BUMA.1121.00108,1,3992281,4003302,+,11021
350,BUMA.1121.00028,1,3169211,3180239,-,11028
350,BUMA.1121.00094,1,2940550,2951605,+,11055
350,BUMA.1121.00102,1,2325944,2337007,-,11063
350,BUMA.1121.00111,1,3127127,3138190,+,11063
350,BUMA.1121.00089,1,2911559,2922614,+,11055
350,BUMA.1121.00084,1,3321879,3332932,+,11053
350,BUMA.1121.00029,1,2004253,2015307,-,11054
350,BUMA.1121.00012,1,1708921,1719984,+,11063
350,BUMA.1121.00087,1,3147692,3158720,+,11028
350,BUMA.1121.00043,1,3040661,3051724,+,11063
350,BUMA.1121.00046,1,1968082,1979110,+,11028
350,BUMA.1121.00037,1,1559109,1570172,+,11063
350,BUMA.1121.00080,1,2955381,2966436,+,11055
350,BUMA.1121.00079,1,2989710,3000764,+,11054
350,BUMA.1121.00045,1,1097517,1108580,-,11063
350,BUMA.1121.00071,1,2884234,2895282,+,11048
350,BUMA.1121.00056,1,1004232,1015287,-,11055
350,BUMA.1121.00065,1,3021559,3032613,+,11054
350,BUMA.1121.00058,1,1560851,1571920,-,11069
350,BUMA.1121.00007,1,1095743,1106793,-,11050
350,BUMA.1121.00067,1,1456082,1467151,-,11069
350,BUMA.1121.00090,1,1031998,1043061,+,11063
350,BUMA.1121.00051,1,2923619,2934672,+,11053
350,BUMA.1121.00020,1,3234031,3245059,-,11028
350,BUMA.1121.00103,1,1404888,1415960,-,11072
350,BUMA.1121.00048,1,270862,281880,+,11018
350,BUMA.1121.00047,1,4061166,4072221,-,11055
350,BUMA.1121.00042,1,1089508,1100542,-,11034
350,BUMA.1121.00055,1,2637138,2648193,+,11055
350,BUMA.1121.00031,1,285206,296269,+,11063
350,BUMA.1121.00040,1,3223723,3234751,+,11028
350,BUMA.1121.00044,1,2427733,2438761,-,11028
350,BUMA.1121.00088,1,3930026,3941079,+,11053
350,BUMA.1121.00069,1,2864880,2875943,+,11063
350,BUMA.1121.00064,1,2961498,2972552,+,11054
350,BUMA.1121.00105,1,2235746,2246799,-,11053
350,BUMA.1121.00015,1,2466763,2477791,+,11028
350,BUMA.1121.00059,1,2184241,2195296,+,11055
350,BUMA.1121.00026,1,2168870,2179904,-,11034
350,BUMA.1121.00022,1,90,11118,+,11028
350,BUMA.1121.00052,1,2983956,2994984,+,11028
350,BUMA.1121.00101,1,3485327,3496380,-,11053
350,BUMA.1121.00001,1,1119877,1130931,-,11054
350,BUMA.1121.00038,1,478334,489352,+,11018
350,BUMA.1121.00068,1,1738937,1749991,+,11054
350,BUMA.1121.00099,1,3449684,3460737,-,11053
350,BUMA.1121.00091,1,1543740,1554795,-,11055
350,BUMA.1121.00098,1,1614971,1626034,+,11063
350,BUMA.1121.00013,1,3276052,3287080,+,11028
350,BUMA.1121.00049,1,2853165,2864219,-,11054
350,BUMA.1121.00072,1,2866460,2877423,+,10963
350,BUMA.1121.00076,1,2352235,2363289,-,11054
350,BUMA.1121.00083,1,2715140,2726203,-,11063
350,BUMA.1121.00078,1,3039384,3050404,-,11020
350,BUMA.1121.00095,1,2752566,2763619,-,11053
350,BUMA.1121.00077,1,1617343,1628397,+,11054
350,BUMA.1121.00063,1,2892387,2903450,+,11063
350,BUMA.1121.00061,1,2895541,2906583,+,11042
350,BUMA.1121.00050,1,772588,783616,-,11028
350,BUMA.1121.00081,1,478403,489421,+,11018
350,BUMA.1121.00074,1,901717,912786,-,11069
350,BUMA.1121.00062,1,1589776,1600831,-,11055
350,BUMA.1121.00060,1,3342729,3353792,-,11063
350,BUMA.1121.00070,1,2866610,2877673,+,11063
350,BUMA.1121.00075,1,2448982,2460035,+,11053
350,BUMA.1121.00041,1,187299,198354,+,11055
350,BUMA.1121.00073,1,2893783,2904846,+,11063
350,BUMA.1121.00017,1,3097228,3108256,-,11028
350,BUMA.1121.00066,1,2869309,2880343,+,11034
350,BUMA.1121.00107,1,2895388,2906451,+,11063
350,BUMA.1121.00085,1,2580902,2591930,+,11028
350,BUMA.1121.00030,1,3097296,3108324,-,11028
350,BUMA.1121.00112,1,4106775,4117828,-,11053
350,BUMA.1121.00002,1,1967374,1978402,-,11028
350,BUMA.1121.00082,1,3053157,3064220,+,11063
350,BUMA.1121.00014,1,3954507,3965570,-,11063
350,BUMA.1121.00011,1,2686726,2697784,-,11058
350,BUMA.1121.00019,1,3120544,3131572,-,11028
350,BUMA.1121.00057,1,60829,71892,+,11063
350,BUMA.1121.00018,1,3547703,3558766,+,11063
350,BUMA.1121.00039,1,3095365,3106428,+,11063
350,BUMA.1121.00016,1,1068714,1079777,+,11063
350,BUMA.1121.00004,1,3249451,3260479,-,11028
350,BUMA.1121.00005,1,1669353,1680402,+,11049
350,BUMA.1121.00100,1,2364683,2375754,-,11071
350,BUMA.1121.00006,1,478334,489352,+,11018
351,BUMA.1121.00027,1,1158787,1168795,+,10008
351,BUMA.1121.00025,1,3839289,3849296,-,10007
351,BUMA.1121.00021,1,3568016,3578024,+,10008
351,BUMA.1121.00023,1,1288314,1298321,+,10007
351,BUMA.1121.00024,1,3086237,3096244,-,10007
351,BUMA.1121.00033,1,1170363,1180371,+,10008
351,BUMA.1121.00034,1,3187789,3197796,-,10007
351,BUMA.1121.00036,1,2642409,2652426,+,10017
351,BUMA.1121.00032,1,1210911,1220918,-,10007
351,BUMA.1121.00009,1,2595600,2605606,-,10006
351,BUMA.1121.00008,1,3169043,3179050,-,10007
351,BUMA.1121.00003,1,1458063,1468057,+,9994
351,BUMA.1121.00109,1,2935240,2945237,-,9997
351,BUMA.1121.00053,1,2730666,2740673,+,10007
351,BUMA.1121.00110,1,1843041,1853046,-,10005
351,BUMA.1121.00104,1,2270895,2280901,-,10006
351,BUMA.1121.00086,1,148597,158613,-,10016
351,BUMA.1121.00092,1,805424,815420,-,9996
351,BUMA.1121.00096,1,301009,311003,-,9994
351,BUMA.1121.00054,1,131948,141955,-,10007
351,BUMA.1121.00097,1,952909,962916,-,10007
351,BUMA.1121.00093,1,3810687,3820684,+,9997
351,BUMA.1121.00106,1,2720026,2730034,+,10008
351,BUMA.1121.00010,1,1928747,1938754,-,10007
351,BUMA.1121.00035,1,303,10311,+,10008
351,BUMA.1121.00108,1,4005068,4015066,+,9998
351,BUMA.1121.00028,1,3157437,3167444,-,10007
351,BUMA.1121.00094,1,2953371,2963379,+,10008
351,BUMA.1121.00102,1,2314171,2324177,-,10006
351,BUMA.1121.00111,1,3139956,3149964,+,10008
351,BUMA.1121.00089,1,2924380,2934388,+,10008
351,BUMA.1121.00084,1,3334698,3344703,+,10005
351,BUMA.1121.00029,1,1992480,2002487,-,10007
351,BUMA.1121.00012,1,1721750,1731758,+,10008
351,BUMA.1121.00087,1,3160486,3170503,+,10017
351,BUMA.1121.00043,1,3053490,3063499,+,10009
351,BUMA.1121.00046,1,1980876,1990875,+,9999
351,BUMA.1121.00037,1,1571938,1581946,+,10008
351,BUMA.1121.00080,1,2968202,2978208,+,10006
351,BUMA.1121.00079,1,3002530,3012536,+,10006
351,BUMA.1121.00045,1,1085755,1095750,-,9995
351,BUMA.1121.00071,1,2897048,2907056,+,10008
351,BUMA.1121.00056,1,992458,1002465,-,10007
351,BUMA.1121.00065,1,3034379,3044386,+,10007
351,BUMA.1121.00058,1,1549077,1559084,-,10007
351,BUMA.1121.00007,1,1083978,1093976,-,9998
351,BUMA.1121.00067,1,1444311,1454315,-,10004
351,BUMA.1121.00090,1,1044827,1054835,+,10008
351,BUMA.1121.00051,1,2936438,2946444,+,10006
351,BUMA.1121.00020,1,3222257,3232264,-,10007
351,BUMA.1121.00103,1,1393124,1403121,-,9997
351,BUMA.1121.00048,1,283645,293653,+,10008
351,BUMA.1121.00047,1,4049392,4059399,-,10007
351,BUMA.1121.00042,1,1077734,1087741,-,10007
351,BUMA.1121.00055,1,2649959,2659965,+,10006
351,BUMA.1121.00031,1,298035,308043,+,10008
351,BUMA.1121.00040,1,3236517,3246525,+,10008
351,BUMA.1121.00044,1,2415959,2425966,-,10007
351,BUMA.1121.00088,1,3942845,3952851,+,10006
351,BUMA.1121.00069,1,2877709,2887715,+,10006
351,BUMA.1121.00064,1,2974318,2984326,+,10008
351,BUMA.1121.00105,1,2223974,2233979,-,10005
351,BUMA.1121.00015,1,2479557,2489565,+,10008
351,BUMA.1121.00059,1,2197062,2207069,+,10007
351,BUMA.1121.00026,1,2157096,2167103,-,10007
351,BUMA.1121.00022,1,12884,22901,+,10017
351,BUMA.1121.00052,1,2996750,3006758,+,10008
351,BUMA.1121.00101,1,3473536,3483560,-,10024
351,BUMA.1121.00001,1,1108103,1118110,-,10007
351,BUMA.1121.00038,1,491118,501126,+,10008
351,BUMA.1121.00068,1,1751757,1761740,+,9983
351,BUMA.1121.00099,1,3438008,3447924,-,9916
351,BUMA.1121.00091,1,1531977,1541973,-,9996
351,BUMA.1121.00098,1,1627800,1637785,+,9985
351,BUMA.1121.00013,1,3288846,3298854,+,10008
351,BUMA.1121.00049,1,2841393,2851398,-,10005
351,BUMA.1121.00072,1,2879189,2889197,+,10008
351,BUMA.1121.00076,1,2340474,2350468,-,9994
351,BUMA.1121.00083,1,2703366,2713373,-,10007
351,BUMA.1121.00078,1,3027613,3037618,-,10005
351,BUMA.1121.00095,1,2740796,2750800,-,10004
351,BUMA.1121.00077,1,1630163,1640169,+,10006
351,BUMA.1121.00063,1,2905216,2915224,+,10008
351,BUMA.1121.00061,1,2908349,2918357,+,10008
351,BUMA.1121.00050,1,760823,770821,-,9998
351,BUMA.1121.00081,1,491187,501195,+,10008
351,BUMA.1121.00074,1,889946,899950,-,10004
351,BUMA.1121.00062,1,1578006,1588009,-,10003
351,BUMA.1121.00060,1,3330967,3340962,-,9995
351,BUMA.1121.00070,1,2879439,2889447,+,10008
351,BUMA.1121.00075,1,2461801,2471796,+,9995
351,BUMA.1121.00041,1,200127,210125,+,9998
351,BUMA.1121.00073,1,2906612,2916620,+,10008
351,BUMA.1121.00017,1,3085454,3095461,-,10007
351,BUMA.1121.00066,1,2882109,2892117,+,10008
351,BUMA.1121.00107,1,2908215,2918220,+,10005
351,BUMA.1121.00085,1,2593696,2603704,+,10008
351,BUMA.1121.00030,1,3085522,3095529,-,10007
351,BUMA.1121.00112,1,4095002,4105008,-,10006
351,BUMA.1121.00002,1,1955600,1965607,-,10007
351,BUMA.1121.00082,1,3065986,3075994,+,10008
351,BUMA.1121.00014,1,3942733,3952740,-,10007
351,BUMA.1121.00011,1,2674941,2684950,-,10009
351,BUMA.1121.00019,1,3108770,3118777,-,10007
351,BUMA.1121.00057,1,73658,83666,+,10008
351,BUMA.1121.00018,1,3560532,3570540,+,10008
351,BUMA.1121.00039,1,3108194,3118202,+,10008
351,BUMA.1121.00016,1,1081543,1091550,+,10007
351,BUMA.1121.00004,1,3237677,3247684,-,10007
351,BUMA.1121.00005,1,1682168,1692166,+,9998
351,BUMA.1121.00100,1,2352918,2362916,-,9998
351,BUMA.1121.00006,1,491118,501126,+,10008
352,BUMA.1121.00027,1,1172558,1177932,+,5374
352,BUMA.1121.00025,1,3830193,3835569,-,5376
352,BUMA.1121.00021,1,3581814,3587191,+,5377
352,BUMA.1121.00023,1,1302098,1307475,+,5377
352,BUMA.1121.00024,1,3075791,3081167,-,5376
352,BUMA.1121.00033,1,1184134,1189511,+,5377
352,BUMA.1121.00036,1,2657495,2662872,+,5377
352,BUMA.1121.00032,1,1200465,1205841,-,5376
352,BUMA.1121.00009,1,2586458,2591834,-,5376
352,BUMA.1121.00008,1,3158597,3163973,-,5376
352,BUMA.1121.00003,1,1471843,1477218,+,5375
352,BUMA.1121.00109,1,2926167,2931532,-,5365
352,BUMA.1121.00053,1,2744437,2749814,+,5377
352,BUMA.1121.00110,1,1833885,1839261,-,5376
352,BUMA.1121.00104,1,2261755,2267131,-,5376
352,BUMA.1121.00086,1,138151,143527,-,5376
352,BUMA.1121.00092,1,796289,801665,-,5376
352,BUMA.1121.00096,1,291858,297234,-,5376
352,BUMA.1121.00054,1,121502,126878,-,5376
352,BUMA.1121.00097,1,943769,949145,-,5376
352,BUMA.1121.00093,1,3824442,3829819,+,5377
352,BUMA.1121.00106,1,2733799,2739176,+,5377
352,BUMA.1121.00010,1,1918301,1923677,-,5376
352,BUMA.1121.00035,1,14075,19452,+,5377
352,BUMA.1121.00108,1,4018849,4024226,+,5377
352,BUMA.1121.00028,1,3146991,3152367,-,5376
352,BUMA.1121.00094,1,2967142,2972519,+,5377
352,BUMA.1121.00102,1,2305030,2310406,-,5376
352,BUMA.1121.00111,1,3153728,3159105,+,5377
352,BUMA.1121.00089,1,2938151,2943528,+,5377
352,BUMA.1121.00084,1,3348469,3353846,+,5377
352,BUMA.1121.00029,1,1983340,1988715,-,5375
352,BUMA.1121.00012,1,1735534,1740911,+,5377
352,BUMA.1121.00087,1,3175572,3180949,+,5377
352,BUMA.1121.00043,1,3067263,3072640,+,5377
352,BUMA.1121.00046,1,1995944,2001321,+,5377
352,BUMA.1121.00037,1,1585749,1591126,+,5377
352,BUMA.1121.00080,1,2981972,2987349,+,5377
352,BUMA.1121.00079,1,3016300,3021677,+,5377
352,BUMA.1121.00045,1,1076626,1082002,-,5376
352,BUMA.1121.00071,1,2910818,2916193,+,5375
352,BUMA.1121.00056,1,983318,988694,-,5376
352,BUMA.1121.00065,1,3048150,3053527,+,5377
352,BUMA.1121.00058,1,1539950,1545326,-,5376
352,BUMA.1121.00007,1,1073534,1078910,-,5376
352,BUMA.1121.00067,1,1435168,1440544,-,5376
352,BUMA.1121.00090,1,1058625,1064002,+,5377
352,BUMA.1121.00051,1,2950208,2955585,+,5377
352,BUMA.1121.00020,1,3211811,3217187,-,5376
352,BUMA.1121.00103,1,1383999,1389347,-,5348
352,BUMA.1121.00048,1,298720,304097,+,5377
352,BUMA.1121.00047,1,4040252,4045628,-,5376
352,BUMA.1121.00042,1,1068602,1073977,-,5375
352,BUMA.1121.00055,1,2663715,2669092,+,5377
352,BUMA.1121.00031,1,311807,317184,+,5377
352,BUMA.1121.00040,1,3251594,3256971,+,5377
352,BUMA.1121.00088,1,3956601,3961978,+,5377
352,BUMA.1121.00069,1,2891478,2896853,+,5375
352,BUMA.1121.00064,1,2988090,2993467,+,5377
352,BUMA.1121.00105,1,2214831,2220207,-,5376
352,BUMA.1121.00059,1,2210832,2216209,+,5377
352,BUMA.1121.00026,1,2147964,2153339,-,5375
352,BUMA.1121.00022,1,27961,33338,+,5377
352,BUMA.1121.00052,1,3011827,3017204,+,5377
352,BUMA.1121.00101,1,3464406,3469782,-,5376
352,BUMA.1121.00001,1,1098962,1104338,-,5376
352,BUMA.1121.00038,1,506195,511572,+,5377
352,BUMA.1121.00068,1,1765492,1770872,+,5380
352,BUMA.1121.00099,1,3428866,3434242,-,5376
352,BUMA.1121.00091,1,1522837,1528213,-,5376
352,BUMA.1121.00098,1,1641535,1646912,+,5377
352,BUMA.1121.00013,1,3303923,3309300,+,5377
352,BUMA.1121.00049,1,2832253,2837629,-,5376
352,BUMA.1121.00072,1,2892960,2898335,+,5375
352,BUMA.1121.00076,1,2331334,2336710,-,5376
352,BUMA.1121.00083,1,2694228,2699602,-,5374
352,BUMA.1121.00078,1,3018471,3023847,-,5376
352,BUMA.1121.00095,1,2730432,2735808,-,5376
352,BUMA.1121.00077,1,1643948,1649327,+,5379
352,BUMA.1121.00063,1,2918987,2924362,+,5375
352,BUMA.1121.00061,1,2922120,2927495,+,5375
352,BUMA.1121.00050,1,750377,755753,-,5376
352,BUMA.1121.00081,1,506264,511641,+,5377
352,BUMA.1121.00074,1,880803,886179,-,5376
352,BUMA.1121.00062,1,1568863,1574239,-,5376
352,BUMA.1121.00060,1,3321838,3327214,-,5376
352,BUMA.1121.00070,1,2893210,2898585,+,5375
352,BUMA.1121.00075,1,2475559,2480936,+,5377
352,BUMA.1121.00041,1,213888,219265,+,5377
352,BUMA.1121.00073,1,2920383,2925758,+,5375
352,BUMA.1121.00066,1,2895880,2901255,+,5375
352,BUMA.1121.00107,1,2921962,2927337,+,5375
352,BUMA.1121.00085,1,2608773,2614150,+,5377
352,BUMA.1121.00112,1,4085863,4091239,-,5376
352,BUMA.1121.00002,1,1945154,1950530,-,5376
352,BUMA.1121.00082,1,3079757,3085132,+,5375
352,BUMA.1121.00014,1,3933592,3938968,-,5376
352,BUMA.1121.00011,1,2665799,2671175,-,5376
352,BUMA.1121.00019,1,3098324,3103700,-,5376
352,BUMA.1121.00057,1,87429,92806,+,5377
352,BUMA.1121.00018,1,3574259,3579636,+,5377
352,BUMA.1121.00039,1,3121992,3127369,+,5377
352,BUMA.1121.00016,1,1096655,1102032,+,5377
352,BUMA.1121.00004,1,3227231,3232607,-,5376
352,BUMA.1121.00005,1,1695937,1701312,+,5375
352,BUMA.1121.00100,1,2343839,2349215,-,5376
352,BUMA.1121.00006,1,506195,511572,+,5377
353,BUMA.1121.00027,1,1184873,1188874,+,4001
353,BUMA.1121.00025,1,3817659,3821660,-,4001
353,BUMA.1121.00021,1,3595722,3599723,+,4001
353,BUMA.1121.00023,1,1316006,1320007,+,4001
353,BUMA.1121.00024,1,1445826,1449827,-,4001
353,BUMA.1121.00033,1,1198042,1202043,+,4001
353,BUMA.1121.00034,1,1483220,1487221,-,4001
353,BUMA.1121.00036,1,862205,866206,-,4001
353,BUMA.1121.00032,1,2976290,2980291,-,4001
353,BUMA.1121.00009,1,2575520,2579521,-,4001
353,BUMA.1121.00008,1,1449576,1453577,-,4001
353,BUMA.1121.00003,1,1484158,1488159,+,4001
353,BUMA.1121.00109,1,2915217,2919218,-,4001
353,BUMA.1121.00053,1,2756754,2760755,+,4001
353,BUMA.1121.00110,1,1821347,1825348,-,4001
353,BUMA.1121.00104,1,2250817,2254818,-,4001
353,BUMA.1121.00086,1,1936417,1940418,+,4001
353,BUMA.1121.00092,1,785347,789348,-,4001
353,BUMA.1121.00096,1,280920,284921,-,4001
353,BUMA.1121.00054,1,1951973,1955974,-,4001
353,BUMA.1121.00097,1,932827,936828,-,4001
353,BUMA.1121.00093,1,3836759,3840760,+,4001
353,BUMA.1121.00106,1,2746113,2750114,+,4001
353,BUMA.1121.00010,1,2566922,2570923,-,4001
353,BUMA.1121.00035,1,27983,31984,+,4001
353,BUMA.1121.00108,1,40,4056,+,4016
353,BUMA.1121.00028,1,1445875,1449876,-,4001
353,BUMA.1121.00094,1,2979459,2983460,+,4001
353,BUMA.1121.00102,1,2294092,2298093,-,4001
353,BUMA.1121.00111,1,3167639,3171640,+,4001
353,BUMA.1121.00089,1,2950469,2954470,+,4001
353,BUMA.1121.00084,1,3360787,3364788,+,4001
353,BUMA.1121.00029,1,1970807,1974808,-,4001
353,BUMA.1121.00012,1,1749442,1753443,+,4001
353,BUMA.1121.00087,1,1376638,1380639,-,4001
353,BUMA.1121.00043,1,3081171,3085172,+,4001
353,BUMA.1121.00046,1,240133,244134,+,4001
353,BUMA.1121.00037,1,1599657,1603658,+,4001
353,BUMA.1121.00080,1,2994290,2998291,+,4001
353,BUMA.1121.00079,1,3028618,3032619,+,4001
353,BUMA.1121.00045,1,1065687,1069688,-,4001
353,BUMA.1121.00071,1,2923134,2927135,+,4001
353,BUMA.1121.00056,1,972375,976376,-,4001
353,BUMA.1121.00065,1,3060463,3064464,+,4001
353,BUMA.1121.00058,1,1529007,1533008,-,4001
353,BUMA.1121.00007,1,1060997,1064998,-,4001
353,BUMA.1121.00067,1,1424229,1428230,-,4001
353,BUMA.1121.00090,1,1072533,1076534,+,4001
353,BUMA.1121.00051,1,2962526,2966527,+,4001
353,BUMA.1121.00020,1,1510789,1514790,-,4001
353,BUMA.1121.00103,1,1373058,1377059,-,4001
353,BUMA.1121.00048,1,1979761,1983762,+,4001
353,BUMA.1121.00047,1,4029313,4033314,-,4001
353,BUMA.1121.00042,1,1054077,1058078,-,4001
353,BUMA.1121.00055,1,2676028,2680029,+,4001
353,BUMA.1121.00031,1,325715,329716,+,4001
353,BUMA.1121.00040,1,1373368,1377369,-,4001
353,BUMA.1121.00044,1,711326,715327,-,4001
353,BUMA.1121.00088,1,3968919,3972920,+,4001
353,BUMA.1121.00069,1,2903793,2907794,+,4001
353,BUMA.1121.00064,1,3000408,3004409,+,4001
353,BUMA.1121.00105,1,2203892,2207893,-,4001
353,BUMA.1121.00015,1,855744,859745,-,4001
353,BUMA.1121.00059,1,2223146,2227147,+,4001
353,BUMA.1121.00026,1,2133282,2137283,-,4001
353,BUMA.1121.00022,1,1708380,1712381,-,4001
353,BUMA.1121.00052,1,1221721,1225722,-,4001
353,BUMA.1121.00101,1,3453466,3457467,-,4001
353,BUMA.1121.00001,1,1086429,1090430,-,4001
353,BUMA.1121.00038,1,2187177,2191178,+,4001
353,BUMA.1121.00068,1,1777811,1781812,+,4001
353,BUMA.1121.00099,1,3417928,3421929,-,4001
353,BUMA.1121.00091,1,1510299,1514300,-,4001
353,BUMA.1121.00098,1,1653852,1657853,+,4001
353,BUMA.1121.00013,1,1417946,1421947,-,4001
353,BUMA.1121.00049,1,2821314,2825315,-,4001
353,BUMA.1121.00072,1,2905275,2909276,+,4001
353,BUMA.1121.00076,1,2318799,2322800,-,4001
353,BUMA.1121.00083,1,2683285,2687286,-,4001
353,BUMA.1121.00078,1,3007532,3011533,-,4001
353,BUMA.1121.00095,1,2717926,2721927,-,4001
353,BUMA.1121.00077,1,1657864,1661865,+,4001
353,BUMA.1121.00063,1,2931302,2935303,+,4001
353,BUMA.1121.00061,1,2934436,2938437,+,4001
353,BUMA.1121.00050,1,2507731,2511732,-,4001
353,BUMA.1121.00081,1,2187303,2191304,+,4001
353,BUMA.1121.00074,1,869864,873865,-,4001
353,BUMA.1121.00062,1,1557920,1561921,-,4001
353,BUMA.1121.00060,1,3310899,3314900,-,4001
353,BUMA.1121.00070,1,2905525,2909526,+,4001
353,BUMA.1121.00075,1,2489469,2493470,+,4001
353,BUMA.1121.00041,1,227799,231800,+,4001
353,BUMA.1121.00073,1,2932698,2936699,+,4001
353,BUMA.1121.00017,1,1380857,1384858,-,4001
353,BUMA.1121.00066,1,2908195,2912196,+,4001
353,BUMA.1121.00107,1,2935873,2939874,+,4001
353,BUMA.1121.00085,1,818556,822557,-,4001
353,BUMA.1121.00030,1,1380910,1384911,-,4001
353,BUMA.1121.00112,1,4074921,4078922,-,4001
353,BUMA.1121.00002,1,2589983,2593984,-,4001
353,BUMA.1121.00082,1,3092073,3096074,+,4001
353,BUMA.1121.00014,1,3921059,3925060,-,4001
353,BUMA.1121.00011,1,2654858,2658859,-,4001
353,BUMA.1121.00019,1,1445922,1449923,-,4001
353,BUMA.1121.00057,1,99747,103748,+,4001
353,BUMA.1121.00018,1,3588168,3592169,+,4001
353,BUMA.1121.00039,1,3135900,3139901,+,4001
353,BUMA.1121.00016,1,1110562,1114563,+,4001
353,BUMA.1121.00004,1,1447032,1451033,-,4001
353,BUMA.1121.00005,1,1711159,1715160,+,4001
353,BUMA.1121.00100,1,2331550,2335551,-,4001
353,BUMA.1121.00006,1,2187085,2191086,+,4001
354,BUMA.1121.00027,1,1190355,1201778,+,11423
354,BUMA.1121.00025,1,3804759,3816179,-,11420
354,BUMA.1121.00021,1,3601204,3612635,+,11431
354,BUMA.1121.00023,1,1321488,1332920,+,11432
354,BUMA.1121.00024,1,1432919,1444335,-,11416
354,BUMA.1121.00033,1,1203524,1214955,+,11431
354,BUMA.1121.00034,1,1470313,1481729,-,11416
354,BUMA.1121.00036,1,849298,860714,-,11416
354,BUMA.1121.00032,1,2963383,2974799,-,11416
354,BUMA.1121.00009,1,2562600,2574040,-,11440
354,BUMA.1121.00008,1,1436669,1448085,-,11416
354,BUMA.1121.00003,1,1489640,1501064,+,11424
354,BUMA.1121.00109,1,2902313,2913738,-,11425
354,BUMA.1121.00053,1,2762236,2773659,+,11423
354,BUMA.1121.00110,1,1808426,1819868,-,11442
354,BUMA.1121.00104,1,2237903,2249337,-,11434
354,BUMA.1121.00086,1,1941910,1953345,+,11435
354,BUMA.1121.00092,1,772423,783867,-,11444
354,BUMA.1121.00096,1,267989,279440,-,11451
354,BUMA.1121.00054,1,1939054,1950470,-,11416
354,BUMA.1121.00097,1,919923,931348,-,11425
354,BUMA.1121.00093,1,3842241,3853684,+,11443
354,BUMA.1121.00106,1,2751595,2763028,+,11433
354,BUMA.1121.00010,1,2554029,2565431,-,11402
354,BUMA.1121.00035,1,33465,44888,+,11423
354,BUMA.1121.00108,1,5536,16989,+,11453
354,BUMA.1121.00028,1,1432968,1444384,-,11416
354,BUMA.1121.00094,1,2984941,2996370,+,11429
354,BUMA.1121.00102,1,2281179,2292613,-,11434
354,BUMA.1121.00111,1,3173121,3184563,+,11442
354,BUMA.1121.00089,1,2955951,2967380,+,11429
354,BUMA.1121.00084,1,3366269,3377692,+,11423
354,BUMA.1121.00029,1,1957889,1969327,-,11438
354,BUMA.1121.00012,1,1754924,1766359,+,11435
354,BUMA.1121.00087,1,1363711,1375147,-,11436
354,BUMA.1121.00043,1,3115081,3126522,+,11441
354,BUMA.1121.00046,1,245650,257065,+,11415
354,BUMA.1121.00037,1,1605139,1616570,+,11431
354,BUMA.1121.00080,1,2999772,3011201,+,11429
354,BUMA.1121.00079,1,3034100,3045527,+,11427
354,BUMA.1121.00045,1,1052779,1064207,-,11428
354,BUMA.1121.00071,1,2928630,2940059,+,11429
354,BUMA.1121.00056,1,959465,970895,-,11430
354,BUMA.1121.00065,1,3065945,3077370,+,11425
354,BUMA.1121.00058,1,1516069,1527527,-,11458
354,BUMA.1121.00007,1,1048078,1059517,-,11439
354,BUMA.1121.00067,1,1411325,1422749,-,11424
354,BUMA.1121.00090,1,1078015,1089445,+,11430
354,BUMA.1121.00051,1,2968008,2979436,+,11428
354,BUMA.1121.00020,1,1497882,1509298,-,11416
354,BUMA.1121.00103,1,1360138,1371579,-,11441
354,BUMA.1121.00048,1,1985266,1996681,+,11415
354,BUMA.1121.00047,1,4016417,4027833,-,11416
354,BUMA.1121.00042,1,1041180,1052586,-,11406
354,BUMA.1121.00055,1,2681510,2692927,+,11417
354,BUMA.1121.00031,1,331197,342568,+,11371
354,BUMA.1121.00040,1,1360459,1371865,-,11406
354,BUMA.1121.00044,1,698419,709835,-,11416
354,BUMA.1121.00088,1,3974401,3985830,+,11429
354,BUMA.1121.00069,1,2909289,2920718,+,11429
354,BUMA.1121.00064,1,3005890,3017313,+,11423
354,BUMA.1121.00105,1,2190972,2202412,-,11440
354,BUMA.1121.00015,1,842789,854205,-,11416
354,BUMA.1121.00059,1,2228628,2240067,+,11439
354,BUMA.1121.00026,1,2120369,2131791,-,11422
354,BUMA.1121.00022,1,1695453,1706889,-,11436
354,BUMA.1121.00052,1,1208776,1220182,-,11406
354,BUMA.1121.00101,1,3440544,3451986,-,11442
354,BUMA.1121.00001,1,1073526,1084949,-,11423
354,BUMA.1121.00038,1,2192682,2204097,+,11415
354,BUMA.1121.00068,1,1783292,1794721,+,11429
354,BUMA.1121.00099,1,3405018,3416448,-,11430
354,BUMA.1121.00091,1,1497404,1508819,-,11415
354,BUMA.1121.00098,1,1659334,1670777,+,11443
354,BUMA.1121.00013,1,1405013,1416419,-,11406
354,BUMA.1121.00049,1,2808398,2819834,-,11436
354,BUMA.1121.00072,1,2910771,2922200,+,11429
354,BUMA.1121.00076,1,2305890,2317320,-,11430
354,BUMA.1121.00083,1,2660579,2672009,-,11430
354,BUMA.1121.00078,1,2994614,3006053,-,11439
354,BUMA.1121.00095,1,2705005,2716447,-,11442
354,BUMA.1121.00077,1,1663345,1674784,+,11439
354,BUMA.1121.00063,1,2936798,2948227,+,11429
354,BUMA.1121.00061,1,2939933,2951362,+,11429
354,BUMA.1121.00050,1,2494800,2506216,-,11416
354,BUMA.1121.00081,1,2192808,2204223,+,11415
354,BUMA.1121.00074,1,856960,868384,-,11424
354,BUMA.1121.00062,1,1545000,1556440,-,11440
354,BUMA.1121.00060,1,3297991,3309419,-,11428
354,BUMA.1121.00070,1,2911022,2922451,+,11429
354,BUMA.1121.00075,1,2494950,2506378,+,11428
354,BUMA.1121.00041,1,233280,244708,+,11428
354,BUMA.1121.00073,1,2938194,2949623,+,11429
354,BUMA.1121.00017,1,1367950,1379366,-,11416
354,BUMA.1121.00066,1,2913691,2925120,+,11429
354,BUMA.1121.00107,1,2941354,2952794,+,11440
354,BUMA.1121.00085,1,805611,817017,-,11406
354,BUMA.1121.00030,1,1368003,1379419,-,11416
354,BUMA.1121.00112,1,4062009,4073441,-,11432
354,BUMA.1121.00002,1,2577090,2588492,-,11402
354,BUMA.1121.00082,1,3107351,3118780,+,11429
354,BUMA.1121.00014,1,3908207,3919579,-,11372
354,BUMA.1121.00011,1,2641963,2653379,-,11416
354,BUMA.1121.00019,1,1433015,1444431,-,11416
354,BUMA.1121.00057,1,105229,116668,+,11439
354,BUMA.1121.00018,1,3593650,3605069,+,11419
354,BUMA.1121.00039,1,3141382,3152813,+,11431
354,BUMA.1121.00016,1,1116044,1127486,+,11442
354,BUMA.1121.00004,1,1434125,1445541,-,11416
354,BUMA.1121.00005,1,1716640,1728058,+,11418
354,BUMA.1121.00100,1,2318630,2330070,-,11440
354,BUMA.1121.00006,1,2192590,2204005,+,11415
355,BUMA.1121.00027,1,1202110,1206436,+,4326
355,BUMA.1121.00025,1,3759383,3763734,-,4351
355,BUMA.1121.00021,1,3660415,3664754,+,4339
355,BUMA.1121.00023,1,1333252,1337587,+,4335
355,BUMA.1121.00024,1,1428250,1432588,-,4338
355,BUMA.1121.00033,1,1215287,1219610,+,4323
355,BUMA.1121.00034,1,1465644,1469982,-,4338
355,BUMA.1121.00036,1,844629,848967,-,4338
355,BUMA.1121.00032,1,2958714,2963052,-,4338
355,BUMA.1121.00009,1,2557931,2562269,-,4338
355,BUMA.1121.00008,1,1432000,1436338,-,4338
355,BUMA.1121.00003,1,1511431,1515751,+,4320
355,BUMA.1121.00109,1,2897644,2901982,-,4338
355,BUMA.1121.00053,1,2773991,2778314,+,4323
355,BUMA.1121.00110,1,1803757,1808095,-,4338
355,BUMA.1121.00104,1,2233245,2237572,-,4327
355,BUMA.1121.00086,1,1953677,1958014,+,4337
355,BUMA.1121.00092,1,767773,772092,-,4319
355,BUMA.1121.00096,1,263326,267658,-,4332
355,BUMA.1121.00054,1,1934385,1938723,-,4338
355,BUMA.1121.00097,1,915260,919592,-,4332
355,BUMA.1121.00093,1,3854016,3858334,+,4318
355,BUMA.1121.00106,1,2763360,2767686,+,4326
355,BUMA.1121.00010,1,2549360,2553698,-,4338
355,BUMA.1121.00035,1,54185,58524,+,4339
355,BUMA.1121.00108,1,17321,21658,+,4337
355,BUMA.1121.00028,1,1428299,1432637,-,4338
355,BUMA.1121.00094,1,2996702,3001047,+,4345
355,BUMA.1121.00102,1,2276518,2280848,-,4330
355,BUMA.1121.00111,1,3184895,3189234,+,4339
355,BUMA.1121.00089,1,2967712,2972057,+,4345
355,BUMA.1121.00084,1,3378024,3382350,+,4326
355,BUMA.1121.00029,1,1916377,1920717,-,4340
355,BUMA.1121.00012,1,1766691,1771030,+,4339
355,BUMA.1121.00087,1,1359042,1363380,-,4338
355,BUMA.1121.00043,1,3126854,3131193,+,4339
355,BUMA.1121.00046,1,257397,261734,+,4337
355,BUMA.1121.00037,1,1616902,1621241,+,4339
355,BUMA.1121.00080,1,3028338,3032695,+,4357
355,BUMA.1121.00079,1,3062664,3067014,+,4350
355,BUMA.1121.00045,1,1048116,1052448,-,4332
355,BUMA.1121.00071,1,2940391,2944717,+,4326
355,BUMA.1121.00056,1,954788,959134,-,4346
355,BUMA.1121.00065,1,3077702,3082039,+,4337
355,BUMA.1121.00058,1,1511411,1515738,-,4327
355,BUMA.1121.00007,1,1043420,1047747,-,4327
355,BUMA.1121.00067,1,1406667,1410994,-,4327
355,BUMA.1121.00090,1,1089777,1094125,+,4348
355,BUMA.1121.00051,1,2979768,2984102,+,4334
355,BUMA.1121.00020,1,1493213,1497551,-,4338
355,BUMA.1121.00103,1,1355469,1359807,-,4338
355,BUMA.1121.00048,1,1997013,2001350,+,4337
355,BUMA.1121.00047,1,3996141,4000493,-,4352
355,BUMA.1121.00042,1,1036511,1040849,-,4338
355,BUMA.1121.00055,1,2693259,2697597,+,4338
355,BUMA.1121.00031,1,342900,347239,+,4339
355,BUMA.1121.00040,1,1355790,1360128,-,4338
355,BUMA.1121.00044,1,693750,698088,-,4338
355,BUMA.1121.00088,1,3986162,3990488,+,4326
355,BUMA.1121.00069,1,2921050,2925376,+,4326
355,BUMA.1121.00064,1,3017645,3021971,+,4326
355,BUMA.1121.00105,1,2186295,2190641,-,4346
355,BUMA.1121.00015,1,838120,842458,-,4338
355,BUMA.1121.00059,1,2240399,2244725,+,4326
355,BUMA.1121.00026,1,2115700,2120038,-,4338
355,BUMA.1121.00022,1,1690784,1695122,-,4338
355,BUMA.1121.00052,1,1204107,1208445,-,4338
355,BUMA.1121.00101,1,3435875,3440213,-,4338
355,BUMA.1121.00001,1,1048998,1053338,-,4340
355,BUMA.1121.00038,1,2204429,2208766,+,4337
355,BUMA.1121.00068,1,1808334,1812645,+,4311
355,BUMA.1121.00099,1,3400355,3404687,-,4332
355,BUMA.1121.00091,1,1492735,1497073,-,4338
355,BUMA.1121.00098,1,1671109,1675446,+,4337
355,BUMA.1121.00013,1,1400344,1404682,-,4338
355,BUMA.1121.00049,1,2803740,2808067,-,4327
355,BUMA.1121.00072,1,2922532,2926858,+,4326
355,BUMA.1121.00076,1,2301229,2305559,-,4330
355,BUMA.1121.00083,1,2655921,2660248,-,4327
355,BUMA.1121.00078,1,2989945,2994283,-,4338
355,BUMA.1121.00095,1,2700336,2704674,-,4338
355,BUMA.1121.00077,1,1675114,1679452,+,4338
355,BUMA.1121.00063,1,2948559,2952885,+,4326
355,BUMA.1121.00061,1,2951694,2956020,+,4326
355,BUMA.1121.00050,1,2490131,2494469,-,4338
355,BUMA.1121.00081,1,2204555,2208892,+,4337
355,BUMA.1121.00074,1,852302,856629,-,4327
355,BUMA.1121.00062,1,1540342,1544669,-,4327
355,BUMA.1121.00060,1,3293328,3297660,-,4332
355,BUMA.1121.00070,1,2922783,2927109,+,4326
355,BUMA.1121.00075,1,2506710,2511039,+,4329
355,BUMA.1121.00041,1,245040,249377,+,4337
355,BUMA.1121.00073,1,2949955,2954281,+,4326
355,BUMA.1121.00017,1,1363281,1367619,-,4338
355,BUMA.1121.00066,1,2925452,2929778,+,4326
355,BUMA.1121.00107,1,2953126,2957457,+,4331
355,BUMA.1121.00085,1,800942,805280,-,4338
355,BUMA.1121.00030,1,1363335,1367672,-,4337
355,BUMA.1121.00112,1,4057346,4061678,-,4332
355,BUMA.1121.00002,1,2572421,2576759,-,4338
355,BUMA.1121.00082,1,3119112,3123438,+,4326
355,BUMA.1121.00014,1,3903536,3907876,-,4340
355,BUMA.1121.00011,1,2637300,2641632,-,4332
355,BUMA.1121.00019,1,1428346,1432684,-,4338
355,BUMA.1121.00057,1,117000,121326,+,4326
355,BUMA.1121.00018,1,3646093,3650443,+,4350
355,BUMA.1121.00039,1,3153145,3157447,+,4302
355,BUMA.1121.00016,1,1127818,1132157,+,4339
355,BUMA.1121.00004,1,1429456,1433794,-,4338
355,BUMA.1121.00005,1,1728390,1732716,+,4326
355,BUMA.1121.00100,1,2300703,2305018,-,4315
355,BUMA.1121.00006,1,2204337,2208674,+,4337
356,BUMA.1121.00027,1,1207217,1231030,+,23813
356,BUMA.1121.00025,1,3734754,3758602,-,23848
356,BUMA.1121.00021,1,3665535,3689365,+,23830
356,BUMA.1121.00023,1,1338368,1362146,+,23778
356,BUMA.1121.00024,1,1403698,1427469,-,23771
356,BUMA.1121.00033,1,1220391,1244260,+,23869
356,BUMA.1121.00034,1,1441089,1464863,-,23774
356,BUMA.1121.00036,1,820028,843848,-,23820
356,BUMA.1121.00032,1,2934152,2957933,-,23781
356,BUMA.1121.00009,1,2533379,2557150,-,23771
356,BUMA.1121.00008,1,1407449,1431219,-,23770
356,BUMA.1121.00003,1,1516532,1540350,+,23818
356,BUMA.1121.00109,1,2873048,2896863,-,23815
356,BUMA.1121.00053,1,2779095,2802960,+,23865
356,BUMA.1121.00110,1,1779195,1802976,-,23781
356,BUMA.1121.00104,1,2208662,2232464,-,23802
356,BUMA.1121.00086,1,1958795,1982597,+,23802
356,BUMA.1121.00092,1,743160,766992,-,23832
356,BUMA.1121.00096,1,238753,262545,-,23792
356,BUMA.1121.00054,1,1909820,1933604,-,23784
356,BUMA.1121.00097,1,890646,914479,-,23833
356,BUMA.1121.00093,1,3859115,3882947,+,23832
356,BUMA.1121.00106,1,2768467,2792260,+,23793
356,BUMA.1121.00010,1,2524822,2548579,-,23757
356,BUMA.1121.00035,1,59305,83154,+,23849
356,BUMA.1121.00108,1,22439,46294,+,23855
356,BUMA.1121.00028,1,1403747,1427518,-,23771
356,BUMA.1121.00094,1,3001828,3025698,+,23870
356,BUMA.1121.00102,1,2251820,2275737,-,23917
356,BUMA.1121.00111,1,3190015,3213867,+,23852
356,BUMA.1121.00089,1,2972838,2996713,+,23875
356,BUMA.1121.00084,1,3383131,3406962,+,23831
356,BUMA.1121.00029,1,1891756,1915596,-,23840
356,BUMA.1121.00012,1,1771811,1795710,+,23899
356,BUMA.1121.00087,1,1334459,1358261,-,23802
356,BUMA.1121.00043,1,3131974,3155931,+,23957
356,BUMA.1121.00046,1,262515,286308,+,23793
356,BUMA.1121.00037,1,1622022,1645955,+,23933
356,BUMA.1121.00080,1,3033476,3057304,+,23828
356,BUMA.1121.00079,1,3067795,3091628,+,23833
356,BUMA.1121.00045,1,1023493,1047335,-,23842
356,BUMA.1121.00071,1,2945498,2969344,+,23846
356,BUMA.1121.00056,1,930132,954007,-,23875
356,BUMA.1121.00065,1,3082820,3106700,+,23880
356,BUMA.1121.00058,1,1486777,1510630,-,23853
356,BUMA.1121.00007,1,1018791,1042639,-,23848
356,BUMA.1121.00067,1,1381998,1405886,-,23888
356,BUMA.1121.00090,1,1094906,1118794,+,23888
356,BUMA.1121.00051,1,2984883,3008711,+,23828
356,BUMA.1121.00020,1,1468661,1492432,-,23771
356,BUMA.1121.00103,1,1330802,1354688,-,23886
356,BUMA.1121.00048,1,2002131,2025915,+,23784
356,BUMA.1121.00047,1,3971532,3995360,-,23828
356,BUMA.1121.00042,1,1011946,1035730,-,23784
356,BUMA.1121.00055,1,2698378,2722185,+,23807
356,BUMA.1121.00031,1,348020,371970,+,23950
356,BUMA.1121.00040,1,1331198,1355009,-,23811
356,BUMA.1121.00044,1,669195,692969,-,23774
356,BUMA.1121.00088,1,3991269,4015071,+,23802
356,BUMA.1121.00069,1,2926157,2949996,+,23839
356,BUMA.1121.00064,1,3022752,3046563,+,23811
356,BUMA.1121.00105,1,2161662,2185514,-,23852
356,BUMA.1121.00015,1,813537,837339,-,23802
356,BUMA.1121.00059,1,2245506,2269335,+,23829
356,BUMA.1121.00026,1,2091153,2114919,-,23766
356,BUMA.1121.00022,1,1666192,1690003,-,23811
356,BUMA.1121.00052,1,1179560,1203326,-,23766
356,BUMA.1121.00101,1,3411291,3435094,-,23803
356,BUMA.1121.00001,1,1024387,1048217,-,23830
356,BUMA.1121.00038,1,2209547,2233331,+,23784
356,BUMA.1121.00068,1,1813426,1837242,+,23816
356,BUMA.1121.00099,1,3375734,3399574,-,23840
356,BUMA.1121.00091,1,1468141,1491954,-,23813
356,BUMA.1121.00098,1,1676227,1700092,+,23865
356,BUMA.1121.00013,1,1375806,1399563,-,23757
356,BUMA.1121.00049,1,2779166,2802959,-,23793
356,BUMA.1121.00072,1,2927639,2951482,+,23843
356,BUMA.1121.00076,1,2276595,2300448,-,23853
356,BUMA.1121.00083,1,2631285,2655140,-,23855
356,BUMA.1121.00078,1,2965341,2989164,-,23823
356,BUMA.1121.00095,1,2675644,2699555,-,23911
356,BUMA.1121.00077,1,1680233,1704015,+,23782
356,BUMA.1121.00063,1,2953666,2977509,+,23843
356,BUMA.1121.00061,1,2956801,2980644,+,23843
356,BUMA.1121.00050,1,2465557,2489350,-,23793
356,BUMA.1121.00081,1,2209673,2233457,+,23784
356,BUMA.1121.00074,1,827669,851521,-,23852
356,BUMA.1121.00062,1,1515676,1539561,-,23885
356,BUMA.1121.00060,1,3268705,3292547,-,23842
356,BUMA.1121.00070,1,2927890,2951732,+,23842
356,BUMA.1121.00075,1,2511820,2535674,+,23854
356,BUMA.1121.00041,1,250158,273998,+,23840
356,BUMA.1121.00073,1,2955062,2978905,+,23843
356,BUMA.1121.00017,1,1338726,1362500,-,23774
356,BUMA.1121.00066,1,2930559,2954399,+,23840
356,BUMA.1121.00107,1,2958238,2982065,+,23827
356,BUMA.1121.00085,1,776395,800161,-,23766
356,BUMA.1121.00030,1,1338780,1362554,-,23774
356,BUMA.1121.00112,1,4032707,4056565,-,23858
356,BUMA.1121.00002,1,2547883,2571640,-,23757
356,BUMA.1121.00082,1,3124219,3148074,+,23855
356,BUMA.1121.00014,1,3878806,3902755,-,23949
356,BUMA.1121.00011,1,2612667,2636519,-,23852
356,BUMA.1121.00019,1,1403794,1427565,-,23771
356,BUMA.1121.00057,1,122107,145927,+,23820
356,BUMA.1121.00018,1,3651224,3675063,+,23839
356,BUMA.1121.00039,1,3158228,3182075,+,23847
356,BUMA.1121.00016,1,1132938,1156788,+,23850
356,BUMA.1121.00004,1,1404961,1428675,-,23714
356,BUMA.1121.00005,1,1733497,1757301,+,23804
356,BUMA.1121.00100,1,2276077,2299922,-,23845
356,BUMA.1121.00006,1,2209455,2233239,+,23784
357,BUMA.1121.00027,1,1233990,1241253,+,7263
357,BUMA.1121.00025,1,3724509,3731796,-,7287
357,BUMA.1121.00021,1,3692324,3699705,+,7381
357,BUMA.1121.00023,1,1365105,1372349,+,7244
357,BUMA.1121.00024,1,1393542,1400740,-,7198
357,BUMA.1121.00033,1,1247219,1254483,+,7264
357,BUMA.1121.00034,1,1430933,1438131,-,7198
357,BUMA.1121.00036,1,809740,817070,-,7330
357,BUMA.1121.00032,1,2923996,2931194,-,7198
357,BUMA.1121.00009,1,2523141,2530421,-,7280
357,BUMA.1121.00008,1,1397293,1404491,-,7198
357,BUMA.1121.00003,1,1543309,1550605,+,7296
357,BUMA.1121.00109,1,2862844,2870105,-,7261
357,BUMA.1121.00053,1,2805920,2813208,+,7288
357,BUMA.1121.00110,1,1768990,1776231,-,7241
357,BUMA.1121.00104,1,2198444,2205703,-,7259
357,BUMA.1121.00086,1,1985556,1992843,+,7287
357,BUMA.1121.00092,1,732897,740202,-,7305
357,BUMA.1121.00096,1,228525,235795,-,7270
357,BUMA.1121.00054,1,1899568,1906862,-,7294
357,BUMA.1121.00097,1,880393,887688,-,7295
357,BUMA.1121.00093,1,3885906,3893222,+,7316
357,BUMA.1121.00106,1,2795220,2802435,+,7215
357,BUMA.1121.00010,1,2514624,2521864,-,7240
357,BUMA.1121.00035,1,86113,93461,+,7348
357,BUMA.1121.00108,1,49253,56541,+,7288
357,BUMA.1121.00028,1,1393591,1400789,-,7198
357,BUMA.1121.00094,1,3028657,3035901,+,7244
357,BUMA.1121.00102,1,2241522,2248862,-,7340
357,BUMA.1121.00111,1,3216826,3224083,+,7257
357,BUMA.1121.00089,1,2999672,3006928,+,7256
357,BUMA.1121.00084,1,3409921,3417213,+,7292
357,BUMA.1121.00029,1,1881520,1888798,-,7278
357,BUMA.1121.00012,1,1798669,1805925,+,7256
357,BUMA.1121.00087,1,1324213,1331501,-,7288
357,BUMA.1121.00043,1,3158890,3166116,+,7226
357,BUMA.1121.00046,1,289267,296464,+,7197
357,BUMA.1121.00037,1,1648914,1656223,+,7309
357,BUMA.1121.00080,1,3060263,3067589,+,7326
357,BUMA.1121.00079,1,3094588,3101848,+,7260
357,BUMA.1121.00045,1,1013258,1020535,-,7277
357,BUMA.1121.00071,1,2972303,2979554,+,7251
357,BUMA.1121.00056,1,919917,927174,-,7257
357,BUMA.1121.00065,1,3109660,3116910,+,7250
357,BUMA.1121.00058,1,1476548,1483818,-,7270
357,BUMA.1121.00007,1,1008574,1015832,-,7258
357,BUMA.1121.00067,1,1371785,1379039,-,7254
357,BUMA.1121.00090,1,1121753,1129048,+,7295
357,BUMA.1121.00051,1,3011670,3018944,+,7274
357,BUMA.1121.00020,1,1458505,1465703,-,7198
357,BUMA.1121.00103,1,1317622,1324884,-,7262
357,BUMA.1121.00048,1,2028874,2036173,+,7299
357,BUMA.1121.00047,1,3961317,3968574,-,7257
357,BUMA.1121.00042,1,1001676,1008988,-,7312
357,BUMA.1121.00055,1,2725144,2732359,+,7215
357,BUMA.1121.00031,1,374929,382197,+,7268
357,BUMA.1121.00040,1,1320982,1328240,-,7258
357,BUMA.1121.00044,1,659039,666237,-,7198
357,BUMA.1121.00088,1,4018031,4025247,+,7216
357,BUMA.1121.00069,1,2952956,2960213,+,7257
357,BUMA.1121.00064,1,3049523,3056822,+,7299
357,BUMA.1121.00105,1,2151479,2158704,-,7225
357,BUMA.1121.00015,1,803363,810579,-,7216
357,BUMA.1121.00059,1,2272295,2279521,+,7226
357,BUMA.1121.00026,1,2080877,2088195,-,7318
357,BUMA.1121.00022,1,1655976,1663234,-,7258
357,BUMA.1121.00052,1,1169362,1176602,-,7240
357,BUMA.1121.00101,1,3401028,3408333,-,7305
357,BUMA.1121.00001,1,1014064,1021429,-,7365
357,BUMA.1121.00038,1,2236290,2243583,+,7293
357,BUMA.1121.00068,1,1840201,1847431,+,7230
357,BUMA.1121.00099,1,3365383,3372776,-,7393
357,BUMA.1121.00091,1,1457964,1465183,-,7219
357,BUMA.1121.00098,1,1703052,1710339,+,7287
357,BUMA.1121.00013,1,1365596,1372848,-,7252
357,BUMA.1121.00049,1,2768978,2776207,-,7229
357,BUMA.1121.00072,1,2954441,2961692,+,7251
357,BUMA.1121.00076,1,2266395,2273637,-,7242
357,BUMA.1121.00083,1,2621066,2628326,-,7260
357,BUMA.1121.00078,1,2955023,2962382,-,7359
357,BUMA.1121.00095,1,2665484,2672685,-,7201
357,BUMA.1121.00077,1,1706980,1714243,+,7263
357,BUMA.1121.00063,1,2980469,2987721,+,7252
357,BUMA.1121.00061,1,2983604,2990856,+,7252
357,BUMA.1121.00050,1,2455401,2462599,-,7198
357,BUMA.1121.00081,1,2236416,2243709,+,7293
357,BUMA.1121.00074,1,817444,824710,-,7266
357,BUMA.1121.00062,1,1505452,1512717,-,7265
357,BUMA.1121.00060,1,3258488,3265747,-,7259
357,BUMA.1121.00070,1,2954692,2961944,+,7252
357,BUMA.1121.00075,1,2538633,2545886,+,7253
357,BUMA.1121.00041,1,277049,284324,+,7275
357,BUMA.1121.00073,1,2981865,2989117,+,7252
357,BUMA.1121.00017,1,1328570,1335768,-,7198
357,BUMA.1121.00066,1,2957359,2964610,+,7251
357,BUMA.1121.00107,1,2985030,2992267,+,7237
357,BUMA.1121.00085,1,766197,773437,-,7240
357,BUMA.1121.00030,1,1328618,1335822,-,7204
357,BUMA.1121.00112,1,4022474,4029749,-,7275
357,BUMA.1121.00002,1,2537655,2544925,-,7270
357,BUMA.1121.00082,1,3151034,3158294,+,7260
357,BUMA.1121.00014,1,3868586,3875848,-,7262
357,BUMA.1121.00011,1,2602521,2609709,-,7188
357,BUMA.1121.00019,1,1393632,1400836,-,7204
357,BUMA.1121.00057,1,148887,156079,+,7192
357,BUMA.1121.00018,1,3678022,3685320,+,7298
357,BUMA.1121.00039,1,3185034,3192335,+,7301
357,BUMA.1121.00016,1,1159732,1167127,+,7395
357,BUMA.1121.00004,1,1394805,1402003,-,7198
357,BUMA.1121.00005,1,1760260,1767463,+,7203
357,BUMA.1121.00100,1,2265897,2273119,-,7222
357,BUMA.1121.00006,1,2236198,2243501,+,7303
358,BUMA.1121.00027,1,1241517,1246522,+,5005
358,BUMA.1121.00025,1,3719251,3724245,-,4994
358,BUMA.1121.00021,1,3699946,3704955,+,5009
358,BUMA.1121.00023,1,1372590,1377599,+,5009
358,BUMA.1121.00024,1,1388285,1393278,-,4993
358,BUMA.1121.00033,1,1254747,1259742,+,4995
358,BUMA.1121.00034,1,1425676,1430669,-,4993
358,BUMA.1121.00036,1,804483,809476,-,4993
358,BUMA.1121.00032,1,2918739,2923732,-,4993
358,BUMA.1121.00009,1,2517883,2522877,-,4994
358,BUMA.1121.00008,1,1392036,1397029,-,4993
358,BUMA.1121.00003,1,1550846,1555855,+,5009
358,BUMA.1121.00109,1,2857587,2862580,-,4993
358,BUMA.1121.00053,1,2813449,2818458,+,5009
358,BUMA.1121.00110,1,1763733,1768726,-,4993
358,BUMA.1121.00104,1,2193187,2198180,-,4993
358,BUMA.1121.00086,1,1993107,1998101,+,4994
358,BUMA.1121.00092,1,727629,732633,-,5004
358,BUMA.1121.00096,1,223266,228261,-,4995
358,BUMA.1121.00054,1,1894310,1899304,-,4994
358,BUMA.1121.00097,1,875143,880152,-,5009
358,BUMA.1121.00093,1,3893486,3898491,+,5005
358,BUMA.1121.00106,1,2802699,2807693,+,4994
358,BUMA.1121.00010,1,2509366,2514360,-,4994
358,BUMA.1121.00035,1,93725,98719,+,4994
358,BUMA.1121.00108,1,56805,61800,+,4995
358,BUMA.1121.00028,1,1388334,1393327,-,4993
358,BUMA.1121.00094,1,3036165,3041158,+,4993
358,BUMA.1121.00102,1,2236262,2241255,-,4993
358,BUMA.1121.00111,1,3224324,3229332,+,5008
358,BUMA.1121.00089,1,3007192,3012185,+,4993
358,BUMA.1121.00084,1,3417454,3422463,+,5009
358,BUMA.1121.00029,1,1876263,1881256,-,4993
358,BUMA.1121.00012,1,1806189,1811184,+,4995
358,BUMA.1121.00087,1,1318956,1323949,-,4993
358,BUMA.1121.00043,1,3166380,3171374,+,4994
358,BUMA.1121.00046,1,296728,301723,+,4995
358,BUMA.1121.00037,1,1656487,1661482,+,4995
358,BUMA.1121.00080,1,3067853,3072846,+,4993
358,BUMA.1121.00079,1,3102112,3107106,+,4994
358,BUMA.1121.00045,1,1008002,1012994,-,4992
358,BUMA.1121.00071,1,2979818,2984812,+,4994
358,BUMA.1121.00056,1,914661,919653,-,4992
358,BUMA.1121.00065,1,3117176,3122170,+,4994
358,BUMA.1121.00058,1,1471290,1476284,-,4994
358,BUMA.1121.00007,1,1003316,1008310,-,4994
358,BUMA.1121.00067,1,1366528,1371521,-,4993
358,BUMA.1121.00090,1,1129312,1134307,+,4995
358,BUMA.1121.00051,1,3019208,3024201,+,4993
358,BUMA.1121.00020,1,1453248,1458241,-,4993
358,BUMA.1121.00103,1,1312364,1317358,-,4994
358,BUMA.1121.00048,1,2036437,2041432,+,4995
358,BUMA.1121.00047,1,3956061,3961053,-,4992
358,BUMA.1121.00042,1,996418,1001412,-,4994
358,BUMA.1121.00055,1,2732623,2737617,+,4994
358,BUMA.1121.00031,1,382438,387447,+,5009
358,BUMA.1121.00040,1,1315724,1320718,-,4994
358,BUMA.1121.00044,1,653782,658775,-,4993
358,BUMA.1121.00088,1,4025511,4030505,+,4994
358,BUMA.1121.00069,1,2960454,2965463,+,5009
358,BUMA.1121.00064,1,3057086,3062080,+,4994
358,BUMA.1121.00105,1,2146222,2151215,-,4993
358,BUMA.1121.00015,1,798105,803099,-,4994
358,BUMA.1121.00059,1,2279785,2284780,+,4995
358,BUMA.1121.00026,1,2075620,2080613,-,4993
358,BUMA.1121.00022,1,1650719,1655712,-,4993
358,BUMA.1121.00052,1,1164104,1169098,-,4994
358,BUMA.1121.00101,1,3395772,3400764,-,4992
358,BUMA.1121.00001,1,1008807,1013800,-,4993
358,BUMA.1121.00038,1,2243847,2248842,+,4995
358,BUMA.1121.00068,1,1847695,1852689,+,4994
358,BUMA.1121.00099,1,3360127,3365119,-,4992
358,BUMA.1121.00091,1,1452714,1457723,-,5009
358,BUMA.1121.00098,1,1710603,1715597,+,4994
358,BUMA.1121.00013,1,1360338,1365332,-,4994
358,BUMA.1121.00049,1,2763721,2768714,-,4993
358,BUMA.1121.00072,1,2961956,2966950,+,4994
358,BUMA.1121.00076,1,2261138,2266131,-,4993
358,BUMA.1121.00083,1,2615816,2620825,-,5009
358,BUMA.1121.00078,1,2949749,2954759,-,5010
358,BUMA.1121.00095,1,2660234,2665243,-,5009
358,BUMA.1121.00077,1,1714507,1719500,+,4993
358,BUMA.1121.00063,1,2987985,2992979,+,4994
358,BUMA.1121.00061,1,2991120,2996114,+,4994
358,BUMA.1121.00050,1,2450143,2455137,-,4994
358,BUMA.1121.00081,1,2243973,2248968,+,4995
358,BUMA.1121.00074,1,812187,817180,-,4993
358,BUMA.1121.00062,1,1500202,1505211,-,5009
358,BUMA.1121.00060,1,3253232,3258224,-,4992
358,BUMA.1121.00070,1,2962208,2967202,+,4994
358,BUMA.1121.00075,1,2546150,2551144,+,4994
358,BUMA.1121.00041,1,284588,289582,+,4994
358,BUMA.1121.00073,1,2989381,2994375,+,4994
358,BUMA.1121.00017,1,1323313,1328306,-,4993
358,BUMA.1121.00066,1,2964874,2969868,+,4994
358,BUMA.1121.00107,1,2992527,2997520,+,4993
358,BUMA.1121.00085,1,760939,765933,-,4994
358,BUMA.1121.00030,1,1323361,1328354,-,4993
358,BUMA.1121.00112,1,4017218,4022210,-,4992
358,BUMA.1121.00002,1,2532397,2537391,-,4994
358,BUMA.1121.00082,1,3158535,3163544,+,5009
358,BUMA.1121.00014,1,3863336,3868345,-,5009
358,BUMA.1121.00011,1,2597264,2602257,-,4993
358,BUMA.1121.00019,1,1388375,1393368,-,4993
358,BUMA.1121.00057,1,156343,161337,+,4994
358,BUMA.1121.00018,1,3685584,3690579,+,4995
358,BUMA.1121.00039,1,3192599,3197594,+,4995
358,BUMA.1121.00016,1,1167368,1172378,+,5010
358,BUMA.1121.00004,1,1389548,1394541,-,4993
358,BUMA.1121.00005,1,1767727,1772721,+,4994
358,BUMA.1121.00100,1,2260640,2265633,-,4993
358,BUMA.1121.00006,1,2243765,2248760,+,4995
359,BUMA.1121.00027,1,1252008,1261011,+,9003
359,BUMA.1121.00025,1,3704761,3713763,-,9002
359,BUMA.1121.00021,1,3724601,3733604,+,9003
359,BUMA.1121.00023,1,1402158,1411161,+,9003
359,BUMA.1121.00024,1,1372264,1381218,-,8954
359,BUMA.1121.00033,1,1281689,1290692,+,9003
359,BUMA.1121.00034,1,1409655,1418609,-,8954
359,BUMA.1121.00036,1,788462,797416,-,8954
359,BUMA.1121.00032,1,2902718,2911672,-,8954
359,BUMA.1121.00009,1,2485632,2494632,-,9000
359,BUMA.1121.00008,1,1376015,1384969,-,8954
359,BUMA.1121.00003,1,1584501,1593503,+,9002
359,BUMA.1121.00109,1,2836342,2845343,-,9001
359,BUMA.1121.00053,1,2823929,2832929,+,9000
359,BUMA.1121.00110,1,1746080,1755082,-,9002
359,BUMA.1121.00104,1,2178720,2187720,-,9000
359,BUMA.1121.00086,1,2005167,2014122,+,8955
359,BUMA.1121.00092,1,713135,722136,-,9001
359,BUMA.1121.00096,1,201695,210696,-,9001
359,BUMA.1121.00054,1,1879896,1888841,-,8945
359,BUMA.1121.00097,1,860676,869678,-,9002
359,BUMA.1121.00093,1,3903983,3912985,+,9002
359,BUMA.1121.00106,1,2813159,2822160,+,9001
359,BUMA.1121.00010,1,2494950,2503904,-,8954
359,BUMA.1121.00035,1,107085,116088,+,9003
359,BUMA.1121.00108,1,67272,76274,+,9002
359,BUMA.1121.00028,1,1372313,1381267,-,8954
359,BUMA.1121.00094,1,3046639,3056999,+,10360
359,BUMA.1121.00102,1,2221779,2230778,-,8999
359,BUMA.1121.00111,1,3250790,3259792,+,9002
359,BUMA.1121.00089,1,3017666,3028026,+,10360
359,BUMA.1121.00084,1,3427926,3436927,+,9001
359,BUMA.1121.00029,1,1850700,1859702,-,9002
359,BUMA.1121.00012,1,1816665,1825667,+,9002
359,BUMA.1121.00087,1,1302936,1311890,-,8954
359,BUMA.1121.00043,1,3196445,3205448,+,9003
359,BUMA.1121.00046,1,307191,316117,+,8926
359,BUMA.1121.00037,1,1699091,1708094,+,9003
359,BUMA.1121.00080,1,3078327,3088687,+,10360
359,BUMA.1121.00079,1,3112579,3121580,+,9001
359,BUMA.1121.00045,1,993530,1002531,-,9001
359,BUMA.1121.00071,1,2990288,2999288,+,9000
359,BUMA.1121.00056,1,898820,909179,-,10359
359,BUMA.1121.00065,1,3127663,3136663,+,9000
359,BUMA.1121.00058,1,1445188,1454188,-,9000
359,BUMA.1121.00007,1,988821,997821,-,9000
359,BUMA.1121.00067,1,1352044,1361043,-,8999
359,BUMA.1121.00090,1,1139363,1148366,+,9003
359,BUMA.1121.00051,1,3029682,3040042,+,10360
359,BUMA.1121.00020,1,1437227,1446181,-,8954
359,BUMA.1121.00103,1,1297861,1306863,-,9002
359,BUMA.1121.00048,1,2046900,2055846,+,8946
359,BUMA.1121.00047,1,3940222,3950579,-,10357
359,BUMA.1121.00042,1,981992,990946,-,8954
359,BUMA.1121.00055,1,2743104,2752105,+,9001
359,BUMA.1121.00031,1,392928,401931,+,9003
359,BUMA.1121.00040,1,1301301,1310255,-,8954
359,BUMA.1121.00044,1,637761,646715,-,8954
359,BUMA.1121.00088,1,4035991,4044992,+,9001
359,BUMA.1121.00069,1,2970939,2979940,+,9001
359,BUMA.1121.00064,1,3067572,3076573,+,9001
359,BUMA.1121.00105,1,2131745,2140745,-,9000
359,BUMA.1121.00015,1,783682,792636,-,8954
359,BUMA.1121.00059,1,2290243,2299244,+,9001
359,BUMA.1121.00026,1,2061194,2070148,-,8954
359,BUMA.1121.00022,1,1634700,1643654,-,8954
359,BUMA.1121.00052,1,1149681,1158635,-,8954
359,BUMA.1121.00101,1,3381290,3390292,-,9002
359,BUMA.1121.00001,1,977106,986108,-,9002
359,BUMA.1121.00038,1,2254310,2263256,+,8946
359,BUMA.1121.00068,1,1858185,1867187,+,9002
359,BUMA.1121.00099,1,3345636,3354638,-,9002
359,BUMA.1121.00091,1,1438219,1447218,-,8999
359,BUMA.1121.00098,1,1721067,1730069,+,9002
359,BUMA.1121.00013,1,1345915,1354869,-,8954
359,BUMA.1121.00049,1,2749240,2758241,-,9001
359,BUMA.1121.00072,1,2972429,2981430,+,9001
359,BUMA.1121.00076,1,2246641,2255644,-,9003
359,BUMA.1121.00083,1,2601336,2610336,-,9000
359,BUMA.1121.00078,1,2935267,2944270,-,9003
359,BUMA.1121.00095,1,2636662,2645663,-,9001
359,BUMA.1121.00077,1,1728150,1737153,+,9003
359,BUMA.1121.00063,1,2998456,3007457,+,9001
359,BUMA.1121.00061,1,3001592,3010593,+,9001
359,BUMA.1121.00050,1,2435747,2444674,-,8927
359,BUMA.1121.00081,1,2254436,2263382,+,8946
359,BUMA.1121.00074,1,797684,806683,-,8999
359,BUMA.1121.00062,1,1485698,1494698,-,9000
359,BUMA.1121.00060,1,3238760,3247761,-,9001
359,BUMA.1121.00070,1,2972679,2981680,+,9001
359,BUMA.1121.00075,1,2556637,2565641,+,9004
359,BUMA.1121.00041,1,300905,309924,+,9019
359,BUMA.1121.00073,1,2999854,3008855,+,9001
359,BUMA.1121.00017,1,1307292,1316246,-,8954
359,BUMA.1121.00066,1,2975344,2984345,+,9001
359,BUMA.1121.00107,1,3003006,3012007,+,9001
359,BUMA.1121.00085,1,746516,755470,-,8954
359,BUMA.1121.00030,1,1307340,1316294,-,8954
359,BUMA.1121.00112,1,4002749,4011748,-,8999
359,BUMA.1121.00002,1,2517981,2526935,-,8954
359,BUMA.1121.00082,1,3169023,3178024,+,9001
359,BUMA.1121.00014,1,3848852,3857854,-,9002
359,BUMA.1121.00011,1,2572964,2581966,-,9002
359,BUMA.1121.00019,1,1372354,1381308,-,8954
359,BUMA.1121.00057,1,166816,175817,+,9001
359,BUMA.1121.00018,1,3696066,3705069,+,9003
359,BUMA.1121.00039,1,3212019,3221022,+,9003
359,BUMA.1121.00016,1,1177859,1186862,+,9003
359,BUMA.1121.00004,1,1373527,1382481,-,8954
359,BUMA.1121.00005,1,1783727,1792728,+,9001
359,BUMA.1121.00100,1,2226603,2235603,-,9000
359,BUMA.1121.00006,1,2254228,2263174,+,8946
360,BUMA.1121.00027,1,1261012,1277756,+,16744
360,BUMA.1121.00025,1,3687993,3704759,-,16766
360,BUMA.1121.00021,1,3733605,3750382,+,16777
360,BUMA.1121.00023,1,1411162,1427955,+,16793
360,BUMA.1121.00024,1,1355495,1372262,-,16767
360,BUMA.1121.00033,1,1290693,1307435,+,16742
360,BUMA.1121.00034,1,1392886,1409653,-,16767
360,BUMA.1121.00036,1,771693,788460,-,16767
360,BUMA.1121.00032,1,2885955,2902716,-,16761
360,BUMA.1121.00009,1,2468876,2485630,-,16754
360,BUMA.1121.00008,1,1359252,1376013,-,16761
360,BUMA.1121.00003,1,1593504,1610224,+,16720
360,BUMA.1121.00109,1,2819613,2836340,-,16727
360,BUMA.1121.00053,1,2832930,2849712,+,16782
360,BUMA.1121.00110,1,1729322,1746078,-,16756
360,BUMA.1121.00104,1,2161964,2178718,-,16754
360,BUMA.1121.00086,1,2014123,2030878,+,16755
360,BUMA.1121.00092,1,696320,713133,-,16813
360,BUMA.1121.00096,1,184894,201693,-,16799
360,BUMA.1121.00054,1,1863214,1879894,-,16680
360,BUMA.1121.00097,1,843922,860674,-,16752
360,BUMA.1121.00093,1,3912986,3929799,+,16813
360,BUMA.1121.00106,1,2822161,2838867,+,16706
360,BUMA.1121.00010,1,2478205,2494948,-,16743
360,BUMA.1121.00035,1,116089,132837,+,16748
360,BUMA.1121.00108,1,76275,93005,+,16730
360,BUMA.1121.00028,1,1355550,1372311,-,16761
360,BUMA.1121.00094,1,3057000,3073716,+,16716
360,BUMA.1121.00102,1,2205021,2221777,-,16756
360,BUMA.1121.00111,1,3259793,3276541,+,16748
360,BUMA.1121.00089,1,3028027,3044743,+,16716
360,BUMA.1121.00084,1,3436928,3453645,+,16717
360,BUMA.1121.00029,1,1833944,1850698,-,16754
360,BUMA.1121.00012,1,1825668,1842456,+,16788
360,BUMA.1121.00087,1,1286179,1302934,-,16755
360,BUMA.1121.00043,1,3205449,3222204,+,16755
360,BUMA.1121.00046,1,317372,334055,+,16683
360,BUMA.1121.00037,1,1708095,1724853,+,16758
360,BUMA.1121.00080,1,3088688,3105398,+,16710
360,BUMA.1121.00079,1,3121581,3138278,+,16697
360,BUMA.1121.00045,1,976794,993528,-,16734
360,BUMA.1121.00071,1,2999289,3016033,+,16744
360,BUMA.1121.00056,1,882102,898818,-,16716
360,BUMA.1121.00065,1,3136664,3153394,+,16730
360,BUMA.1121.00058,1,1428438,1445186,-,16748
360,BUMA.1121.00007,1,972025,988819,-,16794
360,BUMA.1121.00067,1,1335265,1352042,-,16777
360,BUMA.1121.00090,1,1148367,1165128,+,16761
360,BUMA.1121.00051,1,3040043,3056771,+,16728
360,BUMA.1121.00020,1,1420464,1437225,-,16761
360,BUMA.1121.00103,1,1281129,1297859,-,16730
360,BUMA.1121.00048,1,2055847,2072527,+,16680
360,BUMA.1121.00047,1,3923476,3940220,-,16744
360,BUMA.1121.00042,1,965241,981990,-,16749
360,BUMA.1121.00055,1,2752106,2768863,+,16757
360,BUMA.1121.00031,1,401932,418679,+,16747
360,BUMA.1121.00040,1,1284557,1301299,-,16742
360,BUMA.1121.00044,1,620992,637759,-,16767
360,BUMA.1121.00088,1,4044993,4061759,+,16766
360,BUMA.1121.00069,1,2979941,2996682,+,16741
360,BUMA.1121.00064,1,3076574,3093351,+,16777
360,BUMA.1121.00105,1,2115003,2131743,-,16740
360,BUMA.1121.00015,1,766988,783680,-,16692
360,BUMA.1121.00059,1,2299245,2316004,+,16759
360,BUMA.1121.00026,1,2044431,2061192,-,16761
360,BUMA.1121.00022,1,1617943,1634698,-,16755
360,BUMA.1121.00052,1,1132942,1149679,-,16737
360,BUMA.1121.00101,1,3364510,3381288,-,16778
360,BUMA.1121.00001,1,960350,977104,-,16754
360,BUMA.1121.00038,1,2263257,2279937,+,16680
360,BUMA.1121.00068,1,1867188,1883961,+,16773
360,BUMA.1121.00099,1,3328827,3345634,-,16807
360,BUMA.1121.00091,1,1421461,1438217,-,16756
360,BUMA.1121.00098,1,1730070,1746816,+,16746
360,BUMA.1121.00013,1,1329176,1345913,-,16737
360,BUMA.1121.00049,1,2732511,2749238,-,16727
360,BUMA.1121.00072,1,2981431,2998175,+,16744
360,BUMA.1121.00076,1,2229910,2246639,-,16729
360,BUMA.1121.00083,1,2584590,2601334,-,16744
360,BUMA.1121.00078,1,2918493,2935265,-,16772
360,BUMA.1121.00095,1,2619892,2636660,-,16768
360,BUMA.1121.00077,1,1737154,1753911,+,16757
360,BUMA.1121.00063,1,3007458,3024197,+,16739
360,BUMA.1121.00061,1,3010594,3027338,+,16744
360,BUMA.1121.00050,1,2417810,2434494,-,16684
360,BUMA.1121.00081,1,2263383,2280063,+,16680
360,BUMA.1121.00074,1,780911,797682,-,16771
360,BUMA.1121.00062,1,1468936,1485696,-,16760
360,BUMA.1121.00060,1,3222018,3238758,-,16740
360,BUMA.1121.00070,1,2981681,2998425,+,16744
360,BUMA.1121.00075,1,2565642,2582377,+,16735
360,BUMA.1121.00041,1,309925,326668,+,16743
360,BUMA.1121.00073,1,3008856,3025600,+,16744
360,BUMA.1121.00017,1,1290523,1307290,-,16767
360,BUMA.1121.00066,1,2984346,3001090,+,16744
360,BUMA.1121.00107,1,3012008,3028765,+,16757
360,BUMA.1121.00085,1,729777,746514,-,16737
360,BUMA.1121.00030,1,1290571,1307338,-,16767
360,BUMA.1121.00112,1,3986010,4002747,-,16737
360,BUMA.1121.00002,1,2501236,2517979,-,16743
360,BUMA.1121.00082,1,3178025,3194769,+,16744
360,BUMA.1121.00014,1,3832103,3848850,-,16747
360,BUMA.1121.00011,1,2556229,2572962,-,16733
360,BUMA.1121.00019,1,1355591,1372352,-,16761
360,BUMA.1121.00057,1,175818,192574,+,16756
360,BUMA.1121.00018,1,3705070,3721836,+,16766
360,BUMA.1121.00039,1,3221023,3237795,+,16772
360,BUMA.1121.00016,1,1186863,1203611,+,16748
360,BUMA.1121.00004,1,1356758,1373525,-,16767
360,BUMA.1121.00005,1,1792729,1809477,+,16748
360,BUMA.1121.00100,1,2209876,2226601,-,16725
360,BUMA.1121.00006,1,2263175,2279855,+,16680
361,BUMA.1121.00027,1,1284787,1289048,+,4261
361,BUMA.1121.00025,1,3676700,3680961,-,4261
361,BUMA.1121.00021,1,3757414,3761675,+,4261
361,BUMA.1121.00023,1,1434987,1439248,+,4261
361,BUMA.1121.00024,1,1556076,1560337,-,4261
361,BUMA.1121.00033,1,1314466,1318726,+,4260
361,BUMA.1121.00034,1,1593502,1597763,-,4261
361,BUMA.1121.00036,1,972437,976698,-,4261
361,BUMA.1121.00032,1,3086572,3090833,-,4261
361,BUMA.1121.00009,1,2457582,2461843,-,4261
361,BUMA.1121.00008,1,1559802,1564063,-,4261
361,BUMA.1121.00003,1,1617256,1621517,+,4261
361,BUMA.1121.00109,1,2808320,2812581,-,4261
361,BUMA.1121.00053,1,2856744,2861005,+,4261
361,BUMA.1121.00110,1,1718028,1722289,-,4261
361,BUMA.1121.00104,1,2150670,2154931,-,4261
361,BUMA.1121.00086,1,1822165,1826426,+,4261
361,BUMA.1121.00092,1,685026,689287,-,4261
361,BUMA.1121.00096,1,173601,177862,-,4261
361,BUMA.1121.00054,1,2062110,2066371,-,4261
361,BUMA.1121.00097,1,832629,836890,-,4261
361,BUMA.1121.00093,1,3936832,3941093,+,4261
361,BUMA.1121.00106,1,2845900,2850161,+,4261
361,BUMA.1121.00010,1,2677100,2681361,-,4261
361,BUMA.1121.00035,1,139869,144130,+,4261
361,BUMA.1121.00108,1,100038,104299,+,4261
361,BUMA.1121.00028,1,1556125,1560386,-,4261
361,BUMA.1121.00094,1,3080749,3085010,+,4261
361,BUMA.1121.00102,1,2193728,2197989,-,4261
361,BUMA.1121.00111,1,3283573,3287834,+,4261
361,BUMA.1121.00089,1,3051776,3056037,+,4261
361,BUMA.1121.00084,1,3460678,3464939,+,4261
361,BUMA.1121.00029,1,1822651,1826912,-,4261
361,BUMA.1121.00012,1,1849488,1853749,+,4261
361,BUMA.1121.00087,1,1490445,1494706,-,4261
361,BUMA.1121.00043,1,3229236,3233497,+,4261
361,BUMA.1121.00046,1,131979,136240,+,4261
361,BUMA.1121.00037,1,1731885,1736146,+,4261
361,BUMA.1121.00080,1,3112431,3116692,+,4261
361,BUMA.1121.00079,1,3145310,3149571,+,4261
361,BUMA.1121.00045,1,965500,969761,-,4261
361,BUMA.1121.00071,1,3023066,3027327,+,4261
361,BUMA.1121.00056,1,870808,875069,-,4261
361,BUMA.1121.00065,1,3160426,3164687,+,4261
361,BUMA.1121.00058,1,1417144,1421405,-,4261
361,BUMA.1121.00007,1,960732,964993,-,4261
361,BUMA.1121.00067,1,1323972,1328233,-,4261
361,BUMA.1121.00090,1,1172160,1176421,+,4261
361,BUMA.1121.00051,1,3063804,3068065,+,4261
361,BUMA.1121.00020,1,1621047,1625308,-,4261
361,BUMA.1121.00103,1,1269836,1274097,-,4261
361,BUMA.1121.00048,1,1869363,1873624,+,4261
361,BUMA.1121.00047,1,3912182,3916443,-,4261
361,BUMA.1121.00042,1,2852243,2856504,+,4261
361,BUMA.1121.00055,1,2775898,2780159,+,4261
361,BUMA.1121.00031,1,425711,429972,+,4261
361,BUMA.1121.00040,1,1485091,1489352,-,4261
361,BUMA.1121.00044,1,821600,825861,-,4261
361,BUMA.1121.00088,1,4068792,4073053,+,4261
361,BUMA.1121.00069,1,3003715,3007976,+,4261
361,BUMA.1121.00064,1,3100383,3104644,+,4261
361,BUMA.1121.00105,1,2103710,2107971,-,4261
361,BUMA.1121.00015,1,965867,970128,-,4261
361,BUMA.1121.00059,1,2323037,2327298,+,4261
361,BUMA.1121.00026,1,2030658,2034935,-,4277
361,BUMA.1121.00022,1,1822224,1826485,-,4261
361,BUMA.1121.00052,1,1328979,1333240,-,4261
361,BUMA.1121.00101,1,3353217,3357478,-,4261
361,BUMA.1121.00001,1,949058,953319,-,4261
361,BUMA.1121.00038,1,2076780,2081041,+,4261
361,BUMA.1121.00068,1,1890993,1895254,+,4261
361,BUMA.1121.00099,1,3317534,3321795,-,4261
361,BUMA.1121.00098,1,1753848,1758109,+,4261
361,BUMA.1121.00013,1,1529810,1534071,-,4261
361,BUMA.1121.00049,1,2721218,2725479,-,4261
361,BUMA.1121.00072,1,3005208,3009469,+,4261
361,BUMA.1121.00076,1,2218616,2222877,-,4261
361,BUMA.1121.00083,1,2573296,2577557,-,4261
361,BUMA.1121.00078,1,2907200,2911461,-,4261
361,BUMA.1121.00077,1,1760946,1765207,+,4261
361,BUMA.1121.00050,1,2615568,2619829,-,4261
361,BUMA.1121.00081,1,2076906,2081167,+,4261
361,BUMA.1121.00074,1,769618,773879,-,4261
361,BUMA.1121.00062,1,1457642,1461903,-,4261
361,BUMA.1121.00060,1,3210723,3214984,-,4261
361,BUMA.1121.00075,1,2589410,2593671,+,4261
361,BUMA.1121.00017,1,1491131,1495392,-,4261
361,BUMA.1121.00066,1,3008123,3012384,+,4261
361,BUMA.1121.00107,1,3035803,3040064,+,4261
361,BUMA.1121.00085,1,925869,930130,-,4261
361,BUMA.1121.00030,1,1491184,1495445,-,4261
361,BUMA.1121.00112,1,3974717,3978978,-,4261
361,BUMA.1121.00002,1,2699349,2703610,-,4261
361,BUMA.1121.00082,1,3201802,3206063,+,4261
361,BUMA.1121.00014,1,3819475,3825071,-,5596
361,BUMA.1121.00011,1,2544936,2549197,-,4261
361,BUMA.1121.00019,1,1556180,1560441,-,4261
361,BUMA.1121.00057,1,199607,203868,+,4261
361,BUMA.1121.00018,1,3728867,3733128,+,4261
361,BUMA.1121.00039,1,3244827,3249088,+,4261
361,BUMA.1121.00016,1,1210643,1214904,+,4261
361,BUMA.1121.00004,1,1557258,1561519,-,4261
361,BUMA.1121.00006,1,2076693,2080954,+,4261
362,BUMA.1121.00027,1,1289050,1294775,+,5725
362,BUMA.1121.00025,1,3670973,3676699,-,5726
362,BUMA.1121.00021,1,3761677,3767402,+,5725
362,BUMA.1121.00023,1,1439250,1444975,+,5725
362,BUMA.1121.00024,1,1550349,1556075,-,5726
362,BUMA.1121.00033,1,1318728,1324452,+,5724
362,BUMA.1121.00034,1,1587775,1593501,-,5726
362,BUMA.1121.00036,1,966710,972436,-,5726
362,BUMA.1121.00032,1,3080845,3086571,-,5726
362,BUMA.1121.00009,1,2451855,2457581,-,5726
362,BUMA.1121.00008,1,1554075,1559801,-,5726
362,BUMA.1121.00003,1,1621519,1627245,+,5726
362,BUMA.1121.00109,1,2802593,2808319,-,5726
362,BUMA.1121.00053,1,2861007,2866732,+,5725
362,BUMA.1121.00110,1,1712301,1718027,-,5726
362,BUMA.1121.00104,1,2144943,2150669,-,5726
362,BUMA.1121.00086,1,1826428,1832153,+,5725
362,BUMA.1121.00092,1,679299,685025,-,5726
362,BUMA.1121.00096,1,167874,173600,-,5726
362,BUMA.1121.00054,1,2056383,2062109,-,5726
362,BUMA.1121.00097,1,826902,832628,-,5726
362,BUMA.1121.00093,1,3941095,3946820,+,5725
362,BUMA.1121.00106,1,2850163,2855888,+,5725
362,BUMA.1121.00010,1,2671373,2677099,-,5726
362,BUMA.1121.00035,1,144132,149857,+,5725
362,BUMA.1121.00108,1,104301,110026,+,5725
362,BUMA.1121.00028,1,1550398,1556124,-,5726
362,BUMA.1121.00094,1,3085012,3090737,+,5725
362,BUMA.1121.00102,1,2188001,2193727,-,5726
362,BUMA.1121.00111,1,3287836,3293558,+,5722
362,BUMA.1121.00089,1,3056039,3061764,+,5725
362,BUMA.1121.00084,1,3464941,3470666,+,5725
362,BUMA.1121.00029,1,1816924,1822650,-,5726
362,BUMA.1121.00012,1,1853751,1859476,+,5725
362,BUMA.1121.00087,1,1484718,1490444,-,5726
362,BUMA.1121.00043,1,3233499,3239224,+,5725
362,BUMA.1121.00046,1,136242,141967,+,5725
362,BUMA.1121.00037,1,1736148,1741873,+,5725
362,BUMA.1121.00080,1,3116694,3122419,+,5725
362,BUMA.1121.00079,1,3149573,3155298,+,5725
362,BUMA.1121.00045,1,959773,965499,-,5726
362,BUMA.1121.00071,1,3027329,3033054,+,5725
362,BUMA.1121.00056,1,865081,870807,-,5726
362,BUMA.1121.00065,1,3164689,3170414,+,5725
362,BUMA.1121.00058,1,1411417,1417143,-,5726
362,BUMA.1121.00007,1,955005,960731,-,5726
362,BUMA.1121.00067,1,1318245,1323971,-,5726
362,BUMA.1121.00090,1,1176423,1182148,+,5725
362,BUMA.1121.00051,1,3068067,3073792,+,5725
362,BUMA.1121.00020,1,1615320,1621046,-,5726
362,BUMA.1121.00103,1,1264109,1269835,-,5726
362,BUMA.1121.00048,1,1873626,1879351,+,5725
362,BUMA.1121.00047,1,3906455,3912181,-,5726
362,BUMA.1121.00042,1,2856506,2862231,+,5725
362,BUMA.1121.00055,1,2780161,2785886,+,5725
362,BUMA.1121.00031,1,429974,435699,+,5725
362,BUMA.1121.00040,1,1479365,1485090,-,5725
362,BUMA.1121.00044,1,815873,821599,-,5726
362,BUMA.1121.00088,1,4073055,4078780,+,5725
362,BUMA.1121.00069,1,3007978,3013703,+,5725
362,BUMA.1121.00064,1,3104646,3110371,+,5725
362,BUMA.1121.00105,1,2097983,2103709,-,5726
362,BUMA.1121.00015,1,960140,965866,-,5726
362,BUMA.1121.00059,1,2327300,2333025,+,5725
362,BUMA.1121.00026,1,2024931,2030657,-,5726
362,BUMA.1121.00022,1,1816497,1822223,-,5726
362,BUMA.1121.00052,1,1323252,1328978,-,5726
362,BUMA.1121.00101,1,3347490,3353216,-,5726
362,BUMA.1121.00001,1,943331,949057,-,5726
362,BUMA.1121.00038,1,2081043,2086768,+,5725
362,BUMA.1121.00068,1,1895256,1900981,+,5725
362,BUMA.1121.00099,1,3311807,3317533,-,5726
362,BUMA.1121.00098,1,1758111,1763836,+,5725
362,BUMA.1121.00013,1,1524083,1529809,-,5726
362,BUMA.1121.00049,1,2715491,2721217,-,5726
362,BUMA.1121.00072,1,3009471,3015196,+,5725
362,BUMA.1121.00076,1,2212889,2218615,-,5726
362,BUMA.1121.00083,1,2567569,2573295,-,5726
362,BUMA.1121.00078,1,2901473,2907199,-,5726
362,BUMA.1121.00077,1,1765209,1770935,+,5726
362,BUMA.1121.00050,1,2609841,2615567,-,5726
362,BUMA.1121.00081,1,2081169,2086894,+,5725
362,BUMA.1121.00074,1,763891,769617,-,5726
362,BUMA.1121.00062,1,1451915,1457641,-,5726
362,BUMA.1121.00060,1,3204996,3210722,-,5726
362,BUMA.1121.00075,1,2593673,2599398,+,5725
362,BUMA.1121.00017,1,1485404,1491130,-,5726
362,BUMA.1121.00066,1,3012386,3018111,+,5725
362,BUMA.1121.00107,1,3040066,3045791,+,5725
362,BUMA.1121.00085,1,920142,925868,-,5726
362,BUMA.1121.00030,1,1485457,1491183,-,5726
362,BUMA.1121.00112,1,3968990,3974716,-,5726
362,BUMA.1121.00002,1,2693622,2699348,-,5726
362,BUMA.1121.00082,1,3206065,3211790,+,5725
362,BUMA.1121.00014,1,3813748,3819474,-,5726
362,BUMA.1121.00011,1,2504384,2510079,-,5695
362,BUMA.1121.00011,1,2539210,2544935,-,5725
362,BUMA.1121.00019,1,1550453,1556179,-,5726
362,BUMA.1121.00057,1,203870,209595,+,5725
362,BUMA.1121.00018,1,3733130,3738854,+,5724
362,BUMA.1121.00039,1,3249090,3254815,+,5725
362,BUMA.1121.00016,1,1214906,1220631,+,5725
362,BUMA.1121.00004,1,1551531,1557257,-,5726
362,BUMA.1121.00006,1,2080956,2086681,+,5725
363,BUMA.1121.00027,1,1294777,1309353,+,14576
363,BUMA.1121.00025,1,3656305,3670972,-,14667
363,BUMA.1121.00021,1,3767404,3782047,+,14643
363,BUMA.1121.00023,1,1444977,1459512,+,14535
363,BUMA.1121.00024,1,1535773,1550348,-,14575
363,BUMA.1121.00033,1,1324454,1339040,+,14586
363,BUMA.1121.00034,1,1573199,1587774,-,14575
363,BUMA.1121.00036,1,952110,966709,-,14599
363,BUMA.1121.00032,1,3066269,3080844,-,14575
363,BUMA.1121.00009,1,2437150,2451854,-,14704
363,BUMA.1121.00008,1,1539499,1554074,-,14575
363,BUMA.1121.00003,1,1627247,1641847,+,14600
363,BUMA.1121.00109,1,2787969,2802592,-,14623
363,BUMA.1121.00053,1,2866734,2881321,+,14587
363,BUMA.1121.00110,1,1697657,1712300,-,14643
363,BUMA.1121.00104,1,2130291,2144942,-,14651
363,BUMA.1121.00086,1,1832155,1846730,+,14575
363,BUMA.1121.00092,1,664698,679298,-,14600
363,BUMA.1121.00096,1,153246,167873,-,14627
363,BUMA.1121.00054,1,2041719,2056382,-,14663
363,BUMA.1121.00097,1,812225,826901,-,14676
363,BUMA.1121.00093,1,3946822,3961422,+,14600
363,BUMA.1121.00106,1,2855890,2870573,+,14683
363,BUMA.1121.00010,1,2656733,2671372,-,14639
363,BUMA.1121.00035,1,149859,164478,+,14619
363,BUMA.1121.00108,1,110028,124671,+,14643
363,BUMA.1121.00028,1,1535822,1550397,-,14575
363,BUMA.1121.00094,1,3090739,3105390,+,14651
363,BUMA.1121.00102,1,2173389,2188000,-,14611
363,BUMA.1121.00111,1,3293560,3308171,+,14611
363,BUMA.1121.00089,1,3061766,3076417,+,14651
363,BUMA.1121.00084,1,3470668,3485263,+,14595
363,BUMA.1121.00029,1,1802296,1816923,-,14627
363,BUMA.1121.00012,1,1859478,1874081,+,14603
363,BUMA.1121.00087,1,1470142,1484717,-,14575
363,BUMA.1121.00043,1,3239226,3253853,+,14627
363,BUMA.1121.00046,1,141969,156540,+,14571
363,BUMA.1121.00037,1,1741875,1756514,+,14639
363,BUMA.1121.00080,1,3122421,3137112,+,14691
363,BUMA.1121.00079,1,3155300,3169967,+,14667
363,BUMA.1121.00045,1,945020,959772,-,14752
363,BUMA.1121.00071,1,3033056,3047635,+,14579
363,BUMA.1121.00056,1,850429,865080,-,14651
363,BUMA.1121.00065,1,3170416,3185035,+,14619
363,BUMA.1121.00058,1,1396725,1411416,-,14691
363,BUMA.1121.00007,1,940472,955004,-,14532
363,BUMA.1121.00067,1,1303585,1318244,-,14659
363,BUMA.1121.00090,1,1182150,1196809,+,14659
363,BUMA.1121.00051,1,3073794,3088405,+,14611
363,BUMA.1121.00020,1,1600744,1615319,-,14575
363,BUMA.1121.00103,1,1249509,1264108,-,14599
363,BUMA.1121.00048,1,1879353,1894016,+,14663
363,BUMA.1121.00047,1,3891827,3906454,-,14627
363,BUMA.1121.00042,1,2862233,2876840,+,14607
363,BUMA.1121.00055,1,2785888,2800475,+,14587
363,BUMA.1121.00031,1,435701,450368,+,14667
363,BUMA.1121.00040,1,1464765,1479364,-,14599
363,BUMA.1121.00044,1,801297,815872,-,14575
363,BUMA.1121.00088,1,4078782,4093401,+,14619
363,BUMA.1121.00069,1,3013705,3028284,+,14579
363,BUMA.1121.00064,1,3110373,3125016,+,14643
363,BUMA.1121.00105,1,2083379,2097982,-,14603
363,BUMA.1121.00015,1,945560,960139,-,14579
363,BUMA.1121.00059,1,2333027,2347763,+,14736
363,BUMA.1121.00026,1,2010267,2024930,-,14663
363,BUMA.1121.00022,1,1801913,1816496,-,14583
363,BUMA.1121.00052,1,1308572,1323251,-,14679
363,BUMA.1121.00101,1,3332862,3347489,-,14627
363,BUMA.1121.00001,1,928677,943330,-,14653
363,BUMA.1121.00038,1,2086770,2101433,+,14663
363,BUMA.1121.00068,1,1900983,1915530,+,14547
363,BUMA.1121.00099,1,3297259,3311806,-,14547
363,BUMA.1121.00091,1,1371991,1386618,-,14627
363,BUMA.1121.00098,1,1763838,1778497,+,14659
363,BUMA.1121.00013,1,1509435,1524082,-,14647
363,BUMA.1121.00049,1,2700855,2715490,-,14635
363,BUMA.1121.00072,1,3015198,3029777,+,14579
363,BUMA.1121.00076,1,2198293,2212888,-,14595
363,BUMA.1121.00083,1,2552989,2567568,-,14579
363,BUMA.1121.00078,1,2886837,2901472,-,14635
363,BUMA.1121.00095,1,2568934,2583601,-,14667
363,BUMA.1121.00077,1,1770937,1785580,+,14643
363,BUMA.1121.00063,1,3027051,3041572,+,14521
363,BUMA.1121.00061,1,3030192,3044713,+,14521
363,BUMA.1121.00050,1,2595269,2609840,-,14571
363,BUMA.1121.00081,1,2086896,2101559,+,14663
363,BUMA.1121.00074,1,749247,763890,-,14643
363,BUMA.1121.00062,1,1437319,1451914,-,14595
363,BUMA.1121.00060,1,3190251,3204995,-,14744
363,BUMA.1121.00070,1,3001360,3015833,+,14473
363,BUMA.1121.00075,1,2599400,2613994,+,14594
363,BUMA.1121.00041,1,361516,376127,+,14611
363,BUMA.1121.00073,1,3028530,3043051,+,14521
363,BUMA.1121.00017,1,1470828,1485403,-,14575
363,BUMA.1121.00066,1,3018113,3032692,+,14579
363,BUMA.1121.00107,1,3045793,3060436,+,14643
363,BUMA.1121.00085,1,905462,920141,-,14679
363,BUMA.1121.00030,1,1470881,1485456,-,14575
363,BUMA.1121.00112,1,3954413,3968989,-,14576
363,BUMA.1121.00002,1,2678982,2693621,-,14639
363,BUMA.1121.00082,1,3211792,3226371,+,14579
363,BUMA.1121.00014,1,3799112,3813747,-,14635
363,BUMA.1121.00011,1,2489456,2504383,-,14927
363,BUMA.1121.00011,1,2524315,2539209,-,14894
363,BUMA.1121.00019,1,1535877,1550452,-,14575
363,BUMA.1121.00057,1,209597,224168,+,14571
363,BUMA.1121.00018,1,3738856,3753539,+,14683
363,BUMA.1121.00039,1,3254817,3269388,+,14571
363,BUMA.1121.00016,1,1220633,1235316,+,14683
363,BUMA.1121.00004,1,1536955,1551530,-,14575
363,BUMA.1121.00005,1,1842351,1856953,+,14602
363,BUMA.1121.00100,1,2170592,2185135,-,14543
363,BUMA.1121.00006,1,2086683,2101349,+,14666
364,BUMA.1121.00027,1,1310926,1323933,+,13007
364,BUMA.1121.00025,1,3641488,3654500,-,13012
364,BUMA.1121.00021,1,3783861,3796869,+,13008
364,BUMA.1121.00023,1,1460486,1473494,+,13008
364,BUMA.1121.00024,1,1521240,1534208,-,12968
364,BUMA.1121.00033,1,1340734,1353754,+,13020
364,BUMA.1121.00034,1,1558666,1571634,-,12968
364,BUMA.1121.00036,1,937577,950545,-,12968
364,BUMA.1121.00032,1,3051736,3064704,-,12968
364,BUMA.1121.00009,1,2422574,2435585,-,13011
364,BUMA.1121.00008,1,1524966,1537934,-,12968
364,BUMA.1121.00003,1,1642908,1655928,+,13020
364,BUMA.1121.00109,1,2773386,2786404,-,13018
364,BUMA.1121.00053,1,2883015,2896027,+,13012
364,BUMA.1121.00110,1,1682833,1695852,-,13019
364,BUMA.1121.00104,1,2115830,2128846,-,13016
364,BUMA.1121.00086,1,1848304,1861263,+,12959
364,BUMA.1121.00092,1,649877,662893,-,13016
364,BUMA.1121.00096,1,138172,151201,-,13029
364,BUMA.1121.00054,1,2028146,2041114,-,12968
364,BUMA.1121.00097,1,797522,810540,-,13018
364,BUMA.1121.00093,1,3963236,3976243,+,13007
364,BUMA.1121.00106,1,2872147,2885154,+,13007
364,BUMA.1121.00010,1,2642321,2655288,-,12967
364,BUMA.1121.00035,1,166292,179300,+,13008
364,BUMA.1121.00108,1,126005,139017,+,13012
364,BUMA.1121.00028,1,1521289,1534257,-,12968
364,BUMA.1121.00094,1,3106485,3119496,+,13011
364,BUMA.1121.00102,1,2159284,2172304,-,13020
364,BUMA.1121.00111,1,3309505,3322508,+,13003
364,BUMA.1121.00089,1,3077991,3091004,+,13013
364,BUMA.1121.00084,1,3486717,3499727,+,13010
364,BUMA.1121.00029,1,1787594,1800611,-,13017
364,BUMA.1121.00012,1,1875535,1888543,+,13008
364,BUMA.1121.00087,1,1455609,1468577,-,12968
364,BUMA.1121.00043,1,3255268,3268271,+,13003
364,BUMA.1121.00046,1,157144,170113,+,12969
364,BUMA.1121.00037,1,1757848,1770851,+,13003
364,BUMA.1121.00080,1,3138686,3151698,+,13012
364,BUMA.1121.00079,1,3171541,3184553,+,13012
364,BUMA.1121.00045,1,930557,943575,-,13018
364,BUMA.1121.00071,1,3049104,3062111,+,13007
364,BUMA.1121.00056,1,835842,848864,-,13022
364,BUMA.1121.00065,1,3186729,3199738,+,13009
364,BUMA.1121.00058,1,1382980,1396000,-,13020
364,BUMA.1121.00007,1,926070,939087,-,13017
364,BUMA.1121.00067,1,1289003,1302020,-,13017
364,BUMA.1121.00090,1,1198623,1211631,+,13008
364,BUMA.1121.00051,1,3089979,3102990,+,13011
364,BUMA.1121.00020,1,1586211,1599179,-,12968
364,BUMA.1121.00103,1,1235048,1248064,-,13016
364,BUMA.1121.00048,1,1894620,1907589,+,12969
364,BUMA.1121.00047,1,3877241,3890262,-,13021
364,BUMA.1121.00042,1,2878174,2891187,+,13013
364,BUMA.1121.00055,1,2802289,2815296,+,13007
364,BUMA.1121.00031,1,452182,465185,+,13003
364,BUMA.1121.00040,1,1451193,1464160,-,12967
364,BUMA.1121.00044,1,786764,799732,-,12968
364,BUMA.1121.00088,1,4094855,4107865,+,13010
364,BUMA.1121.00069,1,3029858,3042866,+,13008
364,BUMA.1121.00064,1,3126590,3139602,+,13012
364,BUMA.1121.00105,1,2068913,2081934,-,13021
364,BUMA.1121.00015,1,931987,944955,-,12968
364,BUMA.1121.00059,1,2349337,2362345,+,13008
364,BUMA.1121.00026,1,1995920,2008942,-,13022
364,BUMA.1121.00022,1,1787380,1800348,-,12968
364,BUMA.1121.00052,1,1294999,1307967,-,12968
364,BUMA.1121.00101,1,3318517,3331537,-,13020
364,BUMA.1121.00001,1,913855,926872,-,13017
364,BUMA.1121.00038,1,2102037,2115006,+,12969
364,BUMA.1121.00068,1,1916864,1929874,+,13010
364,BUMA.1121.00099,1,3282915,3295934,-,13019
364,BUMA.1121.00091,1,1357461,1370426,-,12965
364,BUMA.1121.00098,1,1780071,1793079,+,13008
364,BUMA.1121.00013,1,1495862,1508830,-,12968
364,BUMA.1121.00049,1,2686272,2699290,-,13018
364,BUMA.1121.00072,1,3031351,3044358,+,13007
364,BUMA.1121.00076,1,2183589,2196608,-,13019
364,BUMA.1121.00083,1,2538407,2551424,-,13017
364,BUMA.1121.00078,1,2872131,2885152,-,13021
364,BUMA.1121.00095,1,2554472,2567489,-,13017
364,BUMA.1121.00077,1,1787394,1800402,+,13008
364,BUMA.1121.00063,1,3043146,3056153,+,13007
364,BUMA.1121.00061,1,3046213,3059221,+,13008
364,BUMA.1121.00050,1,2581696,2594664,-,12968
364,BUMA.1121.00081,1,2102163,2115132,+,12969
364,BUMA.1121.00074,1,734666,747682,-,13016
364,BUMA.1121.00062,1,1422735,1435754,-,13019
364,BUMA.1121.00060,1,3175788,3188806,-,13018
364,BUMA.1121.00070,1,3017407,3030415,+,13008
364,BUMA.1121.00075,1,2615688,2628697,+,13009
364,BUMA.1121.00041,1,377821,390830,+,13009
364,BUMA.1121.00073,1,3044625,3057632,+,13007
364,BUMA.1121.00017,1,1456295,1469263,-,12968
364,BUMA.1121.00066,1,3034215,3047222,+,13007
364,BUMA.1121.00107,1,3062010,3075036,+,13026
364,BUMA.1121.00085,1,891889,904857,-,12968
364,BUMA.1121.00030,1,1456348,1469316,-,12968
364,BUMA.1121.00112,1,3939962,3952980,-,13018
364,BUMA.1121.00002,1,2664570,2677537,-,12967
364,BUMA.1121.00082,1,3227945,3240953,+,13008
364,BUMA.1121.00014,1,3784655,3797667,-,13012
364,BUMA.1121.00011,1,2474632,2487649,-,13017
364,BUMA.1121.00011,1,2510129,2522859,-,12730
364,BUMA.1121.00019,1,1521344,1534312,-,12968
364,BUMA.1121.00057,1,225742,238750,+,13008
364,BUMA.1121.00018,1,3755353,3768356,+,13003
364,BUMA.1121.00039,1,3271202,3284205,+,13003
364,BUMA.1121.00016,1,1236851,1249854,+,13003
364,BUMA.1121.00004,1,1522422,1535390,-,12968
364,BUMA.1121.00005,1,1858406,1871418,+,13012
364,BUMA.1121.00100,1,2156130,2169145,-,13015
364,BUMA.1121.00006,1,2101953,2114922,+,12969
365,BUMA.1121.00027,1,1327855,1355424,+,27569
365,BUMA.1121.00025,1,3610100,3637541,-,27441
365,BUMA.1121.00021,1,3800779,3828287,+,27508
365,BUMA.1121.00023,1,1477404,1504914,+,27510
365,BUMA.1121.00024,1,1489878,1517304,-,27426
365,BUMA.1121.00033,1,1357664,1385146,+,27482
365,BUMA.1121.00034,1,1527304,1554730,-,27426
365,BUMA.1121.00036,1,906178,933614,-,27436
365,BUMA.1121.00032,1,3020374,3047800,-,27426
365,BUMA.1121.00009,1,2391206,2418666,-,27460
365,BUMA.1121.00008,1,1493604,1521030,-,27426
365,BUMA.1121.00003,1,1659841,1687323,+,27482
365,BUMA.1121.00109,1,2741935,2769388,-,27453
365,BUMA.1121.00053,1,2899961,2927436,+,27475
365,BUMA.1121.00110,1,1651444,1678898,-,27454
365,BUMA.1121.00104,1,2084413,2111886,-,27473
365,BUMA.1121.00086,1,1865225,1892662,+,27437
365,BUMA.1121.00092,1,618421,645944,-,27523
365,BUMA.1121.00096,1,106792,134264,-,27472
365,BUMA.1121.00054,1,1996744,2024201,-,27457
365,BUMA.1121.00097,1,766093,793533,-,27440
365,BUMA.1121.00093,1,3980175,4007699,+,27524
365,BUMA.1121.00106,1,2889068,2916498,+,27430
365,BUMA.1121.00010,1,2610946,2638385,-,27439
365,BUMA.1121.00035,1,183210,210591,+,27381
365,BUMA.1121.00108,1,142934,170354,+,27420
365,BUMA.1121.00028,1,1489927,1517353,-,27426
365,BUMA.1121.00094,1,3123451,3150970,+,27519
365,BUMA.1121.00102,1,2127818,2155340,-,27522
365,BUMA.1121.00111,1,3326517,3353986,+,27469
365,BUMA.1121.00089,1,3094959,3122475,+,27516
365,BUMA.1121.00084,1,3503659,3531163,+,27504
365,BUMA.1121.00029,1,1756276,1783683,-,27407
365,BUMA.1121.00012,1,1892453,1919924,+,27471
365,BUMA.1121.00087,1,1424210,1451646,-,27436
365,BUMA.1121.00043,1,3272181,3299608,+,27427
365,BUMA.1121.00046,1,174048,201479,+,27431
365,BUMA.1121.00037,1,1774761,1802241,+,27480
365,BUMA.1121.00080,1,3155706,3183215,+,27509
365,BUMA.1121.00079,1,3188562,3216079,+,27517
365,BUMA.1121.00045,1,899226,926631,-,27405
365,BUMA.1121.00071,1,3066020,3093550,+,27530
365,BUMA.1121.00056,1,804371,831886,-,27515
365,BUMA.1121.00065,1,3203726,3231178,+,27452
365,BUMA.1121.00058,1,1351573,1379015,-,27442
365,BUMA.1121.00007,1,894614,922116,-,27502
365,BUMA.1121.00067,1,1257613,1285079,-,27466
365,BUMA.1121.00090,1,1215541,1242991,+,27450
365,BUMA.1121.00051,1,3106990,3134538,+,27548
365,BUMA.1121.00020,1,1554849,1582275,-,27426
365,BUMA.1121.00103,1,1203637,1231083,-,27446
365,BUMA.1121.00048,1,1911533,1938991,+,27458
365,BUMA.1121.00047,1,3845704,3873213,-,27509
365,BUMA.1121.00042,1,2895148,2922557,+,27409
365,BUMA.1121.00055,1,2819230,2846647,+,27417
365,BUMA.1121.00031,1,469095,496572,+,27477
365,BUMA.1121.00040,1,1419827,1447257,-,27430
365,BUMA.1121.00044,1,755402,782828,-,27426
365,BUMA.1121.00088,1,4111797,4139300,+,27503
365,BUMA.1121.00069,1,3046758,3074262,+,27504
365,BUMA.1121.00064,1,3143534,3170979,+,27445
365,BUMA.1121.00105,1,2037515,2064971,-,27456
365,BUMA.1121.00015,1,900612,928051,-,27439
365,BUMA.1121.00059,1,2366277,2393768,+,27491
365,BUMA.1121.00026,1,1964492,1991976,-,27484
365,BUMA.1121.00022,1,1756008,1783435,-,27427
365,BUMA.1121.00052,1,1263606,1291063,-,27457
365,BUMA.1121.00101,1,3287143,3314555,-,27412
365,BUMA.1121.00001,1,882537,909944,-,27407
365,BUMA.1121.00038,1,2118950,2146408,+,27458
365,BUMA.1121.00068,1,1933817,1961283,+,27466
365,BUMA.1121.00099,1,3251495,3278971,-,27476
365,BUMA.1121.00091,1,1326003,1353492,-,27489
365,BUMA.1121.00098,1,1796989,1824413,+,27424
365,BUMA.1121.00013,1,1464478,1491926,-,27448
365,BUMA.1121.00049,1,2654779,2682310,-,27531
365,BUMA.1121.00072,1,3048280,3075809,+,27529
365,BUMA.1121.00076,1,2152167,2179656,-,27489
365,BUMA.1121.00083,1,2506948,2534483,-,27535
365,BUMA.1121.00078,1,2840692,2868196,-,27504
365,BUMA.1121.00095,1,2523051,2550492,-,27441
365,BUMA.1121.00077,1,1804336,1831790,+,27454
365,BUMA.1121.00063,1,3060075,3087603,+,27528
365,BUMA.1121.00061,1,3063143,3090662,+,27519
365,BUMA.1121.00050,1,2550330,2577760,-,27430
365,BUMA.1121.00081,1,2119076,2146534,+,27458
365,BUMA.1121.00074,1,703267,730733,-,27466
365,BUMA.1121.00062,1,1391298,1418775,-,27477
365,BUMA.1121.00060,1,3144457,3171862,-,27405
365,BUMA.1121.00070,1,3034338,3061744,+,27406
365,BUMA.1121.00075,1,2632629,2660114,+,27485
365,BUMA.1121.00041,1,394782,422262,+,27480
365,BUMA.1121.00073,1,3061550,3089083,+,27533
365,BUMA.1121.00017,1,1424933,1452359,-,27426
365,BUMA.1121.00066,1,3051133,3078667,+,27534
365,BUMA.1121.00107,1,3078953,3106393,+,27440
365,BUMA.1121.00085,1,860496,887953,-,27457
365,BUMA.1121.00030,1,1424986,1452412,-,27426
365,BUMA.1121.00112,1,3908325,3936018,-,27693
365,BUMA.1121.00002,1,2633195,2660634,-,27439
365,BUMA.1121.00082,1,3244876,3272412,+,27536
365,BUMA.1121.00014,1,3753277,3780744,-,27467
365,BUMA.1121.00011,1,2443162,2470653,-,27491
365,BUMA.1121.00019,1,1489982,1517408,-,27426
365,BUMA.1121.00057,1,242673,270236,+,27563
365,BUMA.1121.00018,1,3772302,3799744,+,27442
365,BUMA.1121.00039,1,3288115,3315606,+,27491
365,BUMA.1121.00016,1,1253765,1281206,+,27441
365,BUMA.1121.00004,1,1491060,1518486,-,27426
365,BUMA.1121.00005,1,1875355,1902800,+,27445
365,BUMA.1121.00100,1,2124735,2152222,-,27487
365,BUMA.1121.00006,1,2118866,2146324,+,27458
366,BUMA.1121.00027,1,1356637,1373951,+,17314
366,BUMA.1121.00025,1,3591639,3608887,-,17248
366,BUMA.1121.00021,1,3829500,3846599,+,17099
366,BUMA.1121.00023,1,1506127,1523363,+,17236
366,BUMA.1121.00024,1,1470784,1487874,-,17090
366,BUMA.1121.00033,1,1386359,1403589,+,17230
366,BUMA.1121.00034,1,1508178,1525300,-,17122
366,BUMA.1121.00036,1,887162,904356,-,17194
366,BUMA.1121.00032,1,3001248,3018370,-,17122
366,BUMA.1121.00009,1,2372547,2389993,-,17446
366,BUMA.1121.00008,1,1474534,1491600,-,17066
366,BUMA.1121.00003,1,1688536,1705744,+,17208
366,BUMA.1121.00109,1,2723276,2740722,-,17446
366,BUMA.1121.00053,1,2928649,2946041,+,17392
366,BUMA.1121.00110,1,1633037,1650231,-,17194
366,BUMA.1121.00104,1,2066120,2083200,-,17080
366,BUMA.1121.00086,1,1895118,1912456,+,17338
366,BUMA.1121.00092,1,599996,617208,-,17212
366,BUMA.1121.00096,1,88372,105579,-,17207
366,BUMA.1121.00054,1,1978378,1995531,-,17153
366,BUMA.1121.00097,1,747657,764880,-,17223
366,BUMA.1121.00093,1,4008912,4026124,+,17212
366,BUMA.1121.00106,1,2917711,2934785,+,17074
366,BUMA.1121.00010,1,2592748,2609733,-,16985
366,BUMA.1121.00035,1,211804,228989,+,17185
366,BUMA.1121.00108,1,171568,188735,+,17167
366,BUMA.1121.00028,1,1470833,1487923,-,17090
366,BUMA.1121.00094,1,3152183,3169337,+,17154
366,BUMA.1121.00102,1,2109130,2126605,-,17475
366,BUMA.1121.00111,1,3355199,3372454,+,17255
366,BUMA.1121.00089,1,3123688,3141164,+,17476
366,BUMA.1121.00084,1,3532376,3549557,+,17181
366,BUMA.1121.00029,1,1737894,1755063,-,17169
366,BUMA.1121.00012,1,1921137,1938389,+,17252
366,BUMA.1121.00087,1,1404600,1421754,-,17154
366,BUMA.1121.00043,1,3300821,3318220,+,17399
366,BUMA.1121.00046,1,202692,220070,+,17378
366,BUMA.1121.00037,1,1803454,1820783,+,17329
366,BUMA.1121.00080,1,3184428,3201948,+,17520
366,BUMA.1121.00079,1,3217292,3234470,+,17178
366,BUMA.1121.00045,1,880769,898013,-,17244
366,BUMA.1121.00071,1,3094763,3111929,+,17166
366,BUMA.1121.00056,1,785650,803158,-,17508
366,BUMA.1121.00065,1,3232392,3249832,+,17440
366,BUMA.1121.00058,1,1333097,1350359,-,17262
366,BUMA.1121.00007,1,876228,893401,-,17173
366,BUMA.1121.00067,1,1239236,1256400,-,17164
366,BUMA.1121.00090,1,1244204,1261328,+,17124
366,BUMA.1121.00051,1,3135751,3153139,+,17388
366,BUMA.1121.00020,1,1535747,1552845,-,17098
366,BUMA.1121.00103,1,1184666,1202424,-,17758
366,BUMA.1121.00048,1,1940204,1957357,+,17153
366,BUMA.1121.00047,1,3827087,3844491,-,17404
366,BUMA.1121.00042,1,2923770,2940955,+,17185
366,BUMA.1121.00055,1,2847860,2864961,+,17101
366,BUMA.1121.00031,1,497785,515111,+,17326
366,BUMA.1121.00040,1,1401349,1418614,-,17265
366,BUMA.1121.00044,1,736284,753398,-,17114
366,BUMA.1121.00088,1,1,17131,+,17130
366,BUMA.1121.00069,1,3075475,3092775,+,17300
366,BUMA.1121.00064,1,3172192,3189296,+,17104
366,BUMA.1121.00105,1,2019018,2036301,-,17283
366,BUMA.1121.00015,1,882150,899399,-,17249
366,BUMA.1121.00059,1,2394981,2412117,+,17136
366,BUMA.1121.00026,1,1946149,1963279,-,17130
366,BUMA.1121.00022,1,1736342,1753552,-,17210
366,BUMA.1121.00052,1,1245119,1262393,-,17274
366,BUMA.1121.00101,1,3268631,3285930,-,17299
366,BUMA.1121.00001,1,864043,881324,-,17281
366,BUMA.1121.00038,1,2147621,2164774,+,17153
366,BUMA.1121.00068,1,1962496,1979776,+,17280
366,BUMA.1121.00099,1,3233059,3250282,-,17223
366,BUMA.1121.00091,1,1307419,1324790,-,17371
366,BUMA.1121.00098,1,1825626,1842817,+,17191
366,BUMA.1121.00013,1,1445944,1463265,-,17321
366,BUMA.1121.00049,1,2636302,2653565,-,17263
366,BUMA.1121.00072,1,3077022,3093997,+,16975
366,BUMA.1121.00076,1,2133681,2150953,-,17272
366,BUMA.1121.00083,1,2488429,2505735,-,17306
366,BUMA.1121.00078,1,2821896,2839479,-,17583
366,BUMA.1121.00095,1,2504756,2521838,-,17082
366,BUMA.1121.00077,1,1833003,1850301,+,17298
366,BUMA.1121.00063,1,3088816,3106154,+,17338
366,BUMA.1121.00061,1,3091875,3109213,+,17338
366,BUMA.1121.00050,1,2531796,2549117,-,17321
366,BUMA.1121.00081,1,2147747,2164900,+,17153
366,BUMA.1121.00074,1,684958,702054,-,17096
366,BUMA.1121.00062,1,1372863,1390085,-,17222
366,BUMA.1121.00060,1,3126000,3143244,-,17244
366,BUMA.1121.00070,1,3062957,3080295,+,17338
366,BUMA.1121.00075,1,2661328,2678720,+,17392
366,BUMA.1121.00041,1,423476,440754,+,17278
366,BUMA.1121.00073,1,3090296,3107634,+,17338
366,BUMA.1121.00017,1,1405815,1422929,-,17114
366,BUMA.1121.00066,1,3079880,3097031,+,17151
366,BUMA.1121.00107,1,3107606,3124778,+,17172
366,BUMA.1121.00085,1,841954,859283,-,17329
366,BUMA.1121.00030,1,1405868,1422982,-,17114
366,BUMA.1121.00112,1,3889981,3907112,-,17131
366,BUMA.1121.00002,1,2614941,2631982,-,17041
366,BUMA.1121.00082,1,3273625,3290963,+,17338
366,BUMA.1121.00014,1,3734746,3752064,-,17318
366,BUMA.1121.00011,1,2424704,2441949,-,17245
366,BUMA.1121.00019,1,1470880,1487978,-,17098
366,BUMA.1121.00057,1,271449,288868,+,17419
366,BUMA.1121.00018,1,3800957,3818213,+,17256
366,BUMA.1121.00039,1,3316819,3334361,+,17542
366,BUMA.1121.00016,1,1282419,1299691,+,17272
366,BUMA.1121.00004,1,1471990,1489056,-,17066
366,BUMA.1121.00005,1,1904013,1921462,+,17449
366,BUMA.1121.00100,1,2106080,2123522,-,17442
366,BUMA.1121.00006,1,2147537,2164682,+,17145
367,BUMA.1121.00027,1,1373959,1388114,+,14155
367,BUMA.1121.00025,1,3577477,3591631,-,14154
367,BUMA.1121.00021,1,3846607,3860761,+,14154
367,BUMA.1121.00023,1,1523371,1537525,+,14154
367,BUMA.1121.00024,1,1456620,1470776,-,14156
367,BUMA.1121.00033,1,1403597,1417751,+,14154
367,BUMA.1121.00034,1,1494014,1508170,-,14156
367,BUMA.1121.00036,1,872998,887154,-,14156
367,BUMA.1121.00032,1,2987084,3001240,-,14156
367,BUMA.1121.00009,1,2358388,2372539,-,14151
367,BUMA.1121.00008,1,1460370,1474526,-,14156
367,BUMA.1121.00003,1,1705752,1719917,+,14165
367,BUMA.1121.00109,1,2709109,2723268,-,14159
367,BUMA.1121.00053,1,2946049,2960204,+,14155
367,BUMA.1121.00110,1,1618873,1633029,-,14156
367,BUMA.1121.00104,1,2051958,2066112,-,14154
367,BUMA.1121.00086,1,1912464,1926620,+,14156
367,BUMA.1121.00092,1,584238,598392,-,14154
367,BUMA.1121.00096,1,74219,88364,-,14145
367,BUMA.1121.00054,1,1964214,1978370,-,14156
367,BUMA.1121.00097,1,733483,747649,-,14166
367,BUMA.1121.00093,1,4027728,4041882,+,14154
367,BUMA.1121.00106,1,2934793,2948947,+,14154
367,BUMA.1121.00010,1,2578584,2592740,-,14156
367,BUMA.1121.00035,1,228997,243151,+,14154
367,BUMA.1121.00108,1,188743,202882,+,14139
367,BUMA.1121.00028,1,1456669,1470825,-,14156
367,BUMA.1121.00094,1,3169359,3183504,+,14145
367,BUMA.1121.00102,1,2094966,2109122,-,14156
367,BUMA.1121.00111,1,3374058,3388212,+,14154
367,BUMA.1121.00089,1,3141172,3155322,+,14150
367,BUMA.1121.00084,1,3549583,3563733,+,14150
367,BUMA.1121.00029,1,1723732,1737886,-,14154
367,BUMA.1121.00012,1,1938397,1952551,+,14154
367,BUMA.1121.00087,1,1390436,1404592,-,14156
367,BUMA.1121.00043,1,3318228,3332382,+,14154
367,BUMA.1121.00046,1,220078,234234,+,14156
367,BUMA.1121.00037,1,1820791,1834945,+,14154
367,BUMA.1121.00080,1,3201956,3216106,+,14150
367,BUMA.1121.00079,1,3234478,3248628,+,14150
367,BUMA.1121.00045,1,866588,880743,-,14155
367,BUMA.1121.00071,1,3111937,3126093,+,14156
367,BUMA.1121.00056,1,771492,785642,-,14150
367,BUMA.1121.00065,1,3249840,3263975,+,14135
367,BUMA.1121.00058,1,1318946,1333089,-,14143
367,BUMA.1121.00007,1,862066,876220,-,14154
367,BUMA.1121.00067,1,1225074,1239228,-,14154
367,BUMA.1121.00090,1,1261336,1275490,+,14154
367,BUMA.1121.00051,1,3153147,3167297,+,14150
367,BUMA.1121.00020,1,1521583,1535739,-,14156
367,BUMA.1121.00103,1,1170511,1184657,-,14146
367,BUMA.1121.00048,1,1957365,1971521,+,14156
367,BUMA.1121.00047,1,3812929,3827079,-,14150
367,BUMA.1121.00042,1,2940963,2955119,+,14156
367,BUMA.1121.00055,1,2864969,2879123,+,14154
367,BUMA.1121.00031,1,515119,529273,+,14154
367,BUMA.1121.00040,1,1387188,1401341,-,14153
367,BUMA.1121.00044,1,722120,736276,-,14156
367,BUMA.1121.00088,1,17139,31293,+,14154
367,BUMA.1121.00069,1,3092783,3106939,+,14156
367,BUMA.1121.00064,1,3189304,3203458,+,14154
367,BUMA.1121.00105,1,2004856,2019010,-,14154
367,BUMA.1121.00015,1,867986,882142,-,14156
367,BUMA.1121.00059,1,2412131,2426279,+,14148
367,BUMA.1121.00026,1,1931985,1946141,-,14156
367,BUMA.1121.00022,1,1722178,1736334,-,14156
367,BUMA.1121.00052,1,1230955,1245111,-,14156
367,BUMA.1121.00101,1,3254472,3268623,-,14151
367,BUMA.1121.00001,1,849881,864035,-,14154
367,BUMA.1121.00038,1,2164782,2178938,+,14156
367,BUMA.1121.00068,1,1979784,1993940,+,14156
367,BUMA.1121.00099,1,3218897,3233051,-,14154
367,BUMA.1121.00091,1,1293255,1307411,-,14156
367,BUMA.1121.00098,1,1842825,1856973,+,14148
367,BUMA.1121.00013,1,1431780,1445936,-,14156
367,BUMA.1121.00049,1,2622140,2636294,-,14154
367,BUMA.1121.00072,1,3094005,3108161,+,14156
367,BUMA.1121.00076,1,2119537,2133673,-,14136
367,BUMA.1121.00083,1,2474265,2488421,-,14156
367,BUMA.1121.00078,1,2807732,2821888,-,14156
367,BUMA.1121.00095,1,2490577,2504730,-,14153
367,BUMA.1121.00077,1,1850309,1864464,+,14155
367,BUMA.1121.00063,1,3106162,3120318,+,14156
367,BUMA.1121.00061,1,3109221,3123377,+,14156
367,BUMA.1121.00050,1,2517632,2531788,-,14156
367,BUMA.1121.00081,1,2164908,2179064,+,14156
367,BUMA.1121.00074,1,670796,684950,-,14154
367,BUMA.1121.00062,1,1358716,1372855,-,14139
367,BUMA.1121.00060,1,3111819,3125974,-,14155
367,BUMA.1121.00070,1,3080303,3094459,+,14156
367,BUMA.1121.00075,1,2678728,2692864,+,14136
367,BUMA.1121.00041,1,440762,454916,+,14154
367,BUMA.1121.00073,1,3107642,3121798,+,14156
367,BUMA.1121.00017,1,1391651,1405807,-,14156
367,BUMA.1121.00066,1,3097039,3111192,+,14153
367,BUMA.1121.00107,1,3124786,3138934,+,14148
367,BUMA.1121.00085,1,827790,841946,-,14156
367,BUMA.1121.00030,1,1391704,1405860,-,14156
367,BUMA.1121.00112,1,3875817,3889973,-,14156
367,BUMA.1121.00002,1,2600777,2614933,-,14156
367,BUMA.1121.00082,1,3290971,3305127,+,14156
367,BUMA.1121.00014,1,3720585,3734738,-,14153
367,BUMA.1121.00011,1,2410542,2424696,-,14154
367,BUMA.1121.00019,1,1456716,1470872,-,14156
367,BUMA.1121.00057,1,288876,303032,+,14156
367,BUMA.1121.00018,1,3818221,3832375,+,14154
367,BUMA.1121.00039,1,3334369,3348523,+,14154
367,BUMA.1121.00016,1,1299699,1313853,+,14154
367,BUMA.1121.00004,1,1457826,1471982,-,14156
367,BUMA.1121.00005,1,1921477,1935629,+,14152
367,BUMA.1121.00100,1,2091918,2106072,-,14154
367,BUMA.1121.00006,1,2164690,2178846,+,14156
368,BUMA.1121.00027,1,1388581,1408604,+,20023
368,BUMA.1121.00025,1,3556997,3577009,-,20012
368,BUMA.1121.00021,1,3861228,3881253,+,20025
368,BUMA.1121.00023,1,1537993,1557999,+,20006
368,BUMA.1121.00033,1,1418218,1438234,+,20016
368,BUMA.1121.00009,1,2337909,2357921,-,20012
368,BUMA.1121.00003,1,1720376,1740409,+,20033
368,BUMA.1121.00109,1,2688636,2708648,-,20012
368,BUMA.1121.00053,1,2960671,2980696,+,20025
368,BUMA.1121.00110,1,1598401,1618413,-,20012
368,BUMA.1121.00104,1,2031465,2051490,-,20025
368,BUMA.1121.00092,1,563746,583770,-,20024
368,BUMA.1121.00096,1,53725,73759,-,20034
368,BUMA.1121.00097,1,712987,733022,-,20035
368,BUMA.1121.00093,1,4042350,4062373,+,20023
368,BUMA.1121.00106,1,2949415,2969438,+,20023
368,BUMA.1121.00035,1,243618,263635,+,20017
368,BUMA.1121.00108,1,203343,223359,+,20016
368,BUMA.1121.00094,1,3183972,3203995,+,20023
368,BUMA.1121.00102,1,2074459,2094499,-,20040
368,BUMA.1121.00111,1,3388679,3408688,+,20009
368,BUMA.1121.00089,1,3155790,3175805,+,20015
368,BUMA.1121.00084,1,3564201,3584224,+,20023
368,BUMA.1121.00029,1,1703248,1723265,-,20017
368,BUMA.1121.00012,1,1953018,1973043,+,20025
368,BUMA.1121.00043,1,3332849,3352862,+,20013
368,BUMA.1121.00037,1,1835412,1855424,+,20012
368,BUMA.1121.00080,1,3216575,3236590,+,20015
368,BUMA.1121.00079,1,3249096,3269118,+,20022
368,BUMA.1121.00045,1,846116,866130,-,20014
368,BUMA.1121.00071,1,3126561,3146580,+,20019
368,BUMA.1121.00056,1,751008,771024,-,20016
368,BUMA.1121.00065,1,3264443,3284454,+,20011
368,BUMA.1121.00058,1,1280573,1300588,-,20015
368,BUMA.1121.00007,1,839965,859966,-,20001
368,BUMA.1121.00067,1,1204583,1224606,-,20023
368,BUMA.1121.00090,1,1275957,1295970,+,20013
368,BUMA.1121.00051,1,3167765,3187780,+,20015
368,BUMA.1121.00103,1,1150015,1170053,-,20038
368,BUMA.1121.00047,1,3792435,3812468,-,20033
368,BUMA.1121.00055,1,2879591,2899605,+,20014
368,BUMA.1121.00031,1,529739,549752,+,20013
368,BUMA.1121.00088,1,31760,51779,+,20019
368,BUMA.1121.00069,1,3107407,3127426,+,20019
368,BUMA.1121.00064,1,3203926,3223945,+,20019
368,BUMA.1121.00105,1,1984377,2004388,-,20011
368,BUMA.1121.00059,1,2444637,2464668,+,20031
368,BUMA.1121.00101,1,3234008,3254014,-,20006
368,BUMA.1121.00001,1,829396,849414,-,20018
368,BUMA.1121.00068,1,1994400,2014419,+,20019
368,BUMA.1121.00099,1,3198397,3218439,-,20042
368,BUMA.1121.00091,1,1272770,1292787,-,20017
368,BUMA.1121.00098,1,1857434,1877454,+,20020
368,BUMA.1121.00049,1,2601654,2621672,-,20018
368,BUMA.1121.00072,1,3108629,3128648,+,20019
368,BUMA.1121.00076,1,2099050,2119069,-,20019
368,BUMA.1121.00083,1,2453777,2473797,-,20020
368,BUMA.1121.00078,1,2787217,2807265,-,20048
368,BUMA.1121.00095,1,2470087,2490116,-,20029
368,BUMA.1121.00077,1,1864924,1884933,+,20009
368,BUMA.1121.00063,1,3120786,3140805,+,20019
368,BUMA.1121.00061,1,3123845,3143864,+,20019
368,BUMA.1121.00074,1,650305,670328,-,20023
368,BUMA.1121.00062,1,1338224,1358248,-,20024
368,BUMA.1121.00060,1,3091347,3111361,-,20014
368,BUMA.1121.00070,1,3094927,3114946,+,20019
368,BUMA.1121.00075,1,2693332,2713348,+,20016
368,BUMA.1121.00041,1,455384,475414,+,20030
368,BUMA.1121.00073,1,3122266,3142285,+,20019
368,BUMA.1121.00066,1,3111663,3131682,+,20019
368,BUMA.1121.00107,1,3139401,3159428,+,20027
368,BUMA.1121.00112,1,3855348,3875359,-,20011
368,BUMA.1121.00082,1,3305595,3325614,+,20019
368,BUMA.1121.00014,1,3700103,3720118,-,20015
368,BUMA.1121.00011,1,2390039,2410082,-,20043
368,BUMA.1121.00057,1,303500,323524,+,20024
368,BUMA.1121.00018,1,3832843,3852854,+,20011
368,BUMA.1121.00039,1,3348990,3369001,+,20011
368,BUMA.1121.00016,1,1314320,1334346,+,20026
368,BUMA.1121.00005,1,1954451,1974465,+,20014
368,BUMA.1121.00100,1,2071445,2091458,-,20013
369,BUMA.1121.00027,1,1408606,1428742,+,20136
369,BUMA.1121.00025,1,3536864,3556996,-,20132
369,BUMA.1121.00021,1,3881255,3901381,+,20126
369,BUMA.1121.00023,1,1558001,1578133,+,20132
369,BUMA.1121.00024,1,1246389,1266521,-,20132
369,BUMA.1121.00033,1,1438236,1458365,+,20129
369,BUMA.1121.00034,1,1283777,1303909,-,20132
369,BUMA.1121.00036,1,2707682,2727814,+,20132
369,BUMA.1121.00032,1,2776759,2796891,-,20132
369,BUMA.1121.00009,1,2317776,2337908,-,20132
369,BUMA.1121.00008,1,1250103,1270235,-,20132
369,BUMA.1121.00003,1,1740411,1760543,+,20132
369,BUMA.1121.00109,1,2668503,2688635,-,20132
369,BUMA.1121.00053,1,2980698,3000830,+,20132
369,BUMA.1121.00110,1,1578268,1598400,-,20132
369,BUMA.1121.00104,1,2011331,2031463,-,20132
369,BUMA.1121.00086,1,2120132,2140264,+,20132
369,BUMA.1121.00092,1,543613,563745,-,20132
369,BUMA.1121.00096,1,33594,53724,-,20130
369,BUMA.1121.00054,1,1754058,1774190,-,20132
369,BUMA.1121.00097,1,692854,712986,-,20132
369,BUMA.1121.00093,1,4062375,4082507,+,20132
369,BUMA.1121.00106,1,2969440,2989584,+,20144
369,BUMA.1121.00010,1,1584231,1604363,-,20132
369,BUMA.1121.00035,1,263637,283769,+,20132
369,BUMA.1121.00108,1,223361,243493,+,20132
369,BUMA.1121.00028,1,1246433,1266565,-,20132
369,BUMA.1121.00094,1,3203997,3224129,+,20132
369,BUMA.1121.00102,1,2054326,2074458,-,20132
369,BUMA.1121.00111,1,3408690,3428822,+,20132
369,BUMA.1121.00089,1,3175807,3195939,+,20132
369,BUMA.1121.00084,1,3584226,3604358,+,20132
369,BUMA.1121.00029,1,1683115,1703247,-,20132
369,BUMA.1121.00012,1,1973045,1993177,+,20132
369,BUMA.1121.00087,1,1176825,1196957,-,20132
369,BUMA.1121.00043,1,3352864,3372990,+,20126
369,BUMA.1121.00046,1,423072,443204,+,20132
369,BUMA.1121.00037,1,1855426,1875558,+,20132
369,BUMA.1121.00080,1,3236592,3256718,+,20126
369,BUMA.1121.00079,1,3269120,3289263,+,20143
369,BUMA.1121.00045,1,825971,846115,-,20144
369,BUMA.1121.00071,1,3146582,3166720,+,20138
369,BUMA.1121.00056,1,730875,751007,-,20132
369,BUMA.1121.00065,1,3284456,3304588,+,20132
369,BUMA.1121.00058,1,1260434,1280572,-,20138
369,BUMA.1121.00007,1,819826,839964,-,20138
369,BUMA.1121.00067,1,1184444,1204582,-,20138
369,BUMA.1121.00090,1,1295972,1316104,+,20132
369,BUMA.1121.00051,1,3187782,3207908,+,20126
369,BUMA.1121.00020,1,1311322,1331454,-,20132
369,BUMA.1121.00103,1,1129878,1150014,-,20136
369,BUMA.1121.00048,1,2161551,2181683,+,20132
369,BUMA.1121.00047,1,3772308,3792434,-,20126
369,BUMA.1121.00042,1,2956885,2977017,+,20132
369,BUMA.1121.00055,1,2899607,2919739,+,20132
369,BUMA.1121.00031,1,549754,569894,+,20140
369,BUMA.1121.00040,1,1175253,1195385,-,20132
369,BUMA.1121.00044,1,511875,532007,-,20132
369,BUMA.1121.00088,1,51781,71913,+,20132
369,BUMA.1121.00069,1,3127428,3147566,+,20138
369,BUMA.1121.00064,1,3223947,3244085,+,20138
369,BUMA.1121.00105,1,1964238,1984376,-,20138
369,BUMA.1121.00015,1,2901563,2921695,+,20132
369,BUMA.1121.00059,1,2464670,2484814,+,20144
369,BUMA.1121.00026,1,1910185,1930317,-,20132
369,BUMA.1121.00022,1,1508479,1528611,-,20132
369,BUMA.1121.00052,1,937701,957833,-,20132
369,BUMA.1121.00101,1,3213881,3234007,-,20126
369,BUMA.1121.00001,1,809263,829395,-,20132
369,BUMA.1121.00038,1,2368963,2389095,+,20132
369,BUMA.1121.00068,1,2014421,2034557,+,20136
369,BUMA.1121.00099,1,3178264,3198396,-,20132
369,BUMA.1121.00091,1,1252637,1272769,-,20132
369,BUMA.1121.00098,1,1877456,1897588,+,20132
369,BUMA.1121.00013,1,28550,48682,+,20132
369,BUMA.1121.00049,1,2581509,2601653,-,20144
369,BUMA.1121.00072,1,3128650,3148788,+,20138
369,BUMA.1121.00076,1,2078917,2099049,-,20132
369,BUMA.1121.00083,1,2433638,2453776,-,20138
369,BUMA.1121.00078,1,2767084,2787216,-,20132
369,BUMA.1121.00095,1,2449959,2470085,-,20126
369,BUMA.1121.00077,1,1884935,1905068,+,20133
369,BUMA.1121.00063,1,3140807,3160945,+,20138
369,BUMA.1121.00061,1,3143866,3164004,+,20138
369,BUMA.1121.00050,1,2308671,2328803,-,20132
369,BUMA.1121.00081,1,2369090,2389222,+,20132
369,BUMA.1121.00074,1,630166,650304,-,20138
369,BUMA.1121.00062,1,1318079,1338223,-,20144
369,BUMA.1121.00060,1,3071203,3091346,-,20143
369,BUMA.1121.00070,1,3114948,3135086,+,20138
369,BUMA.1121.00075,1,2713350,2733482,+,20132
369,BUMA.1121.00041,1,475416,495542,+,20126
369,BUMA.1121.00073,1,3142287,3162425,+,20138
369,BUMA.1121.00017,1,1181414,1201546,-,20132
369,BUMA.1121.00066,1,3131684,3151822,+,20138
369,BUMA.1121.00107,1,3159430,3179574,+,20144
369,BUMA.1121.00085,1,534536,554668,-,20132
369,BUMA.1121.00030,1,1181454,1201586,-,20132
369,BUMA.1121.00112,1,3835215,3855347,-,20132
369,BUMA.1121.00002,1,1610496,1630628,-,20132
369,BUMA.1121.00082,1,3325616,3345754,+,20138
369,BUMA.1121.00014,1,3679970,3700102,-,20132
369,BUMA.1121.00011,1,2369900,2390038,-,20138
369,BUMA.1121.00019,1,1246445,1266577,-,20132
369,BUMA.1121.00057,1,323526,343664,+,20138
369,BUMA.1121.00018,1,3852856,3872988,+,20132
369,BUMA.1121.00039,1,3369003,3389141,+,20138
369,BUMA.1121.00016,1,1334348,1354480,+,20132
369,BUMA.1121.00004,1,1247605,1267737,-,20132
369,BUMA.1121.00005,1,1974467,1994599,+,20132
369,BUMA.1121.00100,1,2051297,2071444,-,20147
369,BUMA.1121.00006,1,2368880,2389012,+,20132
370,BUMA.1121.00027,1,1428747,1438388,+,9641
370,BUMA.1121.00025,1,3527210,3536859,-,9649
370,BUMA.1121.00021,1,3901386,3911034,+,9648
370,BUMA.1121.00023,1,1578138,1587786,+,9648
370,BUMA.1121.00024,1,1236735,1246384,-,9649
370,BUMA.1121.00033,1,1458370,1468015,+,9645
370,BUMA.1121.00034,1,1274123,1283772,-,9649
370,BUMA.1121.00036,1,2727819,2737467,+,9648
370,BUMA.1121.00032,1,2767105,2776754,-,9649
370,BUMA.1121.00009,1,2308122,2317771,-,9649
370,BUMA.1121.00008,1,1240449,1250098,-,9649
370,BUMA.1121.00003,1,1760548,1770196,+,9648
370,BUMA.1121.00109,1,2658849,2668498,-,9649
370,BUMA.1121.00053,1,3000835,3010483,+,9648
370,BUMA.1121.00110,1,1568614,1578263,-,9649
370,BUMA.1121.00104,1,2001677,2011326,-,9649
370,BUMA.1121.00086,1,2140269,2149917,+,9648
370,BUMA.1121.00092,1,533959,543608,-,9649
370,BUMA.1121.00096,1,23940,33589,-,9649
370,BUMA.1121.00054,1,1744404,1754053,-,9649
370,BUMA.1121.00097,1,683200,692849,-,9649
370,BUMA.1121.00093,1,4082512,4092176,+,9664
370,BUMA.1121.00106,1,2989589,2999237,+,9648
370,BUMA.1121.00010,1,1574577,1584226,-,9649
370,BUMA.1121.00035,1,283774,293423,+,9649
370,BUMA.1121.00108,1,243498,253146,+,9648
370,BUMA.1121.00028,1,1236779,1246428,-,9649
370,BUMA.1121.00094,1,3224134,3233782,+,9648
370,BUMA.1121.00102,1,2044671,2054321,-,9650
370,BUMA.1121.00111,1,3428827,3438475,+,9648
370,BUMA.1121.00089,1,3195944,3205592,+,9648
370,BUMA.1121.00084,1,3604363,3614011,+,9648
370,BUMA.1121.00029,1,1673461,1683110,-,9649
370,BUMA.1121.00012,1,1993182,2002830,+,9648
370,BUMA.1121.00087,1,1167171,1176820,-,9649
370,BUMA.1121.00043,1,3372995,3382643,+,9648
370,BUMA.1121.00046,1,444474,454097,+,9623
370,BUMA.1121.00037,1,1875563,1885211,+,9648
370,BUMA.1121.00080,1,3256723,3266371,+,9648
370,BUMA.1121.00079,1,3289268,3298916,+,9648
370,BUMA.1121.00045,1,816317,825966,-,9649
370,BUMA.1121.00071,1,3166725,3176373,+,9648
370,BUMA.1121.00056,1,721221,730870,-,9649
370,BUMA.1121.00065,1,3304593,3314241,+,9648
370,BUMA.1121.00058,1,1250780,1260429,-,9649
370,BUMA.1121.00007,1,810172,819821,-,9649
370,BUMA.1121.00067,1,1174790,1184439,-,9649
370,BUMA.1121.00090,1,1316109,1325757,+,9648
370,BUMA.1121.00051,1,3207913,3217561,+,9648
370,BUMA.1121.00020,1,1301668,1311317,-,9649
370,BUMA.1121.00103,1,1120224,1129873,-,9649
370,BUMA.1121.00048,1,2181688,2191336,+,9648
370,BUMA.1121.00047,1,3762654,3772303,-,9649
370,BUMA.1121.00042,1,2977022,2986670,+,9648
370,BUMA.1121.00055,1,2919744,2929392,+,9648
370,BUMA.1121.00031,1,569899,579547,+,9648
370,BUMA.1121.00040,1,1165599,1175248,-,9649
370,BUMA.1121.00044,1,502221,511870,-,9649
370,BUMA.1121.00088,1,71918,81566,+,9648
370,BUMA.1121.00069,1,3147571,3157219,+,9648
370,BUMA.1121.00064,1,3244090,3253738,+,9648
370,BUMA.1121.00105,1,1954584,1964233,-,9649
370,BUMA.1121.00015,1,2921700,2931348,+,9648
370,BUMA.1121.00059,1,2484819,2494467,+,9648
370,BUMA.1121.00026,1,1900531,1910180,-,9649
370,BUMA.1121.00022,1,1498825,1508474,-,9649
370,BUMA.1121.00052,1,928047,937696,-,9649
370,BUMA.1121.00101,1,3204227,3213876,-,9649
370,BUMA.1121.00001,1,799609,809258,-,9649
370,BUMA.1121.00038,1,2389100,2398748,+,9648
370,BUMA.1121.00068,1,2034562,2044210,+,9648
370,BUMA.1121.00099,1,3168610,3178259,-,9649
370,BUMA.1121.00091,1,1242983,1252632,-,9649
370,BUMA.1121.00098,1,1897593,1907241,+,9648
370,BUMA.1121.00013,1,48687,58335,+,9648
370,BUMA.1121.00049,1,2571855,2581504,-,9649
370,BUMA.1121.00072,1,3148793,3158441,+,9648
370,BUMA.1121.00076,1,2069263,2078912,-,9649
370,BUMA.1121.00083,1,2423984,2433633,-,9649
370,BUMA.1121.00078,1,2757430,2767079,-,9649
370,BUMA.1121.00095,1,2440305,2449954,-,9649
370,BUMA.1121.00077,1,1905073,1914720,+,9647
370,BUMA.1121.00063,1,3160950,3170598,+,9648
370,BUMA.1121.00061,1,3164009,3173657,+,9648
370,BUMA.1121.00050,1,2297777,2307401,-,9624
370,BUMA.1121.00081,1,2389227,2398875,+,9648
370,BUMA.1121.00074,1,620512,630161,-,9649
370,BUMA.1121.00062,1,1308425,1318074,-,9649
370,BUMA.1121.00060,1,3061549,3071198,-,9649
370,BUMA.1121.00070,1,3135091,3144739,+,9648
370,BUMA.1121.00075,1,2733487,2743135,+,9648
370,BUMA.1121.00041,1,495547,505194,+,9647
370,BUMA.1121.00073,1,3162430,3172078,+,9648
370,BUMA.1121.00017,1,1171760,1181409,-,9649
370,BUMA.1121.00066,1,3151827,3161475,+,9648
370,BUMA.1121.00107,1,3179579,3189227,+,9648
370,BUMA.1121.00085,1,524882,534531,-,9649
370,BUMA.1121.00030,1,1171800,1181449,-,9649
370,BUMA.1121.00112,1,3825561,3835210,-,9649
370,BUMA.1121.00002,1,1600842,1610491,-,9649
370,BUMA.1121.00082,1,3345759,3355407,+,9648
370,BUMA.1121.00014,1,3670316,3679965,-,9649
370,BUMA.1121.00011,1,2360246,2369895,-,9649
370,BUMA.1121.00019,1,1236791,1246440,-,9649
370,BUMA.1121.00057,1,343669,353317,+,9648
370,BUMA.1121.00018,1,3872993,3882640,+,9647
370,BUMA.1121.00039,1,3389146,3398794,+,9648
370,BUMA.1121.00016,1,1354485,1364131,+,9646
370,BUMA.1121.00004,1,1237951,1247600,-,9649
370,BUMA.1121.00005,1,1994604,2004252,+,9648
370,BUMA.1121.00100,1,2041642,2051292,-,9650
370,BUMA.1121.00006,1,2389017,2398665,+,9648
371,BUMA.1121.00027,1,1438390,1451346,+,12956
371,BUMA.1121.00025,1,3514262,3527209,-,12947
371,BUMA.1121.00021,1,3911036,3923993,+,12957
371,BUMA.1121.00023,1,1587788,1600744,+,12956
371,BUMA.1121.00024,1,1223778,1236734,-,12956
371,BUMA.1121.00033,1,1468017,1480970,+,12953
371,BUMA.1121.00034,1,1261166,1274122,-,12956
371,BUMA.1121.00036,1,2737469,2750425,+,12956
371,BUMA.1121.00032,1,2754148,2767104,-,12956
371,BUMA.1121.00009,1,2295176,2308121,-,12945
371,BUMA.1121.00008,1,1227492,1240448,-,12956
371,BUMA.1121.00003,1,1770198,1783157,+,12959
371,BUMA.1121.00109,1,2645904,2658848,-,12944
371,BUMA.1121.00053,1,3010485,3023430,+,12945
371,BUMA.1121.00110,1,1555665,1568613,-,12948
371,BUMA.1121.00104,1,1988719,2001676,-,12957
371,BUMA.1121.00086,1,2149919,2162875,+,12956
371,BUMA.1121.00092,1,521001,533958,-,12957
371,BUMA.1121.00096,1,10980,23939,-,12959
371,BUMA.1121.00054,1,1731447,1744403,-,12956
371,BUMA.1121.00097,1,670251,683199,-,12948
371,BUMA.1121.00093,1,1,12900,+,12899
371,BUMA.1121.00106,1,2999239,3012187,+,12948
371,BUMA.1121.00010,1,1561620,1574576,-,12956
371,BUMA.1121.00035,1,293425,306373,+,12948
371,BUMA.1121.00108,1,253148,266084,+,12936
371,BUMA.1121.00028,1,1223822,1236778,-,12956
371,BUMA.1121.00094,1,3233784,3246731,+,12947
371,BUMA.1121.00102,1,2031713,2044670,-,12957
371,BUMA.1121.00111,1,3438477,3451433,+,12956
371,BUMA.1121.00089,1,3205594,3218550,+,12956
371,BUMA.1121.00084,1,3614013,3626971,+,12958
371,BUMA.1121.00029,1,1660514,1673460,-,12946
371,BUMA.1121.00012,1,2002832,2015788,+,12956
371,BUMA.1121.00087,1,1154214,1167170,-,12956
371,BUMA.1121.00043,1,3382645,3395601,+,12956
371,BUMA.1121.00046,1,454099,467055,+,12956
371,BUMA.1121.00037,1,1885213,1898169,+,12956
371,BUMA.1121.00080,1,3266373,3279320,+,12947
371,BUMA.1121.00079,1,3298918,3311865,+,12947
371,BUMA.1121.00045,1,803381,816316,-,12935
371,BUMA.1121.00071,1,3176375,3189332,+,12957
371,BUMA.1121.00056,1,708264,721220,-,12956
371,BUMA.1121.00065,1,3314243,3327190,+,12947
371,BUMA.1121.00058,1,1237823,1250779,-,12956
371,BUMA.1121.00007,1,797212,810171,-,12959
371,BUMA.1121.00067,1,1161841,1174789,-,12948
371,BUMA.1121.00090,1,1325759,1338715,+,12956
371,BUMA.1121.00051,1,3217563,3230510,+,12947
371,BUMA.1121.00020,1,1288711,1301667,-,12956
371,BUMA.1121.00103,1,1107287,1120223,-,12936
371,BUMA.1121.00048,1,2191338,2204294,+,12956
371,BUMA.1121.00047,1,3749706,3762653,-,12947
371,BUMA.1121.00042,1,2986672,2999628,+,12956
371,BUMA.1121.00055,1,2929394,2942351,+,12957
371,BUMA.1121.00031,1,579549,592505,+,12956
371,BUMA.1121.00040,1,1152633,1165598,-,12965
371,BUMA.1121.00044,1,489264,502220,-,12956
371,BUMA.1121.00088,1,81568,94513,+,12945
371,BUMA.1121.00069,1,3157221,3170178,+,12957
371,BUMA.1121.00064,1,3253740,3266688,+,12948
371,BUMA.1121.00105,1,1941626,1954583,-,12957
371,BUMA.1121.00015,1,2931350,2944306,+,12956
371,BUMA.1121.00059,1,2494469,2507426,+,12957
371,BUMA.1121.00026,1,1887574,1900530,-,12956
371,BUMA.1121.00022,1,1485868,1498824,-,12956
371,BUMA.1121.00052,1,915090,928046,-,12956
371,BUMA.1121.00101,1,3191282,3204226,-,12944
371,BUMA.1121.00001,1,786660,799608,-,12948
371,BUMA.1121.00038,1,2398750,2411706,+,12956
371,BUMA.1121.00068,1,2044212,2057149,+,12937
371,BUMA.1121.00099,1,3155672,3168609,-,12937
371,BUMA.1121.00091,1,1230034,1242982,-,12948
371,BUMA.1121.00098,1,1907243,1920178,+,12935
371,BUMA.1121.00013,1,58337,71293,+,12956
371,BUMA.1121.00049,1,2558897,2571854,-,12957
371,BUMA.1121.00072,1,3158443,3171400,+,12957
371,BUMA.1121.00076,1,2056305,2069262,-,12957
371,BUMA.1121.00083,1,2411026,2423983,-,12957
371,BUMA.1121.00078,1,2744481,2757429,-,12948
371,BUMA.1121.00095,1,2427358,2440304,-,12946
371,BUMA.1121.00077,1,1914722,1927669,+,12947
371,BUMA.1121.00063,1,3170600,3183557,+,12957
371,BUMA.1121.00061,1,3173659,3186616,+,12957
371,BUMA.1121.00050,1,2284820,2297776,-,12956
371,BUMA.1121.00081,1,2398877,2411833,+,12956
371,BUMA.1121.00074,1,607563,620511,-,12948
371,BUMA.1121.00062,1,1295476,1308424,-,12948
371,BUMA.1121.00060,1,3048613,3061548,-,12935
371,BUMA.1121.00070,1,3144741,3157698,+,12957
371,BUMA.1121.00075,1,2743137,2756094,+,12957
371,BUMA.1121.00041,1,505196,518152,+,12956
371,BUMA.1121.00073,1,3172080,3185037,+,12957
371,BUMA.1121.00017,1,1158803,1171759,-,12956
371,BUMA.1121.00066,1,3161477,3174434,+,12957
371,BUMA.1121.00107,1,3189229,3202177,+,12948
371,BUMA.1121.00085,1,511925,524881,-,12956
371,BUMA.1121.00030,1,1158843,1171799,-,12956
371,BUMA.1121.00112,1,3812612,3825560,-,12948
371,BUMA.1121.00002,1,1587885,1600841,-,12956
371,BUMA.1121.00082,1,3355409,3368366,+,12957
371,BUMA.1121.00014,1,3657359,3670315,-,12956
371,BUMA.1121.00011,1,2347297,2360245,-,12948
371,BUMA.1121.00019,1,1223834,1236790,-,12956
371,BUMA.1121.00057,1,353319,366276,+,12957
371,BUMA.1121.00018,1,3882642,3895589,+,12947
371,BUMA.1121.00039,1,3398796,3411753,+,12957
371,BUMA.1121.00016,1,1364133,1377088,+,12955
371,BUMA.1121.00004,1,1224994,1237950,-,12956
371,BUMA.1121.00005,1,2004254,2017211,+,12957
371,BUMA.1121.00100,1,2028692,2041641,-,12949
371,BUMA.1121.00006,1,2398667,2411623,+,12956
372,BUMA.1121.00027,1,1453443,1458797,+,5354
372,BUMA.1121.00025,1,3508172,3513526,-,5354
372,BUMA.1121.00021,1,3924729,3930083,+,5354
372,BUMA.1121.00023,1,1601479,1606833,+,5354
372,BUMA.1121.00024,1,1217638,1222992,-,5354
372,BUMA.1121.00033,1,1481705,1487059,+,5354
372,BUMA.1121.00034,1,1255026,1260380,-,5354
372,BUMA.1121.00036,1,2751210,2756564,+,5354
372,BUMA.1121.00032,1,2748008,2753362,-,5354
372,BUMA.1121.00009,1,2288988,2294342,-,5354
372,BUMA.1121.00008,1,1221352,1226706,-,5354
372,BUMA.1121.00003,1,1784039,1789393,+,5354
372,BUMA.1121.00109,1,2638486,2643859,-,5373
372,BUMA.1121.00053,1,3024165,3029519,+,5354
372,BUMA.1121.00110,1,1549447,1554835,-,5388
372,BUMA.1121.00104,1,1982531,1987885,-,5354
372,BUMA.1121.00086,1,2163660,2169014,+,5354
372,BUMA.1121.00092,1,514763,520117,-,5354
372,BUMA.1121.00096,1,4742,10096,-,5354
372,BUMA.1121.00054,1,1725307,1730661,-,5354
372,BUMA.1121.00097,1,664014,669368,-,5354
372,BUMA.1121.00093,1,13783,19137,+,5354
372,BUMA.1121.00106,1,3012972,3018326,+,5354
372,BUMA.1121.00010,1,1555480,1560834,-,5354
372,BUMA.1121.00035,1,307206,312560,+,5354
372,BUMA.1121.00108,1,266929,272283,+,5354
372,BUMA.1121.00028,1,1217682,1223036,-,5354
372,BUMA.1121.00094,1,3247515,3252869,+,5354
372,BUMA.1121.00102,1,2025573,2030927,-,5354
372,BUMA.1121.00111,1,3452266,3457620,+,5354
372,BUMA.1121.00089,1,3219335,3224689,+,5354
372,BUMA.1121.00084,1,3627756,3633110,+,5354
372,BUMA.1121.00029,1,1654326,1659680,-,5354
372,BUMA.1121.00012,1,2016523,2021877,+,5354
372,BUMA.1121.00087,1,1148074,1153428,-,5354
372,BUMA.1121.00043,1,3397649,3403003,+,5354
372,BUMA.1121.00046,1,467840,473194,+,5354
372,BUMA.1121.00037,1,1898904,1904258,+,5354
372,BUMA.1121.00080,1,3280203,3285557,+,5354
372,BUMA.1121.00079,1,3312748,3318102,+,5354
372,BUMA.1121.00045,1,797340,802694,-,5354
372,BUMA.1121.00071,1,3191398,3196752,+,5354
372,BUMA.1121.00056,1,702124,707478,-,5354
372,BUMA.1121.00065,1,3328024,3333378,+,5354
372,BUMA.1121.00058,1,1231635,1236989,-,5354
372,BUMA.1121.00007,1,790974,796328,-,5354
372,BUMA.1121.00067,1,1155652,1161006,-,5354
372,BUMA.1121.00090,1,1339450,1344804,+,5354
372,BUMA.1121.00051,1,3231393,3236747,+,5354
372,BUMA.1121.00020,1,1282571,1287925,-,5354
372,BUMA.1121.00103,1,1101099,1106453,-,5354
372,BUMA.1121.00048,1,2205079,2210433,+,5354
372,BUMA.1121.00047,1,3743468,3748822,-,5354
372,BUMA.1121.00042,1,3000413,3005767,+,5354
372,BUMA.1121.00055,1,2943185,2948539,+,5354
372,BUMA.1121.00031,1,593338,598692,+,5354
372,BUMA.1121.00040,1,1145178,1150532,-,5354
372,BUMA.1121.00044,1,483124,488478,-,5354
372,BUMA.1121.00088,1,95298,100652,+,5354
372,BUMA.1121.00069,1,3172264,3177618,+,5354
372,BUMA.1121.00064,1,3267522,3272876,+,5354
372,BUMA.1121.00105,1,1935486,1940840,-,5354
372,BUMA.1121.00015,1,2945091,2950445,+,5354
372,BUMA.1121.00059,1,2508260,2513614,+,5354
372,BUMA.1121.00026,1,1881469,1886788,-,5319
372,BUMA.1121.00022,1,1479728,1485082,-,5354
372,BUMA.1121.00052,1,908950,914304,-,5354
372,BUMA.1121.00101,1,3183732,3189086,-,5354
372,BUMA.1121.00001,1,780472,785826,-,5354
372,BUMA.1121.00038,1,2412491,2417845,+,5354
372,BUMA.1121.00068,1,2057982,2063336,+,5354
372,BUMA.1121.00099,1,3149582,3154936,-,5354
372,BUMA.1121.00091,1,1222482,1227836,-,5354
372,BUMA.1121.00098,1,1921060,1926414,+,5354
372,BUMA.1121.00013,1,72078,77432,+,5354
372,BUMA.1121.00049,1,2552757,2558111,-,5354
372,BUMA.1121.00072,1,3173498,3178852,+,5354
372,BUMA.1121.00076,1,2050068,2055422,-,5354
372,BUMA.1121.00083,1,2403573,2408927,-,5354
372,BUMA.1121.00078,1,2738341,2743695,-,5354
372,BUMA.1121.00095,1,2421160,2426523,-,5363
372,BUMA.1121.00077,1,1928499,1933886,+,5387
372,BUMA.1121.00063,1,3185554,3190908,+,5354
372,BUMA.1121.00061,1,3188665,3194019,+,5354
372,BUMA.1121.00050,1,2278680,2284034,-,5354
372,BUMA.1121.00081,1,2412618,2417972,+,5354
372,BUMA.1121.00074,1,600061,605415,-,5354
372,BUMA.1121.00062,1,1289337,1294691,-,5354
372,BUMA.1121.00060,1,3042572,3047926,-,5354
372,BUMA.1121.00070,1,3159722,3165076,+,5354
372,BUMA.1121.00075,1,2756976,2762330,+,5354
372,BUMA.1121.00041,1,518887,524241,+,5354
372,BUMA.1121.00073,1,3187115,3192469,+,5354
372,BUMA.1121.00017,1,1152663,1158017,-,5354
372,BUMA.1121.00066,1,3176532,3181886,+,5354
372,BUMA.1121.00107,1,3202961,3208315,+,5354
372,BUMA.1121.00085,1,505785,511139,-,5354
372,BUMA.1121.00030,1,1152703,1158057,-,5354
372,BUMA.1121.00112,1,3805209,3810563,-,5354
372,BUMA.1121.00002,1,1581745,1587099,-,5354
372,BUMA.1121.00082,1,3370464,3375818,+,5354
372,BUMA.1121.00014,1,3651171,3656525,-,5354
372,BUMA.1121.00011,1,2341158,2346512,-,5354
372,BUMA.1121.00019,1,1217694,1223048,-,5354
372,BUMA.1121.00057,1,368374,373728,+,5354
372,BUMA.1121.00018,1,3896324,3901678,+,5354
372,BUMA.1121.00039,1,3412489,3417843,+,5354
372,BUMA.1121.00016,1,1377823,1383177,+,5354
372,BUMA.1121.00004,1,1218854,1224208,-,5354
372,BUMA.1121.00005,1,2017995,2023349,+,5354
372,BUMA.1121.00100,1,2022504,2027858,-,5354
372,BUMA.1121.00006,1,2412408,2417762,+,5354
373,BUMA.1121.00027,1,1460129,1463591,+,3462
373,BUMA.1121.00025,1,3503365,3506839,-,3474
373,BUMA.1121.00021,1,3931426,3934901,+,3475
373,BUMA.1121.00023,1,1608158,1611633,+,3475
373,BUMA.1121.00024,1,1212851,1216313,-,3462
373,BUMA.1121.00033,1,1488400,1491875,+,3475
373,BUMA.1121.00034,1,1250239,1253701,-,3462
373,BUMA.1121.00036,1,2757889,2761352,+,3463
373,BUMA.1121.00032,1,2743221,2746683,-,3462
373,BUMA.1121.00009,1,2284193,2287655,-,3462
373,BUMA.1121.00008,1,1216565,1220027,-,3462
373,BUMA.1121.00003,1,1790718,1794181,+,3463
373,BUMA.1121.00109,1,2633691,2637153,-,3462
373,BUMA.1121.00053,1,3030860,3034325,+,3465
373,BUMA.1121.00110,1,1544660,1548122,-,3462
373,BUMA.1121.00104,1,1977736,1981198,-,3462
373,BUMA.1121.00086,1,2170339,2173802,+,3463
373,BUMA.1121.00092,1,509969,513430,-,3461
373,BUMA.1121.00096,1,1,3409,-,3408
373,BUMA.1121.00054,1,1720520,1723982,-,3462
373,BUMA.1121.00097,1,659219,662681,-,3462
373,BUMA.1121.00093,1,20470,23932,+,3462
373,BUMA.1121.00106,1,3019668,3023131,+,3463
373,BUMA.1121.00010,1,1550693,1554155,-,3462
373,BUMA.1121.00035,1,313893,317368,+,3475
373,BUMA.1121.00108,1,273616,277079,+,3463
373,BUMA.1121.00028,1,1212895,1216357,-,3462
373,BUMA.1121.00094,1,3254211,3257674,+,3463
373,BUMA.1121.00102,1,2020776,2024240,-,3464
373,BUMA.1121.00111,1,3458962,3462437,+,3475
373,BUMA.1121.00089,1,3226022,3229488,+,3466
373,BUMA.1121.00084,1,3634443,3637906,+,3463
373,BUMA.1121.00029,1,1649519,1652993,-,3474
373,BUMA.1121.00012,1,2023211,2026686,+,3475
373,BUMA.1121.00087,1,1143287,1146749,-,3462
373,BUMA.1121.00043,1,3404336,3407811,+,3475
373,BUMA.1121.00046,1,474519,477982,+,3463
373,BUMA.1121.00037,1,1906904,1910379,+,3475
373,BUMA.1121.00080,1,3286889,3290355,+,3466
373,BUMA.1121.00079,1,3319434,3322897,+,3463
373,BUMA.1121.00045,1,792544,796006,-,3462
373,BUMA.1121.00071,1,3198085,3201547,+,3462
373,BUMA.1121.00056,1,697326,700791,-,3465
373,BUMA.1121.00065,1,3334711,3338174,+,3463
373,BUMA.1121.00058,1,1226840,1230302,-,3462
373,BUMA.1121.00007,1,786177,789641,-,3464
373,BUMA.1121.00067,1,1150849,1154311,-,3462
373,BUMA.1121.00090,1,1346137,1349612,+,3475
373,BUMA.1121.00051,1,3238079,3241544,+,3465
373,BUMA.1121.00020,1,1277784,1281246,-,3462
373,BUMA.1121.00103,1,1096304,1099766,-,3462
373,BUMA.1121.00048,1,2211758,2215221,+,3463
373,BUMA.1121.00047,1,3738670,3742135,-,3465
373,BUMA.1121.00042,1,3007092,3010555,+,3463
373,BUMA.1121.00055,1,2949872,2953335,+,3463
373,BUMA.1121.00031,1,600017,603492,+,3475
373,BUMA.1121.00040,1,1140391,1143853,-,3462
373,BUMA.1121.00044,1,478337,481799,-,3462
373,BUMA.1121.00088,1,101985,105448,+,3463
373,BUMA.1121.00069,1,3178951,3182414,+,3463
373,BUMA.1121.00064,1,3274209,3277672,+,3463
373,BUMA.1121.00105,1,1930691,1934153,-,3462
373,BUMA.1121.00015,1,2951770,2955233,+,3463
373,BUMA.1121.00059,1,2514947,2518410,+,3463
373,BUMA.1121.00026,1,1876682,1880144,-,3462
373,BUMA.1121.00022,1,1474941,1478403,-,3462
373,BUMA.1121.00052,1,904163,907625,-,3462
373,BUMA.1121.00101,1,3178937,3182399,-,3462
373,BUMA.1121.00001,1,775665,779139,-,3474
373,BUMA.1121.00038,1,2419170,2422633,+,3463
373,BUMA.1121.00068,1,2064680,2068143,+,3463
373,BUMA.1121.00099,1,3144787,3148249,-,3462
373,BUMA.1121.00091,1,1217685,1221149,-,3464
373,BUMA.1121.00098,1,1927748,1931211,+,3463
373,BUMA.1121.00013,1,78757,82220,+,3463
373,BUMA.1121.00049,1,2547963,2551424,-,3461
373,BUMA.1121.00072,1,3180185,3183647,+,3462
373,BUMA.1121.00076,1,2045262,2048735,-,3473
373,BUMA.1121.00083,1,2398778,2402240,-,3462
373,BUMA.1121.00078,1,2733537,2736999,-,3462
373,BUMA.1121.00095,1,2416365,2419827,-,3462
373,BUMA.1121.00077,1,1935211,1938674,+,3463
373,BUMA.1121.00063,1,3192241,3195704,+,3463
373,BUMA.1121.00061,1,3195352,3198815,+,3463
373,BUMA.1121.00050,1,2273893,2277355,-,3462
373,BUMA.1121.00081,1,2419297,2422760,+,3463
373,BUMA.1121.00074,1,595266,598728,-,3462
373,BUMA.1121.00062,1,1284542,1288004,-,3462
373,BUMA.1121.00060,1,3037776,3041238,-,3462
373,BUMA.1121.00070,1,3166409,3169872,+,3463
373,BUMA.1121.00075,1,2763662,2767136,+,3474
373,BUMA.1121.00041,1,525583,529058,+,3475
373,BUMA.1121.00073,1,3193802,3197265,+,3463
373,BUMA.1121.00017,1,1147876,1151338,-,3462
373,BUMA.1121.00066,1,3183219,3186682,+,3463
373,BUMA.1121.00107,1,3209658,3213121,+,3463
373,BUMA.1121.00085,1,500998,504460,-,3462
373,BUMA.1121.00030,1,1147916,1151378,-,3462
373,BUMA.1121.00112,1,3800415,3803876,-,3461
373,BUMA.1121.00002,1,1576958,1580420,-,3462
373,BUMA.1121.00082,1,3377151,3380614,+,3463
373,BUMA.1121.00014,1,3646372,3649846,-,3474
373,BUMA.1121.00011,1,2336352,2339825,-,3473
373,BUMA.1121.00019,1,1212907,1216369,-,3462
373,BUMA.1121.00057,1,375061,378522,+,3461
373,BUMA.1121.00018,1,3903011,3906486,+,3475
373,BUMA.1121.00039,1,3419176,3422639,+,3463
373,BUMA.1121.00016,1,1384509,1387972,+,3463
373,BUMA.1121.00004,1,1214067,1217529,-,3462
373,BUMA.1121.00005,1,2024682,2028144,+,3462
373,BUMA.1121.00100,1,2017709,2021171,-,3462
373,BUMA.1121.00006,1,2419087,2422550,+,3463
374,BUMA.1121.00027,1,1463592,1482834,+,19242
374,BUMA.1121.00025,1,3484125,3503363,-,19238
374,BUMA.1121.00021,1,3934902,3954141,+,19239
374,BUMA.1121.00023,1,1611634,1630872,+,19238
374,BUMA.1121.00024,1,1193607,1212849,-,19242
374,BUMA.1121.00033,1,1491876,1511114,+,19238
374,BUMA.1121.00034,1,1230995,1250237,-,19242
374,BUMA.1121.00036,1,2761353,2780595,+,19242
374,BUMA.1121.00032,1,2723977,2743219,-,19242
374,BUMA.1121.00009,1,2264980,2284191,-,19211
374,BUMA.1121.00008,1,1197321,1216563,-,19242
374,BUMA.1121.00003,1,1794182,1813425,+,19243
374,BUMA.1121.00109,1,2614447,2633689,-,19242
374,BUMA.1121.00053,1,3034326,3053593,+,19267
374,BUMA.1121.00110,1,1525446,1544658,-,19212
374,BUMA.1121.00104,1,1958471,1977734,-,19263
374,BUMA.1121.00086,1,2173803,2193045,+,19242
374,BUMA.1121.00092,1,490729,509967,-,19238
374,BUMA.1121.00096,1,4010153,4029411,-,19258
374,BUMA.1121.00054,1,1701276,1720518,-,19242
374,BUMA.1121.00097,1,639975,659217,-,19242
374,BUMA.1121.00093,1,23933,43171,+,19238
374,BUMA.1121.00106,1,3023132,3042395,+,19263
374,BUMA.1121.00010,1,1531449,1550691,-,19242
374,BUMA.1121.00035,1,317369,336607,+,19238
374,BUMA.1121.00108,1,277080,296321,+,19241
374,BUMA.1121.00028,1,1193651,1212893,-,19242
374,BUMA.1121.00094,1,3257675,3276917,+,19242
374,BUMA.1121.00102,1,2001532,2020774,-,19242
374,BUMA.1121.00111,1,3462438,3481676,+,19238
374,BUMA.1121.00089,1,3229489,3248731,+,19242
374,BUMA.1121.00084,1,3637907,3657149,+,19242
374,BUMA.1121.00029,1,1630279,1649517,-,19238
374,BUMA.1121.00012,1,2026687,2045925,+,19238
374,BUMA.1121.00087,1,1124043,1143285,-,19242
374,BUMA.1121.00043,1,3407812,3427054,+,19242
374,BUMA.1121.00046,1,477983,497225,+,19242
374,BUMA.1121.00037,1,1910380,1929622,+,19242
374,BUMA.1121.00080,1,3290356,3309594,+,19238
374,BUMA.1121.00079,1,3322898,3342161,+,19263
374,BUMA.1121.00045,1,773305,792542,-,19237
374,BUMA.1121.00071,1,3201548,3220790,+,19242
374,BUMA.1121.00056,1,678082,697324,-,19242
374,BUMA.1121.00065,1,3338175,3357434,+,19259
374,BUMA.1121.00058,1,1207596,1226838,-,19242
374,BUMA.1121.00007,1,766922,786175,-,19253
374,BUMA.1121.00067,1,1131605,1150847,-,19242
374,BUMA.1121.00090,1,1349613,1368851,+,19238
374,BUMA.1121.00051,1,3241545,3260787,+,19242
374,BUMA.1121.00020,1,1258540,1277782,-,19242
374,BUMA.1121.00103,1,1077061,1096302,-,19241
374,BUMA.1121.00048,1,2215222,2234464,+,19242
374,BUMA.1121.00047,1,3719426,3738668,-,19242
374,BUMA.1121.00042,1,3010556,3029798,+,19242
374,BUMA.1121.00055,1,2953336,2972544,+,19208
374,BUMA.1121.00031,1,603493,622731,+,19238
374,BUMA.1121.00040,1,1121147,1140389,-,19242
374,BUMA.1121.00044,1,459093,478335,-,19242
374,BUMA.1121.00088,1,105449,124708,+,19259
374,BUMA.1121.00069,1,3182415,3201657,+,19242
374,BUMA.1121.00064,1,3277673,3296915,+,19242
374,BUMA.1121.00105,1,1911422,1930689,-,19267
374,BUMA.1121.00015,1,2955234,2974476,+,19242
374,BUMA.1121.00059,1,2518411,2537653,+,19242
374,BUMA.1121.00026,1,1857438,1876680,-,19242
374,BUMA.1121.00022,1,1455697,1474939,-,19242
374,BUMA.1121.00052,1,884919,904161,-,19242
374,BUMA.1121.00101,1,3159697,3178935,-,19238
374,BUMA.1121.00001,1,756444,775663,-,19219
374,BUMA.1121.00038,1,2422634,2441876,+,19242
374,BUMA.1121.00068,1,2068144,2087350,+,19206
374,BUMA.1121.00099,1,3125543,3144785,-,19242
374,BUMA.1121.00091,1,1198445,1217683,-,19238
374,BUMA.1121.00098,1,1931212,1950449,+,19237
374,BUMA.1121.00013,1,82221,101463,+,19242
374,BUMA.1121.00049,1,2528698,2547961,-,19263
374,BUMA.1121.00072,1,3183648,3202889,+,19241
374,BUMA.1121.00076,1,2025993,2045260,-,19267
374,BUMA.1121.00083,1,2379534,2398776,-,19242
374,BUMA.1121.00078,1,2714293,2733535,-,19242
374,BUMA.1121.00095,1,2397151,2416363,-,19212
374,BUMA.1121.00077,1,1938675,1957885,+,19210
374,BUMA.1121.00063,1,3195705,3214947,+,19242
374,BUMA.1121.00061,1,3198816,3218058,+,19242
374,BUMA.1121.00050,1,2254649,2273891,-,19242
374,BUMA.1121.00081,1,2422761,2442003,+,19242
374,BUMA.1121.00074,1,576026,595264,-,19238
374,BUMA.1121.00062,1,1265281,1284540,-,19259
374,BUMA.1121.00060,1,3018537,3037774,-,19237
374,BUMA.1121.00070,1,3169873,3189115,+,19242
374,BUMA.1121.00075,1,2767137,2786402,+,19265
374,BUMA.1121.00041,1,529059,548297,+,19238
374,BUMA.1121.00073,1,3197266,3216508,+,19242
374,BUMA.1121.00017,1,1128632,1147874,-,19242
374,BUMA.1121.00066,1,3186683,3205925,+,19242
374,BUMA.1121.00107,1,3213122,3232365,+,19243
374,BUMA.1121.00085,1,481754,500996,-,19242
374,BUMA.1121.00030,1,1128672,1147914,-,19242
374,BUMA.1121.00112,1,3781207,3800413,-,19206
374,BUMA.1121.00002,1,1557714,1576956,-,19242
374,BUMA.1121.00082,1,3380615,3399857,+,19242
374,BUMA.1121.00014,1,3627131,3646370,-,19239
374,BUMA.1121.00011,1,2317112,2336350,-,19238
374,BUMA.1121.00019,1,1193663,1212905,-,19242
374,BUMA.1121.00057,1,378523,397765,+,19242
374,BUMA.1121.00018,1,3906487,3925725,+,19238
374,BUMA.1121.00039,1,3422640,3441882,+,19242
374,BUMA.1121.00016,1,1387973,1407211,+,19238
374,BUMA.1121.00004,1,1194823,1214065,-,19242
374,BUMA.1121.00005,1,2028145,2047387,+,19242
374,BUMA.1121.00100,1,1998469,2017707,-,19238
374,BUMA.1121.00006,1,2422551,2441793,+,19242
375,BUMA.1121.00027,1,1483706,1487544,+,3838
375,BUMA.1121.00025,1,3479415,3483254,-,3839
375,BUMA.1121.00021,1,3955013,3958851,+,3838
375,BUMA.1121.00023,1,1631744,1635582,+,3838
375,BUMA.1121.00024,1,135230,139067,-,3837
375,BUMA.1121.00033,1,1511986,1515824,+,3838
375,BUMA.1121.00034,1,135244,139081,-,3837
375,BUMA.1121.00036,1,2859722,2863559,-,3837
375,BUMA.1121.00032,1,1732231,1736068,-,3837
375,BUMA.1121.00009,1,2260270,2264109,-,3839
375,BUMA.1121.00008,1,135258,139095,-,3837
375,BUMA.1121.00003,1,1814297,1818123,+,3826
375,BUMA.1121.00109,1,2609742,2613569,-,3827
375,BUMA.1121.00053,1,3056061,3059899,+,3838
375,BUMA.1121.00110,1,1520736,1524575,-,3839
375,BUMA.1121.00104,1,1952165,1956002,-,3837
375,BUMA.1121.00086,1,2572578,2576415,-,3837
375,BUMA.1121.00092,1,486019,489858,-,3839
375,BUMA.1121.00096,1,4005443,4009282,-,3839
375,BUMA.1121.00054,1,1618218,1622055,+,3837
375,BUMA.1121.00097,1,635265,639104,-,3839
375,BUMA.1121.00093,1,44043,47881,+,3838
375,BUMA.1121.00106,1,3044864,3048701,+,3837
375,BUMA.1121.00010,1,1450091,1453928,+,3837
375,BUMA.1121.00035,1,337472,341310,+,3838
375,BUMA.1121.00108,1,297192,301031,+,3839
375,BUMA.1121.00028,1,135244,139081,-,3837
375,BUMA.1121.00094,1,3277789,3281627,+,3838
375,BUMA.1121.00102,1,1996905,2000744,-,3839
375,BUMA.1121.00111,1,3482548,3486386,+,3838
375,BUMA.1121.00089,1,3249603,3253441,+,3838
375,BUMA.1121.00084,1,3659618,3663456,+,3838
375,BUMA.1121.00029,1,1625569,1629408,-,3839
375,BUMA.1121.00012,1,2046790,2050628,+,3838
375,BUMA.1121.00087,1,759202,763039,+,3837
375,BUMA.1121.00043,1,3427919,3431757,+,3838
375,BUMA.1121.00046,1,576289,580126,-,3837
375,BUMA.1121.00037,1,1930487,1934325,+,3838
375,BUMA.1121.00080,1,3310383,3314221,+,3838
375,BUMA.1121.00079,1,3342950,3346788,+,3838
375,BUMA.1121.00045,1,768595,772434,-,3839
375,BUMA.1121.00071,1,3221662,3225500,+,3838
375,BUMA.1121.00056,1,673372,677211,-,3839
375,BUMA.1121.00065,1,3358306,3362144,+,3838
375,BUMA.1121.00058,1,1202969,1206808,-,3839
375,BUMA.1121.00007,1,762212,766051,-,3839
375,BUMA.1121.00067,1,1126978,1130817,-,3839
375,BUMA.1121.00090,1,1369723,1373561,+,3838
375,BUMA.1121.00051,1,3261659,3265497,+,3838
375,BUMA.1121.00020,1,135251,139088,-,3837
375,BUMA.1121.00103,1,1070767,1074592,-,3825
375,BUMA.1121.00048,1,2313649,2317486,-,3837
375,BUMA.1121.00047,1,3714716,3718555,-,3839
375,BUMA.1121.00042,1,667227,671064,-,3837
375,BUMA.1121.00055,1,2973416,2977242,+,3826
375,BUMA.1121.00031,1,623603,627441,+,3838
375,BUMA.1121.00040,1,1039778,1043615,+,3837
375,BUMA.1121.00044,1,2937247,2941084,-,3837
375,BUMA.1121.00088,1,127177,131015,+,3838
375,BUMA.1121.00069,1,3202529,3206367,+,3838
375,BUMA.1121.00064,1,3297704,3301542,+,3838
375,BUMA.1121.00105,1,1905115,1908954,-,3839
375,BUMA.1121.00015,1,3053598,3057435,-,3837
375,BUMA.1121.00059,1,2538525,2542363,+,3838
375,BUMA.1121.00026,1,1774496,1778333,+,3837
375,BUMA.1121.00022,1,117846,121683,-,3837
375,BUMA.1121.00052,1,735078,738916,-,3838
375,BUMA.1121.00101,1,3153392,3157229,-,3837
375,BUMA.1121.00001,1,751741,755580,-,3839
375,BUMA.1121.00038,1,2521062,2524899,-,3837
375,BUMA.1121.00068,1,2088224,2092060,+,3836
375,BUMA.1121.00099,1,3120852,3124679,-,3827
375,BUMA.1121.00091,1,1193735,1197574,-,3839
375,BUMA.1121.00098,1,1951325,1955159,+,3834
375,BUMA.1121.00013,1,247398,251235,+,3837
375,BUMA.1121.00049,1,2523988,2527827,-,3839
375,BUMA.1121.00072,1,3203761,3207599,+,3838
375,BUMA.1121.00076,1,2021295,2025122,-,3827
375,BUMA.1121.00083,1,2374824,2378663,-,3839
375,BUMA.1121.00078,1,2707987,2711824,-,3837
375,BUMA.1121.00095,1,2390846,2394685,-,3839
375,BUMA.1121.00077,1,1958756,1962595,+,3839
375,BUMA.1121.00063,1,3215819,3219657,+,3838
375,BUMA.1121.00061,1,3218930,3222768,+,3838
375,BUMA.1121.00050,1,2171742,2175579,+,3837
375,BUMA.1121.00081,1,2521189,2525026,-,3837
375,BUMA.1121.00074,1,571399,575238,-,3839
375,BUMA.1121.00062,1,1260654,1264493,-,3839
375,BUMA.1121.00060,1,3013827,3017666,-,3839
375,BUMA.1121.00070,1,3189987,3193825,+,3838
375,BUMA.1121.00075,1,2787274,2791100,+,3826
375,BUMA.1121.00041,1,549169,553007,+,3838
375,BUMA.1121.00073,1,3217380,3221218,+,3838
375,BUMA.1121.00017,1,135244,139081,-,3837
375,BUMA.1121.00066,1,3206797,3210635,+,3838
375,BUMA.1121.00107,1,3233237,3237075,+,3838
375,BUMA.1121.00085,1,331913,335751,-,3838
375,BUMA.1121.00030,1,135244,139081,-,3837
375,BUMA.1121.00112,1,3776497,3780336,-,3839
375,BUMA.1121.00002,1,1476356,1480193,+,3837
375,BUMA.1121.00082,1,3400729,3404567,+,3838
375,BUMA.1121.00014,1,3622421,3626260,-,3839
375,BUMA.1121.00011,1,2312421,2316248,-,3827
375,BUMA.1121.00019,1,135251,139088,-,3837
375,BUMA.1121.00057,1,398637,402475,+,3838
375,BUMA.1121.00018,1,3926597,3930435,+,3838
375,BUMA.1121.00039,1,3442754,3446592,+,3838
375,BUMA.1121.00016,1,1408083,1411921,+,3838
375,BUMA.1121.00004,1,135237,139074,-,3837
375,BUMA.1121.00005,1,2049855,2053693,+,3838
375,BUMA.1121.00100,1,1993771,1997598,-,3827
375,BUMA.1121.00006,1,2521000,2524837,-,3837
376,BUMA.1121.00027,1,1488597,1505047,+,16450
376,BUMA.1121.00025,1,3461898,3478362,-,16464
376,BUMA.1121.00021,1,3959904,3976342,+,16438
376,BUMA.1121.00023,1,1636635,1653082,+,16447
376,BUMA.1121.00024,1,117752,134177,-,16425
376,BUMA.1121.00033,1,1516877,1533315,+,16438
376,BUMA.1121.00034,1,117766,134191,-,16425
376,BUMA.1121.00036,1,2842244,2858669,-,16425
376,BUMA.1121.00032,1,1714753,1731178,-,16425
376,BUMA.1121.00009,1,2242751,2259217,-,16466
376,BUMA.1121.00008,1,117780,134205,-,16425
376,BUMA.1121.00003,1,1819176,1835631,+,16455
376,BUMA.1121.00109,1,2592243,2608689,-,16446
376,BUMA.1121.00053,1,3060952,3077384,+,16432
376,BUMA.1121.00110,1,1503209,1519683,-,16474
376,BUMA.1121.00104,1,1934702,1951112,-,16410
376,BUMA.1121.00086,1,2555100,2571525,-,16425
376,BUMA.1121.00092,1,468538,484966,-,16428
376,BUMA.1121.00096,1,3988000,4004390,-,16390
376,BUMA.1121.00054,1,1623108,1639534,+,16426
376,BUMA.1121.00097,1,617776,634212,-,16436
376,BUMA.1121.00093,1,48934,65363,+,16429
376,BUMA.1121.00106,1,3049754,3067536,+,17782
376,BUMA.1121.00010,1,1454981,1471398,+,16417
376,BUMA.1121.00035,1,342363,358821,+,16458
376,BUMA.1121.00108,1,302084,318527,+,16443
376,BUMA.1121.00028,1,117766,134191,-,16425
376,BUMA.1121.00094,1,3282680,3299112,+,16432
376,BUMA.1121.00102,1,1979400,1995852,-,16452
376,BUMA.1121.00111,1,3487439,3503895,+,16456
376,BUMA.1121.00089,1,3254494,3270926,+,16432
376,BUMA.1121.00084,1,3664509,3680957,+,16448
376,BUMA.1121.00029,1,1608059,1624516,-,16457
376,BUMA.1121.00012,1,2051681,2068126,+,16445
376,BUMA.1121.00087,1,764092,780518,+,16426
376,BUMA.1121.00043,1,3432810,3449233,+,16423
376,BUMA.1121.00046,1,558811,575236,-,16425
376,BUMA.1121.00037,1,1935378,1951816,+,16438
376,BUMA.1121.00080,1,3315274,3331732,+,16458
376,BUMA.1121.00079,1,3347841,3364263,+,16422
376,BUMA.1121.00045,1,751063,767542,-,16479
376,BUMA.1121.00071,1,3226553,3242967,+,16414
376,BUMA.1121.00056,1,655880,672319,-,16439
376,BUMA.1121.00065,1,3363197,3379636,+,16439
376,BUMA.1121.00058,1,1185395,1201916,-,16521
376,BUMA.1121.00007,1,744683,761159,-,16476
376,BUMA.1121.00067,1,1109468,1125925,-,16457
376,BUMA.1121.00090,1,1374614,1391051,+,16437
376,BUMA.1121.00051,1,3266550,3282982,+,16432
376,BUMA.1121.00020,1,117773,134198,-,16425
376,BUMA.1121.00103,1,1053242,1069714,-,16472
376,BUMA.1121.00048,1,2296171,2312596,-,16425
376,BUMA.1121.00047,1,3697229,3713663,-,16434
376,BUMA.1121.00042,1,649749,666174,-,16425
376,BUMA.1121.00055,1,2978295,2994722,+,16427
376,BUMA.1121.00031,1,628494,644935,+,16441
376,BUMA.1121.00040,1,1044668,1061075,+,16407
376,BUMA.1121.00044,1,2919769,2936194,-,16425
376,BUMA.1121.00088,1,132068,148516,+,16448
376,BUMA.1121.00069,1,3207420,3223835,+,16415
376,BUMA.1121.00064,1,3302595,3319050,+,16455
376,BUMA.1121.00105,1,1887618,1904062,-,16444
376,BUMA.1121.00015,1,3036120,3052545,-,16425
376,BUMA.1121.00059,1,2543416,2559871,+,16455
376,BUMA.1121.00026,1,1779386,1795812,+,16426
376,BUMA.1121.00022,1,100386,116793,-,16407
376,BUMA.1121.00052,1,717600,734025,-,16425
376,BUMA.1121.00101,1,3135887,3152339,-,16452
376,BUMA.1121.00001,1,734240,750688,-,16448
376,BUMA.1121.00038,1,2503584,2520009,-,16425
376,BUMA.1121.00068,1,2093113,2109592,+,16479
376,BUMA.1121.00099,1,3103466,3119799,-,16333
376,BUMA.1121.00091,1,1176254,1192682,-,16428
376,BUMA.1121.00098,1,1956212,1972615,+,16403
376,BUMA.1121.00013,1,252288,268714,+,16426
376,BUMA.1121.00049,1,2506502,2522935,-,16433
376,BUMA.1121.00072,1,3208652,3225063,+,16411
376,BUMA.1121.00076,1,2003781,2020242,-,16461
376,BUMA.1121.00083,1,2357341,2373771,-,16430
376,BUMA.1121.00078,1,2690463,2706934,-,16471
376,BUMA.1121.00095,1,2373365,2389793,-,16428
376,BUMA.1121.00077,1,1963648,1980110,+,16462
376,BUMA.1121.00063,1,3220710,3237128,+,16418
376,BUMA.1121.00061,1,3223821,3240239,+,16418
376,BUMA.1121.00050,1,2176632,2193058,+,16426
376,BUMA.1121.00081,1,2503711,2520136,-,16425
376,BUMA.1121.00074,1,553889,570346,-,16457
376,BUMA.1121.00062,1,1243160,1259601,-,16441
376,BUMA.1121.00060,1,2996295,3012774,-,16479
376,BUMA.1121.00070,1,3194878,3211296,+,16418
376,BUMA.1121.00075,1,2792153,2808607,+,16454
376,BUMA.1121.00041,1,554060,570498,+,16438
376,BUMA.1121.00073,1,3222271,3238689,+,16418
376,BUMA.1121.00017,1,117766,134191,-,16425
376,BUMA.1121.00066,1,3211688,3228118,+,16430
376,BUMA.1121.00107,1,3238128,3254538,+,16410
376,BUMA.1121.00085,1,314435,330860,-,16425
376,BUMA.1121.00030,1,117766,134191,-,16425
376,BUMA.1121.00112,1,3758995,3775444,-,16449
376,BUMA.1121.00002,1,1481246,1497663,+,16417
376,BUMA.1121.00082,1,3405620,3422038,+,16418
376,BUMA.1121.00014,1,3604928,3621368,-,16440
376,BUMA.1121.00011,1,2294929,2311368,-,16439
376,BUMA.1121.00019,1,117773,134198,-,16425
376,BUMA.1121.00057,1,403528,419978,+,16450
376,BUMA.1121.00018,1,3931488,3947940,+,16452
376,BUMA.1121.00039,1,3447645,3464065,+,16420
376,BUMA.1121.00016,1,1412974,1429431,+,16457
376,BUMA.1121.00004,1,117759,134184,-,16425
376,BUMA.1121.00005,1,2054746,2071187,+,16441
376,BUMA.1121.00100,1,1976294,1992718,-,16424
376,BUMA.1121.00006,1,2503522,2519947,-,16425
377,BUMA.1121.00027,1,1505230,1521463,+,16233
377,BUMA.1121.00025,1,3445439,3461760,-,16321
377,BUMA.1121.00021,1,3976518,3994231,+,17713
377,BUMA.1121.00023,1,1653279,1669750,+,16471
377,BUMA.1121.00024,1,101526,117624,-,16098
377,BUMA.1121.00033,1,1533486,1549772,+,16286
377,BUMA.1121.00034,1,101540,117638,-,16098
377,BUMA.1121.00036,1,2826001,2842116,-,16115
377,BUMA.1121.00032,1,1698527,1714625,-,16098
377,BUMA.1121.00009,1,2226451,2242608,-,16157
377,BUMA.1121.00008,1,101554,117652,-,16098
377,BUMA.1121.00003,1,1835794,1852110,+,16316
377,BUMA.1121.00109,1,2575778,2592105,-,16327
377,BUMA.1121.00053,1,3077580,3094002,+,16422
377,BUMA.1121.00110,1,1486679,1503091,-,16412
377,BUMA.1121.00104,1,1918402,1934539,-,16137
377,BUMA.1121.00086,1,2538857,2554972,-,16115
377,BUMA.1121.00092,1,452149,468380,-,16231
377,BUMA.1121.00096,1,3971381,3987842,-,16461
377,BUMA.1121.00054,1,1639662,1655774,+,16112
377,BUMA.1121.00097,1,601423,617628,-,16205
377,BUMA.1121.00093,1,65521,81751,+,16230
377,BUMA.1121.00106,1,3067719,3083828,+,16109
377,BUMA.1121.00010,1,1471526,1487641,+,16115
377,BUMA.1121.00035,1,358995,375221,+,16226
377,BUMA.1121.00108,1,318649,334797,+,16148
377,BUMA.1121.00028,1,101540,117638,-,16098
377,BUMA.1121.00094,1,3299227,3315383,+,16156
377,BUMA.1121.00102,1,1962878,1979237,-,16359
377,BUMA.1121.00111,1,3504076,3520470,+,16394
377,BUMA.1121.00089,1,3271036,3287192,+,16156
377,BUMA.1121.00084,1,3681128,3697257,+,16129
377,BUMA.1121.00029,1,1591705,1607910,-,16205
377,BUMA.1121.00012,1,2068282,2084652,+,16370
377,BUMA.1121.00087,1,780646,796760,+,16114
377,BUMA.1121.00043,1,3449379,3465902,+,16523
377,BUMA.1121.00046,1,542570,558678,-,16108
377,BUMA.1121.00037,1,1951982,1968336,+,16354
377,BUMA.1121.00080,1,3331905,3348031,+,16126
377,BUMA.1121.00079,1,3364439,3380593,+,16154
377,BUMA.1121.00045,1,734731,750914,-,16183
377,BUMA.1121.00071,1,3243135,3259314,+,16179
377,BUMA.1121.00056,1,639621,655778,-,16157
377,BUMA.1121.00065,1,3379779,3396000,+,16221
377,BUMA.1121.00058,1,1169098,1185252,-,16154
377,BUMA.1121.00007,1,728233,744521,-,16288
377,BUMA.1121.00067,1,1093156,1109275,-,16119
377,BUMA.1121.00090,1,1391202,1407593,+,16391
377,BUMA.1121.00051,1,3283173,3299354,+,16181
377,BUMA.1121.00020,1,101547,117645,-,16098
377,BUMA.1121.00103,1,1036871,1053069,-,16198
377,BUMA.1121.00048,1,2279930,2296043,-,16113
377,BUMA.1121.00047,1,3680845,3697036,-,16191
377,BUMA.1121.00042,1,633515,649611,-,16096
377,BUMA.1121.00055,1,2996213,3012406,+,16193
377,BUMA.1121.00031,1,645099,661381,+,16282
377,BUMA.1121.00040,1,1061198,1077367,+,16169
377,BUMA.1121.00044,1,2903543,2919641,-,16098
377,BUMA.1121.00088,1,148667,164935,+,16268
377,BUMA.1121.00069,1,3224007,3240240,+,16233
377,BUMA.1121.00064,1,3319231,3335370,+,16139
377,BUMA.1121.00105,1,1871310,1887450,-,16140
377,BUMA.1121.00015,1,3019855,3035987,-,16132
377,BUMA.1121.00059,1,2560037,2576163,+,16126
377,BUMA.1121.00026,1,1795950,1812056,+,16106
377,BUMA.1121.00022,1,84143,100258,-,16115
377,BUMA.1121.00052,1,701318,717467,-,16149
377,BUMA.1121.00101,1,3119579,3135751,-,16172
377,BUMA.1121.00001,1,717836,734076,-,16240
377,BUMA.1121.00038,1,2487343,2503456,-,16113
377,BUMA.1121.00068,1,2109770,2126159,+,16389
377,BUMA.1121.00099,1,3087121,3103315,-,16194
377,BUMA.1121.00091,1,1159787,1176086,-,16299
377,BUMA.1121.00098,1,1972791,1989186,+,16395
377,BUMA.1121.00013,1,268857,285005,+,16148
377,BUMA.1121.00049,1,2490122,2506344,-,16222
377,BUMA.1121.00072,1,3225231,3241418,+,16187
377,BUMA.1121.00076,1,1987473,2003628,-,16155
377,BUMA.1121.00083,1,2340936,2357178,-,16242
377,BUMA.1121.00078,1,2673963,2690300,-,16337
377,BUMA.1121.00095,1,2355604,2371758,-,16154
377,BUMA.1121.00077,1,1980241,1996659,+,16418
377,BUMA.1121.00063,1,3237304,3253519,+,16215
377,BUMA.1121.00061,1,3240415,3256631,+,16216
377,BUMA.1121.00050,1,2193191,2209298,+,16107
377,BUMA.1121.00081,1,2487470,2503583,-,16113
377,BUMA.1121.00074,1,537607,553726,-,16119
377,BUMA.1121.00062,1,1226807,1242992,-,16185
377,BUMA.1121.00060,1,2979963,2996146,-,16183
377,BUMA.1121.00070,1,3211472,3227713,+,16241
377,BUMA.1121.00075,1,2808768,2824929,+,16161
377,BUMA.1121.00041,1,570689,586826,+,16137
377,BUMA.1121.00073,1,3238865,3255106,+,16241
377,BUMA.1121.00017,1,101540,117638,-,16098
377,BUMA.1121.00066,1,3228281,3244472,+,16191
377,BUMA.1121.00107,1,3254686,3270911,+,16225
377,BUMA.1121.00085,1,298153,314302,-,16149
377,BUMA.1121.00030,1,101540,117638,-,16098
377,BUMA.1121.00112,1,3742536,3758827,-,16291
377,BUMA.1121.00002,1,1497791,1513906,+,16115
377,BUMA.1121.00082,1,3422214,3438455,+,16241
377,BUMA.1121.00014,1,3588483,3604749,-,16266
377,BUMA.1121.00011,1,2278578,2294832,-,16254
377,BUMA.1121.00019,1,101547,117645,-,16098
377,BUMA.1121.00057,1,420141,436386,+,16245
377,BUMA.1121.00018,1,3948096,3964366,+,16270
377,BUMA.1121.00039,1,3464216,3480595,+,16379
377,BUMA.1121.00016,1,1430915,1447242,+,16327
377,BUMA.1121.00004,1,101533,117631,-,16098
377,BUMA.1121.00005,1,2071365,2087608,+,16243
377,BUMA.1121.00100,1,1959855,1976121,-,16266
377,BUMA.1121.00006,1,2487281,2503394,-,16113
378,BUMA.1121.00027,1,1523156,1530729,+,7573
378,BUMA.1121.00025,1,3437031,3444632,-,7601
378,BUMA.1121.00021,1,3995039,4002637,+,7598
378,BUMA.1121.00023,1,1670558,1678260,+,7702
378,BUMA.1121.00024,1,93255,100720,-,7465
378,BUMA.1121.00033,1,1550580,1558187,+,7607
378,BUMA.1121.00034,1,93269,100734,-,7465
378,BUMA.1121.00036,1,2817730,2825195,-,7465
378,BUMA.1121.00032,1,1690256,1697721,-,7465
378,BUMA.1121.00009,1,2217150,2224777,-,7627
378,BUMA.1121.00008,1,93283,100748,-,7465
378,BUMA.1121.00003,1,1852918,1860544,+,7626
378,BUMA.1121.00109,1,2566410,2574084,-,7674
378,BUMA.1121.00053,1,3095679,3103303,+,7624
378,BUMA.1121.00110,1,1477422,1485004,-,7582
378,BUMA.1121.00104,1,1909092,1916710,-,7618
378,BUMA.1121.00086,1,2530586,2538051,-,7465
378,BUMA.1121.00092,1,442875,450457,-,7582
378,BUMA.1121.00096,1,3962998,3970574,-,7576
378,BUMA.1121.00054,1,1656581,1664028,+,7447
378,BUMA.1121.00097,1,592998,600613,-,7615
378,BUMA.1121.00093,1,83444,91025,+,7581
378,BUMA.1121.00106,1,3085521,3093101,+,7580
378,BUMA.1121.00010,1,1488448,1495896,+,7448
378,BUMA.1121.00035,1,376029,383605,+,7576
378,BUMA.1121.00108,1,335607,343226,+,7619
378,BUMA.1121.00028,1,93269,100734,-,7465
378,BUMA.1121.00094,1,3316191,3323737,+,7546
378,BUMA.1121.00102,1,1953574,1961186,-,7612
378,BUMA.1121.00111,1,3521278,3528872,+,7594
378,BUMA.1121.00089,1,3288000,3295562,+,7562
378,BUMA.1121.00084,1,3698950,3706564,+,7614
378,BUMA.1121.00029,1,1583339,1590898,-,7559
378,BUMA.1121.00012,1,2085460,2093091,+,7631
378,BUMA.1121.00087,1,797567,805031,+,7464
378,BUMA.1121.00043,1,3466710,3474380,+,7670
378,BUMA.1121.00046,1,534299,541764,-,7465
378,BUMA.1121.00037,1,1969144,1976731,+,7587
378,BUMA.1121.00080,1,3348839,3356420,+,7581
378,BUMA.1121.00079,1,3382286,3389841,+,7555
378,BUMA.1121.00045,1,726372,733922,-,7550
378,BUMA.1121.00071,1,3260122,3267738,+,7616
378,BUMA.1121.00056,1,631251,638814,-,7563
378,BUMA.1121.00065,1,3396808,3404433,+,7625
378,BUMA.1121.00058,1,1160745,1168292,-,7547
378,BUMA.1121.00007,1,718910,726540,-,7630
378,BUMA.1121.00067,1,1083876,1091481,-,7605
378,BUMA.1121.00090,1,1408401,1416008,+,7607
378,BUMA.1121.00051,1,3300162,3307708,+,7546
378,BUMA.1121.00020,1,93276,100741,-,7465
378,BUMA.1121.00103,1,1028516,1036065,-,7549
378,BUMA.1121.00048,1,2271676,2279124,-,7448
378,BUMA.1121.00047,1,3672483,3680038,-,7555
378,BUMA.1121.00042,1,625244,632709,-,7465
378,BUMA.1121.00055,1,3014099,3021709,+,7610
378,BUMA.1121.00031,1,662189,669832,+,7643
378,BUMA.1121.00040,1,1078174,1085638,+,7464
378,BUMA.1121.00044,1,2895272,2902737,-,7465
378,BUMA.1121.00088,1,166628,174194,+,7566
378,BUMA.1121.00069,1,3241048,3248628,+,7580
378,BUMA.1121.00064,1,3337063,3344653,+,7590
378,BUMA.1121.00105,1,1862955,1870502,-,7547
378,BUMA.1121.00015,1,3011584,3019049,-,7465
378,BUMA.1121.00059,1,2577856,2585463,+,7607
378,BUMA.1121.00026,1,1812863,1820315,+,7452
378,BUMA.1121.00022,1,75872,83337,-,7465
378,BUMA.1121.00052,1,693038,700512,-,7474
378,BUMA.1121.00101,1,3111139,3118773,-,7634
378,BUMA.1121.00001,1,709488,717029,-,7541
378,BUMA.1121.00038,1,2479089,2486537,-,7448
378,BUMA.1121.00068,1,2126966,2134577,+,7611
378,BUMA.1121.00099,1,3078727,3086314,-,7587
378,BUMA.1121.00091,1,1150480,1158113,-,7633
378,BUMA.1121.00098,1,1989993,1997621,+,7628
378,BUMA.1121.00013,1,285812,293285,+,7473
378,BUMA.1121.00049,1,2480891,2488430,-,7539
378,BUMA.1121.00072,1,3242226,3249847,+,7621
378,BUMA.1121.00076,1,1978393,1985993,-,7600
378,BUMA.1121.00083,1,2332507,2340129,-,7622
378,BUMA.1121.00078,1,2664690,2672289,-,7599
378,BUMA.1121.00095,1,2346306,2353913,-,7607
378,BUMA.1121.00077,1,1998335,2005914,+,7579
378,BUMA.1121.00063,1,3254327,3261947,+,7620
378,BUMA.1121.00061,1,3257439,3265059,+,7620
378,BUMA.1121.00050,1,2210105,2217569,+,7464
378,BUMA.1121.00081,1,2479216,2486664,-,7448
378,BUMA.1121.00074,1,528266,535932,-,7666
378,BUMA.1121.00062,1,1217600,1225132,-,7532
378,BUMA.1121.00060,1,2971604,2979154,-,7550
378,BUMA.1121.00070,1,3228521,3236132,+,7611
378,BUMA.1121.00075,1,2826410,2834007,+,7597
378,BUMA.1121.00041,1,588501,596022,+,7521
378,BUMA.1121.00073,1,3255914,3263531,+,7617
378,BUMA.1121.00017,1,93269,100734,-,7465
378,BUMA.1121.00066,1,3245280,3252876,+,7596
378,BUMA.1121.00107,1,3271718,3279339,+,7621
378,BUMA.1121.00085,1,289873,297347,-,7474
378,BUMA.1121.00030,1,93269,100734,-,7465
378,BUMA.1121.00112,1,3733281,3740841,-,7560
378,BUMA.1121.00002,1,1514713,1522160,+,7447
378,BUMA.1121.00082,1,3439263,3446884,+,7621
378,BUMA.1121.00014,1,3580101,3587676,-,7575
378,BUMA.1121.00011,1,2270134,2277769,-,7635
378,BUMA.1121.00019,1,93276,100741,-,7465
378,BUMA.1121.00057,1,438079,445652,+,7573
378,BUMA.1121.00018,1,3965174,3972765,+,7591
378,BUMA.1121.00039,1,3481403,3488959,+,7556
378,BUMA.1121.00016,1,1448050,1455663,+,7613
378,BUMA.1121.00004,1,93262,100727,-,7465
378,BUMA.1121.00005,1,2088417,2095992,+,7575
378,BUMA.1121.00100,1,1949267,1956866,-,7599
378,BUMA.1121.00006,1,2479027,2486475,-,7448
379,BUMA.1121.00027,1,1534724,1543797,+,9073
379,BUMA.1121.00025,1,3423749,3432903,-,9154
379,BUMA.1121.00021,1,4006759,4015893,+,9134
379,BUMA.1121.00023,1,1682466,1691513,+,9047
379,BUMA.1121.00024,1,80523,89370,-,8847
379,BUMA.1121.00033,1,1562328,1571347,+,9019
379,BUMA.1121.00034,1,80523,89370,-,8847
379,BUMA.1121.00036,1,2805042,2813859,-,8817
379,BUMA.1121.00032,1,1677508,1686343,-,8835
379,BUMA.1121.00009,1,2204059,2213063,-,9004
379,BUMA.1121.00008,1,80523,89370,-,8847
379,BUMA.1121.00003,1,1864522,1873564,+,9042
379,BUMA.1121.00109,1,2553001,2562324,-,9323
379,BUMA.1121.00053,1,3107341,3116388,+,9047
379,BUMA.1121.00110,1,1464614,1473448,-,8834
379,BUMA.1121.00104,1,1895792,1905020,-,9228
379,BUMA.1121.00086,1,2517919,2526729,-,8810
379,BUMA.1121.00092,1,429697,438803,-,9106
379,BUMA.1121.00096,1,3949945,3959088,-,9143
379,BUMA.1121.00054,1,1668033,1676903,+,8870
379,BUMA.1121.00097,1,579860,588968,-,9108
379,BUMA.1121.00093,1,95028,104134,+,9106
379,BUMA.1121.00106,1,3097230,3106368,+,9138
379,BUMA.1121.00010,1,1499817,1508660,+,8843
379,BUMA.1121.00035,1,387776,396916,+,9140
379,BUMA.1121.00108,1,347131,356010,+,8879
379,BUMA.1121.00028,1,80523,89377,-,8854
379,BUMA.1121.00094,1,3327840,3337049,+,9209
379,BUMA.1121.00102,1,1940027,1949231,-,9204
379,BUMA.1121.00111,1,3533137,3542281,+,9144
379,BUMA.1121.00089,1,3299665,3308874,+,9209
379,BUMA.1121.00084,1,3710623,3719729,+,9106
379,BUMA.1121.00029,1,1570143,1579281,-,9138
379,BUMA.1121.00012,1,2097045,2106095,+,9050
379,BUMA.1121.00087,1,808889,817699,+,8810
379,BUMA.1121.00043,1,3478336,3487528,+,9192
379,BUMA.1121.00046,1,521599,530448,-,8849
379,BUMA.1121.00037,1,1980833,1989975,+,9142
379,BUMA.1121.00080,1,3360530,3369729,+,9199
379,BUMA.1121.00079,1,3393830,3403065,+,9235
379,BUMA.1121.00045,1,713297,722356,-,9059
379,BUMA.1121.00071,1,3271797,3280882,+,9085
379,BUMA.1121.00056,1,618076,627261,-,9185
379,BUMA.1121.00065,1,3408597,3417677,+,9080
379,BUMA.1121.00058,1,1147487,1156722,-,9235
379,BUMA.1121.00007,1,705775,714864,-,9089
379,BUMA.1121.00067,1,1070625,1079818,-,9193
379,BUMA.1121.00090,1,1420228,1429386,+,9158
379,BUMA.1121.00051,1,3311776,3320902,+,9126
379,BUMA.1121.00020,1,80523,89370,-,8847
379,BUMA.1121.00103,1,1015381,1024451,-,9070
379,BUMA.1121.00048,1,2258837,2267707,-,8870
379,BUMA.1121.00047,1,3659396,3668486,-,9090
379,BUMA.1121.00042,1,612510,621375,-,8865
379,BUMA.1121.00055,1,3025735,3034825,+,9090
379,BUMA.1121.00031,1,673779,682897,+,9118
379,BUMA.1121.00040,1,1089536,1098365,+,8829
379,BUMA.1121.00044,1,2882526,2891373,-,8847
379,BUMA.1121.00088,1,178113,187201,+,9088
379,BUMA.1121.00069,1,3252687,3261771,+,9084
379,BUMA.1121.00064,1,3348600,3357777,+,9177
379,BUMA.1121.00105,1,1849902,1858988,-,9086
379,BUMA.1121.00015,1,2998850,3007713,-,8863
379,BUMA.1121.00059,1,2589522,2598623,+,9101
379,BUMA.1121.00026,1,1824213,1833050,+,8837
379,BUMA.1121.00022,1,63142,71952,-,8810
379,BUMA.1121.00052,1,680001,688985,-,8984
379,BUMA.1121.00101,1,3097990,3107137,-,9147
379,BUMA.1121.00001,1,696229,705325,-,9096
379,BUMA.1121.00038,1,2466250,2475120,-,8870
379,BUMA.1121.00068,1,2138636,2147842,+,9206
379,BUMA.1121.00099,1,3065660,3074684,-,9024
379,BUMA.1121.00091,1,1137247,1146408,-,9161
379,BUMA.1121.00098,1,2001539,2010703,+,9164
379,BUMA.1121.00013,1,297346,306282,+,8936
379,BUMA.1121.00049,1,2467763,2476803,-,9040
379,BUMA.1121.00072,1,3253906,3262992,+,9086
379,BUMA.1121.00076,1,1965090,1974272,-,9182
379,BUMA.1121.00083,1,2319337,2328428,-,9091
379,BUMA.1121.00078,1,2651455,2660562,-,9107
379,BUMA.1121.00095,1,2333107,2342234,-,9127
379,BUMA.1121.00077,1,2009874,2018709,+,8835
379,BUMA.1121.00063,1,3266006,3275016,+,9010
379,BUMA.1121.00061,1,3269118,3278203,+,9085
379,BUMA.1121.00050,1,2221427,2230276,+,8849
379,BUMA.1121.00081,1,2466377,2475247,-,8870
379,BUMA.1121.00074,1,515165,524348,-,9183
379,BUMA.1121.00062,1,1204354,1213507,-,9153
379,BUMA.1121.00060,1,2958557,2967623,-,9066
379,BUMA.1121.00070,1,3240191,3249277,+,9086
379,BUMA.1121.00075,1,2838038,2847215,+,9177
379,BUMA.1121.00041,1,600193,609343,+,9150
379,BUMA.1121.00073,1,3267590,3276681,+,9091
379,BUMA.1121.00017,1,80523,89370,-,8847
379,BUMA.1121.00066,1,3256935,3266020,+,9085
379,BUMA.1121.00107,1,3283330,3292356,+,9026
379,BUMA.1121.00085,1,276829,285813,-,8984
379,BUMA.1121.00030,1,80523,89370,-,8847
379,BUMA.1121.00112,1,3720232,3729222,-,8990
379,BUMA.1121.00002,1,1526081,1534924,+,8843
379,BUMA.1121.00082,1,3450943,3460034,+,9091
379,BUMA.1121.00014,1,3566955,3576015,-,9060
379,BUMA.1121.00011,1,2256937,2265956,-,9019
379,BUMA.1121.00019,1,80523,89370,-,8847
379,BUMA.1121.00057,1,449711,458783,+,9072
379,BUMA.1121.00018,1,3976838,3985991,+,9153
379,BUMA.1121.00039,1,3492913,3501979,+,9066
379,BUMA.1121.00016,1,1459708,1468822,+,9114
379,BUMA.1121.00004,1,80523,89370,-,8847
379,BUMA.1121.00005,1,2100356,2109418,+,9062
379,BUMA.1121.00100,1,1935900,1945069,-,9169
379,BUMA.1121.00006,1,2466167,2475030,-,8863
380,BUMA.1121.00027,1,1548577,1552880,+,4303
380,BUMA.1121.00025,1,3414706,3418984,-,4278
380,BUMA.1121.00021,1,4020657,4024935,+,4278
380,BUMA.1121.00023,1,1696277,1700555,+,4278
380,BUMA.1121.00024,1,71533,75822,-,4289
380,BUMA.1121.00033,1,1576111,1580388,+,4277
380,BUMA.1121.00034,1,71533,75822,-,4289
380,BUMA.1121.00036,1,2794444,2798733,-,4289
380,BUMA.1121.00032,1,1668518,1672807,-,4289
380,BUMA.1121.00009,1,2194985,2199276,-,4291
380,BUMA.1121.00008,1,71533,75822,-,4289
380,BUMA.1121.00003,1,1878345,1882648,+,4303
380,BUMA.1121.00109,1,2543925,2548214,-,4289
380,BUMA.1121.00053,1,3121169,3125458,+,4289
380,BUMA.1121.00110,1,1455542,1459832,-,4290
380,BUMA.1121.00104,1,1886721,1891010,-,4289
380,BUMA.1121.00086,1,2508929,2513218,-,4289
380,BUMA.1121.00092,1,420637,424914,-,4277
380,BUMA.1121.00096,1,3940874,3945163,-,4289
380,BUMA.1121.00054,1,1683181,1687470,+,4289
380,BUMA.1121.00097,1,570778,575072,-,4294
380,BUMA.1121.00093,1,108916,113193,+,4277
380,BUMA.1121.00106,1,3111150,3115439,+,4289
380,BUMA.1121.00010,1,1513360,1517649,+,4289
380,BUMA.1121.00035,1,401698,405976,+,4278
380,BUMA.1121.00108,1,360792,365070,+,4278
380,BUMA.1121.00028,1,71533,75822,-,4289
380,BUMA.1121.00094,1,3343423,3347717,+,4294
380,BUMA.1121.00102,1,1930986,1935262,-,4276
380,BUMA.1121.00111,1,3547045,3551324,+,4279
380,BUMA.1121.00089,1,3315249,3319543,+,4294
380,BUMA.1121.00084,1,3724510,3728799,+,4289
380,BUMA.1121.00029,1,1561082,1565360,-,4278
380,BUMA.1121.00012,1,2110877,2115155,+,4278
380,BUMA.1121.00087,1,822399,826688,+,4289
380,BUMA.1121.00043,1,3492310,3496588,+,4278
380,BUMA.1121.00046,1,511031,515320,-,4289
380,BUMA.1121.00037,1,1994739,1999017,+,4278
380,BUMA.1121.00080,1,3376104,3380398,+,4294
380,BUMA.1121.00079,1,3409436,3413730,+,4294
380,BUMA.1121.00045,1,704230,708519,-,4289
380,BUMA.1121.00071,1,3285589,3289892,+,4303
380,BUMA.1121.00056,1,607406,611700,-,4294
380,BUMA.1121.00065,1,3422441,3426733,+,4292
380,BUMA.1121.00058,1,1138402,1142705,-,4303
380,BUMA.1121.00007,1,696693,700998,-,4305
380,BUMA.1121.00067,1,1059963,1064252,-,4289
380,BUMA.1121.00090,1,1434150,1438428,+,4278
380,BUMA.1121.00051,1,3327277,3331571,+,4294
380,BUMA.1121.00020,1,71533,75822,-,4289
380,BUMA.1121.00103,1,1006305,1010594,-,4289
380,BUMA.1121.00048,1,2248270,2252559,-,4289
380,BUMA.1121.00047,1,3648726,3653020,-,4294
380,BUMA.1121.00042,1,603506,607809,-,4303
380,BUMA.1121.00055,1,3039589,3043867,+,4278
380,BUMA.1121.00031,1,687661,691939,+,4278
380,BUMA.1121.00040,1,1103052,1107341,+,4289
380,BUMA.1121.00044,1,2873536,2877825,-,4289
380,BUMA.1121.00088,1,191982,196286,+,4304
380,BUMA.1121.00069,1,3266477,3270780,+,4303
380,BUMA.1121.00064,1,3362558,3366847,+,4289
380,BUMA.1121.00105,1,1840816,1845120,-,4304
380,BUMA.1121.00015,1,2988282,2992571,-,4289
380,BUMA.1121.00059,1,2604995,2609299,+,4304
380,BUMA.1121.00026,1,1837750,1842053,+,4303
380,BUMA.1121.00022,1,54152,58441,-,4289
380,BUMA.1121.00052,1,671024,675313,-,4289
380,BUMA.1121.00101,1,3088908,3093211,-,4303
380,BUMA.1121.00001,1,687168,691446,-,4278
380,BUMA.1121.00038,1,2455682,2459971,-,4289
380,BUMA.1121.00068,1,2152628,2156931,+,4303
380,BUMA.1121.00099,1,3056588,3060877,-,4289
380,BUMA.1121.00091,1,1128206,1132483,-,4277
380,BUMA.1121.00098,1,2015485,2019774,+,4289
380,BUMA.1121.00013,1,310969,315258,+,4289
380,BUMA.1121.00049,1,2458704,2462980,-,4276
380,BUMA.1121.00072,1,3267696,3271999,+,4303
380,BUMA.1121.00076,1,1956019,1960308,-,4289
380,BUMA.1121.00083,1,2310252,2314555,-,4303
380,BUMA.1121.00078,1,2642383,2646672,-,4289
380,BUMA.1121.00095,1,2324026,2328315,-,4289
380,BUMA.1121.00077,1,2023490,2027780,+,4290
380,BUMA.1121.00063,1,3279724,3284027,+,4303
380,BUMA.1121.00061,1,3282910,3287213,+,4303
380,BUMA.1121.00050,1,2236554,2240843,+,4289
380,BUMA.1121.00081,1,2455809,2460098,-,4289
380,BUMA.1121.00074,1,504503,508792,-,4289
380,BUMA.1121.00062,1,1195278,1199572,-,4294
380,BUMA.1121.00060,1,2949490,2953779,-,4289
380,BUMA.1121.00070,1,3253982,3258285,+,4303
380,BUMA.1121.00075,1,2851996,2856285,+,4289
380,BUMA.1121.00041,1,614125,618414,+,4289
380,BUMA.1121.00073,1,3281397,3285700,+,4303
380,BUMA.1121.00017,1,71533,75822,-,4289
380,BUMA.1121.00066,1,3270725,3275028,+,4303
380,BUMA.1121.00107,1,3297138,3301414,+,4276
380,BUMA.1121.00085,1,267852,272141,-,4289
380,BUMA.1121.00030,1,71533,75822,-,4289
380,BUMA.1121.00112,1,3711160,3715449,-,4289
380,BUMA.1121.00002,1,1539624,1543913,+,4289
380,BUMA.1121.00082,1,3464815,3469118,+,4303
380,BUMA.1121.00014,1,3557912,3562190,-,4278
380,BUMA.1121.00011,1,2247866,2252155,-,4289
380,BUMA.1121.00019,1,71533,75822,-,4289
380,BUMA.1121.00057,1,465155,469458,+,4303
380,BUMA.1121.00018,1,3990755,3995033,+,4278
380,BUMA.1121.00039,1,3506743,3511021,+,4278
380,BUMA.1121.00016,1,1473586,1477863,+,4277
380,BUMA.1121.00004,1,71533,75822,-,4289
380,BUMA.1121.00005,1,2114196,2118472,+,4276
380,BUMA.1121.00100,1,1926814,1931105,-,4291
380,BUMA.1121.00006,1,2455599,2459888,-,4289
381,BUMA.1121.00027,1,1564222,1572075,+,7853
381,BUMA.1121.00025,1,3395511,3403366,-,7855
381,BUMA.1121.00021,1,4036276,4044145,+,7869
381,BUMA.1121.00023,1,1711896,1719752,+,7856
381,BUMA.1121.00024,1,140651,148533,+,7882
381,BUMA.1121.00033,1,1591730,1599586,+,7856
381,BUMA.1121.00034,1,140665,148547,+,7882
381,BUMA.1121.00036,1,2865163,2873045,+,7882
381,BUMA.1121.00032,1,1737652,1745534,+,7882
381,BUMA.1121.00009,1,2175776,2183641,-,7865
381,BUMA.1121.00008,1,140679,148561,+,7882
381,BUMA.1121.00003,1,1893998,1901832,+,7834
381,BUMA.1121.00109,1,2524740,2532588,-,7848
381,BUMA.1121.00053,1,3136807,3144660,+,7853
381,BUMA.1121.00110,1,1436364,1444203,-,7839
381,BUMA.1121.00104,1,1867519,1875390,-,7871
381,BUMA.1121.00086,1,2578001,2585883,+,7882
381,BUMA.1121.00092,1,401430,409296,-,7866
381,BUMA.1121.00096,1,3921671,3929540,-,7869
381,BUMA.1121.00054,1,1608753,1616635,-,7882
381,BUMA.1121.00097,1,550233,558117,-,7884
381,BUMA.1121.00093,1,124534,132401,+,7867
381,BUMA.1121.00106,1,3126779,3134681,+,7902
381,BUMA.1121.00010,1,659743,667615,+,7872
381,BUMA.1121.00035,1,417316,425175,+,7859
381,BUMA.1121.00108,1,376399,384263,+,7864
381,BUMA.1121.00028,1,140665,148547,+,7882
381,BUMA.1121.00094,1,3359059,3366927,+,7868
381,BUMA.1121.00102,1,1911774,1919629,-,7855
381,BUMA.1121.00111,1,3562657,3570513,+,7856
381,BUMA.1121.00089,1,3330878,3338737,+,7859
381,BUMA.1121.00084,1,3740135,3747991,+,7856
381,BUMA.1121.00029,1,1541884,1549742,-,7858
381,BUMA.1121.00012,1,2126496,2134343,+,7847
381,BUMA.1121.00087,1,749735,757617,-,7882
381,BUMA.1121.00043,1,3507927,3515785,+,7858
381,BUMA.1121.00046,1,581710,589612,+,7902
381,BUMA.1121.00037,1,2010359,2019451,+,9092
381,BUMA.1121.00080,1,3391733,3399592,+,7859
381,BUMA.1121.00079,1,3425065,3432924,+,7859
381,BUMA.1121.00045,1,685041,692891,-,7850
381,BUMA.1121.00071,1,3301233,3309097,+,7864
381,BUMA.1121.00056,1,588213,596071,-,7858
381,BUMA.1121.00065,1,3438049,3445951,+,7902
381,BUMA.1121.00058,1,1119170,1127061,-,7891
381,BUMA.1121.00007,1,677489,685356,-,7867
381,BUMA.1121.00067,1,1040770,1048622,-,7852
381,BUMA.1121.00090,1,1449768,1457624,+,7856
381,BUMA.1121.00051,1,3342906,3350765,+,7859
381,BUMA.1121.00020,1,140672,148554,+,7882
381,BUMA.1121.00103,1,987110,994964,-,7854
381,BUMA.1121.00048,1,2319070,2326952,+,7882
381,BUMA.1121.00047,1,3629523,3637391,-,7868
381,BUMA.1121.00042,1,672646,680537,+,7891
381,BUMA.1121.00055,1,3055207,3063098,+,7891
381,BUMA.1121.00031,1,703281,711143,+,7862
381,BUMA.1121.00040,1,1030313,1038195,-,7882
381,BUMA.1121.00044,1,2942668,2950550,+,7882
381,BUMA.1121.00088,1,207622,215494,+,7872
381,BUMA.1121.00069,1,3282122,3290004,+,7882
381,BUMA.1121.00064,1,3378188,3386041,+,7853
381,BUMA.1121.00105,1,1821623,1829474,-,7851
381,BUMA.1121.00015,1,3059019,3066901,+,7882
381,BUMA.1121.00059,1,2622234,2630087,+,7853
381,BUMA.1121.00026,1,1765023,1772914,-,7891
381,BUMA.1121.00022,1,123269,131151,+,7882
381,BUMA.1121.00052,1,740499,748381,+,7882
381,BUMA.1121.00101,1,3069692,3077552,-,7860
381,BUMA.1121.00001,1,667970,675828,-,7858
381,BUMA.1121.00038,1,2526483,2534365,+,7882
381,BUMA.1121.00068,1,2168275,2176236,+,7961
381,BUMA.1121.00099,1,3037396,3045242,-,7846
381,BUMA.1121.00091,1,1109015,1116867,-,7852
381,BUMA.1121.00098,1,2031782,2039630,+,7848
381,BUMA.1121.00013,1,237933,245815,-,7882
381,BUMA.1121.00049,1,2439497,2447355,-,7858
381,BUMA.1121.00072,1,3283336,3291234,+,7898
381,BUMA.1121.00076,1,1936807,1944678,-,7871
381,BUMA.1121.00083,1,2291013,2298910,-,7897
381,BUMA.1121.00078,1,2623176,2631043,-,7867
381,BUMA.1121.00095,1,2304832,2312695,-,7863
381,BUMA.1121.00077,1,2039119,2046959,+,7840
381,BUMA.1121.00063,1,3295369,3303265,+,7896
381,BUMA.1121.00061,1,3298555,3306453,+,7898
381,BUMA.1121.00050,1,2162259,2170161,-,7902
381,BUMA.1121.00081,1,2526610,2534492,+,7882
381,BUMA.1121.00074,1,485310,493162,-,7852
381,BUMA.1121.00062,1,1176050,1183930,-,7880
381,BUMA.1121.00060,1,2930301,2938151,-,7850
381,BUMA.1121.00070,1,3269627,3277525,+,7898
381,BUMA.1121.00075,1,2867626,2875498,+,7872
381,BUMA.1121.00041,1,629754,637617,+,7863
381,BUMA.1121.00073,1,3297042,3304940,+,7898
381,BUMA.1121.00017,1,140665,148547,+,7882
381,BUMA.1121.00066,1,3286370,3294268,+,7898
381,BUMA.1121.00107,1,3312742,3320676,+,7934
381,BUMA.1121.00085,1,337334,345216,+,7882
381,BUMA.1121.00030,1,140665,148547,+,7882
381,BUMA.1121.00112,1,3691941,3699805,-,7864
381,BUMA.1121.00002,1,685076,692948,+,7872
381,BUMA.1121.00082,1,3480460,3488358,+,7898
381,BUMA.1121.00014,1,3538698,3546569,-,7871
381,BUMA.1121.00011,1,2228677,2236532,-,7855
381,BUMA.1121.00019,1,140672,148554,+,7882
381,BUMA.1121.00057,1,480800,488653,+,7853
381,BUMA.1121.00018,1,4006373,4014229,+,7856
381,BUMA.1121.00039,1,3522361,3530217,+,7856
381,BUMA.1121.00016,1,1490796,1498653,+,7857
381,BUMA.1121.00004,1,140658,148540,+,7882
381,BUMA.1121.00005,1,2129829,2137703,+,7874
381,BUMA.1121.00100,1,1907609,1915461,-,7852
381,BUMA.1121.00006,1,2526421,2534303,+,7882
382,BUMA.1121.00027,1,1575601,1581917,+,6316
382,BUMA.1121.00025,1,3385491,3391985,-,6494
382,BUMA.1121.00021,1,503,6819,+,6316
382,BUMA.1121.00023,1,1723278,1729594,+,6316
382,BUMA.1121.00024,1,152059,158372,+,6313
382,BUMA.1121.00033,1,1603112,1609428,+,6316
382,BUMA.1121.00034,1,152073,158386,+,6313
382,BUMA.1121.00036,1,2876571,2882884,+,6313
382,BUMA.1121.00032,1,1749060,1755373,+,6313
382,BUMA.1121.00009,1,2165778,2172273,-,6495
382,BUMA.1121.00008,1,152087,158400,+,6313
382,BUMA.1121.00003,1,1905358,1911674,+,6316
382,BUMA.1121.00109,1,2514897,2521213,-,6316
382,BUMA.1121.00053,1,3148186,3154502,+,6316
382,BUMA.1121.00110,1,1426544,1432860,-,6316
382,BUMA.1121.00104,1,1857497,1863992,-,6495
382,BUMA.1121.00086,1,2589409,2595722,+,6313
382,BUMA.1121.00092,1,391432,397927,-,6495
382,BUMA.1121.00096,1,3911672,3918167,-,6495
382,BUMA.1121.00054,1,1597447,1603912,-,6465
382,BUMA.1121.00097,1,540208,546706,-,6498
382,BUMA.1121.00093,1,135904,142220,+,6316
382,BUMA.1121.00106,1,3138207,3144523,+,6316
382,BUMA.1121.00010,1,671141,677454,+,6313
382,BUMA.1121.00035,1,428701,435017,+,6316
382,BUMA.1121.00108,1,389350,395666,+,6316
382,BUMA.1121.00028,1,152073,158386,+,6313
382,BUMA.1121.00094,1,3370454,3376770,+,6316
382,BUMA.1121.00102,1,1901753,1908248,-,6495
382,BUMA.1121.00111,1,3573999,3580315,+,6316
382,BUMA.1121.00089,1,3342264,3348580,+,6316
382,BUMA.1121.00084,1,3751518,3757834,+,6316
382,BUMA.1121.00029,1,1531863,1538358,-,6495
382,BUMA.1121.00012,1,2137869,2144185,+,6316
382,BUMA.1121.00087,1,739744,746209,-,6465
382,BUMA.1121.00043,1,3519311,3525627,+,6316
382,BUMA.1121.00046,1,594453,600766,+,6313
382,BUMA.1121.00037,1,2022977,2029293,+,6316
382,BUMA.1121.00080,1,3403119,3409435,+,6316
382,BUMA.1121.00079,1,3436449,3442765,+,6316
382,BUMA.1121.00045,1,675020,681515,-,6495
382,BUMA.1121.00071,1,3312623,3318939,+,6316
382,BUMA.1121.00056,1,578191,584686,-,6495
382,BUMA.1121.00065,1,3449478,3455794,+,6316
382,BUMA.1121.00058,1,1109149,1115644,-,6495
382,BUMA.1121.00007,1,667447,673962,-,6515
382,BUMA.1121.00067,1,1030748,1037243,-,6495
382,BUMA.1121.00090,1,1461150,1467464,+,6314
382,BUMA.1121.00051,1,3354292,3360608,+,6316
382,BUMA.1121.00020,1,152080,158393,+,6313
382,BUMA.1121.00103,1,974214,980709,-,6495
382,BUMA.1121.00048,1,2331793,2338106,+,6313
382,BUMA.1121.00047,1,3619501,3625996,-,6495
382,BUMA.1121.00042,1,684063,690376,+,6313
382,BUMA.1121.00055,1,3066624,3072940,+,6316
382,BUMA.1121.00031,1,714669,720985,+,6316
382,BUMA.1121.00040,1,1020323,1026786,-,6463
382,BUMA.1121.00044,1,2954076,2960389,+,6313
382,BUMA.1121.00088,1,218998,225314,+,6316
382,BUMA.1121.00069,1,3293522,3299838,+,6316
382,BUMA.1121.00064,1,3389567,3395883,+,6316
382,BUMA.1121.00105,1,1811602,1818097,-,6495
382,BUMA.1121.00015,1,3071742,3078055,+,6313
382,BUMA.1121.00059,1,2633613,2639929,+,6316
382,BUMA.1121.00026,1,1755032,1761497,-,6465
382,BUMA.1121.00022,1,134677,140990,+,6313
382,BUMA.1121.00052,1,753222,759535,+,6313
382,BUMA.1121.00101,1,3058310,3064605,-,6295
382,BUMA.1121.00001,1,657949,664444,-,6495
382,BUMA.1121.00038,1,2539206,2545519,+,6313
382,BUMA.1121.00068,1,2179762,2186078,+,6316
382,BUMA.1121.00099,1,3027402,3033870,-,6468
382,BUMA.1121.00091,1,1098993,1105488,-,6495
382,BUMA.1121.00098,1,2043157,2049473,+,6316
382,BUMA.1121.00013,1,226627,233092,-,6465
382,BUMA.1121.00049,1,2429479,2435971,-,6492
382,BUMA.1121.00072,1,3294760,3301076,+,6316
382,BUMA.1121.00076,1,1926785,1933280,-,6495
382,BUMA.1121.00083,1,2280992,2287487,-,6495
382,BUMA.1121.00078,1,2613158,2619650,-,6492
382,BUMA.1121.00095,1,2294811,2301306,-,6495
382,BUMA.1121.00077,1,2050463,2056779,+,6316
382,BUMA.1121.00063,1,3306791,3313107,+,6316
382,BUMA.1121.00061,1,3309979,3316295,+,6316
382,BUMA.1121.00050,1,2150954,2157419,-,6465
382,BUMA.1121.00081,1,2539333,2545646,+,6313
382,BUMA.1121.00074,1,475288,481783,-,6495
382,BUMA.1121.00062,1,1166029,1172524,-,6495
382,BUMA.1121.00060,1,2920280,2926775,-,6495
382,BUMA.1121.00070,1,3281051,3287367,+,6316
382,BUMA.1121.00075,1,2879025,2885341,+,6316
382,BUMA.1121.00041,1,641143,647459,+,6316
382,BUMA.1121.00073,1,3308466,3314782,+,6316
382,BUMA.1121.00017,1,152073,158386,+,6313
382,BUMA.1121.00066,1,3297794,3304110,+,6316
382,BUMA.1121.00107,1,3324166,3330482,+,6316
382,BUMA.1121.00085,1,350057,356370,+,6313
382,BUMA.1121.00030,1,152073,158386,+,6313
382,BUMA.1121.00112,1,3681920,3688415,-,6495
382,BUMA.1121.00002,1,696474,702787,+,6313
382,BUMA.1121.00082,1,3491884,3498200,+,6316
382,BUMA.1121.00014,1,3528677,3535172,-,6495
382,BUMA.1121.00011,1,2218682,2225150,-,6468
382,BUMA.1121.00019,1,152080,158393,+,6313
382,BUMA.1121.00057,1,492179,498495,+,6316
382,BUMA.1121.00018,1,4017755,4024070,+,6315
382,BUMA.1121.00039,1,3533743,3540059,+,6316
382,BUMA.1121.00016,1,1502179,1508495,+,6316
382,BUMA.1121.00004,1,152066,158379,+,6313
382,BUMA.1121.00005,1,2141229,2147545,+,6316
382,BUMA.1121.00100,1,1897609,1904104,-,6495
382,BUMA.1121.00006,1,2539144,2545457,+,6313
383,BUMA.1121.00027,1,1588184,1598563,+,10379
383,BUMA.1121.00025,1,3368955,3379367,-,10412
383,BUMA.1121.00021,1,13193,23658,+,10465
383,BUMA.1121.00023,1,1735903,1746314,+,10411
383,BUMA.1121.00024,1,164601,174992,+,10391
383,BUMA.1121.00033,1,1615835,1626252,+,10417
383,BUMA.1121.00034,1,164615,175006,+,10391
383,BUMA.1121.00036,1,2889113,2899504,+,10391
383,BUMA.1121.00032,1,1761602,1771993,+,10391
383,BUMA.1121.00009,1,2149233,2159642,-,10409
383,BUMA.1121.00008,1,164629,175020,+,10391
383,BUMA.1121.00003,1,1917984,1928370,+,10386
383,BUMA.1121.00109,1,2498258,2508648,-,10390
383,BUMA.1121.00053,1,3162380,3172792,+,10412
383,BUMA.1121.00110,1,1409866,1420270,-,10404
383,BUMA.1121.00104,1,1840939,1851350,-,10411
383,BUMA.1121.00086,1,2601951,2612342,+,10391
383,BUMA.1121.00092,1,374941,385332,-,10391
383,BUMA.1121.00096,1,3895117,3905544,-,10427
383,BUMA.1121.00054,1,1580979,1591370,-,10391
383,BUMA.1121.00097,1,523649,534088,-,10439
383,BUMA.1121.00093,1,148499,158890,+,10391
383,BUMA.1121.00106,1,3150802,3161193,+,10391
383,BUMA.1121.00010,1,683683,694074,+,10391
383,BUMA.1121.00035,1,441316,451721,+,10405
383,BUMA.1121.00108,1,401949,412352,+,10403
383,BUMA.1121.00028,1,164615,175006,+,10391
383,BUMA.1121.00094,1,3383088,3393459,+,10371
383,BUMA.1121.00102,1,1885312,1895671,-,10359
383,BUMA.1121.00111,1,3586677,3597112,+,10435
383,BUMA.1121.00089,1,3354898,3365269,+,10371
383,BUMA.1121.00084,1,3764111,3774532,+,10421
383,BUMA.1121.00029,1,1515345,1525750,-,10405
383,BUMA.1121.00012,1,2150494,2160905,+,10411
383,BUMA.1121.00087,1,723276,733667,-,10391
383,BUMA.1121.00043,1,3533292,3543696,+,10404
383,BUMA.1121.00046,1,606995,617386,+,10391
383,BUMA.1121.00037,1,2035663,2046074,+,10411
383,BUMA.1121.00080,1,3415760,3426131,+,10371
383,BUMA.1121.00079,1,3449106,3459478,+,10372
383,BUMA.1121.00045,1,658486,668919,-,10433
383,BUMA.1121.00071,1,3325206,3335591,+,10385
383,BUMA.1121.00056,1,561681,572091,-,10410
383,BUMA.1121.00065,1,3462091,3472482,+,10391
383,BUMA.1121.00058,1,1092592,1102997,-,10405
383,BUMA.1121.00007,1,650952,661343,-,10391
383,BUMA.1121.00067,1,1014235,1024694,-,10459
383,BUMA.1121.00090,1,1473756,1484191,+,10435
383,BUMA.1121.00051,1,3366992,3377364,+,10372
383,BUMA.1121.00020,1,164622,175013,+,10391
383,BUMA.1121.00103,1,957676,968093,-,10417
383,BUMA.1121.00048,1,2344335,2354726,+,10391
383,BUMA.1121.00047,1,3602948,3613353,-,10405
383,BUMA.1121.00042,1,696606,706997,+,10391
383,BUMA.1121.00055,1,3079213,3089622,+,10409
383,BUMA.1121.00031,1,727295,737706,+,10411
383,BUMA.1121.00040,1,1003868,1014246,-,10378
383,BUMA.1121.00044,1,2966618,2977009,+,10391
383,BUMA.1121.00088,1,231587,242032,+,10445
383,BUMA.1121.00069,1,3306111,3316490,+,10379
383,BUMA.1121.00064,1,3402162,3412541,+,10379
383,BUMA.1121.00105,1,1795045,1805501,-,10456
383,BUMA.1121.00015,1,3084284,3094675,+,10391
383,BUMA.1121.00059,1,2646219,2656610,+,10391
383,BUMA.1121.00026,1,1738554,1748954,-,10400
383,BUMA.1121.00022,1,147219,157610,+,10391
383,BUMA.1121.00052,1,765770,776050,+,10280
383,BUMA.1121.00101,1,3039972,3050344,-,10372
383,BUMA.1121.00001,1,641433,651843,-,10410
383,BUMA.1121.00038,1,2551748,2562139,+,10391
383,BUMA.1121.00068,1,2192364,2202776,+,10412
383,BUMA.1121.00099,1,3010926,3021337,-,10411
383,BUMA.1121.00091,1,1082507,1092901,-,10394
383,BUMA.1121.00098,1,2055726,2066126,+,10400
383,BUMA.1121.00013,1,210264,220544,-,10280
383,BUMA.1121.00049,1,2412951,2423350,-,10399
383,BUMA.1121.00072,1,3307343,3317728,+,10385
383,BUMA.1121.00076,1,1910211,1920732,-,10521
383,BUMA.1121.00083,1,2264519,2274898,-,10379
383,BUMA.1121.00078,1,2596631,2607061,-,10430
383,BUMA.1121.00095,1,2278270,2288701,-,10431
383,BUMA.1121.00077,1,2063051,2073455,+,10404
383,BUMA.1121.00063,1,3319364,3329755,+,10391
383,BUMA.1121.00061,1,3322554,3332945,+,10391
383,BUMA.1121.00050,1,2134486,2144877,-,10391
383,BUMA.1121.00081,1,2551875,2562266,+,10391
383,BUMA.1121.00074,1,458815,469194,-,10379
383,BUMA.1121.00062,1,1149514,1159911,-,10397
383,BUMA.1121.00060,1,2903746,2914179,-,10433
383,BUMA.1121.00070,1,3293640,3304019,+,10379
383,BUMA.1121.00075,1,2891667,2902082,+,10415
383,BUMA.1121.00041,1,653712,664108,+,10396
383,BUMA.1121.00073,1,3321049,3331434,+,10385
383,BUMA.1121.00017,1,164615,175006,+,10391
383,BUMA.1121.00066,1,3310377,3320762,+,10385
383,BUMA.1121.00107,1,3336795,3347167,+,10372
383,BUMA.1121.00085,1,362605,372885,+,10280
383,BUMA.1121.00030,1,164615,175006,+,10391
383,BUMA.1121.00112,1,3665330,3675849,-,10519
383,BUMA.1121.00002,1,709016,719407,+,10391
383,BUMA.1121.00082,1,3504473,3514852,+,10379
383,BUMA.1121.00014,1,3512122,3522557,-,10435
383,BUMA.1121.00011,1,2202195,2212572,-,10377
383,BUMA.1121.00019,1,164622,175013,+,10391
383,BUMA.1121.00057,1,504762,515141,+,10379
383,BUMA.1121.00018,1,4030373,4040784,+,10411
383,BUMA.1121.00039,1,3546392,3556815,+,10423
383,BUMA.1121.00016,1,1514797,1525214,+,10417
383,BUMA.1121.00004,1,164608,174999,+,10391
383,BUMA.1121.00005,1,2153812,2164209,+,10397
383,BUMA.1121.00100,1,1881139,1891535,-,10396
383,BUMA.1121.00006,1,2551686,2562077,+,10391
384,BUMA.1121.00027,1,1600876,1641362,+,40486
384,BUMA.1121.00025,1,3326113,3366642,-,40529
384,BUMA.1121.00021,1,25969,66543,+,40574
384,BUMA.1121.00023,1,1748627,1789142,+,40515
384,BUMA.1121.00024,1,629010,669575,+,40565
384,BUMA.1121.00024,1,693927,734496,+,40569
384,BUMA.1121.00033,1,1628565,1669070,+,40505
384,BUMA.1121.00034,1,629013,669598,+,40585
384,BUMA.1121.00034,1,731330,771915,+,40585
384,BUMA.1121.00036,1,2903053,2943561,+,40508
384,BUMA.1121.00032,1,2224424,2265002,+,40578
384,BUMA.1121.00009,1,2106389,2146921,-,40532
384,BUMA.1121.00008,1,629031,669610,+,40579
384,BUMA.1121.00008,1,697669,738238,+,40569
384,BUMA.1121.00003,1,1930683,1971258,+,40575
384,BUMA.1121.00109,1,2455441,2495945,-,40504
384,BUMA.1121.00053,1,3175104,3215567,+,40463
384,BUMA.1121.00110,1,1367012,1407553,-,40541
384,BUMA.1121.00104,1,1798069,1838627,-,40558
384,BUMA.1121.00086,1,3249527,3290036,-,40509
384,BUMA.1121.00092,1,332084,372628,-,40544
384,BUMA.1121.00096,1,3852287,3892804,-,40517
384,BUMA.1121.00054,1,1538154,1578670,-,40516
384,BUMA.1121.00097,1,480833,521336,-,40503
384,BUMA.1121.00093,1,161203,201746,+,40543
384,BUMA.1121.00106,1,3163505,3204023,+,40518
384,BUMA.1121.00010,1,696383,736888,+,40505
384,BUMA.1121.00035,1,454033,494540,+,40507
384,BUMA.1121.00108,1,414683,455181,+,40498
384,BUMA.1121.00028,1,629019,669586,+,40567
384,BUMA.1121.00028,1,693941,734501,+,40560
384,BUMA.1121.00094,1,3395772,3436270,+,40498
384,BUMA.1121.00102,1,1842390,1883000,-,40610
384,BUMA.1121.00111,1,3599425,3639933,+,40508
384,BUMA.1121.00089,1,3367582,3408081,+,40499
384,BUMA.1121.00084,1,3776844,3817296,+,40452
384,BUMA.1121.00029,1,1472556,1513033,-,40477
384,BUMA.1121.00012,1,2163218,2203733,+,40515
384,BUMA.1121.00087,1,45949,86457,+,40508
384,BUMA.1121.00043,1,3546009,3586511,+,40502
384,BUMA.1121.00046,1,619695,660196,+,40501
384,BUMA.1121.00037,1,2048386,2088856,+,40470
384,BUMA.1121.00080,1,3428443,3468989,+,40546
384,BUMA.1121.00079,1,3461791,3502365,+,40574
384,BUMA.1121.00045,1,615614,656173,-,40559
384,BUMA.1121.00071,1,3337904,3378400,+,40496
384,BUMA.1121.00056,1,518868,559368,-,40500
384,BUMA.1121.00065,1,3474794,3515312,+,40518
384,BUMA.1121.00058,1,1049754,1090279,-,40525
384,BUMA.1121.00007,1,608038,648639,-,40601
384,BUMA.1121.00067,1,971338,1011923,-,40585
384,BUMA.1121.00090,1,1486504,1527040,+,40536
384,BUMA.1121.00051,1,3379677,3420192,+,40515
384,BUMA.1121.00020,1,629025,669570,+,40545
384,BUMA.1121.00020,1,693930,734506,+,40576
384,BUMA.1121.00020,1,758866,799442,+,40576
384,BUMA.1121.00103,1,914835,955363,-,40528
384,BUMA.1121.00048,1,2357035,2397550,+,40515
384,BUMA.1121.00047,1,3560112,3600635,-,40523
384,BUMA.1121.00042,1,709306,749786,+,40480
384,BUMA.1121.00055,1,3091934,3133739,+,41805
384,BUMA.1121.00031,1,740018,780560,+,40542
384,BUMA.1121.00040,1,961071,1001559,-,40488
384,BUMA.1121.00044,1,3431019,3471604,+,40585
384,BUMA.1121.00088,1,244344,284803,+,40459
384,BUMA.1121.00069,1,3318803,3359299,+,40496
384,BUMA.1121.00064,1,3414853,3455393,+,40540
384,BUMA.1121.00105,1,1752214,1792732,-,40518
384,BUMA.1121.00015,1,3096984,3137443,+,40459
384,BUMA.1121.00059,1,2658922,2699484,+,40562
384,BUMA.1121.00026,1,1695729,1736245,-,40516
384,BUMA.1121.00022,1,161159,201646,+,40487
384,BUMA.1121.00052,1,778359,818979,+,40620
384,BUMA.1121.00101,1,2997064,3037659,-,40595
384,BUMA.1121.00001,1,598607,639121,-,40514
384,BUMA.1121.00038,1,2564448,2604963,+,40515
384,BUMA.1121.00068,1,2205088,2245621,+,40533
384,BUMA.1121.00099,1,2968076,3008613,-,40537
384,BUMA.1121.00091,1,1039671,1080194,-,40523
384,BUMA.1121.00098,1,2068439,2108928,+,40489
384,BUMA.1121.00013,1,167397,207955,-,40558
384,BUMA.1121.00049,1,2370113,2410639,-,40526
384,BUMA.1121.00072,1,3320041,3360537,+,40496
384,BUMA.1121.00076,1,1867369,1907899,-,40530
384,BUMA.1121.00083,1,2221709,2262206,-,40497
384,BUMA.1121.00078,1,2553753,2594318,-,40565
384,BUMA.1121.00095,1,2235431,2275957,-,40526
384,BUMA.1121.00077,1,2075768,2116307,+,40539
384,BUMA.1121.00063,1,3332068,3372564,+,40496
384,BUMA.1121.00061,1,3335258,3375754,+,40496
384,BUMA.1121.00050,1,2091682,2132177,-,40495
384,BUMA.1121.00081,1,2564575,2605090,+,40515
384,BUMA.1121.00074,1,415913,456503,-,40590
384,BUMA.1121.00062,1,1105293,1147202,-,41909
384,BUMA.1121.00060,1,2860867,2901433,-,40566
384,BUMA.1121.00070,1,3306332,3346826,+,40494
384,BUMA.1121.00075,1,2904394,2944916,+,40522
384,BUMA.1121.00041,1,666421,706972,+,40551
384,BUMA.1121.00073,1,3333747,3374240,+,40493
384,BUMA.1121.00017,1,629017,669602,+,40585
384,BUMA.1121.00066,1,3323075,3363571,+,40496
384,BUMA.1121.00107,1,3349480,3389995,+,40515
384,BUMA.1121.00085,1,375194,415814,+,40620
384,BUMA.1121.00030,1,629017,669602,+,40585
384,BUMA.1121.00112,1,3622413,3663017,-,40604
384,BUMA.1121.00002,1,721716,762224,+,40508
384,BUMA.1121.00082,1,3517165,3557661,+,40496
384,BUMA.1121.00014,1,3469279,3509808,-,40529
384,BUMA.1121.00011,1,2159368,2199882,-,40514
384,BUMA.1121.00019,1,629031,669610,+,40579
384,BUMA.1121.00019,1,693970,734540,+,40570
384,BUMA.1121.00057,1,517454,557946,+,40492
384,BUMA.1121.00018,1,4043097,4083632,+,40535
384,BUMA.1121.00039,1,3559128,3599670,+,40542
384,BUMA.1121.00016,1,1527527,1568037,+,40510
384,BUMA.1121.00004,1,629011,669571,+,40560
384,BUMA.1121.00004,1,693927,734482,+,40555
384,BUMA.1121.00005,1,2166521,2207057,+,40536
384,BUMA.1121.00100,1,1838318,1878826,-,40508
384,BUMA.1121.00006,1,2564386,2604901,+,40515
385,BUMA.1121.00027,1,1641364,1646430,+,5066
385,BUMA.1121.00025,1,3321046,3326112,-,5066
385,BUMA.1121.00021,1,66545,71611,+,5066
385,BUMA.1121.00023,1,1789144,1794210,+,5066
385,BUMA.1121.00024,1,669577,674643,+,5066
385,BUMA.1121.00024,1,734498,739564,+,5066
385,BUMA.1121.00033,1,1669072,1674138,+,5066
385,BUMA.1121.00034,1,669600,674666,+,5066
385,BUMA.1121.00034,1,771917,776983,+,5066
385,BUMA.1121.00036,1,2943563,2948629,+,5066
385,BUMA.1121.00032,1,2265004,2270070,+,5066
385,BUMA.1121.00009,1,2101322,2106388,-,5066
385,BUMA.1121.00008,1,669612,674678,+,5066
385,BUMA.1121.00008,1,738240,743306,+,5066
385,BUMA.1121.00003,1,1971260,1976325,+,5065
385,BUMA.1121.00109,1,2450374,2455440,-,5066
385,BUMA.1121.00053,1,3215569,3220635,+,5066
385,BUMA.1121.00110,1,1361945,1367011,-,5066
385,BUMA.1121.00104,1,1793002,1798068,-,5066
385,BUMA.1121.00086,1,3244460,3249526,-,5066
385,BUMA.1121.00092,1,327017,332083,-,5066
385,BUMA.1121.00096,1,3847220,3852286,-,5066
385,BUMA.1121.00054,1,1533087,1538153,-,5066
385,BUMA.1121.00097,1,475767,480832,-,5065
385,BUMA.1121.00093,1,201748,206814,+,5066
385,BUMA.1121.00106,1,3204025,3209091,+,5066
385,BUMA.1121.00010,1,736890,741956,+,5066
385,BUMA.1121.00035,1,494542,499614,+,5072
385,BUMA.1121.00108,1,455183,460249,+,5066
385,BUMA.1121.00028,1,669588,674654,+,5066
385,BUMA.1121.00028,1,734503,739569,+,5066
385,BUMA.1121.00094,1,3436272,3441338,+,5066
385,BUMA.1121.00102,1,1837323,1842389,-,5066
385,BUMA.1121.00111,1,3639935,3645001,+,5066
385,BUMA.1121.00089,1,3408083,3413149,+,5066
385,BUMA.1121.00084,1,3817298,3822364,+,5066
385,BUMA.1121.00029,1,1467483,1472555,-,5072
385,BUMA.1121.00012,1,2203735,2208801,+,5066
385,BUMA.1121.00087,1,86459,91525,+,5066
385,BUMA.1121.00043,1,3586513,3591579,+,5066
385,BUMA.1121.00046,1,660198,665264,+,5066
385,BUMA.1121.00037,1,2088858,2093924,+,5066
385,BUMA.1121.00080,1,3468991,3474057,+,5066
385,BUMA.1121.00079,1,3502367,3507433,+,5066
385,BUMA.1121.00045,1,610538,615613,-,5075
385,BUMA.1121.00071,1,3378402,3383450,+,5048
385,BUMA.1121.00056,1,513801,518867,-,5066
385,BUMA.1121.00065,1,3515314,3520380,+,5066
385,BUMA.1121.00058,1,1044675,1049753,-,5078
385,BUMA.1121.00007,1,602972,608037,-,5065
385,BUMA.1121.00067,1,966271,971337,-,5066
385,BUMA.1121.00090,1,1527042,1532108,+,5066
385,BUMA.1121.00051,1,3420194,3425258,+,5064
385,BUMA.1121.00020,1,669572,674638,+,5066
385,BUMA.1121.00020,1,734508,739574,+,5066
385,BUMA.1121.00020,1,799444,804510,+,5066
385,BUMA.1121.00103,1,909768,914834,-,5066
385,BUMA.1121.00048,1,2397552,2402618,+,5066
385,BUMA.1121.00047,1,3555045,3560111,-,5066
385,BUMA.1121.00042,1,749788,754854,+,5066
385,BUMA.1121.00055,1,3133741,3138807,+,5066
385,BUMA.1121.00031,1,780562,785628,+,5066
385,BUMA.1121.00040,1,956004,961070,-,5066
385,BUMA.1121.00044,1,49,5103,+,5054
385,BUMA.1121.00044,1,3471606,3476672,+,5066
385,BUMA.1121.00088,1,284805,289871,+,5066
385,BUMA.1121.00069,1,3359301,3364349,+,5048
385,BUMA.1121.00064,1,3455395,3460461,+,5066
385,BUMA.1121.00105,1,1747147,1752213,-,5066
385,BUMA.1121.00015,1,3137445,3142511,+,5066
385,BUMA.1121.00059,1,2699486,2704552,+,5066
385,BUMA.1121.00026,1,1690662,1695728,-,5066
385,BUMA.1121.00022,1,201648,206714,+,5066
385,BUMA.1121.00052,1,818981,824047,+,5066
385,BUMA.1121.00101,1,2991998,2997063,-,5065
385,BUMA.1121.00001,1,593534,598606,-,5072
385,BUMA.1121.00038,1,2604965,2610031,+,5066
385,BUMA.1121.00068,1,2245623,2250688,+,5065
385,BUMA.1121.00099,1,2963009,2968075,-,5066
385,BUMA.1121.00091,1,1034606,1039670,-,5064
385,BUMA.1121.00098,1,2108930,2114008,+,5078
385,BUMA.1121.00013,1,162330,167396,-,5066
385,BUMA.1121.00049,1,2365046,2370112,-,5066
385,BUMA.1121.00072,1,3360539,3365587,+,5048
385,BUMA.1121.00076,1,1862302,1867368,-,5066
385,BUMA.1121.00083,1,2216660,2221708,-,5048
385,BUMA.1121.00078,1,2548686,2553752,-,5066
385,BUMA.1121.00095,1,2230364,2235430,-,5066
385,BUMA.1121.00077,1,2116309,2121375,+,5066
385,BUMA.1121.00063,1,3372566,3377614,+,5048
385,BUMA.1121.00061,1,3375756,3380804,+,5048
385,BUMA.1121.00050,1,2086615,2091681,-,5066
385,BUMA.1121.00081,1,2605092,2610158,+,5066
385,BUMA.1121.00074,1,410846,415912,-,5066
385,BUMA.1121.00062,1,1100226,1105292,-,5066
385,BUMA.1121.00060,1,2855791,2860866,-,5075
385,BUMA.1121.00070,1,3346828,3351876,+,5048
385,BUMA.1121.00075,1,2944918,2949983,+,5065
385,BUMA.1121.00041,1,706974,712040,+,5066
385,BUMA.1121.00073,1,3374242,3379290,+,5048
385,BUMA.1121.00017,1,669604,674670,+,5066
385,BUMA.1121.00066,1,3363573,3368621,+,5048
385,BUMA.1121.00107,1,3389997,3395063,+,5066
385,BUMA.1121.00085,1,415816,420882,+,5066
385,BUMA.1121.00030,1,669604,674670,+,5066
385,BUMA.1121.00112,1,3617348,3622412,-,5064
385,BUMA.1121.00002,1,762226,767292,+,5066
385,BUMA.1121.00082,1,3557663,3562711,+,5048
385,BUMA.1121.00014,1,3464212,3469278,-,5066
385,BUMA.1121.00011,1,2154301,2159367,-,5066
385,BUMA.1121.00019,1,669612,674678,+,5066
385,BUMA.1121.00019,1,734542,739608,+,5066
385,BUMA.1121.00057,1,557948,563014,+,5066
385,BUMA.1121.00018,1,4083634,4088700,+,5066
385,BUMA.1121.00039,1,3599672,3604738,+,5066
385,BUMA.1121.00016,1,1568039,1573105,+,5066
385,BUMA.1121.00004,1,669573,674639,+,5066
385,BUMA.1121.00004,1,734484,739550,+,5066
385,BUMA.1121.00005,1,2207059,2212125,+,5066
385,BUMA.1121.00100,1,1833251,1838317,-,5066
385,BUMA.1121.00006,1,2604903,2609969,+,5066
386,BUMA.1121.00027,1,1646666,1661056,+,14390
386,BUMA.1121.00025,1,3306420,3320810,-,14390
386,BUMA.1121.00021,1,71847,86237,+,14390
386,BUMA.1121.00023,1,1794446,1808836,+,14390
386,BUMA.1121.00024,1,674879,689157,+,14278
386,BUMA.1121.00024,1,739800,754082,+,14282
386,BUMA.1121.00033,1,1674374,1688760,+,14386
386,BUMA.1121.00034,1,674902,689179,+,14277
386,BUMA.1121.00034,1,777219,791512,+,14293
386,BUMA.1121.00036,1,2948865,2963150,+,14285
386,BUMA.1121.00032,1,2270306,2284591,+,14285
386,BUMA.1121.00009,1,2086695,2101086,-,14391
386,BUMA.1121.00008,1,674914,689193,+,14279
386,BUMA.1121.00008,1,743542,757833,+,14291
386,BUMA.1121.00003,1,1976561,1990961,+,14400
386,BUMA.1121.00109,1,2435747,2450138,-,14391
386,BUMA.1121.00053,1,3220871,3235262,+,14391
386,BUMA.1121.00110,1,1347318,1361709,-,14391
386,BUMA.1121.00104,1,1778360,1792766,-,14406
386,BUMA.1121.00086,1,3229938,3244224,-,14286
386,BUMA.1121.00092,1,312376,326781,-,14405
386,BUMA.1121.00096,1,3832593,3846984,-,14391
386,BUMA.1121.00054,1,1518593,1532851,-,14258
386,BUMA.1121.00097,1,461140,475531,-,14391
386,BUMA.1121.00093,1,207050,221456,+,14406
386,BUMA.1121.00106,1,3209327,3223719,+,14392
386,BUMA.1121.00010,1,742192,756465,+,14273
386,BUMA.1121.00035,1,499850,514240,+,14390
386,BUMA.1121.00108,1,460485,474870,+,14385
386,BUMA.1121.00028,1,674890,689171,+,14281
386,BUMA.1121.00028,1,739805,754081,+,14276
386,BUMA.1121.00094,1,3441574,3455963,+,14389
386,BUMA.1121.00102,1,1822771,1837087,-,14316
386,BUMA.1121.00111,1,3645237,3659627,+,14390
386,BUMA.1121.00089,1,3413385,3427775,+,14390
386,BUMA.1121.00084,1,3822600,3836990,+,14390
386,BUMA.1121.00029,1,1452857,1467247,-,14390
386,BUMA.1121.00012,1,2209037,2223424,+,14387
386,BUMA.1121.00087,1,91761,106046,+,14285
386,BUMA.1121.00043,1,3591815,3606205,+,14390
386,BUMA.1121.00046,1,665500,679803,+,14303
386,BUMA.1121.00037,1,2094160,2108550,+,14390
386,BUMA.1121.00080,1,3474293,3488683,+,14390
386,BUMA.1121.00079,1,3507669,3522058,+,14389
386,BUMA.1121.00045,1,595929,610302,-,14373
386,BUMA.1121.00071,1,3383686,3398074,+,14388
386,BUMA.1121.00056,1,499175,513565,-,14390
386,BUMA.1121.00065,1,3520616,3535006,+,14390
386,BUMA.1121.00058,1,1030048,1044439,-,14391
386,BUMA.1121.00007,1,587030,601390,-,14360
386,BUMA.1121.00067,1,951644,966035,-,14391
386,BUMA.1121.00090,1,1532344,1546719,+,14375
386,BUMA.1121.00051,1,3425494,3439883,+,14389
386,BUMA.1121.00020,1,674874,689160,+,14286
386,BUMA.1121.00020,1,739810,754096,+,14286
386,BUMA.1121.00020,1,804746,819031,+,14285
386,BUMA.1121.00103,1,895146,909532,-,14386
386,BUMA.1121.00048,1,2402854,2417112,+,14258
386,BUMA.1121.00047,1,3540419,3554809,-,14390
386,BUMA.1121.00042,1,755090,769376,+,14286
386,BUMA.1121.00055,1,3139043,3153434,+,14391
386,BUMA.1121.00031,1,785864,800253,+,14389
386,BUMA.1121.00040,1,941513,955768,-,14255
386,BUMA.1121.00044,1,5339,19619,+,14280
386,BUMA.1121.00044,1,3476908,3491193,+,14285
386,BUMA.1121.00088,1,290107,304497,+,14390
386,BUMA.1121.00069,1,3364585,3378961,+,14376
386,BUMA.1121.00064,1,3460697,3475103,+,14406
386,BUMA.1121.00105,1,1732521,1746911,-,14390
386,BUMA.1121.00015,1,3142747,3157035,+,14288
386,BUMA.1121.00059,1,2704788,2719193,+,14405
386,BUMA.1121.00026,1,1676154,1690426,-,14272
386,BUMA.1121.00022,1,206950,221235,+,14285
386,BUMA.1121.00052,1,824283,838571,+,14288
386,BUMA.1121.00101,1,2977371,2991762,-,14391
386,BUMA.1121.00001,1,578908,593298,-,14390
386,BUMA.1121.00038,1,2610267,2624525,+,14258
386,BUMA.1121.00068,1,2250924,2265313,+,14389
386,BUMA.1121.00099,1,2948383,2962773,-,14390
386,BUMA.1121.00091,1,1019980,1034370,-,14390
386,BUMA.1121.00098,1,2114244,2128634,+,14390
386,BUMA.1121.00013,1,147806,162094,-,14288
386,BUMA.1121.00049,1,2350449,2364810,-,14361
386,BUMA.1121.00072,1,3365823,3380211,+,14388
386,BUMA.1121.00076,1,1847676,1862066,-,14390
386,BUMA.1121.00083,1,2202034,2216424,-,14390
386,BUMA.1121.00078,1,2534060,2548450,-,14390
386,BUMA.1121.00095,1,2215752,2230128,-,14376
386,BUMA.1121.00077,1,2121611,2136001,+,14390
386,BUMA.1121.00063,1,3377850,3392226,+,14376
386,BUMA.1121.00061,1,3381040,3395420,+,14380
386,BUMA.1121.00050,1,2072076,2086379,-,14303
386,BUMA.1121.00081,1,2610394,2624652,+,14258
386,BUMA.1121.00074,1,396219,410610,-,14391
386,BUMA.1121.00062,1,1085600,1099990,-,14390
386,BUMA.1121.00060,1,2841182,2855555,-,14373
386,BUMA.1121.00070,1,3352112,3366483,+,14371
386,BUMA.1121.00075,1,2950219,2964608,+,14389
386,BUMA.1121.00041,1,712276,727979,+,15703
386,BUMA.1121.00073,1,3379526,3393901,+,14375
386,BUMA.1121.00017,1,674906,689191,+,14285
386,BUMA.1121.00066,1,3368857,3383247,+,14390
386,BUMA.1121.00107,1,3395299,3409691,+,14392
386,BUMA.1121.00085,1,421118,435406,+,14288
386,BUMA.1121.00030,1,674906,689191,+,14285
386,BUMA.1121.00112,1,3602737,3617112,-,14375
386,BUMA.1121.00002,1,767528,781801,+,14273
386,BUMA.1121.00082,1,3562947,3577337,+,14390
386,BUMA.1121.00014,1,3449587,3463976,-,14389
386,BUMA.1121.00011,1,2139675,2154065,-,14390
386,BUMA.1121.00019,1,674914,689200,+,14286
386,BUMA.1121.00019,1,739844,754131,+,14287
386,BUMA.1121.00057,1,563250,577640,+,14390
386,BUMA.1121.00018,1,4088936,4103326,+,14390
386,BUMA.1121.00039,1,3604974,3619364,+,14390
386,BUMA.1121.00016,1,1573341,1587730,+,14389
386,BUMA.1121.00004,1,674875,689157,+,14282
386,BUMA.1121.00004,1,739786,754040,+,14254
386,BUMA.1121.00005,1,2212361,2226752,+,14391
386,BUMA.1121.00100,1,1818600,1833015,-,14415
386,BUMA.1121.00006,1,2610205,2624463,+,14258
387,BUMA.1121.00027,1,1662679,1667069,+,4390
387,BUMA.1121.00025,1,3302004,3306399,-,4395
387,BUMA.1121.00021,1,86258,90654,+,4396
387,BUMA.1121.00023,1,1808857,1813252,+,4395
387,BUMA.1121.00024,1,755702,760092,+,4390
387,BUMA.1121.00033,1,1688781,1693176,+,4395
387,BUMA.1121.00034,1,690800,695189,+,4389
387,BUMA.1121.00034,1,793132,797522,+,4390
387,BUMA.1121.00036,1,2964773,2969163,+,4390
387,BUMA.1121.00032,1,2286211,2290601,+,4390
387,BUMA.1121.00009,1,2082279,2086674,-,4395
387,BUMA.1121.00008,1,759453,763843,+,4390
387,BUMA.1121.00003,1,1990983,1995378,+,4395
387,BUMA.1121.00109,1,2431331,2435726,-,4395
387,BUMA.1121.00053,1,3235283,3239678,+,4395
387,BUMA.1121.00110,1,1342862,1347297,-,4435
387,BUMA.1121.00104,1,1773944,1778339,-,4395
387,BUMA.1121.00086,1,3223927,3228317,-,4390
387,BUMA.1121.00092,1,307960,312355,-,4395
387,BUMA.1121.00096,1,3828177,3832572,-,4395
387,BUMA.1121.00054,1,1514177,1518572,-,4395
387,BUMA.1121.00097,1,456724,461119,-,4395
387,BUMA.1121.00093,1,221477,225872,+,4395
387,BUMA.1121.00106,1,3223740,3228135,+,4395
387,BUMA.1121.00010,1,756486,760881,+,4395
387,BUMA.1121.00035,1,514261,518656,+,4395
387,BUMA.1121.00108,1,476490,480880,+,4390
387,BUMA.1121.00028,1,755701,760091,+,4390
387,BUMA.1121.00094,1,3455985,3460380,+,4395
387,BUMA.1121.00102,1,1818355,1822750,-,4395
387,BUMA.1121.00111,1,3659648,3664043,+,4395
387,BUMA.1121.00089,1,3427797,3432192,+,4395
387,BUMA.1121.00084,1,3837011,3841406,+,4395
387,BUMA.1121.00029,1,1448441,1452836,-,4395
387,BUMA.1121.00012,1,2223445,2227840,+,4395
387,BUMA.1121.00087,1,107668,112058,+,4390
387,BUMA.1121.00043,1,3606226,3610622,+,4396
387,BUMA.1121.00046,1,679824,684219,+,4395
387,BUMA.1121.00037,1,2108571,2112966,+,4395
387,BUMA.1121.00080,1,3488705,3493100,+,4395
387,BUMA.1121.00079,1,3522080,3526475,+,4395
387,BUMA.1121.00045,1,589921,594316,-,4395
387,BUMA.1121.00071,1,3399699,3404089,+,4390
387,BUMA.1121.00056,1,494758,499153,-,4395
387,BUMA.1121.00065,1,3535027,3539422,+,4395
387,BUMA.1121.00058,1,1025632,1030027,-,4395
387,BUMA.1121.00007,1,582614,587009,-,4395
387,BUMA.1121.00067,1,947228,951623,-,4395
387,BUMA.1121.00090,1,1546740,1551135,+,4395
387,BUMA.1121.00051,1,3439905,3444299,+,4394
387,BUMA.1121.00020,1,820651,825041,+,4390
387,BUMA.1121.00103,1,890730,895125,-,4395
387,BUMA.1121.00048,1,2417133,2421528,+,4395
387,BUMA.1121.00047,1,3536002,3540397,-,4395
387,BUMA.1121.00042,1,770989,775384,+,4395
387,BUMA.1121.00055,1,3153456,3157851,+,4395
387,BUMA.1121.00031,1,800274,804669,+,4395
387,BUMA.1121.00040,1,937097,941492,-,4395
387,BUMA.1121.00044,1,21239,25629,+,4390
387,BUMA.1121.00044,1,3492813,3497203,+,4390
387,BUMA.1121.00088,1,304518,308913,+,4395
387,BUMA.1121.00069,1,3380584,3384974,+,4390
387,BUMA.1121.00064,1,3475124,3479519,+,4395
387,BUMA.1121.00105,1,1728105,1732500,-,4395
387,BUMA.1121.00015,1,3157056,3161451,+,4395
387,BUMA.1121.00059,1,2719214,2723609,+,4395
387,BUMA.1121.00026,1,1670148,1674543,-,4395
387,BUMA.1121.00022,1,222854,227244,+,4390
387,BUMA.1121.00052,1,838592,842987,+,4395
387,BUMA.1121.00101,1,2972954,2977349,-,4395
387,BUMA.1121.00001,1,574492,578887,-,4395
387,BUMA.1121.00038,1,2624546,2628941,+,4395
387,BUMA.1121.00068,1,2265334,2269729,+,4395
387,BUMA.1121.00099,1,2943967,2948362,-,4395
387,BUMA.1121.00091,1,1015564,1019959,-,4395
387,BUMA.1121.00098,1,2130247,2134642,+,4395
387,BUMA.1121.00013,1,143390,147785,-,4395
387,BUMA.1121.00049,1,2346033,2350428,-,4395
387,BUMA.1121.00072,1,3381834,3386224,+,4390
387,BUMA.1121.00076,1,1841668,1846063,-,4395
387,BUMA.1121.00083,1,2196021,2200411,-,4390
387,BUMA.1121.00078,1,2529643,2534038,-,4395
387,BUMA.1121.00095,1,2211336,2215731,-,4395
387,BUMA.1121.00077,1,2136022,2140404,+,4382
387,BUMA.1121.00063,1,3393849,3398239,+,4390
387,BUMA.1121.00061,1,3397041,3401431,+,4390
387,BUMA.1121.00050,1,2067660,2072055,-,4395
387,BUMA.1121.00081,1,2624673,2629068,+,4395
387,BUMA.1121.00074,1,391803,396198,-,4395
387,BUMA.1121.00062,1,1081184,1085579,-,4395
387,BUMA.1121.00060,1,2835174,2839569,-,4395
387,BUMA.1121.00070,1,3368106,3372496,+,4390
387,BUMA.1121.00075,1,2966220,2970615,+,4395
387,BUMA.1121.00041,1,728000,732395,+,4395
387,BUMA.1121.00073,1,3395524,3399914,+,4390
387,BUMA.1121.00017,1,690811,695201,+,4390
387,BUMA.1121.00066,1,3384870,3389260,+,4390
387,BUMA.1121.00107,1,3409712,3414107,+,4395
387,BUMA.1121.00085,1,435427,439822,+,4395
387,BUMA.1121.00030,1,690811,695201,+,4390
387,BUMA.1121.00112,1,3598322,3602716,-,4394
387,BUMA.1121.00002,1,781822,786217,+,4395
387,BUMA.1121.00082,1,3578960,3583350,+,4390
387,BUMA.1121.00014,1,3445171,3449566,-,4395
387,BUMA.1121.00011,1,2135259,2139654,-,4395
387,BUMA.1121.00019,1,755751,760141,+,4390
387,BUMA.1121.00057,1,579263,583653,+,4390
387,BUMA.1121.00018,1,4103347,4107742,+,4395
387,BUMA.1121.00039,1,3619385,3623780,+,4395
387,BUMA.1121.00016,1,1587751,1592145,+,4394
387,BUMA.1121.00004,1,755660,760050,+,4390
387,BUMA.1121.00005,1,2226773,2231167,+,4394
387,BUMA.1121.00100,1,1814184,1818579,-,4395
387,BUMA.1121.00006,1,2624484,2628879,+,4395
388,BUMA.1121.00027,1,1667118,1680953,+,13835
388,BUMA.1121.00025,1,3288126,3301955,-,13829
388,BUMA.1121.00021,1,90703,104533,+,13830
388,BUMA.1121.00023,1,1813301,1827130,+,13829
388,BUMA.1121.00024,1,763863,777764,+,13901
388,BUMA.1121.00033,1,1693225,1707052,+,13827
388,BUMA.1121.00034,1,801293,815194,+,13901
388,BUMA.1121.00036,1,2972934,2986871,+,13937
388,BUMA.1121.00032,1,2294372,2308279,+,13907
388,BUMA.1121.00009,1,2068396,2082230,-,13834
388,BUMA.1121.00008,1,767614,781509,+,13895
388,BUMA.1121.00003,1,2013374,2027200,+,13826
388,BUMA.1121.00109,1,2417330,2431282,-,13952
388,BUMA.1121.00053,1,3239727,3253551,+,13824
388,BUMA.1121.00110,1,1304517,1318353,-,13836
388,BUMA.1121.00104,1,1759960,1773895,-,13935
388,BUMA.1121.00086,1,3206315,3220156,-,13841
388,BUMA.1121.00092,1,294009,307911,-,13902
388,BUMA.1121.00096,1,3814219,3828128,-,13909
388,BUMA.1121.00054,1,1495566,1509503,-,13937
388,BUMA.1121.00097,1,442848,456675,-,13827
388,BUMA.1121.00093,1,225921,239829,+,13908
388,BUMA.1121.00106,1,3228184,3242015,+,13831
388,BUMA.1121.00010,1,765217,779088,+,13871
388,BUMA.1121.00035,1,518705,532536,+,13831
388,BUMA.1121.00108,1,480929,494867,+,13938
388,BUMA.1121.00028,1,763862,777763,+,13901
388,BUMA.1121.00094,1,3460429,3474361,+,13932
388,BUMA.1121.00102,1,1804356,1818306,-,13950
388,BUMA.1121.00111,1,3664092,3677921,+,13829
388,BUMA.1121.00089,1,3432241,3446173,+,13932
388,BUMA.1121.00084,1,3841455,3855370,+,13915
388,BUMA.1121.00029,1,1434563,1448392,-,13829
388,BUMA.1121.00012,1,2227889,2241718,+,13829
388,BUMA.1121.00087,1,115829,129670,+,13841
388,BUMA.1121.00043,1,3610671,3624509,+,13838
388,BUMA.1121.00046,1,687990,701903,+,13913
388,BUMA.1121.00037,1,2113015,2126844,+,13829
388,BUMA.1121.00080,1,3493149,3507027,+,13878
388,BUMA.1121.00079,1,3526524,3540480,+,13956
388,BUMA.1121.00045,1,575939,589872,-,13933
388,BUMA.1121.00071,1,3404138,3417964,+,13826
388,BUMA.1121.00056,1,480759,494709,-,13950
388,BUMA.1121.00065,1,3539471,3553349,+,13878
388,BUMA.1121.00058,1,1011663,1025583,-,13920
388,BUMA.1121.00007,1,546722,560629,-,13907
388,BUMA.1121.00067,1,933301,947179,-,13878
388,BUMA.1121.00090,1,1551184,1565013,+,13829
388,BUMA.1121.00051,1,3444348,3458316,+,13968
388,BUMA.1121.00020,1,828812,842707,+,13895
388,BUMA.1121.00103,1,859702,873581,-,13879
388,BUMA.1121.00048,1,2426202,2440139,+,13937
388,BUMA.1121.00047,1,3522003,3535953,-,13950
388,BUMA.1121.00042,1,779082,792941,+,13859
388,BUMA.1121.00055,1,3157900,3171775,+,13875
388,BUMA.1121.00031,1,825737,839565,+,13828
388,BUMA.1121.00040,1,242558,256417,+,13859
388,BUMA.1121.00044,1,29400,43301,+,13901
388,BUMA.1121.00088,1,308962,322882,+,13920
388,BUMA.1121.00069,1,3385023,3398849,+,13826
388,BUMA.1121.00064,1,3479568,3493458,+,13890
388,BUMA.1121.00105,1,1714198,1728056,-,13858
388,BUMA.1121.00015,1,3165222,3179111,+,13889
388,BUMA.1121.00059,1,2723658,2737584,+,13926
388,BUMA.1121.00026,1,1652494,1666377,-,13883
388,BUMA.1121.00022,1,231015,244856,+,13841
388,BUMA.1121.00052,1,846758,860599,+,13841
388,BUMA.1121.00101,1,2959048,2972905,-,13857
388,BUMA.1121.00001,1,560614,574443,-,13829
388,BUMA.1121.00038,1,2633615,2647545,+,13930
388,BUMA.1121.00068,1,2269778,2283725,+,13947
388,BUMA.1121.00099,1,2929866,2943918,-,14052
388,BUMA.1121.00091,1,1001619,1015515,-,13896
388,BUMA.1121.00098,1,2134691,2148528,+,13837
388,BUMA.1121.00013,1,125784,139619,-,13835
388,BUMA.1121.00049,1,2332088,2345984,-,13896
388,BUMA.1121.00072,1,3386273,3400099,+,13826
388,BUMA.1121.00076,1,1827771,1841619,-,13848
388,BUMA.1121.00083,1,2182146,2195972,-,13826
388,BUMA.1121.00078,1,2515783,2529594,-,13811
388,BUMA.1121.00095,1,2197415,2211287,-,13872
388,BUMA.1121.00077,1,2164963,2178799,+,13836
388,BUMA.1121.00063,1,3398288,3412114,+,13826
388,BUMA.1121.00061,1,3401480,3415305,+,13825
388,BUMA.1121.00050,1,2049982,2063889,-,13907
388,BUMA.1121.00081,1,2633742,2647679,+,13937
388,BUMA.1121.00074,1,377864,391754,-,13890
388,BUMA.1121.00062,1,1067197,1081135,-,13938
388,BUMA.1121.00060,1,2821180,2835125,-,13945
388,BUMA.1121.00070,1,3372545,3386371,+,13826
388,BUMA.1121.00075,1,2970664,2984500,+,13836
388,BUMA.1121.00041,1,732444,746303,+,13859
388,BUMA.1121.00073,1,3399963,3413789,+,13826
388,BUMA.1121.00017,1,698972,712813,+,13841
388,BUMA.1121.00066,1,3389309,3403135,+,13826
388,BUMA.1121.00107,1,3414156,3427993,+,13837
388,BUMA.1121.00085,1,443593,457434,+,13841
388,BUMA.1121.00030,1,698972,712873,+,13901
388,BUMA.1121.00112,1,3584443,3598273,-,13830
388,BUMA.1121.00002,1,790551,804482,+,13931
388,BUMA.1121.00082,1,3583399,3597225,+,13826
388,BUMA.1121.00014,1,3400350,3414179,-,13829
388,BUMA.1121.00011,1,2121319,2135210,-,13891
388,BUMA.1121.00019,1,763912,777807,+,13895
388,BUMA.1121.00057,1,583702,597592,+,13890
388,BUMA.1121.00018,1,4107791,4121620,+,13829
388,BUMA.1121.00039,1,3623829,3637658,+,13829
388,BUMA.1121.00016,1,1592194,1606014,+,13820
388,BUMA.1121.00004,1,763821,777722,+,13901
388,BUMA.1121.00005,1,2231216,2245040,+,13824
388,BUMA.1121.00100,1,1800269,1814135,-,13866
388,BUMA.1121.00006,1,2633553,2647490,+,13937
389,BUMA.1121.00027,1,1681018,1702746,+,21728
389,BUMA.1121.00025,1,3266332,3288061,-,21729
389,BUMA.1121.00021,1,104598,126327,+,21729
389,BUMA.1121.00023,1,1827195,1848924,+,21729
389,BUMA.1121.00024,1,777829,799558,+,21729
389,BUMA.1121.00033,1,1707117,1728845,+,21728
389,BUMA.1121.00034,1,815259,836988,+,21729
389,BUMA.1121.00036,1,2986936,3008665,+,21729
389,BUMA.1121.00032,1,2308344,2330073,+,21729
389,BUMA.1121.00009,1,2046602,2068331,-,21729
389,BUMA.1121.00008,1,781574,803303,+,21729
389,BUMA.1121.00003,1,2027265,2048994,+,21729
389,BUMA.1121.00109,1,2395524,2417265,-,21741
389,BUMA.1121.00053,1,3253616,3275321,+,21705
389,BUMA.1121.00110,1,1282711,1304452,-,21741
389,BUMA.1121.00104,1,1738166,1759895,-,21729
389,BUMA.1121.00086,1,3184521,3206250,-,21729
389,BUMA.1121.00092,1,272215,293944,-,21729
389,BUMA.1121.00096,1,3792425,3814154,-,21729
389,BUMA.1121.00054,1,1473772,1495501,-,21729
389,BUMA.1121.00097,1,419463,441192,-,21729
389,BUMA.1121.00093,1,239894,261623,+,21729
389,BUMA.1121.00106,1,3242080,3263809,+,21729
389,BUMA.1121.00010,1,779153,800882,+,21729
389,BUMA.1121.00035,1,532601,554330,+,21729
389,BUMA.1121.00108,1,494932,516660,+,21728
389,BUMA.1121.00028,1,777828,799557,+,21729
389,BUMA.1121.00094,1,3474426,3496156,+,21730
389,BUMA.1121.00102,1,1782586,1804291,-,21705
389,BUMA.1121.00111,1,3677986,3699715,+,21729
389,BUMA.1121.00089,1,3446238,3467967,+,21729
389,BUMA.1121.00084,1,3855435,3877164,+,21729
389,BUMA.1121.00029,1,1412769,1434498,-,21729
389,BUMA.1121.00012,1,2241783,2263512,+,21729
389,BUMA.1121.00087,1,129735,151464,+,21729
389,BUMA.1121.00043,1,3626165,3647894,+,21729
389,BUMA.1121.00046,1,701968,723697,+,21729
389,BUMA.1121.00037,1,2126909,2149874,+,22965
389,BUMA.1121.00080,1,3507092,3528821,+,21729
389,BUMA.1121.00079,1,3540545,3562274,+,21729
389,BUMA.1121.00045,1,554145,575871,-,21726
389,BUMA.1121.00071,1,3418029,3439747,+,21718
389,BUMA.1121.00056,1,458965,480694,-,21729
389,BUMA.1121.00065,1,3553414,3575119,+,21705
389,BUMA.1121.00058,1,989869,1011598,-,21729
389,BUMA.1121.00007,1,524928,546657,-,21729
389,BUMA.1121.00067,1,911507,933236,-,21729
389,BUMA.1121.00090,1,1565078,1586807,+,21729
389,BUMA.1121.00051,1,3458381,3480110,+,21729
389,BUMA.1121.00020,1,842772,864501,+,21729
389,BUMA.1121.00103,1,837909,859637,-,21728
389,BUMA.1121.00048,1,2440204,2461933,+,21729
389,BUMA.1121.00047,1,3500209,3521938,-,21729
389,BUMA.1121.00042,1,793006,814735,+,21729
389,BUMA.1121.00055,1,3171840,3193570,+,21730
389,BUMA.1121.00031,1,839630,861359,+,21729
389,BUMA.1121.00040,1,256482,278211,+,21729
389,BUMA.1121.00044,1,43366,65095,+,21729
389,BUMA.1121.00088,1,322947,344677,+,21730
389,BUMA.1121.00069,1,3398914,3420644,+,21730
389,BUMA.1121.00064,1,3493523,3515252,+,21729
389,BUMA.1121.00105,1,1692404,1714133,-,21729
389,BUMA.1121.00015,1,3179176,3200905,+,21729
389,BUMA.1121.00059,1,2737649,2759378,+,21729
389,BUMA.1121.00026,1,1630700,1652429,-,21729
389,BUMA.1121.00022,1,244921,266650,+,21729
389,BUMA.1121.00052,1,860664,882393,+,21729
389,BUMA.1121.00101,1,2937254,2958983,-,21729
389,BUMA.1121.00001,1,538820,560549,-,21729
389,BUMA.1121.00038,1,2647610,2669339,+,21729
389,BUMA.1121.00068,1,2285384,2307113,+,21729
389,BUMA.1121.00099,1,2908072,2929801,-,21729
389,BUMA.1121.00091,1,979825,1001554,-,21729
389,BUMA.1121.00098,1,2148593,2170322,+,21729
389,BUMA.1121.00013,1,103990,125719,-,21729
389,BUMA.1121.00049,1,2310294,2332023,-,21729
389,BUMA.1121.00072,1,3400164,3421882,+,21718
389,BUMA.1121.00076,1,1805977,1827706,-,21729
389,BUMA.1121.00083,1,2160351,2182081,-,21730
389,BUMA.1121.00078,1,2493989,2515718,-,21729
389,BUMA.1121.00095,1,2174030,2195759,-,21729
389,BUMA.1121.00077,1,2178864,2200605,+,21741
389,BUMA.1121.00063,1,3412179,3433909,+,21730
389,BUMA.1121.00061,1,3415370,3437100,+,21730
389,BUMA.1121.00050,1,2028188,2049917,-,21729
389,BUMA.1121.00081,1,2647744,2669473,+,21729
389,BUMA.1121.00074,1,356070,377799,-,21729
389,BUMA.1121.00062,1,1045406,1067132,-,21726
389,BUMA.1121.00060,1,2799386,2821112,-,21726
389,BUMA.1121.00070,1,3386436,3408166,+,21730
389,BUMA.1121.00075,1,2984565,3006294,+,21729
389,BUMA.1121.00041,1,746368,768073,+,21705
389,BUMA.1121.00073,1,3413854,3435584,+,21730
389,BUMA.1121.00017,1,712878,734607,+,21729
389,BUMA.1121.00066,1,3403200,3424920,+,21720
389,BUMA.1121.00107,1,3428058,3449787,+,21729
389,BUMA.1121.00085,1,457499,479228,+,21729
389,BUMA.1121.00030,1,712938,734667,+,21729
389,BUMA.1121.00112,1,3562649,3584378,-,21729
389,BUMA.1121.00002,1,804547,826276,+,21729
389,BUMA.1121.00082,1,3597290,3619020,+,21730
389,BUMA.1121.00014,1,3378556,3400285,-,21729
389,BUMA.1121.00011,1,2099525,2121254,-,21729
389,BUMA.1121.00019,1,777872,799601,+,21729
389,BUMA.1121.00057,1,597657,619386,+,21729
389,BUMA.1121.00018,1,4121685,4143414,+,21729
389,BUMA.1121.00039,1,3637723,3659452,+,21729
389,BUMA.1121.00016,1,1606079,1627808,+,21729
389,BUMA.1121.00004,1,777787,799516,+,21729
389,BUMA.1121.00005,1,2245105,2266810,+,21705
389,BUMA.1121.00100,1,1778476,1800204,-,21728
389,BUMA.1121.00006,1,2647555,2669284,+,21729
390,BUMA.1121.00027,1,1703345,1706505,+,3160
390,BUMA.1121.00025,1,3262572,3265732,-,3160
390,BUMA.1121.00021,1,128522,131682,+,3160
390,BUMA.1121.00023,1,1849524,1852684,+,3160
390,BUMA.1121.00033,1,1729445,1732605,+,3160
390,BUMA.1121.00009,1,2042843,2046003,-,3160
390,BUMA.1121.00003,1,2049593,2052753,+,3160
390,BUMA.1121.00109,1,2391765,2394925,-,3160
390,BUMA.1121.00053,1,3275920,3279080,+,3160
390,BUMA.1121.00110,1,1278951,1282111,-,3160
390,BUMA.1121.00104,1,1734440,1737567,-,3127
390,BUMA.1121.00092,1,268456,271616,-,3160
390,BUMA.1121.00096,1,3788665,3791825,-,3160
390,BUMA.1121.00097,1,415704,418864,-,3160
390,BUMA.1121.00093,1,262222,265382,+,3160
390,BUMA.1121.00106,1,3264408,3267568,+,3160
390,BUMA.1121.00035,1,554930,558090,+,3160
390,BUMA.1121.00108,1,517259,520419,+,3160
390,BUMA.1121.00094,1,3498348,3501508,+,3160
390,BUMA.1121.00102,1,1778826,1781986,-,3160
390,BUMA.1121.00111,1,3700315,3703475,+,3160
390,BUMA.1121.00089,1,3470159,3473319,+,3160
390,BUMA.1121.00084,1,3877763,3880923,+,3160
390,BUMA.1121.00029,1,1409009,1412169,-,3160
390,BUMA.1121.00012,1,2264112,2267272,+,3160
390,BUMA.1121.00043,1,3648494,3651654,+,3160
390,BUMA.1121.00037,1,2150474,2153634,+,3160
390,BUMA.1121.00080,1,3531013,3534173,+,3160
390,BUMA.1121.00079,1,3564466,3567626,+,3160
390,BUMA.1121.00045,1,550386,553546,-,3160
390,BUMA.1121.00071,1,3440346,3443506,+,3160
390,BUMA.1121.00056,1,453613,456773,-,3160
390,BUMA.1121.00065,1,3575719,3578879,+,3160
390,BUMA.1121.00058,1,986110,989270,-,3160
390,BUMA.1121.00007,1,521169,524329,-,3160
390,BUMA.1121.00067,1,907747,910907,-,3160
390,BUMA.1121.00090,1,1587407,1590567,+,3160
390,BUMA.1121.00051,1,3482302,3485462,+,3160
390,BUMA.1121.00103,1,834149,837309,-,3160
390,BUMA.1121.00047,1,3494857,3498017,-,3160
390,BUMA.1121.00055,1,3194169,3197329,+,3160
390,BUMA.1121.00031,1,861959,865119,+,3160
390,BUMA.1121.00088,1,345276,348436,+,3160
390,BUMA.1121.00069,1,3421243,3424403,+,3160
390,BUMA.1121.00064,1,3515851,3519011,+,3160
390,BUMA.1121.00105,1,1688645,1691805,-,3160
390,BUMA.1121.00059,1,2759977,2763137,+,3160
390,BUMA.1121.00101,1,2933495,2936655,-,3160
390,BUMA.1121.00001,1,535060,538220,-,3160
390,BUMA.1121.00068,1,2307713,2310873,+,3160
390,BUMA.1121.00099,1,2904313,2907473,-,3160
390,BUMA.1121.00091,1,976066,979226,-,3160
390,BUMA.1121.00098,1,2172514,2175674,+,3160
390,BUMA.1121.00049,1,2306535,2309695,-,3160
390,BUMA.1121.00072,1,3422481,3425641,+,3160
390,BUMA.1121.00076,1,1802218,1805378,-,3160
390,BUMA.1121.00083,1,2156592,2159752,-,3160
390,BUMA.1121.00078,1,2490229,2493389,-,3160
390,BUMA.1121.00095,1,2170271,2173431,-,3160
390,BUMA.1121.00077,1,2201205,2204365,+,3160
390,BUMA.1121.00063,1,3434508,3437668,+,3160
390,BUMA.1121.00061,1,3437699,3440859,+,3160
390,BUMA.1121.00074,1,352311,355471,-,3160
390,BUMA.1121.00062,1,1041647,1044807,-,3160
390,BUMA.1121.00060,1,2795627,2798787,-,3160
390,BUMA.1121.00070,1,3408765,3411925,+,3160
390,BUMA.1121.00075,1,3006893,3010053,+,3160
390,BUMA.1121.00041,1,768673,771833,+,3160
390,BUMA.1121.00073,1,3436183,3439343,+,3160
390,BUMA.1121.00066,1,3425519,3428679,+,3160
390,BUMA.1121.00107,1,3450386,3453546,+,3160
390,BUMA.1121.00112,1,3558889,3562049,-,3160
390,BUMA.1121.00082,1,3619619,3622779,+,3160
390,BUMA.1121.00014,1,3374796,3377956,-,3160
390,BUMA.1121.00011,1,2095765,2098925,-,3160
390,BUMA.1121.00057,1,619985,623145,+,3160
390,BUMA.1121.00018,1,4144014,4147174,+,3160
390,BUMA.1121.00039,1,3660052,3663212,+,3160
390,BUMA.1121.00016,1,1628408,1631568,+,3160
390,BUMA.1121.00005,1,2267410,2270570,+,3160
390,BUMA.1121.00100,1,1774717,1777877,-,3160
391,BUMA.1121.00027,1,1717157,1735952,+,18795
391,BUMA.1121.00026,2,1386423,1405264,-,18841
391,BUMA.1121.00025,1,3233131,3251927,-,18796
391,BUMA.1121.00021,1,142330,161157,+,18827
391,BUMA.1121.00023,1,1864565,1883367,+,18802
391,BUMA.1121.00022,2,1027425,1046225,+,18800
391,BUMA.1121.00033,1,1743249,1762051,+,18802
391,BUMA.1121.00034,2,398715,417524,-,18809
391,BUMA.1121.00009,1,2013386,2032184,-,18798
391,BUMA.1121.00008,2,398559,417336,-,18777
391,BUMA.1121.00003,1,2063408,2082261,+,18853
391,BUMA.1121.00002,2,1071416,1090193,-,18777
391,BUMA.1121.00004,2,398687,417491,-,18804
391,BUMA.1121.00109,1,2362246,2381059,-,18813
391,BUMA.1121.00053,1,3289723,3308565,+,18842
391,BUMA.1121.00110,1,1249420,1268259,-,18839
391,BUMA.1121.00104,1,1704277,1723112,-,18835
391,BUMA.1121.00006,2,1773069,1791829,+,18760
391,BUMA.1121.00092,1,238961,257762,-,18801
391,BUMA.1121.00096,1,3759213,3778004,-,18791
391,BUMA.1121.00097,1,385002,403814,-,18812
391,BUMA.1121.00093,1,276074,294874,+,18800
391,BUMA.1121.00106,1,3278260,3297087,+,18827
391,BUMA.1121.00035,1,568699,587502,+,18803
391,BUMA.1121.00042,2,482176,500961,-,18785
391,BUMA.1121.00108,1,531072,549875,+,18803
391,BUMA.1121.00094,1,3512199,3530980,+,18781
391,BUMA.1121.00032,2,823027,841812,-,18785
391,BUMA.1121.00102,1,1749403,1768172,-,18769
391,BUMA.1121.00020,2,398662,417471,-,18809
391,BUMA.1121.00111,1,3714120,3732941,+,18821
391,BUMA.1121.00089,1,3484011,3502793,+,18782
391,BUMA.1121.00084,1,3891615,3910400,+,18785
391,BUMA.1121.00029,1,1379616,1398401,-,18785
391,BUMA.1121.00012,1,2277917,2296710,+,18793
391,BUMA.1121.00043,1,3662300,3681079,+,18779
391,BUMA.1121.00037,1,2164279,2183066,+,18787
391,BUMA.1121.00080,1,3544865,3563662,+,18797
391,BUMA.1121.00079,1,3578318,3597149,+,18831
391,BUMA.1121.00045,1,520909,539732,-,18823
391,BUMA.1121.00071,1,3454160,3472952,+,18792
391,BUMA.1121.00056,1,424138,442921,-,18783
391,BUMA.1121.00086,2,1835321,1854137,+,18816
391,BUMA.1121.00024,2,398559,417368,-,18809
391,BUMA.1121.00010,2,1927312,1946089,-,18777
391,BUMA.1121.00040,2,1671780,1690620,+,18840
391,BUMA.1121.00065,1,3589495,3608287,+,18792
391,BUMA.1121.00058,1,954171,973007,-,18836
391,BUMA.1121.00007,1,491719,510514,-,18795
391,BUMA.1121.00067,1,878234,897046,-,18812
391,BUMA.1121.00090,1,1601208,1620032,+,18824
391,BUMA.1121.00051,1,3496154,3514928,+,18774
391,BUMA.1121.00019,2,398626,417435,-,18809
391,BUMA.1121.00103,1,804666,823495,-,18829
391,BUMA.1121.00087,2,1101066,1119883,-,18817
391,BUMA.1121.00047,1,3465421,3484204,-,18783
391,BUMA.1121.00055,1,3209218,3227985,+,18767
391,BUMA.1121.00031,1,875764,894573,+,18809
391,BUMA.1121.00030,2,1704276,1723084,+,18808
391,BUMA.1121.00088,1,359129,377908,+,18779
391,BUMA.1121.00069,1,3434970,3453760,+,18790
391,BUMA.1121.00085,2,647119,665919,+,18800
391,BUMA.1121.00064,1,3530916,3549727,+,18811
391,BUMA.1121.00046,2,107197,125989,+,18792
391,BUMA.1121.00105,1,1659143,1677953,-,18810
391,BUMA.1121.00054,2,1573190,1591950,+,18760
391,BUMA.1121.00015,2,759609,778410,-,18801
391,BUMA.1121.00059,1,2773791,2792586,+,18795
391,BUMA.1121.00052,2,1335666,1354466,+,18800
391,BUMA.1121.00101,1,2904031,2922842,-,18811
391,BUMA.1121.00001,1,505625,524452,-,18827
391,BUMA.1121.00050,2,1867976,1886768,+,18792
391,BUMA.1121.00036,2,2094741,2113574,-,18833
391,BUMA.1121.00038,2,1674263,1693023,+,18760
391,BUMA.1121.00068,1,2321565,2340354,+,18789
391,BUMA.1121.00099,1,2874859,2893662,-,18803
391,BUMA.1121.00091,1,946649,965435,-,18786
391,BUMA.1121.00098,1,2186403,2205197,+,18794
391,BUMA.1121.00049,1,2277023,2295843,-,18820
391,BUMA.1121.00028,2,398641,417450,-,18809
391,BUMA.1121.00072,1,3436133,3454936,+,18803
391,BUMA.1121.00076,1,1772757,1791524,-,18767
391,BUMA.1121.00044,2,449831,468640,-,18809
391,BUMA.1121.00074,2,550729,569539,+,18810
391,BUMA.1121.00083,1,2127134,2145938,-,18804
391,BUMA.1121.00078,1,2460788,2479581,-,18793
391,BUMA.1121.00081,2,531680,550441,-,18761
391,BUMA.1121.00095,1,2140839,2159618,-,18779
391,BUMA.1121.00077,1,2215063,2233909,+,18846
391,BUMA.1121.00063,1,3448322,3467098,+,18776
391,BUMA.1121.00061,1,3451513,3470316,+,18803
391,BUMA.1121.00062,1,1012195,1030982,-,18787
391,BUMA.1121.00060,1,2766149,2784972,-,18823
391,BUMA.1121.00070,1,3422579,3441369,+,18790
391,BUMA.1121.00075,1,3020747,3039513,+,18766
391,BUMA.1121.00041,1,782449,801273,+,18824
391,BUMA.1121.00073,1,3449997,3468787,+,18790
391,BUMA.1121.00066,1,3439333,3458121,+,18788
391,BUMA.1121.00107,1,3464240,3483050,+,18810
391,BUMA.1121.00112,1,3529457,3548235,-,18778
391,BUMA.1121.00082,1,3633433,3652236,+,18803
391,BUMA.1121.00014,1,3345372,3364151,-,18779
391,BUMA.1121.00013,2,2039198,2057990,+,18792
391,BUMA.1121.00011,1,2066310,2085115,-,18805
391,BUMA.1121.00057,1,633799,652594,+,18795
391,BUMA.1121.00018,1,7943,26738,+,18795
391,BUMA.1121.00048,2,1271075,1289836,-,18761
391,BUMA.1121.00039,1,3673858,3692692,+,18834
391,BUMA.1121.00016,1,1642211,1661040,+,18829
391,BUMA.1121.00017,2,398694,417495,-,18801
391,BUMA.1121.00005,1,4031096,4049902,-,18806
391,BUMA.1121.00100,1,1745253,1764048,-,18795
392,BUMA.1121.00027,1,1737033,1757091,+,20058
392,BUMA.1121.00026,2,1365394,1385342,-,19948
392,BUMA.1121.00025,1,3211989,3232050,-,20061
392,BUMA.1121.00021,1,162238,182323,+,20085
392,BUMA.1121.00023,1,1884448,1904465,+,20017
392,BUMA.1121.00022,2,1047306,1067272,+,19966
392,BUMA.1121.00033,1,1767068,1787171,+,20103
392,BUMA.1121.00034,2,377668,397634,-,19966
392,BUMA.1121.00009,1,1992237,2012305,-,20068
392,BUMA.1121.00008,2,377512,397478,-,19966
392,BUMA.1121.00003,1,2083342,2103443,+,20101
392,BUMA.1121.00002,2,1050376,1070335,-,19959
392,BUMA.1121.00004,2,377640,397606,-,19966
392,BUMA.1121.00109,1,2338072,2358161,-,20089
392,BUMA.1121.00053,1,3309646,3329746,+,20100
392,BUMA.1121.00110,1,1228307,1248339,-,20032
392,BUMA.1121.00104,1,1683234,1703196,-,19962
392,BUMA.1121.00006,2,1792910,1812863,+,19953
392,BUMA.1121.00092,1,217959,237880,-,19921
392,BUMA.1121.00096,1,3712426,3732636,-,20210
392,BUMA.1121.00097,1,363818,383921,-,20103
392,BUMA.1121.00093,1,295955,315877,+,19922
392,BUMA.1121.00106,1,3315241,3335225,+,19984
392,BUMA.1121.00035,1,596303,616379,+,20076
392,BUMA.1121.00042,2,461137,481095,-,19958
392,BUMA.1121.00108,1,550956,570980,+,20024
392,BUMA.1121.00094,1,3532061,3552025,+,19964
392,BUMA.1121.00032,2,801981,821946,-,19965
392,BUMA.1121.00102,1,1728269,1748322,-,20053
392,BUMA.1121.00020,2,377615,397581,-,19966
392,BUMA.1121.00111,1,3737959,3758001,+,20042
392,BUMA.1121.00089,1,3503874,3523838,+,19964
392,BUMA.1121.00084,1,3911481,3931425,+,19944
392,BUMA.1121.00029,1,1352047,1372108,-,20061
392,BUMA.1121.00012,1,2297791,2317792,+,20001
392,BUMA.1121.00043,1,3682160,3702233,+,20073
392,BUMA.1121.00037,1,2184147,2204132,+,19985
392,BUMA.1121.00080,1,3564743,3584770,+,20027
392,BUMA.1121.00079,1,3616543,3636503,+,19960
392,BUMA.1121.00045,1,499840,519828,-,19988
392,BUMA.1121.00071,1,3474033,3494076,+,20043
392,BUMA.1121.00056,1,403094,423057,-,19963
392,BUMA.1121.00086,2,1855218,1875192,+,19974
392,BUMA.1121.00024,2,377512,397478,-,19966
392,BUMA.1121.00010,2,1906272,1926231,-,19959
392,BUMA.1121.00040,2,1691701,1711664,+,19963
392,BUMA.1121.00065,1,3609368,3629438,+,20070
392,BUMA.1121.00058,1,933120,953090,-,19970
392,BUMA.1121.00007,1,470590,490638,-,20048
392,BUMA.1121.00067,1,857222,877153,-,19931
392,BUMA.1121.00090,1,1625050,1645069,+,20019
392,BUMA.1121.00051,1,3516009,3536043,+,20034
392,BUMA.1121.00019,2,377579,397545,-,19966
392,BUMA.1121.00103,1,781993,801970,-,19977
392,BUMA.1121.00087,2,1080012,1099985,-,19973
392,BUMA.1121.00047,1,3444307,3464340,-,20033
392,BUMA.1121.00055,1,3229066,3248987,+,19921
392,BUMA.1121.00031,1,904872,924866,+,19994
392,BUMA.1121.00030,2,1724165,1744131,+,19966
392,BUMA.1121.00088,1,378989,398938,+,19949
392,BUMA.1121.00069,1,3454841,3474845,+,20004
392,BUMA.1121.00085,2,667000,686953,+,19953
392,BUMA.1121.00064,1,3550808,3570862,+,20054
392,BUMA.1121.00046,2,127070,147030,+,19960
392,BUMA.1121.00105,1,1637986,1658062,-,20076
392,BUMA.1121.00054,2,1593031,1612984,+,19953
392,BUMA.1121.00015,2,738576,758528,-,19952
392,BUMA.1121.00059,1,2793667,2813694,+,20027
392,BUMA.1121.00052,2,1355547,1375500,+,19953
392,BUMA.1121.00101,1,2882915,2902950,-,20035
392,BUMA.1121.00001,1,478038,498117,-,20079
392,BUMA.1121.00050,2,1887849,1907809,+,19960
392,BUMA.1121.00036,2,2073694,2093660,-,19966
392,BUMA.1121.00038,2,1694104,1714057,+,19953
392,BUMA.1121.00068,1,2341435,2361502,+,20067
392,BUMA.1121.00099,1,2853729,2873778,-,20049
392,BUMA.1121.00091,1,925503,945568,-,20065
392,BUMA.1121.00098,1,2206277,2226258,+,19981
392,BUMA.1121.00049,1,2255972,2275942,-,19970
392,BUMA.1121.00028,2,377594,397560,-,19966
392,BUMA.1121.00072,1,3456017,3476071,+,20054
392,BUMA.1121.00076,1,1751642,1771676,-,20034
392,BUMA.1121.00044,2,428784,448750,-,19966
392,BUMA.1121.00074,2,570620,590552,+,19932
392,BUMA.1121.00083,1,2106000,2126053,-,20053
392,BUMA.1121.00078,1,2435734,2455769,-,20035
392,BUMA.1121.00081,2,510647,530599,-,19952
392,BUMA.1121.00095,1,2119731,2139758,-,20027
392,BUMA.1121.00077,1,2234989,2255021,+,20032
392,BUMA.1121.00063,1,3468179,3488233,+,20054
392,BUMA.1121.00061,1,3471397,3491451,+,20054
392,BUMA.1121.00062,1,991151,1011114,-,19963
392,BUMA.1121.00060,1,2745080,2765068,-,19988
392,BUMA.1121.00070,1,3442450,3462497,+,20047
392,BUMA.1121.00075,1,3040594,3060629,+,20035
392,BUMA.1121.00041,1,802354,822427,+,20073
392,BUMA.1121.00073,1,3469868,3489909,+,20041
392,BUMA.1121.00066,1,3459202,3479243,+,20041
392,BUMA.1121.00107,1,3484131,3504148,+,20017
392,BUMA.1121.00112,1,3508319,3528376,-,20057
392,BUMA.1121.00082,1,3653317,3673371,+,20054
392,BUMA.1121.00014,1,3324306,3344291,-,19985
392,BUMA.1121.00013,2,2059071,2079024,+,19953
392,BUMA.1121.00011,1,2045175,2065229,-,20054
392,BUMA.1121.00057,1,653675,673754,+,20079
392,BUMA.1121.00018,1,27819,47881,+,20062
392,BUMA.1121.00048,2,1250042,1269994,-,19952
392,BUMA.1121.00039,1,3699044,3719138,+,20094
392,BUMA.1121.00016,1,1666058,1686066,+,20008
392,BUMA.1121.00017,2,377647,397613,-,19966
392,BUMA.1121.00005,1,4009888,4030015,-,20127
392,BUMA.1121.00100,1,1724171,1744172,-,20001
393,BUMA.1121.00027,1,1758120,1794366,+,36246
393,BUMA.1121.00025,1,3173040,3209364,-,36324
393,BUMA.1121.00021,1,184947,221311,+,36364
393,BUMA.1121.00023,1,1907089,1943426,+,36337
393,BUMA.1121.00024,1,439449,475568,-,36119
393,BUMA.1121.00033,1,1788200,1824545,+,36345
393,BUMA.1121.00034,1,439457,475576,-,36119
393,BUMA.1121.00036,1,3389882,3426010,-,36128
393,BUMA.1121.00032,1,2187017,2223137,+,36120
393,BUMA.1121.00009,1,1955040,1991207,-,36167
393,BUMA.1121.00008,1,439471,475590,-,36119
393,BUMA.1121.00003,1,2104472,2140673,+,36201
393,BUMA.1121.00109,1,2300812,2337042,-,36230
393,BUMA.1121.00053,1,3330775,3366972,+,36197
393,BUMA.1121.00110,1,1191124,1227277,-,36153
393,BUMA.1121.00104,1,1645955,1682206,-,36251
393,BUMA.1121.00086,1,3104107,3140228,-,36121
393,BUMA.1121.00092,1,180713,216929,-,36216
393,BUMA.1121.00096,1,3673581,3709801,-,36220
393,BUMA.1121.00054,1,1216422,1252539,-,36117
393,BUMA.1121.00097,1,326536,362788,-,36252
393,BUMA.1121.00093,1,316906,353123,+,36217
393,BUMA.1121.00106,1,3336252,3372446,+,36194
393,BUMA.1121.00010,1,895039,931204,+,36165
393,BUMA.1121.00035,1,619003,655270,+,36267
393,BUMA.1121.00108,1,572009,608200,+,36191
393,BUMA.1121.00028,1,439458,475577,-,36119
393,BUMA.1121.00094,1,3553054,3589351,+,36297
393,BUMA.1121.00102,1,1691031,1727239,-,36208
393,BUMA.1121.00111,1,3759030,3795327,+,36297
393,BUMA.1121.00089,1,3524867,3561164,+,36297
393,BUMA.1121.00084,1,3932454,3968722,+,36268
393,BUMA.1121.00029,1,1313148,1349422,-,36274
393,BUMA.1121.00012,1,2318821,2355092,+,36271
393,BUMA.1121.00087,1,195732,231854,+,36122
393,BUMA.1121.00043,1,3703262,3739582,+,36320
393,BUMA.1121.00046,1,944602,980726,+,36124
393,BUMA.1121.00037,1,2205163,2241476,+,36313
393,BUMA.1121.00080,1,3585799,3622112,+,36313
393,BUMA.1121.00079,1,3637530,3673822,+,36292
393,BUMA.1121.00045,1,462567,498810,-,36243
393,BUMA.1121.00071,1,3495105,3531327,+,36222
393,BUMA.1121.00056,1,365768,402064,-,36296
393,BUMA.1121.00065,1,3630467,3666672,+,36205
393,BUMA.1121.00058,1,895845,932090,-,36245
393,BUMA.1121.00007,1,433297,469560,-,36263
393,BUMA.1121.00067,1,818745,854925,-,36180
393,BUMA.1121.00090,1,1646098,1682367,+,36269
393,BUMA.1121.00051,1,3537072,3573354,+,36282
393,BUMA.1121.00020,1,439464,475583,-,36119
393,BUMA.1121.00103,1,743145,779370,-,36225
393,BUMA.1121.00048,1,2683258,2719376,+,36118
393,BUMA.1121.00047,1,3406988,3443277,-,36289
393,BUMA.1121.00042,1,195801,231955,-,36154
393,BUMA.1121.00055,1,3250016,3286217,+,36201
393,BUMA.1121.00031,1,925897,962211,+,36314
393,BUMA.1121.00040,1,203741,239830,+,36089
393,BUMA.1121.00044,1,3241458,3277577,-,36119
393,BUMA.1121.00088,1,399967,436261,+,36294
393,BUMA.1121.00069,1,3475874,3512087,+,36213
393,BUMA.1121.00064,1,3571891,3608111,+,36220
393,BUMA.1121.00105,1,1600748,1636956,-,36208
393,BUMA.1121.00015,1,3374410,3410513,+,36103
393,BUMA.1121.00059,1,2814723,2850975,+,36252
393,BUMA.1121.00026,1,1505273,1541437,-,36164
393,BUMA.1121.00022,1,277553,313681,+,36128
393,BUMA.1121.00052,1,426563,462681,+,36118
393,BUMA.1121.00101,1,2845665,2881885,-,36220
393,BUMA.1121.00001,1,439182,475413,-,36231
393,BUMA.1121.00038,1,2890558,2926676,+,36118
393,BUMA.1121.00068,1,2362531,2398674,+,36143
393,BUMA.1121.00099,1,2816485,2852699,-,36214
393,BUMA.1121.00091,1,888209,924473,-,36264
393,BUMA.1121.00098,1,2227287,2263504,+,36217
393,BUMA.1121.00013,1,523589,559706,-,36117
393,BUMA.1121.00049,1,2218669,2254944,-,36275
393,BUMA.1121.00072,1,3477100,3513266,+,36166
393,BUMA.1121.00076,1,1714369,1750612,-,36243
393,BUMA.1121.00074,2,591581,627810,+,36229
393,BUMA.1121.00083,1,2068747,2104970,-,36223
393,BUMA.1121.00078,1,2398526,2434704,-,36178
393,BUMA.1121.00095,1,2080943,2117107,-,36164
393,BUMA.1121.00077,1,2256051,2292206,+,36155
393,BUMA.1121.00063,1,3489262,3525485,+,36223
393,BUMA.1121.00061,1,3492480,3528694,+,36214
393,BUMA.1121.00050,1,1770973,1807096,-,36123
393,BUMA.1121.00081,1,2890757,2926875,+,36118
393,BUMA.1121.00062,1,953858,990121,-,36263
393,BUMA.1121.00060,1,2707815,2744050,-,36235
393,BUMA.1121.00070,1,3463526,3499724,+,36198
393,BUMA.1121.00075,1,3061658,3097907,+,36249
393,BUMA.1121.00041,1,823454,859637,+,36183
393,BUMA.1121.00073,1,3490938,3527161,+,36223
393,BUMA.1121.00017,1,439456,475575,-,36119
393,BUMA.1121.00066,1,3480272,3516454,+,36182
393,BUMA.1121.00107,1,3506770,3542976,+,36206
393,BUMA.1121.00085,1,23391,59509,+,36118
393,BUMA.1121.00030,1,439456,475575,-,36119
393,BUMA.1121.00112,1,3471145,3507289,-,36144
393,BUMA.1121.00002,1,921686,957876,+,36190
393,BUMA.1121.00082,1,3674400,3710624,+,36224
393,BUMA.1121.00014,1,3286979,3323275,-,36296
393,BUMA.1121.00011,1,2007963,2044145,-,36182
393,BUMA.1121.00019,1,439470,475589,-,36119
393,BUMA.1121.00057,1,674783,710974,+,36191
393,BUMA.1121.00018,1,50505,86830,+,36325
393,BUMA.1121.00039,1,3720167,3756389,+,36222
393,BUMA.1121.00016,1,1687095,1723291,+,36196
393,BUMA.1121.00004,1,439450,475569,-,36119
393,BUMA.1121.00005,1,3972661,4008858,-,36197
393,BUMA.1121.00100,1,1687008,1723141,-,36133
393,BUMA.1121.00006,1,2890642,2926760,+,36118
394,BUMA.1121.00027,1,1794367,1800985,+,6618
394,BUMA.1121.00025,1,3166420,3173038,-,6618
394,BUMA.1121.00021,1,221312,227931,+,6619
394,BUMA.1121.00023,1,1943427,1950045,+,6618
394,BUMA.1121.00033,1,1824546,1831165,+,6619
394,BUMA.1121.00009,1,1948420,1955038,-,6618
394,BUMA.1121.00003,1,2140674,2147294,+,6620
394,BUMA.1121.00109,1,2294194,2300810,-,6616
394,BUMA.1121.00053,1,3366973,3373590,+,6617
394,BUMA.1121.00110,1,1184505,1191122,-,6617
394,BUMA.1121.00104,1,1639337,1645953,-,6616
394,BUMA.1121.00092,1,174094,180711,-,6617
394,BUMA.1121.00096,1,3666962,3673579,-,6617
394,BUMA.1121.00097,1,319917,326534,-,6617
394,BUMA.1121.00093,1,353124,359742,+,6618
394,BUMA.1121.00106,1,3372447,3379064,+,6617
394,BUMA.1121.00035,1,655271,661889,+,6618
394,BUMA.1121.00108,1,608201,614819,+,6618
394,BUMA.1121.00094,1,3589352,3595969,+,6617
394,BUMA.1121.00102,1,1684411,1691029,-,6618
394,BUMA.1121.00111,1,3795328,3801952,+,6624
394,BUMA.1121.00089,1,3561165,3567782,+,6617
394,BUMA.1121.00084,1,3968723,3975340,+,6617
394,BUMA.1121.00029,1,1306529,1313146,-,6617
394,BUMA.1121.00012,1,2355093,2361711,+,6618
394,BUMA.1121.00043,1,3739583,3746202,+,6619
394,BUMA.1121.00037,1,2241477,2248096,+,6619
394,BUMA.1121.00080,1,3622113,3628730,+,6617
394,BUMA.1121.00079,1,3673823,3680439,+,6616
394,BUMA.1121.00045,1,455947,462565,-,6618
394,BUMA.1121.00071,1,3531328,3537947,+,6619
394,BUMA.1121.00056,1,359150,365766,-,6616
394,BUMA.1121.00065,1,3666673,3673291,+,6618
394,BUMA.1121.00058,1,889225,895843,-,6618
394,BUMA.1121.00007,1,426678,433295,-,6617
394,BUMA.1121.00067,1,812127,818743,-,6616
394,BUMA.1121.00090,1,1682368,1688980,+,6612
394,BUMA.1121.00051,1,3573355,3579972,+,6617
394,BUMA.1121.00103,1,736526,743143,-,6617
394,BUMA.1121.00047,1,3400370,3406986,-,6616
394,BUMA.1121.00055,1,3286218,3292836,+,6618
394,BUMA.1121.00031,1,962212,968831,+,6619
394,BUMA.1121.00088,1,436262,442879,+,6617
394,BUMA.1121.00069,1,3512088,3518704,+,6616
394,BUMA.1121.00064,1,3608112,3614730,+,6618
394,BUMA.1121.00105,1,1594128,1600746,-,6618
394,BUMA.1121.00059,1,2850976,2857594,+,6618
394,BUMA.1121.00101,1,2839046,2845663,-,6617
394,BUMA.1121.00001,1,432563,439180,-,6617
394,BUMA.1121.00068,1,2398675,2405305,+,6630
394,BUMA.1121.00099,1,2809866,2816483,-,6617
394,BUMA.1121.00091,1,881591,888207,-,6616
394,BUMA.1121.00098,1,2263505,2270123,+,6618
394,BUMA.1121.00049,1,2212051,2218667,-,6616
394,BUMA.1121.00072,1,3513267,3519886,+,6619
394,BUMA.1121.00076,1,1707750,1714367,-,6617
394,BUMA.1121.00074,2,627811,634428,+,6617
394,BUMA.1121.00083,1,2062127,2068745,-,6618
394,BUMA.1121.00078,1,2391910,2398524,-,6614
394,BUMA.1121.00095,1,2074325,2080941,-,6616
394,BUMA.1121.00077,1,2292207,2298825,+,6618
394,BUMA.1121.00063,1,3525486,3532105,+,6619
394,BUMA.1121.00061,1,3528695,3535314,+,6619
394,BUMA.1121.00062,1,947238,953856,-,6618
394,BUMA.1121.00060,1,2701195,2707813,-,6618
394,BUMA.1121.00070,1,3499725,3506344,+,6619
394,BUMA.1121.00075,1,3097908,3104526,+,6618
394,BUMA.1121.00041,1,859638,866256,+,6618
394,BUMA.1121.00073,1,3527162,3533781,+,6619
394,BUMA.1121.00066,1,3516455,3523074,+,6619
394,BUMA.1121.00107,1,3542977,3549595,+,6618
394,BUMA.1121.00112,1,3464527,3471143,-,6616
394,BUMA.1121.00082,1,3710625,3717244,+,6619
394,BUMA.1121.00014,1,3280359,3286977,-,6618
394,BUMA.1121.00011,1,2001338,2007961,-,6623
394,BUMA.1121.00057,1,710975,717594,+,6619
394,BUMA.1121.00018,1,86831,93450,+,6619
394,BUMA.1121.00039,1,3756390,3763008,+,6618
394,BUMA.1121.00016,1,1723292,1729911,+,6619
394,BUMA.1121.00005,1,3966042,3972659,-,6617
394,BUMA.1121.00100,1,1680387,1687006,-,6619
395,BUMA.1121.00027,1,1808599,1814982,+,6383
395,BUMA.1121.00025,1,3155967,3162352,-,6385
395,BUMA.1121.00021,1,266283,272667,+,6384
395,BUMA.1121.00023,1,1988985,1995357,+,6372
395,BUMA.1121.00024,1,536734,543119,-,6385
395,BUMA.1121.00033,1,1885577,1891961,+,6384
395,BUMA.1121.00034,1,536742,543127,-,6385
395,BUMA.1121.00036,1,28979,35364,-,6385
395,BUMA.1121.00032,1,2119467,2125851,+,6384
395,BUMA.1121.00009,1,1938712,1945097,-,6385
395,BUMA.1121.00008,1,536756,543141,-,6385
395,BUMA.1121.00003,1,2154910,2161294,+,6384
395,BUMA.1121.00109,1,2269380,2275765,-,6385
395,BUMA.1121.00053,1,3380929,3387313,+,6384
395,BUMA.1121.00110,1,1169713,1176098,-,6385
395,BUMA.1121.00104,1,1613314,1619699,-,6385
395,BUMA.1121.00086,1,2699759,2706143,+,6384
395,BUMA.1121.00092,1,3725911,3732295,+,6384
395,BUMA.1121.00096,1,3611749,3618134,-,6385
395,BUMA.1121.00054,1,1346149,1352534,-,6385
395,BUMA.1121.00097,1,310213,316598,-,6385
395,BUMA.1121.00093,1,894141,900526,-,6385
395,BUMA.1121.00106,1,3397490,3403874,+,6384
395,BUMA.1121.00010,1,1301081,1307465,+,6384
395,BUMA.1121.00035,1,670507,676891,+,6384
395,BUMA.1121.00108,1,618145,624529,+,6384
395,BUMA.1121.00028,1,536743,543128,-,6385
395,BUMA.1121.00094,1,3649388,3655772,+,6384
395,BUMA.1121.00102,1,1658470,1664855,-,6385
395,BUMA.1121.00111,1,3809291,3815675,+,6384
395,BUMA.1121.00089,1,3621202,3627586,+,6384
395,BUMA.1121.00084,1,4018251,4024635,+,6384
395,BUMA.1121.00029,1,1293620,1300005,-,6385
395,BUMA.1121.00012,1,2366224,2372608,+,6384
395,BUMA.1121.00087,1,629586,635971,-,6385
395,BUMA.1121.00043,1,3750270,3756642,+,6372
395,BUMA.1121.00046,1,864205,870590,-,6385
395,BUMA.1121.00037,1,2282819,2289203,+,6384
395,BUMA.1121.00080,1,3647088,3653472,+,6384
395,BUMA.1121.00079,1,3732546,3738930,+,6384
395,BUMA.1121.00045,1,441145,447536,-,6391
395,BUMA.1121.00071,1,3539409,3545793,+,6384
395,BUMA.1121.00056,1,299345,305730,-,6385
395,BUMA.1121.00065,1,3680627,3687011,+,6384
395,BUMA.1121.00058,1,875213,881598,-,6385
395,BUMA.1121.00007,1,411727,418100,-,6373
395,BUMA.1121.00067,1,787384,793769,-,6385
395,BUMA.1121.00090,1,1696317,1702689,+,6372
395,BUMA.1121.00051,1,3619426,3625810,+,6384
395,BUMA.1121.00020,1,536749,543134,-,6385
395,BUMA.1121.00103,1,711339,717724,-,6385
395,BUMA.1121.00048,1,2583257,2589641,+,6384
395,BUMA.1121.00047,1,3341878,3348263,-,6385
395,BUMA.1121.00042,1,183776,191401,-,7625
395,BUMA.1121.00055,1,3300175,3306559,+,6384
395,BUMA.1121.00031,1,1008660,1015044,+,6384
395,BUMA.1121.00040,1,110272,116657,-,6385
395,BUMA.1121.00044,1,3338743,3345128,-,6385
395,BUMA.1121.00088,1,476131,482515,+,6384
395,BUMA.1121.00069,1,3519967,3526351,+,6384
395,BUMA.1121.00064,1,3633088,3639472,+,6384
395,BUMA.1121.00105,1,1581635,1588020,-,6385
395,BUMA.1121.00015,1,528094,534479,-,6385
395,BUMA.1121.00059,1,2883134,2889518,+,6384
395,BUMA.1121.00026,1,1494488,1500873,-,6385
395,BUMA.1121.00022,1,745119,751504,-,6385
395,BUMA.1121.00052,1,120623,127008,-,6385
395,BUMA.1121.00101,1,2829337,2835722,-,6385
395,BUMA.1121.00001,1,419655,426040,-,6385
395,BUMA.1121.00038,1,2790557,2796941,+,6384
395,BUMA.1121.00068,1,2456075,2462459,+,6384
395,BUMA.1121.00099,1,2798012,2804397,-,6385
395,BUMA.1121.00091,1,856404,862790,-,6386
395,BUMA.1121.00098,1,2329915,2336299,+,6384
395,BUMA.1121.00013,1,828756,835140,+,6384
395,BUMA.1121.00049,1,2184924,2191309,-,6385
395,BUMA.1121.00072,1,3521537,3527921,+,6384
395,BUMA.1121.00076,1,1694026,1700411,-,6385
395,BUMA.1121.00074,2,652786,659170,+,6384
395,BUMA.1121.00083,1,2048126,2054511,-,6385
395,BUMA.1121.00078,1,2378187,2384572,-,6385
395,BUMA.1121.00095,1,2019216,2025601,-,6385
395,BUMA.1121.00077,1,2307232,2313616,+,6384
395,BUMA.1121.00063,1,3533398,3539782,+,6384
395,BUMA.1121.00061,1,3536837,3543221,+,6384
395,BUMA.1121.00050,1,1881262,1887646,+,6384
395,BUMA.1121.00081,1,2790756,2797140,+,6384
395,BUMA.1121.00062,1,935285,941670,-,6385
395,BUMA.1121.00060,1,2686393,2692784,-,6391
395,BUMA.1121.00070,1,3507684,3514068,+,6384
395,BUMA.1121.00075,1,3111865,3118249,+,6384
395,BUMA.1121.00041,1,873347,879731,+,6384
395,BUMA.1121.00073,1,3535116,3541500,+,6384
395,BUMA.1121.00017,1,536741,543126,-,6385
395,BUMA.1121.00066,1,3524490,3530874,+,6384
395,BUMA.1121.00107,1,3600602,3606986,+,6384
395,BUMA.1121.00085,1,3214429,3220814,-,6385
395,BUMA.1121.00030,1,536741,543126,-,6385
395,BUMA.1121.00112,1,3448353,3454738,-,6385
395,BUMA.1121.00002,1,1327906,1334290,+,6384
395,BUMA.1121.00082,1,3724860,3731244,+,6384
395,BUMA.1121.00014,1,3235415,3241800,-,6385
395,BUMA.1121.00011,1,1975010,1981395,-,6385
395,BUMA.1121.00019,1,536755,543140,-,6385
395,BUMA.1121.00057,1,725210,731594,+,6384
395,BUMA.1121.00018,1,97517,103901,+,6384
395,BUMA.1121.00039,1,3768411,3774783,+,6372
395,BUMA.1121.00016,1,1733979,1740363,+,6384
395,BUMA.1121.00004,1,536735,543120,-,6385
395,BUMA.1121.00005,1,3934014,3940397,-,6383
395,BUMA.1121.00100,1,1665459,1671844,-,6385
395,BUMA.1121.00006,1,2790641,2797025,+,6384
396,BUMA.1121.00027,1,1815173,1843900,+,28727
396,BUMA.1121.00025,1,3127178,3155872,-,28694
396,BUMA.1121.00021,1,272763,301467,+,28704
396,BUMA.1121.00023,1,1995453,2024141,+,28688
396,BUMA.1121.00024,1,507838,536540,-,28702
396,BUMA.1121.00033,1,1892155,1920874,+,28719
396,BUMA.1121.00034,1,507846,536548,-,28702
396,BUMA.1121.00036,1,76,28785,-,28709
396,BUMA.1121.00032,1,2126046,2154748,+,28702
396,BUMA.1121.00009,1,1909792,1938519,-,28727
396,BUMA.1121.00008,1,507860,536562,-,28702
396,BUMA.1121.00003,1,2161489,2190211,+,28722
396,BUMA.1121.00109,1,2240326,2269186,-,28860
396,BUMA.1121.00053,1,3387504,3416216,+,28712
396,BUMA.1121.00110,1,1140813,1169519,-,28706
396,BUMA.1121.00104,1,1584425,1613124,-,28699
396,BUMA.1121.00086,1,2706338,2735046,+,28708
396,BUMA.1121.00092,1,3732391,3761094,+,28703
396,BUMA.1121.00096,1,3582843,3611556,-,28713
396,BUMA.1121.00054,1,1317218,1345955,-,28737
396,BUMA.1121.00097,1,281315,310019,-,28704
396,BUMA.1121.00093,1,865343,894046,-,28703
396,BUMA.1121.00106,1,3404065,3432764,+,28699
396,BUMA.1121.00010,1,1307660,1336369,+,28709
396,BUMA.1121.00035,1,677085,705776,+,28691
396,BUMA.1121.00108,1,624723,653470,+,28747
396,BUMA.1121.00028,1,507847,536549,-,28702
396,BUMA.1121.00094,1,3655967,3684661,+,28694
396,BUMA.1121.00102,1,1629507,1658280,-,28773
396,BUMA.1121.00111,1,3815869,3844569,+,28700
396,BUMA.1121.00089,1,3627777,3656465,+,28688
396,BUMA.1121.00084,1,4024830,4053556,+,28726
396,BUMA.1121.00029,1,1264737,1293427,-,28690
396,BUMA.1121.00012,1,2372802,2401500,+,28698
396,BUMA.1121.00087,1,600684,629392,-,28708
396,BUMA.1121.00043,1,3756738,3785438,+,28700
396,BUMA.1121.00046,1,835267,864011,-,28744
396,BUMA.1121.00037,1,2289299,2317994,+,28695
396,BUMA.1121.00080,1,3653663,3682359,+,28696
396,BUMA.1121.00079,1,3739124,3767817,+,28693
396,BUMA.1121.00045,1,412250,440951,-,28701
396,BUMA.1121.00071,1,3545984,3574693,+,28709
396,BUMA.1121.00056,1,270467,299155,-,28688
396,BUMA.1121.00065,1,3687206,3715902,+,28696
396,BUMA.1121.00058,1,846324,875023,-,28699
396,BUMA.1121.00007,1,381246,409939,-,28693
396,BUMA.1121.00067,1,758484,787190,-,28706
396,BUMA.1121.00090,1,1702785,1731479,+,28694
396,BUMA.1121.00051,1,3626005,3654713,+,28708
396,BUMA.1121.00020,1,507853,536555,-,28702
396,BUMA.1121.00103,1,682408,711145,-,28737
396,BUMA.1121.00048,1,2589836,2618573,+,28737
396,BUMA.1121.00047,1,3312987,3341684,-,28697
396,BUMA.1121.00042,1,154862,183582,-,28720
396,BUMA.1121.00055,1,3306750,3335455,+,28705
396,BUMA.1121.00031,1,1015140,1043846,+,28706
396,BUMA.1121.00040,1,81313,110078,-,28765
396,BUMA.1121.00044,1,3309847,3338549,-,28702
396,BUMA.1121.00088,1,482710,511408,+,28698
396,BUMA.1121.00069,1,3526542,3555247,+,28705
396,BUMA.1121.00064,1,3639663,3668387,+,28724
396,BUMA.1121.00105,1,1552734,1581441,-,28707
396,BUMA.1121.00015,1,499177,527900,-,28723
396,BUMA.1121.00059,1,2889709,2918413,+,28704
396,BUMA.1121.00026,1,1465556,1494294,-,28738
396,BUMA.1121.00022,1,716223,744925,-,28702
396,BUMA.1121.00052,1,91692,120429,-,28737
396,BUMA.1121.00101,1,2800426,2829143,-,28717
396,BUMA.1121.00001,1,390765,419462,-,28697
396,BUMA.1121.00038,1,2797136,2825873,+,28737
396,BUMA.1121.00068,1,2462660,2491369,+,28709
396,BUMA.1121.00099,1,2769087,2797819,-,28732
396,BUMA.1121.00091,1,827490,856214,-,28724
396,BUMA.1121.00098,1,2338086,2366835,+,28749
396,BUMA.1121.00013,1,835335,864051,+,28716
396,BUMA.1121.00049,1,2156044,2184734,-,28690
396,BUMA.1121.00072,1,3528112,3556816,+,28704
396,BUMA.1121.00076,1,1665135,1693832,-,28697
396,BUMA.1121.00074,2,659361,688078,+,28717
396,BUMA.1121.00083,1,2019226,2047936,-,28710
396,BUMA.1121.00078,1,2349239,2377997,-,28758
396,BUMA.1121.00095,1,1990309,2019026,-,28717
396,BUMA.1121.00077,1,2313811,2342516,+,28705
396,BUMA.1121.00063,1,3539973,3568682,+,28709
396,BUMA.1121.00061,1,3543412,3572122,+,28710
396,BUMA.1121.00050,1,1887841,1916585,+,28744
396,BUMA.1121.00081,1,2797335,2826072,+,28737
396,BUMA.1121.00062,1,906366,935091,-,28725
396,BUMA.1121.00060,1,2657498,2686199,-,28701
396,BUMA.1121.00070,1,3514259,3542969,+,28710
396,BUMA.1121.00075,1,3118444,3147140,+,28696
396,BUMA.1121.00041,1,879922,908682,+,28760
396,BUMA.1121.00073,1,3541691,3570401,+,28710
396,BUMA.1121.00017,1,507845,536547,-,28702
396,BUMA.1121.00066,1,3531065,3559774,+,28709
396,BUMA.1121.00107,1,3607177,3635875,+,28698
396,BUMA.1121.00085,1,3185498,3214235,-,28737
396,BUMA.1121.00030,1,507845,536547,-,28702
396,BUMA.1121.00112,1,3419466,3448160,-,28694
396,BUMA.1121.00002,1,1334485,1363194,+,28709
396,BUMA.1121.00082,1,3731435,3760145,+,28710
396,BUMA.1121.00014,1,3206614,3235320,-,28706
396,BUMA.1121.00011,1,1946089,1974816,-,28727
396,BUMA.1121.00019,1,507859,536561,-,28702
396,BUMA.1121.00057,1,731785,760504,+,28719
396,BUMA.1121.00018,1,103997,132690,+,28693
396,BUMA.1121.00039,1,3774879,3803574,+,28695
396,BUMA.1121.00016,1,1742151,1770854,+,28703
396,BUMA.1121.00004,1,507839,536541,-,28702
396,BUMA.1121.00005,1,3905102,3933826,-,28724
396,BUMA.1121.00100,1,1636571,1665266,-,28695
396,BUMA.1121.00006,1,2797220,2825957,+,28737
397,BUMA.1121.00027,1,1843922,1862302,+,18380
397,BUMA.1121.00025,1,3108766,3127156,-,18390
397,BUMA.1121.00021,1,301489,319869,+,18380
397,BUMA.1121.00023,1,2024163,2042552,+,18389
397,BUMA.1121.00024,1,489436,507816,-,18380
397,BUMA.1121.00033,1,1920896,1939284,+,18388
397,BUMA.1121.00034,1,489444,507824,-,18380
397,BUMA.1121.00036,1,3439921,3458245,-,18324
397,BUMA.1121.00032,1,2154770,2173149,+,18379
397,BUMA.1121.00009,1,1891390,1909770,-,18380
397,BUMA.1121.00008,1,489458,507838,-,18380
397,BUMA.1121.00003,1,2190233,2208612,+,18379
397,BUMA.1121.00109,1,2221925,2240304,-,18379
397,BUMA.1121.00053,1,3416238,3434616,+,18378
397,BUMA.1121.00110,1,1122411,1140791,-,18380
397,BUMA.1121.00104,1,1566022,1584403,-,18381
397,BUMA.1121.00086,1,2735068,2753447,+,18379
397,BUMA.1121.00092,1,3761116,3779495,+,18379
397,BUMA.1121.00096,1,3564442,3582821,-,18379
397,BUMA.1121.00054,1,1298816,1317196,-,18380
397,BUMA.1121.00097,1,262913,281293,-,18380
397,BUMA.1121.00093,1,846941,865321,-,18380
397,BUMA.1121.00106,1,3432786,3451166,+,18380
397,BUMA.1121.00010,1,1336391,1354770,+,18379
397,BUMA.1121.00035,1,705798,724187,+,18389
397,BUMA.1121.00108,1,653492,671880,+,18388
397,BUMA.1121.00028,1,489445,507825,-,18380
397,BUMA.1121.00094,1,3684683,3703072,+,18389
397,BUMA.1121.00102,1,1611105,1629485,-,18380
397,BUMA.1121.00111,1,3844591,3862971,+,18380
397,BUMA.1121.00089,1,3656487,3674876,+,18389
397,BUMA.1121.00084,1,4053578,4071958,+,18380
397,BUMA.1121.00029,1,1246325,1264715,-,18390
397,BUMA.1121.00012,1,2401522,2419917,+,18395
397,BUMA.1121.00087,1,582282,600662,-,18380
397,BUMA.1121.00043,1,3785460,3803839,+,18379
397,BUMA.1121.00046,1,816865,835245,-,18380
397,BUMA.1121.00037,1,2318016,2336405,+,18389
397,BUMA.1121.00080,1,3682381,3700769,+,18388
397,BUMA.1121.00079,1,3767839,3786228,+,18389
397,BUMA.1121.00045,1,393849,412228,-,18379
397,BUMA.1121.00071,1,3574715,3593086,+,18371
397,BUMA.1121.00056,1,252055,270445,-,18390
397,BUMA.1121.00065,1,3715924,3734299,+,18375
397,BUMA.1121.00058,1,827928,846302,-,18374
397,BUMA.1121.00007,1,362844,381224,-,18380
397,BUMA.1121.00067,1,740081,758462,-,18381
397,BUMA.1121.00090,1,1731501,1749890,+,18389
397,BUMA.1121.00051,1,3654735,3673124,+,18389
397,BUMA.1121.00020,1,489451,507831,-,18380
397,BUMA.1121.00103,1,664007,682386,-,18379
397,BUMA.1121.00048,1,2618595,2636974,+,18379
397,BUMA.1121.00047,1,3294575,3312965,-,18390
397,BUMA.1121.00042,1,136469,154840,-,18371
397,BUMA.1121.00055,1,3335477,3353857,+,18380
397,BUMA.1121.00031,1,1043868,1062257,+,18389
397,BUMA.1121.00040,1,62912,81291,-,18379
397,BUMA.1121.00044,1,3291445,3309825,-,18380
397,BUMA.1121.00088,1,511430,529810,+,18380
397,BUMA.1121.00069,1,3555269,3573640,+,18371
397,BUMA.1121.00064,1,3668409,3686789,+,18380
397,BUMA.1121.00105,1,1534332,1552712,-,18380
397,BUMA.1121.00015,1,480775,499155,-,18380
397,BUMA.1121.00059,1,2918435,2936815,+,18380
397,BUMA.1121.00026,1,1447163,1465534,-,18371
397,BUMA.1121.00022,1,697821,716201,-,18380
397,BUMA.1121.00052,1,73290,91670,-,18380
397,BUMA.1121.00101,1,2782015,2800404,-,18389
397,BUMA.1121.00001,1,372353,390743,-,18390
397,BUMA.1121.00038,1,2825895,2844274,+,18379
397,BUMA.1121.00068,1,2491391,2509770,+,18379
397,BUMA.1121.00099,1,2750685,2769065,-,18380
397,BUMA.1121.00091,1,809098,827468,-,18370
397,BUMA.1121.00098,1,2366857,2385245,+,18388
397,BUMA.1121.00013,1,864073,882452,+,18379
397,BUMA.1121.00049,1,2137641,2156022,-,18381
397,BUMA.1121.00072,1,3556838,3575209,+,18371
397,BUMA.1121.00076,1,1646733,1665113,-,18380
397,BUMA.1121.00074,2,688100,706480,+,18380
397,BUMA.1121.00083,1,2000832,2019204,-,18372
397,BUMA.1121.00078,1,2330845,2349217,-,18372
397,BUMA.1121.00095,1,1971906,1990287,-,18381
397,BUMA.1121.00077,1,2342538,2360916,+,18378
397,BUMA.1121.00063,1,3568704,3587075,+,18371
397,BUMA.1121.00061,1,3572144,3590515,+,18371
397,BUMA.1121.00050,1,1916607,1934986,+,18379
397,BUMA.1121.00081,1,2826094,2844473,+,18379
397,BUMA.1121.00062,1,887965,906344,-,18379
397,BUMA.1121.00060,1,2639097,2657476,-,18379
397,BUMA.1121.00070,1,3542991,3561361,+,18370
397,BUMA.1121.00075,1,3147162,3165539,+,18377
397,BUMA.1121.00041,1,908704,927083,+,18379
397,BUMA.1121.00073,1,3570423,3588794,+,18371
397,BUMA.1121.00017,1,489443,507823,-,18380
397,BUMA.1121.00066,1,3559796,3578167,+,18371
397,BUMA.1121.00107,1,3635897,3654285,+,18388
397,BUMA.1121.00085,1,3167096,3185476,-,18380
397,BUMA.1121.00030,1,489443,507823,-,18380
397,BUMA.1121.00112,1,3401064,3419444,-,18380
397,BUMA.1121.00002,1,1363216,1381595,+,18379
397,BUMA.1121.00082,1,3760167,3778538,+,18371
397,BUMA.1121.00014,1,3188202,3206592,-,18390
397,BUMA.1121.00011,1,1927678,1946067,-,18389
397,BUMA.1121.00019,1,489457,507837,-,18380
397,BUMA.1121.00057,1,760526,778897,+,18371
397,BUMA.1121.00018,1,132712,151101,+,18389
397,BUMA.1121.00039,1,3803596,3821985,+,18389
397,BUMA.1121.00016,1,1770876,1789256,+,18380
397,BUMA.1121.00004,1,489437,507817,-,18380
397,BUMA.1121.00005,1,3886713,3905080,-,18367
397,BUMA.1121.00100,1,1618170,1636549,-,18379
397,BUMA.1121.00006,1,2825979,2844358,+,18379
398,BUMA.1121.00027,1,1870081,1874632,+,4551
398,BUMA.1121.00025,1,3096441,3100992,-,4551
398,BUMA.1121.00021,1,327643,332195,+,4552
398,BUMA.1121.00023,1,2050279,2054831,+,4552
398,BUMA.1121.00024,1,1080209,1084760,-,4551
398,BUMA.1121.00033,1,1947056,1951608,+,4552
398,BUMA.1121.00034,1,1117646,1122197,-,4551
398,BUMA.1121.00036,1,159491,164042,-,4551
398,BUMA.1121.00032,1,2610633,2615184,-,4551
398,BUMA.1121.00009,1,1879074,1883625,-,4551
398,BUMA.1121.00008,1,1083938,1088489,-,4551
398,BUMA.1121.00003,1,2216374,2220926,+,4552
398,BUMA.1121.00109,1,2209606,2214157,-,4551
398,BUMA.1121.00053,1,3442384,3446936,+,4552
398,BUMA.1121.00110,1,1110091,1114642,-,4551
398,BUMA.1121.00104,1,1553709,1558260,-,4551
398,BUMA.1121.00086,1,3448019,3452570,-,4551
398,BUMA.1121.00092,1,3787275,3791827,+,4552
398,BUMA.1121.00096,1,3552119,3556668,-,4549
398,BUMA.1121.00054,1,1431506,1436057,-,4551
398,BUMA.1121.00097,1,250594,255145,-,4551
398,BUMA.1121.00093,1,834610,839161,-,4551
398,BUMA.1121.00106,1,3458951,3463503,+,4552
398,BUMA.1121.00010,1,1405760,1410311,-,4551
398,BUMA.1121.00035,1,731967,736519,+,4552
398,BUMA.1121.00108,1,681239,685791,+,4552
398,BUMA.1121.00028,1,1080243,1084794,-,4551
398,BUMA.1121.00094,1,3710841,3715393,+,4552
398,BUMA.1121.00102,1,1598774,1603325,-,4551
398,BUMA.1121.00111,1,3870739,3875291,+,4552
398,BUMA.1121.00089,1,3682645,3687197,+,4552
398,BUMA.1121.00084,1,4079720,4084272,+,4552
398,BUMA.1121.00029,1,1233994,1238545,-,4551
398,BUMA.1121.00012,1,2427685,2432237,+,4552
398,BUMA.1121.00087,1,3359677,3364229,+,4552
398,BUMA.1121.00043,1,3811613,3816165,+,4552
398,BUMA.1121.00046,1,761324,765876,+,4552
398,BUMA.1121.00037,1,2344173,2348725,+,4552
398,BUMA.1121.00080,1,3708538,3713090,+,4552
398,BUMA.1121.00079,1,3793995,3798547,+,4552
398,BUMA.1121.00045,1,379935,384486,-,4551
398,BUMA.1121.00071,1,3600855,3605407,+,4552
398,BUMA.1121.00056,1,239735,244286,-,4551
398,BUMA.1121.00065,1,3742061,3746613,+,4552
398,BUMA.1121.00058,1,815605,820156,-,4551
398,BUMA.1121.00007,1,350532,355083,-,4551
398,BUMA.1121.00067,1,727762,732313,-,4551
398,BUMA.1121.00090,1,1757658,1762210,+,4552
398,BUMA.1121.00051,1,3680893,3685445,+,4552
398,BUMA.1121.00020,1,1145180,1149731,-,4551
398,BUMA.1121.00103,1,651689,656240,-,4551
398,BUMA.1121.00048,1,2499733,2504285,+,4552
398,BUMA.1121.00047,1,3282255,3286806,-,4551
398,BUMA.1121.00042,1,3399319,3403871,+,4552
398,BUMA.1121.00055,1,3361619,3366171,+,4552
398,BUMA.1121.00031,1,1070025,1074577,+,4552
398,BUMA.1121.00040,1,819237,823788,-,4551
398,BUMA.1121.00044,1,345760,350311,-,4551
398,BUMA.1121.00088,1,537074,541626,+,4552
398,BUMA.1121.00069,1,3581409,3585961,+,4552
398,BUMA.1121.00064,1,3694563,3699115,+,4552
398,BUMA.1121.00105,1,1521996,1526547,-,4551
398,BUMA.1121.00015,1,3238502,3243054,+,4552
398,BUMA.1121.00059,1,2944577,2949129,+,4552
398,BUMA.1121.00026,1,1589926,1594477,-,4551
398,BUMA.1121.00022,1,875624,880175,-,4551
398,BUMA.1121.00052,1,17743,22295,+,4552
398,BUMA.1121.00101,1,2768104,2772655,-,4551
398,BUMA.1121.00001,1,360022,364573,-,4551
398,BUMA.1121.00038,1,2707033,2711585,+,4552
398,BUMA.1121.00068,1,2517538,2522090,+,4552
398,BUMA.1121.00099,1,2738354,2742905,-,4551
398,BUMA.1121.00091,1,796767,801318,-,4551
398,BUMA.1121.00098,1,2393019,2397571,+,4552
398,BUMA.1121.00013,1,933448,937999,-,4551
398,BUMA.1121.00049,1,2123738,2128289,-,4551
398,BUMA.1121.00072,1,3582978,3587530,+,4552
398,BUMA.1121.00076,1,1634413,1638964,-,4551
398,BUMA.1121.00074,2,714248,718800,+,4552
398,BUMA.1121.00083,1,1988512,1993063,-,4551
398,BUMA.1121.00078,1,2318520,2323071,-,4551
398,BUMA.1121.00095,1,1959593,1964144,-,4551
398,BUMA.1121.00077,1,2368685,2373237,+,4552
398,BUMA.1121.00063,1,3594844,3599396,+,4552
398,BUMA.1121.00061,1,3598284,3602836,+,4552
398,BUMA.1121.00050,1,1985969,1990520,-,4551
398,BUMA.1121.00081,1,2707232,2711784,+,4552
398,BUMA.1121.00062,1,875646,880197,-,4551
398,BUMA.1121.00060,1,2625184,2629735,-,4551
398,BUMA.1121.00070,1,3569129,3573681,+,4552
398,BUMA.1121.00075,1,3173305,3177857,+,4552
398,BUMA.1121.00041,1,934851,939403,+,4552
398,BUMA.1121.00073,1,3596563,3601115,+,4552
398,BUMA.1121.00017,1,1015286,1019837,-,4551
398,BUMA.1121.00066,1,3585936,3590488,+,4552
398,BUMA.1121.00107,1,3662059,3666611,+,4552
398,BUMA.1121.00085,1,3111549,3116101,+,4552
398,BUMA.1121.00030,1,1015318,1019869,-,4551
398,BUMA.1121.00112,1,3388769,3393296,-,4527
398,BUMA.1121.00002,1,1432589,1437140,-,4551
398,BUMA.1121.00082,1,3786307,3790859,+,4552
398,BUMA.1121.00014,1,3175883,3180434,-,4551
398,BUMA.1121.00011,1,1915360,1919911,-,4551
398,BUMA.1121.00019,1,1080287,1084838,-,4551
398,BUMA.1121.00057,1,786666,791218,+,4552
398,BUMA.1121.00018,1,158875,163427,+,4552
398,BUMA.1121.00039,1,3829753,3834305,+,4552
398,BUMA.1121.00016,1,1797028,1801580,+,4552
398,BUMA.1121.00004,1,1081482,1086033,-,4551
398,BUMA.1121.00005,1,3874393,3878944,-,4551
398,BUMA.1121.00100,1,1605845,1610396,-,4551
398,BUMA.1121.00006,1,2707117,2711669,+,4552
399,BUMA.1121.00027,1,1877399,1893256,+,15857
399,BUMA.1121.00025,1,3077817,3093673,-,15856
399,BUMA.1121.00021,1,334963,350819,+,15856
399,BUMA.1121.00023,1,2057598,2073463,+,15865
399,BUMA.1121.00024,1,1061586,1077441,-,15855
399,BUMA.1121.00033,1,1954375,1970232,+,15857
399,BUMA.1121.00034,1,1099023,1114878,-,15855
399,BUMA.1121.00036,1,140868,156723,-,15855
399,BUMA.1121.00032,1,2592010,2607865,-,15855
399,BUMA.1121.00009,1,1860450,1876306,-,15856
399,BUMA.1121.00008,1,1065315,1081170,-,15855
399,BUMA.1121.00003,1,2223690,2239547,+,15857
399,BUMA.1121.00109,1,2190985,2206841,-,15856
399,BUMA.1121.00053,1,3449703,3465560,+,15857
399,BUMA.1121.00110,1,1089869,1105725,-,15856
399,BUMA.1121.00104,1,1535085,1550941,-,15856
399,BUMA.1121.00086,1,3429396,3445251,-,15855
399,BUMA.1121.00092,1,3794594,3810451,+,15857
399,BUMA.1121.00096,1,3531897,3547752,-,15855
399,BUMA.1121.00054,1,1412883,1428738,-,15855
399,BUMA.1121.00097,1,231970,247826,-,15856
399,BUMA.1121.00093,1,815986,831842,-,15856
399,BUMA.1121.00106,1,3466270,3482127,+,15857
399,BUMA.1121.00010,1,1387137,1402992,-,15855
399,BUMA.1121.00035,1,739286,755143,+,15857
399,BUMA.1121.00108,1,688558,704415,+,15857
399,BUMA.1121.00028,1,1061620,1077475,-,15855
399,BUMA.1121.00094,1,3718160,3734017,+,15857
399,BUMA.1121.00102,1,1580150,1596006,-,15856
399,BUMA.1121.00111,1,3878058,3893915,+,15857
399,BUMA.1121.00089,1,3689964,3705821,+,15857
399,BUMA.1121.00084,1,4087039,4102896,+,15857
399,BUMA.1121.00029,1,1215370,1231226,-,15856
399,BUMA.1121.00012,1,2435004,2450861,+,15857
399,BUMA.1121.00087,1,3366996,3382852,+,15856
399,BUMA.1121.00043,1,3818932,3834789,+,15857
399,BUMA.1121.00046,1,768643,784499,+,15856
399,BUMA.1121.00037,1,2351492,2367349,+,15857
399,BUMA.1121.00080,1,3715857,3731714,+,15857
399,BUMA.1121.00079,1,3802910,3818767,+,15857
399,BUMA.1121.00045,1,361311,377167,-,15856
399,BUMA.1121.00071,1,3608174,3624031,+,15857
399,BUMA.1121.00056,1,221111,236967,-,15856
399,BUMA.1121.00065,1,3749380,3765237,+,15857
399,BUMA.1121.00058,1,796981,812837,-,15856
399,BUMA.1121.00007,1,331908,347764,-,15856
399,BUMA.1121.00067,1,709141,724997,-,15856
399,BUMA.1121.00090,1,1764977,1780834,+,15857
399,BUMA.1121.00051,1,3688212,3704069,+,15857
399,BUMA.1121.00020,1,1126557,1142412,-,15855
399,BUMA.1121.00103,1,633065,648921,-,15856
399,BUMA.1121.00048,1,2507052,2522908,+,15856
399,BUMA.1121.00047,1,3263631,3279487,-,15856
399,BUMA.1121.00042,1,3406638,3422494,+,15856
399,BUMA.1121.00055,1,3368938,3384795,+,15857
399,BUMA.1121.00031,1,1077344,1093201,+,15857
399,BUMA.1121.00040,1,800621,816469,-,15848
399,BUMA.1121.00044,1,327137,342992,-,15855
399,BUMA.1121.00088,1,544393,560250,+,15857
399,BUMA.1121.00069,1,3588728,3604585,+,15857
399,BUMA.1121.00064,1,3701882,3717739,+,15857
399,BUMA.1121.00105,1,1503372,1519228,-,15856
399,BUMA.1121.00015,1,3245821,3261677,+,15856
399,BUMA.1121.00059,1,2951896,2967753,+,15857
399,BUMA.1121.00026,1,1571303,1587158,-,15855
399,BUMA.1121.00022,1,857001,872856,-,15855
399,BUMA.1121.00052,1,25062,40918,+,15856
399,BUMA.1121.00101,1,2749480,2765336,-,15856
399,BUMA.1121.00001,1,341398,357254,-,15856
399,BUMA.1121.00038,1,2714352,2730208,+,15856
399,BUMA.1121.00068,1,2524857,2540714,+,15857
399,BUMA.1121.00099,1,2719730,2735586,-,15856
399,BUMA.1121.00091,1,778143,793999,-,15856
399,BUMA.1121.00098,1,2400338,2416195,+,15857
399,BUMA.1121.00013,1,914825,930680,-,15855
399,BUMA.1121.00049,1,2105114,2120970,-,15856
399,BUMA.1121.00072,1,3590297,3606154,+,15857
399,BUMA.1121.00076,1,1615789,1631645,-,15856
399,BUMA.1121.00074,2,721564,737421,+,15857
399,BUMA.1121.00083,1,1969888,1985744,-,15856
399,BUMA.1121.00078,1,2298300,2314156,-,15856
399,BUMA.1121.00095,1,1940972,1956825,-,15853
399,BUMA.1121.00077,1,2377600,2393457,+,15857
399,BUMA.1121.00063,1,3602163,3618020,+,15857
399,BUMA.1121.00061,1,3605603,3621460,+,15857
399,BUMA.1121.00050,1,1967346,1983201,-,15855
399,BUMA.1121.00081,1,2714551,2730407,+,15856
399,BUMA.1121.00062,1,857022,872878,-,15856
399,BUMA.1121.00060,1,2606560,2622416,-,15856
399,BUMA.1121.00070,1,3576448,3592305,+,15857
399,BUMA.1121.00075,1,3180624,3196481,+,15857
399,BUMA.1121.00041,1,942170,958027,+,15857
399,BUMA.1121.00073,1,3603882,3619739,+,15857
399,BUMA.1121.00017,1,996663,1012518,-,15855
399,BUMA.1121.00066,1,3593255,3609112,+,15857
399,BUMA.1121.00107,1,3669378,3685235,+,15857
399,BUMA.1121.00085,1,3118868,3134724,+,15856
399,BUMA.1121.00030,1,996695,1012550,-,15855
399,BUMA.1121.00112,1,3370145,3386001,-,15856
399,BUMA.1121.00002,1,1413966,1429821,-,15855
399,BUMA.1121.00082,1,3793626,3809483,+,15857
399,BUMA.1121.00014,1,3157259,3173115,-,15856
399,BUMA.1121.00011,1,1896736,1912592,-,15856
399,BUMA.1121.00019,1,1061664,1077519,-,15855
399,BUMA.1121.00057,1,793985,809842,+,15857
399,BUMA.1121.00018,1,166194,182051,+,15857
399,BUMA.1121.00039,1,3837072,3852929,+,15857
399,BUMA.1121.00016,1,1804347,1820204,+,15857
399,BUMA.1121.00004,1,1062859,1078714,-,15855
399,BUMA.1121.00005,1,3855769,3871625,-,15856
399,BUMA.1121.00100,1,1587221,1603077,-,15856
399,BUMA.1121.00006,1,2714436,2730292,+,15856
400,BUMA.1121.00027,1,1894399,1899828,+,5429
400,BUMA.1121.00025,1,3071245,3076673,-,5428
400,BUMA.1121.00021,1,351962,357391,+,5429
400,BUMA.1121.00023,1,2074606,2080035,+,5429
400,BUMA.1121.00024,1,1055014,1060442,-,5428
400,BUMA.1121.00033,1,1971375,1976804,+,5429
400,BUMA.1121.00034,1,1092451,1097879,-,5428
400,BUMA.1121.00036,1,134296,139724,-,5428
400,BUMA.1121.00032,1,2585438,2590866,-,5428
400,BUMA.1121.00009,1,1853878,1859306,-,5428
400,BUMA.1121.00008,1,1058743,1064171,-,5428
400,BUMA.1121.00003,1,2240690,2246119,+,5429
400,BUMA.1121.00109,1,2184413,2189841,-,5428
400,BUMA.1121.00053,1,3466703,3472132,+,5429
400,BUMA.1121.00110,1,1083297,1088725,-,5428
400,BUMA.1121.00104,1,1528513,1533941,-,5428
400,BUMA.1121.00086,1,3422824,3428252,-,5428
400,BUMA.1121.00092,1,3811594,3817023,+,5429
400,BUMA.1121.00096,1,3525325,3530753,-,5428
400,BUMA.1121.00054,1,1406311,1411739,-,5428
400,BUMA.1121.00097,1,225398,230826,-,5428
400,BUMA.1121.00093,1,809414,814842,-,5428
400,BUMA.1121.00106,1,3483270,3488699,+,5429
400,BUMA.1121.00010,1,1380565,1385993,-,5428
400,BUMA.1121.00035,1,756286,761715,+,5429
400,BUMA.1121.00108,1,705558,710987,+,5429
400,BUMA.1121.00028,1,1055048,1060476,-,5428
400,BUMA.1121.00094,1,3735160,3740589,+,5429
400,BUMA.1121.00102,1,1573578,1579006,-,5428
400,BUMA.1121.00111,1,3895058,3900487,+,5429
400,BUMA.1121.00089,1,3706964,3712393,+,5429
400,BUMA.1121.00084,1,4104039,4109468,+,5429
400,BUMA.1121.00029,1,1208798,1214226,-,5428
400,BUMA.1121.00012,1,2452004,2457433,+,5429
400,BUMA.1121.00087,1,3383995,3389424,+,5429
400,BUMA.1121.00043,1,3835932,3841361,+,5429
400,BUMA.1121.00046,1,785642,791071,+,5429
400,BUMA.1121.00037,1,2368492,2373921,+,5429
400,BUMA.1121.00080,1,3732857,3738286,+,5429
400,BUMA.1121.00079,1,3819910,3825339,+,5429
400,BUMA.1121.00045,1,354739,360167,-,5428
400,BUMA.1121.00071,1,3625174,3630603,+,5429
400,BUMA.1121.00056,1,214539,219967,-,5428
400,BUMA.1121.00065,1,3766380,3771809,+,5429
400,BUMA.1121.00058,1,790409,795837,-,5428
400,BUMA.1121.00007,1,325336,330764,-,5428
400,BUMA.1121.00067,1,702569,707997,-,5428
400,BUMA.1121.00090,1,1781977,1787406,+,5429
400,BUMA.1121.00051,1,3705212,3710641,+,5429
400,BUMA.1121.00020,1,1119985,1125413,-,5428
400,BUMA.1121.00103,1,626492,631920,-,5428
400,BUMA.1121.00048,1,2524051,2529480,+,5429
400,BUMA.1121.00047,1,3257059,3262487,-,5428
400,BUMA.1121.00042,1,3423637,3429066,+,5429
400,BUMA.1121.00055,1,3385938,3391367,+,5429
400,BUMA.1121.00031,1,1094344,1099773,+,5429
400,BUMA.1121.00040,1,794042,799470,-,5428
400,BUMA.1121.00044,1,320565,325993,-,5428
400,BUMA.1121.00088,1,561393,566822,+,5429
400,BUMA.1121.00069,1,3605728,3611157,+,5429
400,BUMA.1121.00064,1,3718882,3724311,+,5429
400,BUMA.1121.00105,1,1496800,1502228,-,5428
400,BUMA.1121.00015,1,3262820,3268249,+,5429
400,BUMA.1121.00059,1,2968896,2974325,+,5429
400,BUMA.1121.00026,1,1564731,1570159,-,5428
400,BUMA.1121.00022,1,850429,855857,-,5428
400,BUMA.1121.00052,1,42061,47490,+,5429
400,BUMA.1121.00101,1,2742908,2748336,-,5428
400,BUMA.1121.00001,1,334826,340254,-,5428
400,BUMA.1121.00038,1,2731351,2736780,+,5429
400,BUMA.1121.00068,1,2541857,2547286,+,5429
400,BUMA.1121.00099,1,2713158,2718586,-,5428
400,BUMA.1121.00091,1,771571,776999,-,5428
400,BUMA.1121.00098,1,2417338,2422767,+,5429
400,BUMA.1121.00013,1,908253,913681,-,5428
400,BUMA.1121.00049,1,2098542,2103970,-,5428
400,BUMA.1121.00072,1,3607297,3612726,+,5429
400,BUMA.1121.00076,1,1609217,1614645,-,5428
400,BUMA.1121.00074,2,738564,743993,+,5429
400,BUMA.1121.00083,1,1963316,1968744,-,5428
400,BUMA.1121.00078,1,2291728,2297156,-,5428
400,BUMA.1121.00095,1,1934399,1939828,-,5429
400,BUMA.1121.00077,1,2394600,2400029,+,5429
400,BUMA.1121.00063,1,3619163,3624592,+,5429
400,BUMA.1121.00061,1,3622603,3628032,+,5429
400,BUMA.1121.00050,1,1960774,1966202,-,5428
400,BUMA.1121.00081,1,2731550,2736979,+,5429
400,BUMA.1121.00062,1,850450,855878,-,5428
400,BUMA.1121.00060,1,2599988,2605416,-,5428
400,BUMA.1121.00070,1,3593448,3598877,+,5429
400,BUMA.1121.00075,1,3197624,3203053,+,5429
400,BUMA.1121.00041,1,959170,964599,+,5429
400,BUMA.1121.00073,1,3620882,3626311,+,5429
400,BUMA.1121.00017,1,990091,995519,-,5428
400,BUMA.1121.00066,1,3610255,3615684,+,5429
400,BUMA.1121.00107,1,3686378,3691807,+,5429
400,BUMA.1121.00085,1,3135867,3141296,+,5429
400,BUMA.1121.00030,1,990123,995551,-,5428
400,BUMA.1121.00112,1,3363573,3369001,-,5428
400,BUMA.1121.00002,1,1407394,1412822,-,5428
400,BUMA.1121.00082,1,3810626,3816055,+,5429
400,BUMA.1121.00014,1,3150687,3156115,-,5428
400,BUMA.1121.00011,1,1890164,1895592,-,5428
400,BUMA.1121.00019,1,1055092,1060520,-,5428
400,BUMA.1121.00057,1,810985,816414,+,5429
400,BUMA.1121.00018,1,183194,188623,+,5429
400,BUMA.1121.00039,1,3854072,3859501,+,5429
400,BUMA.1121.00016,1,1821347,1826776,+,5429
400,BUMA.1121.00004,1,1056287,1061715,-,5428
400,BUMA.1121.00005,1,3849197,3854625,-,5428
400,BUMA.1121.00100,1,1580649,1586077,-,5428
400,BUMA.1121.00006,1,2731435,2736864,+,5429
401,BUMA.1121.00027,1,1899889,1912382,+,12493
401,BUMA.1121.00025,1,3058688,3071184,-,12496
401,BUMA.1121.00021,1,357452,369948,+,12496
401,BUMA.1121.00023,1,2080096,2092592,+,12496
401,BUMA.1121.00024,1,1041144,1053640,-,12496
401,BUMA.1121.00033,1,1978177,1990673,+,12496
401,BUMA.1121.00034,1,1078581,1091077,-,12496
401,BUMA.1121.00036,1,120426,132922,-,12496
401,BUMA.1121.00032,1,2571568,2584064,-,12496
401,BUMA.1121.00009,1,1841322,1853817,-,12495
401,BUMA.1121.00008,1,1044873,1057369,-,12496
401,BUMA.1121.00003,1,2246180,2258676,+,12496
401,BUMA.1121.00109,1,2171856,2184352,-,12496
401,BUMA.1121.00053,1,3472193,3484689,+,12496
401,BUMA.1121.00110,1,1069427,1081923,-,12496
401,BUMA.1121.00104,1,1515956,1528452,-,12496
401,BUMA.1121.00086,1,3408954,3421450,-,12496
401,BUMA.1121.00092,1,3817084,3829580,+,12496
401,BUMA.1121.00096,1,3512768,3525264,-,12496
401,BUMA.1121.00054,1,1392441,1404937,-,12496
401,BUMA.1121.00097,1,212841,225337,-,12496
401,BUMA.1121.00093,1,796857,809353,-,12496
401,BUMA.1121.00106,1,3488760,3501256,+,12496
401,BUMA.1121.00010,1,1366695,1379191,-,12496
401,BUMA.1121.00035,1,761776,774272,+,12496
401,BUMA.1121.00108,1,711048,723544,+,12496
401,BUMA.1121.00028,1,1041178,1053674,-,12496
401,BUMA.1121.00094,1,3743176,3755670,+,12494
401,BUMA.1121.00102,1,1561021,1573517,-,12496
401,BUMA.1121.00111,1,3900548,3913044,+,12496
401,BUMA.1121.00089,1,3714979,3727475,+,12496
401,BUMA.1121.00084,1,4110842,4123338,+,12496
401,BUMA.1121.00029,1,1196241,1208737,-,12496
401,BUMA.1121.00012,1,2457494,2469990,+,12496
401,BUMA.1121.00087,1,3390798,3403294,+,12496
401,BUMA.1121.00043,1,3841422,3853918,+,12496
401,BUMA.1121.00046,1,792445,804941,+,12496
401,BUMA.1121.00037,1,2373982,2386478,+,12496
401,BUMA.1121.00080,1,3740872,3753368,+,12496
401,BUMA.1121.00079,1,3827925,3840421,+,12496
401,BUMA.1121.00045,1,342182,354678,-,12496
401,BUMA.1121.00071,1,3630664,3643160,+,12496
401,BUMA.1121.00056,1,199457,211953,-,12496
401,BUMA.1121.00065,1,3771870,3784366,+,12496
401,BUMA.1121.00058,1,777852,790348,-,12496
401,BUMA.1121.00007,1,311466,323962,-,12496
401,BUMA.1121.00067,1,690012,702508,-,12496
401,BUMA.1121.00090,1,1787467,1799963,+,12496
401,BUMA.1121.00051,1,3713227,3725723,+,12496
401,BUMA.1121.00020,1,1106115,1118611,-,12496
401,BUMA.1121.00103,1,612622,625118,-,12496
401,BUMA.1121.00048,1,2530854,2543350,+,12496
401,BUMA.1121.00047,1,3241977,3254473,-,12496
401,BUMA.1121.00042,1,3430440,3442936,+,12496
401,BUMA.1121.00055,1,3391428,3403924,+,12496
401,BUMA.1121.00031,1,1099834,1112330,+,12496
401,BUMA.1121.00040,1,780172,792668,-,12496
401,BUMA.1121.00044,1,306695,319191,-,12496
401,BUMA.1121.00088,1,568196,580692,+,12496
401,BUMA.1121.00069,1,3611218,3623714,+,12496
401,BUMA.1121.00064,1,3725685,3738181,+,12496
401,BUMA.1121.00105,1,1484243,1496739,-,12496
401,BUMA.1121.00015,1,3269623,3282119,+,12496
401,BUMA.1121.00059,1,2974386,2986882,+,12496
401,BUMA.1121.00026,1,1550861,1563357,-,12496
401,BUMA.1121.00022,1,836559,849055,-,12496
401,BUMA.1121.00052,1,48864,61360,+,12496
401,BUMA.1121.00101,1,2730351,2742847,-,12496
401,BUMA.1121.00001,1,322269,334765,-,12496
401,BUMA.1121.00038,1,2738154,2750650,+,12496
401,BUMA.1121.00068,1,2547347,2559843,+,12496
401,BUMA.1121.00099,1,2700601,2713097,-,12496
401,BUMA.1121.00091,1,759014,771510,-,12496
401,BUMA.1121.00098,1,2422828,2435324,+,12496
401,BUMA.1121.00013,1,894383,906879,-,12496
401,BUMA.1121.00049,1,2085985,2098481,-,12496
401,BUMA.1121.00072,1,3612787,3625283,+,12496
401,BUMA.1121.00076,1,1596660,1609156,-,12496
401,BUMA.1121.00074,2,744054,756550,+,12496
401,BUMA.1121.00083,1,1950759,1963255,-,12496
401,BUMA.1121.00078,1,2279171,2291667,-,12496
401,BUMA.1121.00095,1,1921842,1934338,-,12496
401,BUMA.1121.00077,1,2401401,2413898,+,12497
401,BUMA.1121.00063,1,3624653,3637149,+,12496
401,BUMA.1121.00061,1,3628093,3640589,+,12496
401,BUMA.1121.00050,1,1946904,1959400,-,12496
401,BUMA.1121.00081,1,2738353,2750849,+,12496
401,BUMA.1121.00062,1,837893,850389,-,12496
401,BUMA.1121.00060,1,2587431,2599927,-,12496
401,BUMA.1121.00070,1,3598938,3611434,+,12496
401,BUMA.1121.00075,1,3203114,3215610,+,12496
401,BUMA.1121.00041,1,964660,977156,+,12496
401,BUMA.1121.00073,1,3626372,3638868,+,12496
401,BUMA.1121.00017,1,976221,988717,-,12496
401,BUMA.1121.00066,1,3615745,3628241,+,12496
401,BUMA.1121.00107,1,3691868,3704364,+,12496
401,BUMA.1121.00085,1,3142670,3155166,+,12496
401,BUMA.1121.00030,1,976253,988749,-,12496
401,BUMA.1121.00112,1,3351016,3363512,-,12496
401,BUMA.1121.00002,1,1393526,1406022,-,12496
401,BUMA.1121.00082,1,3816116,3828612,+,12496
401,BUMA.1121.00014,1,3138130,3150626,-,12496
401,BUMA.1121.00011,1,1877607,1890103,-,12496
401,BUMA.1121.00019,1,1041222,1053718,-,12496
401,BUMA.1121.00057,1,816475,828971,+,12496
401,BUMA.1121.00018,1,188684,201180,+,12496
401,BUMA.1121.00039,1,3859562,3872058,+,12496
401,BUMA.1121.00016,1,1826837,1839333,+,12496
401,BUMA.1121.00004,1,1042417,1054913,-,12496
401,BUMA.1121.00005,1,3836640,3849136,-,12496
401,BUMA.1121.00100,1,1568092,1580588,-,12496
401,BUMA.1121.00006,1,2738238,2750734,+,12496
402,BUMA.1121.00027,1,1922218,1925690,+,3472
402,BUMA.1121.00025,1,3044239,3047711,-,3472
402,BUMA.1121.00021,1,381161,384633,+,3472
402,BUMA.1121.00023,1,2103729,2107201,+,3472
402,BUMA.1121.00024,1,1109869,1113342,-,3473
402,BUMA.1121.00033,1,2001745,2005217,+,3472
402,BUMA.1121.00034,1,1147313,1150786,-,3473
402,BUMA.1121.00036,1,189201,192674,-,3473
402,BUMA.1121.00032,1,2640272,2643745,-,3473
402,BUMA.1121.00009,1,1828003,1831475,-,3472
402,BUMA.1121.00008,1,1113584,1117057,-,3473
402,BUMA.1121.00003,1,2268626,2272100,+,3474
402,BUMA.1121.00109,1,2158415,2161887,-,3472
402,BUMA.1121.00053,1,3494689,3498170,+,3481
402,BUMA.1121.00110,1,1054909,1058381,-,3472
402,BUMA.1121.00104,1,1502575,1506047,-,3472
402,BUMA.1121.00086,1,3477657,3481130,-,3473
402,BUMA.1121.00092,1,3839492,3842964,+,3472
402,BUMA.1121.00096,1,3499427,3502899,-,3472
402,BUMA.1121.00054,1,1459193,1462665,-,3472
402,BUMA.1121.00097,1,199552,203036,-,3484
402,BUMA.1121.00093,1,783511,786983,-,3472
402,BUMA.1121.00106,1,3511200,3514672,+,3472
402,BUMA.1121.00010,1,1439894,1443367,+,3473
402,BUMA.1121.00035,1,784875,788347,+,3472
402,BUMA.1121.00108,1,733368,736840,+,3472
402,BUMA.1121.00028,1,1109889,1113362,-,3473
402,BUMA.1121.00094,1,3765461,3768933,+,3472
402,BUMA.1121.00102,1,1547432,1550904,-,3472
402,BUMA.1121.00111,1,3924111,3927583,+,3472
402,BUMA.1121.00089,1,3737268,3740740,+,3472
402,BUMA.1121.00084,1,8144,11616,+,3472
402,BUMA.1121.00029,1,1181764,1185236,-,3472
402,BUMA.1121.00012,1,2484095,2487567,+,3472
402,BUMA.1121.00087,1,3331118,3334591,+,3473
402,BUMA.1121.00043,1,3864997,3868469,+,3472
402,BUMA.1121.00046,1,734696,738168,+,3472
402,BUMA.1121.00037,1,2397578,2401050,+,3472
402,BUMA.1121.00080,1,3763160,3766632,+,3472
402,BUMA.1121.00079,1,3850174,3853646,+,3472
402,BUMA.1121.00045,1,328973,332408,-,3435
402,BUMA.1121.00071,1,3652946,3656418,+,3472
402,BUMA.1121.00056,1,186192,189664,-,3472
402,BUMA.1121.00065,1,3794219,3797699,+,3480
402,BUMA.1121.00058,1,764478,767950,-,3472
402,BUMA.1121.00007,1,298170,301642,-,3472
402,BUMA.1121.00067,1,676665,680137,-,3472
402,BUMA.1121.00090,1,1810973,1814445,+,3472
402,BUMA.1121.00051,1,3735515,3738987,+,3472
402,BUMA.1121.00020,1,1174826,1178299,-,3473
402,BUMA.1121.00103,1,599251,602731,-,3480
402,BUMA.1121.00048,1,2473126,2476598,+,3472
402,BUMA.1121.00047,1,3228752,3232224,-,3472
402,BUMA.1121.00042,1,3372349,3375821,+,3472
402,BUMA.1121.00055,1,3415145,3418626,+,3481
402,BUMA.1121.00031,1,1123365,1126837,+,3472
402,BUMA.1121.00040,1,847273,850745,-,3472
402,BUMA.1121.00044,1,375427,378900,-,3473
402,BUMA.1121.00088,1,591827,595299,+,3472
402,BUMA.1121.00069,1,3633497,3636969,+,3472
402,BUMA.1121.00064,1,3749474,3752946,+,3472
402,BUMA.1121.00105,1,1470890,1474362,-,3472
402,BUMA.1121.00015,1,3211839,3215311,+,3472
402,BUMA.1121.00059,1,2996697,3000169,+,3472
402,BUMA.1121.00026,1,1618018,1621490,-,3472
402,BUMA.1121.00022,1,905273,908746,-,3473
402,BUMA.1121.00052,1,410163,413635,-,3472
402,BUMA.1121.00052,1,3487606,3491078,+,3472
402,BUMA.1121.00101,1,2717125,2720609,-,3484
402,BUMA.1121.00001,1,305310,308782,-,3472
402,BUMA.1121.00038,1,2680426,2683898,+,3472
402,BUMA.1121.00068,1,2569626,2573118,+,3492
402,BUMA.1121.00099,1,2687274,2690773,-,3499
402,BUMA.1121.00091,1,744520,747992,-,3472
402,BUMA.1121.00098,1,2445261,2448733,+,3472
402,BUMA.1121.00013,1,961456,964928,-,3472
402,BUMA.1121.00049,1,2072586,2076067,-,3481
402,BUMA.1121.00072,1,3635078,3638550,+,3472
402,BUMA.1121.00076,1,1583385,1586857,-,3472
402,BUMA.1121.00083,1,1937489,1940961,-,3472
402,BUMA.1121.00078,1,2263394,2266875,-,3481
402,BUMA.1121.00095,1,1907361,1910859,-,3498
402,BUMA.1121.00077,1,2424943,2428415,+,3472
402,BUMA.1121.00063,1,3646935,3650407,+,3472
402,BUMA.1121.00061,1,3650375,3653847,+,3472
402,BUMA.1121.00050,1,2013677,2017149,-,3472
402,BUMA.1121.00081,1,2680625,2684097,+,3472
402,BUMA.1121.00074,1,340430,343902,-,3472
402,BUMA.1121.00062,1,824533,828005,-,3472
402,BUMA.1121.00060,1,2574222,2577657,-,3435
402,BUMA.1121.00070,1,3621221,3624693,+,3472
402,BUMA.1121.00075,1,3225393,3228865,+,3472
402,BUMA.1121.00041,1,987162,990634,+,3472
402,BUMA.1121.00073,1,3648654,3652126,+,3472
402,BUMA.1121.00017,1,1044953,1048426,-,3473
402,BUMA.1121.00066,1,3638028,3641500,+,3472
402,BUMA.1121.00107,1,3714178,3717650,+,3472
402,BUMA.1121.00085,1,6484,9956,-,3472
402,BUMA.1121.00085,1,3084551,3088023,+,3472
402,BUMA.1121.00030,1,1044985,1048458,-,3473
402,BUMA.1121.00112,1,3337718,3341190,-,3472
402,BUMA.1121.00002,1,1466157,1469630,+,3473
402,BUMA.1121.00082,1,3838410,3841882,+,3472
402,BUMA.1121.00014,1,3123608,3127080,-,3472
402,BUMA.1121.00011,1,1864308,1867780,-,3472
402,BUMA.1121.00019,1,1109933,1113406,-,3473
402,BUMA.1121.00057,1,838768,842240,+,3472
402,BUMA.1121.00018,1,212157,215629,+,3472
402,BUMA.1121.00039,1,3884364,3887836,+,3472
402,BUMA.1121.00016,1,1850375,1853847,+,3472
402,BUMA.1121.00004,1,1111149,1114622,-,3473
402,BUMA.1121.00005,1,3822081,3825553,-,3472
402,BUMA.1121.00100,1,1554783,1558255,-,3472
402,BUMA.1121.00006,1,2680510,2683982,+,3472
403,BUMA.1121.00027,1,1926381,1930830,+,4449
403,BUMA.1121.00025,1,3039097,3043548,-,4451
403,BUMA.1121.00021,1,386678,391129,+,4451
403,BUMA.1121.00023,1,2107892,2112341,+,4449
403,BUMA.1121.00024,1,1104728,1109178,-,4450
403,BUMA.1121.00033,1,2005908,2010359,+,4451
403,BUMA.1121.00034,1,1142172,1146622,-,4450
403,BUMA.1121.00036,1,184060,188510,-,4450
403,BUMA.1121.00032,1,2635131,2639581,-,4450
403,BUMA.1121.00009,1,1822862,1827312,-,4450
403,BUMA.1121.00008,1,1108443,1112893,-,4450
403,BUMA.1121.00003,1,2272791,2277242,+,4451
403,BUMA.1121.00109,1,2153273,2157724,-,4451
403,BUMA.1121.00053,1,3498861,3503310,+,4449
403,BUMA.1121.00110,1,1049767,1054218,-,4451
403,BUMA.1121.00104,1,1497433,1501884,-,4451
403,BUMA.1121.00086,1,3472516,3476966,-,4450
403,BUMA.1121.00092,1,3843655,3848106,+,4451
403,BUMA.1121.00096,1,3494285,3498736,-,4451
403,BUMA.1121.00054,1,1454052,1458502,-,4450
403,BUMA.1121.00097,1,194412,198861,-,4449
403,BUMA.1121.00093,1,778369,782820,-,4451
403,BUMA.1121.00106,1,3515363,3519814,+,4451
403,BUMA.1121.00010,1,1444058,1448508,+,4450
403,BUMA.1121.00035,1,789038,793489,+,4451
403,BUMA.1121.00108,1,737531,741982,+,4451
403,BUMA.1121.00028,1,1104748,1109198,-,4450
403,BUMA.1121.00094,1,3769624,3774075,+,4451
403,BUMA.1121.00102,1,1542290,1546741,-,4451
403,BUMA.1121.00111,1,3928274,3932725,+,4451
403,BUMA.1121.00089,1,3741431,3745880,+,4449
403,BUMA.1121.00084,1,12307,16757,+,4450
403,BUMA.1121.00029,1,1176622,1181073,-,4451
403,BUMA.1121.00012,1,2488258,2492709,+,4451
403,BUMA.1121.00087,1,3335282,3339732,+,4450
403,BUMA.1121.00043,1,3869160,3873611,+,4451
403,BUMA.1121.00046,1,738859,743309,+,4450
403,BUMA.1121.00037,1,2401741,2406192,+,4451
403,BUMA.1121.00080,1,3767323,3771772,+,4449
403,BUMA.1121.00079,1,3854337,3858788,+,4451
403,BUMA.1121.00045,1,323794,328245,-,4451
403,BUMA.1121.00071,1,3657109,3661560,+,4451
403,BUMA.1121.00056,1,181052,185501,-,4449
403,BUMA.1121.00065,1,3798390,3802841,+,4451
403,BUMA.1121.00058,1,759338,763787,-,4449
403,BUMA.1121.00007,1,293028,297479,-,4451
403,BUMA.1121.00067,1,671523,675974,-,4451
403,BUMA.1121.00090,1,1815136,1819587,+,4451
403,BUMA.1121.00051,1,3739678,3744127,+,4449
403,BUMA.1121.00020,1,1169685,1174135,-,4450
403,BUMA.1121.00103,1,594109,598560,-,4451
403,BUMA.1121.00048,1,2477289,2481739,+,4450
403,BUMA.1121.00047,1,3223612,3228061,-,4449
403,BUMA.1121.00042,1,3376512,3380962,+,4450
403,BUMA.1121.00055,1,3419317,3423746,+,4429
403,BUMA.1121.00031,1,1127528,1131979,+,4451
403,BUMA.1121.00040,1,842132,846582,-,4450
403,BUMA.1121.00044,1,370286,374736,-,4450
403,BUMA.1121.00088,1,595990,600441,+,4451
403,BUMA.1121.00069,1,3637660,3642111,+,4451
403,BUMA.1121.00064,1,3753637,3758088,+,4451
403,BUMA.1121.00105,1,1465769,1470199,-,4430
403,BUMA.1121.00015,1,3216002,3220452,+,4450
403,BUMA.1121.00059,1,3000860,3005311,+,4451
403,BUMA.1121.00026,1,1612877,1617327,-,4450
403,BUMA.1121.00022,1,900132,904582,-,4450
403,BUMA.1121.00052,1,405022,409472,-,4450
403,BUMA.1121.00052,1,3491769,3496219,+,4450
403,BUMA.1121.00101,1,2711984,2716434,-,4450
403,BUMA.1121.00001,1,300168,304619,-,4451
403,BUMA.1121.00038,1,2684589,2689039,+,4450
403,BUMA.1121.00068,1,2573809,2578260,+,4451
403,BUMA.1121.00099,1,2682131,2686569,-,4438
403,BUMA.1121.00091,1,739380,743829,-,4449
403,BUMA.1121.00098,1,2449424,2453874,+,4450
403,BUMA.1121.00013,1,956315,960765,-,4450
403,BUMA.1121.00049,1,2067466,2071895,-,4429
403,BUMA.1121.00072,1,3639241,3643692,+,4451
403,BUMA.1121.00076,1,1578264,1582694,-,4430
403,BUMA.1121.00083,1,1932347,1936798,-,4451
403,BUMA.1121.00078,1,2258253,2262703,-,4450
403,BUMA.1121.00095,1,1902219,1906670,-,4451
403,BUMA.1121.00077,1,2429106,2433557,+,4451
403,BUMA.1121.00063,1,3651098,3655549,+,4451
403,BUMA.1121.00061,1,3654538,3658989,+,4451
403,BUMA.1121.00050,1,2008536,2012986,-,4450
403,BUMA.1121.00081,1,2684788,2689238,+,4450
403,BUMA.1121.00074,1,335288,339739,-,4451
403,BUMA.1121.00062,1,819391,823842,-,4451
403,BUMA.1121.00060,1,2569043,2573494,-,4451
403,BUMA.1121.00070,1,3625384,3629835,+,4451
403,BUMA.1121.00075,1,3229556,3233986,+,4430
403,BUMA.1121.00041,1,991325,995754,+,4429
403,BUMA.1121.00073,1,3652817,3657268,+,4451
403,BUMA.1121.00017,1,1039812,1044262,-,4450
403,BUMA.1121.00066,1,3642191,3646642,+,4451
403,BUMA.1121.00107,1,3718341,3722793,+,4452
403,BUMA.1121.00085,1,1343,5793,-,4450
403,BUMA.1121.00085,1,3088714,3093164,+,4450
403,BUMA.1121.00030,1,1039844,1044294,-,4450
403,BUMA.1121.00112,1,3332576,3337027,-,4451
403,BUMA.1121.00002,1,1470321,1474771,+,4450
403,BUMA.1121.00082,1,3842573,3847024,+,4451
403,BUMA.1121.00014,1,3118465,3122917,-,4452
403,BUMA.1121.00011,1,1859166,1863617,-,4451
403,BUMA.1121.00019,1,1104792,1109242,-,4450
403,BUMA.1121.00057,1,842931,847382,+,4451
403,BUMA.1121.00018,1,216320,220771,+,4451
403,BUMA.1121.00039,1,3888527,3892978,+,4451
403,BUMA.1121.00016,1,1854538,1858989,+,4451
403,BUMA.1121.00004,1,1106008,1110458,-,4450
403,BUMA.1121.00005,1,3816939,3821390,-,4451
403,BUMA.1121.00100,1,1548329,1554092,-,5763
403,BUMA.1121.00006,1,2684673,2689123,+,4450
404,BUMA.1121.00027,1,1932230,1946081,+,13851
404,BUMA.1121.00025,1,3023848,3037693,-,13845
404,BUMA.1121.00021,1,392532,406392,+,13860
404,BUMA.1121.00023,1,2113746,2127565,+,13819
404,BUMA.1121.00024,1,1087871,1101728,-,13857
404,BUMA.1121.00033,1,2011762,2025609,+,13847
404,BUMA.1121.00034,1,1125308,1139172,-,13864
404,BUMA.1121.00036,1,167153,181059,-,13906
404,BUMA.1121.00032,1,2618295,2632131,-,13836
404,BUMA.1121.00009,1,1807575,1821458,-,13883
404,BUMA.1121.00008,1,1091600,1105443,-,13843
404,BUMA.1121.00003,1,2278645,2292546,+,13901
404,BUMA.1121.00109,1,2137993,2151869,-,13876
404,BUMA.1121.00053,1,3504713,3518533,+,13820
404,BUMA.1121.00110,1,1034532,1048363,-,13831
404,BUMA.1121.00104,1,1482151,1496029,-,13878
404,BUMA.1121.00086,1,3455681,3469510,-,13829
404,BUMA.1121.00092,1,3849509,3863316,+,13807
404,BUMA.1121.00096,1,3479018,3492881,-,13863
404,BUMA.1121.00054,1,1438819,1452648,-,13829
404,BUMA.1121.00097,1,179066,193008,-,13942
404,BUMA.1121.00093,1,763158,776965,-,13807
404,BUMA.1121.00106,1,3521217,3535086,+,13869
404,BUMA.1121.00010,1,1413419,1427246,-,13827
404,BUMA.1121.00035,1,794892,808760,+,13868
404,BUMA.1121.00108,1,743385,757215,+,13830
404,BUMA.1121.00028,1,1087905,1101748,-,13843
404,BUMA.1121.00094,1,3775478,3789372,+,13894
404,BUMA.1121.00102,1,1527020,1540886,-,13866
404,BUMA.1121.00111,1,3935483,3949302,+,13819
404,BUMA.1121.00089,1,3747280,3761152,+,13872
404,BUMA.1121.00084,1,18160,32075,+,13915
404,BUMA.1121.00029,1,1161365,1175218,-,13853
404,BUMA.1121.00012,1,2494112,2507963,+,13851
404,BUMA.1121.00087,1,3342737,3356566,+,13829
404,BUMA.1121.00043,1,3875014,3888805,+,13791
404,BUMA.1121.00046,1,744712,758562,+,13850
404,BUMA.1121.00037,1,2407595,2421393,+,13798
404,BUMA.1121.00080,1,3773172,3787093,+,13921
404,BUMA.1121.00079,1,3860191,3874046,+,13855
404,BUMA.1121.00045,1,308467,322390,-,13923
404,BUMA.1121.00071,1,3662963,3676823,+,13860
404,BUMA.1121.00056,1,165780,179651,-,13871
404,BUMA.1121.00065,1,3804244,3818108,+,13864
404,BUMA.1121.00058,1,744048,757937,-,13889
404,BUMA.1121.00007,1,277732,291624,-,13892
404,BUMA.1121.00067,1,656248,670119,-,13871
404,BUMA.1121.00090,1,1820990,1834816,+,13826
404,BUMA.1121.00051,1,3745527,3759385,+,13858
404,BUMA.1121.00020,1,1152842,1166685,-,13843
404,BUMA.1121.00103,1,577546,592705,-,15159
404,BUMA.1121.00048,1,2483142,2496971,+,13829
404,BUMA.1121.00047,1,3206983,3220854,-,13871
404,BUMA.1121.00042,1,3382365,3396208,+,13843
404,BUMA.1121.00055,1,3425149,3439057,+,13908
404,BUMA.1121.00031,1,1133382,1147205,+,13823
404,BUMA.1121.00040,1,826899,840728,-,13829
404,BUMA.1121.00044,1,353422,367286,-,13864
404,BUMA.1121.00088,1,601844,615706,+,13862
404,BUMA.1121.00069,1,3643514,3657378,+,13864
404,BUMA.1121.00064,1,3759491,3773363,+,13872
404,BUMA.1121.00105,1,1450515,1464365,-,13850
404,BUMA.1121.00015,1,3221855,3235740,+,13885
404,BUMA.1121.00059,1,3006714,3020575,+,13861
404,BUMA.1121.00026,1,1597588,1611473,-,13885
404,BUMA.1121.00022,1,883286,897129,-,13843
404,BUMA.1121.00052,1,773,14632,+,13859
404,BUMA.1121.00052,1,389751,403618,-,13867
404,BUMA.1121.00101,1,2696661,2710580,-,13919
404,BUMA.1121.00001,1,284946,298764,-,13818
404,BUMA.1121.00038,1,2690442,2704271,+,13829
404,BUMA.1121.00068,1,2579660,2593487,+,13827
404,BUMA.1121.00099,1,2666891,2680727,-,13836
404,BUMA.1121.00091,1,724109,737976,-,13867
404,BUMA.1121.00098,1,2455277,2469174,+,13897
404,BUMA.1121.00013,1,941110,954911,-,13801
404,BUMA.1121.00049,1,2052180,2066062,-,13882
404,BUMA.1121.00072,1,3645095,3658957,+,13862
404,BUMA.1121.00076,1,1562988,1576860,-,13872
404,BUMA.1121.00083,1,1917080,1930943,-,13863
404,BUMA.1121.00078,1,2243010,2256849,-,13839
404,BUMA.1121.00095,1,1886913,1900815,-,13902
404,BUMA.1121.00077,1,2434958,2448791,+,13833
404,BUMA.1121.00063,1,3656952,3670809,+,13857
404,BUMA.1121.00061,1,3660392,3674251,+,13859
404,BUMA.1121.00050,1,1993282,2007132,-,13850
404,BUMA.1121.00081,1,2690641,2704470,+,13829
404,BUMA.1121.00074,1,320027,333884,-,13857
404,BUMA.1121.00062,1,804143,817987,-,13844
404,BUMA.1121.00060,1,2553723,2567639,-,13916
404,BUMA.1121.00070,1,3631238,3645095,+,13857
404,BUMA.1121.00075,1,3235389,3249253,+,13864
404,BUMA.1121.00041,1,997157,1011017,+,13860
404,BUMA.1121.00073,1,3658671,3672529,+,13858
404,BUMA.1121.00017,1,1022948,1036812,-,13864
404,BUMA.1121.00066,1,3648045,3661908,+,13863
404,BUMA.1121.00107,1,3724196,3738081,+,13885
404,BUMA.1121.00085,1,3094567,3108438,+,13871
404,BUMA.1121.00085,1,3483547,3497434,-,13887
404,BUMA.1121.00030,1,1022980,1036844,-,13864
404,BUMA.1121.00112,1,3317306,3331172,-,13866
404,BUMA.1121.00002,1,1440250,1454100,-,13850
404,BUMA.1121.00082,1,3848427,3862291,+,13864
404,BUMA.1121.00014,1,3103239,3117061,-,13822
404,BUMA.1121.00011,1,1843908,1857762,-,13854
404,BUMA.1121.00019,1,1087949,1101792,-,13843
404,BUMA.1121.00057,1,848785,862664,+,13879
404,BUMA.1121.00018,1,222174,236034,+,13860
404,BUMA.1121.00039,1,3895735,3909562,+,13827
404,BUMA.1121.00016,1,1860392,1874232,+,13840
404,BUMA.1121.00004,1,1089144,1103008,-,13864
404,BUMA.1121.00005,1,3801694,3815535,-,13841
404,BUMA.1121.00100,1,1533039,1546925,-,13886
404,BUMA.1121.00006,1,2690526,2704355,+,13829
405,BUMA.1121.00027,1,1946082,1954660,+,8578
405,BUMA.1121.00025,1,3015274,3023846,-,8572
405,BUMA.1121.00021,1,406394,414951,+,8557
405,BUMA.1121.00023,1,2128859,2137454,+,8595
405,BUMA.1121.00033,1,2026903,2035509,+,8606
405,BUMA.1121.00009,1,1798996,1807573,-,8577
405,BUMA.1121.00003,1,2292547,2301112,+,8565
405,BUMA.1121.00109,1,2128112,2136699,-,8587
405,BUMA.1121.00053,1,3519827,3528438,+,8611
405,BUMA.1121.00110,1,1025958,1034530,-,8572
405,BUMA.1121.00104,1,1472275,1480858,-,8583
405,BUMA.1121.00092,1,3864610,3873203,+,8593
405,BUMA.1121.00096,1,3470443,3479016,-,8573
405,BUMA.1121.00097,1,170488,179064,-,8576
405,BUMA.1121.00093,1,753272,761865,-,8593
405,BUMA.1121.00106,1,3535087,3543661,+,8574
405,BUMA.1121.00035,1,810054,818638,+,8584
405,BUMA.1121.00108,1,758518,767104,+,8586
405,BUMA.1121.00094,1,3789373,3797947,+,8574
405,BUMA.1121.00102,1,1518434,1527018,-,8584
405,BUMA.1121.00111,1,3950596,3959180,+,8584
405,BUMA.1121.00089,1,3761153,3769753,+,8600
405,BUMA.1121.00084,1,32076,40654,+,8578
405,BUMA.1121.00029,1,1151477,1160072,-,8595
405,BUMA.1121.00012,1,2509257,2517849,+,8592
405,BUMA.1121.00043,1,3890099,3898691,+,8592
405,BUMA.1121.00037,1,2422687,2431282,+,8595
405,BUMA.1121.00080,1,3787094,3795694,+,8600
405,BUMA.1121.00079,1,3874047,3882620,+,8573
405,BUMA.1121.00045,1,299892,308465,-,8573
405,BUMA.1121.00071,1,3676824,3685424,+,8600
405,BUMA.1121.00056,1,157179,165778,-,8599
405,BUMA.1121.00065,1,3819402,3827995,+,8593
405,BUMA.1121.00058,1,734162,742755,-,8593
405,BUMA.1121.00007,1,269159,277730,-,8571
405,BUMA.1121.00067,1,646369,654954,-,8585
405,BUMA.1121.00090,1,1836111,1844706,+,8595
405,BUMA.1121.00051,1,3759386,3767975,+,8589
405,BUMA.1121.00103,1,568979,577544,-,8565
405,BUMA.1121.00047,1,3198370,3206981,-,8611
405,BUMA.1121.00055,1,3439058,3447636,+,8578
405,BUMA.1121.00031,1,1147207,1155784,+,8577
405,BUMA.1121.00088,1,615707,624283,+,8576
405,BUMA.1121.00069,1,3657379,3665979,+,8600
405,BUMA.1121.00064,1,3774656,3783242,+,8586
405,BUMA.1121.00105,1,1441936,1450513,-,8577
405,BUMA.1121.00059,1,3021869,3030462,+,8593
405,BUMA.1121.00101,1,2688093,2696659,-,8566
405,BUMA.1121.00001,1,275058,283653,-,8595
405,BUMA.1121.00068,1,2593488,2602064,+,8576
405,BUMA.1121.00099,1,2658299,2666889,-,8590
405,BUMA.1121.00091,1,714222,722818,-,8596
405,BUMA.1121.00098,1,2470467,2479044,+,8577
405,BUMA.1121.00049,1,2043603,2052178,-,8575
405,BUMA.1121.00072,1,3658958,3667558,+,8600
405,BUMA.1121.00076,1,1554411,1562986,-,8575
405,BUMA.1121.00083,1,1908479,1917078,-,8599
405,BUMA.1121.00078,1,2233123,2241715,-,8592
405,BUMA.1121.00095,1,1878351,1886911,-,8560
405,BUMA.1121.00077,1,2448792,2457365,+,8573
405,BUMA.1121.00063,1,3670810,3679410,+,8600
405,BUMA.1121.00061,1,3674252,3682852,+,8600
405,BUMA.1121.00074,1,310148,318733,-,8585
405,BUMA.1121.00062,1,795568,804141,-,8573
405,BUMA.1121.00060,1,2545148,2553721,-,8573
405,BUMA.1121.00070,1,3645096,3653679,+,8583
405,BUMA.1121.00075,1,3249254,3257830,+,8576
405,BUMA.1121.00041,1,1012313,1020906,+,8593
405,BUMA.1121.00073,1,3672530,3681115,+,8585
405,BUMA.1121.00066,1,3661909,3670509,+,8600
405,BUMA.1121.00107,1,3738082,3746658,+,8576
405,BUMA.1121.00112,1,3308734,3317304,-,8570
405,BUMA.1121.00082,1,3862292,3870892,+,8600
405,BUMA.1121.00014,1,3094660,3103237,-,8577
405,BUMA.1121.00011,1,1835329,1843906,-,8577
405,BUMA.1121.00057,1,862665,871243,+,8578
405,BUMA.1121.00018,1,236035,244608,+,8573
405,BUMA.1121.00039,1,3910856,3919466,+,8610
405,BUMA.1121.00016,1,1875526,1884146,+,8620
405,BUMA.1121.00005,1,3791807,3800401,-,8594
405,BUMA.1121.00100,1,1524451,1533037,-,8586
406,BUMA.1121.00027,1,1966467,1971362,+,4895
406,BUMA.1121.00083,1,1891919,1896793,-,4874
406,BUMA.1121.00082,1,3882577,3887452,+,4875
407,BUMA.1121.00027,1,1975497,1980615,+,5118
407,BUMA.1121.00025,1,2949993,2955112,-,5119
407,BUMA.1121.00021,1,420279,425397,+,5118
407,BUMA.1121.00023,1,2142782,2147900,+,5118
407,BUMA.1121.00024,1,362500,367618,+,5118
407,BUMA.1121.00033,1,2040835,2045953,+,5118
407,BUMA.1121.00034,1,362508,367626,+,5118
407,BUMA.1121.00036,1,3314534,3319652,+,5118
407,BUMA.1121.00032,1,1957914,1963032,+,5118
407,BUMA.1121.00009,1,1788549,1793668,-,5119
407,BUMA.1121.00008,1,362522,367640,+,5118
407,BUMA.1121.00003,1,2306451,2311569,+,5118
407,BUMA.1121.00109,1,2117653,2122773,-,5120
407,BUMA.1121.00053,1,3549263,3554381,+,5118
407,BUMA.1121.00110,1,1015509,1020629,-,5120
407,BUMA.1121.00104,1,1461825,1466944,-,5119
407,BUMA.1121.00086,1,2923220,2928338,-,5118
407,BUMA.1121.00092,1,3878526,3883644,+,5118
407,BUMA.1121.00096,1,3459992,3465112,-,5120
407,BUMA.1121.00054,1,1141068,1146186,+,5118
407,BUMA.1121.00097,1,160038,165157,-,5119
407,BUMA.1121.00093,1,742830,747949,-,5119
407,BUMA.1121.00106,1,3548984,3554103,+,5119
407,BUMA.1121.00010,1,1001459,1006577,-,5118
407,BUMA.1121.00035,1,823960,829078,+,5118
407,BUMA.1121.00108,1,772435,777553,+,5118
407,BUMA.1121.00028,1,362509,367627,+,5118
407,BUMA.1121.00094,1,3823275,3828393,+,5118
407,BUMA.1121.00102,1,1475567,1480686,-,5119
407,BUMA.1121.00111,1,3981668,3986786,+,5118
407,BUMA.1121.00089,1,3809967,3815085,+,5118
407,BUMA.1121.00084,1,45985,51103,+,5118
407,BUMA.1121.00029,1,1141118,1146237,-,5119
407,BUMA.1121.00012,1,2523175,2528293,+,5118
407,BUMA.1121.00087,1,407562,412680,+,5118
407,BUMA.1121.00043,1,3904017,3909135,+,5118
407,BUMA.1121.00046,1,1154947,1160065,+,5118
407,BUMA.1121.00037,1,2443553,2448671,+,5118
407,BUMA.1121.00080,1,3834696,3839815,+,5119
407,BUMA.1121.00079,1,3887951,3893069,+,5118
407,BUMA.1121.00045,1,289437,294557,-,5120
407,BUMA.1121.00071,1,3691054,3696172,+,5118
407,BUMA.1121.00056,1,114417,119536,-,5119
407,BUMA.1121.00065,1,3833326,3838444,+,5118
407,BUMA.1121.00058,1,722119,727238,-,5119
407,BUMA.1121.00007,1,258712,263831,-,5119
407,BUMA.1121.00067,1,635918,641038,-,5120
407,BUMA.1121.00090,1,1885922,1891040,+,5118
407,BUMA.1121.00051,1,3806977,3812095,+,5118
407,BUMA.1121.00020,1,362515,367633,+,5118
407,BUMA.1121.00103,1,538440,543559,-,5119
407,BUMA.1121.00048,1,2789610,2794728,-,5118
407,BUMA.1121.00047,1,3154249,3159368,-,5119
407,BUMA.1121.00042,1,935018,940136,-,5118
407,BUMA.1121.00055,1,3452967,3458085,+,5118
407,BUMA.1121.00031,1,1161112,1166230,+,5118
407,BUMA.1121.00040,1,861232,866350,+,5118
407,BUMA.1121.00044,1,3164509,3169627,+,5118
407,BUMA.1121.00088,1,629614,634732,+,5118
407,BUMA.1121.00069,1,3679324,3684442,+,5118
407,BUMA.1121.00064,1,3788573,3793691,+,5118
407,BUMA.1121.00105,1,1431486,1436605,-,5119
407,BUMA.1121.00015,1,3480748,3485866,-,5118
407,BUMA.1121.00059,1,3035785,3040903,+,5118
407,BUMA.1121.00026,1,1246236,1251354,-,5118
407,BUMA.1121.00022,1,383911,389029,-,5118
407,BUMA.1121.00052,1,270944,276062,+,5118
407,BUMA.1121.00101,1,2664675,2669798,-,5123
407,BUMA.1121.00001,1,264617,269736,-,5119
407,BUMA.1121.00038,1,2996911,3002029,-,5118
407,BUMA.1121.00068,1,2620359,2625478,+,5119
407,BUMA.1121.00099,1,2647849,2652968,-,5119
407,BUMA.1121.00091,1,703772,708891,-,5119
407,BUMA.1121.00098,1,2484375,2489493,+,5118
407,BUMA.1121.00013,1,679719,684837,-,5118
407,BUMA.1121.00049,1,2031542,2036677,-,5135
407,BUMA.1121.00072,1,3676305,3681423,+,5118
407,BUMA.1121.00076,1,1543961,1549080,-,5119
407,BUMA.1121.00083,1,1882665,1887784,-,5119
407,BUMA.1121.00078,1,2222673,2227792,-,5119
407,BUMA.1121.00095,1,1861500,1866619,-,5119
407,BUMA.1121.00077,1,2462694,2467809,+,5115
407,BUMA.1121.00063,1,3684968,3690086,+,5118
407,BUMA.1121.00061,1,3688228,3693346,+,5118
407,BUMA.1121.00050,1,1591663,1596781,-,5118
407,BUMA.1121.00081,1,2997110,3002228,-,5118
407,BUMA.1121.00074,1,299698,304817,-,5119
407,BUMA.1121.00062,1,765152,770271,-,5119
407,BUMA.1121.00060,1,2534693,2539813,-,5120
407,BUMA.1121.00070,1,3664080,3669198,+,5118
407,BUMA.1121.00075,1,3263161,3268279,+,5118
407,BUMA.1121.00041,1,1041731,1046834,+,5103
407,BUMA.1121.00073,1,3691197,3696315,+,5118
407,BUMA.1121.00017,1,362507,367625,+,5118
407,BUMA.1121.00066,1,3676641,3681759,+,5118
407,BUMA.1121.00107,1,3751989,3757107,+,5118
407,BUMA.1121.00085,1,3364750,3369868,+,5118
407,BUMA.1121.00030,1,362507,367625,+,5118
407,BUMA.1121.00112,1,3298284,3303403,-,5119
407,BUMA.1121.00002,1,1028132,1033250,-,5118
407,BUMA.1121.00082,1,3891587,3896705,+,5118
407,BUMA.1121.00014,1,3084213,3089332,-,5119
407,BUMA.1121.00011,1,1824881,1830000,-,5119
407,BUMA.1121.00019,1,362521,367639,+,5118
407,BUMA.1121.00057,1,876566,881684,+,5118
407,BUMA.1121.00018,1,304769,309887,+,5118
407,BUMA.1121.00039,1,3939943,3945061,+,5118
407,BUMA.1121.00016,1,1889472,1894590,+,5118
407,BUMA.1121.00004,1,362501,367619,+,5118
407,BUMA.1121.00005,1,3781357,3786476,-,5119
407,BUMA.1121.00100,1,1514002,1519122,-,5120
407,BUMA.1121.00006,1,2996995,3002113,-,5118
408,BUMA.1121.00027,1,1985522,2016359,+,30837
408,BUMA.1121.00025,1,2914272,2945085,-,30813
408,BUMA.1121.00021,1,430303,461113,+,30810
408,BUMA.1121.00023,1,2152806,2183625,+,30819
408,BUMA.1121.00024,1,406900,437687,-,30787
408,BUMA.1121.00033,1,2050859,2081672,+,30813
408,BUMA.1121.00034,1,406908,437695,-,30787
408,BUMA.1121.00036,1,3357348,3388120,-,30772
408,BUMA.1121.00032,1,2002314,2033101,-,30787
408,BUMA.1121.00009,1,1752775,1783642,-,30867
408,BUMA.1121.00008,1,406922,437709,-,30787
408,BUMA.1121.00003,1,2316476,2347291,+,30815
408,BUMA.1121.00109,1,2081961,2112745,-,30784
408,BUMA.1121.00053,1,3559289,3590156,+,30867
408,BUMA.1121.00110,1,979788,1010602,-,30814
408,BUMA.1121.00104,1,1426077,1456916,-,30839
408,BUMA.1121.00086,1,3071575,3102345,-,30770
408,BUMA.1121.00092,1,3888550,3919390,+,30840
408,BUMA.1121.00096,1,3424244,3455086,-,30842
408,BUMA.1121.00054,1,1183888,1214660,-,30772
408,BUMA.1121.00097,1,124294,155131,-,30837
408,BUMA.1121.00093,1,707084,737924,-,30840
408,BUMA.1121.00106,1,3559011,3589851,+,30840
408,BUMA.1121.00010,1,932965,963757,+,30792
408,BUMA.1121.00035,1,833984,864803,+,30819
408,BUMA.1121.00108,1,782459,813235,+,30776
408,BUMA.1121.00028,1,406909,437696,-,30787
408,BUMA.1121.00094,1,3833299,3864138,+,30839
408,BUMA.1121.00102,1,1439898,1470660,-,30762
408,BUMA.1121.00111,1,3991694,4022512,+,30818
408,BUMA.1121.00089,1,3819991,3850819,+,30828
408,BUMA.1121.00084,1,56011,86839,+,30828
408,BUMA.1121.00029,1,1105394,1136212,-,30818
408,BUMA.1121.00012,1,2533198,2564011,+,30813
408,BUMA.1121.00087,1,233615,264385,+,30770
408,BUMA.1121.00043,1,3914041,3944845,+,30804
408,BUMA.1121.00046,1,982487,1013259,+,30772
408,BUMA.1121.00037,1,2453577,2484397,+,30820
408,BUMA.1121.00080,1,3844721,3875548,+,30827
408,BUMA.1121.00079,1,3897976,3928796,+,30820
408,BUMA.1121.00045,1,253690,284529,-,30839
408,BUMA.1121.00071,1,3701079,3731818,+,30739
408,BUMA.1121.00056,1,78683,109511,-,30828
408,BUMA.1121.00065,1,3843351,3874186,+,30835
408,BUMA.1121.00058,1,686364,717213,-,30849
408,BUMA.1121.00007,1,222972,253806,-,30834
408,BUMA.1121.00067,1,600184,631012,-,30828
408,BUMA.1121.00090,1,1895946,1926756,+,30810
408,BUMA.1121.00051,1,3817001,3847820,+,30819
408,BUMA.1121.00020,1,406915,437702,-,30787
408,BUMA.1121.00103,1,502714,533533,-,30819
408,BUMA.1121.00048,1,2721138,2751910,+,30772
408,BUMA.1121.00047,1,3118515,3149343,-,30828
408,BUMA.1121.00042,1,898127,928884,-,30757
408,BUMA.1121.00055,1,3462992,3493817,+,30825
408,BUMA.1121.00031,1,1171136,1201940,+,30804
408,BUMA.1121.00040,1,904052,934824,-,30772
408,BUMA.1121.00044,1,3208909,3239696,-,30787
408,BUMA.1121.00088,1,639638,670480,+,30842
408,BUMA.1121.00069,1,3689349,3720089,+,30740
408,BUMA.1121.00064,1,3798597,3829425,+,30828
408,BUMA.1121.00105,1,1395738,1426580,-,30842
408,BUMA.1121.00015,1,3412274,3443046,+,30772
408,BUMA.1121.00059,1,3045811,3076512,+,30701
408,BUMA.1121.00026,1,1209339,1240096,-,30757
408,BUMA.1121.00022,1,315442,346214,+,30772
408,BUMA.1121.00052,1,282211,312983,+,30772
408,BUMA.1121.00101,1,2628932,2659768,-,30836
408,BUMA.1121.00001,1,228886,259711,-,30825
408,BUMA.1121.00038,1,2928437,2959209,+,30772
408,BUMA.1121.00068,1,2630386,2661212,+,30826
408,BUMA.1121.00099,1,2612133,2642942,-,30809
408,BUMA.1121.00091,1,668099,698866,-,30767
408,BUMA.1121.00098,1,2494401,2525213,+,30812
408,BUMA.1121.00013,1,642798,673570,-,30772
408,BUMA.1121.00049,1,1994611,2025439,-,30828
408,BUMA.1121.00072,1,3686330,3717105,+,30775
408,BUMA.1121.00076,1,1508258,1539053,-,30795
408,BUMA.1121.00083,1,1846983,1877758,-,30775
408,BUMA.1121.00078,1,2186928,2217767,-,30839
408,BUMA.1121.00095,1,1825769,1856593,-,30824
408,BUMA.1121.00077,1,2472716,2503532,+,30816
408,BUMA.1121.00063,1,3694993,3725733,+,30740
408,BUMA.1121.00061,1,3698253,3728993,+,30740
408,BUMA.1121.00050,1,1738439,1769211,-,30772
408,BUMA.1121.00081,1,2928636,2959408,+,30772
408,BUMA.1121.00074,1,263964,294792,-,30828
408,BUMA.1121.00062,1,729416,760246,-,30830
408,BUMA.1121.00060,1,2498946,2529785,-,30839
408,BUMA.1121.00070,1,3674105,3704880,+,30775
408,BUMA.1121.00075,1,3273187,3303982,+,30795
408,BUMA.1121.00041,1,1051742,1082578,+,30836
408,BUMA.1121.00073,1,3701222,3731997,+,30775
408,BUMA.1121.00017,1,406907,437694,-,30787
408,BUMA.1121.00066,1,3686666,3717441,+,30775
408,BUMA.1121.00107,1,3762013,3792858,+,30845
408,BUMA.1121.00085,1,3376017,3406779,+,30762
408,BUMA.1121.00030,1,406907,437694,-,30787
408,BUMA.1121.00112,1,3262548,3293378,-,30830
408,BUMA.1121.00002,1,959639,990430,+,30791
408,BUMA.1121.00082,1,3901612,3932387,+,30775
408,BUMA.1121.00014,1,3048497,3079307,-,30810
408,BUMA.1121.00011,1,1789296,1819973,-,30677
408,BUMA.1121.00019,1,406921,437708,-,30787
408,BUMA.1121.00057,1,886591,917432,+,30841
408,BUMA.1121.00018,1,314795,345607,+,30812
408,BUMA.1121.00039,1,3949967,3980786,+,30819
408,BUMA.1121.00016,1,1899495,1930313,+,30818
408,BUMA.1121.00004,1,406901,437688,-,30787
408,BUMA.1121.00005,1,3745639,3776457,-,30818
408,BUMA.1121.00100,1,1478249,1509096,-,30847
408,BUMA.1121.00006,1,2928521,2959293,+,30772
409,BUMA.1121.00027,1,2016361,2026500,+,10139
409,BUMA.1121.00025,1,2904130,2914271,-,10141
409,BUMA.1121.00021,1,461115,471256,+,10141
409,BUMA.1121.00023,1,2183627,2193768,+,10141
409,BUMA.1121.00024,1,395176,405317,-,10141
409,BUMA.1121.00033,1,2081674,2091814,+,10140
409,BUMA.1121.00034,1,395184,405325,-,10141
409,BUMA.1121.00036,1,3347204,3357347,-,10143
409,BUMA.1121.00032,1,1990590,2000731,-,10141
409,BUMA.1121.00009,1,1742633,1752774,-,10141
409,BUMA.1121.00008,1,395198,405339,-,10141
409,BUMA.1121.00003,1,2347293,2357434,+,10141
409,BUMA.1121.00109,1,2071818,2081960,-,10142
409,BUMA.1121.00053,1,3590158,3600299,+,10141
409,BUMA.1121.00110,1,969644,979787,-,10143
409,BUMA.1121.00104,1,1415935,1426076,-,10141
409,BUMA.1121.00086,1,3061431,3071574,-,10143
409,BUMA.1121.00092,1,3919392,3929533,+,10141
409,BUMA.1121.00096,1,3414094,3424243,-,10149
409,BUMA.1121.00054,1,1173744,1183887,-,10143
409,BUMA.1121.00097,1,114150,124293,-,10143
409,BUMA.1121.00093,1,696942,707083,-,10141
409,BUMA.1121.00106,1,3589853,3599994,+,10141
409,BUMA.1121.00010,1,963759,973902,+,10143
409,BUMA.1121.00035,1,864805,874946,+,10141
409,BUMA.1121.00108,1,813237,823379,+,10142
409,BUMA.1121.00028,1,395185,405326,-,10141
409,BUMA.1121.00094,1,3864140,3874281,+,10141
409,BUMA.1121.00102,1,1429756,1439897,-,10141
409,BUMA.1121.00111,1,4022514,4032598,+,10084
409,BUMA.1121.00089,1,3850821,3860964,+,10143
409,BUMA.1121.00084,1,86841,96982,+,10141
409,BUMA.1121.00029,1,1095252,1105393,-,10141
409,BUMA.1121.00012,1,2564013,2574154,+,10141
409,BUMA.1121.00087,1,264387,274530,+,10143
409,BUMA.1121.00043,1,3944847,3954988,+,10141
409,BUMA.1121.00046,1,1013261,1023404,+,10143
409,BUMA.1121.00037,1,2484399,2494540,+,10141
409,BUMA.1121.00080,1,3875550,3885693,+,10143
409,BUMA.1121.00079,1,3928798,3938941,+,10143
409,BUMA.1121.00045,1,243546,253689,-,10143
409,BUMA.1121.00071,1,3731820,3741961,+,10141
409,BUMA.1121.00056,1,68539,78682,-,10143
409,BUMA.1121.00065,1,3874188,3884329,+,10141
409,BUMA.1121.00058,1,676220,686363,-,10143
409,BUMA.1121.00007,1,212830,222971,-,10141
409,BUMA.1121.00067,1,590042,600183,-,10141
409,BUMA.1121.00090,1,1926758,1936899,+,10141
409,BUMA.1121.00051,1,3847822,3859425,+,11603
409,BUMA.1121.00020,1,395191,405332,-,10141
409,BUMA.1121.00103,1,492572,502713,-,10141
409,BUMA.1121.00048,1,2751912,2762055,+,10143
409,BUMA.1121.00047,1,3108371,3118514,-,10143
409,BUMA.1121.00042,1,887983,898126,-,10143
409,BUMA.1121.00055,1,3493819,3505423,+,11604
409,BUMA.1121.00031,1,1201942,1212083,+,10141
409,BUMA.1121.00040,1,893908,904051,-,10143
409,BUMA.1121.00044,1,3197185,3207326,-,10141
409,BUMA.1121.00088,1,670482,680623,+,10141
409,BUMA.1121.00069,1,3720091,3730232,+,10141
409,BUMA.1121.00064,1,3829427,3839570,+,10143
409,BUMA.1121.00105,1,1385596,1395737,-,10141
409,BUMA.1121.00015,1,3443048,3453191,+,10143
409,BUMA.1121.00059,1,3076514,3086655,+,10141
409,BUMA.1121.00026,1,1199195,1209338,-,10143
409,BUMA.1121.00022,1,346216,356359,+,10143
409,BUMA.1121.00052,1,312985,323128,+,10143
409,BUMA.1121.00101,1,2618788,2628931,-,10143
409,BUMA.1121.00001,1,218744,228885,-,10141
409,BUMA.1121.00038,1,2959211,2969354,+,10143
409,BUMA.1121.00068,1,2661214,2671355,+,10141
409,BUMA.1121.00099,1,2601992,2612132,-,10140
409,BUMA.1121.00091,1,657957,668098,-,10141
409,BUMA.1121.00098,1,2525215,2535357,+,10142
409,BUMA.1121.00013,1,632654,642797,-,10143
409,BUMA.1121.00049,1,1984467,1994610,-,10143
409,BUMA.1121.00072,1,3717107,3727248,+,10141
409,BUMA.1121.00076,1,1498116,1508257,-,10141
409,BUMA.1121.00083,1,1836841,1846982,-,10141
409,BUMA.1121.00078,1,2176784,2186927,-,10143
409,BUMA.1121.00095,1,1815620,1825768,-,10148
409,BUMA.1121.00077,1,2503534,2513672,+,10138
409,BUMA.1121.00063,1,3725735,3735876,+,10141
409,BUMA.1121.00061,1,3728995,3739136,+,10141
409,BUMA.1121.00050,1,1728295,1738438,-,10143
409,BUMA.1121.00081,1,2959410,2969553,+,10143
409,BUMA.1121.00074,1,253820,263963,-,10143
409,BUMA.1121.00062,1,717811,729415,-,11604
409,BUMA.1121.00060,1,2488802,2498945,-,10143
409,BUMA.1121.00070,1,3704882,3715023,+,10141
409,BUMA.1121.00075,1,3303984,3314123,+,10139
409,BUMA.1121.00041,1,1082580,1092721,+,10141
409,BUMA.1121.00073,1,3731999,3742140,+,10141
409,BUMA.1121.00017,1,395183,405324,-,10141
409,BUMA.1121.00066,1,3717443,3727584,+,10141
409,BUMA.1121.00107,1,3792860,3803002,+,10142
409,BUMA.1121.00085,1,3406781,3416924,+,10143
409,BUMA.1121.00030,1,395183,405324,-,10141
409,BUMA.1121.00112,1,3252406,3262547,-,10141
409,BUMA.1121.00002,1,990432,1000575,+,10143
409,BUMA.1121.00082,1,3932389,3942530,+,10141
409,BUMA.1121.00014,1,3038355,3048496,-,10141
409,BUMA.1121.00011,1,1779146,1789295,-,10149
409,BUMA.1121.00019,1,395197,405338,-,10141
409,BUMA.1121.00057,1,917434,927575,+,10141
409,BUMA.1121.00018,1,345609,355750,+,10141
409,BUMA.1121.00039,1,3980788,3990929,+,10141
409,BUMA.1121.00016,1,1930315,1940456,+,10141
409,BUMA.1121.00004,1,395177,405318,-,10141
409,BUMA.1121.00005,1,3735497,3745638,-,10141
409,BUMA.1121.00100,1,1466644,1478248,-,11604
409,BUMA.1121.00006,1,2959295,2969438,+,10143
410,BUMA.1121.00027,1,2035588,2039499,+,3911
410,BUMA.1121.00025,1,2891146,2895051,-,3905
410,BUMA.1121.00021,1,480335,484246,+,3911
410,BUMA.1121.00023,1,2202847,2206758,+,3911
410,BUMA.1121.00024,1,382182,386087,-,3905
410,BUMA.1121.00033,1,2100893,2104804,+,3911
410,BUMA.1121.00034,1,382190,386095,-,3905
410,BUMA.1121.00036,1,3334210,3338115,-,3905
410,BUMA.1121.00032,1,1977596,1981501,-,3905
410,BUMA.1121.00009,1,1729633,1733545,-,3912
410,BUMA.1121.00008,1,382204,386109,-,3905
410,BUMA.1121.00003,1,2366513,2370419,+,3906
410,BUMA.1121.00109,1,2058826,2062739,-,3913
410,BUMA.1121.00053,1,3609391,3613306,+,3915
410,BUMA.1121.00110,1,956642,960554,-,3912
410,BUMA.1121.00104,1,1402941,1406846,-,3905
410,BUMA.1121.00086,1,3048437,3052342,-,3905
410,BUMA.1121.00092,1,3938622,3942525,+,3903
410,BUMA.1121.00096,1,3403203,3407116,-,3913
410,BUMA.1121.00054,1,1160750,1164655,-,3905
410,BUMA.1121.00097,1,103267,107172,-,3905
410,BUMA.1121.00093,1,683949,687853,-,3904
410,BUMA.1121.00106,1,3609083,3612987,+,3904
410,BUMA.1121.00010,1,982991,986895,+,3904
410,BUMA.1121.00035,1,884025,887936,+,3911
410,BUMA.1121.00108,1,832470,836382,+,3912
410,BUMA.1121.00028,1,382191,386096,-,3905
410,BUMA.1121.00094,1,3883360,3887264,+,3904
410,BUMA.1121.00102,1,1416759,1420671,-,3912
410,BUMA.1121.00111,1,9136,13047,+,3911
410,BUMA.1121.00089,1,3870043,3873947,+,3904
410,BUMA.1121.00084,1,106071,109988,+,3917
410,BUMA.1121.00029,1,1082255,1086173,-,3918
410,BUMA.1121.00012,1,2583233,2587144,+,3911
410,BUMA.1121.00087,1,283619,287523,+,3904
410,BUMA.1121.00043,1,3964067,3967978,+,3911
410,BUMA.1121.00046,1,1032493,1036397,+,3904
410,BUMA.1121.00037,1,2501517,2505428,+,3911
410,BUMA.1121.00080,1,3894772,3898676,+,3904
410,BUMA.1121.00079,1,3948020,3951923,+,3903
410,BUMA.1121.00045,1,230539,234458,-,3919
410,BUMA.1121.00071,1,3744169,3748077,+,3908
410,BUMA.1121.00056,1,55555,59460,-,3905
410,BUMA.1121.00065,1,3893415,3897326,+,3911
410,BUMA.1121.00058,1,663236,667141,-,3905
410,BUMA.1121.00007,1,199831,203744,-,3913
410,BUMA.1121.00067,1,577036,580954,-,3918
410,BUMA.1121.00090,1,1945978,1949889,+,3911
410,BUMA.1121.00051,1,3868504,3872408,+,3904
410,BUMA.1121.00020,1,382197,386102,-,3905
410,BUMA.1121.00103,1,479570,483483,-,3913
410,BUMA.1121.00048,1,2771144,2775048,+,3904
410,BUMA.1121.00047,1,3095387,3099292,-,3905
410,BUMA.1121.00042,1,874989,878894,-,3905
410,BUMA.1121.00055,1,3514509,3518412,+,3903
410,BUMA.1121.00031,1,1219060,1222964,+,3904
410,BUMA.1121.00040,1,880914,884819,-,3905
410,BUMA.1121.00044,1,3184191,3188096,-,3905
410,BUMA.1121.00088,1,689709,693613,+,3904
410,BUMA.1121.00069,1,3739102,3743013,+,3911
410,BUMA.1121.00064,1,3848656,3852567,+,3911
410,BUMA.1121.00105,1,1372597,1376510,-,3913
410,BUMA.1121.00015,1,3462280,3466184,+,3904
410,BUMA.1121.00059,1,3093633,3097544,+,3911
410,BUMA.1121.00026,1,1186201,1190106,-,3905
410,BUMA.1121.00022,1,365448,369352,+,3904
410,BUMA.1121.00052,1,332217,336121,+,3904
410,BUMA.1121.00101,1,2607897,2611803,-,3906
410,BUMA.1121.00001,1,205753,209665,-,3912
410,BUMA.1121.00038,1,2978443,2982347,+,3904
410,BUMA.1121.00068,1,2680437,2684341,+,3904
410,BUMA.1121.00099,1,2591110,2595014,-,3904
410,BUMA.1121.00091,1,644959,648864,-,3905
410,BUMA.1121.00098,1,2544448,2548347,+,3899
410,BUMA.1121.00013,1,619660,623565,-,3905
410,BUMA.1121.00049,1,1971475,1975381,-,3906
410,BUMA.1121.00072,1,3736119,3740030,+,3911
410,BUMA.1121.00076,1,1485122,1489027,-,3905
410,BUMA.1121.00083,1,1823841,1827753,-,3912
410,BUMA.1121.00078,1,2163793,2167698,-,3905
410,BUMA.1121.00095,1,1802638,1806541,-,3903
410,BUMA.1121.00077,1,2522762,2526672,+,3910
410,BUMA.1121.00063,1,3738084,3741995,+,3911
410,BUMA.1121.00061,1,3748224,3752135,+,3911
410,BUMA.1121.00050,1,1715301,1719206,-,3905
410,BUMA.1121.00081,1,2978642,2982546,+,3904
410,BUMA.1121.00074,1,240822,244734,-,3912
410,BUMA.1121.00062,1,704817,708722,-,3905
410,BUMA.1121.00060,1,2475795,2479714,-,3919
410,BUMA.1121.00070,1,3723893,3727804,+,3911
410,BUMA.1121.00075,1,3323212,3327116,+,3904
410,BUMA.1121.00041,1,1101823,1105735,+,3912
410,BUMA.1121.00073,1,3751010,3754921,+,3911
410,BUMA.1121.00017,1,382189,386094,-,3905
410,BUMA.1121.00066,1,3736454,3740365,+,3911
410,BUMA.1121.00107,1,3812088,3815991,+,3903
410,BUMA.1121.00085,1,3426013,3429917,+,3904
410,BUMA.1121.00030,1,382189,386094,-,3905
410,BUMA.1121.00112,1,3239402,3243315,-,3913
410,BUMA.1121.00002,1,1009664,1013568,+,3904
410,BUMA.1121.00082,1,3951618,3955529,+,3911
410,BUMA.1121.00014,1,3027473,3031378,-,3905
410,BUMA.1121.00011,1,1766147,1770060,-,3913
410,BUMA.1121.00019,1,382203,386108,-,3905
410,BUMA.1121.00057,1,936663,940574,+,3911
410,BUMA.1121.00018,1,364829,368733,+,3904
410,BUMA.1121.00039,1,4000008,4003919,+,3911
410,BUMA.1121.00016,1,1949535,1953445,+,3910
410,BUMA.1121.00004,1,382183,386088,-,3905
410,BUMA.1121.00005,1,3722503,3726408,-,3905
410,BUMA.1121.00100,1,1453650,1457555,-,3905
410,BUMA.1121.00006,1,2978527,2982431,+,3904
411,BUMA.1121.00027,1,2040280,2047626,+,7346
411,BUMA.1121.00025,1,2883027,2890365,-,7338
411,BUMA.1121.00021,1,485027,492366,+,7339
411,BUMA.1121.00023,1,2207539,2214878,+,7339
411,BUMA.1121.00024,1,374073,381401,-,7328
411,BUMA.1121.00033,1,2105585,2112923,+,7338
411,BUMA.1121.00034,1,374081,381409,-,7328
411,BUMA.1121.00036,1,3326106,3333429,-,7323
411,BUMA.1121.00032,1,1969487,1976815,-,7328
411,BUMA.1121.00009,1,1721521,1728852,-,7331
411,BUMA.1121.00008,1,374095,381423,-,7328
411,BUMA.1121.00003,1,2371200,2378545,+,7345
411,BUMA.1121.00109,1,2050702,2058045,-,7343
411,BUMA.1121.00053,1,3614087,3621425,+,7338
411,BUMA.1121.00110,1,948527,955861,-,7334
411,BUMA.1121.00104,1,1394816,1402160,-,7344
411,BUMA.1121.00086,1,3040333,3047656,-,7323
411,BUMA.1121.00092,1,3943306,3950645,+,7339
411,BUMA.1121.00096,1,3395091,3402422,-,7331
411,BUMA.1121.00054,1,1152641,1159969,-,7328
411,BUMA.1121.00097,1,95149,102486,-,7337
411,BUMA.1121.00093,1,675830,683168,-,7338
411,BUMA.1121.00106,1,3613768,3621113,+,7345
411,BUMA.1121.00010,1,987676,995005,+,7329
411,BUMA.1121.00035,1,888717,896056,+,7339
411,BUMA.1121.00108,1,837163,844494,+,7331
411,BUMA.1121.00028,1,374082,381410,-,7328
411,BUMA.1121.00094,1,3888045,3895385,+,7340
411,BUMA.1121.00102,1,1408649,1415978,-,7329
411,BUMA.1121.00111,1,13828,21167,+,7339
411,BUMA.1121.00089,1,3874728,3882068,+,7340
411,BUMA.1121.00084,1,110769,118108,+,7339
411,BUMA.1121.00029,1,1074137,1081474,-,7337
411,BUMA.1121.00012,1,2587925,2595264,+,7339
411,BUMA.1121.00087,1,288304,295628,+,7324
411,BUMA.1121.00043,1,3968759,3976098,+,7339
411,BUMA.1121.00046,1,1037178,1044507,+,7329
411,BUMA.1121.00037,1,2506209,2513548,+,7339
411,BUMA.1121.00080,1,3899457,3906797,+,7340
411,BUMA.1121.00079,1,3952704,3960044,+,7340
411,BUMA.1121.00045,1,222426,229758,-,7332
411,BUMA.1121.00071,1,3748858,3756205,+,7347
411,BUMA.1121.00056,1,47435,54774,-,7339
411,BUMA.1121.00065,1,3898107,3905446,+,7339
411,BUMA.1121.00058,1,655111,662455,-,7344
411,BUMA.1121.00007,1,191720,199050,-,7330
411,BUMA.1121.00067,1,568917,576255,-,7338
411,BUMA.1121.00090,1,1950670,1958009,+,7339
411,BUMA.1121.00051,1,3873189,3880529,+,7340
411,BUMA.1121.00020,1,374088,381416,-,7328
411,BUMA.1121.00103,1,471460,478789,-,7329
411,BUMA.1121.00048,1,2775829,2783158,+,7329
411,BUMA.1121.00047,1,3087267,3094606,-,7339
411,BUMA.1121.00042,1,866880,874208,-,7328
411,BUMA.1121.00055,1,3519193,3526537,+,7344
411,BUMA.1121.00031,1,1223745,1231083,+,7338
411,BUMA.1121.00040,1,872805,880133,-,7328
411,BUMA.1121.00044,1,3176082,3183410,-,7328
411,BUMA.1121.00088,1,694394,701735,+,7341
411,BUMA.1121.00069,1,3743794,3751141,+,7347
411,BUMA.1121.00064,1,3853348,3860688,+,7340
411,BUMA.1121.00105,1,1364478,1371816,-,7338
411,BUMA.1121.00015,1,3466965,3474294,+,7329
411,BUMA.1121.00059,1,3098325,3105666,+,7341
411,BUMA.1121.00026,1,1178092,1185420,-,7328
411,BUMA.1121.00022,1,370133,377457,+,7324
411,BUMA.1121.00052,1,336902,344231,+,7329
411,BUMA.1121.00101,1,2599787,2607116,-,7329
411,BUMA.1121.00001,1,197634,204972,-,7338
411,BUMA.1121.00038,1,2983128,2990457,+,7329
411,BUMA.1121.00068,1,2685122,2692457,+,7335
411,BUMA.1121.00099,1,2582990,2590329,-,7339
411,BUMA.1121.00091,1,636840,644178,-,7338
411,BUMA.1121.00098,1,2549128,2556466,+,7338
411,BUMA.1121.00013,1,611551,618879,-,7328
411,BUMA.1121.00049,1,1963364,1970694,-,7330
411,BUMA.1121.00072,1,3740811,3748153,+,7342
411,BUMA.1121.00076,1,1477002,1484341,-,7339
411,BUMA.1121.00083,1,1815714,1823060,-,7346
411,BUMA.1121.00078,1,2155683,2163012,-,7329
411,BUMA.1121.00095,1,1794514,1801857,-,7343
411,BUMA.1121.00077,1,2527453,2534788,+,7335
411,BUMA.1121.00063,1,3742776,3750123,+,7347
411,BUMA.1121.00061,1,3752916,3760261,+,7345
411,BUMA.1121.00050,1,1707192,1714520,-,7328
411,BUMA.1121.00081,1,2983327,2990656,+,7329
411,BUMA.1121.00074,1,232702,240041,-,7339
411,BUMA.1121.00062,1,696699,704036,-,7337
411,BUMA.1121.00060,1,2467682,2475014,-,7332
411,BUMA.1121.00070,1,3728585,3735932,+,7347
411,BUMA.1121.00075,1,3327897,3335237,+,7340
411,BUMA.1121.00041,1,1106516,1113855,+,7339
411,BUMA.1121.00073,1,3755702,3763049,+,7347
411,BUMA.1121.00017,1,374080,381408,-,7328
411,BUMA.1121.00066,1,3741146,3748493,+,7347
411,BUMA.1121.00107,1,3816772,3824107,+,7335
411,BUMA.1121.00085,1,3430698,3438027,+,7329
411,BUMA.1121.00030,1,374080,381408,-,7328
411,BUMA.1121.00112,1,3231291,3238621,-,7330
411,BUMA.1121.00002,1,1014349,1021678,+,7329
411,BUMA.1121.00082,1,3956310,3963657,+,7347
411,BUMA.1121.00014,1,3019354,3026692,-,7338
411,BUMA.1121.00011,1,1758022,1765366,-,7344
411,BUMA.1121.00019,1,374094,381422,-,7328
411,BUMA.1121.00057,1,941355,948702,+,7347
411,BUMA.1121.00018,1,369514,376853,+,7339
411,BUMA.1121.00039,1,4004700,4012039,+,7339
411,BUMA.1121.00016,1,1954226,1961557,+,7331
411,BUMA.1121.00004,1,374074,381402,-,7328
411,BUMA.1121.00005,1,3714376,3721722,-,7346
411,BUMA.1121.00100,1,1445523,1452869,-,7346
411,BUMA.1121.00006,1,2983212,2990541,+,7329
412,BUMA.1121.00027,1,2048293,2056089,+,7796
412,BUMA.1121.00025,1,2869073,2876863,-,7790
412,BUMA.1121.00021,1,498530,506321,+,7791
412,BUMA.1121.00023,1,2221042,2228832,+,7790
412,BUMA.1121.00024,1,1028905,1036708,-,7803
412,BUMA.1121.00033,1,2158527,2166316,+,7789
412,BUMA.1121.00034,1,1066342,1074145,-,7803
412,BUMA.1121.00036,1,3205702,3213505,+,7803
412,BUMA.1121.00032,1,2559329,2567132,-,7803
412,BUMA.1121.00009,1,1669149,1676934,-,7785
412,BUMA.1121.00008,1,1032634,1040437,-,7803
412,BUMA.1121.00003,1,2395125,2402905,+,7780
412,BUMA.1121.00109,1,1987780,1995558,-,7778
412,BUMA.1121.00053,1,3634130,3641919,+,7789
412,BUMA.1121.00110,1,923578,931347,-,7769
412,BUMA.1121.00104,1,1380853,1388651,-,7798
412,BUMA.1121.00086,1,3029318,3037121,-,7803
412,BUMA.1121.00092,1,3994300,4002096,+,7796
412,BUMA.1121.00096,1,3381137,3388927,-,7790
412,BUMA.1121.00054,1,1033792,1041595,+,7803
412,BUMA.1121.00097,1,81195,88984,-,7789
412,BUMA.1121.00093,1,624378,632174,-,7796
412,BUMA.1121.00106,1,3667505,3675301,+,7796
412,BUMA.1121.00010,1,1215097,1222900,-,7803
412,BUMA.1121.00035,1,905313,913101,+,7788
412,BUMA.1121.00108,1,853898,861685,+,7787
412,BUMA.1121.00028,1,1028939,1036742,-,7803
412,BUMA.1121.00094,1,3902907,3910705,+,7798
412,BUMA.1121.00102,1,1384326,1392113,-,7787
412,BUMA.1121.00111,1,27331,35121,+,7790
412,BUMA.1121.00089,1,3889590,3897388,+,7798
412,BUMA.1121.00084,1,124273,132067,+,7794
412,BUMA.1121.00029,1,1060180,1067973,-,7793
412,BUMA.1121.00012,1,2601437,2609225,+,7788
412,BUMA.1121.00087,1,298839,306642,+,7803
412,BUMA.1121.00043,1,4028993,4036783,+,7790
412,BUMA.1121.00046,1,1047719,1055522,+,7803
412,BUMA.1121.00037,1,2521066,2528856,+,7790
412,BUMA.1121.00080,1,3914319,3922117,+,7798
412,BUMA.1121.00079,1,3967566,3975363,+,7797
412,BUMA.1121.00045,1,177166,184956,-,7790
412,BUMA.1121.00071,1,3756872,3764713,+,7841
412,BUMA.1121.00056,1,32115,39913,-,7798
412,BUMA.1121.00065,1,3939611,3947399,+,7788
412,BUMA.1121.00058,1,641148,648946,-,7798
412,BUMA.1121.00007,1,177769,185556,-,7787
412,BUMA.1121.00067,1,512682,520480,-,7798
412,BUMA.1121.00090,1,1987997,1995787,+,7790
412,BUMA.1121.00051,1,3888051,3895849,+,7798
412,BUMA.1121.00020,1,1093876,1101679,-,7803
412,BUMA.1121.00103,1,457505,465295,-,7790
412,BUMA.1121.00048,1,2894194,2901997,-,7803
412,BUMA.1121.00047,1,3071947,3079745,-,7798
412,BUMA.1121.00042,1,25014,32817,+,7803
412,BUMA.1121.00055,1,3532701,3540488,+,7787
412,BUMA.1121.00031,1,1237247,1245037,+,7790
412,BUMA.1121.00040,1,659982,667785,-,7803
412,BUMA.1121.00044,1,294456,302259,-,7803
412,BUMA.1121.00088,1,750244,758040,+,7796
412,BUMA.1121.00069,1,3751808,3759760,+,7952
412,BUMA.1121.00064,1,3907669,3915466,+,7797
412,BUMA.1121.00105,1,1350515,1358313,-,7798
412,BUMA.1121.00015,1,42453,50256,-,7803
412,BUMA.1121.00059,1,3111833,3119631,+,7798
412,BUMA.1121.00026,1,1351746,1359549,-,7803
412,BUMA.1121.00022,1,557910,565713,+,7803
412,BUMA.1121.00052,1,163775,171578,+,7803
412,BUMA.1121.00101,1,2581208,2588995,-,7787
412,BUMA.1121.00001,1,183682,191470,-,7788
412,BUMA.1121.00038,1,3101510,3109313,-,7803
412,BUMA.1121.00068,1,2716175,2723962,+,7787
412,BUMA.1121.00099,1,2562409,2570199,-,7790
412,BUMA.1121.00091,1,628384,636173,-,7789
412,BUMA.1121.00098,1,2567967,2575761,+,7794
412,BUMA.1121.00013,1,784186,791989,-,7803
412,BUMA.1121.00049,1,1954908,1962697,-,7789
412,BUMA.1121.00072,1,3748820,3756794,+,7974
412,BUMA.1121.00076,1,1463045,1470837,-,7792
412,BUMA.1121.00083,1,1795714,1803500,-,7786
412,BUMA.1121.00078,1,2142426,2149519,-,7093
412,BUMA.1121.00095,1,1769673,1777461,-,7788
412,BUMA.1121.00077,1,2551968,2559737,+,7769
412,BUMA.1121.00063,1,3754228,3762014,+,7786
412,BUMA.1121.00061,1,3760928,3768766,+,7838
412,BUMA.1121.00050,1,1696177,1703980,-,7803
412,BUMA.1121.00081,1,3101702,3109505,-,7803
412,BUMA.1121.00074,1,181776,189574,-,7798
412,BUMA.1121.00062,1,682736,690534,-,7798
412,BUMA.1121.00060,1,2422421,2430211,-,7790
412,BUMA.1121.00070,1,3743504,3751288,+,7784
412,BUMA.1121.00075,1,3341402,3349194,+,7792
412,BUMA.1121.00041,1,1115888,1123673,+,7785
412,BUMA.1121.00073,1,3767747,3775533,+,7786
412,BUMA.1121.00017,1,963982,971785,-,7803
412,BUMA.1121.00066,1,3756274,3764060,+,7786
412,BUMA.1121.00107,1,3830269,3838057,+,7788
412,BUMA.1121.00085,1,3257581,3265384,+,7803
412,BUMA.1121.00030,1,964014,971817,-,7803
412,BUMA.1121.00112,1,3180794,3188588,-,7794
412,BUMA.1121.00002,1,1241785,1249588,-,7803
412,BUMA.1121.00082,1,3975871,3983657,+,7786
412,BUMA.1121.00014,1,3005401,3013190,-,7789
412,BUMA.1121.00011,1,1744853,1752644,-,7791
412,BUMA.1121.00019,1,1028983,1036786,-,7803
412,BUMA.1121.00057,1,995607,1003393,+,7786
412,BUMA.1121.00018,1,383017,390807,+,7790
412,BUMA.1121.00039,1,4019538,4027326,+,7788
412,BUMA.1121.00016,1,1978353,1986142,+,7789
412,BUMA.1121.00004,1,1030178,1037981,-,7803
412,BUMA.1121.00005,1,3700428,3708212,-,7784
412,BUMA.1121.00100,1,1431584,1439358,-,7774
412,BUMA.1121.00006,1,3101587,3109390,-,7803
413,BUMA.1121.00027,1,2056261,2071434,+,15173
413,BUMA.1121.00025,1,2853878,2868797,-,14919
413,BUMA.1121.00021,1,506450,521329,+,14879
413,BUMA.1121.00023,1,2229108,2243977,+,14869
413,BUMA.1121.00024,1,1013826,1028706,-,14880
413,BUMA.1121.00033,1,2166529,2181593,+,15064
413,BUMA.1121.00034,1,1051256,1066136,-,14880
413,BUMA.1121.00036,1,3213676,3228555,+,14879
413,BUMA.1121.00032,1,2544341,2559221,-,14880
413,BUMA.1121.00009,1,1653923,1668901,-,14978
413,BUMA.1121.00008,1,1017571,1032451,-,14880
413,BUMA.1121.00003,1,2403377,2418550,+,15173
413,BUMA.1121.00109,1,1972301,1987434,-,15133
413,BUMA.1121.00053,1,3642119,3657352,+,15233
413,BUMA.1121.00110,1,908300,923421,-,15121
413,BUMA.1121.00104,1,1365528,1380612,-,15084
413,BUMA.1121.00086,1,3014330,3029210,-,14880
413,BUMA.1121.00092,1,4002379,4017209,+,14830
413,BUMA.1121.00096,1,3366023,3380903,-,14880
413,BUMA.1121.00054,1,1041794,1056673,+,14879
413,BUMA.1121.00097,1,65661,80933,-,15272
413,BUMA.1121.00093,1,609278,624109,-,14831
413,BUMA.1121.00106,1,3675549,3690673,+,15124
413,BUMA.1121.00010,1,1200116,1214996,-,14880
413,BUMA.1121.00035,1,913426,928305,+,14879
413,BUMA.1121.00108,1,861793,876917,+,15124
413,BUMA.1121.00028,1,1013825,1028705,-,14880
413,BUMA.1121.00094,1,3911016,3926333,+,15317
413,BUMA.1121.00102,1,1368920,1384105,-,15185
413,BUMA.1121.00111,1,35383,50264,+,14881
413,BUMA.1121.00089,1,3897699,3913000,+,15301
413,BUMA.1121.00084,1,132336,147460,+,15124
413,BUMA.1121.00029,1,1045080,1059960,-,14880
413,BUMA.1121.00012,1,2609508,2624387,+,14879
413,BUMA.1121.00087,1,306750,321629,+,14879
413,BUMA.1121.00043,1,4037101,4051970,+,14869
413,BUMA.1121.00046,1,1055700,1070579,+,14879
413,BUMA.1121.00037,1,2531736,2546605,+,14869
413,BUMA.1121.00080,1,3922316,3937632,+,15316
413,BUMA.1121.00079,1,3975555,3990870,+,15315
413,BUMA.1121.00045,1,161876,177051,-,15175
413,BUMA.1121.00071,1,3764962,3780131,+,15169
413,BUMA.1121.00056,1,16593,31895,-,15302
413,BUMA.1121.00065,1,3947633,3962855,+,15222
413,BUMA.1121.00058,1,625852,640977,-,15125
413,BUMA.1121.00007,1,162092,177315,-,15223
413,BUMA.1121.00067,1,497399,512532,-,15133
413,BUMA.1121.00090,1,1996224,2011299,+,15075
413,BUMA.1121.00051,1,3896109,3911429,+,15320
413,BUMA.1121.00020,1,1078769,1093649,-,14880
413,BUMA.1121.00103,1,442041,457264,-,15223
413,BUMA.1121.00048,1,2879122,2894002,-,14880
413,BUMA.1121.00047,1,3056382,3071699,-,15317
413,BUMA.1121.00042,1,32925,47804,+,14879
413,BUMA.1121.00055,1,3540715,3555847,+,15132
413,BUMA.1121.00031,1,1245215,1260093,+,14878
413,BUMA.1121.00040,1,644966,659846,-,14880
413,BUMA.1121.00044,1,279363,294243,-,14880
413,BUMA.1121.00088,1,758218,773338,+,15120
413,BUMA.1121.00069,1,3760008,3775177,+,15169
413,BUMA.1121.00064,1,3915763,3930891,+,15128
413,BUMA.1121.00105,1,1335289,1350414,-,15125
413,BUMA.1121.00015,1,27332,42212,-,14880
413,BUMA.1121.00059,1,3119928,3135056,+,15128
413,BUMA.1121.00026,1,1336814,1351694,-,14880
413,BUMA.1121.00022,1,565856,580735,+,14879
413,BUMA.1121.00052,1,171742,186621,+,14879
413,BUMA.1121.00101,1,2565744,2580918,-,15174
413,BUMA.1121.00001,1,168659,183539,-,14880
413,BUMA.1121.00038,1,3086424,3101304,-,14880
413,BUMA.1121.00068,1,2724056,2739343,+,15287
413,BUMA.1121.00099,1,2547099,2562175,-,15076
413,BUMA.1121.00091,1,612889,628108,-,15219
413,BUMA.1121.00098,1,2575995,2591217,+,15222
413,BUMA.1121.00013,1,769170,784050,-,14880
413,BUMA.1121.00049,1,1939518,1954786,-,15268
413,BUMA.1121.00072,1,3757037,3772206,+,15169
413,BUMA.1121.00076,1,1447710,1462895,-,15185
413,BUMA.1121.00083,1,1780295,1795465,-,15170
413,BUMA.1121.00078,1,2127357,2142234,-,14877
413,BUMA.1121.00095,1,1754493,1769460,-,14967
413,BUMA.1121.00077,1,2559912,2575035,+,15123
413,BUMA.1121.00063,1,3762263,3777432,+,15169
413,BUMA.1121.00061,1,3769015,3784184,+,15169
413,BUMA.1121.00050,1,1681147,1696027,-,14880
413,BUMA.1121.00081,1,3086623,3101503,-,14880
413,BUMA.1121.00074,1,166294,181423,-,15129
413,BUMA.1121.00062,1,667327,682509,-,15182
413,BUMA.1121.00060,1,2407068,2422243,-,15175
413,BUMA.1121.00070,1,3751536,3766705,+,15169
413,BUMA.1121.00075,1,3349330,3364513,+,15183
413,BUMA.1121.00041,1,1123879,1138801,+,14922
413,BUMA.1121.00073,1,3775782,3790951,+,15169
413,BUMA.1121.00017,1,948875,963755,-,14880
413,BUMA.1121.00066,1,3764308,3779477,+,15169
413,BUMA.1121.00107,1,3838249,3853470,+,15221
413,BUMA.1121.00085,1,3265548,3280427,+,14879
413,BUMA.1121.00030,1,948935,963815,-,14880
413,BUMA.1121.00112,1,3165673,3180700,-,15027
413,BUMA.1121.00002,1,1226804,1241684,-,14880
413,BUMA.1121.00082,1,3983906,3999075,+,15169
413,BUMA.1121.00014,1,2990336,3005216,-,14880
413,BUMA.1121.00011,1,1729564,1744591,-,15027
413,BUMA.1121.00019,1,1013869,1028749,-,14880
413,BUMA.1121.00057,1,1003731,1018802,+,15071
413,BUMA.1121.00018,1,391074,405992,+,14918
413,BUMA.1121.00039,1,4027700,4042579,+,14879
413,BUMA.1121.00016,1,1986453,2001330,+,14877
413,BUMA.1121.00004,1,1015022,1029902,-,14880
413,BUMA.1121.00005,1,3685273,3700152,-,14879
413,BUMA.1121.00100,1,1416036,1431357,-,15321
413,BUMA.1121.00006,1,3086508,3101388,-,14880
414,BUMA.1121.00027,1,2075717,2088136,+,12419
414,BUMA.1121.00025,1,2837184,2849595,-,12411
414,BUMA.1121.00021,1,525613,537987,+,12374
414,BUMA.1121.00023,1,2248261,2260631,+,12370
414,BUMA.1121.00024,1,282428,294800,+,12372
414,BUMA.1121.00033,1,2185881,2198228,+,12347
414,BUMA.1121.00034,1,282444,294816,+,12372
414,BUMA.1121.00036,1,3234474,3246822,+,12348
414,BUMA.1121.00032,1,1879435,1891807,+,12372
414,BUMA.1121.00009,1,1637305,1649639,-,12334
414,BUMA.1121.00008,1,282458,294830,+,12372
414,BUMA.1121.00003,1,2422836,2435164,+,12328
414,BUMA.1121.00109,1,1955597,1968017,-,12420
414,BUMA.1121.00053,1,3663088,3675428,+,12340
414,BUMA.1121.00110,1,891684,904017,-,12333
414,BUMA.1121.00104,1,1348877,1361244,-,12367
414,BUMA.1121.00086,1,2996069,3008422,-,12353
414,BUMA.1121.00092,1,4021493,4033866,+,12373
414,BUMA.1121.00096,1,3349385,3361740,-,12355
414,BUMA.1121.00054,1,1062550,1074898,+,12348
414,BUMA.1121.00097,1,49018,61377,-,12359
414,BUMA.1121.00093,1,592622,604994,-,12372
414,BUMA.1121.00106,1,3694957,3707289,+,12332
414,BUMA.1121.00010,1,1072741,1085100,-,12359
414,BUMA.1121.00035,1,932589,944962,+,12373
414,BUMA.1121.00108,1,881201,893521,+,12320
414,BUMA.1121.00028,1,282445,294817,+,12372
414,BUMA.1121.00094,1,3930617,3942981,+,12364
414,BUMA.1121.00102,1,1352287,1364636,-,12349
414,BUMA.1121.00111,1,54549,66913,+,12364
414,BUMA.1121.00089,1,3917284,3929654,+,12370
414,BUMA.1121.00084,1,151744,164075,+,12331
414,BUMA.1121.00029,1,1028430,1040796,-,12366
414,BUMA.1121.00012,1,2628676,2641019,+,12343
414,BUMA.1121.00087,1,327504,339858,+,12354
414,BUMA.1121.00043,1,4056254,4068630,+,12376
414,BUMA.1121.00046,1,1076455,1088809,+,12354
414,BUMA.1121.00037,1,2550896,2563272,+,12376
414,BUMA.1121.00080,1,3941916,3954272,+,12356
414,BUMA.1121.00079,1,3995153,4007536,+,12383
414,BUMA.1121.00045,1,145311,157607,-,12296
414,BUMA.1121.00071,1,3784415,3796783,+,12368
414,BUMA.1121.00056,1,1,12309,-,12308
414,BUMA.1121.00065,1,3967140,3979520,+,12380
414,BUMA.1121.00058,1,607758,620113,-,12355
414,BUMA.1121.00007,1,145451,157808,-,12357
414,BUMA.1121.00067,1,480671,493115,-,12444
414,BUMA.1121.00090,1,2015583,2027929,+,12346
414,BUMA.1121.00051,1,3915712,3928057,+,12345
414,BUMA.1121.00020,1,282451,294823,+,12372
414,BUMA.1121.00103,1,425327,437758,-,12431
414,BUMA.1121.00048,1,2860899,2873246,-,12347
414,BUMA.1121.00047,1,3039716,3052098,-,12382
414,BUMA.1121.00042,1,118218,130571,-,12353
414,BUMA.1121.00055,1,3560131,3572461,+,12330
414,BUMA.1121.00031,1,1264392,1276766,+,12374
414,BUMA.1121.00040,1,626741,639088,-,12347
414,BUMA.1121.00044,1,3084445,3096817,+,12372
414,BUMA.1121.00088,1,777622,790015,+,12393
414,BUMA.1121.00069,1,3779461,3791818,+,12357
414,BUMA.1121.00064,1,3935175,3947522,+,12347
414,BUMA.1121.00105,1,1318667,1331005,-,12338
414,BUMA.1121.00015,1,9109,21456,-,12347
414,BUMA.1121.00059,1,3139340,3151679,+,12339
414,BUMA.1121.00026,1,1254202,1266463,+,12261
414,BUMA.1121.00022,1,651504,663857,-,12353
414,BUMA.1121.00052,1,192497,204851,+,12354
414,BUMA.1121.00101,1,2549157,2561460,-,12303
414,BUMA.1121.00001,1,152009,164375,-,12366
414,BUMA.1121.00038,1,3068200,3080547,-,12347
414,BUMA.1121.00068,1,2743627,2755956,+,12329
414,BUMA.1121.00099,1,2530473,2542811,-,12338
414,BUMA.1121.00091,1,596244,608604,-,12360
414,BUMA.1121.00098,1,2595501,2607838,+,12337
414,BUMA.1121.00013,1,750939,763292,-,12353
414,BUMA.1121.00049,1,1922872,1935234,-,12362
414,BUMA.1121.00072,1,3776490,3788845,+,12355
414,BUMA.1121.00076,1,1431077,1443426,-,12349
414,BUMA.1121.00083,1,1763628,1776011,-,12383
414,BUMA.1121.00078,1,2110741,2123073,-,12332
414,BUMA.1121.00095,1,1737809,1750207,-,12398
414,BUMA.1121.00077,1,2579318,2591652,+,12334
414,BUMA.1121.00063,1,3781716,3794071,+,12355
414,BUMA.1121.00061,1,3788468,3800824,+,12356
414,BUMA.1121.00050,1,1662918,1675271,-,12353
414,BUMA.1121.00081,1,3068399,3080746,-,12347
414,BUMA.1121.00074,1,149652,162010,-,12358
414,BUMA.1121.00062,1,650717,663043,-,12326
414,BUMA.1121.00060,1,2390503,2402799,-,12296
414,BUMA.1121.00070,1,3770989,3783352,+,12363
414,BUMA.1121.00075,1,3368797,3381147,+,12350
414,BUMA.1121.00041,1,1143085,1155409,+,12324
414,BUMA.1121.00073,1,3795235,3807597,+,12362
414,BUMA.1121.00017,1,282443,294815,+,12372
414,BUMA.1121.00066,1,3783761,3796129,+,12368
414,BUMA.1121.00107,1,3857755,3870105,+,12350
414,BUMA.1121.00085,1,3286303,3298657,+,12354
414,BUMA.1121.00030,1,282443,294815,+,12372
414,BUMA.1121.00112,1,3149052,3161387,-,12335
414,BUMA.1121.00002,1,1099406,1111765,-,12359
414,BUMA.1121.00082,1,4003359,4015727,+,12368
414,BUMA.1121.00014,1,2973675,2986036,-,12361
414,BUMA.1121.00011,1,1712950,1725280,-,12330
414,BUMA.1121.00019,1,282457,294829,+,12372
414,BUMA.1121.00057,1,1023086,1035430,+,12344
414,BUMA.1121.00018,1,410275,422681,+,12406
414,BUMA.1121.00039,1,41,12408,+,12367
414,BUMA.1121.00016,1,2005615,2017991,+,12376
414,BUMA.1121.00004,1,282437,294809,+,12372
414,BUMA.1121.00005,1,3668638,3680988,-,12350
414,BUMA.1121.00100,1,1399403,1411753,-,12350
414,BUMA.1121.00006,1,3068284,3080631,-,12347
415,BUMA.1121.00027,1,2088594,2097364,+,8770
415,BUMA.1121.00025,1,2828037,2836796,-,8759
415,BUMA.1121.00021,1,538503,547262,+,8759
415,BUMA.1121.00023,1,2260915,2269674,+,8759
415,BUMA.1121.00024,1,295148,303898,+,8750
415,BUMA.1121.00033,1,2198512,2207263,+,8751
415,BUMA.1121.00034,1,295156,303906,+,8750
415,BUMA.1121.00036,1,3247178,3255928,+,8750
415,BUMA.1121.00032,1,1892155,1900905,+,8750
415,BUMA.1121.00009,1,1628037,1636791,-,8754
415,BUMA.1121.00008,1,295170,303920,+,8750
415,BUMA.1121.00003,1,2435506,2444268,+,8762
415,BUMA.1121.00109,1,1946305,1955056,-,8751
415,BUMA.1121.00053,1,3675936,3684707,+,8771
415,BUMA.1121.00110,1,882509,891264,-,8755
415,BUMA.1121.00104,1,1339821,1348583,-,8762
415,BUMA.1121.00086,1,2986971,2995721,-,8750
415,BUMA.1121.00092,1,4034294,4043052,+,8758
415,BUMA.1121.00096,1,3340221,3348976,-,8755
415,BUMA.1121.00054,1,1075304,1084054,+,8750
415,BUMA.1121.00097,1,39925,48696,-,8771
415,BUMA.1121.00093,1,583452,592210,-,8758
415,BUMA.1121.00106,1,3707699,3716461,+,8762
415,BUMA.1121.00010,1,1063587,1072337,-,8750
415,BUMA.1121.00035,1,945398,954157,+,8759
415,BUMA.1121.00108,1,893893,902651,+,8758
415,BUMA.1121.00028,1,295157,303907,+,8750
415,BUMA.1121.00094,1,3943385,3952136,+,8751
415,BUMA.1121.00102,1,1343035,1351805,-,8770
415,BUMA.1121.00111,1,67467,76180,+,8713
415,BUMA.1121.00089,1,3930058,3938809,+,8751
415,BUMA.1121.00084,1,164369,173131,+,8762
415,BUMA.1121.00029,1,1018940,1027866,-,8926
415,BUMA.1121.00012,1,2641495,2650254,+,8759
415,BUMA.1121.00087,1,340206,348956,+,8750
415,BUMA.1121.00043,1,4069106,4077865,+,8759
415,BUMA.1121.00046,1,1089183,1097933,+,8750
415,BUMA.1121.00037,1,2563692,2572451,+,8759
415,BUMA.1121.00080,1,3954771,3963540,+,8769
415,BUMA.1121.00079,1,4007994,4016764,+,8770
415,BUMA.1121.00045,1,136220,144971,-,8751
415,BUMA.1121.00071,1,3797281,3806051,+,8770
415,BUMA.1121.00056,1,3975078,3983829,-,8751
415,BUMA.1121.00065,1,3979930,3988693,+,8763
415,BUMA.1121.00058,1,598692,607442,-,8750
415,BUMA.1121.00007,1,136374,145137,-,8763
415,BUMA.1121.00067,1,471461,480231,-,8770
415,BUMA.1121.00090,1,2028373,2037132,+,8759
415,BUMA.1121.00051,1,3928619,3937373,+,8754
415,BUMA.1121.00020,1,295163,303913,+,8750
415,BUMA.1121.00103,1,416111,424873,-,8762
415,BUMA.1121.00048,1,2851743,2860493,-,8750
415,BUMA.1121.00047,1,3030448,3039202,-,8754
415,BUMA.1121.00042,1,109088,117838,-,8750
415,BUMA.1121.00055,1,3572845,3581608,+,8763
415,BUMA.1121.00031,1,1277234,1285985,+,8751
415,BUMA.1121.00040,1,617593,626343,-,8750
415,BUMA.1121.00044,1,3097157,3105907,+,8750
415,BUMA.1121.00088,1,790425,799195,+,8770
415,BUMA.1121.00069,1,3792316,3801086,+,8770
415,BUMA.1121.00064,1,3947924,3956694,+,8770
415,BUMA.1121.00105,1,1309515,1318265,-,8750
415,BUMA.1121.00015,1,1,8695,-,8694
415,BUMA.1121.00059,1,3152155,3160925,+,8770
415,BUMA.1121.00026,1,1266779,1275529,+,8750
415,BUMA.1121.00022,1,642366,651116,-,8750
415,BUMA.1121.00052,1,205193,213943,+,8750
415,BUMA.1121.00101,1,2540022,2548785,-,8763
415,BUMA.1121.00001,1,142679,151605,-,8926
415,BUMA.1121.00038,1,3059044,3067794,-,8750
415,BUMA.1121.00068,1,2756370,2765152,+,8782
415,BUMA.1121.00099,1,2521388,2530159,-,8771
415,BUMA.1121.00091,1,586952,595722,-,8770
415,BUMA.1121.00098,1,2608222,2616985,+,8763
415,BUMA.1121.00013,1,741839,750589,-,8750
415,BUMA.1121.00049,1,1913808,1922578,-,8770
415,BUMA.1121.00072,1,3789343,3798113,+,8770
415,BUMA.1121.00076,1,1422034,1430793,-,8759
415,BUMA.1121.00083,1,1754376,1763146,-,8770
415,BUMA.1121.00078,1,2101674,2110425,-,8751
415,BUMA.1121.00095,1,1728526,1737297,-,8771
415,BUMA.1121.00077,1,2592136,2600891,+,8755
415,BUMA.1121.00063,1,3794569,3803339,+,8770
415,BUMA.1121.00061,1,3801322,3810092,+,8770
415,BUMA.1121.00050,1,1653794,1662544,-,8750
415,BUMA.1121.00081,1,3059243,3067993,-,8750
415,BUMA.1121.00074,1,140400,149170,-,8770
415,BUMA.1121.00062,1,641503,650253,-,8750
415,BUMA.1121.00060,1,2381404,2390155,-,8751
415,BUMA.1121.00070,1,3783728,3792498,+,8770
415,BUMA.1121.00075,1,3381431,3390190,+,8759
415,BUMA.1121.00041,1,1155983,1164753,+,8770
415,BUMA.1121.00073,1,3807964,3816734,+,8770
415,BUMA.1121.00017,1,295155,303905,+,8750
415,BUMA.1121.00066,1,3796627,3805397,+,8770
415,BUMA.1121.00107,1,3870515,3879269,+,8754
415,BUMA.1121.00085,1,3298999,3307749,+,8750
415,BUMA.1121.00030,1,295155,303905,+,8750
415,BUMA.1121.00112,1,3139874,3148624,-,8750
415,BUMA.1121.00002,1,1090260,1099010,-,8750
415,BUMA.1121.00082,1,4016225,4024995,+,8770
415,BUMA.1121.00014,1,2964456,2973207,-,8751
415,BUMA.1121.00011,1,1703893,1712656,-,8763
415,BUMA.1121.00019,1,295169,303919,+,8750
415,BUMA.1121.00057,1,1035960,1044730,+,8770
415,BUMA.1121.00018,1,423093,431852,+,8759
415,BUMA.1121.00039,1,12908,21667,+,8759
415,BUMA.1121.00016,1,2018555,2027305,+,8750
415,BUMA.1121.00004,1,295149,303899,+,8750
415,BUMA.1121.00005,1,3659404,3668182,-,8778
415,BUMA.1121.00100,1,1390194,1398949,-,8755
415,BUMA.1121.00006,1,3059128,3067878,-,8750
416,BUMA.1121.00027,1,2097365,2104356,+,6991
416,BUMA.1121.00025,1,2821038,2828035,-,6997
416,BUMA.1121.00021,1,547263,554261,+,6998
416,BUMA.1121.00023,1,2269675,2276673,+,6998
416,BUMA.1121.00024,1,303899,310881,+,6982
416,BUMA.1121.00033,1,2207264,2214256,+,6992
416,BUMA.1121.00034,1,303907,310889,+,6982
416,BUMA.1121.00036,1,3255929,3262921,+,6992
416,BUMA.1121.00032,1,1900906,1907898,+,6992
416,BUMA.1121.00009,1,1621044,1628035,-,6991
416,BUMA.1121.00008,1,303921,310903,+,6982
416,BUMA.1121.00003,1,2444269,2451261,+,6992
416,BUMA.1121.00109,1,1939306,1946303,-,6997
416,BUMA.1121.00053,1,3684708,3691700,+,6992
416,BUMA.1121.00110,1,875510,882507,-,6997
416,BUMA.1121.00104,1,1332828,1339819,-,6991
416,BUMA.1121.00086,1,2979978,2986969,-,6991
416,BUMA.1121.00092,1,4043053,4050045,+,6992
416,BUMA.1121.00096,1,3333228,3340219,-,6991
416,BUMA.1121.00054,1,1084055,1091047,+,6992
416,BUMA.1121.00097,1,32932,39923,-,6991
416,BUMA.1121.00093,1,576459,583450,-,6991
416,BUMA.1121.00106,1,3716462,3723454,+,6992
416,BUMA.1121.00010,1,1056594,1063585,-,6991
416,BUMA.1121.00035,1,954158,961156,+,6998
416,BUMA.1121.00108,1,902652,909644,+,6992
416,BUMA.1121.00028,1,303908,310890,+,6982
416,BUMA.1121.00094,1,3952137,3959129,+,6992
416,BUMA.1121.00102,1,1336042,1343033,-,6991
416,BUMA.1121.00111,1,76181,83173,+,6992
416,BUMA.1121.00089,1,3938810,3945802,+,6992
416,BUMA.1121.00084,1,173132,180124,+,6992
416,BUMA.1121.00029,1,1011941,1018938,-,6997
416,BUMA.1121.00012,1,2650255,2657253,+,6998
416,BUMA.1121.00087,1,348957,355949,+,6992
416,BUMA.1121.00043,1,4077866,4084867,+,7001
416,BUMA.1121.00046,1,1097934,1104926,+,6992
416,BUMA.1121.00037,1,2572452,2579450,+,6998
416,BUMA.1121.00080,1,3963541,3970533,+,6992
416,BUMA.1121.00079,1,4016765,4023757,+,6992
416,BUMA.1121.00045,1,129227,136218,-,6991
416,BUMA.1121.00071,1,3806052,3813044,+,6992
416,BUMA.1121.00056,1,3968085,3975076,-,6991
416,BUMA.1121.00065,1,3988694,3995686,+,6992
416,BUMA.1121.00058,1,591699,598690,-,6991
416,BUMA.1121.00007,1,129381,136372,-,6991
416,BUMA.1121.00067,1,464468,471459,-,6991
416,BUMA.1121.00090,1,2037133,2044131,+,6998
416,BUMA.1121.00051,1,3937374,3944366,+,6992
416,BUMA.1121.00020,1,303914,310896,+,6982
416,BUMA.1121.00103,1,409118,416109,-,6991
416,BUMA.1121.00048,1,2844750,2851741,-,6991
416,BUMA.1121.00047,1,3023455,3030446,-,6991
416,BUMA.1121.00042,1,102095,109086,-,6991
416,BUMA.1121.00055,1,3581609,3588601,+,6992
416,BUMA.1121.00031,1,1285986,1292984,+,6998
416,BUMA.1121.00040,1,610600,617591,-,6991
416,BUMA.1121.00044,1,3105908,3112890,+,6982
416,BUMA.1121.00088,1,799196,806188,+,6992
416,BUMA.1121.00069,1,3801087,3808079,+,6992
416,BUMA.1121.00064,1,3956695,3963687,+,6992
416,BUMA.1121.00105,1,1302522,1309513,-,6991
416,BUMA.1121.00015,1,3535888,3542895,-,7007
416,BUMA.1121.00059,1,3160926,3167918,+,6992
416,BUMA.1121.00026,1,1275530,1282522,+,6992
416,BUMA.1121.00022,1,635373,642364,-,6991
416,BUMA.1121.00052,1,213944,220936,+,6992
416,BUMA.1121.00101,1,2533070,2540020,-,6950
416,BUMA.1121.00001,1,135680,142677,-,6997
416,BUMA.1121.00038,1,3052051,3059042,-,6991
416,BUMA.1121.00068,1,2765153,2772145,+,6992
416,BUMA.1121.00099,1,2514396,2521386,-,6990
416,BUMA.1121.00091,1,579959,586950,-,6991
416,BUMA.1121.00098,1,2616986,2623984,+,6998
416,BUMA.1121.00013,1,734846,741837,-,6991
416,BUMA.1121.00049,1,1906815,1913806,-,6991
416,BUMA.1121.00072,1,3798114,3805106,+,6992
416,BUMA.1121.00076,1,1415041,1422032,-,6991
416,BUMA.1121.00083,1,1747383,1754374,-,6991
416,BUMA.1121.00078,1,2094676,2101672,-,6996
416,BUMA.1121.00095,1,1721530,1728524,-,6994
416,BUMA.1121.00077,1,2600892,2607890,+,6998
416,BUMA.1121.00063,1,3803340,3810332,+,6992
416,BUMA.1121.00061,1,3810093,3817085,+,6992
416,BUMA.1121.00050,1,1646801,1653792,-,6991
416,BUMA.1121.00081,1,3052250,3059241,-,6991
416,BUMA.1121.00074,1,133407,140398,-,6991
416,BUMA.1121.00062,1,634510,641501,-,6991
416,BUMA.1121.00060,1,2374411,2381402,-,6991
416,BUMA.1121.00070,1,3792499,3799491,+,6992
416,BUMA.1121.00075,1,3390191,3397183,+,6992
416,BUMA.1121.00041,1,1164754,1171746,+,6992
416,BUMA.1121.00073,1,3816735,3823727,+,6992
416,BUMA.1121.00017,1,303906,310888,+,6982
416,BUMA.1121.00066,1,3805398,3812390,+,6992
416,BUMA.1121.00107,1,3879270,3886274,+,7004
416,BUMA.1121.00085,1,3307750,3314742,+,6992
416,BUMA.1121.00030,1,303906,310888,+,6982
416,BUMA.1121.00112,1,3132881,3139872,-,6991
416,BUMA.1121.00002,1,1083267,1090258,-,6991
416,BUMA.1121.00082,1,4024996,4031988,+,6992
416,BUMA.1121.00014,1,2957457,2964454,-,6997
416,BUMA.1121.00011,1,1696894,1703891,-,6997
416,BUMA.1121.00019,1,303920,310902,+,6982
416,BUMA.1121.00057,1,1044731,1051723,+,6992
416,BUMA.1121.00018,1,431853,438851,+,6998
416,BUMA.1121.00039,1,21668,28666,+,6998
416,BUMA.1121.00016,1,2027306,2034307,+,7001
416,BUMA.1121.00004,1,303900,310882,+,6982
416,BUMA.1121.00005,1,3652411,3659402,-,6991
416,BUMA.1121.00100,1,1383201,1390192,-,6991
416,BUMA.1121.00006,1,3052135,3059126,-,6991
417,BUMA.1121.00027,1,2106249,2136434,+,30185
417,BUMA.1121.00025,1,2788865,2819145,-,30280
417,BUMA.1121.00021,1,556154,586434,+,30280
417,BUMA.1121.00023,1,2278566,2308837,+,30271
417,BUMA.1121.00024,1,314377,344573,+,30196
417,BUMA.1121.00033,1,2216161,2246148,+,29987
417,BUMA.1121.00034,1,314385,344581,+,30196
417,BUMA.1121.00036,1,3266408,3296603,+,30195
417,BUMA.1121.00032,1,1909791,1939987,+,30196
417,BUMA.1121.00009,1,1588970,1619151,-,30181
417,BUMA.1121.00008,1,314399,344595,+,30196
417,BUMA.1121.00003,1,2453154,2483258,+,30104
417,BUMA.1121.00109,1,1907193,1937413,-,30220
417,BUMA.1121.00053,1,3693593,3723591,+,29998
417,BUMA.1121.00110,1,843613,873617,-,30004
417,BUMA.1121.00104,1,1300735,1330935,-,30200
417,BUMA.1121.00086,1,2946266,2976460,-,30194
417,BUMA.1121.00092,1,4051938,4082022,+,30084
417,BUMA.1121.00096,1,3300024,3331335,-,31311
417,BUMA.1121.00054,1,1092940,1123138,+,30198
417,BUMA.1121.00097,1,945,31039,-,30094
417,BUMA.1121.00093,1,544481,574566,-,30085
417,BUMA.1121.00106,1,3725347,3755535,+,30188
417,BUMA.1121.00010,1,1024505,1054701,-,30196
417,BUMA.1121.00035,1,963049,993324,+,30275
417,BUMA.1121.00108,1,911537,941734,+,30197
417,BUMA.1121.00028,1,314386,344582,+,30196
417,BUMA.1121.00094,1,3961022,3991109,+,30087
417,BUMA.1121.00102,1,1303869,1334149,-,30280
417,BUMA.1121.00111,1,85066,115344,+,30278
417,BUMA.1121.00089,1,3947695,3977787,+,30092
417,BUMA.1121.00084,1,182017,212109,+,30092
417,BUMA.1121.00029,1,979773,1010048,-,30275
417,BUMA.1121.00012,1,2659146,2689425,+,30279
417,BUMA.1121.00087,1,359440,389635,+,30195
417,BUMA.1121.00043,1,4086760,4116760,+,30000
417,BUMA.1121.00046,1,1106819,1137017,+,30198
417,BUMA.1121.00037,1,2581343,2611618,+,30275
417,BUMA.1121.00080,1,3972426,4002612,+,30186
417,BUMA.1121.00079,1,4025650,4055836,+,30186
417,BUMA.1121.00045,1,97137,127334,-,30197
417,BUMA.1121.00071,1,3814937,3844937,+,30000
417,BUMA.1121.00056,1,3936099,3966192,-,30093
417,BUMA.1121.00065,1,3997579,4027869,+,30290
417,BUMA.1121.00058,1,559738,589806,-,30068
417,BUMA.1121.00007,1,97473,127488,-,30015
417,BUMA.1121.00067,1,432396,462575,-,30179
417,BUMA.1121.00090,1,2046024,2076303,+,30279
417,BUMA.1121.00051,1,3946259,3976350,+,30091
417,BUMA.1121.00020,1,314392,344588,+,30196
417,BUMA.1121.00103,1,375629,405631,-,30002
417,BUMA.1121.00048,1,2812659,2842857,-,30198
417,BUMA.1121.00047,1,2991469,3021562,-,30093
417,BUMA.1121.00042,1,70004,100202,-,30198
417,BUMA.1121.00055,1,3590494,3620586,+,30092
417,BUMA.1121.00031,1,1294889,1325152,+,30263
417,BUMA.1121.00040,1,576915,607113,-,30198
417,BUMA.1121.00044,1,3116386,3146582,+,30196
417,BUMA.1121.00088,1,808081,838363,+,30282
417,BUMA.1121.00069,1,3809972,3839972,+,30000
417,BUMA.1121.00064,1,3965580,3995778,+,30198
417,BUMA.1121.00105,1,1270625,1300629,-,30004
417,BUMA.1121.00015,1,3503797,3533995,-,30198
417,BUMA.1121.00059,1,3169811,3199961,+,30150
417,BUMA.1121.00026,1,1284415,1314613,+,30198
417,BUMA.1121.00022,1,601690,631884,-,30194
417,BUMA.1121.00052,1,222829,253027,+,30198
417,BUMA.1121.00101,1,2500990,2531177,-,30187
417,BUMA.1121.00001,1,103511,133787,-,30276
417,BUMA.1121.00038,1,3019960,3050158,-,30198
417,BUMA.1121.00068,1,2774038,2804042,+,30004
417,BUMA.1121.00099,1,2482390,2512503,-,30113
417,BUMA.1121.00091,1,548073,578066,-,29993
417,BUMA.1121.00098,1,2627470,2657470,+,30000
417,BUMA.1121.00013,1,702755,732953,-,30198
417,BUMA.1121.00049,1,1874733,1904922,-,30189
417,BUMA.1121.00072,1,3806999,3836999,+,30000
417,BUMA.1121.00076,1,1382959,1413148,-,30189
417,BUMA.1121.00083,1,1715489,1745490,-,30001
417,BUMA.1121.00078,1,2063073,2092783,-,29710
417,BUMA.1121.00095,1,1689629,1719637,-,30008
417,BUMA.1121.00077,1,2609783,2639787,+,30004
417,BUMA.1121.00063,1,3812225,3842225,+,30000
417,BUMA.1121.00061,1,3818978,3848978,+,30000
417,BUMA.1121.00050,1,1614710,1644908,-,30198
417,BUMA.1121.00081,1,3020159,3050357,-,30198
417,BUMA.1121.00074,1,101316,131514,-,30198
417,BUMA.1121.00062,1,602616,632617,-,30001
417,BUMA.1121.00060,1,2342321,2372518,-,30197
417,BUMA.1121.00070,1,3801384,3831384,+,30000
417,BUMA.1121.00075,1,3399076,3429263,+,30187
417,BUMA.1121.00041,1,1173639,1203930,+,30291
417,BUMA.1121.00073,1,3825620,3855620,+,30000
417,BUMA.1121.00017,1,314384,344580,+,30196
417,BUMA.1121.00066,1,3814283,3844283,+,30000
417,BUMA.1121.00107,1,3889763,3919764,+,30001
417,BUMA.1121.00085,1,3316635,3346833,+,30198
417,BUMA.1121.00030,1,314384,344580,+,30196
417,BUMA.1121.00112,1,3100789,3130988,-,30199
417,BUMA.1121.00002,1,1051178,1081374,-,30196
417,BUMA.1121.00082,1,4033881,4063881,+,30000
417,BUMA.1121.00014,1,2925296,2955564,-,30268
417,BUMA.1121.00011,1,1665011,1695001,-,29990
417,BUMA.1121.00019,1,314398,344594,+,30196
417,BUMA.1121.00057,1,1053616,1083802,+,30186
417,BUMA.1121.00018,1,440744,471023,+,30279
417,BUMA.1121.00039,1,30559,60841,+,30282
417,BUMA.1121.00016,1,2036212,2066198,+,29986
417,BUMA.1121.00004,1,314378,344574,+,30196
417,BUMA.1121.00005,1,3620525,3650518,-,29993
417,BUMA.1121.00100,1,1351214,1381308,-,30094
417,BUMA.1121.00006,1,3020044,3050242,-,30198
418,BUMA.1121.00027,1,2140114,2146937,+,6823
418,BUMA.1121.00025,1,2778366,2785184,-,6818
418,BUMA.1121.00021,1,590115,596927,+,6812
418,BUMA.1121.00023,1,2312517,2319336,+,6819
418,BUMA.1121.00024,1,348241,354948,+,6707
418,BUMA.1121.00033,1,2249829,2256648,+,6819
418,BUMA.1121.00034,1,348249,354956,+,6707
418,BUMA.1121.00036,1,3300271,3306978,+,6707
418,BUMA.1121.00032,1,1943655,1950362,+,6707
418,BUMA.1121.00009,1,1578517,1585327,-,6810
418,BUMA.1121.00008,1,348263,354970,+,6707
418,BUMA.1121.00003,1,2486926,2493749,+,6823
418,BUMA.1121.00109,1,1896703,1903525,-,6822
418,BUMA.1121.00053,1,3727271,3734094,+,6823
418,BUMA.1121.00110,1,833121,839943,-,6822
418,BUMA.1121.00104,1,1290243,1297065,-,6822
418,BUMA.1121.00086,1,2935891,2942597,-,6706
418,BUMA.1121.00092,1,4085702,4092500,+,6798
418,BUMA.1121.00096,1,3289533,3296344,-,6811
418,BUMA.1121.00054,1,1126806,1133516,+,6710
418,BUMA.1121.00097,1,4058429,4065250,-,6821
418,BUMA.1121.00093,1,534004,540801,-,6797
418,BUMA.1121.00106,1,3759215,3766038,+,6823
418,BUMA.1121.00010,1,1014130,1020836,-,6706
418,BUMA.1121.00035,1,997004,1003821,+,6817
418,BUMA.1121.00108,1,945382,952205,+,6823
418,BUMA.1121.00028,1,348250,354957,+,6707
418,BUMA.1121.00094,1,3994790,4001609,+,6819
418,BUMA.1121.00102,1,1293393,1300189,-,6796
418,BUMA.1121.00111,1,119025,125837,+,6812
418,BUMA.1121.00089,1,3981468,3988287,+,6819
418,BUMA.1121.00084,1,215789,222612,+,6823
418,BUMA.1121.00029,1,969275,976093,-,6818
418,BUMA.1121.00012,1,2693103,2699922,+,6819
418,BUMA.1121.00087,1,393303,400010,+,6707
418,BUMA.1121.00043,1,4120441,4127253,+,6812
418,BUMA.1121.00046,1,1140685,1147395,+,6710
418,BUMA.1121.00037,1,2615299,2622118,+,6819
418,BUMA.1121.00080,1,4006293,4013105,+,6812
418,BUMA.1121.00079,1,4059516,4066328,+,6812
418,BUMA.1121.00045,1,86635,93457,-,6822
418,BUMA.1121.00071,1,3848618,3855430,+,6812
418,BUMA.1121.00056,1,3925600,3932418,-,6818
418,BUMA.1121.00065,1,4031538,4038336,+,6798
418,BUMA.1121.00058,1,549261,556058,-,6797
418,BUMA.1121.00007,1,86971,93793,-,6822
418,BUMA.1121.00067,1,421905,428716,-,6811
418,BUMA.1121.00090,1,2079992,2086803,+,6811
418,BUMA.1121.00051,1,3980030,3986840,+,6810
418,BUMA.1121.00020,1,348256,354963,+,6707
418,BUMA.1121.00103,1,365114,371948,-,6834
418,BUMA.1121.00048,1,2802281,2808990,-,6709
418,BUMA.1121.00047,1,2980979,2987788,-,6809
418,BUMA.1121.00042,1,58389,65081,-,6692
418,BUMA.1121.00055,1,3624265,3631077,+,6812
418,BUMA.1121.00031,1,1328833,1335674,+,6841
418,BUMA.1121.00040,1,566540,573246,-,6706
418,BUMA.1121.00044,1,3150250,3156957,+,6707
418,BUMA.1121.00088,1,842043,848866,+,6823
418,BUMA.1121.00069,1,3843653,3850465,+,6812
418,BUMA.1121.00064,1,3999447,4006259,+,6812
418,BUMA.1121.00105,1,1260123,1266945,-,6822
418,BUMA.1121.00015,1,3493419,3500128,-,6709
418,BUMA.1121.00059,1,3203641,3210427,+,6786
418,BUMA.1121.00026,1,1319568,1326228,+,6660
418,BUMA.1121.00022,1,591315,598021,-,6706
418,BUMA.1121.00052,1,256695,263402,+,6707
418,BUMA.1121.00101,1,2490487,2497309,-,6822
418,BUMA.1121.00001,1,93013,99831,-,6818
418,BUMA.1121.00038,1,3009582,3016291,-,6709
418,BUMA.1121.00068,1,2807710,2814511,+,6801
418,BUMA.1121.00099,1,2471886,2478708,-,6822
418,BUMA.1121.00091,1,537581,544392,-,6811
418,BUMA.1121.00098,1,2661149,2667971,+,6822
418,BUMA.1121.00013,1,692380,699086,-,6706
418,BUMA.1121.00049,1,1864231,1871053,-,6822
418,BUMA.1121.00072,1,3840680,3847492,+,6812
418,BUMA.1121.00076,1,1372457,1379279,-,6822
418,BUMA.1121.00083,1,1704997,1711808,-,6811
418,BUMA.1121.00078,1,2052584,2059392,-,6808
418,BUMA.1121.00095,1,1679114,1685948,-,6834
418,BUMA.1121.00077,1,2643456,2650275,+,6819
418,BUMA.1121.00063,1,3845906,3852718,+,6812
418,BUMA.1121.00061,1,3852659,3859471,+,6812
418,BUMA.1121.00050,1,1604332,1611041,-,6709
418,BUMA.1121.00081,1,3009781,3016490,-,6709
418,BUMA.1121.00074,1,90835,97646,-,6811
418,BUMA.1121.00062,1,592113,598935,-,6822
418,BUMA.1121.00060,1,2331819,2338641,-,6822
418,BUMA.1121.00070,1,3835065,3841877,+,6812
418,BUMA.1121.00075,1,3432943,3439766,+,6823
418,BUMA.1121.00041,1,1207598,1214421,+,6823
418,BUMA.1121.00073,1,3859301,3866113,+,6812
418,BUMA.1121.00017,1,348248,354955,+,6707
418,BUMA.1121.00066,1,3847963,3854775,+,6812
418,BUMA.1121.00107,1,3923445,3930268,+,6823
418,BUMA.1121.00085,1,3350501,3357208,+,6707
418,BUMA.1121.00030,1,348248,354955,+,6707
418,BUMA.1121.00112,1,3090286,3097108,-,6822
418,BUMA.1121.00002,1,1040803,1047509,-,6706
418,BUMA.1121.00082,1,4067562,4074374,+,6812
418,BUMA.1121.00014,1,2914775,2921615,-,6840
418,BUMA.1121.00011,1,1654509,1661331,-,6822
418,BUMA.1121.00019,1,348262,354969,+,6707
418,BUMA.1121.00057,1,1087483,1094295,+,6812
418,BUMA.1121.00018,1,474704,481523,+,6819
418,BUMA.1121.00039,1,64522,71341,+,6819
418,BUMA.1121.00016,1,2069879,2076667,+,6788
418,BUMA.1121.00004,1,348242,354949,+,6707
418,BUMA.1121.00005,1,3610013,3616847,-,6834
418,BUMA.1121.00100,1,1340711,1347533,-,6822
418,BUMA.1121.00006,1,3009666,3016375,-,6709
419,BUMA.1121.00027,1,2147106,2152892,+,5786
419,BUMA.1121.00025,1,2772409,2778197,-,5788
419,BUMA.1121.00021,1,597096,602873,+,5777
419,BUMA.1121.00023,1,2319505,2325291,+,5786
419,BUMA.1121.00024,1,355117,360919,+,5802
419,BUMA.1121.00033,1,2256817,2262603,+,5786
419,BUMA.1121.00034,1,355125,360927,+,5802
419,BUMA.1121.00036,1,3307147,3312949,+,5802
419,BUMA.1121.00032,1,1950531,1956333,+,5802
419,BUMA.1121.00009,1,1572570,1578348,-,5778
419,BUMA.1121.00008,1,355139,360941,+,5802
419,BUMA.1121.00003,1,2493918,2499695,+,5777
419,BUMA.1121.00109,1,1890747,1896534,-,5787
419,BUMA.1121.00053,1,3734263,3740048,+,5785
419,BUMA.1121.00110,1,827156,832952,-,5796
419,BUMA.1121.00104,1,1284287,1290074,-,5787
419,BUMA.1121.00086,1,2929920,2935722,-,5802
419,BUMA.1121.00092,1,1,5787,+,5786
419,BUMA.1121.00096,1,3283577,3289364,-,5787
419,BUMA.1121.00054,1,1133685,1139487,+,5802
419,BUMA.1121.00097,1,4052473,4058260,-,5787
419,BUMA.1121.00093,1,528048,533835,-,5787
419,BUMA.1121.00106,1,3766207,3771993,+,5786
419,BUMA.1121.00010,1,1008159,1013961,-,5802
419,BUMA.1121.00035,1,1003990,1009776,+,5786
419,BUMA.1121.00108,1,952373,958175,+,5802
419,BUMA.1121.00028,1,355126,360928,+,5802
419,BUMA.1121.00094,1,1,5787,+,5786
419,BUMA.1121.00102,1,1287437,1293224,-,5787
419,BUMA.1121.00111,1,126006,131783,+,5777
419,BUMA.1121.00089,1,1,5787,+,5786
419,BUMA.1121.00084,1,222781,228567,+,5786
419,BUMA.1121.00029,1,963319,969106,-,5787
419,BUMA.1121.00012,1,2700091,2705877,+,5786
419,BUMA.1121.00087,1,400179,405981,+,5802
419,BUMA.1121.00043,1,4127422,4133207,+,5785
419,BUMA.1121.00046,1,1147564,1153366,+,5802
419,BUMA.1121.00037,1,2622287,2628073,+,5786
419,BUMA.1121.00080,1,1,5787,+,5786
419,BUMA.1121.00079,1,1,5787,+,5786
419,BUMA.1121.00045,1,80679,86466,-,5787
419,BUMA.1121.00071,1,1,5787,+,5786
419,BUMA.1121.00056,1,3919644,3925431,-,5787
419,BUMA.1121.00065,1,1,5786,+,5785
419,BUMA.1121.00058,1,543305,549092,-,5787
419,BUMA.1121.00007,1,81015,86802,-,5787
419,BUMA.1121.00067,1,415949,421736,-,5787
419,BUMA.1121.00090,1,2086972,2092758,+,5786
419,BUMA.1121.00051,1,1,5787,+,5786
419,BUMA.1121.00020,1,355132,360934,+,5802
419,BUMA.1121.00103,1,359159,364945,-,5786
419,BUMA.1121.00048,1,2796310,2802112,-,5802
419,BUMA.1121.00047,1,2975023,2980810,-,5787
419,BUMA.1121.00042,1,52418,58220,-,5802
419,BUMA.1121.00055,1,3631246,3637048,+,5802
419,BUMA.1121.00031,1,1335843,1341629,+,5786
419,BUMA.1121.00040,1,560569,566371,-,5802
419,BUMA.1121.00044,1,3157126,3162928,+,5802
419,BUMA.1121.00088,1,849035,854821,+,5786
419,BUMA.1121.00069,1,1,5787,+,5786
419,BUMA.1121.00064,1,1,5787,+,5786
419,BUMA.1121.00105,1,1254167,1259954,-,5787
419,BUMA.1121.00015,1,3487448,3493250,-,5802
419,BUMA.1121.00059,1,3210596,3216382,+,5786
419,BUMA.1121.00026,1,1326397,1332199,+,5802
419,BUMA.1121.00022,1,585344,591146,-,5802
419,BUMA.1121.00052,1,263571,269364,+,5793
419,BUMA.1121.00101,1,2484531,2490318,-,5787
419,BUMA.1121.00001,1,87057,92844,-,5787
419,BUMA.1121.00038,1,3003611,3009413,-,5802
419,BUMA.1121.00068,1,2814680,2820457,+,5777
419,BUMA.1121.00099,1,2465931,2471718,-,5787
419,BUMA.1121.00091,1,531625,537412,-,5787
419,BUMA.1121.00098,1,2668140,2673942,+,5802
419,BUMA.1121.00013,1,686418,692211,-,5793
419,BUMA.1121.00049,1,1858275,1864062,-,5787
419,BUMA.1121.00072,1,1,5787,+,5786
419,BUMA.1121.00076,1,1366501,1372288,-,5787
419,BUMA.1121.00083,1,1699041,1704828,-,5787
419,BUMA.1121.00078,1,2046628,2052415,-,5787
419,BUMA.1121.00095,1,1673159,1678945,-,5786
419,BUMA.1121.00077,1,2650443,2656238,+,5795
419,BUMA.1121.00063,1,1,5787,+,5786
419,BUMA.1121.00061,1,1,5787,+,5786
419,BUMA.1121.00050,1,1598361,1604163,-,5802
419,BUMA.1121.00081,1,3003810,3009612,-,5802
419,BUMA.1121.00074,1,84879,90666,-,5787
419,BUMA.1121.00062,1,586157,591944,-,5787
419,BUMA.1121.00060,1,2325863,2331650,-,5787
419,BUMA.1121.00070,1,1,5787,+,5786
419,BUMA.1121.00075,1,3439935,3445721,+,5786
419,BUMA.1121.00041,1,1214590,1220376,+,5786
419,BUMA.1121.00073,1,1,5787,+,5786
419,BUMA.1121.00017,1,355124,360926,+,5802
419,BUMA.1121.00066,1,1,5787,+,5786
419,BUMA.1121.00107,1,3930437,3936223,+,5786
419,BUMA.1121.00085,1,3357377,3363170,+,5793
419,BUMA.1121.00030,1,355124,360926,+,5802
419,BUMA.1121.00112,1,3084330,3090117,-,5787
419,BUMA.1121.00002,1,1034832,1040634,-,5802
419,BUMA.1121.00082,1,1,5787,+,5786
419,BUMA.1121.00014,1,2908819,2914606,-,5787
419,BUMA.1121.00011,1,1648553,1654340,-,5787
419,BUMA.1121.00019,1,355138,360940,+,5802
419,BUMA.1121.00057,1,1094464,1100250,+,5786
419,BUMA.1121.00018,1,481692,487478,+,5786
419,BUMA.1121.00039,1,71510,77296,+,5786
419,BUMA.1121.00016,1,2078179,2083965,+,5786
419,BUMA.1121.00004,1,355118,360920,+,5802
419,BUMA.1121.00005,1,3604057,3609844,-,5787
419,BUMA.1121.00100,1,1334755,1340542,-,5787
419,BUMA.1121.00006,1,3003695,3009497,-,5802
420,BUMA.1121.00027,1,2152894,2159740,+,6846
420,BUMA.1121.00025,1,2765561,2772408,-,6847
420,BUMA.1121.00021,1,602875,609721,+,6846
420,BUMA.1121.00023,1,2325293,2332139,+,6846
420,BUMA.1121.00024,1,613690,620533,-,6843
420,BUMA.1121.00033,1,2262605,2269451,+,6846
420,BUMA.1121.00034,1,613693,620536,-,6843
420,BUMA.1121.00034,1,716010,722853,-,6843
420,BUMA.1121.00036,1,104716,111559,-,6843
420,BUMA.1121.00032,1,2042052,2048895,+,6843
420,BUMA.1121.00009,1,1565722,1572569,-,6847
420,BUMA.1121.00008,1,613712,620555,-,6843
420,BUMA.1121.00003,1,2499697,2506543,+,6846
420,BUMA.1121.00109,1,1883899,1890746,-,6847
420,BUMA.1121.00053,1,3740050,3746896,+,6846
420,BUMA.1121.00110,1,820308,827155,-,6847
420,BUMA.1121.00104,1,1277439,1284286,-,6847
420,BUMA.1121.00086,1,2623577,2630420,+,6843
420,BUMA.1121.00092,1,5789,12635,+,6846
420,BUMA.1121.00096,1,3276729,3283576,-,6847
420,BUMA.1121.00054,1,1263385,1270228,+,6843
420,BUMA.1121.00097,1,4045625,4052472,-,6847
420,BUMA.1121.00093,1,521200,528047,-,6847
420,BUMA.1121.00106,1,3771995,3778841,+,6846
420,BUMA.1121.00010,1,1227414,1234256,+,6842
420,BUMA.1121.00035,1,1009778,1016624,+,6846
420,BUMA.1121.00108,1,959756,966602,+,6846
420,BUMA.1121.00028,1,613699,620542,-,6843
420,BUMA.1121.00094,1,5789,12633,+,6844
420,BUMA.1121.00102,1,1280589,1287436,-,6847
420,BUMA.1121.00111,1,131785,138631,+,6846
420,BUMA.1121.00089,1,5789,12635,+,6846
420,BUMA.1121.00084,1,228569,235415,+,6846
420,BUMA.1121.00029,1,956471,963318,-,6847
420,BUMA.1121.00012,1,2705879,2712725,+,6846
420,BUMA.1121.00087,1,705197,712040,-,6843
420,BUMA.1121.00043,1,4133209,4140055,+,6846
420,BUMA.1121.00046,1,927068,933911,-,6843
420,BUMA.1121.00037,1,2628075,2634921,+,6846
420,BUMA.1121.00080,1,5789,12635,+,6846
420,BUMA.1121.00079,1,5789,12635,+,6846
420,BUMA.1121.00045,1,73849,80678,-,6829
420,BUMA.1121.00071,1,5789,12635,+,6846
420,BUMA.1121.00056,1,3912796,3919643,-,6847
420,BUMA.1121.00065,1,5788,12634,+,6846
420,BUMA.1121.00058,1,536457,543304,-,6847
420,BUMA.1121.00007,1,74167,81014,-,6847
420,BUMA.1121.00067,1,409101,415948,-,6847
420,BUMA.1121.00090,1,2092760,2099606,+,6846
420,BUMA.1121.00051,1,5789,12635,+,6846
420,BUMA.1121.00020,1,613705,620548,-,6843
420,BUMA.1121.00103,1,352311,359158,-,6847
420,BUMA.1121.00048,1,2665569,2672412,-,6843
420,BUMA.1121.00047,1,2968175,2975022,-,6847
420,BUMA.1121.00042,1,3451814,3458658,+,6844
420,BUMA.1121.00055,1,3638629,3645475,+,6846
420,BUMA.1121.00031,1,1341631,1348481,+,6850
420,BUMA.1121.00040,1,186053,192895,-,6842
420,BUMA.1121.00044,1,3415699,3422542,-,6843
420,BUMA.1121.00088,1,854823,861669,+,6846
420,BUMA.1121.00069,1,5789,12635,+,6846
420,BUMA.1121.00064,1,5789,12635,+,6846
420,BUMA.1121.00105,1,1247319,1254166,-,6847
420,BUMA.1121.00015,1,327532,334375,+,6843
420,BUMA.1121.00059,1,3216384,3223230,+,6846
420,BUMA.1121.00026,1,1426967,1433811,-,6844
420,BUMA.1121.00022,1,820849,827692,-,6843
420,BUMA.1121.00052,1,378958,385801,-,6843
420,BUMA.1121.00101,1,2477701,2484530,-,6829
420,BUMA.1121.00001,1,80209,87056,-,6847
420,BUMA.1121.00038,1,2872869,2879712,-,6843
420,BUMA.1121.00068,1,2820459,2827305,+,6846
420,BUMA.1121.00099,1,2459101,2465930,-,6829
420,BUMA.1121.00091,1,524777,531624,-,6847
420,BUMA.1121.00098,1,2675524,2682370,+,6846
420,BUMA.1121.00013,1,569987,576830,+,6843
420,BUMA.1121.00049,1,1851427,1858274,-,6847
420,BUMA.1121.00072,1,5789,12635,+,6846
420,BUMA.1121.00076,1,1359653,1366500,-,6847
420,BUMA.1121.00083,1,1692193,1699040,-,6847
420,BUMA.1121.00078,1,2039780,2046627,-,6847
420,BUMA.1121.00095,1,1666311,1673158,-,6847
420,BUMA.1121.00077,1,2656240,2663084,+,6844
420,BUMA.1121.00063,1,5789,12635,+,6846
420,BUMA.1121.00061,1,5789,12635,+,6846
420,BUMA.1121.00050,1,1817940,1824783,+,6843
420,BUMA.1121.00081,1,2873068,2879911,-,6843
420,BUMA.1121.00074,1,78031,84878,-,6847
420,BUMA.1121.00062,1,579309,586156,-,6847
420,BUMA.1121.00060,1,2319033,2325862,-,6829
420,BUMA.1121.00070,1,5789,12635,+,6846
420,BUMA.1121.00075,1,3445723,3452569,+,6846
420,BUMA.1121.00041,1,1220378,1227224,+,6846
420,BUMA.1121.00073,1,5789,12635,+,6846
420,BUMA.1121.00017,1,613697,620540,-,6843
420,BUMA.1121.00066,1,5789,12635,+,6846
420,BUMA.1121.00107,1,3936225,3943070,+,6845
420,BUMA.1121.00085,1,3472754,3479597,-,6843
420,BUMA.1121.00030,1,613697,620540,-,6843
420,BUMA.1121.00112,1,3077482,3084329,-,6847
420,BUMA.1121.00002,1,1254099,1260941,+,6842
420,BUMA.1121.00082,1,5789,12635,+,6846
420,BUMA.1121.00014,1,2901971,2908818,-,6847
420,BUMA.1121.00011,1,1641724,1648552,-,6828
420,BUMA.1121.00019,1,613711,620554,-,6843
420,BUMA.1121.00057,1,1100252,1107098,+,6846
420,BUMA.1121.00018,1,487480,494326,+,6846
420,BUMA.1121.00039,1,77298,84144,+,6846
420,BUMA.1121.00016,1,2083967,2090813,+,6846
420,BUMA.1121.00004,1,613691,620534,-,6843
420,BUMA.1121.00005,1,3597209,3604056,-,6847
420,BUMA.1121.00100,1,1327919,1334754,-,6835
420,BUMA.1121.00006,1,2872953,2879796,-,6843
421,BUMA.1121.00027,1,2159742,2167408,+,7666
421,BUMA.1121.00025,1,2757894,2765560,-,7666
421,BUMA.1121.00021,1,609723,617389,+,7666
421,BUMA.1121.00023,1,2332141,2339807,+,7666
421,BUMA.1121.00024,1,606023,613689,-,7666
421,BUMA.1121.00033,1,2269453,2277119,+,7666
421,BUMA.1121.00034,1,606026,613692,-,7666
421,BUMA.1121.00034,1,708343,716009,-,7666
421,BUMA.1121.00036,1,97049,104715,-,7666
421,BUMA.1121.00032,1,2048897,2056563,+,7666
421,BUMA.1121.00009,1,1558055,1565721,-,7666
421,BUMA.1121.00008,1,606045,613711,-,7666
421,BUMA.1121.00003,1,2506545,2514204,+,7659
421,BUMA.1121.00109,1,1876244,1883898,-,7654
421,BUMA.1121.00053,1,3746898,3754552,+,7654
421,BUMA.1121.00110,1,812641,820307,-,7666
421,BUMA.1121.00104,1,1269777,1277438,-,7661
421,BUMA.1121.00086,1,2630422,2638088,+,7666
421,BUMA.1121.00092,1,12637,20303,+,7666
421,BUMA.1121.00096,1,3269059,3276728,-,7669
421,BUMA.1121.00054,1,1270230,1277896,+,7666
421,BUMA.1121.00097,1,4037958,4045624,-,7666
421,BUMA.1121.00093,1,513533,521199,-,7666
421,BUMA.1121.00106,1,3778843,3786509,+,7666
421,BUMA.1121.00010,1,1234258,1241924,+,7666
421,BUMA.1121.00035,1,1016626,1024292,+,7666
421,BUMA.1121.00108,1,966604,974270,+,7666
421,BUMA.1121.00028,1,606032,613698,-,7666
421,BUMA.1121.00094,1,12635,20301,+,7666
421,BUMA.1121.00102,1,1272922,1280588,-,7666
421,BUMA.1121.00111,1,138633,146299,+,7666
421,BUMA.1121.00089,1,12637,20303,+,7666
421,BUMA.1121.00084,1,235417,243083,+,7666
421,BUMA.1121.00029,1,948804,956470,-,7666
421,BUMA.1121.00012,1,2712727,2720393,+,7666
421,BUMA.1121.00087,1,697641,705196,-,7555
421,BUMA.1121.00043,1,4140057,4147723,+,7666
421,BUMA.1121.00046,1,919401,927067,-,7666
421,BUMA.1121.00037,1,2634923,2642589,+,7666
421,BUMA.1121.00080,1,12637,20303,+,7666
421,BUMA.1121.00079,1,12637,20303,+,7666
421,BUMA.1121.00045,1,66182,73848,-,7666
421,BUMA.1121.00071,1,12637,20299,+,7662
421,BUMA.1121.00056,1,3905129,3912795,-,7666
421,BUMA.1121.00065,1,12636,20302,+,7666
421,BUMA.1121.00058,1,528790,536456,-,7666
421,BUMA.1121.00007,1,66500,74166,-,7666
421,BUMA.1121.00067,1,401434,409100,-,7666
421,BUMA.1121.00090,1,2099608,2107274,+,7666
421,BUMA.1121.00051,1,12637,20303,+,7666
421,BUMA.1121.00020,1,606038,613704,-,7666
421,BUMA.1121.00103,1,344644,352310,-,7666
421,BUMA.1121.00048,1,2657902,2665568,-,7666
421,BUMA.1121.00047,1,2960508,2968174,-,7666
421,BUMA.1121.00042,1,3458660,3466300,+,7640
421,BUMA.1121.00055,1,3645477,3653143,+,7666
421,BUMA.1121.00031,1,1348483,1356149,+,7666
421,BUMA.1121.00040,1,178386,186052,-,7666
421,BUMA.1121.00044,1,3408032,3415698,-,7666
421,BUMA.1121.00044,1,3510365,3517959,-,7594
421,BUMA.1121.00088,1,861671,869337,+,7666
421,BUMA.1121.00069,1,12637,20303,+,7666
421,BUMA.1121.00064,1,12637,20303,+,7666
421,BUMA.1121.00105,1,1239652,1247318,-,7666
421,BUMA.1121.00015,1,334377,342043,+,7666
421,BUMA.1121.00059,1,3223232,3230898,+,7666
421,BUMA.1121.00026,1,1419326,1426966,-,7640
421,BUMA.1121.00022,1,813190,820848,-,7658
421,BUMA.1121.00052,1,371291,378957,-,7666
421,BUMA.1121.00101,1,2469907,2477700,-,7793
421,BUMA.1121.00001,1,72542,80208,-,7666
421,BUMA.1121.00038,1,2865202,2872868,-,7666
421,BUMA.1121.00068,1,2827307,2834973,+,7666
421,BUMA.1121.00099,1,2451428,2459100,-,7672
421,BUMA.1121.00091,1,517122,524776,-,7654
421,BUMA.1121.00098,1,2682372,2690038,+,7666
421,BUMA.1121.00013,1,576832,584498,+,7666
421,BUMA.1121.00049,1,1843760,1851426,-,7666
421,BUMA.1121.00072,1,12637,20303,+,7666
421,BUMA.1121.00076,1,1352000,1359652,-,7652
421,BUMA.1121.00083,1,1684526,1692192,-,7666
421,BUMA.1121.00078,1,2032113,2039779,-,7666
421,BUMA.1121.00095,1,1658652,1666310,-,7658
421,BUMA.1121.00077,1,2663086,2670752,+,7666
421,BUMA.1121.00063,1,12637,20299,+,7662
421,BUMA.1121.00061,1,12637,20303,+,7666
421,BUMA.1121.00050,1,1824785,1832451,+,7666
421,BUMA.1121.00081,1,2865401,2873067,-,7666
421,BUMA.1121.00074,1,70364,78030,-,7666
421,BUMA.1121.00062,1,571642,579308,-,7666
421,BUMA.1121.00060,1,2311366,2319032,-,7666
421,BUMA.1121.00070,1,12637,20303,+,7666
421,BUMA.1121.00075,1,3452571,3460174,+,7603
421,BUMA.1121.00041,1,1227226,1234892,+,7666
421,BUMA.1121.00073,1,12637,20303,+,7666
421,BUMA.1121.00017,1,606030,613696,-,7666
421,BUMA.1121.00066,1,12637,20303,+,7666
421,BUMA.1121.00107,1,3943072,3950726,+,7654
421,BUMA.1121.00085,1,3465087,3472753,-,7666
421,BUMA.1121.00030,1,606030,613696,-,7666
421,BUMA.1121.00112,1,3069836,3077481,-,7645
421,BUMA.1121.00002,1,1260943,1268609,+,7666
421,BUMA.1121.00082,1,12637,20303,+,7666
421,BUMA.1121.00014,1,2894304,2901970,-,7666
421,BUMA.1121.00011,1,1634057,1641723,-,7666
421,BUMA.1121.00019,1,606044,613710,-,7666
421,BUMA.1121.00057,1,1107100,1114766,+,7666
421,BUMA.1121.00018,1,494328,501994,+,7666
421,BUMA.1121.00039,1,84146,91812,+,7666
421,BUMA.1121.00016,1,2090815,2098481,+,7666
421,BUMA.1121.00004,1,606024,613690,-,7666
421,BUMA.1121.00005,1,3589542,3597208,-,7666
421,BUMA.1121.00100,1,1320249,1327918,-,7669
421,BUMA.1121.00006,1,2865286,2872952,-,7666
422,BUMA.1121.00027,1,2167409,2173196,+,5787
422,BUMA.1121.00025,1,2752067,2757838,-,5771
422,BUMA.1121.00021,1,617390,623209,+,5819
422,BUMA.1121.00023,1,2339808,2345690,+,5882
422,BUMA.1121.00024,1,600233,605995,-,5762
422,BUMA.1121.00033,1,2277120,2282918,+,5798
422,BUMA.1121.00034,1,600241,605998,-,5757
422,BUMA.1121.00034,1,702561,708315,-,5754
422,BUMA.1121.00036,1,91238,97000,-,5762
422,BUMA.1121.00032,1,2056570,2062353,+,5783
422,BUMA.1121.00009,1,1552285,1558053,-,5768
422,BUMA.1121.00008,1,600255,606017,-,5762
422,BUMA.1121.00003,1,2514206,2519969,+,5763
422,BUMA.1121.00109,1,1870398,1876160,-,5762
422,BUMA.1121.00053,1,3754580,3760418,+,5838
422,BUMA.1121.00110,1,806814,812585,-,5771
422,BUMA.1121.00104,1,1262732,1268488,-,5756
422,BUMA.1121.00086,1,2638095,2643885,+,5790
422,BUMA.1121.00092,1,20304,26099,+,5795
422,BUMA.1121.00096,1,3263241,3269003,-,5762
422,BUMA.1121.00054,1,1277903,1283826,+,5923
422,BUMA.1121.00097,1,4032147,4037909,-,5762
422,BUMA.1121.00093,1,507737,513498,-,5761
422,BUMA.1121.00106,1,3786544,3792339,+,5795
422,BUMA.1121.00010,1,1241925,1247735,+,5810
422,BUMA.1121.00035,1,1024293,1030140,+,5847
422,BUMA.1121.00108,1,974271,980089,+,5818
422,BUMA.1121.00028,1,600242,606004,-,5762
422,BUMA.1121.00094,1,20308,26112,+,5804
422,BUMA.1121.00102,1,1267030,1272782,-,5752
422,BUMA.1121.00111,1,146331,152073,+,5742
422,BUMA.1121.00089,1,20310,26105,+,5795
422,BUMA.1121.00084,1,243084,248836,+,5752
422,BUMA.1121.00029,1,942984,948755,-,5771
422,BUMA.1121.00012,1,2720394,2726241,+,5847
422,BUMA.1121.00087,1,691844,697606,-,5762
422,BUMA.1121.00043,1,4147724,4153564,+,5840
422,BUMA.1121.00046,1,913541,919303,-,5762
422,BUMA.1121.00037,1,2642590,2648463,+,5873
422,BUMA.1121.00080,1,20304,26140,+,5836
422,BUMA.1121.00079,1,20304,26265,+,5961
422,BUMA.1121.00045,1,60399,66154,-,5755
422,BUMA.1121.00071,1,20300,26125,+,5825
422,BUMA.1121.00056,1,3899327,3905080,-,5753
422,BUMA.1121.00065,1,20358,26173,+,5815
422,BUMA.1121.00058,1,522946,528699,-,5753
422,BUMA.1121.00007,1,60732,66493,-,5761
422,BUMA.1121.00067,1,395572,401343,-,5771
422,BUMA.1121.00090,1,2107275,2113115,+,5840
422,BUMA.1121.00051,1,20304,26154,+,5850
422,BUMA.1121.00020,1,600248,606010,-,5762
422,BUMA.1121.00103,1,338833,344637,-,5804
422,BUMA.1121.00048,1,2651965,2657727,-,5762
422,BUMA.1121.00047,1,2954678,2960431,-,5753
422,BUMA.1121.00042,1,3466301,3472076,+,5775
422,BUMA.1121.00055,1,3653171,3659000,+,5829
422,BUMA.1121.00031,1,1356258,1362007,+,5749
422,BUMA.1121.00040,1,172533,178295,-,5762
422,BUMA.1121.00044,1,3402242,3408004,-,5762
422,BUMA.1121.00044,1,3504575,3510337,-,5762
422,BUMA.1121.00088,1,869365,875181,+,5816
422,BUMA.1121.00069,1,20304,26129,+,5825
422,BUMA.1121.00064,1,20304,26165,+,5861
422,BUMA.1121.00105,1,1233835,1239596,-,5761
422,BUMA.1121.00015,1,342050,347924,+,5874
422,BUMA.1121.00059,1,3230899,3236722,+,5823
422,BUMA.1121.00026,1,1413529,1419291,-,5762
422,BUMA.1121.00022,1,807378,813140,-,5762
422,BUMA.1121.00052,1,365494,371256,-,5762
422,BUMA.1121.00101,1,2464065,2469816,-,5751
422,BUMA.1121.00001,1,66659,72430,-,5771
422,BUMA.1121.00038,1,2859265,2865027,-,5762
422,BUMA.1121.00068,1,2834974,2840834,+,5860
422,BUMA.1121.00099,1,2445596,2451358,-,5762
422,BUMA.1121.00091,1,511332,517094,-,5762
422,BUMA.1121.00098,1,2690045,2695835,+,5790
422,BUMA.1121.00013,1,584505,590288,+,5783
422,BUMA.1121.00049,1,1838012,1843725,-,5713
422,BUMA.1121.00072,1,20304,26129,+,5825
422,BUMA.1121.00076,1,1344920,1350676,-,5756
422,BUMA.1121.00083,1,1678700,1684491,-,5791
422,BUMA.1121.00078,1,2026293,2032057,-,5764
422,BUMA.1121.00095,1,1652741,1658512,-,5771
422,BUMA.1121.00077,1,2670753,2676579,+,5826
422,BUMA.1121.00063,1,20300,26122,+,5822
422,BUMA.1121.00061,1,20310,26129,+,5819
422,BUMA.1121.00050,1,1832458,1838311,+,5853
422,BUMA.1121.00081,1,2859464,2865226,-,5762
422,BUMA.1121.00074,1,64523,70294,-,5771
422,BUMA.1121.00062,1,565796,571558,-,5762
422,BUMA.1121.00060,1,2305590,2311345,-,5755
422,BUMA.1121.00070,1,20310,26129,+,5819
422,BUMA.1121.00075,1,3461393,3467282,+,5889
422,BUMA.1121.00041,1,1234899,1240751,+,5852
422,BUMA.1121.00073,1,20310,26129,+,5819
422,BUMA.1121.00017,1,600240,606002,-,5762
422,BUMA.1121.00066,1,20310,26129,+,5819
422,BUMA.1121.00107,1,3950733,3956570,+,5837
422,BUMA.1121.00085,1,3459290,3465052,-,5762
422,BUMA.1121.00030,1,600240,606002,-,5762
422,BUMA.1121.00112,1,3064054,3069795,-,5741
422,BUMA.1121.00002,1,1268610,1274560,+,5950
422,BUMA.1121.00082,1,20304,26129,+,5825
422,BUMA.1121.00014,1,2888509,2894258,-,5749
422,BUMA.1121.00011,1,1628248,1634022,-,5774
422,BUMA.1121.00019,1,600254,606016,-,5762
422,BUMA.1121.00057,1,1114767,1120575,+,5808
422,BUMA.1121.00018,1,502015,507821,+,5806
422,BUMA.1121.00039,1,91813,97667,+,5854
422,BUMA.1121.00016,1,2098482,2104301,+,5819
422,BUMA.1121.00004,1,600234,605996,-,5762
422,BUMA.1121.00005,1,3583671,3589423,-,5752
422,BUMA.1121.00100,1,1314417,1320179,-,5762
422,BUMA.1121.00006,1,2859349,2865111,-,5762
423,BUMA.1121.00027,1,2173395,2178259,+,4864
423,BUMA.1121.00025,1,2747012,2751868,-,4856
423,BUMA.1121.00021,1,623408,628264,+,4856
423,BUMA.1121.00023,1,2345889,2350745,+,4856
423,BUMA.1121.00024,1,595192,600034,-,4842
423,BUMA.1121.00033,1,2283117,2287971,+,4854
423,BUMA.1121.00034,1,595200,600042,-,4842
423,BUMA.1121.00034,1,697520,702362,-,4842
423,BUMA.1121.00036,1,86197,91039,-,4842
423,BUMA.1121.00032,1,2062552,2067393,+,4841
423,BUMA.1121.00009,1,1547216,1552086,-,4870
423,BUMA.1121.00008,1,595214,600056,-,4842
423,BUMA.1121.00003,1,2520168,2525020,+,4852
423,BUMA.1121.00109,1,1865329,1870199,-,4870
423,BUMA.1121.00053,1,3760617,3765455,+,4838
423,BUMA.1121.00110,1,801738,806615,-,4877
423,BUMA.1121.00104,1,1257660,1262533,-,4873
423,BUMA.1121.00086,1,2644084,2648925,+,4841
423,BUMA.1121.00092,1,26298,31136,+,4838
423,BUMA.1121.00096,1,3258175,3263042,-,4867
423,BUMA.1121.00054,1,1284025,1288897,+,4872
423,BUMA.1121.00097,1,4027077,4031948,-,4871
423,BUMA.1121.00093,1,502700,507538,-,4838
423,BUMA.1121.00106,1,3792538,3797411,+,4873
423,BUMA.1121.00010,1,1247934,1252805,+,4871
423,BUMA.1121.00035,1,1030339,1035195,+,4856
423,BUMA.1121.00108,1,980288,985124,+,4836
423,BUMA.1121.00028,1,595201,600043,-,4842
423,BUMA.1121.00094,1,26311,31177,+,4866
423,BUMA.1121.00102,1,1261975,1266831,-,4856
423,BUMA.1121.00111,1,152272,157143,+,4871
423,BUMA.1121.00089,1,26304,31170,+,4866
423,BUMA.1121.00084,1,249035,253891,+,4856
423,BUMA.1121.00029,1,937929,942785,-,4856
423,BUMA.1121.00012,1,2726463,2731296,+,4833
423,BUMA.1121.00087,1,686803,691645,-,4842
423,BUMA.1121.00043,1,4153763,4158616,+,4853
423,BUMA.1121.00046,1,908469,913342,-,4873
423,BUMA.1121.00037,1,2648685,2653533,+,4848
423,BUMA.1121.00080,1,26339,31205,+,4866
423,BUMA.1121.00079,1,26464,31329,+,4865
423,BUMA.1121.00045,1,55344,60200,-,4856
423,BUMA.1121.00071,1,26324,31195,+,4871
423,BUMA.1121.00056,1,3894262,3899128,-,4866
423,BUMA.1121.00065,1,26372,31237,+,4865
423,BUMA.1121.00058,1,517891,522747,-,4856
423,BUMA.1121.00007,1,55667,60533,-,4866
423,BUMA.1121.00067,1,390521,395373,-,4852
423,BUMA.1121.00090,1,2113337,2118180,+,4843
423,BUMA.1121.00051,1,26353,31218,+,4865
423,BUMA.1121.00020,1,595207,600049,-,4842
423,BUMA.1121.00103,1,333742,338634,-,4892
423,BUMA.1121.00048,1,2646893,2651766,-,4873
423,BUMA.1121.00047,1,2949613,2954479,-,4866
423,BUMA.1121.00042,1,3472275,3477149,+,4874
423,BUMA.1121.00055,1,3659199,3664065,+,4866
423,BUMA.1121.00031,1,1362229,1367077,+,4848
423,BUMA.1121.00040,1,167493,172334,-,4841
423,BUMA.1121.00044,1,3397201,3402043,-,4842
423,BUMA.1121.00044,1,3499534,3504376,-,4842
423,BUMA.1121.00088,1,875380,880236,+,4856
423,BUMA.1121.00069,1,26328,31199,+,4871
423,BUMA.1121.00064,1,26364,31216,+,4852
423,BUMA.1121.00105,1,1228771,1233636,-,4865
423,BUMA.1121.00015,1,348123,352997,+,4874
423,BUMA.1121.00059,1,3236921,3241773,+,4852
423,BUMA.1121.00026,1,1408456,1413330,-,4874
423,BUMA.1121.00022,1,802337,807179,-,4842
423,BUMA.1121.00052,1,360432,365295,-,4863
423,BUMA.1121.00101,1,2459109,2463866,-,4757
423,BUMA.1121.00001,1,61604,66460,-,4856
423,BUMA.1121.00038,1,2854193,2859066,-,4873
423,BUMA.1121.00068,1,2841056,2845893,+,4837
423,BUMA.1121.00099,1,2440640,2445397,-,4757
423,BUMA.1121.00091,1,506268,511109,-,4841
423,BUMA.1121.00098,1,2696034,2700870,+,4836
423,BUMA.1121.00013,1,590487,595349,+,4862
423,BUMA.1121.00049,1,1831595,1836460,-,4865
423,BUMA.1121.00072,1,26328,31198,+,4870
423,BUMA.1121.00076,1,1339848,1344721,-,4873
423,BUMA.1121.00083,1,1673626,1678501,-,4875
423,BUMA.1121.00078,1,2021241,2026094,-,4853
423,BUMA.1121.00095,1,1647694,1652542,-,4848
423,BUMA.1121.00077,1,2676778,2681655,+,4877
423,BUMA.1121.00063,1,26321,31192,+,4871
423,BUMA.1121.00061,1,26328,31197,+,4869
423,BUMA.1121.00050,1,1838510,1843382,+,4872
423,BUMA.1121.00081,1,2854392,2859265,-,4873
423,BUMA.1121.00074,1,59472,64324,-,4852
423,BUMA.1121.00062,1,560741,565597,-,4856
423,BUMA.1121.00060,1,2300535,2305391,-,4856
423,BUMA.1121.00070,1,26328,31203,+,4875
423,BUMA.1121.00075,1,3467481,3472354,+,4873
423,BUMA.1121.00041,1,1240950,1245806,+,4856
423,BUMA.1121.00073,1,26328,31203,+,4875
423,BUMA.1121.00017,1,595199,600041,-,4842
423,BUMA.1121.00066,1,26328,31196,+,4868
423,BUMA.1121.00107,1,3956769,3961516,+,4747
423,BUMA.1121.00085,1,3454228,3459091,-,4863
423,BUMA.1121.00030,1,595199,600041,-,4842
423,BUMA.1121.00112,1,3059110,3063855,-,4745
423,BUMA.1121.00002,1,1274759,1279630,+,4871
423,BUMA.1121.00082,1,26328,31203,+,4875
423,BUMA.1121.00014,1,2883439,2888286,-,4847
423,BUMA.1121.00011,1,1623188,1628049,-,4861
423,BUMA.1121.00019,1,595213,600055,-,4842
423,BUMA.1121.00057,1,1120774,1125640,+,4866
423,BUMA.1121.00018,1,508020,512876,+,4856
423,BUMA.1121.00039,1,97866,102722,+,4856
423,BUMA.1121.00016,1,2104500,2109356,+,4856
423,BUMA.1121.00004,1,595193,600035,-,4842
423,BUMA.1121.00005,1,3578616,3583472,-,4856
423,BUMA.1121.00100,1,1309347,1314218,-,4871
423,BUMA.1121.00006,1,2854277,2859150,-,4873
424,BUMA.1121.00027,1,2178260,2188851,+,10591
424,BUMA.1121.00025,1,2736423,2747010,-,10587
424,BUMA.1121.00021,1,628265,638857,+,10592
424,BUMA.1121.00023,1,2350746,2361337,+,10591
424,BUMA.1121.00024,1,547469,558068,+,10599
424,BUMA.1121.00033,1,2287972,2298563,+,10591
424,BUMA.1121.00034,1,547477,558076,+,10599
424,BUMA.1121.00036,1,74358,84958,-,10600
424,BUMA.1121.00032,1,2104517,2115117,-,10600
424,BUMA.1121.00009,1,1536631,1547214,-,10583
424,BUMA.1121.00008,1,547491,558090,+,10599
424,BUMA.1121.00003,1,2525021,2535612,+,10591
424,BUMA.1121.00109,1,1854738,1865327,-,10589
424,BUMA.1121.00053,1,3765456,3776045,+,10589
424,BUMA.1121.00110,1,791152,801736,-,10584
424,BUMA.1121.00104,1,1247060,1257658,-,10598
424,BUMA.1121.00086,1,2650165,2660764,+,10599
424,BUMA.1121.00092,1,31137,41732,+,10595
424,BUMA.1121.00096,1,3247582,3258173,-,10591
424,BUMA.1121.00054,1,1356884,1367493,+,10609
424,BUMA.1121.00097,1,4016486,4027075,-,10589
424,BUMA.1121.00093,1,492103,502698,-,10595
424,BUMA.1121.00106,1,3797412,3808006,+,10594
424,BUMA.1121.00010,1,1288720,1299320,-,10600
424,BUMA.1121.00035,1,1035196,1045787,+,10591
424,BUMA.1121.00108,1,985125,995721,+,10596
424,BUMA.1121.00028,1,547478,558077,+,10599
424,BUMA.1121.00094,1,31178,41774,+,10596
424,BUMA.1121.00102,1,1251390,1261973,-,10583
424,BUMA.1121.00111,1,157144,167735,+,10591
424,BUMA.1121.00089,1,31171,41767,+,10596
424,BUMA.1121.00084,1,253892,264488,+,10596
424,BUMA.1121.00029,1,927328,937927,-,10599
424,BUMA.1121.00012,1,2731297,2741888,+,10591
424,BUMA.1121.00087,1,674964,685564,-,10600
424,BUMA.1121.00043,1,4158617,4169209,+,10592
424,BUMA.1121.00046,1,874920,885524,+,10604
424,BUMA.1121.00037,1,2653534,2664126,+,10592
424,BUMA.1121.00080,1,31206,41800,+,10594
424,BUMA.1121.00079,1,31330,41924,+,10594
424,BUMA.1121.00045,1,44756,55342,-,10586
424,BUMA.1121.00071,1,31196,41792,+,10596
424,BUMA.1121.00056,1,3883664,3894260,-,10596
424,BUMA.1121.00065,1,31238,41833,+,10595
424,BUMA.1121.00058,1,507303,517889,-,10586
424,BUMA.1121.00007,1,45074,55665,-,10591
424,BUMA.1121.00067,1,379923,390519,-,10596
424,BUMA.1121.00090,1,2118181,2128772,+,10591
424,BUMA.1121.00051,1,31219,41813,+,10594
424,BUMA.1121.00020,1,547484,558083,+,10599
424,BUMA.1121.00103,1,323157,333740,-,10583
424,BUMA.1121.00048,1,2568297,2578907,-,10610
424,BUMA.1121.00047,1,2939017,2949611,-,10594
424,BUMA.1121.00042,1,3478387,3488986,+,10599
424,BUMA.1121.00055,1,3664066,3674662,+,10596
424,BUMA.1121.00031,1,1367078,1377670,+,10592
424,BUMA.1121.00040,1,121007,131606,+,10599
424,BUMA.1121.00044,1,3349478,3360077,+,10599
424,BUMA.1121.00088,1,880237,890840,+,10603
424,BUMA.1121.00069,1,31200,41796,+,10596
424,BUMA.1121.00064,1,31217,41805,+,10588
424,BUMA.1121.00105,1,1218158,1228769,-,10611
424,BUMA.1121.00015,1,375940,386545,-,10605
424,BUMA.1121.00059,1,3241774,3252370,+,10596
424,BUMA.1121.00026,1,1396618,1407218,-,10600
424,BUMA.1121.00022,1,790498,801098,-,10600
424,BUMA.1121.00052,1,129161,139760,+,10599
424,BUMA.1121.00101,1,2448524,2459107,-,10583
424,BUMA.1121.00001,1,51011,61602,-,10591
424,BUMA.1121.00038,1,2775597,2786207,-,10610
424,BUMA.1121.00068,1,2845894,2856490,+,10596
424,BUMA.1121.00099,1,2430047,2440638,-,10591
424,BUMA.1121.00091,1,495676,506266,-,10590
424,BUMA.1121.00098,1,2700871,2711462,+,10591
424,BUMA.1121.00013,1,816003,826603,-,10600
424,BUMA.1121.00049,1,1820999,1831593,-,10594
424,BUMA.1121.00072,1,31199,41795,+,10596
424,BUMA.1121.00076,1,1329248,1339846,-,10598
424,BUMA.1121.00083,1,1663028,1673624,-,10596
424,BUMA.1121.00078,1,2010643,2021239,-,10596
424,BUMA.1121.00095,1,1637091,1647692,-,10601
424,BUMA.1121.00077,1,2681656,2692240,+,10584
424,BUMA.1121.00063,1,31193,41789,+,10596
424,BUMA.1121.00061,1,31198,41794,+,10596
424,BUMA.1121.00050,1,1866327,1876932,-,10605
424,BUMA.1121.00081,1,2775796,2786406,-,10610
424,BUMA.1121.00074,1,48874,59470,-,10596
424,BUMA.1121.00062,1,550146,560739,-,10593
424,BUMA.1121.00060,1,2289947,2300533,-,10586
424,BUMA.1121.00070,1,31204,41800,+,10596
424,BUMA.1121.00075,1,3472355,3482953,+,10598
424,BUMA.1121.00041,1,1245807,1256393,+,10586
424,BUMA.1121.00073,1,31204,41800,+,10596
424,BUMA.1121.00017,1,547476,558075,+,10599
424,BUMA.1121.00066,1,31197,41793,+,10596
424,BUMA.1121.00107,1,3961517,3972122,+,10605
424,BUMA.1121.00085,1,3222967,3233566,+,10599
424,BUMA.1121.00030,1,547476,558075,+,10599
424,BUMA.1121.00112,1,3048508,3059108,-,10600
424,BUMA.1121.00002,1,1315545,1326145,-,10600
424,BUMA.1121.00082,1,31204,41800,+,10596
424,BUMA.1121.00014,1,2872846,2883437,-,10591
424,BUMA.1121.00011,1,1612592,1623186,-,10594
424,BUMA.1121.00019,1,547490,558089,+,10599
424,BUMA.1121.00057,1,1125641,1136232,+,10591
424,BUMA.1121.00018,1,512877,523464,+,10587
424,BUMA.1121.00039,1,102723,113319,+,10596
424,BUMA.1121.00016,1,2109357,2119943,+,10586
424,BUMA.1121.00004,1,547470,558069,+,10599
424,BUMA.1121.00005,1,3567813,3578614,-,10801
424,BUMA.1121.00100,1,1298756,1309345,-,10589
424,BUMA.1121.00006,1,2775681,2786291,-,10610
425,BUMA.1121.00027,1,2188853,2197698,+,8845
425,BUMA.1121.00025,1,2727577,2736422,-,8845
425,BUMA.1121.00021,1,638859,647705,+,8846
425,BUMA.1121.00023,1,2361339,2370184,+,8845
425,BUMA.1121.00024,1,558070,566915,+,8845
425,BUMA.1121.00033,1,2298565,2307409,+,8844
425,BUMA.1121.00034,1,558078,566923,+,8845
425,BUMA.1121.00036,1,65512,74357,-,8845
425,BUMA.1121.00032,1,2095671,2104516,-,8845
425,BUMA.1121.00009,1,1527792,1536630,-,8838
425,BUMA.1121.00008,1,558092,566937,+,8845
425,BUMA.1121.00003,1,2535614,2544452,+,8838
425,BUMA.1121.00109,1,1845899,1854737,-,8838
425,BUMA.1121.00053,1,3776047,3784892,+,8845
425,BUMA.1121.00110,1,782313,791151,-,8838
425,BUMA.1121.00104,1,1238214,1247059,-,8845
425,BUMA.1121.00086,1,2660766,2669611,+,8845
425,BUMA.1121.00092,1,41734,50579,+,8845
425,BUMA.1121.00096,1,3238743,3247581,-,8838
425,BUMA.1121.00054,1,1367495,1376340,+,8845
425,BUMA.1121.00097,1,4007677,4016485,-,8808
425,BUMA.1121.00093,1,483257,492102,-,8845
425,BUMA.1121.00106,1,3808008,3816853,+,8845
425,BUMA.1121.00010,1,1279874,1288719,-,8845
425,BUMA.1121.00035,1,1045789,1054634,+,8845
425,BUMA.1121.00108,1,995723,1004568,+,8845
425,BUMA.1121.00028,1,558079,566924,+,8845
425,BUMA.1121.00094,1,41776,50621,+,8845
425,BUMA.1121.00102,1,1242544,1251389,-,8845
425,BUMA.1121.00111,1,167737,176582,+,8845
425,BUMA.1121.00089,1,41769,50614,+,8845
425,BUMA.1121.00084,1,264490,273335,+,8845
425,BUMA.1121.00029,1,918482,927327,-,8845
425,BUMA.1121.00012,1,2741890,2750735,+,8845
425,BUMA.1121.00087,1,666118,674963,-,8845
425,BUMA.1121.00043,1,4169211,4177999,+,8788
425,BUMA.1121.00046,1,885526,894371,+,8845
425,BUMA.1121.00037,1,2664128,2672973,+,8845
425,BUMA.1121.00080,1,41802,50647,+,8845
425,BUMA.1121.00079,1,41926,50771,+,8845
425,BUMA.1121.00045,1,35917,44755,-,8838
425,BUMA.1121.00071,1,41794,50639,+,8845
425,BUMA.1121.00056,1,3874818,3883663,-,8845
425,BUMA.1121.00065,1,41835,50680,+,8845
425,BUMA.1121.00058,1,498473,507302,-,8829
425,BUMA.1121.00007,1,36228,45073,-,8845
425,BUMA.1121.00067,1,371077,379922,-,8845
425,BUMA.1121.00090,1,2128774,2137619,+,8845
425,BUMA.1121.00051,1,41815,50660,+,8845
425,BUMA.1121.00020,1,558085,566930,+,8845
425,BUMA.1121.00103,1,314311,323156,-,8845
425,BUMA.1121.00048,1,2559451,2568296,-,8845
425,BUMA.1121.00047,1,2930171,2939016,-,8845
425,BUMA.1121.00042,1,3488988,3497833,+,8845
425,BUMA.1121.00055,1,3674664,3683509,+,8845
425,BUMA.1121.00031,1,1377672,1386517,+,8845
425,BUMA.1121.00040,1,131608,140453,+,8845
425,BUMA.1121.00044,1,3360079,3368924,+,8845
425,BUMA.1121.00088,1,890842,899688,+,8846
425,BUMA.1121.00069,1,41798,50643,+,8845
425,BUMA.1121.00064,1,41807,50652,+,8845
425,BUMA.1121.00105,1,1207734,1216554,-,8820
425,BUMA.1121.00015,1,367094,375939,-,8845
425,BUMA.1121.00059,1,3252372,3261217,+,8845
425,BUMA.1121.00026,1,1387772,1396617,-,8845
425,BUMA.1121.00022,1,781652,790497,-,8845
425,BUMA.1121.00052,1,139762,148607,+,8845
425,BUMA.1121.00101,1,2439678,2448523,-,8845
425,BUMA.1121.00001,1,42165,51010,-,8845
425,BUMA.1121.00038,1,2766751,2775596,-,8845
425,BUMA.1121.00068,1,2856492,2865337,+,8845
425,BUMA.1121.00099,1,2421201,2430046,-,8845
425,BUMA.1121.00091,1,486830,495675,-,8845
425,BUMA.1121.00098,1,2711464,2720309,+,8845
425,BUMA.1121.00013,1,807157,816002,-,8845
425,BUMA.1121.00049,1,1812152,1820998,-,8846
425,BUMA.1121.00072,1,41797,50642,+,8845
425,BUMA.1121.00076,1,1320402,1329247,-,8845
425,BUMA.1121.00083,1,1654182,1663027,-,8845
425,BUMA.1121.00078,1,2001798,2010642,-,8844
425,BUMA.1121.00095,1,1626667,1635487,-,8820
425,BUMA.1121.00077,1,2692242,2701080,+,8838
425,BUMA.1121.00063,1,41791,50636,+,8845
425,BUMA.1121.00061,1,41796,50641,+,8845
425,BUMA.1121.00050,1,1857481,1866326,-,8845
425,BUMA.1121.00081,1,2766950,2775795,-,8845
425,BUMA.1121.00074,1,40028,48873,-,8845
425,BUMA.1121.00062,1,541300,550145,-,8845
425,BUMA.1121.00060,1,2281108,2289946,-,8838
425,BUMA.1121.00070,1,41802,50647,+,8845
425,BUMA.1121.00075,1,3482955,3491800,+,8845
425,BUMA.1121.00041,1,1256395,1265240,+,8845
425,BUMA.1121.00073,1,41802,50647,+,8845
425,BUMA.1121.00017,1,558077,566922,+,8845
425,BUMA.1121.00066,1,41795,50638,+,8843
425,BUMA.1121.00107,1,3972124,3980962,+,8838
425,BUMA.1121.00085,1,3233568,3242413,+,8845
425,BUMA.1121.00030,1,558077,566922,+,8845
425,BUMA.1121.00112,1,3039662,3048507,-,8845
425,BUMA.1121.00002,1,1306699,1315544,-,8845
425,BUMA.1121.00082,1,41802,50647,+,8845
425,BUMA.1121.00014,1,2864000,2872845,-,8845
425,BUMA.1121.00011,1,1603746,1612591,-,8845
425,BUMA.1121.00019,1,558091,566936,+,8845
425,BUMA.1121.00057,1,1136234,1145079,+,8845
425,BUMA.1121.00018,1,523466,532311,+,8845
425,BUMA.1121.00039,1,113321,122159,+,8838
425,BUMA.1121.00016,1,2119945,2128789,+,8844
425,BUMA.1121.00004,1,558071,566916,+,8845
425,BUMA.1121.00005,1,3558967,3567812,-,8845
425,BUMA.1121.00100,1,1289910,1298755,-,8845
425,BUMA.1121.00006,1,2766835,2775680,-,8845
426,BUMA.1121.00027,1,2197699,2200851,+,3152
426,BUMA.1121.00025,1,2724423,2727575,-,3152
426,BUMA.1121.00021,1,647706,650859,+,3153
426,BUMA.1121.00023,1,2370185,2373338,+,3153
426,BUMA.1121.00024,1,566916,570069,+,3153
426,BUMA.1121.00033,1,2307410,2310563,+,3153
426,BUMA.1121.00034,1,566924,570077,+,3153
426,BUMA.1121.00036,1,62358,65510,-,3152
426,BUMA.1121.00032,1,2092517,2095669,-,3152
426,BUMA.1121.00009,1,1524638,1527790,-,3152
426,BUMA.1121.00008,1,566938,570091,+,3153
426,BUMA.1121.00003,1,2544453,2547606,+,3153
426,BUMA.1121.00109,1,1842745,1845897,-,3152
426,BUMA.1121.00053,1,3784893,3788046,+,3153
426,BUMA.1121.00110,1,779159,782311,-,3152
426,BUMA.1121.00104,1,1235060,1238212,-,3152
426,BUMA.1121.00086,1,2669612,2672765,+,3153
426,BUMA.1121.00092,1,50580,53733,+,3153
426,BUMA.1121.00096,1,3235589,3238741,-,3152
426,BUMA.1121.00054,1,1376341,1379494,+,3153
426,BUMA.1121.00097,1,4004523,4007675,-,3152
426,BUMA.1121.00093,1,480103,483255,-,3152
426,BUMA.1121.00106,1,3816854,3820007,+,3153
426,BUMA.1121.00010,1,1276720,1279872,-,3152
426,BUMA.1121.00035,1,1054635,1057788,+,3153
426,BUMA.1121.00108,1,1004569,1007722,+,3153
426,BUMA.1121.00028,1,566925,570078,+,3153
426,BUMA.1121.00094,1,50622,53775,+,3153
426,BUMA.1121.00102,1,1239390,1242542,-,3152
426,BUMA.1121.00111,1,176583,179736,+,3153
426,BUMA.1121.00089,1,50615,53768,+,3153
426,BUMA.1121.00084,1,273336,276489,+,3153
426,BUMA.1121.00029,1,915328,918480,-,3152
426,BUMA.1121.00012,1,2750736,2753889,+,3153
426,BUMA.1121.00087,1,662964,666116,-,3152
426,BUMA.1121.00043,1,42,3210,+,3168
426,BUMA.1121.00046,1,894372,897525,+,3153
426,BUMA.1121.00037,1,2672974,2676127,+,3153
426,BUMA.1121.00080,1,50648,53801,+,3153
426,BUMA.1121.00079,1,50772,53925,+,3153
426,BUMA.1121.00045,1,32763,35915,-,3152
426,BUMA.1121.00071,1,50640,53793,+,3153
426,BUMA.1121.00056,1,3871664,3874816,-,3152
426,BUMA.1121.00065,1,50681,53834,+,3153
426,BUMA.1121.00058,1,495319,498471,-,3152
426,BUMA.1121.00007,1,33074,36226,-,3152
426,BUMA.1121.00067,1,367923,371075,-,3152
426,BUMA.1121.00090,1,2137620,2140773,+,3153
426,BUMA.1121.00051,1,50661,53814,+,3153
426,BUMA.1121.00020,1,566931,570084,+,3153
426,BUMA.1121.00103,1,311157,314309,-,3152
426,BUMA.1121.00048,1,2556297,2559449,-,3152
426,BUMA.1121.00047,1,2927017,2930169,-,3152
426,BUMA.1121.00042,1,3497834,3500987,+,3153
426,BUMA.1121.00055,1,3683510,3686663,+,3153
426,BUMA.1121.00031,1,1386518,1389671,+,3153
426,BUMA.1121.00040,1,140454,143607,+,3153
426,BUMA.1121.00044,1,3368925,3372078,+,3153
426,BUMA.1121.00088,1,899689,902842,+,3153
426,BUMA.1121.00069,1,50644,53797,+,3153
426,BUMA.1121.00064,1,50653,53806,+,3153
426,BUMA.1121.00105,1,1204580,1207732,-,3152
426,BUMA.1121.00015,1,363940,367092,-,3152
426,BUMA.1121.00059,1,3261218,3264371,+,3153
426,BUMA.1121.00026,1,1384618,1387770,-,3152
426,BUMA.1121.00022,1,778498,781650,-,3152
426,BUMA.1121.00052,1,148608,151761,+,3153
426,BUMA.1121.00101,1,2436524,2439676,-,3152
426,BUMA.1121.00001,1,39011,42163,-,3152
426,BUMA.1121.00038,1,2763597,2766749,-,3152
426,BUMA.1121.00068,1,2865338,2868491,+,3153
426,BUMA.1121.00099,1,2418047,2421199,-,3152
426,BUMA.1121.00091,1,483676,486828,-,3152
426,BUMA.1121.00098,1,2720310,2723463,+,3153
426,BUMA.1121.00013,1,804003,807155,-,3152
426,BUMA.1121.00049,1,1808998,1812150,-,3152
426,BUMA.1121.00072,1,50643,53796,+,3153
426,BUMA.1121.00076,1,1317248,1320400,-,3152
426,BUMA.1121.00083,1,1651028,1654180,-,3152
426,BUMA.1121.00078,1,1998644,2001796,-,3152
426,BUMA.1121.00095,1,1623513,1626665,-,3152
426,BUMA.1121.00077,1,2701081,2704234,+,3153
426,BUMA.1121.00063,1,50637,53790,+,3153
426,BUMA.1121.00061,1,50642,53795,+,3153
426,BUMA.1121.00050,1,1854327,1857479,-,3152
426,BUMA.1121.00081,1,2763796,2766948,-,3152
426,BUMA.1121.00074,1,36874,40026,-,3152
426,BUMA.1121.00062,1,538146,541298,-,3152
426,BUMA.1121.00060,1,2277954,2281106,-,3152
426,BUMA.1121.00070,1,50648,53801,+,3153
426,BUMA.1121.00075,1,3491801,3494954,+,3153
426,BUMA.1121.00041,1,1265241,1268394,+,3153
426,BUMA.1121.00073,1,50648,53801,+,3153
426,BUMA.1121.00017,1,566923,570076,+,3153
426,BUMA.1121.00066,1,50639,53792,+,3153
426,BUMA.1121.00107,1,3980963,3984116,+,3153
426,BUMA.1121.00085,1,3242414,3245567,+,3153
426,BUMA.1121.00030,1,566923,570076,+,3153
426,BUMA.1121.00112,1,3036508,3039660,-,3152
426,BUMA.1121.00002,1,1303545,1306697,-,3152
426,BUMA.1121.00082,1,50648,53801,+,3153
426,BUMA.1121.00014,1,2860846,2863998,-,3152
426,BUMA.1121.00011,1,1600592,1603744,-,3152
426,BUMA.1121.00019,1,566937,570090,+,3153
426,BUMA.1121.00057,1,1145080,1148233,+,3153
426,BUMA.1121.00018,1,532312,535465,+,3153
426,BUMA.1121.00039,1,122160,125313,+,3153
426,BUMA.1121.00016,1,2128790,2131943,+,3153
426,BUMA.1121.00004,1,566917,570070,+,3153
426,BUMA.1121.00005,1,3555813,3558965,-,3152
426,BUMA.1121.00100,1,1286756,1289908,-,3152
426,BUMA.1121.00006,1,2763681,2766833,-,3152
427,BUMA.1121.00027,1,2200857,2210246,+,9389
427,BUMA.1121.00025,1,2715026,2724417,-,9391
427,BUMA.1121.00021,1,650865,660256,+,9391
427,BUMA.1121.00023,1,2373344,2382735,+,9391
427,BUMA.1121.00024,1,570075,579389,+,9314
427,BUMA.1121.00033,1,2310569,2319960,+,9391
427,BUMA.1121.00034,1,570083,579397,+,9314
427,BUMA.1121.00036,1,53032,62352,-,9320
427,BUMA.1121.00032,1,2083196,2092511,-,9315
427,BUMA.1121.00009,1,1515243,1524632,-,9389
427,BUMA.1121.00008,1,570097,579411,+,9314
427,BUMA.1121.00003,1,2547612,2557001,+,9389
427,BUMA.1121.00109,1,1833349,1842739,-,9390
427,BUMA.1121.00053,1,3788052,3797442,+,9390
427,BUMA.1121.00110,1,769765,779153,-,9388
427,BUMA.1121.00104,1,1225663,1235054,-,9391
427,BUMA.1121.00086,1,2672771,2682091,+,9320
427,BUMA.1121.00092,1,53739,63130,+,9391
427,BUMA.1121.00096,1,3226166,3235583,-,9417
427,BUMA.1121.00054,1,1379500,1388820,+,9320
427,BUMA.1121.00097,1,3995128,4004517,-,9389
427,BUMA.1121.00093,1,470706,480097,-,9391
427,BUMA.1121.00106,1,3820013,3829404,+,9391
427,BUMA.1121.00010,1,1267394,1276714,-,9320
427,BUMA.1121.00035,1,1057794,1067185,+,9391
427,BUMA.1121.00108,1,1007728,1017099,+,9371
427,BUMA.1121.00028,1,570084,579398,+,9314
427,BUMA.1121.00094,1,53781,63171,+,9390
427,BUMA.1121.00102,1,1229994,1239384,-,9390
427,BUMA.1121.00111,1,179742,189133,+,9391
427,BUMA.1121.00089,1,53774,63164,+,9390
427,BUMA.1121.00084,1,276495,285886,+,9391
427,BUMA.1121.00029,1,905931,915322,-,9391
427,BUMA.1121.00012,1,2753895,2763286,+,9391
427,BUMA.1121.00087,1,653638,662958,-,9320
427,BUMA.1121.00043,1,3216,12607,+,9391
427,BUMA.1121.00046,1,897531,906851,+,9320
427,BUMA.1121.00037,1,2676133,2685524,+,9391
427,BUMA.1121.00080,1,53807,63179,+,9372
427,BUMA.1121.00079,1,53931,63322,+,9391
427,BUMA.1121.00045,1,23386,32757,-,9371
427,BUMA.1121.00071,1,53799,63190,+,9391
427,BUMA.1121.00056,1,3862268,3871658,-,9390
427,BUMA.1121.00065,1,53840,63230,+,9390
427,BUMA.1121.00058,1,485922,495313,-,9391
427,BUMA.1121.00007,1,23687,33068,-,9381
427,BUMA.1121.00067,1,358528,367917,-,9389
427,BUMA.1121.00090,1,2140779,2150170,+,9391
427,BUMA.1121.00051,1,53820,63192,+,9372
427,BUMA.1121.00020,1,570090,579404,+,9314
427,BUMA.1121.00103,1,301761,311151,-,9390
427,BUMA.1121.00048,1,2546971,2556291,-,9320
427,BUMA.1121.00047,1,2917639,2927011,-,9372
427,BUMA.1121.00042,1,1,9265,+,9264
427,BUMA.1121.00055,1,3686669,3696060,+,9391
427,BUMA.1121.00031,1,1389677,1399067,+,9390
427,BUMA.1121.00040,1,143613,152933,+,9320
427,BUMA.1121.00044,1,3372084,3381398,+,9314
427,BUMA.1121.00088,1,902848,912239,+,9391
427,BUMA.1121.00069,1,53803,63194,+,9391
427,BUMA.1121.00064,1,53812,63201,+,9389
427,BUMA.1121.00105,1,1195183,1204574,-,9391
427,BUMA.1121.00015,1,354614,363934,-,9320
427,BUMA.1121.00059,1,3264377,3273768,+,9391
427,BUMA.1121.00026,1,1375292,1384612,-,9320
427,BUMA.1121.00022,1,769172,778492,-,9320
427,BUMA.1121.00052,1,151767,161087,+,9320
427,BUMA.1121.00101,1,2427130,2436518,-,9388
427,BUMA.1121.00001,1,29614,39005,-,9391
427,BUMA.1121.00038,1,2754271,2763591,-,9320
427,BUMA.1121.00068,1,2868497,2877886,+,9389
427,BUMA.1121.00099,1,2408674,2418041,-,9367
427,BUMA.1121.00091,1,474281,483670,-,9389
427,BUMA.1121.00098,1,2723469,2732858,+,9389
427,BUMA.1121.00013,1,794677,803997,-,9320
427,BUMA.1121.00049,1,1799602,1808992,-,9390
427,BUMA.1121.00072,1,53802,63191,+,9389
427,BUMA.1121.00076,1,1307851,1317242,-,9391
427,BUMA.1121.00083,1,1641631,1651022,-,9391
427,BUMA.1121.00078,1,1989246,1998638,-,9392
427,BUMA.1121.00095,1,1614117,1623507,-,9390
427,BUMA.1121.00077,1,2704240,2713628,+,9388
427,BUMA.1121.00063,1,53796,63187,+,9391
427,BUMA.1121.00061,1,53801,63192,+,9391
427,BUMA.1121.00050,1,1845001,1854321,-,9320
427,BUMA.1121.00081,1,2754470,2763790,-,9320
427,BUMA.1121.00074,1,27479,36868,-,9389
427,BUMA.1121.00062,1,528750,538140,-,9390
427,BUMA.1121.00060,1,2268577,2277948,-,9371
427,BUMA.1121.00070,1,53807,63198,+,9391
427,BUMA.1121.00075,1,3494960,3504351,+,9391
427,BUMA.1121.00041,1,1268400,1277790,+,9390
427,BUMA.1121.00073,1,53807,63198,+,9391
427,BUMA.1121.00017,1,570082,579396,+,9314
427,BUMA.1121.00066,1,53798,63189,+,9391
427,BUMA.1121.00107,1,3984122,3993513,+,9391
427,BUMA.1121.00085,1,3245573,3254893,+,9320
427,BUMA.1121.00030,1,570082,579396,+,9314
427,BUMA.1121.00112,1,3027113,3036502,-,9389
427,BUMA.1121.00002,1,1294219,1303539,-,9320
427,BUMA.1121.00082,1,53807,63198,+,9391
427,BUMA.1121.00014,1,2851450,2860840,-,9390
427,BUMA.1121.00011,1,1591196,1600586,-,9390
427,BUMA.1121.00019,1,570096,579410,+,9314
427,BUMA.1121.00057,1,1148239,1157630,+,9391
427,BUMA.1121.00018,1,535471,544862,+,9391
427,BUMA.1121.00039,1,125319,134710,+,9391
427,BUMA.1121.00016,1,2131949,2141339,+,9390
427,BUMA.1121.00004,1,570076,579390,+,9314
427,BUMA.1121.00005,1,3546417,3555807,-,9390
427,BUMA.1121.00100,1,1277378,1286750,-,9372
427,BUMA.1121.00006,1,2754355,2763675,-,9320
428,BUMA.1121.00027,1,2210621,2223590,+,12969
428,BUMA.1121.00025,1,2701642,2714650,-,13008
428,BUMA.1121.00021,1,660631,673586,+,12955
428,BUMA.1121.00023,1,2383110,2396064,+,12954
428,BUMA.1121.00024,1,581010,593904,+,12894
428,BUMA.1121.00033,1,2320335,2333336,+,13001
428,BUMA.1121.00034,1,581018,593912,+,12894
428,BUMA.1121.00036,1,39763,52656,-,12893
428,BUMA.1121.00032,1,2068682,2081575,-,12893
428,BUMA.1121.00009,1,1501881,1514876,-,12995
428,BUMA.1121.00008,1,581032,593926,+,12894
428,BUMA.1121.00003,1,2557376,2570389,+,13013
428,BUMA.1121.00109,1,1820007,1832973,-,12966
428,BUMA.1121.00053,1,3797817,3810828,+,13011
428,BUMA.1121.00110,1,756423,769389,-,12966
428,BUMA.1121.00104,1,1212313,1225287,-,12974
428,BUMA.1121.00086,1,2682466,2695360,+,12894
428,BUMA.1121.00092,1,63505,76452,+,12947
428,BUMA.1121.00096,1,3212752,3225790,-,13038
428,BUMA.1121.00097,1,3981754,3994752,-,12998
428,BUMA.1121.00093,1,457384,470330,-,12946
428,BUMA.1121.00106,1,3829779,3842767,+,12988
428,BUMA.1121.00010,1,1254094,1267018,-,12924
428,BUMA.1121.00035,1,1067560,1080505,+,12945
428,BUMA.1121.00108,1,1017474,1030443,+,12969
428,BUMA.1121.00028,1,581019,593913,+,12894
428,BUMA.1121.00094,1,63546,76575,+,13029
428,BUMA.1121.00102,1,1216578,1229618,-,13040
428,BUMA.1121.00111,1,189508,202510,+,13002
428,BUMA.1121.00089,1,63539,76558,+,13019
428,BUMA.1121.00084,1,286261,299269,+,13008
428,BUMA.1121.00029,1,892611,905555,-,12944
428,BUMA.1121.00012,1,2763661,2776655,+,12994
428,BUMA.1121.00087,1,640369,653262,-,12893
428,BUMA.1121.00043,1,12982,25981,+,12999
428,BUMA.1121.00037,1,2685899,2698935,+,13036
428,BUMA.1121.00080,1,63548,76561,+,13013
428,BUMA.1121.00079,1,63691,76731,+,13040
428,BUMA.1121.00045,1,10021,23010,-,12989
428,BUMA.1121.00071,1,63565,76509,+,12944
428,BUMA.1121.00056,1,3848874,3861892,-,13018
428,BUMA.1121.00065,1,63605,76597,+,12992
428,BUMA.1121.00058,1,472558,485546,-,12988
428,BUMA.1121.00007,1,10352,23301,-,12949
428,BUMA.1121.00067,1,345173,358152,-,12979
428,BUMA.1121.00090,1,2150545,2163533,+,12988
428,BUMA.1121.00051,1,63561,76634,+,13073
428,BUMA.1121.00020,1,581025,593919,+,12894
428,BUMA.1121.00103,1,288400,301384,-,12984
428,BUMA.1121.00047,1,2904254,2917270,-,13016
428,BUMA.1121.00042,1,9640,22534,+,12894
428,BUMA.1121.00055,1,3696435,3709389,+,12954
428,BUMA.1121.00031,1,1399442,1412404,+,12962
428,BUMA.1121.00040,1,153308,166208,+,12900
428,BUMA.1121.00044,1,3383019,3395913,+,12894
428,BUMA.1121.00088,1,912614,925594,+,12980
428,BUMA.1121.00069,1,63569,76548,+,12979
428,BUMA.1121.00064,1,63576,76572,+,12996
428,BUMA.1121.00105,1,1181812,1194807,-,12995
428,BUMA.1121.00059,1,3274143,3287139,+,12996
428,BUMA.1121.00026,1,1362029,1374916,-,12887
428,BUMA.1121.00022,1,755903,768796,-,12893
428,BUMA.1121.00052,1,346253,359144,+,12891
428,BUMA.1121.00101,1,2413745,2426754,-,13009
428,BUMA.1121.00001,1,16294,29238,-,12944
428,BUMA.1121.00068,1,2878261,2891255,+,12994
428,BUMA.1121.00099,1,2395297,2408294,-,12997
428,BUMA.1121.00091,1,460884,473905,-,13021
428,BUMA.1121.00098,1,2733233,2746185,+,12952
428,BUMA.1121.00013,1,596638,609529,-,12891
428,BUMA.1121.00049,1,1786268,1799226,-,12958
428,BUMA.1121.00072,1,63566,76545,+,12979
428,BUMA.1121.00076,1,1294484,1307475,-,12991
428,BUMA.1121.00083,1,1628277,1641255,-,12978
428,BUMA.1121.00078,1,1975959,1988870,-,12911
428,BUMA.1121.00095,1,1600841,1613741,-,12900
428,BUMA.1121.00077,1,2714003,2726970,+,12967
428,BUMA.1121.00063,1,63562,76541,+,12979
428,BUMA.1121.00061,1,63567,76546,+,12979
428,BUMA.1121.00074,1,14102,27103,-,13001
428,BUMA.1121.00062,1,515383,528374,-,12991
428,BUMA.1121.00060,1,2255212,2268201,-,12989
428,BUMA.1121.00070,1,63573,76552,+,12979
428,BUMA.1121.00075,1,3504726,3517725,+,12999
428,BUMA.1121.00041,1,1278165,1291161,+,12996
428,BUMA.1121.00073,1,63573,76552,+,12979
428,BUMA.1121.00017,1,581017,593911,+,12894
428,BUMA.1121.00066,1,63564,76511,+,12947
428,BUMA.1121.00107,1,3993888,4006774,+,12886
428,BUMA.1121.00085,1,3440049,3452940,+,12891
428,BUMA.1121.00030,1,581017,593911,+,12894
428,BUMA.1121.00112,1,3013712,3026737,-,13025
428,BUMA.1121.00002,1,1280919,1293843,-,12924
428,BUMA.1121.00082,1,63573,76552,+,12979
428,BUMA.1121.00014,1,2838105,2851074,-,12969
428,BUMA.1121.00011,1,1577811,1590820,-,13009
428,BUMA.1121.00019,1,581031,593925,+,12894
428,BUMA.1121.00057,1,1158005,1170990,+,12985
428,BUMA.1121.00018,1,545237,558238,+,13001
428,BUMA.1121.00039,1,135085,148055,+,12970
428,BUMA.1121.00016,1,2141714,2154696,+,12982
428,BUMA.1121.00004,1,581011,593905,+,12894
428,BUMA.1121.00005,1,3533102,3546041,-,12939
428,BUMA.1121.00100,1,1264049,1277002,-,12953
429,BUMA.1121.00027,1,2223591,2227614,+,4023
429,BUMA.1121.00025,1,2697619,2701640,-,4021
429,BUMA.1121.00021,1,673587,677615,+,4028
429,BUMA.1121.00023,1,2396065,2400093,+,4028
429,BUMA.1121.00033,1,2333337,2337365,+,4028
429,BUMA.1121.00009,1,1497849,1501879,-,4030
429,BUMA.1121.00003,1,2570390,2574430,+,4040
429,BUMA.1121.00109,1,1815973,1820005,-,4032
429,BUMA.1121.00053,1,3810829,3814849,+,4020
429,BUMA.1121.00110,1,752381,756421,-,4040
429,BUMA.1121.00104,1,1208281,1212311,-,4030
429,BUMA.1121.00092,1,76453,80484,+,4031
429,BUMA.1121.00096,1,3208721,3212750,-,4029
429,BUMA.1121.00097,1,3977731,3981752,-,4021
429,BUMA.1121.00093,1,453352,457382,-,4030
429,BUMA.1121.00106,1,3842768,3846799,+,4031
429,BUMA.1121.00035,1,1080506,1084534,+,4028
429,BUMA.1121.00108,1,1030444,1034462,+,4018
429,BUMA.1121.00094,1,76576,80625,+,4049
429,BUMA.1121.00102,1,1212557,1216576,-,4019
429,BUMA.1121.00111,1,202511,206539,+,4028
429,BUMA.1121.00089,1,76559,80608,+,4049
429,BUMA.1121.00084,1,299270,303301,+,4031
429,BUMA.1121.00029,1,888582,892609,-,4027
429,BUMA.1121.00012,1,2776656,2780684,+,4028
429,BUMA.1121.00043,1,25982,30010,+,4028
429,BUMA.1121.00037,1,2698936,2702958,+,4022
429,BUMA.1121.00080,1,76562,80593,+,4031
429,BUMA.1121.00079,1,76732,80781,+,4049
429,BUMA.1121.00045,1,5989,10019,-,4030
429,BUMA.1121.00071,1,76510,80533,+,4023
429,BUMA.1121.00056,1,3844824,3848872,-,4048
429,BUMA.1121.00065,1,76598,80629,+,4031
429,BUMA.1121.00058,1,468526,472556,-,4030
429,BUMA.1121.00007,1,6334,10350,-,4016
429,BUMA.1121.00067,1,341141,345171,-,4030
429,BUMA.1121.00090,1,2163534,2167562,+,4028
429,BUMA.1121.00051,1,76635,80684,+,4049
429,BUMA.1121.00103,1,284361,288398,-,4037
429,BUMA.1121.00047,1,2900204,2904252,-,4048
429,BUMA.1121.00055,1,3709390,3713421,+,4031
429,BUMA.1121.00031,1,1412405,1416433,+,4028
429,BUMA.1121.00088,1,925595,929626,+,4031
429,BUMA.1121.00069,1,76549,80572,+,4023
429,BUMA.1121.00064,1,76573,80613,+,4040
429,BUMA.1121.00105,1,1177780,1181810,-,4030
429,BUMA.1121.00059,1,3287140,3291171,+,4031
429,BUMA.1121.00101,1,2409730,2413743,-,4013
429,BUMA.1121.00001,1,12265,16292,-,4027
429,BUMA.1121.00068,1,2891256,2895265,+,4009
429,BUMA.1121.00099,1,2391265,2395295,-,4030
429,BUMA.1121.00091,1,456846,460882,-,4036
429,BUMA.1121.00098,1,2746186,2750213,+,4027
429,BUMA.1121.00049,1,1782246,1786266,-,4020
429,BUMA.1121.00072,1,76546,80569,+,4023
429,BUMA.1121.00076,1,1290452,1294482,-,4030
429,BUMA.1121.00083,1,1624245,1628275,-,4030
429,BUMA.1121.00078,1,1971928,1975957,-,4029
429,BUMA.1121.00095,1,1596826,1600839,-,4013
429,BUMA.1121.00077,1,2726971,2731012,+,4041
429,BUMA.1121.00063,1,76542,80573,+,4031
429,BUMA.1121.00061,1,76547,80570,+,4023
429,BUMA.1121.00074,1,10070,14100,-,4030
429,BUMA.1121.00062,1,511351,515381,-,4030
429,BUMA.1121.00060,1,2251180,2255210,-,4030
429,BUMA.1121.00070,1,76553,80576,+,4023
429,BUMA.1121.00075,1,3517726,3521757,+,4031
429,BUMA.1121.00041,1,1291162,1295176,+,4014
429,BUMA.1121.00073,1,76553,80576,+,4023
429,BUMA.1121.00066,1,76512,80535,+,4023
429,BUMA.1121.00107,1,4006775,4010797,+,4022
429,BUMA.1121.00112,1,3009693,3013710,-,4017
429,BUMA.1121.00082,1,76553,80584,+,4031
429,BUMA.1121.00014,1,2834076,2838103,-,4027
429,BUMA.1121.00011,1,1573779,1577809,-,4030
429,BUMA.1121.00057,1,1170991,1175014,+,4023
429,BUMA.1121.00018,1,558239,562261,+,4022
429,BUMA.1121.00039,1,148056,152084,+,4028
429,BUMA.1121.00016,1,2154697,2158733,+,4036
429,BUMA.1121.00005,1,3529070,3533100,-,4030
429,BUMA.1121.00100,1,1260026,1264047,-,4021
430,BUMA.1121.00027,1,2228488,2233576,+,5088
430,BUMA.1121.00025,1,2691667,2696755,-,5088
430,BUMA.1121.00021,1,678479,683567,+,5088
430,BUMA.1121.00023,1,2400957,2406045,+,5088
430,BUMA.1121.00024,1,367,5455,-,5088
430,BUMA.1121.00033,1,2338229,2343316,+,5087
430,BUMA.1121.00034,1,367,5455,-,5088
430,BUMA.1121.00036,1,443861,448949,+,5088
430,BUMA.1121.00032,1,1597352,1602440,-,5088
430,BUMA.1121.00009,1,1487254,1492341,-,5087
430,BUMA.1121.00008,1,367,5455,-,5088
430,BUMA.1121.00003,1,2575302,2580390,+,5088
430,BUMA.1121.00109,1,1807437,1812525,-,5088
430,BUMA.1121.00053,1,3815723,3820810,+,5087
430,BUMA.1121.00110,1,746425,751513,-,5088
430,BUMA.1121.00104,1,1199755,1204842,-,5087
430,BUMA.1121.00086,1,436,5524,-,5088
430,BUMA.1121.00092,1,81348,86436,+,5088
430,BUMA.1121.00096,1,3188497,3193585,-,5088
430,BUMA.1121.00054,1,627619,632707,+,5088
430,BUMA.1121.00097,1,3960504,3965592,-,5088
430,BUMA.1121.00093,1,447400,452488,-,5088
430,BUMA.1121.00106,1,3847667,3852754,+,5087
430,BUMA.1121.00010,1,413644,418732,-,5088
430,BUMA.1121.00035,1,1095339,1100427,+,5088
430,BUMA.1121.00108,1,1051998,1057086,+,5088
430,BUMA.1121.00028,1,367,5455,-,5088
430,BUMA.1121.00094,1,81494,86581,+,5087
430,BUMA.1121.00102,1,1206595,1211683,-,5088
430,BUMA.1121.00111,1,207403,212491,+,5088
430,BUMA.1121.00089,1,97308,102384,+,5076
430,BUMA.1121.00084,1,306741,311828,+,5087
430,BUMA.1121.00029,1,873108,878196,-,5088
430,BUMA.1121.00012,1,2781548,2786636,+,5088
430,BUMA.1121.00087,1,3311037,3316125,+,5088
430,BUMA.1121.00043,1,54174,59262,+,5088
430,BUMA.1121.00046,1,1438883,1443971,+,5088
430,BUMA.1121.00037,1,2703822,2708910,+,5088
430,BUMA.1121.00080,1,84033,89120,+,5087
430,BUMA.1121.00079,1,81650,86737,+,5087
430,BUMA.1121.00045,1,30,5119,-,5089
430,BUMA.1121.00071,1,81410,86498,+,5088
430,BUMA.1121.00056,1,3823048,3828124,-,5076
430,BUMA.1121.00065,1,81497,86585,+,5088
430,BUMA.1121.00058,1,462572,467659,-,5087
430,BUMA.1121.00007,1,367,5455,-,5088
430,BUMA.1121.00067,1,332614,337701,-,5087
430,BUMA.1121.00090,1,2168426,2173514,+,5088
430,BUMA.1121.00051,1,81553,86640,+,5087
430,BUMA.1121.00020,1,367,5455,-,5088
430,BUMA.1121.00103,1,278399,283487,-,5088
430,BUMA.1121.00048,1,3303081,3308169,-,5088
430,BUMA.1121.00047,1,2894248,2899335,-,5087
430,BUMA.1121.00042,1,531412,536500,-,5088
430,BUMA.1121.00055,1,3714289,3719377,+,5088
430,BUMA.1121.00031,1,1417297,1422385,+,5088
430,BUMA.1121.00040,1,30,5119,-,5089
430,BUMA.1121.00044,1,2802370,2807458,-,5088
430,BUMA.1121.00088,1,933066,938153,+,5087
430,BUMA.1121.00069,1,81449,86537,+,5088
430,BUMA.1121.00064,1,84053,89140,+,5087
430,BUMA.1121.00105,1,1136696,1141783,-,5087
430,BUMA.1121.00015,1,544689,549777,-,5088
430,BUMA.1121.00059,1,3292039,3297126,+,5087
430,BUMA.1121.00026,1,767261,772349,-,5088
430,BUMA.1121.00022,1,1324967,1330055,-,5088
430,BUMA.1121.00052,1,3229696,3234784,-,5088
430,BUMA.1121.00101,1,2391256,2396343,-,5087
430,BUMA.1121.00001,1,30,5119,-,5089
430,BUMA.1121.00038,1,367,5455,-,5088
430,BUMA.1121.00068,1,2917067,2922155,+,5088
430,BUMA.1121.00099,1,2372286,2377373,-,5087
430,BUMA.1121.00091,1,450890,455978,-,5088
430,BUMA.1121.00098,1,2764115,2769203,+,5088
430,BUMA.1121.00013,1,1216159,1221247,+,5088
430,BUMA.1121.00049,1,1773719,1778806,-,5087
430,BUMA.1121.00072,1,81446,86534,+,5088
430,BUMA.1121.00076,1,1284498,1289586,-,5088
430,BUMA.1121.00083,1,1618288,1623376,-,5088
430,BUMA.1121.00078,1,1964373,1969461,-,5088
430,BUMA.1121.00095,1,1586014,1591102,-,5088
430,BUMA.1121.00077,1,2731880,2736968,+,5088
430,BUMA.1121.00063,1,81441,86529,+,5088
430,BUMA.1121.00061,1,81447,86535,+,5088
430,BUMA.1121.00050,1,1307761,1312849,-,5088
430,BUMA.1121.00081,1,436,5524,-,5088
430,BUMA.1121.00074,1,331,5418,-,5087
430,BUMA.1121.00062,1,502824,507912,-,5088
430,BUMA.1121.00060,1,2245222,2250310,-,5088
430,BUMA.1121.00070,1,81453,86541,+,5088
430,BUMA.1121.00075,1,3522623,3527711,+,5088
430,BUMA.1121.00041,1,1297413,1302501,+,5088
430,BUMA.1121.00073,1,81453,86541,+,5088
430,BUMA.1121.00017,1,367,5455,-,5088
430,BUMA.1121.00066,1,81336,86424,+,5088
430,BUMA.1121.00107,1,4011670,4016758,+,5088
430,BUMA.1121.00085,1,2826642,2831730,-,5088
430,BUMA.1121.00030,1,367,5455,-,5088
430,BUMA.1121.00112,1,3003724,3008812,-,5088
430,BUMA.1121.00002,1,438968,444056,-,5088
430,BUMA.1121.00082,1,81453,86541,+,5088
430,BUMA.1121.00014,1,2828124,2833212,-,5088
430,BUMA.1121.00011,1,1563183,1568271,-,5088
430,BUMA.1121.00019,1,367,5455,-,5088
430,BUMA.1121.00057,1,1175888,1180976,+,5088
430,BUMA.1121.00018,1,563125,568213,+,5088
430,BUMA.1121.00039,1,152948,158036,+,5088
430,BUMA.1121.00016,1,2159597,2164685,+,5088
430,BUMA.1121.00004,1,367,5455,-,5088
430,BUMA.1121.00005,1,3523114,3528202,-,5088
430,BUMA.1121.00100,1,1252468,1257556,-,5088
430,BUMA.1121.00006,1,367,5455,-,5088
431,BUMA.1121.00027,1,2233988,2237189,+,3201
431,BUMA.1121.00025,1,2688052,2691255,-,3203
431,BUMA.1121.00021,1,683979,687198,+,3219
431,BUMA.1121.00023,1,2406457,2409657,+,3200
431,BUMA.1121.00024,1,3504110,3507313,-,3203
431,BUMA.1121.00033,1,2343728,2346929,+,3201
431,BUMA.1121.00034,1,3570571,3573774,-,3203
431,BUMA.1121.00036,1,449361,452563,+,3202
431,BUMA.1121.00032,1,1593737,1596940,-,3203
431,BUMA.1121.00009,1,1483639,1486842,-,3203
431,BUMA.1121.00008,1,3555156,3558359,-,3203
431,BUMA.1121.00003,1,2580802,2584004,+,3202
431,BUMA.1121.00109,1,1803823,1807025,-,3202
431,BUMA.1121.00053,1,3821228,3824431,+,3203
431,BUMA.1121.00110,1,742811,746013,-,3202
431,BUMA.1121.00104,1,1196141,1199343,-,3202
431,BUMA.1121.00086,1,3492508,3495687,-,3179
431,BUMA.1121.00092,1,86848,90049,+,3201
431,BUMA.1121.00096,1,3184883,3188085,-,3202
431,BUMA.1121.00054,1,633119,636321,+,3202
431,BUMA.1121.00097,1,3956889,3960092,-,3203
431,BUMA.1121.00093,1,443786,446988,-,3202
431,BUMA.1121.00106,1,3853166,3856367,+,3201
431,BUMA.1121.00010,1,410029,413232,-,3203
431,BUMA.1121.00035,1,1100839,1104041,+,3202
431,BUMA.1121.00108,1,1057498,1060700,+,3202
431,BUMA.1121.00028,1,3575318,3578521,-,3203
431,BUMA.1121.00094,1,86993,90197,+,3204
431,BUMA.1121.00102,1,1202981,1206183,-,3202
431,BUMA.1121.00111,1,212903,216105,+,3202
431,BUMA.1121.00089,1,102796,105998,+,3202
431,BUMA.1121.00084,1,312240,315441,+,3201
431,BUMA.1121.00029,1,869493,872696,-,3203
431,BUMA.1121.00012,1,2787048,2790250,+,3202
431,BUMA.1121.00087,1,3316537,3319739,+,3202
431,BUMA.1121.00043,1,59674,62876,+,3202
431,BUMA.1121.00046,1,1444383,1447585,+,3202
431,BUMA.1121.00037,1,2709322,2712522,+,3200
431,BUMA.1121.00080,1,89532,92733,+,3201
431,BUMA.1121.00079,1,87149,90352,+,3203
431,BUMA.1121.00045,1,4015972,4019174,-,3202
431,BUMA.1121.00071,1,86910,90111,+,3201
431,BUMA.1121.00056,1,3819433,3822636,-,3203
431,BUMA.1121.00065,1,86997,90198,+,3201
431,BUMA.1121.00058,1,458958,462160,-,3202
431,BUMA.1121.00007,1,4051011,4054214,-,3203
431,BUMA.1121.00067,1,329000,332202,-,3202
431,BUMA.1121.00090,1,2173926,2177128,+,3202
431,BUMA.1121.00051,1,87052,90256,+,3204
431,BUMA.1121.00020,1,3622600,3625803,-,3203
431,BUMA.1121.00103,1,274787,277987,-,3200
431,BUMA.1121.00048,1,3299466,3302669,-,3203
431,BUMA.1121.00047,1,2890631,2893836,-,3205
431,BUMA.1121.00042,1,527797,531000,-,3203
431,BUMA.1121.00055,1,3719789,3722990,+,3201
431,BUMA.1121.00031,1,1422797,1425997,+,3200
431,BUMA.1121.00040,1,3550407,3553610,-,3203
431,BUMA.1121.00044,1,2798755,2801958,-,3203
431,BUMA.1121.00088,1,938565,941766,+,3201
431,BUMA.1121.00069,1,86949,90149,+,3200
431,BUMA.1121.00064,1,89552,92753,+,3201
431,BUMA.1121.00105,1,1133082,1136284,-,3202
431,BUMA.1121.00015,1,541074,544277,-,3203
431,BUMA.1121.00059,1,3297538,3300739,+,3201
431,BUMA.1121.00026,1,763646,766849,-,3203
431,BUMA.1121.00022,1,1321352,1324555,-,3203
431,BUMA.1121.00052,1,3226081,3229284,-,3203
431,BUMA.1121.00101,1,2387641,2390844,-,3203
431,BUMA.1121.00001,1,4087390,4090593,-,3203
431,BUMA.1121.00038,1,3506784,3509987,-,3203
431,BUMA.1121.00068,1,2922567,2925770,+,3203
431,BUMA.1121.00099,1,2368671,2371874,-,3203
431,BUMA.1121.00091,1,447275,450478,-,3203
431,BUMA.1121.00098,1,2769615,2772838,+,3223
431,BUMA.1121.00013,1,1221659,1224861,+,3202
431,BUMA.1121.00049,1,1770105,1773307,-,3202
431,BUMA.1121.00072,1,86946,90147,+,3201
431,BUMA.1121.00076,1,1280884,1284086,-,3202
431,BUMA.1121.00083,1,1614674,1617876,-,3202
431,BUMA.1121.00078,1,1960759,1963961,-,3202
431,BUMA.1121.00095,1,1582399,1585602,-,3203
431,BUMA.1121.00077,1,2737380,2740581,+,3201
431,BUMA.1121.00063,1,86941,90142,+,3201
431,BUMA.1121.00061,1,86947,90148,+,3201
431,BUMA.1121.00050,1,1304146,1307349,-,3203
431,BUMA.1121.00081,1,3506969,3510148,-,3179
431,BUMA.1121.00074,1,3797183,3800385,-,3202
431,BUMA.1121.00062,1,499210,502412,-,3202
431,BUMA.1121.00060,1,2241608,2244810,-,3202
431,BUMA.1121.00070,1,86953,90154,+,3201
431,BUMA.1121.00075,1,3528123,3531324,+,3201
431,BUMA.1121.00041,1,1302913,1306115,+,3202
431,BUMA.1121.00073,1,86953,90154,+,3201
431,BUMA.1121.00017,1,3468236,3471439,-,3203
431,BUMA.1121.00066,1,86836,90037,+,3201
431,BUMA.1121.00107,1,4017170,4020373,+,3203
431,BUMA.1121.00085,1,2823027,2826230,-,3203
431,BUMA.1121.00030,1,3468315,3471518,-,3203
431,BUMA.1121.00112,1,3000108,3003312,-,3204
431,BUMA.1121.00002,1,435353,438556,-,3203
431,BUMA.1121.00082,1,86953,90154,+,3201
431,BUMA.1121.00014,1,2824511,2827712,-,3201
431,BUMA.1121.00011,1,1559568,1562771,-,3203
431,BUMA.1121.00019,1,3509108,3512311,-,3203
431,BUMA.1121.00057,1,1181388,1184589,+,3201
431,BUMA.1121.00018,1,568625,571827,+,3202
431,BUMA.1121.00039,1,158448,161650,+,3202
431,BUMA.1121.00016,1,2165097,2168299,+,3202
431,BUMA.1121.00004,1,3620455,3623658,-,3203
431,BUMA.1121.00005,1,3519500,3522703,-,3203
431,BUMA.1121.00100,1,1248850,1252056,-,3206
431,BUMA.1121.00006,1,3506861,3510064,-,3203
432,BUMA.1121.00027,1,2255704,2265183,+,9479
432,BUMA.1121.00025,1,2656283,2665721,-,9438
432,BUMA.1121.00021,1,710914,720389,+,9475
432,BUMA.1121.00023,1,2429972,2439432,+,9460
432,BUMA.1121.00024,1,3455846,3465283,-,9437
432,BUMA.1121.00024,1,3473411,3482846,-,9435
432,BUMA.1121.00024,1,3490974,3500408,-,9434
432,BUMA.1121.00033,1,2354022,2363516,+,9494
432,BUMA.1121.00034,1,3557434,3566869,-,9435
432,BUMA.1121.00036,1,456266,465694,+,9428
432,BUMA.1121.00032,1,1580600,1590035,-,9435
432,BUMA.1121.00009,1,1467141,1476547,-,9406
432,BUMA.1121.00008,1,3542019,3551454,-,9435
432,BUMA.1121.00003,1,2605244,2614621,+,9377
432,BUMA.1121.00109,1,1769235,1778657,-,9422
432,BUMA.1121.00053,1,3848080,3857512,+,9432
432,BUMA.1121.00110,1,707982,717390,-,9408
432,BUMA.1121.00104,1,1164267,1173670,-,9403
432,BUMA.1121.00086,1,2265309,2274737,+,9428
432,BUMA.1121.00086,1,2283836,2293264,+,9428
432,BUMA.1121.00092,1,97143,106532,+,9389
432,BUMA.1121.00096,1,3153786,3163201,-,9415
432,BUMA.1121.00054,1,498674,508123,-,9449
432,BUMA.1121.00097,1,3940399,3949795,-,9396
432,BUMA.1121.00093,1,427303,436693,-,9390
432,BUMA.1121.00106,1,3874932,3884342,+,9410
432,BUMA.1121.00010,1,1626075,1635540,+,9465
432,BUMA.1121.00035,1,1124230,1133684,+,9454
432,BUMA.1121.00108,1,1078606,1088037,+,9431
432,BUMA.1121.00028,1,3527041,3536485,-,9444
432,BUMA.1121.00028,1,3544613,3554048,-,9435
432,BUMA.1121.00028,1,3562181,3571616,-,9435
432,BUMA.1121.00094,1,108714,118186,+,9472
432,BUMA.1121.00102,1,1172328,1181738,-,9410
432,BUMA.1121.00111,1,223198,232698,+,9500
432,BUMA.1121.00089,1,124563,133980,+,9417
432,BUMA.1121.00084,1,333959,343395,+,9436
432,BUMA.1121.00029,1,839352,848830,-,9478
432,BUMA.1121.00012,1,2814056,2823473,+,9417
432,BUMA.1121.00087,1,1042352,1051781,-,9429
432,BUMA.1121.00043,1,84377,93851,+,9474
432,BUMA.1121.00046,1,1451106,1460534,+,9428
432,BUMA.1121.00037,1,2731319,2740839,+,9520
432,BUMA.1121.00080,1,111254,120773,+,9519
432,BUMA.1121.00079,1,108870,118376,+,9506
432,BUMA.1121.00045,1,3984871,3994329,-,9458
432,BUMA.1121.00071,1,98603,108030,+,9427
432,BUMA.1121.00056,1,3791452,3800870,-,9418
432,BUMA.1121.00065,1,97292,106768,+,9476
432,BUMA.1121.00058,1,442412,451866,-,9454
432,BUMA.1121.00007,1,4021426,4030843,-,9417
432,BUMA.1121.00067,1,298238,307737,-,9499
432,BUMA.1121.00090,1,2196825,2206304,+,9479
432,BUMA.1121.00051,1,108774,118287,+,9513
432,BUMA.1121.00020,1,3591903,3601338,-,9435
432,BUMA.1121.00020,1,3609465,3618898,-,9433
432,BUMA.1121.00103,1,252062,261461,-,9399
432,BUMA.1121.00048,1,3427665,3437113,+,9448
432,BUMA.1121.00047,1,2862608,2872114,-,9506
432,BUMA.1121.00042,1,513409,522830,-,9421
432,BUMA.1121.00055,1,3744230,3753666,+,9436
432,BUMA.1121.00031,1,1445416,1454845,+,9429
432,BUMA.1121.00040,1,3537465,3546887,-,9422
432,BUMA.1121.00044,1,2785618,2795053,-,9435
432,BUMA.1121.00088,1,960284,969661,+,9377
432,BUMA.1121.00069,1,98533,107964,+,9431
432,BUMA.1121.00064,1,114017,123469,+,9452
432,BUMA.1121.00105,1,1108523,1117999,-,9476
432,BUMA.1121.00015,1,387819,397263,+,9444
432,BUMA.1121.00059,1,3327941,3337381,+,9440
432,BUMA.1121.00026,1,749250,758677,-,9427
432,BUMA.1121.00022,1,1308270,1317650,-,9380
432,BUMA.1121.00052,1,3213096,3222561,-,9465
432,BUMA.1121.00101,1,2371129,2380545,-,9416
432,BUMA.1121.00001,1,4057258,4066727,-,9469
432,BUMA.1121.00038,1,124951,134399,+,9448
432,BUMA.1121.00068,1,2932867,2942263,+,9396
432,BUMA.1121.00099,1,2338405,2347859,-,9454
432,BUMA.1121.00091,1,430677,440183,-,9506
432,BUMA.1121.00098,1,2792327,2801792,+,9465
432,BUMA.1121.00013,1,3505203,3514676,-,9473
432,BUMA.1121.00049,1,1739424,1748842,-,9418
432,BUMA.1121.00072,1,102426,111861,+,9435
432,BUMA.1121.00076,1,1250938,1260348,-,9410
432,BUMA.1121.00083,1,1586722,1596158,-,9436
432,BUMA.1121.00078,1,1944333,1953712,-,9379
432,BUMA.1121.00095,1,1565920,1575303,-,9383
432,BUMA.1121.00077,1,2766003,2775409,+,9406
432,BUMA.1121.00063,1,108659,118060,+,9401
432,BUMA.1121.00061,1,108665,118080,+,9415
432,BUMA.1121.00050,1,1291197,1300626,-,9429
432,BUMA.1121.00081,1,125020,134468,+,9448
432,BUMA.1121.00074,1,3766442,3775920,-,9478
432,BUMA.1121.00062,1,473484,482895,-,9411
432,BUMA.1121.00060,1,2210507,2219965,-,9458
432,BUMA.1121.00070,1,108671,118074,+,9403
432,BUMA.1121.00075,1,3551858,3561261,+,9403
432,BUMA.1121.00041,1,1327903,1337364,+,9461
432,BUMA.1121.00073,1,108671,118070,+,9399
432,BUMA.1121.00017,1,3455099,3464534,-,9435
432,BUMA.1121.00066,1,105833,115262,+,9429
432,BUMA.1121.00107,1,4037459,4046876,+,9417
432,BUMA.1121.00085,1,2810042,2819507,-,9465
432,BUMA.1121.00030,1,3455178,3464613,-,9435
432,BUMA.1121.00112,1,2969448,2978831,-,9383
432,BUMA.1121.00002,1,1652432,1661906,+,9474
432,BUMA.1121.00082,1,108671,118106,+,9435
432,BUMA.1121.00014,1,2795624,2805093,-,9469
432,BUMA.1121.00011,1,1529228,1538684,-,9456
432,BUMA.1121.00019,1,3478410,3487837,-,9427
432,BUMA.1121.00019,1,3495967,3505406,-,9439
432,BUMA.1121.00057,1,1203105,1212578,+,9473
432,BUMA.1121.00018,1,594159,603595,+,9436
432,BUMA.1121.00039,1,188024,197410,+,9386
432,BUMA.1121.00016,1,2191714,2201215,+,9501
432,BUMA.1121.00004,1,3607318,3616753,-,9435
432,BUMA.1121.00005,1,3488469,3497934,-,9465
432,BUMA.1121.00100,1,1230783,1240159,-,9376
432,BUMA.1121.00006,1,124951,134399,+,9448
433,BUMA.1121.00027,1,2287717,2291817,+,4100
433,BUMA.1121.00025,1,2625076,2629189,-,4113
433,BUMA.1121.00021,1,764122,768234,+,4112
433,BUMA.1121.00023,1,2458357,2462470,+,4113
433,BUMA.1121.00024,1,3441054,3445167,-,4113
433,BUMA.1121.00033,1,2380964,2385078,+,4114
433,BUMA.1121.00034,1,3542641,3546754,-,4113
433,BUMA.1121.00036,1,476373,480486,+,4113
433,BUMA.1121.00032,1,1565807,1569920,-,4113
433,BUMA.1121.00009,1,1446053,1450153,-,4100
433,BUMA.1121.00008,1,3523889,3528002,-,4113
433,BUMA.1121.00003,1,2628908,2633009,+,4101
433,BUMA.1121.00109,1,1756071,1760185,-,4114
433,BUMA.1121.00053,1,3866563,3870667,+,4104
433,BUMA.1121.00110,1,690869,694983,-,4114
433,BUMA.1121.00104,1,1149257,1153359,-,4102
433,BUMA.1121.00086,1,2303944,2308057,+,4113
433,BUMA.1121.00092,1,115589,119703,+,4114
433,BUMA.1121.00096,1,3140641,3144743,-,4102
433,BUMA.1121.00054,1,485017,489130,-,4113
433,BUMA.1121.00097,1,3912059,3916173,-,4114
433,BUMA.1121.00093,1,414133,418247,-,4114
433,BUMA.1121.00106,1,3893654,3897768,+,4114
433,BUMA.1121.00010,1,1646435,1650548,+,4113
433,BUMA.1121.00035,1,1145505,1149619,+,4114
433,BUMA.1121.00108,1,1111029,1115128,+,4099
433,BUMA.1121.00028,1,3512247,3516360,-,4113
433,BUMA.1121.00094,1,126436,130538,+,4102
433,BUMA.1121.00102,1,1159183,1163287,-,4104
433,BUMA.1121.00111,1,263347,267460,+,4113
433,BUMA.1121.00089,1,142230,146332,+,4102
433,BUMA.1121.00084,1,354042,358144,+,4102
433,BUMA.1121.00029,1,823419,827533,-,4114
433,BUMA.1121.00012,1,2849295,2853408,+,4113
433,BUMA.1121.00087,1,1027561,1031674,-,4113
433,BUMA.1121.00043,1,117105,121219,+,4114
433,BUMA.1121.00046,1,1471215,1475328,+,4113
433,BUMA.1121.00037,1,2765196,2769310,+,4114
433,BUMA.1121.00080,1,170957,175059,+,4102
433,BUMA.1121.00079,1,126625,130727,+,4102
433,BUMA.1121.00045,1,3971297,3975399,-,4102
433,BUMA.1121.00071,1,117066,121168,+,4102
433,BUMA.1121.00056,1,3779101,3783203,-,4102
433,BUMA.1121.00065,1,120640,124742,+,4102
433,BUMA.1121.00058,1,429003,433105,-,4102
433,BUMA.1121.00007,1,3992984,3997101,-,4117
433,BUMA.1121.00067,1,284829,288931,-,4102
433,BUMA.1121.00090,1,2229390,2233504,+,4114
433,BUMA.1121.00051,1,126537,130639,+,4102
433,BUMA.1121.00020,1,3577110,3581223,-,4113
433,BUMA.1121.00103,1,238900,243014,-,4114
433,BUMA.1121.00048,1,3446658,3450771,+,4113
433,BUMA.1121.00047,1,2850257,2854359,-,4102
433,BUMA.1121.00042,1,499751,503864,-,4113
433,BUMA.1121.00055,1,3762974,3767076,+,4102
433,BUMA.1121.00031,1,1468634,1472748,+,4114
433,BUMA.1121.00040,1,3523893,3528006,-,4113
433,BUMA.1121.00044,1,2770825,2774938,-,4113
433,BUMA.1121.00088,1,980309,984411,+,4102
433,BUMA.1121.00069,1,116995,121097,+,4102
433,BUMA.1121.00064,1,132777,136879,+,4102
433,BUMA.1121.00105,1,1087790,1091892,-,4102
433,BUMA.1121.00015,1,407944,412057,+,4113
433,BUMA.1121.00059,1,3346429,3350531,+,4102
433,BUMA.1121.00026,1,734787,738900,-,4113
433,BUMA.1121.00022,1,1293478,1297591,-,4113
433,BUMA.1121.00052,1,3198303,3202416,-,4113
433,BUMA.1121.00101,1,2357984,2362086,-,4102
433,BUMA.1121.00001,1,4035598,4039712,-,4114
433,BUMA.1121.00038,1,143944,148057,+,4113
433,BUMA.1121.00068,1,2956072,2960175,+,4103
433,BUMA.1121.00099,1,2326129,2330232,-,4103
433,BUMA.1121.00091,1,417533,421635,-,4102
433,BUMA.1121.00098,1,2811592,2815694,+,4102
433,BUMA.1121.00013,1,3490410,3494523,-,4113
433,BUMA.1121.00049,1,1724415,1728517,-,4102
433,BUMA.1121.00072,1,120902,125004,+,4102
433,BUMA.1121.00076,1,1236179,1240282,-,4103
433,BUMA.1121.00083,1,1573318,1577420,-,4102
433,BUMA.1121.00078,1,1880121,1884234,-,4113
433,BUMA.1121.00095,1,1548114,1552218,-,4104
433,BUMA.1121.00077,1,2788412,2792526,+,4114
433,BUMA.1121.00063,1,127091,131193,+,4102
433,BUMA.1121.00061,1,127114,131216,+,4102
433,BUMA.1121.00050,1,1276404,1280517,-,4113
433,BUMA.1121.00081,1,144013,148126,+,4113
433,BUMA.1121.00074,1,3753033,3757135,-,4102
433,BUMA.1121.00062,1,452743,456845,-,4102
433,BUMA.1121.00060,1,2196933,2201035,-,4102
433,BUMA.1121.00070,1,127106,131208,+,4102
433,BUMA.1121.00075,1,3571918,3576021,+,4103
433,BUMA.1121.00041,1,1354479,1358581,+,4102
433,BUMA.1121.00073,1,127104,131206,+,4102
433,BUMA.1121.00017,1,3440306,3444419,-,4113
433,BUMA.1121.00066,1,124297,128399,+,4102
433,BUMA.1121.00107,1,4056349,4060452,+,4103
433,BUMA.1121.00085,1,2795249,2799362,-,4113
433,BUMA.1121.00030,1,3440385,3444498,-,4113
433,BUMA.1121.00112,1,2954149,2958265,-,4116
433,BUMA.1121.00002,1,1672120,1676233,+,4113
433,BUMA.1121.00082,1,127409,131511,+,4102
433,BUMA.1121.00014,1,2765676,2769790,-,4114
433,BUMA.1121.00011,1,1497349,1501449,-,4100
433,BUMA.1121.00019,1,3463623,3467736,-,4113
433,BUMA.1121.00057,1,1223491,1227593,+,4102
433,BUMA.1121.00018,1,630689,634803,+,4114
433,BUMA.1121.00039,1,221850,225963,+,4113
433,BUMA.1121.00016,1,2229250,2233364,+,4114
433,BUMA.1121.00004,1,3592525,3596638,-,4113
433,BUMA.1121.00005,1,3444028,3448128,-,4100
433,BUMA.1121.00100,1,1217635,1221737,-,4102
433,BUMA.1121.00006,1,143944,148057,+,4113
434,BUMA.1121.00027,1,2291982,2296044,+,4062
434,BUMA.1121.00025,1,2620859,2624923,-,4064
434,BUMA.1121.00021,1,768387,772451,+,4064
434,BUMA.1121.00023,1,2462623,2466688,+,4065
434,BUMA.1121.00024,1,3436827,3440889,-,4062
434,BUMA.1121.00033,1,2385231,2389295,+,4064
434,BUMA.1121.00034,1,3538414,3542476,-,4062
434,BUMA.1121.00036,1,480651,484713,+,4062
434,BUMA.1121.00032,1,1561580,1565642,-,4062
434,BUMA.1121.00009,1,1441824,1445888,-,4064
434,BUMA.1121.00008,1,3519662,3523724,-,4062
434,BUMA.1121.00003,1,2633174,2637238,+,4064
434,BUMA.1121.00109,1,1751854,1755918,-,4064
434,BUMA.1121.00053,1,3870832,3874894,+,4062
434,BUMA.1121.00110,1,686653,690716,-,4063
434,BUMA.1121.00104,1,1145030,1149092,-,4062
434,BUMA.1121.00086,1,2308222,2312284,+,4062
434,BUMA.1121.00092,1,119856,123920,+,4064
434,BUMA.1121.00096,1,3136415,3140478,-,4063
434,BUMA.1121.00054,1,480790,484852,-,4062
434,BUMA.1121.00097,1,3907847,3911906,-,4059
434,BUMA.1121.00093,1,409916,413980,-,4064
434,BUMA.1121.00106,1,3897921,3901985,+,4064
434,BUMA.1121.00010,1,1650713,1654748,+,4035
434,BUMA.1121.00035,1,1149772,1153836,+,4064
434,BUMA.1121.00108,1,1115293,1119357,+,4064
434,BUMA.1121.00028,1,3508020,3512082,-,4062
434,BUMA.1121.00094,1,130703,134768,+,4065
434,BUMA.1121.00102,1,1154956,1159018,-,4062
434,BUMA.1121.00111,1,267613,271677,+,4064
434,BUMA.1121.00089,1,146497,150562,+,4065
434,BUMA.1121.00084,1,358309,362371,+,4062
434,BUMA.1121.00029,1,819202,823266,-,4064
434,BUMA.1121.00012,1,2853561,2857625,+,4064
434,BUMA.1121.00087,1,1023334,1027396,-,4062
434,BUMA.1121.00043,1,121372,125436,+,4064
434,BUMA.1121.00046,1,1475493,1479555,+,4062
434,BUMA.1121.00037,1,2769463,2773527,+,4064
434,BUMA.1121.00080,1,175224,179289,+,4065
434,BUMA.1121.00079,1,130892,134957,+,4065
434,BUMA.1121.00045,1,3967070,3971132,-,4062
434,BUMA.1121.00071,1,121333,125396,+,4063
434,BUMA.1121.00056,1,3774871,3778936,-,4065
434,BUMA.1121.00065,1,124907,128969,+,4062
434,BUMA.1121.00058,1,424773,428838,-,4065
434,BUMA.1121.00007,1,3988768,3992831,-,4063
434,BUMA.1121.00067,1,280599,284664,-,4065
434,BUMA.1121.00090,1,2233657,2237721,+,4064
434,BUMA.1121.00051,1,130804,134869,+,4065
434,BUMA.1121.00020,1,3572883,3576945,-,4062
434,BUMA.1121.00103,1,234683,238747,-,4064
434,BUMA.1121.00048,1,3450936,3454998,+,4062
434,BUMA.1121.00047,1,2846030,2850092,-,4062
434,BUMA.1121.00042,1,495524,499586,-,4062
434,BUMA.1121.00055,1,3767241,3771302,+,4061
434,BUMA.1121.00031,1,1472901,1476966,+,4065
434,BUMA.1121.00040,1,3519666,3523728,-,4062
434,BUMA.1121.00044,1,2766598,2770660,-,4062
434,BUMA.1121.00088,1,984576,988638,+,4062
434,BUMA.1121.00069,1,121262,125325,+,4063
434,BUMA.1121.00064,1,137044,141109,+,4065
434,BUMA.1121.00105,1,1083563,1087625,-,4062
434,BUMA.1121.00015,1,412222,416284,+,4062
434,BUMA.1121.00059,1,3350696,3354758,+,4062
434,BUMA.1121.00026,1,730560,734622,-,4062
434,BUMA.1121.00022,1,1289251,1293313,-,4062
434,BUMA.1121.00052,1,3194076,3198138,-,4062
434,BUMA.1121.00101,1,2353755,2357819,-,4064
434,BUMA.1121.00001,1,4031381,4035445,-,4064
434,BUMA.1121.00038,1,148222,152284,+,4062
434,BUMA.1121.00068,1,2960340,2964402,+,4062
434,BUMA.1121.00099,1,2321918,2325964,-,4046
434,BUMA.1121.00091,1,413306,417368,-,4062
434,BUMA.1121.00098,1,2815859,2819923,+,4064
434,BUMA.1121.00013,1,3486183,3490245,-,4062
434,BUMA.1121.00049,1,1720188,1724250,-,4062
434,BUMA.1121.00072,1,125169,129232,+,4063
434,BUMA.1121.00076,1,1231952,1236014,-,4062
434,BUMA.1121.00083,1,1569090,1573153,-,4063
434,BUMA.1121.00078,1,1874309,1878346,-,4037
434,BUMA.1121.00095,1,1543885,1547949,-,4064
434,BUMA.1121.00077,1,2792679,2796738,+,4059
434,BUMA.1121.00063,1,131358,135421,+,4063
434,BUMA.1121.00061,1,131381,135444,+,4063
434,BUMA.1121.00050,1,1272177,1276239,-,4062
434,BUMA.1121.00081,1,148291,152353,+,4062
434,BUMA.1121.00074,1,3748803,3752868,-,4065
434,BUMA.1121.00062,1,448516,452578,-,4062
434,BUMA.1121.00060,1,2192706,2196768,-,4062
434,BUMA.1121.00070,1,131373,135436,+,4063
434,BUMA.1121.00075,1,3576186,3580248,+,4062
434,BUMA.1121.00041,1,1358746,1362808,+,4062
434,BUMA.1121.00073,1,131371,135434,+,4063
434,BUMA.1121.00017,1,3436079,3440141,-,4062
434,BUMA.1121.00066,1,128564,132627,+,4063
434,BUMA.1121.00107,1,4060617,4064680,+,4063
434,BUMA.1121.00085,1,2791022,2795084,-,4062
434,BUMA.1121.00030,1,3436158,3440220,-,4062
434,BUMA.1121.00112,1,2949932,2953996,-,4064
434,BUMA.1121.00002,1,1676398,1680433,+,4035
434,BUMA.1121.00082,1,131676,135739,+,4063
434,BUMA.1121.00014,1,2761458,2765523,-,4065
434,BUMA.1121.00011,1,1493120,1497184,-,4064
434,BUMA.1121.00019,1,3459396,3463458,-,4062
434,BUMA.1121.00057,1,1227758,1231819,+,4061
434,BUMA.1121.00018,1,634956,639020,+,4064
434,BUMA.1121.00039,1,227740,231779,+,4039
434,BUMA.1121.00016,1,2233517,2237581,+,4064
434,BUMA.1121.00004,1,3588298,3592360,-,4062
434,BUMA.1121.00005,1,3439799,3443863,-,4064
434,BUMA.1121.00100,1,1213427,1217470,-,4043
434,BUMA.1121.00006,1,148222,152284,+,4062
435,BUMA.1121.00027,1,2296734,2305792,+,9058
435,BUMA.1121.00025,1,2611127,2620168,-,9041
435,BUMA.1121.00021,1,773141,782151,+,9010
435,BUMA.1121.00023,1,2467378,2476446,+,9068
435,BUMA.1121.00024,1,3427213,3436136,-,8923
435,BUMA.1121.00033,1,2389985,2399028,+,9043
435,BUMA.1121.00034,1,3528800,3537723,-,8923
435,BUMA.1121.00036,1,485403,494327,+,8924
435,BUMA.1121.00032,1,1551966,1560889,-,8923
435,BUMA.1121.00009,1,1432114,1441133,-,9019
435,BUMA.1121.00008,1,3510048,3518971,-,8923
435,BUMA.1121.00003,1,2637928,2646924,+,8996
435,BUMA.1121.00109,1,1742120,1751163,-,9043
435,BUMA.1121.00053,1,3875584,3884690,+,9106
435,BUMA.1121.00110,1,676879,685962,-,9083
435,BUMA.1121.00104,1,1135266,1144339,-,9073
435,BUMA.1121.00086,1,2312974,2321898,+,8924
435,BUMA.1121.00092,1,124610,133604,+,8994
435,BUMA.1121.00096,1,3126641,3135724,-,9083
435,BUMA.1121.00054,1,471168,480099,-,8931
435,BUMA.1121.00097,1,3898202,3907156,-,8954
435,BUMA.1121.00093,1,400232,409225,-,8993
435,BUMA.1121.00106,1,3902675,3911701,+,9026
435,BUMA.1121.00010,1,1656705,1665628,+,8923
435,BUMA.1121.00035,1,1154526,1163502,+,8976
435,BUMA.1121.00108,1,1120047,1129091,+,9044
435,BUMA.1121.00028,1,3498406,3507329,-,8923
435,BUMA.1121.00094,1,135458,144604,+,9146
435,BUMA.1121.00102,1,1145214,1154265,-,9051
435,BUMA.1121.00111,1,272367,281457,+,9090
435,BUMA.1121.00089,1,151252,160400,+,9148
435,BUMA.1121.00084,1,363061,372103,+,9042
435,BUMA.1121.00029,1,809512,818511,-,8999
435,BUMA.1121.00012,1,2858315,2867347,+,9032
435,BUMA.1121.00087,1,1013720,1022643,-,8923
435,BUMA.1121.00043,1,126126,135170,+,9044
435,BUMA.1121.00046,1,1480245,1489177,+,8932
435,BUMA.1121.00037,1,2774217,2783283,+,9066
435,BUMA.1121.00080,1,179979,189174,+,9195
435,BUMA.1121.00079,1,135647,144832,+,9185
435,BUMA.1121.00045,1,3957224,3966379,-,9155
435,BUMA.1121.00071,1,126086,135112,+,9026
435,BUMA.1121.00056,1,3765033,3774180,-,9147
435,BUMA.1121.00065,1,129659,138725,+,9066
435,BUMA.1121.00058,1,415039,424082,-,9043
435,BUMA.1121.00007,1,3978970,3988077,-,9107
435,BUMA.1121.00067,1,270837,279908,-,9071
435,BUMA.1121.00090,1,2238411,2247437,+,9026
435,BUMA.1121.00051,1,135559,144715,+,9156
435,BUMA.1121.00020,1,3563269,3572192,-,8923
435,BUMA.1121.00103,1,224887,233992,-,9105
435,BUMA.1121.00048,1,3455688,3464620,+,8932
435,BUMA.1121.00047,1,2836200,2845339,-,9139
435,BUMA.1121.00042,1,485902,494833,-,8931
435,BUMA.1121.00055,1,3771992,3781058,+,9066
435,BUMA.1121.00031,1,1477656,1486682,+,9026
435,BUMA.1121.00040,1,3510044,3518975,-,8931
435,BUMA.1121.00044,1,2756984,2765907,-,8923
435,BUMA.1121.00088,1,989328,998360,+,9032
435,BUMA.1121.00069,1,126015,135042,+,9027
435,BUMA.1121.00064,1,141799,150799,+,9000
435,BUMA.1121.00105,1,1073847,1082872,-,9025
435,BUMA.1121.00015,1,416974,425906,+,8932
435,BUMA.1121.00059,1,3355448,3364500,+,9052
435,BUMA.1121.00026,1,720938,729869,-,8931
435,BUMA.1121.00022,1,1279637,1288560,-,8923
435,BUMA.1121.00052,1,3184454,3193385,-,8931
435,BUMA.1121.00101,1,2344013,2353064,-,9051
435,BUMA.1121.00001,1,4021643,4030690,-,9047
435,BUMA.1121.00038,1,152974,161906,+,8932
435,BUMA.1121.00068,1,2965092,2974190,+,9098
435,BUMA.1121.00099,1,2312048,2321227,-,9179
435,BUMA.1121.00091,1,403508,412615,-,9107
435,BUMA.1121.00098,1,2820613,2829719,+,9106
435,BUMA.1121.00013,1,3476561,3485492,-,8931
435,BUMA.1121.00049,1,1710432,1719497,-,9065
435,BUMA.1121.00072,1,129922,138948,+,9026
435,BUMA.1121.00076,1,1222188,1231261,-,9073
435,BUMA.1121.00083,1,1559374,1568399,-,9025
435,BUMA.1121.00078,1,1864607,1873618,-,9011
435,BUMA.1121.00095,1,1534142,1543194,-,9052
435,BUMA.1121.00077,1,2797428,2806535,+,9107
435,BUMA.1121.00063,1,136111,145137,+,9026
435,BUMA.1121.00061,1,136134,145160,+,9026
435,BUMA.1121.00050,1,1262555,1271486,-,8931
435,BUMA.1121.00081,1,153043,161975,+,8932
435,BUMA.1121.00074,1,3739039,3748112,-,9073
435,BUMA.1121.00062,1,438782,447825,-,9043
435,BUMA.1121.00060,1,2182860,2192015,-,9155
435,BUMA.1121.00070,1,136126,145153,+,9027
435,BUMA.1121.00075,1,3580938,3590003,+,9065
435,BUMA.1121.00041,1,1363498,1372588,+,9090
435,BUMA.1121.00073,1,136124,145150,+,9026
435,BUMA.1121.00017,1,3426465,3435388,-,8923
435,BUMA.1121.00066,1,133317,142343,+,9026
435,BUMA.1121.00107,1,4065370,4074379,+,9009
435,BUMA.1121.00085,1,2781400,2790331,-,8931
435,BUMA.1121.00030,1,3426544,3435467,-,8923
435,BUMA.1121.00112,1,2940166,2949241,-,9075
435,BUMA.1121.00002,1,1682389,1691313,+,8924
435,BUMA.1121.00082,1,136429,145455,+,9026
435,BUMA.1121.00014,1,2751718,2760767,-,9049
435,BUMA.1121.00011,1,1483402,1492429,-,9027
435,BUMA.1121.00019,1,3449782,3458705,-,8923
435,BUMA.1121.00057,1,1232509,1241567,+,9058
435,BUMA.1121.00018,1,639710,648744,+,9034
435,BUMA.1121.00039,1,232469,241588,+,9119
435,BUMA.1121.00016,1,2238271,2247345,+,9074
435,BUMA.1121.00004,1,3578684,3587607,-,8923
435,BUMA.1121.00005,1,3430137,3439108,-,8971
435,BUMA.1121.00100,1,1203653,1212736,-,9083
435,BUMA.1121.00006,1,152974,161906,+,8932
436,BUMA.1121.00027,1,2342062,2346415,+,4353
436,BUMA.1121.00025,1,2606785,2611125,-,4340
436,BUMA.1121.00021,1,782152,786493,+,4341
436,BUMA.1121.00023,1,2476447,2480788,+,4341
436,BUMA.1121.00024,1,3422871,3427211,-,4340
436,BUMA.1121.00033,1,2399029,2403370,+,4341
436,BUMA.1121.00034,1,3524458,3528798,-,4340
436,BUMA.1121.00036,1,494328,498669,+,4341
436,BUMA.1121.00032,1,1547624,1551964,-,4340
436,BUMA.1121.00009,1,1427771,1432112,-,4341
436,BUMA.1121.00008,1,3505706,3510046,-,4340
436,BUMA.1121.00003,1,2646925,2651267,+,4342
436,BUMA.1121.00109,1,1737778,1742118,-,4340
436,BUMA.1121.00053,1,3922467,3926823,+,4356
436,BUMA.1121.00110,1,672537,676877,-,4340
436,BUMA.1121.00104,1,1130923,1135264,-,4341
436,BUMA.1121.00086,1,2321899,2326240,+,4341
436,BUMA.1121.00092,1,3716006,3720366,-,4360
436,BUMA.1121.00096,1,3122301,3126639,-,4338
436,BUMA.1121.00054,1,466826,471166,-,4340
436,BUMA.1121.00097,1,3893861,3898200,-,4339
436,BUMA.1121.00093,1,906071,910431,+,4360
436,BUMA.1121.00106,1,3911702,3916044,+,4342
436,BUMA.1121.00010,1,1665629,1669970,+,4341
436,BUMA.1121.00035,1,1201657,1206013,+,4356
436,BUMA.1121.00108,1,1129092,1133432,+,4340
436,BUMA.1121.00028,1,3494064,3498404,-,4340
436,BUMA.1121.00094,1,144605,148949,+,4344
436,BUMA.1121.00102,1,1140871,1145212,-,4341
436,BUMA.1121.00111,1,281458,285799,+,4341
436,BUMA.1121.00089,1,160401,164746,+,4345
436,BUMA.1121.00084,1,372104,376445,+,4341
436,BUMA.1121.00029,1,764513,768869,-,4356
436,BUMA.1121.00012,1,2904038,2908394,+,4356
436,BUMA.1121.00087,1,1009378,1013718,-,4340
436,BUMA.1121.00043,1,135171,139513,+,4342
436,BUMA.1121.00046,1,1489178,1493519,+,4341
436,BUMA.1121.00037,1,2783284,2787626,+,4342
436,BUMA.1121.00080,1,189175,193520,+,4345
436,BUMA.1121.00079,1,182565,186925,+,4360
436,BUMA.1121.00045,1,3952880,3957222,-,4342
436,BUMA.1121.00071,1,163490,167844,+,4354
436,BUMA.1121.00056,1,3760687,3765031,-,4344
436,BUMA.1121.00065,1,176350,180707,+,4357
436,BUMA.1121.00058,1,410696,415037,-,4341
436,BUMA.1121.00007,1,3974628,3978968,-,4340
436,BUMA.1121.00067,1,229714,234071,-,4357
436,BUMA.1121.00090,1,2247438,2251779,+,4341
436,BUMA.1121.00051,1,144716,149061,+,4345
436,BUMA.1121.00020,1,3558927,3563267,-,4340
436,BUMA.1121.00103,1,220542,224885,-,4343
436,BUMA.1121.00048,1,3464621,3468962,+,4341
436,BUMA.1121.00047,1,2831854,2836198,-,4344
436,BUMA.1121.00042,1,481560,485900,-,4340
436,BUMA.1121.00055,1,3818865,3823220,+,4355
436,BUMA.1121.00031,1,1486683,1491024,+,4341
436,BUMA.1121.00040,1,3505702,3510042,-,4340
436,BUMA.1121.00044,1,2752642,2756982,-,4340
436,BUMA.1121.00088,1,1035985,1040341,+,4356
436,BUMA.1121.00069,1,136597,140951,+,4354
436,BUMA.1121.00064,1,188424,192781,+,4357
436,BUMA.1121.00105,1,1069504,1073845,-,4341
436,BUMA.1121.00015,1,425907,430248,+,4341
436,BUMA.1121.00059,1,3364501,3368842,+,4341
436,BUMA.1121.00026,1,716596,720936,-,4340
436,BUMA.1121.00022,1,1275295,1279635,-,4340
436,BUMA.1121.00052,1,3180112,3184452,-,4340
436,BUMA.1121.00101,1,2339659,2344011,-,4352
436,BUMA.1121.00001,1,3979136,3983492,-,4356
436,BUMA.1121.00038,1,161907,166248,+,4341
436,BUMA.1121.00068,1,3011527,3015883,+,4356
436,BUMA.1121.00099,1,2267890,2272250,-,4360
436,BUMA.1121.00091,1,399162,403506,-,4344
436,BUMA.1121.00098,1,2866049,2870403,+,4354
436,BUMA.1121.00013,1,3472219,3476559,-,4340
436,BUMA.1121.00049,1,1706090,1710430,-,4340
436,BUMA.1121.00072,1,147261,151615,+,4354
436,BUMA.1121.00076,1,1217845,1222186,-,4341
436,BUMA.1121.00083,1,1518746,1523100,-,4354
436,BUMA.1121.00078,1,1860264,1864605,-,4341
436,BUMA.1121.00095,1,1529801,1534140,-,4339
436,BUMA.1121.00077,1,2806536,2810876,+,4340
436,BUMA.1121.00063,1,172339,176693,+,4354
436,BUMA.1121.00061,1,175314,179668,+,4354
436,BUMA.1121.00050,1,1258213,1262553,-,4340
436,BUMA.1121.00081,1,161976,166317,+,4341
436,BUMA.1121.00074,1,3734696,3739037,-,4341
436,BUMA.1121.00062,1,434439,438780,-,4341
436,BUMA.1121.00060,1,2178516,2182858,-,4342
436,BUMA.1121.00070,1,146947,151301,+,4354
436,BUMA.1121.00075,1,3590004,3594344,+,4340
436,BUMA.1121.00041,1,1409723,1414077,+,4354
436,BUMA.1121.00073,1,173269,177623,+,4354
436,BUMA.1121.00017,1,3422123,3426463,-,4340
436,BUMA.1121.00066,1,144075,148429,+,4354
436,BUMA.1121.00107,1,4074380,4078720,+,4340
436,BUMA.1121.00085,1,2777058,2781398,-,4340
436,BUMA.1121.00030,1,3422202,3426542,-,4340
436,BUMA.1121.00112,1,2935820,2940164,-,4344
436,BUMA.1121.00002,1,1691314,1695655,+,4341
436,BUMA.1121.00082,1,181729,186083,+,4354
436,BUMA.1121.00014,1,2747376,2751716,-,4340
436,BUMA.1121.00011,1,1479057,1483400,-,4343
436,BUMA.1121.00019,1,3445440,3449780,-,4340
436,BUMA.1121.00057,1,1241568,1245907,+,4339
436,BUMA.1121.00018,1,648745,653086,+,4341
436,BUMA.1121.00039,1,241589,245930,+,4341
436,BUMA.1121.00016,1,2247346,2251686,+,4340
436,BUMA.1121.00004,1,3574342,3578682,-,4340
436,BUMA.1121.00005,1,3425796,3430135,-,4339
436,BUMA.1121.00100,1,1199312,1203651,-,4339
436,BUMA.1121.00006,1,161907,166248,+,4341
437,BUMA.1121.00027,1,2346542,2358695,+,12153
437,BUMA.1121.00025,1,2594104,2606175,-,12071
437,BUMA.1121.00021,1,786719,798859,+,12140
437,BUMA.1121.00023,1,2481538,2493683,+,12145
437,BUMA.1121.00024,1,3410529,3422666,-,12137
437,BUMA.1121.00033,1,2403791,2415939,+,12148
437,BUMA.1121.00034,1,3512088,3524225,-,12137
437,BUMA.1121.00036,1,498979,511116,+,12137
437,BUMA.1121.00032,1,1535247,1547384,-,12137
437,BUMA.1121.00009,1,1415403,1427539,-,12136
437,BUMA.1121.00008,1,3493343,3505480,-,12137
437,BUMA.1121.00003,1,2651463,2663588,+,12125
437,BUMA.1121.00109,1,1725397,1737533,-,12136
437,BUMA.1121.00053,1,3928627,3940772,+,12145
437,BUMA.1121.00110,1,660322,672452,-,12130
437,BUMA.1121.00104,1,1118577,1130712,-,12135
437,BUMA.1121.00086,1,2326403,2338545,+,12142
437,BUMA.1121.00092,1,3703642,3715781,-,12139
437,BUMA.1121.00096,1,3110029,3122173,-,12144
437,BUMA.1121.00054,1,454393,466530,-,12137
437,BUMA.1121.00097,1,3881562,3893692,-,12130
437,BUMA.1121.00093,1,910656,922795,+,12139
437,BUMA.1121.00106,1,3916465,3928586,+,12121
437,BUMA.1121.00010,1,1670210,1682347,+,12137
437,BUMA.1121.00035,1,1206715,1218855,+,12140
437,BUMA.1121.00108,1,1133586,1145702,+,12116
437,BUMA.1121.00028,1,3481722,3493859,-,12137
437,BUMA.1121.00094,1,149207,161365,+,12158
437,BUMA.1121.00102,1,1128495,1140640,-,12145
437,BUMA.1121.00111,1,286612,298757,+,12145
437,BUMA.1121.00089,1,165005,177163,+,12158
437,BUMA.1121.00084,1,376601,388736,+,12135
437,BUMA.1121.00029,1,751945,764085,-,12140
437,BUMA.1121.00012,1,2908918,2921049,+,12131
437,BUMA.1121.00087,1,997073,1009215,-,12142
437,BUMA.1121.00043,1,139913,152068,+,12155
437,BUMA.1121.00046,1,1493703,1505840,+,12137
437,BUMA.1121.00037,1,2788529,2800672,+,12143
437,BUMA.1121.00080,1,193778,205936,+,12158
437,BUMA.1121.00079,1,187176,199324,+,12148
437,BUMA.1121.00045,1,3940540,3952690,-,12150
437,BUMA.1121.00071,1,168047,180224,+,12177
437,BUMA.1121.00056,1,3748298,3760456,-,12158
437,BUMA.1121.00065,1,180883,193018,+,12135
437,BUMA.1121.00058,1,398287,410422,-,12135
437,BUMA.1121.00007,1,3962282,3974417,-,12135
437,BUMA.1121.00067,1,217382,229517,-,12135
437,BUMA.1121.00090,1,2252116,2264254,+,12138
437,BUMA.1121.00051,1,149264,161404,+,12140
437,BUMA.1121.00020,1,3546557,3558694,-,12137
437,BUMA.1121.00103,1,208259,220394,-,12135
437,BUMA.1121.00048,1,3469258,3481395,+,12137
437,BUMA.1121.00047,1,2819377,2831518,-,12141
437,BUMA.1121.00042,1,469213,481355,-,12142
437,BUMA.1121.00055,1,3823606,3835756,+,12150
437,BUMA.1121.00031,1,1491759,1503899,+,12140
437,BUMA.1121.00040,1,3493262,3505399,-,12137
437,BUMA.1121.00044,1,2740258,2752395,-,12137
437,BUMA.1121.00088,1,1040607,1052746,+,12139
437,BUMA.1121.00069,1,141154,153350,+,12196
437,BUMA.1121.00064,1,192999,205134,+,12135
437,BUMA.1121.00105,1,1056930,1069063,-,12133
437,BUMA.1121.00015,1,430516,442653,+,12137
437,BUMA.1121.00059,1,3369375,3381510,+,12135
437,BUMA.1121.00026,1,704118,716265,-,12147
437,BUMA.1121.00022,1,1263011,1275153,-,12142
437,BUMA.1121.00052,1,3167714,3179851,-,12137
437,BUMA.1121.00101,1,2327376,2339512,-,12136
437,BUMA.1121.00001,1,3966330,3978470,-,12140
437,BUMA.1121.00038,1,166544,178681,+,12137
437,BUMA.1121.00068,1,3016121,3028304,+,12183
437,BUMA.1121.00099,1,2255532,2267686,-,12154
437,BUMA.1121.00091,1,386840,398980,-,12140
437,BUMA.1121.00098,1,2870586,2882736,+,12150
437,BUMA.1121.00013,1,3459842,3471979,-,12137
437,BUMA.1121.00049,1,1693745,1705880,-,12135
437,BUMA.1121.00072,1,151821,163999,+,12178
437,BUMA.1121.00076,1,1205402,1217543,-,12141
437,BUMA.1121.00083,1,1506343,1518542,-,12199
437,BUMA.1121.00078,1,1847894,1860024,-,12130
437,BUMA.1121.00095,1,1517506,1529646,-,12140
437,BUMA.1121.00077,1,2810961,2823091,+,12130
437,BUMA.1121.00063,1,176903,189098,+,12195
437,BUMA.1121.00061,1,179867,192062,+,12195
437,BUMA.1121.00050,1,1245899,1258036,-,12137
437,BUMA.1121.00081,1,166613,178750,+,12137
437,BUMA.1121.00074,1,3722336,3734471,-,12135
437,BUMA.1121.00062,1,422009,434144,-,12135
437,BUMA.1121.00060,1,2166190,2178340,-,12150
437,BUMA.1121.00070,1,151504,163700,+,12196
437,BUMA.1121.00075,1,3594632,3606772,+,12140
437,BUMA.1121.00041,1,1414275,1426448,+,12173
437,BUMA.1121.00073,1,177834,190030,+,12196
437,BUMA.1121.00017,1,3409753,3421890,-,12137
437,BUMA.1121.00066,1,148626,160804,+,12178
437,BUMA.1121.00107,1,4078875,4091020,+,12145
437,BUMA.1121.00085,1,2764660,2776797,-,12137
437,BUMA.1121.00030,1,3409818,3421955,-,12137
437,BUMA.1121.00112,1,2923530,2935665,-,12135
437,BUMA.1121.00002,1,1695895,1708032,+,12137
437,BUMA.1121.00082,1,186294,198493,+,12199
437,BUMA.1121.00014,1,2734248,2746393,-,12145
437,BUMA.1121.00011,1,1466727,1478885,-,12158
437,BUMA.1121.00019,1,3433070,3445207,-,12137
437,BUMA.1121.00057,1,1246083,1258246,+,12163
437,BUMA.1121.00018,1,653654,665725,+,12071
437,BUMA.1121.00039,1,246419,258564,+,12145
437,BUMA.1121.00016,1,2251960,2264110,+,12150
437,BUMA.1121.00004,1,3561972,3574109,-,12137
437,BUMA.1121.00005,1,3413431,3425564,-,12133
437,BUMA.1121.00100,1,1186882,1199017,-,12135
437,BUMA.1121.00006,1,166544,178681,+,12137
438,BUMA.1121.00027,1,2360110,2371138,+,11028
438,BUMA.1121.00025,1,2581628,2592654,-,11026
438,BUMA.1121.00021,1,800351,811377,+,11026
438,BUMA.1121.00023,1,2495104,2506131,+,11027
438,BUMA.1121.00024,1,965045,976063,-,11018
438,BUMA.1121.00033,1,2417458,2428473,+,11015
438,BUMA.1121.00034,1,1002475,1013493,-,11018
438,BUMA.1121.00036,1,374156,385174,-,11018
438,BUMA.1121.00032,1,2495560,2506578,-,11018
438,BUMA.1121.00009,1,1402947,1413962,-,11015
438,BUMA.1121.00008,1,968790,979808,-,11018
438,BUMA.1121.00003,1,2666663,2677690,+,11027
438,BUMA.1121.00109,1,1712937,1723968,-,11031
438,BUMA.1121.00053,1,3943746,3954774,+,11028
438,BUMA.1121.00110,1,647884,658894,-,11010
438,BUMA.1121.00104,1,1106029,1117043,-,11014
438,BUMA.1121.00086,1,3386337,3397355,-,11018
438,BUMA.1121.00092,1,3691082,3702136,-,11054
438,BUMA.1121.00096,1,3097601,3108630,-,11029
438,BUMA.1121.00054,1,781147,792156,-,11009
438,BUMA.1121.00097,1,3869119,3880128,-,11009
438,BUMA.1121.00093,1,924301,935355,+,11054
438,BUMA.1121.00106,1,3930071,3941094,+,11023
438,BUMA.1121.00010,1,476179,487206,+,11027
438,BUMA.1121.00035,1,1220311,1231337,+,11026
438,BUMA.1121.00108,1,1147116,1158116,+,11000
438,BUMA.1121.00028,1,965044,976062,-,11018
438,BUMA.1121.00094,1,162743,173770,+,11027
438,BUMA.1121.00102,1,1114487,1125514,-,11027
438,BUMA.1121.00111,1,300206,311232,+,11026
438,BUMA.1121.00089,1,178569,189596,+,11027
438,BUMA.1121.00084,1,390156,401173,+,11017
438,BUMA.1121.00029,1,739449,750475,-,11026
438,BUMA.1121.00012,1,2924060,2935087,+,11027
438,BUMA.1121.00087,1,3414869,3425887,+,11018
438,BUMA.1121.00043,1,153482,164486,+,11004
438,BUMA.1121.00046,1,1329518,1340527,+,11009
438,BUMA.1121.00037,1,2803769,2814774,+,11005
438,BUMA.1121.00080,1,207337,218354,+,11017
438,BUMA.1121.00079,1,200744,211763,+,11019
438,BUMA.1121.00045,1,3928118,3939125,-,11007
438,BUMA.1121.00071,1,181611,192625,+,11014
438,BUMA.1121.00056,1,3735865,3746892,-,11027
438,BUMA.1121.00065,1,194452,205482,+,11030
438,BUMA.1121.00058,1,385819,396825,-,11006
438,BUMA.1121.00007,1,3949834,3960841,-,11007
438,BUMA.1121.00067,1,204915,215932,-,11017
438,BUMA.1121.00090,1,2267323,2278349,+,11026
438,BUMA.1121.00051,1,162824,173851,+,11027
438,BUMA.1121.00020,1,1029988,1041006,-,11018
438,BUMA.1121.00103,1,194222,205248,-,11026
438,BUMA.1121.00048,1,3143631,3154640,+,11009
438,BUMA.1121.00047,1,2806951,2817978,-,11027
438,BUMA.1121.00042,1,3034985,3046010,+,11025
438,BUMA.1121.00055,1,3837205,3848226,+,11021
438,BUMA.1121.00031,1,1505369,1516395,+,11026
438,BUMA.1121.00040,1,313015,324024,+,11009
438,BUMA.1121.00044,1,230582,241600,-,11018
438,BUMA.1121.00088,1,1054238,1065255,+,11017
438,BUMA.1121.00069,1,154737,165751,+,11014
438,BUMA.1121.00064,1,206563,217580,+,11017
438,BUMA.1121.00105,1,1042841,1053847,-,11006
438,BUMA.1121.00015,1,216568,227577,+,11009
438,BUMA.1121.00059,1,3382974,3393991,+,11017
438,BUMA.1121.00026,1,825735,836760,+,11025
438,BUMA.1121.00022,1,1090228,1101246,-,11018
438,BUMA.1121.00052,1,3293478,3304487,+,11009
438,BUMA.1121.00101,1,2313325,2324345,-,11020
438,BUMA.1121.00001,1,3953834,3964860,-,11026
438,BUMA.1121.00038,1,3350949,3361958,+,11009
438,BUMA.1121.00068,1,3029822,3040856,+,11034
438,BUMA.1121.00099,1,2243054,2254056,-,11002
438,BUMA.1121.00091,1,374374,385390,-,11016
438,BUMA.1121.00098,1,2884184,2895210,+,11026
438,BUMA.1121.00013,1,1146456,1157465,-,11009
438,BUMA.1121.00049,1,1681114,1692128,-,11014
438,BUMA.1121.00072,1,165386,176400,+,11014
438,BUMA.1121.00076,1,1192942,1203968,-,11026
438,BUMA.1121.00083,1,1493942,1504956,-,11014
438,BUMA.1121.00078,1,1833888,1844912,-,11024
438,BUMA.1121.00095,1,1505029,1516049,-,11020
438,BUMA.1121.00077,1,2824526,2835536,+,11010
438,BUMA.1121.00063,1,190485,201497,+,11012
438,BUMA.1121.00061,1,193449,204460,+,11011
438,BUMA.1121.00050,1,1411205,1422214,-,11009
438,BUMA.1121.00081,1,3351134,3362143,+,11009
438,BUMA.1121.00074,1,3709813,3720830,-,11017
438,BUMA.1121.00062,1,409457,420482,-,11025
438,BUMA.1121.00060,1,2153761,2164768,-,11007
438,BUMA.1121.00070,1,165087,176098,+,11011
438,BUMA.1121.00075,1,3608199,3619225,+,11026
438,BUMA.1121.00041,1,1427896,1438913,+,11017
438,BUMA.1121.00073,1,191417,202429,+,11012
438,BUMA.1121.00017,1,900094,911112,-,11018
438,BUMA.1121.00066,1,162191,173205,+,11014
438,BUMA.1121.00107,1,4092547,4103565,+,11018
438,BUMA.1121.00085,1,2890423,2901432,+,11009
438,BUMA.1121.00030,1,900154,911172,-,11018
438,BUMA.1121.00112,1,2911035,2922061,-,11026
438,BUMA.1121.00002,1,501509,512536,+,11027
438,BUMA.1121.00082,1,199880,210894,+,11014
438,BUMA.1121.00014,1,2721737,2732763,-,11026
438,BUMA.1121.00011,1,1454224,1465258,-,11034
438,BUMA.1121.00019,1,965088,976106,-,11018
438,BUMA.1121.00057,1,1259633,1270656,+,11023
438,BUMA.1121.00018,1,667174,678200,+,11026
438,BUMA.1121.00039,1,260020,271046,+,11026
438,BUMA.1121.00016,1,2265580,2276584,+,11004
438,BUMA.1121.00004,1,966242,977260,-,11018
438,BUMA.1121.00005,1,3400989,3412016,-,11027
438,BUMA.1121.00100,1,1174458,1185469,-,11011
438,BUMA.1121.00006,1,3351026,3362035,+,11009
439,BUMA.1121.00027,1,2371227,2378046,+,6819
439,BUMA.1121.00025,1,2574723,2581539,-,6816
439,BUMA.1121.00021,1,811466,818304,+,6838
439,BUMA.1121.00023,1,2506220,2513047,+,6827
439,BUMA.1121.00024,1,958137,964956,-,6819
439,BUMA.1121.00033,1,2430178,2437004,+,6826
439,BUMA.1121.00034,1,995567,1002386,-,6819
439,BUMA.1121.00036,1,367248,374067,-,6819
439,BUMA.1121.00032,1,2488652,2495471,-,6819
439,BUMA.1121.00009,1,1396037,1402858,-,6821
439,BUMA.1121.00008,1,961882,968701,-,6819
439,BUMA.1121.00003,1,2677779,2684573,+,6794
439,BUMA.1121.00109,1,1704574,1711383,-,6809
439,BUMA.1121.00053,1,3954863,3961675,+,6812
439,BUMA.1121.00110,1,640986,647795,-,6809
439,BUMA.1121.00104,1,1099139,1105940,-,6801
439,BUMA.1121.00086,1,3379429,3386248,-,6819
439,BUMA.1121.00092,1,3684171,3690993,-,6822
439,BUMA.1121.00096,1,3089218,3096044,-,6826
439,BUMA.1121.00054,1,774239,781058,-,6819
439,BUMA.1121.00097,1,3862243,3869030,-,6787
439,BUMA.1121.00093,1,935444,942266,+,6822
439,BUMA.1121.00106,1,3941183,3947985,+,6802
439,BUMA.1121.00010,1,487295,494114,+,6819
439,BUMA.1121.00035,1,1231426,1238253,+,6827
439,BUMA.1121.00108,1,1158205,1165005,+,6800
439,BUMA.1121.00028,1,958136,964955,-,6819
439,BUMA.1121.00094,1,173859,180693,+,6834
439,BUMA.1121.00102,1,1107575,1114398,-,6823
439,BUMA.1121.00111,1,311321,318159,+,6838
439,BUMA.1121.00089,1,189685,196519,+,6834
439,BUMA.1121.00084,1,401262,408071,+,6809
439,BUMA.1121.00029,1,732533,739360,-,6827
439,BUMA.1121.00012,1,2935176,2942016,+,6840
439,BUMA.1121.00087,1,3425976,3432795,+,6819
439,BUMA.1121.00043,1,166191,173040,+,6849
439,BUMA.1121.00046,1,1340616,1347435,+,6819
439,BUMA.1121.00037,1,2816479,2823324,+,6845
439,BUMA.1121.00080,1,218443,225241,+,6798
439,BUMA.1121.00079,1,213320,220153,+,6833
439,BUMA.1121.00045,1,3921242,3928029,-,6787
439,BUMA.1121.00071,1,192714,199523,+,6809
439,BUMA.1121.00056,1,3728942,3735776,-,6834
439,BUMA.1121.00065,1,205571,212394,+,6823
439,BUMA.1121.00058,1,377485,384262,-,6777
439,BUMA.1121.00007,1,3942925,3949745,-,6820
439,BUMA.1121.00067,1,198028,204826,-,6798
439,BUMA.1121.00090,1,2278438,2285265,+,6827
439,BUMA.1121.00051,1,173940,180774,+,6834
439,BUMA.1121.00020,1,1023080,1029899,-,6819
439,BUMA.1121.00103,1,187315,194133,-,6818
439,BUMA.1121.00048,1,3154729,3161548,+,6819
439,BUMA.1121.00047,1,2800028,2806862,-,6834
439,BUMA.1121.00042,1,3047698,3054517,+,6819
439,BUMA.1121.00055,1,3849780,3856578,+,6798
439,BUMA.1121.00031,1,1516484,1523304,+,6820
439,BUMA.1121.00040,1,324113,330932,+,6819
439,BUMA.1121.00044,1,223674,230493,-,6819
439,BUMA.1121.00088,1,1065344,1072135,+,6791
439,BUMA.1121.00069,1,165840,172649,+,6809
439,BUMA.1121.00064,1,217669,224466,+,6797
439,BUMA.1121.00105,1,1035938,1042752,-,6814
439,BUMA.1121.00015,1,227666,234485,+,6819
439,BUMA.1121.00059,1,3394080,3400878,+,6798
439,BUMA.1121.00026,1,838447,845266,+,6819
439,BUMA.1121.00022,1,1083320,1090139,-,6819
439,BUMA.1121.00052,1,3304576,3311395,+,6819
439,BUMA.1121.00101,1,2306456,2313236,-,6780
439,BUMA.1121.00001,1,3946929,3953745,-,6816
439,BUMA.1121.00038,1,3362047,3368866,+,6819
439,BUMA.1121.00068,1,3040945,3047754,+,6809
439,BUMA.1121.00099,1,2236149,2242965,-,6816
439,BUMA.1121.00091,1,367448,374285,-,6837
439,BUMA.1121.00098,1,2895299,2902103,+,6804
439,BUMA.1121.00013,1,1139548,1146367,-,6819
439,BUMA.1121.00049,1,1674227,1681025,-,6798
439,BUMA.1121.00072,1,176489,183298,+,6809
439,BUMA.1121.00076,1,1186035,1192853,-,6818
439,BUMA.1121.00083,1,1487044,1493853,-,6809
439,BUMA.1121.00078,1,1826957,1833799,-,6842
439,BUMA.1121.00095,1,1498129,1504940,-,6811
439,BUMA.1121.00077,1,2835625,2842433,+,6808
439,BUMA.1121.00063,1,201586,208366,+,6780
439,BUMA.1121.00061,1,204549,211358,+,6809
439,BUMA.1121.00050,1,1404297,1411116,-,6819
439,BUMA.1121.00081,1,3362232,3369051,+,6819
439,BUMA.1121.00074,1,3702926,3709724,-,6798
439,BUMA.1121.00062,1,401085,407892,-,6807
439,BUMA.1121.00060,1,2146885,2153672,-,6787
439,BUMA.1121.00070,1,176187,182996,+,6809
439,BUMA.1121.00075,1,3619314,3626131,+,6817
439,BUMA.1121.00041,1,1439002,1445818,+,6816
439,BUMA.1121.00073,1,202518,209327,+,6809
439,BUMA.1121.00017,1,893186,900005,-,6819
439,BUMA.1121.00066,1,173294,180103,+,6809
439,BUMA.1121.00107,1,4103654,4110442,+,6788
439,BUMA.1121.00085,1,2901521,2908340,+,6819
439,BUMA.1121.00030,1,893246,900065,-,6819
439,BUMA.1121.00112,1,2904137,2910946,-,6809
439,BUMA.1121.00002,1,512625,519444,+,6819
439,BUMA.1121.00082,1,210983,217792,+,6809
439,BUMA.1121.00014,1,2714819,2721648,-,6829
439,BUMA.1121.00011,1,1447348,1454135,-,6787
439,BUMA.1121.00019,1,958180,964999,-,6819
439,BUMA.1121.00057,1,1270745,1277547,+,6802
439,BUMA.1121.00018,1,678289,685105,+,6816
439,BUMA.1121.00039,1,271135,277962,+,6827
439,BUMA.1121.00016,1,2278289,2285096,+,6807
439,BUMA.1121.00004,1,959334,966153,-,6819
439,BUMA.1121.00005,1,3394109,3400900,-,6791
439,BUMA.1121.00100,1,1166077,1172901,-,6824
439,BUMA.1121.00006,1,3362124,3368943,+,6819
440,BUMA.1121.00027,1,2378047,2381903,+,3856
440,BUMA.1121.00025,1,2570865,2574721,-,3856
440,BUMA.1121.00021,1,818305,822162,+,3857
440,BUMA.1121.00023,1,2513048,2516904,+,3856
440,BUMA.1121.00024,1,954280,958135,-,3855
440,BUMA.1121.00033,1,2437005,2440862,+,3857
440,BUMA.1121.00034,1,991710,995565,-,3855
440,BUMA.1121.00036,1,363391,367246,-,3855
440,BUMA.1121.00032,1,2484795,2488650,-,3855
440,BUMA.1121.00009,1,1392180,1396035,-,3855
440,BUMA.1121.00008,1,958025,961880,-,3855
440,BUMA.1121.00003,1,2684574,2688430,+,3856
440,BUMA.1121.00109,1,1700718,1704572,-,3854
440,BUMA.1121.00053,1,3961676,3965533,+,3857
440,BUMA.1121.00110,1,637130,640984,-,3854
440,BUMA.1121.00104,1,1095282,1099137,-,3855
440,BUMA.1121.00086,1,3375572,3379427,-,3855
440,BUMA.1121.00092,1,3680313,3684169,-,3856
440,BUMA.1121.00096,1,3085361,3089216,-,3855
440,BUMA.1121.00054,1,770382,774237,-,3855
440,BUMA.1121.00097,1,3858386,3862241,-,3855
440,BUMA.1121.00093,1,942267,946124,+,3857
440,BUMA.1121.00106,1,3947986,3951843,+,3857
440,BUMA.1121.00010,1,494115,497971,+,3856
440,BUMA.1121.00035,1,1238254,1242111,+,3857
440,BUMA.1121.00108,1,1165006,1168862,+,3856
440,BUMA.1121.00028,1,954279,958134,-,3855
440,BUMA.1121.00094,1,180694,184550,+,3856
440,BUMA.1121.00102,1,1103717,1107573,-,3856
440,BUMA.1121.00111,1,318160,322017,+,3857
440,BUMA.1121.00089,1,196520,200377,+,3857
440,BUMA.1121.00084,1,408072,411928,+,3856
440,BUMA.1121.00029,1,728675,732531,-,3856
440,BUMA.1121.00012,1,2942017,2945874,+,3857
440,BUMA.1121.00087,1,3432796,3436652,+,3856
440,BUMA.1121.00043,1,173041,176897,+,3856
440,BUMA.1121.00046,1,1347436,1351292,+,3856
440,BUMA.1121.00037,1,2823325,2827182,+,3857
440,BUMA.1121.00080,1,225243,229102,+,3859
440,BUMA.1121.00079,1,220154,224011,+,3857
440,BUMA.1121.00045,1,3917385,3921240,-,3855
440,BUMA.1121.00071,1,199524,203380,+,3856
440,BUMA.1121.00056,1,3725084,3728940,-,3856
440,BUMA.1121.00065,1,212395,216251,+,3856
440,BUMA.1121.00058,1,373624,377483,-,3859
440,BUMA.1121.00007,1,3939068,3942923,-,3855
440,BUMA.1121.00067,1,194167,198026,-,3859
440,BUMA.1121.00090,1,2285266,2289123,+,3857
440,BUMA.1121.00051,1,180775,184632,+,3857
440,BUMA.1121.00020,1,1019223,1023078,-,3855
440,BUMA.1121.00103,1,183458,187313,-,3855
440,BUMA.1121.00048,1,3161549,3165405,+,3856
440,BUMA.1121.00047,1,2796170,2800026,-,3856
440,BUMA.1121.00042,1,3054518,3058374,+,3856
440,BUMA.1121.00055,1,3856579,3860436,+,3857
440,BUMA.1121.00031,1,1523305,1527161,+,3856
440,BUMA.1121.00040,1,330933,334789,+,3856
440,BUMA.1121.00044,1,219817,223672,-,3855
440,BUMA.1121.00088,1,1072137,1075996,+,3859
440,BUMA.1121.00069,1,172650,176506,+,3856
440,BUMA.1121.00064,1,224468,228327,+,3859
440,BUMA.1121.00105,1,1032077,1035936,-,3859
440,BUMA.1121.00015,1,234486,238342,+,3856
440,BUMA.1121.00059,1,3400880,3404739,+,3859
440,BUMA.1121.00026,1,845267,849123,+,3856
440,BUMA.1121.00022,1,1079463,1083318,-,3855
440,BUMA.1121.00052,1,3311396,3315252,+,3856
440,BUMA.1121.00101,1,2302599,2306454,-,3855
440,BUMA.1121.00001,1,3943071,3946927,-,3856
440,BUMA.1121.00038,1,3368867,3372723,+,3856
440,BUMA.1121.00068,1,3047755,3051611,+,3856
440,BUMA.1121.00099,1,2232292,2236147,-,3855
440,BUMA.1121.00091,1,363591,367446,-,3855
440,BUMA.1121.00098,1,2902104,2905960,+,3856
440,BUMA.1121.00013,1,1135691,1139546,-,3855
440,BUMA.1121.00049,1,1670366,1674225,-,3859
440,BUMA.1121.00072,1,183299,187155,+,3856
440,BUMA.1121.00076,1,1182178,1186033,-,3855
440,BUMA.1121.00083,1,1483187,1487042,-,3855
440,BUMA.1121.00078,1,1823100,1826955,-,3855
440,BUMA.1121.00095,1,1494271,1498127,-,3856
440,BUMA.1121.00077,1,2842434,2846289,+,3855
440,BUMA.1121.00063,1,208367,212223,+,3856
440,BUMA.1121.00061,1,211359,215215,+,3856
440,BUMA.1121.00050,1,1400440,1404295,-,3855
440,BUMA.1121.00081,1,3369052,3372908,+,3856
440,BUMA.1121.00074,1,3699065,3702924,-,3859
440,BUMA.1121.00062,1,397224,401083,-,3859
440,BUMA.1121.00060,1,2143028,2146883,-,3855
440,BUMA.1121.00070,1,182997,186853,+,3856
440,BUMA.1121.00075,1,3626132,3629988,+,3856
440,BUMA.1121.00041,1,1445819,1449675,+,3856
440,BUMA.1121.00073,1,209328,213184,+,3856
440,BUMA.1121.00017,1,889329,893184,-,3855
440,BUMA.1121.00066,1,180104,183960,+,3856
440,BUMA.1121.00107,1,1,3867,+,3866
440,BUMA.1121.00085,1,2908341,2912197,+,3856
440,BUMA.1121.00030,1,889389,893244,-,3855
440,BUMA.1121.00112,1,2900280,2904135,-,3855
440,BUMA.1121.00002,1,519445,523301,+,3856
440,BUMA.1121.00082,1,217793,221649,+,3856
440,BUMA.1121.00014,1,2710962,2714817,-,3855
440,BUMA.1121.00011,1,1443490,1447346,-,3856
440,BUMA.1121.00019,1,954323,958178,-,3855
440,BUMA.1121.00057,1,1277548,1281405,+,3857
440,BUMA.1121.00018,1,685106,688963,+,3857
440,BUMA.1121.00039,1,277963,281820,+,3857
440,BUMA.1121.00016,1,2285097,2288954,+,3857
440,BUMA.1121.00004,1,955477,959332,-,3855
440,BUMA.1121.00005,1,3390252,3394107,-,3855
440,BUMA.1121.00100,1,1162220,1166075,-,3855
440,BUMA.1121.00006,1,3368944,3372800,+,3856
441,BUMA.1121.00027,1,2381997,2386130,+,4133
441,BUMA.1121.00025,1,2566646,2570770,-,4124
441,BUMA.1121.00021,1,822256,826383,+,4127
441,BUMA.1121.00023,1,2516998,2521130,+,4132
441,BUMA.1121.00024,1,950090,954186,-,4096
441,BUMA.1121.00033,1,2440956,2445083,+,4127
441,BUMA.1121.00034,1,987520,991616,-,4096
441,BUMA.1121.00036,1,359201,363297,-,4096
441,BUMA.1121.00032,1,2480605,2484701,-,4096
441,BUMA.1121.00009,1,1387946,1392086,-,4140
441,BUMA.1121.00008,1,953835,957931,-,4096
441,BUMA.1121.00003,1,2688524,2692655,+,4131
441,BUMA.1121.00109,1,1696483,1700623,-,4140
441,BUMA.1121.00053,1,3967225,3971367,+,4142
441,BUMA.1121.00110,1,632894,637036,-,4142
441,BUMA.1121.00104,1,1091048,1095188,-,4140
441,BUMA.1121.00086,1,3371394,3375478,-,4084
441,BUMA.1121.00092,1,3676078,3680218,-,4140
441,BUMA.1121.00096,1,3081134,3085266,-,4132
441,BUMA.1121.00054,1,766176,770272,-,4096
441,BUMA.1121.00097,1,3854151,3858292,-,4141
441,BUMA.1121.00093,1,946219,950359,+,4140
441,BUMA.1121.00106,1,3951937,3956068,+,4131
441,BUMA.1121.00010,1,498065,502161,+,4096
441,BUMA.1121.00035,1,1242205,1246332,+,4127
441,BUMA.1121.00108,1,1168957,1173053,+,4096
441,BUMA.1121.00028,1,950089,954185,-,4096
441,BUMA.1121.00094,1,184644,188786,+,4142
441,BUMA.1121.00102,1,1097866,1101971,-,4105
441,BUMA.1121.00111,1,322111,326243,+,4132
441,BUMA.1121.00089,1,200472,204614,+,4142
441,BUMA.1121.00084,1,412022,416162,+,4140
441,BUMA.1121.00029,1,724454,728581,-,4127
441,BUMA.1121.00012,1,2945968,2950095,+,4127
441,BUMA.1121.00087,1,3436746,3440830,+,4084
441,BUMA.1121.00043,1,176991,181122,+,4131
441,BUMA.1121.00046,1,1351386,1355482,+,4096
441,BUMA.1121.00037,1,2827276,2831403,+,4127
441,BUMA.1121.00080,1,229196,233336,+,4140
441,BUMA.1121.00079,1,224106,228248,+,4142
441,BUMA.1121.00045,1,3913150,3917290,-,4140
441,BUMA.1121.00071,1,203474,207607,+,4133
441,BUMA.1121.00056,1,3720847,3724989,-,4142
441,BUMA.1121.00065,1,216345,220472,+,4127
441,BUMA.1121.00058,1,369389,373530,-,4141
441,BUMA.1121.00007,1,3934832,3938974,-,4142
441,BUMA.1121.00067,1,189933,194073,-,4140
441,BUMA.1121.00090,1,2289217,2293344,+,4127
441,BUMA.1121.00051,1,184727,188869,+,4142
441,BUMA.1121.00020,1,1015033,1019129,-,4096
441,BUMA.1121.00103,1,177626,181767,-,4141
441,BUMA.1121.00048,1,3165515,3169611,+,4096
441,BUMA.1121.00047,1,2791936,2796076,-,4140
441,BUMA.1121.00042,1,3058468,3062564,+,4096
441,BUMA.1121.00055,1,3860530,3864663,+,4133
441,BUMA.1121.00031,1,1527255,1531382,+,4127
441,BUMA.1121.00040,1,334883,338979,+,4096
441,BUMA.1121.00044,1,215627,219723,-,4096
441,BUMA.1121.00088,1,1076090,1080230,+,4140
441,BUMA.1121.00069,1,176600,180733,+,4133
441,BUMA.1121.00064,1,228421,232561,+,4140
441,BUMA.1121.00105,1,1027843,1031983,-,4140
441,BUMA.1121.00015,1,238436,242532,+,4096
441,BUMA.1121.00059,1,3404833,3408973,+,4140
441,BUMA.1121.00026,1,849217,853313,+,4096
441,BUMA.1121.00022,1,1075273,1079369,-,4096
441,BUMA.1121.00052,1,3315346,3319442,+,4096
441,BUMA.1121.00101,1,2298417,2302504,-,4087
441,BUMA.1121.00001,1,3938850,3942977,-,4127
441,BUMA.1121.00038,1,3372833,3376929,+,4096
441,BUMA.1121.00068,1,3051705,3055844,+,4139
441,BUMA.1121.00099,1,2228058,2232198,-,4140
441,BUMA.1121.00091,1,359363,363497,-,4134
441,BUMA.1121.00098,1,2906054,2910187,+,4133
441,BUMA.1121.00013,1,1131501,1135597,-,4096
441,BUMA.1121.00049,1,1666132,1670272,-,4140
441,BUMA.1121.00072,1,187249,191382,+,4133
441,BUMA.1121.00076,1,1177944,1182084,-,4140
441,BUMA.1121.00083,1,1478960,1483093,-,4133
441,BUMA.1121.00078,1,1818866,1823006,-,4140
441,BUMA.1121.00095,1,1490040,1494176,-,4136
441,BUMA.1121.00077,1,2846383,2850526,+,4143
441,BUMA.1121.00063,1,212317,216450,+,4133
441,BUMA.1121.00061,1,215309,219442,+,4133
441,BUMA.1121.00050,1,1396250,1400346,-,4096
441,BUMA.1121.00081,1,3373018,3377114,+,4096
441,BUMA.1121.00074,1,3694831,3698971,-,4140
441,BUMA.1121.00062,1,392990,397130,-,4140
441,BUMA.1121.00060,1,2138793,2142933,-,4140
441,BUMA.1121.00070,1,186947,191080,+,4133
441,BUMA.1121.00075,1,3630082,3634222,+,4140
441,BUMA.1121.00041,1,1449769,1453900,+,4131
441,BUMA.1121.00073,1,213278,217411,+,4133
441,BUMA.1121.00017,1,885139,889235,-,4096
441,BUMA.1121.00066,1,184054,188187,+,4133
441,BUMA.1121.00107,1,3961,8099,+,4138
441,BUMA.1121.00085,1,2912291,2916387,+,4096
441,BUMA.1121.00030,1,885199,889295,-,4096
441,BUMA.1121.00112,1,2896053,2900186,-,4133
441,BUMA.1121.00002,1,523395,527491,+,4096
441,BUMA.1121.00082,1,221743,225876,+,4133
441,BUMA.1121.00014,1,2706741,2710868,-,4127
441,BUMA.1121.00011,1,1439250,1443366,-,4116
441,BUMA.1121.00019,1,950133,954229,-,4096
441,BUMA.1121.00057,1,1281500,1285631,+,4131
441,BUMA.1121.00018,1,689058,693182,+,4124
441,BUMA.1121.00039,1,281914,286047,+,4133
441,BUMA.1121.00016,1,2289048,2293173,+,4125
441,BUMA.1121.00004,1,951287,955383,-,4096
441,BUMA.1121.00005,1,3386025,3390158,-,4133
441,BUMA.1121.00100,1,1158000,1162125,-,4125
441,BUMA.1121.00006,1,3372910,3377006,+,4096
442,BUMA.1121.00027,1,2404948,2411211,+,6263
442,BUMA.1121.00025,1,2541550,2547798,-,6248
442,BUMA.1121.00021,1,845218,851474,+,6256
442,BUMA.1121.00023,1,2539971,2546227,+,6256
442,BUMA.1121.00024,1,925126,931303,-,6177
442,BUMA.1121.00033,1,2463921,2470181,+,6260
442,BUMA.1121.00034,1,962556,968733,-,6177
442,BUMA.1121.00036,1,334248,340425,-,6177
442,BUMA.1121.00032,1,2455641,2461818,-,6177
442,BUMA.1121.00009,1,1362880,1369140,-,6260
442,BUMA.1121.00008,1,928871,935048,-,6177
442,BUMA.1121.00003,1,2711439,2717708,+,6269
442,BUMA.1121.00109,1,1671449,1677701,-,6252
442,BUMA.1121.00053,1,3990062,3996336,+,6274
442,BUMA.1121.00110,1,607856,614105,-,6249
442,BUMA.1121.00104,1,1066054,1072314,-,6260
442,BUMA.1121.00086,1,3346441,3352618,-,6177
442,BUMA.1121.00092,1,3650994,3657248,-,6254
442,BUMA.1121.00096,1,3056046,3062306,-,6260
442,BUMA.1121.00054,1,741246,747411,-,6165
442,BUMA.1121.00097,1,3829081,3835345,-,6264
442,BUMA.1121.00093,1,969189,975443,+,6254
442,BUMA.1121.00106,1,3974774,3981034,+,6260
442,BUMA.1121.00010,1,520937,527114,+,6177
442,BUMA.1121.00035,1,1265149,1271411,+,6262
442,BUMA.1121.00108,1,1191799,1198070,+,6271
442,BUMA.1121.00028,1,925125,931302,-,6177
442,BUMA.1121.00094,1,207549,213802,+,6253
442,BUMA.1121.00102,1,1072876,1079125,-,6249
442,BUMA.1121.00111,1,345047,351319,+,6272
442,BUMA.1121.00089,1,223377,229636,+,6259
442,BUMA.1121.00084,1,434869,441111,+,6242
442,BUMA.1121.00029,1,699376,705638,-,6262
442,BUMA.1121.00012,1,2968914,2975177,+,6263
442,BUMA.1121.00087,1,3459606,3465783,+,6177
442,BUMA.1121.00043,1,199944,206204,+,6260
442,BUMA.1121.00046,1,1374264,1380423,+,6159
442,BUMA.1121.00037,1,2850201,2856463,+,6262
442,BUMA.1121.00080,1,252052,258317,+,6265
442,BUMA.1121.00079,1,247011,253270,+,6259
442,BUMA.1121.00045,1,3888110,3894349,-,6239
442,BUMA.1121.00071,1,226418,232704,+,6286
442,BUMA.1121.00056,1,3695773,3702032,-,6259
442,BUMA.1121.00065,1,239324,245586,+,6262
442,BUMA.1121.00058,1,344420,350667,-,6247
442,BUMA.1121.00007,1,3909801,3916033,-,6232
442,BUMA.1121.00067,1,164961,171226,-,6265
442,BUMA.1121.00090,1,2312170,2318432,+,6262
442,BUMA.1121.00051,1,207643,213902,+,6259
442,BUMA.1121.00020,1,990069,996246,-,6177
442,BUMA.1121.00103,1,152553,158804,-,6251
442,BUMA.1121.00048,1,3188376,3194541,+,6165
442,BUMA.1121.00047,1,2766903,2773162,-,6259
442,BUMA.1121.00042,1,3081340,3087517,+,6177
442,BUMA.1121.00055,1,3883364,3889605,+,6241
442,BUMA.1121.00031,1,1550199,1556454,+,6255
442,BUMA.1121.00040,1,357744,363909,+,6165
442,BUMA.1121.00044,1,190663,196840,-,6177
442,BUMA.1121.00088,1,1098946,1105205,+,6259
442,BUMA.1121.00069,1,199552,205838,+,6286
442,BUMA.1121.00064,1,251294,257548,+,6254
442,BUMA.1121.00105,1,1002962,1009218,-,6256
442,BUMA.1121.00015,1,261297,267462,+,6165
442,BUMA.1121.00059,1,3427682,3433935,+,6253
442,BUMA.1121.00026,1,872089,878266,+,6177
442,BUMA.1121.00022,1,1050332,1056497,-,6165
442,BUMA.1121.00052,1,3338202,3344367,+,6165
442,BUMA.1121.00101,1,2273346,2279615,-,6269
442,BUMA.1121.00001,1,3913771,3920033,-,6262
442,BUMA.1121.00038,1,3395694,3401859,+,6165
442,BUMA.1121.00068,1,3074688,3080964,+,6276
442,BUMA.1121.00099,1,2203023,2209287,-,6264
442,BUMA.1121.00091,1,334242,340514,-,6272
442,BUMA.1121.00098,1,2929050,2935331,+,6281
442,BUMA.1121.00013,1,1106576,1112741,-,6165
442,BUMA.1121.00049,1,1641145,1647417,-,6272
442,BUMA.1121.00072,1,210193,216477,+,6284
442,BUMA.1121.00076,1,1152986,1159253,-,6267
442,BUMA.1121.00083,1,1453855,1460141,-,6286
442,BUMA.1121.00078,1,1793793,1800059,-,6266
442,BUMA.1121.00095,1,1464956,1471216,-,6260
442,BUMA.1121.00077,1,2869315,2875561,+,6246
442,BUMA.1121.00063,1,235269,241553,+,6284
442,BUMA.1121.00061,1,238250,244536,+,6286
442,BUMA.1121.00050,1,1371309,1377468,-,6159
442,BUMA.1121.00081,1,3395879,3402044,+,6165
442,BUMA.1121.00074,1,3669859,3676124,-,6265
442,BUMA.1121.00062,1,367898,374178,-,6280
442,BUMA.1121.00060,1,2113753,2119992,-,6239
442,BUMA.1121.00070,1,209890,216176,+,6286
442,BUMA.1121.00075,1,3652913,3659179,+,6266
442,BUMA.1121.00041,1,1472609,1478883,+,6274
442,BUMA.1121.00073,1,236228,242514,+,6286
442,BUMA.1121.00017,1,860175,866352,-,6177
442,BUMA.1121.00066,1,206997,213283,+,6286
442,BUMA.1121.00107,1,26904,33156,+,6252
442,BUMA.1121.00085,1,2935147,2941312,+,6165
442,BUMA.1121.00030,1,860235,866412,-,6177
442,BUMA.1121.00112,1,2870950,2877215,-,6265
442,BUMA.1121.00002,1,546267,552444,+,6177
442,BUMA.1121.00082,1,244695,250981,+,6286
442,BUMA.1121.00014,1,2681667,2687924,-,6257
442,BUMA.1121.00011,1,1414229,1420481,-,6252
442,BUMA.1121.00019,1,925169,931346,-,6177
442,BUMA.1121.00057,1,1304450,1310718,+,6268
442,BUMA.1121.00018,1,712030,718278,+,6248
442,BUMA.1121.00039,1,304885,311153,+,6268
442,BUMA.1121.00016,1,2311996,2318259,+,6263
442,BUMA.1121.00004,1,926324,932501,-,6177
442,BUMA.1121.00005,1,3360938,3367200,-,6262
442,BUMA.1121.00100,1,1132987,1139246,-,6259
442,BUMA.1121.00006,1,3395771,3401936,+,6165
443,BUMA.1121.00027,1,2414708,2417953,+,3245
443,BUMA.1121.00025,1,2534806,2538052,-,3246
443,BUMA.1121.00021,1,854971,858217,+,3246
443,BUMA.1121.00023,1,2549724,2552970,+,3246
443,BUMA.1121.00024,1,918419,921665,-,3246
443,BUMA.1121.00033,1,2473677,2476922,+,3245
443,BUMA.1121.00034,1,955849,959095,-,3246
443,BUMA.1121.00036,1,327541,330787,-,3246
443,BUMA.1121.00032,1,2448934,2452180,-,3246
443,BUMA.1121.00009,1,1356136,1359382,-,3246
443,BUMA.1121.00008,1,922164,925410,-,3246
443,BUMA.1121.00003,1,2721080,2724326,+,3246
443,BUMA.1121.00109,1,1664705,1667951,-,3246
443,BUMA.1121.00053,1,3999833,4003079,+,3246
443,BUMA.1121.00110,1,601093,604339,-,3246
443,BUMA.1121.00104,1,1059291,1062537,-,3246
443,BUMA.1121.00086,1,3339734,3342980,-,3246
443,BUMA.1121.00092,1,3644250,3647496,-,3246
443,BUMA.1121.00096,1,3049302,3052548,-,3246
443,BUMA.1121.00054,1,732945,736191,-,3246
443,BUMA.1121.00097,1,3822337,3825583,-,3246
443,BUMA.1121.00093,1,978940,982186,+,3246
443,BUMA.1121.00106,1,497,3743,+,3246
443,BUMA.1121.00010,1,530574,533815,+,3241
443,BUMA.1121.00035,1,1274908,1278154,+,3246
443,BUMA.1121.00108,1,1201567,1204813,+,3246
443,BUMA.1121.00028,1,918418,921664,-,3246
443,BUMA.1121.00094,1,217299,220545,+,3246
443,BUMA.1121.00102,1,1066113,1069359,-,3246
443,BUMA.1121.00111,1,354816,358062,+,3246
443,BUMA.1121.00089,1,233133,236379,+,3246
443,BUMA.1121.00084,1,444628,447874,+,3246
443,BUMA.1121.00029,1,692632,695878,-,3246
443,BUMA.1121.00012,1,2978674,2981920,+,3246
443,BUMA.1121.00087,1,3469243,3472489,+,3246
443,BUMA.1121.00043,1,209701,212947,+,3246
443,BUMA.1121.00046,1,1385477,1388723,+,3246
443,BUMA.1121.00037,1,2859960,2863206,+,3246
443,BUMA.1121.00080,1,261814,265060,+,3246
443,BUMA.1121.00079,1,256767,260013,+,3246
443,BUMA.1121.00045,1,3881392,3884593,-,3201
443,BUMA.1121.00071,1,236201,239447,+,3246
443,BUMA.1121.00056,1,3689029,3692275,-,3246
443,BUMA.1121.00065,1,249083,252329,+,3246
443,BUMA.1121.00058,1,337676,340922,-,3246
443,BUMA.1121.00007,1,3903038,3906284,-,3246
443,BUMA.1121.00067,1,158217,161463,-,3246
443,BUMA.1121.00090,1,2321929,2325175,+,3246
443,BUMA.1121.00051,1,217399,220645,+,3246
443,BUMA.1121.00020,1,983362,986608,-,3246
443,BUMA.1121.00103,1,145809,149055,-,3246
443,BUMA.1121.00048,1,3199595,3202841,+,3246
443,BUMA.1121.00047,1,2760159,2763405,-,3246
443,BUMA.1121.00042,1,3090977,3094223,+,3246
443,BUMA.1121.00055,1,3893122,3896378,+,3256
443,BUMA.1121.00031,1,1559951,1563197,+,3246
443,BUMA.1121.00040,1,367369,370615,+,3246
443,BUMA.1121.00044,1,183956,187202,-,3246
443,BUMA.1121.00088,1,1108722,1111968,+,3246
443,BUMA.1121.00069,1,209335,212581,+,3246
443,BUMA.1121.00064,1,261045,264291,+,3246
443,BUMA.1121.00105,1,996218,999464,-,3246
443,BUMA.1121.00015,1,272516,275762,+,3246
443,BUMA.1121.00059,1,3437432,3440678,+,3246
443,BUMA.1121.00026,1,881726,884972,+,3246
443,BUMA.1121.00022,1,1043625,1046871,-,3246
443,BUMA.1121.00052,1,3347827,3351073,+,3246
443,BUMA.1121.00101,1,2266602,2269848,-,3246
443,BUMA.1121.00001,1,3907027,3910273,-,3246
443,BUMA.1121.00038,1,3406913,3410159,+,3246
443,BUMA.1121.00068,1,3084460,3087706,+,3246
443,BUMA.1121.00099,1,2196264,2199525,-,3261
443,BUMA.1121.00091,1,327488,330744,-,3256
443,BUMA.1121.00098,1,2938828,2942084,+,3256
443,BUMA.1121.00013,1,1099869,1103115,-,3246
443,BUMA.1121.00049,1,1634382,1637628,-,3246
443,BUMA.1121.00072,1,219974,223220,+,3246
443,BUMA.1121.00076,1,1146223,1149469,-,3246
443,BUMA.1121.00083,1,1447111,1450357,-,3246
443,BUMA.1121.00078,1,1787049,1790295,-,3246
443,BUMA.1121.00095,1,1458197,1461458,-,3261
443,BUMA.1121.00077,1,2879078,2882322,+,3244
443,BUMA.1121.00063,1,245050,248296,+,3246
443,BUMA.1121.00061,1,248033,251279,+,3246
443,BUMA.1121.00050,1,1363008,1366254,-,3246
443,BUMA.1121.00081,1,3407098,3410344,+,3246
443,BUMA.1121.00074,1,3663115,3666361,-,3246
443,BUMA.1121.00062,1,361154,364400,-,3246
443,BUMA.1121.00060,1,2107035,2110236,-,3201
443,BUMA.1121.00070,1,219673,222919,+,3246
443,BUMA.1121.00075,1,3662696,3665941,+,3245
443,BUMA.1121.00041,1,1482380,1485626,+,3246
443,BUMA.1121.00073,1,246011,249257,+,3246
443,BUMA.1121.00017,1,853468,856714,-,3246
443,BUMA.1121.00066,1,216780,220026,+,3246
443,BUMA.1121.00107,1,36654,39900,+,3246
443,BUMA.1121.00085,1,2944772,2948018,+,3246
443,BUMA.1121.00030,1,853528,856774,-,3246
443,BUMA.1121.00112,1,2864206,2867452,-,3246
443,BUMA.1121.00002,1,555904,559145,+,3241
443,BUMA.1121.00082,1,254478,257724,+,3246
443,BUMA.1121.00014,1,2674923,2678169,-,3246
443,BUMA.1121.00011,1,1407485,1410731,-,3246
443,BUMA.1121.00019,1,918462,921708,-,3246
443,BUMA.1121.00057,1,1314215,1317461,+,3246
443,BUMA.1121.00018,1,721775,725021,+,3246
443,BUMA.1121.00039,1,314650,317896,+,3246
443,BUMA.1121.00016,1,2321756,2325002,+,3246
443,BUMA.1121.00004,1,919617,922863,-,3246
443,BUMA.1121.00005,1,3354194,3357440,-,3246
443,BUMA.1121.00100,1,1126243,1129489,-,3246
443,BUMA.1121.00006,1,3406990,3410236,+,3246
444,BUMA.1121.00027,1,2418566,2421929,+,3363
444,BUMA.1121.00025,1,2531093,2534195,-,3102
444,BUMA.1121.00021,1,858828,862191,+,3363
444,BUMA.1121.00023,1,2553581,2556944,+,3363
444,BUMA.1121.00024,1,914457,917807,-,3350
444,BUMA.1121.00033,1,2477533,2480896,+,3363
444,BUMA.1121.00034,1,951887,955237,-,3350
444,BUMA.1121.00036,1,323579,326929,-,3350
444,BUMA.1121.00032,1,2444972,2448322,-,3350
444,BUMA.1121.00009,1,1352422,1355524,-,3102
444,BUMA.1121.00008,1,918202,921552,-,3350
444,BUMA.1121.00003,1,2724938,2728301,+,3363
444,BUMA.1121.00109,1,1660991,1664093,-,3102
444,BUMA.1121.00053,1,4003691,4007054,+,3363
444,BUMA.1121.00110,1,597379,600481,-,3102
444,BUMA.1121.00104,1,1055570,1058678,-,3108
444,BUMA.1121.00086,1,3335772,3339122,-,3350
444,BUMA.1121.00092,1,3640530,3643638,-,3108
444,BUMA.1121.00096,1,3045588,3048690,-,3102
444,BUMA.1121.00054,1,728983,732333,-,3350
444,BUMA.1121.00097,1,3818622,3821724,-,3102
444,BUMA.1121.00093,1,982798,986167,+,3369
444,BUMA.1121.00106,1,4356,7725,+,3369
444,BUMA.1121.00010,1,534427,537778,+,3351
444,BUMA.1121.00035,1,1278766,1282129,+,3363
444,BUMA.1121.00108,1,1205425,1208528,+,3103
444,BUMA.1121.00028,1,914456,917806,-,3350
444,BUMA.1121.00094,1,221157,224526,+,3369
444,BUMA.1121.00102,1,1062399,1065501,-,3102
444,BUMA.1121.00111,1,358673,362036,+,3363
444,BUMA.1121.00089,1,236992,240361,+,3369
444,BUMA.1121.00084,1,448487,451850,+,3363
444,BUMA.1121.00029,1,688918,692020,-,3102
444,BUMA.1121.00012,1,2982531,2985894,+,3363
444,BUMA.1121.00087,1,3473101,3476186,+,3085
444,BUMA.1121.00043,1,213558,216921,+,3363
444,BUMA.1121.00046,1,1389335,1392686,+,3351
444,BUMA.1121.00037,1,2863817,2867180,+,3363
444,BUMA.1121.00080,1,265673,269036,+,3363
444,BUMA.1121.00079,1,260625,263988,+,3363
444,BUMA.1121.00045,1,3877678,3880780,-,3102
444,BUMA.1121.00071,1,240060,243429,+,3369
444,BUMA.1121.00056,1,3685308,3688416,-,3108
444,BUMA.1121.00065,1,252940,256303,+,3363
444,BUMA.1121.00058,1,333963,337065,-,3102
444,BUMA.1121.00007,1,3899324,3902426,-,3102
444,BUMA.1121.00067,1,154502,157604,-,3102
444,BUMA.1121.00090,1,2325786,2329149,+,3363
444,BUMA.1121.00051,1,221257,224620,+,3363
444,BUMA.1121.00020,1,979400,982750,-,3350
444,BUMA.1121.00103,1,142096,145198,-,3102
444,BUMA.1121.00048,1,3203453,3206804,+,3351
444,BUMA.1121.00047,1,2756445,2759547,-,3102
444,BUMA.1121.00042,1,3094835,3098186,+,3351
444,BUMA.1121.00055,1,3896990,3900359,+,3369
444,BUMA.1121.00031,1,1563808,1567171,+,3363
444,BUMA.1121.00040,1,371227,374578,+,3351
444,BUMA.1121.00044,1,179994,183344,-,3350
444,BUMA.1121.00088,1,1112581,1115944,+,3363
444,BUMA.1121.00069,1,213194,216563,+,3369
444,BUMA.1121.00064,1,264903,268272,+,3369
444,BUMA.1121.00105,1,992497,995605,-,3108
444,BUMA.1121.00015,1,276374,279725,+,3351
444,BUMA.1121.00059,1,3441291,3444654,+,3363
444,BUMA.1121.00026,1,885584,888935,+,3351
444,BUMA.1121.00022,1,1039663,1043013,-,3350
444,BUMA.1121.00052,1,3351685,3355036,+,3351
444,BUMA.1121.00101,1,2262887,2265989,-,3102
444,BUMA.1121.00001,1,3903313,3906415,-,3102
444,BUMA.1121.00038,1,3410771,3414122,+,3351
444,BUMA.1121.00068,1,3088318,3091681,+,3363
444,BUMA.1121.00099,1,2192573,2195653,-,3080
444,BUMA.1121.00091,1,323774,326876,-,3102
444,BUMA.1121.00098,1,2942695,2946058,+,3363
444,BUMA.1121.00013,1,1095907,1099257,-,3350
444,BUMA.1121.00049,1,1630661,1633769,-,3108
444,BUMA.1121.00072,1,223833,227202,+,3369
444,BUMA.1121.00076,1,1142502,1145610,-,3108
444,BUMA.1121.00083,1,1443390,1446498,-,3108
444,BUMA.1121.00078,1,1783336,1786438,-,3102
444,BUMA.1121.00095,1,1453185,1456287,-,3102
444,BUMA.1121.00077,1,2882934,2886297,+,3363
444,BUMA.1121.00063,1,248909,252278,+,3369
444,BUMA.1121.00061,1,251892,255261,+,3369
444,BUMA.1121.00050,1,1359046,1362396,-,3350
444,BUMA.1121.00081,1,3410956,3414307,+,3351
444,BUMA.1121.00074,1,3659400,3662502,-,3102
444,BUMA.1121.00062,1,357440,360542,-,3102
444,BUMA.1121.00060,1,2103321,2106423,-,3102
444,BUMA.1121.00070,1,223532,226901,+,3369
444,BUMA.1121.00075,1,3666554,3669923,+,3369
444,BUMA.1121.00041,1,1486237,1489612,+,3375
444,BUMA.1121.00073,1,249870,253239,+,3369
444,BUMA.1121.00017,1,849506,852856,-,3350
444,BUMA.1121.00066,1,220639,224008,+,3369
444,BUMA.1121.00107,1,40512,43875,+,3363
444,BUMA.1121.00085,1,2948630,2951981,+,3351
444,BUMA.1121.00030,1,849566,852916,-,3350
444,BUMA.1121.00112,1,2860231,2863593,-,3362
444,BUMA.1121.00002,1,559757,563108,+,3351
444,BUMA.1121.00082,1,258337,261706,+,3369
444,BUMA.1121.00014,1,2671210,2674312,-,3102
444,BUMA.1121.00011,1,1403770,1406872,-,3102
444,BUMA.1121.00019,1,914500,917850,-,3350
444,BUMA.1121.00057,1,1318074,1321449,+,3375
444,BUMA.1121.00018,1,725632,728995,+,3363
444,BUMA.1121.00039,1,318507,321870,+,3363
444,BUMA.1121.00016,1,2325614,2328977,+,3363
444,BUMA.1121.00004,1,915655,919005,-,3350
444,BUMA.1121.00005,1,3350481,3353583,-,3102
444,BUMA.1121.00100,1,1122529,1125631,-,3102
444,BUMA.1121.00006,1,3410848,3414199,+,3351
445,BUMA.1121.00027,1,2421930,2427180,+,5250
445,BUMA.1121.00025,1,2525579,2530839,-,5260
445,BUMA.1121.00021,1,862192,867443,+,5251
445,BUMA.1121.00023,1,2556945,2562196,+,5251
445,BUMA.1121.00024,1,909343,914455,-,5112
445,BUMA.1121.00033,1,2480897,2486148,+,5251
445,BUMA.1121.00034,1,946773,951885,-,5112
445,BUMA.1121.00036,1,318465,323577,-,5112
445,BUMA.1121.00032,1,2439858,2444970,-,5112
445,BUMA.1121.00009,1,1346909,1352168,-,5259
445,BUMA.1121.00008,1,913088,918200,-,5112
445,BUMA.1121.00003,1,2728302,2733553,+,5251
445,BUMA.1121.00109,1,1655478,1660737,-,5259
445,BUMA.1121.00053,1,4007055,4012305,+,5250
445,BUMA.1121.00110,1,591866,597125,-,5259
445,BUMA.1121.00104,1,1050056,1055316,-,5260
445,BUMA.1121.00086,1,3330658,3335770,-,5112
445,BUMA.1121.00092,1,3635016,3640276,-,5260
445,BUMA.1121.00096,1,3040075,3045334,-,5259
445,BUMA.1121.00054,1,723869,728981,-,5112
445,BUMA.1121.00097,1,3813108,3818368,-,5260
445,BUMA.1121.00093,1,986168,991419,+,5251
445,BUMA.1121.00106,1,7726,12977,+,5251
445,BUMA.1121.00010,1,537779,542890,+,5111
445,BUMA.1121.00035,1,1282130,1287381,+,5251
445,BUMA.1121.00108,1,1208787,1214039,+,5252
445,BUMA.1121.00028,1,909342,914454,-,5112
445,BUMA.1121.00094,1,224527,229777,+,5250
445,BUMA.1121.00102,1,1056886,1062145,-,5259
445,BUMA.1121.00111,1,362037,367288,+,5251
445,BUMA.1121.00089,1,240362,245612,+,5250
445,BUMA.1121.00084,1,451851,457102,+,5251
445,BUMA.1121.00029,1,683404,688664,-,5260
445,BUMA.1121.00012,1,2985895,2991146,+,5251
445,BUMA.1121.00087,1,207,5325,+,5118
445,BUMA.1121.00043,1,216922,222173,+,5251
445,BUMA.1121.00046,1,1392687,1397798,+,5111
445,BUMA.1121.00037,1,2867181,2872432,+,5251
445,BUMA.1121.00080,1,269037,274287,+,5250
445,BUMA.1121.00079,1,263989,269239,+,5250
445,BUMA.1121.00045,1,3872165,3877419,-,5254
445,BUMA.1121.00071,1,243430,248680,+,5250
445,BUMA.1121.00056,1,3679795,3685054,-,5259
445,BUMA.1121.00065,1,256304,261554,+,5250
445,BUMA.1121.00058,1,328450,333709,-,5259
445,BUMA.1121.00007,1,3893810,3899070,-,5260
445,BUMA.1121.00067,1,148989,154248,-,5259
445,BUMA.1121.00090,1,2329150,2334401,+,5251
445,BUMA.1121.00051,1,224621,229871,+,5250
445,BUMA.1121.00020,1,974286,979398,-,5112
445,BUMA.1121.00103,1,136583,141842,-,5259
445,BUMA.1121.00048,1,3206805,3211916,+,5111
445,BUMA.1121.00047,1,2750932,2756191,-,5259
445,BUMA.1121.00042,1,3098187,3103298,+,5111
445,BUMA.1121.00055,1,3900360,3905610,+,5250
445,BUMA.1121.00031,1,1567172,1572423,+,5251
445,BUMA.1121.00040,1,374579,379695,+,5116
445,BUMA.1121.00044,1,174880,179992,-,5112
445,BUMA.1121.00088,1,1115945,1121195,+,5250
445,BUMA.1121.00069,1,216564,221814,+,5250
445,BUMA.1121.00064,1,268273,273524,+,5251
445,BUMA.1121.00105,1,986984,992243,-,5259
445,BUMA.1121.00015,1,279726,284837,+,5111
445,BUMA.1121.00059,1,3444655,3449905,+,5250
445,BUMA.1121.00026,1,888936,894047,+,5111
445,BUMA.1121.00022,1,1034549,1039661,-,5112
445,BUMA.1121.00052,1,3355037,3360153,+,5116
445,BUMA.1121.00101,1,2257374,2262633,-,5259
445,BUMA.1121.00001,1,3897799,3903059,-,5260
445,BUMA.1121.00038,1,3414123,3419234,+,5111
445,BUMA.1121.00068,1,3091682,3096932,+,5250
445,BUMA.1121.00099,1,2187060,2192319,-,5259
445,BUMA.1121.00091,1,318261,323520,-,5259
445,BUMA.1121.00098,1,2946059,2951310,+,5251
445,BUMA.1121.00013,1,1090793,1095905,-,5112
445,BUMA.1121.00049,1,1625148,1630407,-,5259
445,BUMA.1121.00072,1,227203,232453,+,5250
445,BUMA.1121.00076,1,1136989,1142248,-,5259
445,BUMA.1121.00083,1,1437877,1443136,-,5259
445,BUMA.1121.00078,1,1777823,1783082,-,5259
445,BUMA.1121.00095,1,1447671,1452926,-,5255
445,BUMA.1121.00077,1,2886298,2891548,+,5250
445,BUMA.1121.00063,1,252279,257529,+,5250
445,BUMA.1121.00061,1,255262,260506,+,5244
445,BUMA.1121.00050,1,1353932,1359044,-,5112
445,BUMA.1121.00081,1,3414308,3419419,+,5111
445,BUMA.1121.00074,1,3653887,3659146,-,5259
445,BUMA.1121.00062,1,351926,357186,-,5260
445,BUMA.1121.00060,1,2097808,2103062,-,5254
445,BUMA.1121.00070,1,226902,232152,+,5250
445,BUMA.1121.00075,1,3669924,3675173,+,5249
445,BUMA.1121.00041,1,1489613,1494863,+,5250
445,BUMA.1121.00073,1,253240,258490,+,5250
445,BUMA.1121.00017,1,844392,849504,-,5112
445,BUMA.1121.00066,1,224009,229259,+,5250
445,BUMA.1121.00107,1,43876,49126,+,5250
445,BUMA.1121.00085,1,2951982,2957098,+,5116
445,BUMA.1121.00030,1,844452,849564,-,5112
445,BUMA.1121.00112,1,2854977,2860229,-,5252
445,BUMA.1121.00002,1,563109,568220,+,5111
445,BUMA.1121.00082,1,261707,266957,+,5250
445,BUMA.1121.00014,1,2665696,2670956,-,5260
445,BUMA.1121.00011,1,1398256,1403516,-,5260
445,BUMA.1121.00019,1,909386,914498,-,5112
445,BUMA.1121.00057,1,1321450,1326700,+,5250
445,BUMA.1121.00018,1,728996,734247,+,5251
445,BUMA.1121.00039,1,321871,327122,+,5251
445,BUMA.1121.00016,1,2328978,2334229,+,5251
445,BUMA.1121.00004,1,910541,915653,-,5112
445,BUMA.1121.00005,1,3344967,3350227,-,5260
445,BUMA.1121.00100,1,1117016,1122275,-,5259
445,BUMA.1121.00006,1,3414200,3419311,+,5111
446,BUMA.1121.00027,1,2427182,2439398,+,12216
446,BUMA.1121.00025,1,2513473,2525578,-,12105
446,BUMA.1121.00021,1,867445,879729,+,12284
446,BUMA.1121.00023,1,2562198,2574391,+,12193
446,BUMA.1121.00024,1,897218,909342,-,12124
446,BUMA.1121.00033,1,2486150,2498325,+,12175
446,BUMA.1121.00034,1,934648,946772,-,12124
446,BUMA.1121.00036,1,306340,318464,-,12124
446,BUMA.1121.00032,1,2427733,2439857,-,12124
446,BUMA.1121.00009,1,1334659,1346908,-,12249
446,BUMA.1121.00008,1,900963,913087,-,12124
446,BUMA.1121.00003,1,2733555,2745758,+,12203
446,BUMA.1121.00109,1,1643314,1655477,-,12163
446,BUMA.1121.00053,1,4012307,4024544,+,12237
446,BUMA.1121.00110,1,579679,591865,-,12186
446,BUMA.1121.00104,1,1037880,1050055,-,12175
446,BUMA.1121.00086,1,3318533,3330657,-,12124
446,BUMA.1121.00092,1,3622866,3635015,-,12149
446,BUMA.1121.00096,1,3027933,3040074,-,12141
446,BUMA.1121.00054,1,711744,723868,-,12124
446,BUMA.1121.00097,1,3800960,3813107,-,12147
446,BUMA.1121.00093,1,991421,1003571,+,12150
446,BUMA.1121.00106,1,12979,25171,+,12192
446,BUMA.1121.00010,1,542892,555017,+,12125
446,BUMA.1121.00035,1,1287383,1299550,+,12167
446,BUMA.1121.00108,1,1214041,1226274,+,12233
446,BUMA.1121.00028,1,897217,909341,-,12124
446,BUMA.1121.00094,1,229779,241947,+,12168
446,BUMA.1121.00102,1,1044677,1056885,-,12208
446,BUMA.1121.00111,1,367290,379532,+,12242
446,BUMA.1121.00089,1,245614,257782,+,12168
446,BUMA.1121.00084,1,457104,469248,+,12144
446,BUMA.1121.00029,1,671213,683403,-,12190
446,BUMA.1121.00012,1,2991148,3003324,+,12176
446,BUMA.1121.00087,1,5327,17452,+,12125
446,BUMA.1121.00043,1,222175,234384,+,12209
446,BUMA.1121.00046,1,1397800,1409916,+,12116
446,BUMA.1121.00037,1,2872434,2884643,+,12209
446,BUMA.1121.00080,1,274289,286425,+,12136
446,BUMA.1121.00079,1,269241,281401,+,12160
446,BUMA.1121.00045,1,3860002,3872164,-,12162
446,BUMA.1121.00071,1,248682,260873,+,12191
446,BUMA.1121.00056,1,3667627,3679794,-,12167
446,BUMA.1121.00065,1,261556,273780,+,12224
446,BUMA.1121.00058,1,316290,328449,-,12159
446,BUMA.1121.00007,1,3881645,3893809,-,12164
446,BUMA.1121.00067,1,136837,148988,-,12151
446,BUMA.1121.00090,1,2334403,2346636,+,12233
446,BUMA.1121.00051,1,229873,242121,+,12248
446,BUMA.1121.00020,1,962161,974285,-,12124
446,BUMA.1121.00103,1,124422,136582,-,12160
446,BUMA.1121.00048,1,3211918,3224043,+,12125
446,BUMA.1121.00047,1,2738740,2750931,-,12191
446,BUMA.1121.00042,1,3103300,3115424,+,12124
446,BUMA.1121.00055,1,3905612,3917805,+,12193
446,BUMA.1121.00031,1,1572425,1584650,+,12225
446,BUMA.1121.00040,1,381306,393416,+,12110
446,BUMA.1121.00044,1,162755,174879,-,12124
446,BUMA.1121.00088,1,1121197,1133349,+,12152
446,BUMA.1121.00069,1,221816,234004,+,12188
446,BUMA.1121.00064,1,273526,285678,+,12152
446,BUMA.1121.00105,1,974788,986983,-,12195
446,BUMA.1121.00015,1,284839,296955,+,12116
446,BUMA.1121.00059,1,3449907,3462059,+,12152
446,BUMA.1121.00026,1,894049,906173,+,12124
446,BUMA.1121.00022,1,1022424,1034548,-,12124
446,BUMA.1121.00052,1,3361763,3373866,+,12103
446,BUMA.1121.00101,1,2245202,2257373,-,12171
446,BUMA.1121.00001,1,3885552,3897798,-,12246
446,BUMA.1121.00038,1,3419236,3431361,+,12125
446,BUMA.1121.00068,1,3096934,3109124,+,12190
446,BUMA.1121.00099,1,2174848,2187059,-,12211
446,BUMA.1121.00091,1,306051,318260,-,12209
446,BUMA.1121.00098,1,2951312,2963515,+,12203
446,BUMA.1121.00013,1,1078668,1090792,-,12124
446,BUMA.1121.00049,1,1612962,1625147,-,12185
446,BUMA.1121.00072,1,232455,244649,+,12194
446,BUMA.1121.00076,1,1124781,1136988,-,12207
446,BUMA.1121.00083,1,1425683,1437876,-,12193
446,BUMA.1121.00078,1,1765682,1777822,-,12140
446,BUMA.1121.00095,1,1435510,1447670,-,12160
446,BUMA.1121.00077,1,2891550,2903737,+,12187
446,BUMA.1121.00063,1,257531,269719,+,12188
446,BUMA.1121.00061,1,260514,272705,+,12191
446,BUMA.1121.00050,1,1341816,1353931,-,12115
446,BUMA.1121.00081,1,3419421,3431546,+,12125
446,BUMA.1121.00074,1,3641719,3653886,-,12167
446,BUMA.1121.00062,1,339758,351925,-,12167
446,BUMA.1121.00060,1,2085653,2097807,-,12154
446,BUMA.1121.00070,1,232154,244344,+,12190
446,BUMA.1121.00075,1,3675175,3687383,+,12208
446,BUMA.1121.00041,1,1494865,1507019,+,12154
446,BUMA.1121.00073,1,258492,270684,+,12192
446,BUMA.1121.00017,1,832267,844391,-,12124
446,BUMA.1121.00066,1,229261,241446,+,12185
446,BUMA.1121.00107,1,49128,61297,+,12169
446,BUMA.1121.00085,1,2958708,2970811,+,12103
446,BUMA.1121.00030,1,832327,844451,-,12124
446,BUMA.1121.00112,1,2842753,2854976,-,12223
446,BUMA.1121.00002,1,568222,580347,+,12125
446,BUMA.1121.00082,1,266959,279153,+,12194
446,BUMA.1121.00014,1,2653455,2665695,-,12240
446,BUMA.1121.00011,1,1386126,1398255,-,12129
446,BUMA.1121.00019,1,897261,909385,-,12124
446,BUMA.1121.00057,1,1326702,1338905,+,12203
446,BUMA.1121.00018,1,734249,746355,+,12106
446,BUMA.1121.00039,1,327124,339311,+,12187
446,BUMA.1121.00016,1,2334231,2346371,+,12140
446,BUMA.1121.00004,1,898416,910540,-,12124
446,BUMA.1121.00005,1,3332775,3344966,-,12191
446,BUMA.1121.00100,1,1104879,1117015,-,12136
446,BUMA.1121.00006,1,3419313,3431438,+,12125
447,BUMA.1121.00027,1,2440117,2446751,+,6634
447,BUMA.1121.00025,1,2506098,2512738,-,6640
447,BUMA.1121.00021,1,880448,887089,+,6641
447,BUMA.1121.00023,1,2575110,2581751,+,6641
447,BUMA.1121.00024,1,889871,896498,-,6627
447,BUMA.1121.00033,1,2499044,2505685,+,6641
447,BUMA.1121.00034,1,927301,933928,-,6627
447,BUMA.1121.00036,1,298993,305620,-,6627
447,BUMA.1121.00032,1,2420386,2427013,-,6627
447,BUMA.1121.00009,1,1327300,1333940,-,6640
447,BUMA.1121.00008,1,893616,900243,-,6627
447,BUMA.1121.00003,1,2746493,2753146,+,6653
447,BUMA.1121.00109,1,1623934,1630583,-,6649
447,BUMA.1121.00053,1,4037274,4043915,+,6641
447,BUMA.1121.00110,1,572303,578943,-,6640
447,BUMA.1121.00104,1,1030520,1037160,-,6640
447,BUMA.1121.00086,1,3311186,3317813,-,6627
447,BUMA.1121.00092,1,3615512,3622146,-,6634
447,BUMA.1121.00096,1,3008550,3015190,-,6640
447,BUMA.1121.00054,1,704409,711024,-,6615
447,BUMA.1121.00097,1,3793601,3800241,-,6640
447,BUMA.1121.00093,1,1004290,1010925,+,6635
447,BUMA.1121.00106,1,25890,32531,+,6641
447,BUMA.1121.00010,1,555736,562364,+,6628
447,BUMA.1121.00035,1,1300269,1306910,+,6641
447,BUMA.1121.00108,1,1226992,1233618,+,6626
447,BUMA.1121.00028,1,889870,896497,-,6627
447,BUMA.1121.00094,1,242682,249323,+,6641
447,BUMA.1121.00102,1,1025312,1031946,-,6634
447,BUMA.1121.00111,1,380251,386892,+,6641
447,BUMA.1121.00089,1,258517,265152,+,6635
447,BUMA.1121.00084,1,469967,476608,+,6641
447,BUMA.1121.00029,1,663853,670493,-,6640
447,BUMA.1121.00012,1,3004042,3010683,+,6641
447,BUMA.1121.00087,1,18171,24799,+,6628
447,BUMA.1121.00043,1,235103,241744,+,6641
447,BUMA.1121.00046,1,1410635,1417251,+,6616
447,BUMA.1121.00037,1,2885362,2892003,+,6641
447,BUMA.1121.00080,1,287144,293785,+,6641
447,BUMA.1121.00079,1,282136,288771,+,6635
447,BUMA.1121.00045,1,3852627,3859267,-,6640
447,BUMA.1121.00071,1,261608,268258,+,6650
447,BUMA.1121.00056,1,3660257,3666891,-,6634
447,BUMA.1121.00065,1,274515,281156,+,6641
447,BUMA.1121.00058,1,308930,315570,-,6640
447,BUMA.1121.00007,1,3874275,3880909,-,6634
447,BUMA.1121.00067,1,129477,136117,-,6640
447,BUMA.1121.00090,1,2347355,2353996,+,6641
447,BUMA.1121.00051,1,242856,249491,+,6635
447,BUMA.1121.00020,1,954814,961441,-,6627
447,BUMA.1121.00103,1,117047,123687,-,6640
447,BUMA.1121.00048,1,3224762,3231378,+,6616
447,BUMA.1121.00047,1,2731370,2738004,-,6634
447,BUMA.1121.00042,1,3116143,3122780,+,6637
447,BUMA.1121.00055,1,3918524,3925165,+,6641
447,BUMA.1121.00031,1,1585385,1592026,+,6641
447,BUMA.1121.00040,1,394135,400708,+,6573
447,BUMA.1121.00044,1,155408,162035,-,6627
447,BUMA.1121.00088,1,1134068,1140709,+,6641
447,BUMA.1121.00069,1,234741,241391,+,6650
447,BUMA.1121.00064,1,286397,293038,+,6641
447,BUMA.1121.00105,1,967416,974068,-,6652
447,BUMA.1121.00015,1,297674,304290,+,6616
447,BUMA.1121.00059,1,3462778,3469419,+,6641
447,BUMA.1121.00026,1,906892,913529,+,6637
447,BUMA.1121.00022,1,1015077,1021704,-,6627
447,BUMA.1121.00052,1,3374585,3381201,+,6616
447,BUMA.1121.00101,1,2237837,2244483,-,6646
447,BUMA.1121.00001,1,3878193,3884832,-,6639
447,BUMA.1121.00038,1,3432080,3438696,+,6616
447,BUMA.1121.00068,1,3109842,3116483,+,6641
447,BUMA.1121.00099,1,2167488,2174128,-,6640
447,BUMA.1121.00091,1,298692,305332,-,6640
447,BUMA.1121.00098,1,2964233,2970892,+,6659
447,BUMA.1121.00013,1,1071333,1077948,-,6615
447,BUMA.1121.00049,1,1605602,1612242,-,6640
447,BUMA.1121.00072,1,245384,252034,+,6650
447,BUMA.1121.00076,1,1117411,1124045,-,6634
447,BUMA.1121.00083,1,1418298,1424947,-,6649
447,BUMA.1121.00078,1,1746327,1752967,-,6640
447,BUMA.1121.00095,1,1428135,1434775,-,6640
447,BUMA.1121.00077,1,2904472,2911113,+,6641
447,BUMA.1121.00063,1,270456,277106,+,6650
447,BUMA.1121.00061,1,273440,280090,+,6650
447,BUMA.1121.00050,1,1334481,1341096,-,6615
447,BUMA.1121.00081,1,3432265,3438881,+,6616
447,BUMA.1121.00074,1,3634359,3640999,-,6640
447,BUMA.1121.00062,1,332398,339038,-,6640
447,BUMA.1121.00060,1,2078278,2084918,-,6640
447,BUMA.1121.00070,1,245081,251731,+,6650
447,BUMA.1121.00075,1,3688118,3694753,+,6635
447,BUMA.1121.00041,1,1507738,1514379,+,6641
447,BUMA.1121.00073,1,271419,278069,+,6650
447,BUMA.1121.00017,1,824920,831547,-,6627
447,BUMA.1121.00066,1,242183,248833,+,6650
447,BUMA.1121.00107,1,62015,68656,+,6641
447,BUMA.1121.00085,1,2971530,2978146,+,6616
447,BUMA.1121.00030,1,824980,831607,-,6627
447,BUMA.1121.00112,1,2835394,2842034,-,6640
447,BUMA.1121.00002,1,581066,587694,+,6628
447,BUMA.1121.00082,1,279888,286538,+,6650
447,BUMA.1121.00014,1,2646079,2652719,-,6640
447,BUMA.1121.00011,1,1378746,1385407,-,6661
447,BUMA.1121.00019,1,889914,896541,-,6627
447,BUMA.1121.00057,1,1339639,1346289,+,6650
447,BUMA.1121.00018,1,747089,753730,+,6641
447,BUMA.1121.00039,1,340045,346686,+,6641
447,BUMA.1121.00016,1,2347090,2353731,+,6641
447,BUMA.1121.00004,1,891069,897696,-,6627
447,BUMA.1121.00005,1,3325390,3332039,-,6649
447,BUMA.1121.00100,1,1085507,1092147,-,6640
447,BUMA.1121.00006,1,3432157,3438773,+,6616
448,BUMA.1121.00027,1,2446816,2466647,+,19831
448,BUMA.1121.00025,1,2486150,2506033,-,19883
448,BUMA.1121.00021,1,887154,907023,+,19869
448,BUMA.1121.00023,1,2581816,2601674,+,19858
448,BUMA.1121.00024,1,869959,889806,-,19847
448,BUMA.1121.00033,1,2505750,2525633,+,19883
448,BUMA.1121.00034,1,907389,927236,-,19847
448,BUMA.1121.00036,1,279080,298928,-,19848
448,BUMA.1121.00032,1,2400474,2420321,-,19847
448,BUMA.1121.00009,1,1307351,1327235,-,19884
448,BUMA.1121.00008,1,873704,893551,-,19847
448,BUMA.1121.00003,1,2753211,2773035,+,19824
448,BUMA.1121.00109,1,1603961,1623869,-,19908
448,BUMA.1121.00053,1,4043980,4063845,+,19865
448,BUMA.1121.00110,1,552357,572235,-,19878
448,BUMA.1121.00104,1,1010584,1030455,-,19871
448,BUMA.1121.00086,1,3291273,3311121,-,19848
448,BUMA.1121.00092,1,3595590,3615447,-,19857
448,BUMA.1121.00096,1,2988648,3008485,-,19837
448,BUMA.1121.00054,1,684498,704344,-,19846
448,BUMA.1121.00097,1,3773663,3793536,-,19873
448,BUMA.1121.00093,1,1010990,1030847,+,19857
448,BUMA.1121.00106,1,32596,52461,+,19865
448,BUMA.1121.00010,1,562429,582283,+,19854
448,BUMA.1121.00035,1,1306975,1326870,+,19895
448,BUMA.1121.00108,1,1233683,1253554,+,19871
448,BUMA.1121.00028,1,869958,889805,-,19847
448,BUMA.1121.00094,1,249388,269263,+,19875
448,BUMA.1121.00102,1,1005382,1025247,-,19865
448,BUMA.1121.00111,1,386957,406833,+,19876
448,BUMA.1121.00089,1,265217,285083,+,19866
448,BUMA.1121.00084,1,476673,496543,+,19870
448,BUMA.1121.00029,1,643893,663788,-,19895
448,BUMA.1121.00012,1,3010748,3030627,+,19879
448,BUMA.1121.00087,1,24864,44712,+,19848
448,BUMA.1121.00043,1,241809,263059,+,21250
448,BUMA.1121.00046,1,1417316,1437162,+,19846
448,BUMA.1121.00037,1,2892068,2911953,+,19885
448,BUMA.1121.00080,1,293850,313720,+,19870
448,BUMA.1121.00079,1,288836,308706,+,19870
448,BUMA.1121.00045,1,3832709,3852562,-,19853
448,BUMA.1121.00071,1,268323,288192,+,19869
448,BUMA.1121.00056,1,3640326,3660192,-,19866
448,BUMA.1121.00065,1,281221,301058,+,19837
448,BUMA.1121.00058,1,288988,308865,-,19877
448,BUMA.1121.00007,1,3854351,3874210,-,19859
448,BUMA.1121.00067,1,109606,129412,-,19806
448,BUMA.1121.00090,1,2354061,2373962,+,19901
448,BUMA.1121.00051,1,249556,269426,+,19870
448,BUMA.1121.00020,1,934902,954749,-,19847
448,BUMA.1121.00103,1,97154,116982,-,19828
448,BUMA.1121.00048,1,3231443,3251289,+,19846
448,BUMA.1121.00047,1,2711435,2731305,-,19870
448,BUMA.1121.00042,1,3122845,3142678,+,19833
448,BUMA.1121.00055,1,3925230,3945072,+,19842
448,BUMA.1121.00031,1,1592091,1611980,+,19889
448,BUMA.1121.00040,1,402068,421916,+,19848
448,BUMA.1121.00044,1,135496,155343,-,19847
448,BUMA.1121.00088,1,1140774,1160655,+,19881
448,BUMA.1121.00069,1,241456,261322,+,19866
448,BUMA.1121.00064,1,293103,312920,+,19817
448,BUMA.1121.00105,1,947494,967351,-,19857
448,BUMA.1121.00015,1,304355,324201,+,19846
448,BUMA.1121.00059,1,3469484,3489338,+,19854
448,BUMA.1121.00026,1,913594,933429,+,19835
448,BUMA.1121.00022,1,995164,1015012,-,19848
448,BUMA.1121.00052,1,3381266,3401120,+,19854
448,BUMA.1121.00101,1,2217932,2237772,-,19840
448,BUMA.1121.00001,1,3858235,3878128,-,19893
448,BUMA.1121.00038,1,3438761,3458607,+,19846
448,BUMA.1121.00068,1,3116548,3136433,+,19885
448,BUMA.1121.00099,1,2147559,2167423,-,19864
448,BUMA.1121.00091,1,278773,298627,-,19854
448,BUMA.1121.00098,1,2970957,2990845,+,19888
448,BUMA.1121.00013,1,1051414,1071268,-,19854
448,BUMA.1121.00049,1,1585678,1605537,-,19859
448,BUMA.1121.00072,1,252099,271968,+,19869
448,BUMA.1121.00076,1,1097486,1117346,-,19860
448,BUMA.1121.00083,1,1398364,1418233,-,19869
448,BUMA.1121.00078,1,1726413,1746262,-,19849
448,BUMA.1121.00095,1,1408202,1428070,-,19868
448,BUMA.1121.00077,1,2911181,2931058,+,19877
448,BUMA.1121.00063,1,277171,297040,+,19869
448,BUMA.1121.00061,1,280155,300024,+,19869
448,BUMA.1121.00050,1,1314568,1334416,-,19848
448,BUMA.1121.00081,1,3438946,3458792,+,19846
448,BUMA.1121.00074,1,3614488,3634294,-,19806
448,BUMA.1121.00062,1,312464,332333,-,19869
448,BUMA.1121.00060,1,2058360,2078213,-,19853
448,BUMA.1121.00070,1,251796,271665,+,19869
448,BUMA.1121.00075,1,3694818,3714677,+,19859
448,BUMA.1121.00041,1,1514444,1534317,+,19873
448,BUMA.1121.00073,1,278134,298003,+,19869
448,BUMA.1121.00017,1,805008,824855,-,19847
448,BUMA.1121.00066,1,248898,268766,+,19868
448,BUMA.1121.00107,1,68721,88639,+,19918
448,BUMA.1121.00085,1,2978211,2998065,+,19854
448,BUMA.1121.00030,1,805068,824915,-,19847
448,BUMA.1121.00112,1,2815460,2835329,-,19869
448,BUMA.1121.00002,1,587759,607613,+,19854
448,BUMA.1121.00082,1,286603,306472,+,19869
448,BUMA.1121.00014,1,2626119,2646014,-,19895
448,BUMA.1121.00011,1,1358815,1378681,-,19866
448,BUMA.1121.00019,1,870002,889849,-,19847
448,BUMA.1121.00057,1,1346354,1366191,+,19837
448,BUMA.1121.00018,1,753795,773678,+,19883
448,BUMA.1121.00039,1,346751,366615,+,19864
448,BUMA.1121.00016,1,2353796,2373685,+,19889
448,BUMA.1121.00004,1,869917,889709,-,19792
448,BUMA.1121.00005,1,3305518,3325325,-,19807
448,BUMA.1121.00100,1,1065580,1085442,-,19862
448,BUMA.1121.00006,1,3438838,3458684,+,19846
449,BUMA.1121.00027,1,2466702,2472709,+,6007
449,BUMA.1121.00025,1,2480080,2486095,-,6015
449,BUMA.1121.00021,1,907078,913108,+,6030
449,BUMA.1121.00023,1,2601729,2607769,+,6040
449,BUMA.1121.00024,1,862669,868663,-,5994
449,BUMA.1121.00033,1,2525688,2531691,+,6003
449,BUMA.1121.00034,1,900099,906093,-,5994
449,BUMA.1121.00036,1,271791,277785,-,5994
449,BUMA.1121.00032,1,2393184,2399178,-,5994
449,BUMA.1121.00009,1,1301284,1307296,-,6012
449,BUMA.1121.00008,1,866414,872408,-,5994
449,BUMA.1121.00003,1,2773090,2779102,+,6012
449,BUMA.1121.00109,1,1597907,1603906,-,5999
449,BUMA.1121.00053,1,4063900,4069912,+,6012
449,BUMA.1121.00110,1,546291,552302,-,6011
449,BUMA.1121.00104,1,1004528,1010529,-,6001
449,BUMA.1121.00086,1,2615949,2621943,+,5994
449,BUMA.1121.00092,1,3589534,3595535,-,6001
449,BUMA.1121.00096,1,2982575,2988593,-,6018
449,BUMA.1121.00054,1,677209,683203,-,5994
449,BUMA.1121.00097,1,3767603,3773608,-,6005
449,BUMA.1121.00093,1,1030902,1036903,+,6001
449,BUMA.1121.00106,1,52516,58534,+,6018
449,BUMA.1121.00010,1,583578,589572,+,5994
449,BUMA.1121.00035,1,1326925,1332939,+,6014
449,BUMA.1121.00108,1,1253609,1259614,+,6005
449,BUMA.1121.00028,1,862668,868662,-,5994
449,BUMA.1121.00094,1,269318,275322,+,6004
449,BUMA.1121.00102,1,999309,1005327,-,6018
449,BUMA.1121.00111,1,406888,412892,+,6004
449,BUMA.1121.00089,1,285138,291145,+,6007
449,BUMA.1121.00084,1,496598,502599,+,6001
449,BUMA.1121.00029,1,637834,643838,-,6004
449,BUMA.1121.00012,1,3030682,3036686,+,6004
449,BUMA.1121.00087,1,713675,719669,-,5994
449,BUMA.1121.00043,1,263114,269137,+,6023
449,BUMA.1121.00046,1,1609502,1615496,-,5994
449,BUMA.1121.00037,1,2912008,2918040,+,6032
449,BUMA.1121.00080,1,313775,319779,+,6004
449,BUMA.1121.00079,1,308761,314778,+,6017
449,BUMA.1121.00045,1,3826635,3832654,-,6019
449,BUMA.1121.00071,1,288247,294247,+,6000
449,BUMA.1121.00056,1,3634264,3640271,-,6007
449,BUMA.1121.00065,1,301113,307125,+,6012
449,BUMA.1121.00058,1,282896,288933,-,6037
449,BUMA.1121.00007,1,3848275,3854296,-,6021
449,BUMA.1121.00067,1,103543,109551,-,6008
449,BUMA.1121.00090,1,2374017,2380021,+,6004
449,BUMA.1121.00051,1,269481,275484,+,6003
449,BUMA.1121.00020,1,927612,933606,-,5994
449,BUMA.1121.00103,1,91078,97099,-,6021
449,BUMA.1121.00048,1,3252584,3258578,+,5994
449,BUMA.1121.00047,1,2705386,2711380,-,5994
449,BUMA.1121.00042,1,3143975,3149980,+,6005
449,BUMA.1121.00055,1,3945127,3951116,+,5989
449,BUMA.1121.00031,1,1612035,1618067,+,6032
449,BUMA.1121.00040,1,423211,429205,+,5994
449,BUMA.1121.00044,1,128206,134200,-,5994
449,BUMA.1121.00088,1,1160710,1166714,+,6004
449,BUMA.1121.00069,1,261377,267377,+,6000
449,BUMA.1121.00064,1,312975,318983,+,6008
449,BUMA.1121.00105,1,941435,947439,-,6004
449,BUMA.1121.00015,1,3359594,3365588,-,5994
449,BUMA.1121.00059,1,3489400,3495397,+,5997
449,BUMA.1121.00026,1,934724,940729,+,6005
449,BUMA.1121.00022,1,987875,993869,-,5994
449,BUMA.1121.00052,1,3402415,3408409,+,5994
449,BUMA.1121.00101,1,2211883,2217877,-,5994
449,BUMA.1121.00001,1,3852166,3858180,-,6014
449,BUMA.1121.00038,1,3459902,3465896,+,5994
449,BUMA.1121.00068,1,3136488,3142471,+,5983
449,BUMA.1121.00099,1,2141492,2147504,-,6012
449,BUMA.1121.00091,1,272704,278718,-,6014
449,BUMA.1121.00098,1,2990900,2996834,+,5934
449,BUMA.1121.00013,1,1044125,1050119,-,5994
449,BUMA.1121.00049,1,1579622,1585623,-,6001
449,BUMA.1121.00072,1,272023,278023,+,6000
449,BUMA.1121.00076,1,1091417,1097431,-,6014
449,BUMA.1121.00083,1,1392309,1398309,-,6000
449,BUMA.1121.00078,1,1720357,1726358,-,6001
449,BUMA.1121.00095,1,1402128,1408147,-,6019
449,BUMA.1121.00077,1,2931113,2937125,+,6012
449,BUMA.1121.00063,1,297095,303095,+,6000
449,BUMA.1121.00061,1,300079,306079,+,6000
449,BUMA.1121.00050,1,1136210,1142204,+,5994
449,BUMA.1121.00081,1,3460087,3466081,+,5994
449,BUMA.1121.00074,1,3608425,3614433,-,6008
449,BUMA.1121.00062,1,306405,312409,-,6004
449,BUMA.1121.00060,1,2052286,2058305,-,6019
449,BUMA.1121.00070,1,271720,277720,+,6000
449,BUMA.1121.00075,1,3714732,3720746,+,6014
449,BUMA.1121.00041,1,1534372,1540384,+,6012
449,BUMA.1121.00073,1,298058,304058,+,6000
449,BUMA.1121.00017,1,797718,803712,-,5994
449,BUMA.1121.00066,1,268821,274820,+,5999
449,BUMA.1121.00107,1,88694,94643,+,5949
449,BUMA.1121.00085,1,2999360,3005354,+,5994
449,BUMA.1121.00030,1,797778,803772,-,5994
449,BUMA.1121.00112,1,2809414,2815405,-,5991
449,BUMA.1121.00002,1,608908,614902,+,5994
449,BUMA.1121.00082,1,306527,312527,+,6000
449,BUMA.1121.00014,1,2620041,2626064,-,6023
449,BUMA.1121.00011,1,1352758,1358760,-,6002
449,BUMA.1121.00019,1,862712,868706,-,5994
449,BUMA.1121.00057,1,1366246,1372246,+,6000
449,BUMA.1121.00018,1,773733,779748,+,6015
449,BUMA.1121.00039,1,366670,372674,+,6004
449,BUMA.1121.00016,1,2373740,2379754,+,6014
449,BUMA.1121.00004,1,862627,868621,-,5994
449,BUMA.1121.00005,1,3299452,3305463,-,6011
449,BUMA.1121.00100,1,1059518,1065525,-,6007
449,BUMA.1121.00006,1,3459979,3465973,+,5994
450,BUMA.1121.00027,1,2477172,2491831,+,14659
450,BUMA.1121.00025,1,2460894,2475579,-,14685
450,BUMA.1121.00021,1,917590,932258,+,14668
450,BUMA.1121.00023,1,2612260,2626925,+,14665
450,BUMA.1121.00024,1,1172082,1186722,-,14640
450,BUMA.1121.00033,1,2536172,2550847,+,14675
450,BUMA.1121.00034,1,1209470,1224110,-,14640
450,BUMA.1121.00036,1,251084,265737,-,14653
450,BUMA.1121.00032,1,2702452,2717092,-,14640
450,BUMA.1121.00009,1,1282158,1296838,-,14680
450,BUMA.1121.00008,1,1175796,1190436,-,14640
450,BUMA.1121.00003,1,2783544,2798210,+,14666
450,BUMA.1121.00109,1,1578731,1593429,-,14698
450,BUMA.1121.00053,1,32,14668,+,14636
450,BUMA.1121.00110,1,527191,541835,-,14644
450,BUMA.1121.00104,1,985356,1000073,-,14717
450,BUMA.1121.00086,1,2199930,2214583,+,14653
450,BUMA.1121.00092,1,3570373,3585079,-,14706
450,BUMA.1121.00096,1,2962191,2976817,-,14626
450,BUMA.1121.00054,1,656518,671158,-,14640
450,BUMA.1121.00097,1,3748447,3763107,-,14660
450,BUMA.1121.00093,1,1041357,1056063,+,14706
450,BUMA.1121.00106,1,62988,77716,+,14728
450,BUMA.1121.00010,1,595609,610262,+,14653
450,BUMA.1121.00035,1,1337429,1352095,+,14666
450,BUMA.1121.00108,1,1264077,1278744,+,14667
450,BUMA.1121.00028,1,1172126,1186766,-,14640
450,BUMA.1121.00094,1,279776,294472,+,14696
450,BUMA.1121.00102,1,978714,993402,-,14688
450,BUMA.1121.00111,1,418972,433633,+,14661
450,BUMA.1121.00089,1,295599,310296,+,14697
450,BUMA.1121.00084,1,508366,523011,+,14645
450,BUMA.1121.00029,1,618680,633333,-,14653
450,BUMA.1121.00012,1,3041168,3055856,+,14688
450,BUMA.1121.00087,1,1102505,1117158,-,14653
450,BUMA.1121.00043,1,273638,288349,+,14711
450,BUMA.1121.00046,1,1588810,1603450,-,14640
450,BUMA.1121.00037,1,2922522,2937197,+,14675
450,BUMA.1121.00080,1,325546,340274,+,14728
450,BUMA.1121.00079,1,319230,333962,+,14732
450,BUMA.1121.00045,1,3807480,3822126,-,14646
450,BUMA.1121.00071,1,298691,313350,+,14659
450,BUMA.1121.00056,1,3615112,3629809,-,14697
450,BUMA.1121.00065,1,311583,326224,+,14641
450,BUMA.1121.00058,1,263700,278441,-,14741
450,BUMA.1121.00007,1,3829177,3843811,-,14634
450,BUMA.1121.00067,1,84330,99088,-,14758
450,BUMA.1121.00090,1,2384502,2399177,+,14675
450,BUMA.1121.00051,1,281251,295979,+,14728
450,BUMA.1121.00020,1,1237015,1251655,-,14640
450,BUMA.1121.00103,1,70294,84996,-,14702
450,BUMA.1121.00048,1,3264629,3279269,+,14640
450,BUMA.1121.00047,1,2684890,2699618,-,14728
450,BUMA.1121.00042,1,3199499,3214203,-,14704
450,BUMA.1121.00055,1,3955580,3970288,+,14708
450,BUMA.1121.00031,1,1622549,1637224,+,14675
450,BUMA.1121.00040,1,435255,449895,+,14640
450,BUMA.1121.00044,1,437568,452208,-,14640
450,BUMA.1121.00088,1,1172481,1187209,+,14728
450,BUMA.1121.00069,1,271817,286475,+,14658
450,BUMA.1121.00064,1,323437,338182,+,14745
450,BUMA.1121.00105,1,922309,936980,-,14671
450,BUMA.1121.00015,1,3338902,3353542,-,14640
450,BUMA.1121.00059,1,3501164,3515892,+,14728
450,BUMA.1121.00026,1,946780,961497,+,14717
450,BUMA.1121.00022,1,967172,981825,-,14653
450,BUMA.1121.00052,1,3414460,3429139,+,14679
450,BUMA.1121.00101,1,2192755,2207391,-,14636
450,BUMA.1121.00001,1,3833009,3847675,-,14666
450,BUMA.1121.00038,1,3471947,3486587,+,14640
450,BUMA.1121.00068,1,3146916,3161622,+,14706
450,BUMA.1121.00099,1,2122368,2137037,-,14669
450,BUMA.1121.00091,1,252282,266933,-,14651
450,BUMA.1121.00098,1,3001303,3015926,+,14623
450,BUMA.1121.00013,1,1023394,1038073,-,14679
450,BUMA.1121.00049,1,1560464,1575167,-,14703
450,BUMA.1121.00072,1,282456,297075,+,14619
450,BUMA.1121.00076,1,1072224,1086963,-,14739
450,BUMA.1121.00083,1,1373194,1387854,-,14660
450,BUMA.1121.00078,1,1699920,1714557,-,14637
450,BUMA.1121.00095,1,1382993,1397684,-,14691
450,BUMA.1121.00077,1,2941580,2956225,+,14645
450,BUMA.1121.00063,1,307532,322192,+,14660
450,BUMA.1121.00061,1,310526,325186,+,14660
450,BUMA.1121.00050,1,1148254,1162894,+,14640
450,BUMA.1121.00081,1,3472132,3486772,+,14640
450,BUMA.1121.00074,1,3589225,3603970,-,14745
450,BUMA.1121.00062,1,287216,301950,-,14734
450,BUMA.1121.00060,1,2033131,2047777,-,14646
450,BUMA.1121.00070,1,282162,296822,+,14660
450,BUMA.1121.00075,1,3725199,3739938,+,14739
450,BUMA.1121.00041,1,1544883,1559550,+,14667
450,BUMA.1121.00073,1,308505,323156,+,14651
450,BUMA.1121.00017,1,1107107,1121747,-,14640
450,BUMA.1121.00066,1,279264,293914,+,14650
450,BUMA.1121.00107,1,99111,113835,+,14724
450,BUMA.1121.00085,1,3011405,3026084,+,14679
450,BUMA.1121.00030,1,1107147,1121787,-,14640
450,BUMA.1121.00112,1,2790275,2804946,-,14671
450,BUMA.1121.00002,1,620938,635591,+,14653
450,BUMA.1121.00082,1,316981,331641,+,14660
450,BUMA.1121.00014,1,2600883,2615558,-,14675
450,BUMA.1121.00011,1,1333537,1348240,-,14703
450,BUMA.1121.00019,1,1172138,1186778,-,14640
450,BUMA.1121.00057,1,1376700,1391454,+,14754
450,BUMA.1121.00018,1,784248,798933,+,14685
450,BUMA.1121.00039,1,377184,391859,+,14675
450,BUMA.1121.00016,1,2384236,2398893,+,14657
450,BUMA.1121.00004,1,1173298,1187938,-,14640
450,BUMA.1121.00005,1,3278765,3293404,-,14639
450,BUMA.1121.00100,1,1040443,1055064,-,14621
450,BUMA.1121.00006,1,3472024,3486664,+,14640
451,BUMA.1121.00027,1,2493346,2505369,+,12023
451,BUMA.1121.00025,1,2447476,2459379,-,11903
451,BUMA.1121.00021,1,933773,945715,+,11942
451,BUMA.1121.00023,1,2628440,2640409,+,11969
451,BUMA.1121.00024,1,1158604,1170567,-,11963
451,BUMA.1121.00033,1,2552362,2564297,+,11935
451,BUMA.1121.00034,1,1195992,1207955,-,11963
451,BUMA.1121.00036,1,237606,249569,-,11963
451,BUMA.1121.00032,1,2688974,2700937,-,11963
451,BUMA.1121.00009,1,1268648,1280643,-,11995
451,BUMA.1121.00008,1,1162319,1174281,-,11962
451,BUMA.1121.00003,1,2799725,2811750,+,12025
451,BUMA.1121.00109,1,1565248,1577216,-,11968
451,BUMA.1121.00053,1,16183,28180,+,11997
451,BUMA.1121.00110,1,513628,525676,-,12048
451,BUMA.1121.00104,1,971821,983841,-,12020
451,BUMA.1121.00086,1,2216098,2228062,+,11964
451,BUMA.1121.00092,1,3556850,3568858,-,12008
451,BUMA.1121.00096,1,2948685,2960676,-,11991
451,BUMA.1121.00054,1,643025,655003,-,11978
451,BUMA.1121.00097,1,3734963,3746932,-,11969
451,BUMA.1121.00093,1,1057578,1069587,+,12009
451,BUMA.1121.00106,1,79231,91252,+,12021
451,BUMA.1121.00010,1,611777,623741,+,11964
451,BUMA.1121.00035,1,1353610,1365552,+,11942
451,BUMA.1121.00108,1,1280259,1292262,+,12003
451,BUMA.1121.00028,1,1158648,1170611,-,11963
451,BUMA.1121.00094,1,295987,307987,+,12000
451,BUMA.1121.00102,1,965230,977199,-,11969
451,BUMA.1121.00111,1,435148,447090,+,11942
451,BUMA.1121.00089,1,311811,323811,+,12000
451,BUMA.1121.00084,1,524526,536514,+,11988
451,BUMA.1121.00029,1,605224,617165,-,11941
451,BUMA.1121.00012,1,3057371,3069313,+,11942
451,BUMA.1121.00087,1,1089027,1100990,-,11963
451,BUMA.1121.00043,1,289864,301842,+,11978
451,BUMA.1121.00046,1,1575356,1587295,-,11939
451,BUMA.1121.00037,1,2938712,2950654,+,11942
451,BUMA.1121.00080,1,341789,353800,+,12011
451,BUMA.1121.00079,1,335477,347496,+,12019
451,BUMA.1121.00045,1,3793975,3805965,-,11990
451,BUMA.1121.00071,1,314865,326853,+,11988
451,BUMA.1121.00056,1,3601598,3613597,-,11999
451,BUMA.1121.00065,1,327739,339704,+,11965
451,BUMA.1121.00058,1,250217,262185,-,11968
451,BUMA.1121.00007,1,3815666,3827662,-,11996
451,BUMA.1121.00067,1,70807,82815,-,12008
451,BUMA.1121.00090,1,2400692,2412634,+,11942
451,BUMA.1121.00051,1,297494,309505,+,12011
451,BUMA.1121.00020,1,1223537,1235500,-,11963
451,BUMA.1121.00103,1,56820,68779,-,11959
451,BUMA.1121.00048,1,3280784,3292763,+,11979
451,BUMA.1121.00047,1,2671364,2683375,-,12011
451,BUMA.1121.00042,1,3186043,3197984,-,11941
451,BUMA.1121.00055,1,3971803,3983817,+,12014
451,BUMA.1121.00031,1,1638739,1650709,+,11970
451,BUMA.1121.00040,1,451410,463045,+,11635
451,BUMA.1121.00044,1,424090,436053,-,11963
451,BUMA.1121.00088,1,1188724,1200703,+,11979
451,BUMA.1121.00069,1,287990,299953,+,11963
451,BUMA.1121.00064,1,339697,351688,+,11991
451,BUMA.1121.00105,1,908807,920794,-,11987
451,BUMA.1121.00015,1,3325409,3337387,-,11978
451,BUMA.1121.00059,1,3517407,3529410,+,12003
451,BUMA.1121.00026,1,963012,974952,+,11940
451,BUMA.1121.00022,1,953694,965657,-,11963
451,BUMA.1121.00052,1,3430654,3442633,+,11979
451,BUMA.1121.00101,1,2179312,2191240,-,11928
451,BUMA.1121.00001,1,3819553,3831494,-,11941
451,BUMA.1121.00038,1,3488102,3500081,+,11979
451,BUMA.1121.00068,1,3163137,3175150,+,12013
451,BUMA.1121.00099,1,2108844,2120853,-,12009
451,BUMA.1121.00091,1,238782,250767,-,11985
451,BUMA.1121.00098,1,3017441,3029411,+,11970
451,BUMA.1121.00013,1,1009901,1021879,-,11978
451,BUMA.1121.00049,1,1546938,1558949,-,12011
451,BUMA.1121.00072,1,298590,310510,+,11920
451,BUMA.1121.00076,1,1058726,1070709,-,11983
451,BUMA.1121.00083,1,1359666,1371679,-,12013
451,BUMA.1121.00078,1,1686386,1698405,-,12019
451,BUMA.1121.00095,1,1369498,1381478,-,11980
451,BUMA.1121.00077,1,2957740,2969790,+,12050
451,BUMA.1121.00063,1,323707,335574,+,11867
451,BUMA.1121.00061,1,326701,338536,+,11835
451,BUMA.1121.00050,1,1164409,1176388,+,11979
451,BUMA.1121.00081,1,3488287,3500266,+,11979
451,BUMA.1121.00074,1,3575720,3587710,-,11990
451,BUMA.1121.00062,1,273714,285701,-,11987
451,BUMA.1121.00060,1,2019626,2031616,-,11990
451,BUMA.1121.00070,1,298337,310318,+,11981
451,BUMA.1121.00075,1,3741453,3753434,+,11981
451,BUMA.1121.00041,1,1561065,1573095,+,12030
451,BUMA.1121.00073,1,324671,336636,+,11965
451,BUMA.1121.00017,1,1093629,1105592,-,11963
451,BUMA.1121.00066,1,295429,307423,+,11994
451,BUMA.1121.00107,1,115350,127380,+,12030
451,BUMA.1121.00085,1,3027599,3039578,+,11979
451,BUMA.1121.00030,1,1093670,1105632,-,11962
451,BUMA.1121.00112,1,2776777,2788760,-,11983
451,BUMA.1121.00002,1,637106,649070,+,11964
451,BUMA.1121.00082,1,333156,345170,+,12014
451,BUMA.1121.00014,1,2587399,2599368,-,11969
451,BUMA.1121.00011,1,1320047,1332022,-,11975
451,BUMA.1121.00019,1,1158660,1170623,-,11963
451,BUMA.1121.00057,1,1392969,1405001,+,12032
451,BUMA.1121.00018,1,800448,812352,+,11904
451,BUMA.1121.00039,1,393374,405293,+,11919
451,BUMA.1121.00016,1,2400408,2412349,+,11941
451,BUMA.1121.00004,1,1159820,1171783,-,11963
451,BUMA.1121.00005,1,3265335,3277250,-,11915
451,BUMA.1121.00100,1,1026959,1038928,-,11969
451,BUMA.1121.00006,1,3488179,3500158,+,11979
452,BUMA.1121.00027,1,2522005,2525348,+,3343
452,BUMA.1121.00025,1,2427470,2430825,-,3355
452,BUMA.1121.00021,1,962434,965801,+,3367
452,BUMA.1121.00023,1,2657012,2660368,+,3356
452,BUMA.1121.00033,1,2583862,2587218,+,3356
452,BUMA.1121.00009,1,1248624,1251967,-,3343
452,BUMA.1121.00003,1,2828359,2831683,+,3324
452,BUMA.1121.00109,1,1543872,1547207,-,3335
452,BUMA.1121.00053,1,44924,48268,+,3344
452,BUMA.1121.00110,1,490761,494104,-,3343
452,BUMA.1121.00104,1,951764,955107,-,3343
452,BUMA.1121.00092,1,3535531,3538886,-,3355
452,BUMA.1121.00096,1,2928713,2932057,-,3344
452,BUMA.1121.00097,1,3712430,3715773,-,3343
452,BUMA.1121.00093,1,1087549,1090905,+,3356
452,BUMA.1121.00106,1,107836,111180,+,3344
452,BUMA.1121.00035,1,1382191,1385557,+,3366
452,BUMA.1121.00108,1,1310162,1313506,+,3344
452,BUMA.1121.00094,1,325956,329300,+,3344
452,BUMA.1121.00102,1,945277,948620,-,3343
452,BUMA.1121.00111,1,463753,467109,+,3356
452,BUMA.1121.00089,1,341761,345105,+,3344
452,BUMA.1121.00084,1,553162,556506,+,3344
452,BUMA.1121.00029,1,585165,588530,-,3365
452,BUMA.1121.00012,1,3085891,3089247,+,3356
452,BUMA.1121.00043,1,318415,321771,+,3356
452,BUMA.1121.00037,1,2968580,2971936,+,3356
452,BUMA.1121.00080,1,371805,375149,+,3344
452,BUMA.1121.00079,1,365453,368797,+,3344
452,BUMA.1121.00045,1,3774026,3777369,-,3343
452,BUMA.1121.00071,1,343459,346803,+,3344
452,BUMA.1121.00056,1,3580304,3583647,-,3343
452,BUMA.1121.00065,1,356391,359735,+,3344
452,BUMA.1121.00058,1,227637,230980,-,3343
452,BUMA.1121.00007,1,3795711,3799054,-,3343
452,BUMA.1121.00067,1,50920,54263,-,3343
452,BUMA.1121.00090,1,2429348,2432704,+,3356
452,BUMA.1121.00051,1,327558,330902,+,3344
452,BUMA.1121.00103,1,35598,38941,-,3343
452,BUMA.1121.00047,1,2650102,2653445,-,3343
452,BUMA.1121.00055,1,4001705,4005049,+,3344
452,BUMA.1121.00031,1,1668671,1672027,+,3356
452,BUMA.1121.00088,1,1217269,1220613,+,3344
452,BUMA.1121.00069,1,316558,319902,+,3344
452,BUMA.1121.00064,1,368334,371678,+,3344
452,BUMA.1121.00105,1,888822,892165,-,3343
452,BUMA.1121.00059,1,3545995,3549339,+,3344
452,BUMA.1121.00101,1,2159289,2162632,-,3343
452,BUMA.1121.00001,1,3799467,3802832,-,3365
452,BUMA.1121.00068,1,3193095,3196439,+,3344
452,BUMA.1121.00099,1,2088736,2092078,-,3342
452,BUMA.1121.00091,1,216166,219521,-,3355
452,BUMA.1121.00098,1,3048948,3052292,+,3344
452,BUMA.1121.00049,1,1526918,1530261,-,3343
452,BUMA.1121.00072,1,327144,330488,+,3344
452,BUMA.1121.00076,1,1037508,1040851,-,3343
452,BUMA.1121.00083,1,1339679,1343022,-,3343
452,BUMA.1121.00078,1,1666327,1669670,-,3343
452,BUMA.1121.00095,1,1349553,1352895,-,3342
452,BUMA.1121.00077,1,2989312,2992656,+,3344
452,BUMA.1121.00063,1,352209,355553,+,3344
452,BUMA.1121.00061,1,355135,358479,+,3344
452,BUMA.1121.00074,1,3555809,3559152,-,3343
452,BUMA.1121.00062,1,252496,255839,-,3343
452,BUMA.1121.00060,1,1999693,2003036,-,3343
452,BUMA.1121.00070,1,326922,330266,+,3344
452,BUMA.1121.00075,1,3771313,3774657,+,3344
452,BUMA.1121.00041,1,1591059,1594403,+,3344
452,BUMA.1121.00073,1,353239,356583,+,3344
452,BUMA.1121.00066,1,324028,327372,+,3344
452,BUMA.1121.00107,1,143908,147251,+,3343
452,BUMA.1121.00112,1,2756742,2760085,-,3343
452,BUMA.1121.00082,1,361813,365157,+,3344
452,BUMA.1121.00014,1,2567464,2570819,-,3355
452,BUMA.1121.00011,1,1300082,1303425,-,3343
452,BUMA.1121.00057,1,1421640,1424984,+,3344
452,BUMA.1121.00018,1,829021,832377,+,3356
452,BUMA.1121.00039,1,421996,425352,+,3356
452,BUMA.1121.00016,1,2428982,2432338,+,3356
452,BUMA.1121.00005,1,3243661,3247015,-,3354
452,BUMA.1121.00100,1,1006815,1010158,-,3343
453,BUMA.1121.00027,1,2534652,2546159,+,11507
453,BUMA.1121.00025,1,2406611,2418170,-,11559
453,BUMA.1121.00021,1,975093,986638,+,11545
453,BUMA.1121.00023,1,2669668,2681195,+,11527
453,BUMA.1121.00033,1,2596518,2608071,+,11553
453,BUMA.1121.00009,1,1227746,1239323,-,11577
453,BUMA.1121.00003,1,2833889,2845461,+,11572
453,BUMA.1121.00109,1,1523003,1534540,-,11537
453,BUMA.1121.00053,1,57492,68959,+,11467
453,BUMA.1121.00110,1,438921,450448,-,11527
453,BUMA.1121.00104,1,930950,942464,-,11514
453,BUMA.1121.00092,1,3514659,3526228,-,11569
453,BUMA.1121.00096,1,2911306,2922908,-,11602
453,BUMA.1121.00097,1,3677927,3689449,-,11522
453,BUMA.1121.00093,1,1100208,1111776,+,11568
453,BUMA.1121.00106,1,120483,132003,+,11520
453,BUMA.1121.00035,1,1394857,1406410,+,11553
453,BUMA.1121.00108,1,1322806,1334301,+,11495
453,BUMA.1121.00094,1,338602,350161,+,11559
453,BUMA.1121.00102,1,924548,936053,-,11505
453,BUMA.1121.00111,1,476401,487970,+,11569
453,BUMA.1121.00089,1,354407,365966,+,11559
453,BUMA.1121.00084,1,565806,577373,+,11567
453,BUMA.1121.00029,1,564327,575865,-,11538
453,BUMA.1121.00012,1,3098539,3110089,+,11550
453,BUMA.1121.00043,1,331072,342633,+,11561
453,BUMA.1121.00037,1,2981236,2992749,+,11513
453,BUMA.1121.00080,1,384451,396002,+,11551
453,BUMA.1121.00079,1,378099,389682,+,11583
453,BUMA.1121.00045,1,3753149,3764726,-,11577
453,BUMA.1121.00071,1,356030,367510,+,11480
453,BUMA.1121.00056,1,3559457,3571002,-,11545
453,BUMA.1121.00065,1,369027,380635,+,11608
453,BUMA.1121.00058,1,206834,218333,-,11499
453,BUMA.1121.00007,1,3774851,3786420,-,11569
453,BUMA.1121.00067,1,30050,41618,-,11568
453,BUMA.1121.00090,1,2442004,2453541,+,11537
453,BUMA.1121.00051,1,340204,351786,+,11582
453,BUMA.1121.00103,1,14753,26298,-,11545
453,BUMA.1121.00047,1,2629240,2640800,-,11560
453,BUMA.1121.00055,1,4014359,4025896,+,11537
453,BUMA.1121.00031,1,1681321,1692834,+,11513
453,BUMA.1121.00088,1,1229916,1241435,+,11519
453,BUMA.1121.00069,1,329126,340632,+,11506
453,BUMA.1121.00064,1,380983,392490,+,11507
453,BUMA.1121.00105,1,867983,879520,-,11537
453,BUMA.1121.00059,1,3588835,3600326,+,11491
453,BUMA.1121.00101,1,2124840,2136386,-,11546
453,BUMA.1121.00001,1,3778621,3790167,-,11546
453,BUMA.1121.00068,1,3205731,3217237,+,11506
453,BUMA.1121.00099,1,2067949,2079519,-,11570
453,BUMA.1121.00091,1,165864,177403,-,11539
453,BUMA.1121.00098,1,3061517,3073067,+,11550
453,BUMA.1121.00049,1,1506070,1517615,-,11545
453,BUMA.1121.00072,1,339715,351221,+,11506
453,BUMA.1121.00076,1,1016690,1028204,-,11514
453,BUMA.1121.00083,1,1318872,1330379,-,11507
453,BUMA.1121.00078,1,1645625,1657100,-,11475
453,BUMA.1121.00095,1,1328699,1340252,-,11553
453,BUMA.1121.00077,1,3032967,3044493,+,11526
453,BUMA.1121.00063,1,364778,376256,+,11478
453,BUMA.1121.00061,1,367705,379211,+,11506
453,BUMA.1121.00074,1,3533710,3545294,-,11584
453,BUMA.1121.00062,1,231637,243184,-,11547
453,BUMA.1121.00060,1,1978816,1990393,-,11577
453,BUMA.1121.00070,1,339491,350970,+,11479
453,BUMA.1121.00075,1,3783961,3795474,+,11513
453,BUMA.1121.00041,1,1603627,1615139,+,11512
453,BUMA.1121.00073,1,365809,377290,+,11481
453,BUMA.1121.00066,1,336599,348078,+,11479
453,BUMA.1121.00107,1,182333,193886,+,11553
453,BUMA.1121.00112,1,2735910,2747439,-,11529
453,BUMA.1121.00082,1,374457,385963,+,11506
453,BUMA.1121.00014,1,2546656,2558170,-,11514
453,BUMA.1121.00011,1,1278043,1290774,-,12731
453,BUMA.1121.00057,1,1434268,1445798,+,11530
453,BUMA.1121.00018,1,841677,853235,+,11558
453,BUMA.1121.00039,1,450831,462368,+,11537
453,BUMA.1121.00016,1,2441638,2453215,+,11577
453,BUMA.1121.00005,1,3222835,3234362,-,11527
453,BUMA.1121.00100,1,960640,972172,-,11532
454,BUMA.1121.00027,1,2546439,2560219,+,13780
454,BUMA.1121.00025,1,2392555,2406332,-,13777
454,BUMA.1121.00021,1,986918,1000685,+,13767
454,BUMA.1121.00023,1,2681475,2695259,+,13784
454,BUMA.1121.00024,1,1140246,1154028,-,13782
454,BUMA.1121.00033,1,2608351,2622126,+,13775
454,BUMA.1121.00034,1,1177634,1191416,-,13782
454,BUMA.1121.00036,1,219249,233030,-,13781
454,BUMA.1121.00032,1,2670616,2684398,-,13782
454,BUMA.1121.00009,1,1213705,1227467,-,13762
454,BUMA.1121.00008,1,1143961,1157743,-,13782
454,BUMA.1121.00003,1,2845741,2859497,+,13756
454,BUMA.1121.00109,1,1508909,1522724,-,13815
454,BUMA.1121.00053,1,69239,83021,+,13782
454,BUMA.1121.00110,1,424844,438642,-,13798
454,BUMA.1121.00104,1,916849,930671,-,13822
454,BUMA.1121.00086,1,2232638,2246418,+,13780
454,BUMA.1121.00092,1,3500613,3514380,-,13767
454,BUMA.1121.00096,1,2897258,2911027,-,13769
454,BUMA.1121.00054,1,509516,523285,+,13769
454,BUMA.1121.00097,1,3663870,3677648,-,13778
454,BUMA.1121.00093,1,1112056,1125822,+,13766
454,BUMA.1121.00106,1,132283,146072,+,13789
454,BUMA.1121.00010,1,628317,642098,+,13781
454,BUMA.1121.00035,1,1406690,1420475,+,13785
454,BUMA.1121.00108,1,1334581,1348359,+,13778
454,BUMA.1121.00028,1,1140290,1154072,-,13782
454,BUMA.1121.00094,1,350441,364240,+,13799
454,BUMA.1121.00102,1,910438,924269,-,13831
454,BUMA.1121.00111,1,488250,502024,+,13774
454,BUMA.1121.00089,1,366246,380046,+,13800
454,BUMA.1121.00084,1,577653,591438,+,13785
454,BUMA.1121.00029,1,550264,564048,-,13784
454,BUMA.1121.00012,1,3110369,3124146,+,13777
454,BUMA.1121.00087,1,1070670,1084451,-,13781
454,BUMA.1121.00043,1,342913,356689,+,13776
454,BUMA.1121.00046,1,1557003,1570780,-,13777
454,BUMA.1121.00037,1,2993029,3006806,+,13777
454,BUMA.1121.00080,1,396282,410071,+,13789
454,BUMA.1121.00079,1,389962,403751,+,13789
454,BUMA.1121.00045,1,3739147,3752870,-,13723
454,BUMA.1121.00071,1,367790,381557,+,13767
454,BUMA.1121.00056,1,3545377,3559178,-,13801
454,BUMA.1121.00065,1,380915,394724,+,13809
454,BUMA.1121.00058,1,192748,206555,-,13807
454,BUMA.1121.00007,1,3760785,3774572,-,13787
454,BUMA.1121.00067,1,15979,29771,-,13792
454,BUMA.1121.00090,1,2453821,2467597,+,13776
454,BUMA.1121.00051,1,352066,365855,+,13789
454,BUMA.1121.00020,1,1205179,1218961,-,13782
454,BUMA.1121.00103,1,691,14474,-,13783
454,BUMA.1121.00048,1,3412502,3426272,-,13770
454,BUMA.1121.00047,1,2615160,2628961,-,13801
454,BUMA.1121.00042,1,3167685,3181467,-,13782
454,BUMA.1121.00055,1,4026176,4040014,+,13838
454,BUMA.1121.00031,1,1693114,1706899,+,13785
454,BUMA.1121.00040,1,467621,481394,+,13773
454,BUMA.1121.00044,1,405732,419514,-,13782
454,BUMA.1121.00088,1,1241715,1255482,+,13767
454,BUMA.1121.00069,1,340912,354679,+,13767
454,BUMA.1121.00064,1,392770,406536,+,13766
454,BUMA.1121.00105,1,853937,867704,-,13767
454,BUMA.1121.00015,1,3307056,3320833,-,13777
454,BUMA.1121.00059,1,3600606,3614389,+,13783
454,BUMA.1121.00026,1,979528,993309,+,13781
454,BUMA.1121.00022,1,935337,949118,-,13781
454,BUMA.1121.00052,1,3447209,3460985,+,13776
454,BUMA.1121.00101,1,2110713,2124561,-,13848
454,BUMA.1121.00001,1,3764556,3778342,-,13786
454,BUMA.1121.00038,1,109788,123558,-,13770
454,BUMA.1121.00068,1,3217517,3231347,+,13830
454,BUMA.1121.00099,1,2053928,2067670,-,13742
454,BUMA.1121.00091,1,151762,165585,-,13823
454,BUMA.1121.00098,1,3073347,3087081,+,13734
454,BUMA.1121.00013,1,991548,1005325,-,13777
454,BUMA.1121.00049,1,1491994,1505791,-,13797
454,BUMA.1121.00072,1,351501,365268,+,13767
454,BUMA.1121.00076,1,1002584,1016411,-,13827
454,BUMA.1121.00083,1,1304825,1318593,-,13768
454,BUMA.1121.00078,1,1631567,1645346,-,13779
454,BUMA.1121.00095,1,1314620,1328420,-,13800
454,BUMA.1121.00077,1,3044773,3058569,+,13796
454,BUMA.1121.00063,1,376536,390303,+,13767
454,BUMA.1121.00061,1,379491,393257,+,13766
454,BUMA.1121.00050,1,1180964,1194740,+,13776
454,BUMA.1121.00081,1,109857,123627,-,13770
454,BUMA.1121.00074,1,3519664,3533431,-,13767
454,BUMA.1121.00062,1,217567,231358,-,13791
454,BUMA.1121.00060,1,1964814,1978537,-,13723
454,BUMA.1121.00070,1,351250,365017,+,13767
454,BUMA.1121.00075,1,3795754,3809575,+,13821
454,BUMA.1121.00041,1,1615419,1629200,+,13781
454,BUMA.1121.00073,1,377570,391337,+,13767
454,BUMA.1121.00017,1,1075271,1089053,-,13782
454,BUMA.1121.00066,1,348358,362116,+,13758
454,BUMA.1121.00107,1,194166,207985,+,13819
454,BUMA.1121.00085,1,3044154,3057930,+,13776
454,BUMA.1121.00030,1,1075312,1089094,-,13782
454,BUMA.1121.00112,1,2721822,2735631,-,13809
454,BUMA.1121.00002,1,653646,667427,+,13781
454,BUMA.1121.00082,1,386243,400010,+,13767
454,BUMA.1121.00014,1,2532591,2546377,-,13786
454,BUMA.1121.00011,1,1263997,1277764,-,13767
454,BUMA.1121.00019,1,1140302,1154084,-,13782
454,BUMA.1121.00057,1,1446078,1459844,+,13766
454,BUMA.1121.00018,1,853515,867291,+,13776
454,BUMA.1121.00039,1,462648,476424,+,13776
454,BUMA.1121.00016,1,2453495,2467271,+,13776
454,BUMA.1121.00004,1,1141462,1155244,-,13782
454,BUMA.1121.00005,1,3208745,3222556,-,13811
454,BUMA.1121.00100,1,946626,960361,-,13735
454,BUMA.1121.00006,1,109788,123558,-,13770
455,BUMA.1121.00027,1,2560853,2576181,+,15328
455,BUMA.1121.00025,1,2376599,2391922,-,15323
455,BUMA.1121.00021,1,1001319,1016655,+,15336
455,BUMA.1121.00023,1,2695893,2711238,+,15345
455,BUMA.1121.00024,1,1124702,1139607,-,14905
455,BUMA.1121.00033,1,2622760,2638077,+,15317
455,BUMA.1121.00034,1,1162090,1176995,-,14905
455,BUMA.1121.00036,1,203705,218610,-,14905
455,BUMA.1121.00032,1,2655072,2669977,-,14905
455,BUMA.1121.00009,1,1197726,1213072,-,15346
455,BUMA.1121.00008,1,1128417,1143322,-,14905
455,BUMA.1121.00003,1,2860131,2875490,+,15359
455,BUMA.1121.00109,1,1492952,1508276,-,15324
455,BUMA.1121.00053,1,83655,98975,+,15320
455,BUMA.1121.00110,1,408793,424211,-,15418
455,BUMA.1121.00104,1,900829,916216,-,15387
455,BUMA.1121.00086,1,2247058,2261954,+,14896
455,BUMA.1121.00092,1,3484577,3499980,-,15403
455,BUMA.1121.00096,1,2881271,2896625,-,15354
455,BUMA.1121.00054,1,523925,538830,+,14905
455,BUMA.1121.00097,1,3647878,3663237,-,15359
455,BUMA.1121.00093,1,1126456,1141858,+,15402
455,BUMA.1121.00106,1,146706,162084,+,15378
455,BUMA.1121.00010,1,642738,657643,+,14905
455,BUMA.1121.00035,1,1421109,1436445,+,15336
455,BUMA.1121.00108,1,1348993,1364302,+,15309
455,BUMA.1121.00028,1,1124746,1139651,-,14905
455,BUMA.1121.00094,1,364874,380212,+,15338
455,BUMA.1121.00102,1,894445,909805,-,15360
455,BUMA.1121.00111,1,502658,517994,+,15336
455,BUMA.1121.00089,1,380680,396018,+,15338
455,BUMA.1121.00084,1,592072,607454,+,15382
455,BUMA.1121.00029,1,534294,549631,-,15337
455,BUMA.1121.00012,1,3124780,3140091,+,15311
455,BUMA.1121.00087,1,1055135,1070031,-,14896
455,BUMA.1121.00043,1,357323,372611,+,15288
455,BUMA.1121.00046,1,1541459,1556364,-,14905
455,BUMA.1121.00037,1,3007440,3022777,+,15337
455,BUMA.1121.00080,1,410705,425576,+,14871
455,BUMA.1121.00079,1,404385,419723,+,15338
455,BUMA.1121.00045,1,3723193,3738514,-,15321
455,BUMA.1121.00071,1,382191,397513,+,15322
455,BUMA.1121.00056,1,3529405,3544744,-,15339
455,BUMA.1121.00065,1,395358,410690,+,15332
455,BUMA.1121.00058,1,176752,192130,-,15378
455,BUMA.1121.00007,1,3744798,3760152,-,15354
455,BUMA.1121.00067,1,3,15346,-,15343
455,BUMA.1121.00090,1,2468231,2483567,+,15336
455,BUMA.1121.00051,1,366489,381827,+,15338
455,BUMA.1121.00020,1,1189635,1204540,-,14905
455,BUMA.1121.00103,1,4044664,4059501,-,14837
455,BUMA.1121.00048,1,3396958,3411863,-,14905
455,BUMA.1121.00047,1,2599188,2614527,-,15339
455,BUMA.1121.00042,1,3152133,3167046,-,14913
455,BUMA.1121.00055,1,4040648,4055994,+,15346
455,BUMA.1121.00031,1,1707533,1722829,+,15296
455,BUMA.1121.00040,1,482034,496939,+,14905
455,BUMA.1121.00044,1,390188,405093,-,14905
455,BUMA.1121.00088,1,1256116,1271501,+,15385
455,BUMA.1121.00069,1,355313,370640,+,15327
455,BUMA.1121.00064,1,407170,422580,+,15410
455,BUMA.1121.00105,1,837925,853304,-,15379
455,BUMA.1121.00015,1,3291512,3306417,-,14905
455,BUMA.1121.00059,1,3615023,3630392,+,15369
455,BUMA.1121.00026,1,993949,1008862,+,14913
455,BUMA.1121.00022,1,919793,934698,-,14905
455,BUMA.1121.00052,1,3461623,3476528,+,14905
455,BUMA.1121.00101,1,2094743,2110080,-,15337
455,BUMA.1121.00001,1,3748578,3763923,-,15345
455,BUMA.1121.00038,1,94244,109149,-,14905
455,BUMA.1121.00068,1,3231981,3247325,+,15344
455,BUMA.1121.00099,1,2037928,2053295,-,15367
455,BUMA.1121.00091,1,135774,151129,-,15355
455,BUMA.1121.00098,1,3087715,3103048,+,15333
455,BUMA.1121.00013,1,976006,990911,-,14905
455,BUMA.1121.00049,1,1475982,1491361,-,15379
455,BUMA.1121.00072,1,365902,381230,+,15328
455,BUMA.1121.00076,1,986618,1001951,-,15333
455,BUMA.1121.00083,1,1288861,1304192,-,15331
455,BUMA.1121.00078,1,1615574,1630934,-,15360
455,BUMA.1121.00095,1,1298634,1313987,-,15353
455,BUMA.1121.00077,1,3059203,3074619,+,15416
455,BUMA.1121.00063,1,390937,406267,+,15330
455,BUMA.1121.00061,1,393891,409221,+,15330
455,BUMA.1121.00050,1,1195380,1210285,+,14905
455,BUMA.1121.00081,1,94313,109218,-,14905
455,BUMA.1121.00074,1,3504143,3519031,-,14888
455,BUMA.1121.00062,1,201572,216934,-,15362
455,BUMA.1121.00060,1,1948860,1964181,-,15321
455,BUMA.1121.00070,1,365651,380972,+,15321
455,BUMA.1121.00075,1,3810209,3825605,+,15396
455,BUMA.1121.00041,1,1629834,1645193,+,15359
455,BUMA.1121.00073,1,391971,407300,+,15329
455,BUMA.1121.00017,1,1059727,1074632,-,14905
455,BUMA.1121.00066,1,362750,378073,+,15323
455,BUMA.1121.00107,1,208619,223940,+,15321
455,BUMA.1121.00085,1,3058568,3073473,+,14905
455,BUMA.1121.00030,1,1059768,1074673,-,14905
455,BUMA.1121.00112,1,2705879,2721189,-,15310
455,BUMA.1121.00002,1,668067,682972,+,14905
455,BUMA.1121.00082,1,400644,415974,+,15330
455,BUMA.1121.00014,1,2516621,2531958,-,15337
455,BUMA.1121.00011,1,1248018,1263364,-,15346
455,BUMA.1121.00019,1,1124758,1139663,-,14905
455,BUMA.1121.00057,1,1460478,1475807,+,15329
455,BUMA.1121.00018,1,867925,883247,+,15322
455,BUMA.1121.00039,1,477058,492394,+,15336
455,BUMA.1121.00016,1,2467905,2483233,+,15328
455,BUMA.1121.00004,1,1125918,1140823,-,14905
455,BUMA.1121.00005,1,3192743,3208112,-,15369
455,BUMA.1121.00100,1,930636,945993,-,15357
455,BUMA.1121.00006,1,94244,109149,-,14905
456,BUMA.1121.00027,1,2576765,2590087,+,13322
456,BUMA.1121.00025,1,2362776,2376016,-,13240
456,BUMA.1121.00021,1,1017239,1030469,+,13230
456,BUMA.1121.00023,1,2711822,2725057,+,13235
456,BUMA.1121.00024,1,801257,814504,+,13247
456,BUMA.1121.00033,1,2638661,2651872,+,13211
456,BUMA.1121.00034,1,838687,851934,+,13247
456,BUMA.1121.00036,1,3010365,3023617,+,13252
456,BUMA.1121.00032,1,2331772,2345019,+,13247
456,BUMA.1121.00009,1,1183895,1197143,-,13248
456,BUMA.1121.00008,1,805002,818249,+,13247
456,BUMA.1121.00003,1,2876074,2889315,+,13241
456,BUMA.1121.00109,1,1479137,1492369,-,13232
456,BUMA.1121.00053,1,99559,112876,+,13317
456,BUMA.1121.00110,1,394932,408210,-,13278
456,BUMA.1121.00104,1,886975,900246,-,13271
456,BUMA.1121.00086,1,3169567,3182824,-,13257
456,BUMA.1121.00092,1,3470679,3483994,-,13315
456,BUMA.1121.00096,1,2867403,2880688,-,13285
456,BUMA.1121.00054,1,540990,554236,+,13246
456,BUMA.1121.00097,1,3634078,3647295,-,13217
456,BUMA.1121.00093,1,1142442,1155757,+,13315
456,BUMA.1121.00106,1,162668,175934,+,13266
456,BUMA.1121.00010,1,802579,815824,+,13245
456,BUMA.1121.00035,1,1437029,1450234,+,13205
456,BUMA.1121.00108,1,1364886,1378136,+,13250
456,BUMA.1121.00028,1,801256,814503,+,13247
456,BUMA.1121.00094,1,380796,394114,+,13318
456,BUMA.1121.00102,1,880555,893862,-,13307
456,BUMA.1121.00111,1,518578,531812,+,13234
456,BUMA.1121.00089,1,396602,409896,+,13294
456,BUMA.1121.00084,1,608022,621308,+,13286
456,BUMA.1121.00029,1,520507,533712,-,13205
456,BUMA.1121.00012,1,3140675,3153930,+,13255
456,BUMA.1121.00087,1,153161,166418,+,13257
456,BUMA.1121.00043,1,374787,388022,+,13235
456,BUMA.1121.00046,1,1526038,1539299,-,13261
456,BUMA.1121.00037,1,3023361,3036686,+,13325
456,BUMA.1121.00080,1,426160,439478,+,13318
456,BUMA.1121.00079,1,420307,433593,+,13286
456,BUMA.1121.00045,1,3709243,3722610,-,13367
456,BUMA.1121.00071,1,398097,411432,+,13335
456,BUMA.1121.00056,1,3515528,3528822,-,13294
456,BUMA.1121.00065,1,411274,424631,+,13357
456,BUMA.1121.00058,1,162926,176169,-,13243
456,BUMA.1121.00007,1,3730955,3744215,-,13260
456,BUMA.1121.00067,1,4014223,4027467,-,13244
456,BUMA.1121.00090,1,2484151,2497406,+,13255
456,BUMA.1121.00051,1,382411,395695,+,13284
456,BUMA.1121.00020,1,866200,879447,+,13247
456,BUMA.1121.00103,1,4030810,4044096,-,13286
456,BUMA.1121.00048,1,3381552,3394798,-,13246
456,BUMA.1121.00047,1,2585246,2598605,-,13359
456,BUMA.1121.00042,1,3220263,3233504,+,13241
456,BUMA.1121.00055,1,4056578,4069843,+,13265
456,BUMA.1121.00031,1,1723413,1736698,+,13285
456,BUMA.1121.00040,1,499102,512353,+,13251
456,BUMA.1121.00044,1,66794,80041,+,13247
456,BUMA.1121.00088,1,1272069,1285348,+,13279
456,BUMA.1121.00069,1,371224,384505,+,13281
456,BUMA.1121.00064,1,423164,436464,+,13300
456,BUMA.1121.00105,1,824020,837342,-,13322
456,BUMA.1121.00015,1,462839,476084,-,13245
456,BUMA.1121.00059,1,3630976,3644269,+,13293
456,BUMA.1121.00026,1,1011022,1024263,+,13241
456,BUMA.1121.00022,1,390662,403914,+,13252
456,BUMA.1121.00052,1,644802,658048,-,13246
456,BUMA.1121.00101,1,2080892,2094175,-,13283
456,BUMA.1121.00001,1,3734790,3747995,-,13205
456,BUMA.1121.00038,1,78838,92084,-,13246
456,BUMA.1121.00068,1,3247880,3261183,+,13303
456,BUMA.1121.00099,1,2024121,2037345,-,13224
456,BUMA.1121.00091,1,121922,135191,-,13269
456,BUMA.1121.00098,1,3103632,3116892,+,13260
456,BUMA.1121.00013,1,328235,341481,+,13246
456,BUMA.1121.00049,1,1462088,1475399,-,13311
456,BUMA.1121.00072,1,381814,395102,+,13288
456,BUMA.1121.00076,1,971180,984443,-,13263
456,BUMA.1121.00083,1,1274943,1288278,-,13335
456,BUMA.1121.00078,1,1601721,1614991,-,13270
456,BUMA.1121.00095,1,1284787,1298066,-,13279
456,BUMA.1121.00077,1,3075203,3088481,+,13278
456,BUMA.1121.00063,1,406851,420153,+,13302
456,BUMA.1121.00061,1,409805,423140,+,13335
456,BUMA.1121.00050,1,1212445,1225701,+,13256
456,BUMA.1121.00081,1,78907,92153,-,13246
456,BUMA.1121.00074,1,3490293,3503560,-,13267
456,BUMA.1121.00062,1,187697,200989,-,13292
456,BUMA.1121.00060,1,1934905,1948277,-,13372
456,BUMA.1121.00070,1,381556,394890,+,13334
456,BUMA.1121.00075,1,3827781,3841033,+,13252
456,BUMA.1121.00041,1,1645777,1659089,+,13312
456,BUMA.1121.00073,1,407884,421219,+,13335
456,BUMA.1121.00017,1,736306,749553,+,13247
456,BUMA.1121.00066,1,378657,391992,+,13335
456,BUMA.1121.00107,1,224508,237783,+,13275
456,BUMA.1121.00085,1,241630,254876,-,13246
456,BUMA.1121.00030,1,736366,749613,+,13247
456,BUMA.1121.00112,1,2692002,2705296,-,13294
456,BUMA.1121.00002,1,827972,841218,+,13246
456,BUMA.1121.00082,1,416558,429893,+,13335
456,BUMA.1121.00014,1,2502728,2516038,-,13310
456,BUMA.1121.00011,1,1234203,1247435,-,13232
456,BUMA.1121.00019,1,801300,814547,+,13247
456,BUMA.1121.00057,1,1476391,1489726,+,13335
456,BUMA.1121.00018,1,883831,897071,+,13240
456,BUMA.1121.00039,1,492978,506278,+,13300
456,BUMA.1121.00016,1,2483817,2497058,+,13241
456,BUMA.1121.00004,1,801215,814462,+,13247
456,BUMA.1121.00005,1,3178878,3192175,-,13297
456,BUMA.1121.00100,1,916811,930053,-,13242
456,BUMA.1121.00006,1,78838,92084,-,13246
457,BUMA.1121.00027,1,2590907,2608721,+,17814
457,BUMA.1121.00025,1,2344145,2361944,-,17799
457,BUMA.1121.00021,1,1031289,1049066,+,17777
457,BUMA.1121.00023,1,2747888,2765699,+,17811
457,BUMA.1121.00024,1,815336,833000,+,17664
457,BUMA.1121.00033,1,2652704,2670442,+,17738
457,BUMA.1121.00034,1,852766,870430,+,17664
457,BUMA.1121.00036,1,3024449,3042113,+,17664
457,BUMA.1121.00032,1,2345851,2363515,+,17664
457,BUMA.1121.00009,1,1165233,1183064,-,17831
457,BUMA.1121.00008,1,819081,836745,+,17664
457,BUMA.1121.00003,1,2890147,2908002,+,17855
457,BUMA.1121.00109,1,1460524,1478304,-,17780
457,BUMA.1121.00053,1,113696,131496,+,17800
457,BUMA.1121.00110,1,376330,394100,-,17770
457,BUMA.1121.00104,1,868378,886155,-,17777
457,BUMA.1121.00086,1,3151102,3168735,-,17633
457,BUMA.1121.00092,1,3452101,3469847,-,17746
457,BUMA.1121.00096,1,2848864,2866583,-,17719
457,BUMA.1121.00054,1,555068,572849,+,17781
457,BUMA.1121.00097,1,3615436,3633252,-,17816
457,BUMA.1121.00093,1,1156589,1174336,+,17747
457,BUMA.1121.00106,1,176754,194531,+,17777
457,BUMA.1121.00010,1,816656,834420,+,17764
457,BUMA.1121.00035,1,1471675,1489455,+,17780
457,BUMA.1121.00108,1,1378956,1396732,+,17776
457,BUMA.1121.00028,1,815335,832999,+,17664
457,BUMA.1121.00094,1,394934,412683,+,17749
457,BUMA.1121.00102,1,861995,879753,-,17758
457,BUMA.1121.00111,1,532632,550408,+,17776
457,BUMA.1121.00089,1,410716,428477,+,17761
457,BUMA.1121.00084,1,622134,639874,+,17740
457,BUMA.1121.00029,1,481264,499066,-,17802
457,BUMA.1121.00012,1,3175750,3193492,+,17742
457,BUMA.1121.00087,1,167250,184883,+,17633
457,BUMA.1121.00043,1,388842,406620,+,17778
457,BUMA.1121.00046,1,1507444,1525206,-,17762
457,BUMA.1121.00037,1,3037506,3055258,+,17752
457,BUMA.1121.00080,1,440298,458045,+,17747
457,BUMA.1121.00079,1,434413,452160,+,17747
457,BUMA.1121.00045,1,3690667,3708423,-,17756
457,BUMA.1121.00071,1,412252,430006,+,17754
457,BUMA.1121.00056,1,3496947,3514708,-,17761
457,BUMA.1121.00065,1,425451,443180,+,17729
457,BUMA.1121.00058,1,144352,162100,-,17748
457,BUMA.1121.00007,1,3712316,3730123,-,17807
457,BUMA.1121.00067,1,3995639,4013403,-,17764
457,BUMA.1121.00090,1,2498226,2516026,+,17800
457,BUMA.1121.00051,1,396515,414264,+,17749
457,BUMA.1121.00020,1,880279,897943,+,17664
457,BUMA.1121.00103,1,4012255,4029978,-,17723
457,BUMA.1121.00048,1,3362939,3380720,-,17781
457,BUMA.1121.00047,1,2566665,2584426,-,17761
457,BUMA.1121.00042,1,3234336,3252138,+,17802
457,BUMA.1121.00055,1,4070675,4088396,+,17721
457,BUMA.1121.00031,1,1737530,1755282,+,17752
457,BUMA.1121.00040,1,513185,530953,+,17768
457,BUMA.1121.00044,1,80873,98537,+,17664
457,BUMA.1121.00088,1,1286168,1303953,+,17785
457,BUMA.1121.00069,1,385325,403079,+,17754
457,BUMA.1121.00064,1,437296,455042,+,17746
457,BUMA.1121.00105,1,805473,823194,-,17721
457,BUMA.1121.00015,1,444257,462007,-,17750
457,BUMA.1121.00059,1,3645089,3662824,+,17735
457,BUMA.1121.00026,1,1025095,1042992,+,17897
457,BUMA.1121.00022,1,404746,422390,+,17644
457,BUMA.1121.00052,1,626213,643970,-,17757
457,BUMA.1121.00101,1,2062300,2080059,-,17759
457,BUMA.1121.00001,1,3695572,3713350,-,17778
457,BUMA.1121.00038,1,60225,78006,-,17781
457,BUMA.1121.00068,1,3262015,3279783,+,17768
457,BUMA.1121.00099,1,2005459,2023288,-,17829
457,BUMA.1121.00091,1,103319,121102,-,17783
457,BUMA.1121.00098,1,3117694,3135457,+,17763
457,BUMA.1121.00013,1,342313,360070,+,17757
457,BUMA.1121.00049,1,1443440,1461268,-,17828
457,BUMA.1121.00072,1,395922,413676,+,17754
457,BUMA.1121.00076,1,952570,970360,-,17790
457,BUMA.1121.00083,1,1256369,1274123,-,17754
457,BUMA.1121.00078,1,1583107,1600889,-,17782
457,BUMA.1121.00095,1,1266218,1283961,-,17743
457,BUMA.1121.00077,1,3089313,3107084,+,17771
457,BUMA.1121.00063,1,420968,438722,+,17754
457,BUMA.1121.00061,1,423960,441714,+,17754
457,BUMA.1121.00050,1,1226533,1244295,+,17762
457,BUMA.1121.00081,1,60294,78075,-,17781
457,BUMA.1121.00074,1,3471738,3489473,-,17735
457,BUMA.1121.00062,1,169149,186877,-,17728
457,BUMA.1121.00060,1,1916329,1934085,-,17756
457,BUMA.1121.00070,1,395710,413464,+,17754
457,BUMA.1121.00075,1,3841853,3859640,+,17787
457,BUMA.1121.00041,1,1659909,1677638,+,17729
457,BUMA.1121.00073,1,422039,439793,+,17754
457,BUMA.1121.00017,1,750385,768049,+,17664
457,BUMA.1121.00066,1,392812,410566,+,17754
457,BUMA.1121.00107,1,238615,256414,+,17799
457,BUMA.1121.00085,1,223041,240798,-,17757
457,BUMA.1121.00030,1,750445,768109,+,17664
457,BUMA.1121.00112,1,2673452,2691170,-,17718
457,BUMA.1121.00002,1,842050,859814,+,17764
457,BUMA.1121.00082,1,430713,448467,+,17754
457,BUMA.1121.00014,1,2462082,2479885,-,17803
457,BUMA.1121.00011,1,1215598,1233371,-,17773
457,BUMA.1121.00019,1,815379,833043,+,17664
457,BUMA.1121.00057,1,1490546,1508353,+,17807
457,BUMA.1121.00018,1,897903,915701,+,17798
457,BUMA.1121.00039,1,507098,524898,+,17800
457,BUMA.1121.00016,1,2497890,2515620,+,17730
457,BUMA.1121.00004,1,815294,832958,+,17664
457,BUMA.1121.00005,1,3160332,3178046,-,17714
457,BUMA.1121.00100,1,898249,915979,-,17730
457,BUMA.1121.00006,1,60225,78006,-,17781
458,BUMA.1121.00027,1,2608732,2612358,+,3626
458,BUMA.1121.00025,1,2340509,2344134,-,3625
458,BUMA.1121.00021,1,1049077,1052718,+,3641
458,BUMA.1121.00023,1,2765710,2769392,+,3682
458,BUMA.1121.00024,1,834604,838150,+,3546
458,BUMA.1121.00033,1,2670453,2674032,+,3579
458,BUMA.1121.00034,1,872034,875580,+,3546
458,BUMA.1121.00036,1,3043721,3047275,+,3554
458,BUMA.1121.00032,1,2365119,2368665,+,3546
458,BUMA.1121.00009,1,1161609,1165222,-,3613
458,BUMA.1121.00008,1,838349,841895,+,3546
458,BUMA.1121.00003,1,2908013,2911576,+,3563
458,BUMA.1121.00109,1,1456923,1460513,-,3590
458,BUMA.1121.00053,1,131507,135163,+,3656
458,BUMA.1121.00110,1,372681,376319,-,3638
458,BUMA.1121.00104,1,864763,868367,-,3604
458,BUMA.1121.00086,1,2758100,2761646,+,3546
458,BUMA.1121.00092,1,3448512,3452090,-,3578
458,BUMA.1121.00096,1,2845217,2848853,-,3636
458,BUMA.1121.00054,1,796542,800104,+,3562
458,BUMA.1121.00097,1,3611781,3615425,-,3644
458,BUMA.1121.00093,1,1174347,1177924,+,3577
458,BUMA.1121.00106,1,194542,198201,+,3659
458,BUMA.1121.00010,1,836021,839567,+,3546
458,BUMA.1121.00035,1,1489466,1493090,+,3624
458,BUMA.1121.00108,1,1396743,1400293,+,3550
458,BUMA.1121.00028,1,834603,838149,+,3546
458,BUMA.1121.00094,1,412694,416330,+,3636
458,BUMA.1121.00102,1,858311,861984,-,3673
458,BUMA.1121.00111,1,550419,554051,+,3632
458,BUMA.1121.00089,1,428488,432124,+,3636
458,BUMA.1121.00084,1,639885,643475,+,3590
458,BUMA.1121.00029,1,477628,481253,-,3625
458,BUMA.1121.00012,1,3193503,3197103,+,3600
458,BUMA.1121.00087,1,574109,577656,-,3547
458,BUMA.1121.00043,1,408224,411809,+,3585
458,BUMA.1121.00046,1,1321640,1325195,-,3555
458,BUMA.1121.00037,1,3055269,3058885,+,3616
458,BUMA.1121.00080,1,458056,461691,+,3635
458,BUMA.1121.00079,1,452171,455798,+,3627
458,BUMA.1121.00045,1,3686956,3690656,-,3700
458,BUMA.1121.00071,1,430017,433613,+,3596
458,BUMA.1121.00056,1,3493299,3496936,-,3637
458,BUMA.1121.00065,1,443191,446851,+,3660
458,BUMA.1121.00058,1,140676,144341,-,3665
458,BUMA.1121.00007,1,3708675,3712305,-,3630
458,BUMA.1121.00067,1,3991999,3995628,-,3629
458,BUMA.1121.00090,1,2516037,2519677,+,3640
458,BUMA.1121.00051,1,414275,417919,+,3644
458,BUMA.1121.00020,1,899547,903093,+,3546
458,BUMA.1121.00103,1,4008630,4012244,-,3614
458,BUMA.1121.00048,1,3135681,3139244,-,3563
458,BUMA.1121.00047,1,2563017,2566654,-,3637
458,BUMA.1121.00042,1,3307132,3310695,-,3563
458,BUMA.1121.00055,1,4088407,4092011,+,3604
458,BUMA.1121.00031,1,1755293,1759021,+,3728
458,BUMA.1121.00040,1,532557,536111,+,3554
458,BUMA.1121.00044,1,100141,103687,+,3546
458,BUMA.1121.00088,1,1303964,1307619,+,3655
458,BUMA.1121.00069,1,403090,406701,+,3611
458,BUMA.1121.00064,1,455053,458621,+,3568
458,BUMA.1121.00105,1,801813,805462,-,3649
458,BUMA.1121.00015,1,208634,212189,-,3555
458,BUMA.1121.00059,1,3662835,3666476,+,3641
458,BUMA.1121.00022,1,689610,693165,-,3555
458,BUMA.1121.00052,1,621055,624610,-,3555
458,BUMA.1121.00101,1,2058736,2062289,-,3553
458,BUMA.1121.00001,1,3691936,3695561,-,3625
458,BUMA.1121.00038,1,3343000,3346563,-,3563
458,BUMA.1121.00068,1,3279794,3283436,+,3642
458,BUMA.1121.00099,1,2001810,2005448,-,3638
458,BUMA.1121.00091,1,98066,101715,-,3649
458,BUMA.1121.00098,1,3135468,3139024,+,3556
458,BUMA.1121.00013,1,361674,365220,+,3546
458,BUMA.1121.00049,1,1439779,1443429,-,3650
458,BUMA.1121.00072,1,413687,417298,+,3611
458,BUMA.1121.00076,1,948947,952559,-,3612
458,BUMA.1121.00083,1,1252746,1256358,-,3612
458,BUMA.1121.00078,1,1579480,1583096,-,3616
458,BUMA.1121.00095,1,1262625,1266207,-,3582
458,BUMA.1121.00077,1,3107095,3110732,+,3637
458,BUMA.1121.00063,1,438733,442331,+,3598
458,BUMA.1121.00061,1,441725,445335,+,3610
458,BUMA.1121.00050,1,1426535,1430089,+,3554
458,BUMA.1121.00081,1,3343185,3346748,-,3563
458,BUMA.1121.00074,1,3468137,3471727,-,3590
458,BUMA.1121.00062,1,165481,169138,-,3657
458,BUMA.1121.00060,1,1912618,1916318,-,3700
458,BUMA.1121.00070,1,413475,417080,+,3605
458,BUMA.1121.00075,1,3859651,3863260,+,3609
458,BUMA.1121.00041,1,1677649,1681309,+,3660
458,BUMA.1121.00073,1,439804,443412,+,3608
458,BUMA.1121.00017,1,769653,773199,+,3546
458,BUMA.1121.00066,1,410577,414179,+,3602
458,BUMA.1121.00107,1,256425,259987,+,3562
458,BUMA.1121.00085,1,217883,221438,-,3555
458,BUMA.1121.00030,1,769713,773259,+,3546
458,BUMA.1121.00112,1,2669883,2673441,-,3558
458,BUMA.1121.00002,1,862663,866209,+,3546
458,BUMA.1121.00082,1,448478,452089,+,3611
458,BUMA.1121.00014,1,2458454,2462071,-,3617
458,BUMA.1121.00011,1,1212006,1215587,-,3581
458,BUMA.1121.00019,1,834647,838193,+,3546
458,BUMA.1121.00057,1,1508364,1511975,+,3611
458,BUMA.1121.00018,1,915712,919336,+,3624
458,BUMA.1121.00039,1,524909,528581,+,3672
458,BUMA.1121.00016,1,2515631,2519256,+,3625
458,BUMA.1121.00004,1,834562,838108,+,3546
458,BUMA.1121.00005,1,3156704,3160321,-,3617
458,BUMA.1121.00100,1,894629,898238,-,3609
458,BUMA.1121.00006,1,3343077,3346640,-,3563
459,BUMA.1121.00027,1,2612730,2618705,+,5975
459,BUMA.1121.00025,1,2334186,2340162,-,5976
459,BUMA.1121.00021,1,1053050,1059026,+,5976
459,BUMA.1121.00023,1,2769777,2775753,+,5976
459,BUMA.1121.00024,1,838352,844328,+,5976
459,BUMA.1121.00033,1,2674315,2680291,+,5976
459,BUMA.1121.00034,1,875782,881758,+,5976
459,BUMA.1121.00036,1,3047469,3053445,+,5976
459,BUMA.1121.00032,1,2368867,2374843,+,5976
459,BUMA.1121.00009,1,1155358,1161334,-,5976
459,BUMA.1121.00008,1,842097,848073,+,5976
459,BUMA.1121.00003,1,2911964,2917940,+,5976
459,BUMA.1121.00109,1,1450672,1456648,-,5976
459,BUMA.1121.00053,1,135535,141511,+,5976
459,BUMA.1121.00110,1,366398,372374,-,5976
459,BUMA.1121.00104,1,858424,864400,-,5976
459,BUMA.1121.00086,1,2761840,2767816,+,5976
459,BUMA.1121.00092,1,3442189,3448165,-,5976
459,BUMA.1121.00096,1,2838902,2844878,-,5976
459,BUMA.1121.00054,1,800300,806276,+,5976
459,BUMA.1121.00097,1,3605586,3611562,-,5976
459,BUMA.1121.00093,1,1178261,1184237,+,5976
459,BUMA.1121.00106,1,198508,204484,+,5976
459,BUMA.1121.00010,1,839769,845745,+,5976
459,BUMA.1121.00035,1,1493470,1499446,+,5976
459,BUMA.1121.00108,1,1400514,1406490,+,5976
459,BUMA.1121.00028,1,838351,844327,+,5976
459,BUMA.1121.00094,1,416660,422636,+,5976
459,BUMA.1121.00102,1,851900,857876,-,5976
459,BUMA.1121.00111,1,554343,560319,+,5976
459,BUMA.1121.00089,1,432456,438432,+,5976
459,BUMA.1121.00084,1,643783,649759,+,5976
459,BUMA.1121.00029,1,471305,477281,-,5976
459,BUMA.1121.00012,1,3197387,3203363,+,5976
459,BUMA.1121.00087,1,567940,573916,-,5976
459,BUMA.1121.00043,1,412101,418077,+,5976
459,BUMA.1121.00046,1,1315470,1321446,-,5976
459,BUMA.1121.00037,1,3059321,3065297,+,5976
459,BUMA.1121.00080,1,462031,468007,+,5976
459,BUMA.1121.00079,1,456150,462126,+,5976
459,BUMA.1121.00045,1,3680665,3686641,-,5976
459,BUMA.1121.00071,1,433813,439789,+,5976
459,BUMA.1121.00056,1,3486992,3492968,-,5976
459,BUMA.1121.00065,1,447151,453127,+,5976
459,BUMA.1121.00058,1,134389,140365,-,5976
459,BUMA.1121.00007,1,3702342,3708318,-,5976
459,BUMA.1121.00067,1,3985684,3991660,-,5976
459,BUMA.1121.00090,1,2519953,2525929,+,5976
459,BUMA.1121.00051,1,418179,424155,+,5976
459,BUMA.1121.00020,1,903295,909271,+,5976
459,BUMA.1121.00103,1,4002333,4008309,-,5976
459,BUMA.1121.00048,1,3129510,3135486,-,5976
459,BUMA.1121.00047,1,2556750,2562726,-,5976
459,BUMA.1121.00042,1,3300883,3306859,-,5976
459,BUMA.1121.00055,1,4092396,4098323,+,5927
459,BUMA.1121.00031,1,1759345,1765321,+,5976
459,BUMA.1121.00040,1,536313,542289,+,5976
459,BUMA.1121.00044,1,103889,109865,+,5976
459,BUMA.1121.00088,1,1307911,1313887,+,5976
459,BUMA.1121.00069,1,406831,412807,+,5976
459,BUMA.1121.00064,1,458945,464921,+,5976
459,BUMA.1121.00105,1,794262,800238,-,5976
459,BUMA.1121.00015,1,202464,208440,-,5976
459,BUMA.1121.00059,1,3666832,3672808,+,5976
459,BUMA.1121.00022,1,683441,689417,-,5976
459,BUMA.1121.00052,1,614885,620861,-,5976
459,BUMA.1121.00101,1,2052444,2058421,-,5977
459,BUMA.1121.00001,1,3685629,3691605,-,5976
459,BUMA.1121.00038,1,3336829,3342805,-,5976
459,BUMA.1121.00068,1,3283808,3289784,+,5976
459,BUMA.1121.00099,1,1995546,2001522,-,5976
459,BUMA.1121.00091,1,91865,97841,-,5976
459,BUMA.1121.00098,1,3139308,3145284,+,5976
459,BUMA.1121.00013,1,365415,371391,+,5976
459,BUMA.1121.00049,1,1433472,1439448,-,5976
459,BUMA.1121.00072,1,417529,423505,+,5976
459,BUMA.1121.00076,1,942584,948560,-,5976
459,BUMA.1121.00083,1,1246455,1252431,-,5976
459,BUMA.1121.00078,1,1573151,1579127,-,5976
459,BUMA.1121.00095,1,1256306,1262282,-,5976
459,BUMA.1121.00077,1,3111040,3117016,+,5976
459,BUMA.1121.00063,1,442559,448535,+,5976
459,BUMA.1121.00061,1,445555,451531,+,5976
459,BUMA.1121.00050,1,1430284,1436260,+,5976
459,BUMA.1121.00081,1,3337014,3342990,-,5976
459,BUMA.1121.00074,1,3461726,3467702,-,5976
459,BUMA.1121.00062,1,159150,165126,-,5976
459,BUMA.1121.00060,1,1906327,1912303,-,5976
459,BUMA.1121.00070,1,417162,423106,+,5944
459,BUMA.1121.00075,1,3863647,3869623,+,5976
459,BUMA.1121.00041,1,1681785,1687761,+,5976
459,BUMA.1121.00073,1,443619,449595,+,5976
459,BUMA.1121.00017,1,773401,779377,+,5976
459,BUMA.1121.00066,1,414401,420377,+,5976
459,BUMA.1121.00107,1,260224,266200,+,5976
459,BUMA.1121.00085,1,211713,217689,-,5976
459,BUMA.1121.00030,1,773461,779437,+,5976
459,BUMA.1121.00112,1,2663687,2669663,-,5976
459,BUMA.1121.00002,1,866411,872387,+,5976
459,BUMA.1121.00082,1,452397,458373,+,5976
459,BUMA.1121.00014,1,2452187,2458163,-,5976
459,BUMA.1121.00011,1,1205755,1211731,-,5976
459,BUMA.1121.00019,1,838395,844371,+,5976
459,BUMA.1121.00057,1,1512339,1518315,+,5976
459,BUMA.1121.00018,1,919715,925691,+,5976
459,BUMA.1121.00039,1,528953,534929,+,5976
459,BUMA.1121.00016,1,2519556,2525532,+,5976
459,BUMA.1121.00004,1,838310,844286,+,5976
459,BUMA.1121.00005,1,3150559,3156535,-,5976
459,BUMA.1121.00100,1,888266,894242,-,5976
459,BUMA.1121.00006,1,3336906,3342882,-,5976
460,BUMA.1121.00027,1,2618706,2632024,+,13318
460,BUMA.1121.00025,1,2321047,2334184,-,13137
460,BUMA.1121.00021,1,1059027,1072197,+,13170
460,BUMA.1121.00023,1,2775754,2788891,+,13137
460,BUMA.1121.00024,1,844329,857374,+,13045
460,BUMA.1121.00033,1,2680292,2693437,+,13145
460,BUMA.1121.00034,1,881759,894804,+,13045
460,BUMA.1121.00036,1,3053446,3066491,+,13045
460,BUMA.1121.00032,1,2374844,2387889,+,13045
460,BUMA.1121.00009,1,1142156,1155356,-,13200
460,BUMA.1121.00008,1,848074,861119,+,13045
460,BUMA.1121.00003,1,2917941,2931200,+,13259
460,BUMA.1121.00109,1,1437427,1450670,-,13243
460,BUMA.1121.00053,1,141512,154693,+,13181
460,BUMA.1121.00110,1,353103,366396,-,13293
460,BUMA.1121.00104,1,845213,858422,-,13209
460,BUMA.1121.00086,1,2767817,2780870,+,13053
460,BUMA.1121.00092,1,3428928,3442187,-,13259
460,BUMA.1121.00096,1,2825685,2838900,-,13215
460,BUMA.1121.00054,1,806277,819314,+,13037
460,BUMA.1121.00097,1,3592454,3605584,-,13130
460,BUMA.1121.00093,1,1184238,1197497,+,13259
460,BUMA.1121.00106,1,204485,217696,+,13211
460,BUMA.1121.00010,1,845746,858807,+,13061
460,BUMA.1121.00035,1,1499447,1512584,+,13137
460,BUMA.1121.00108,1,1406491,1419667,+,13176
460,BUMA.1121.00028,1,844328,857373,+,13045
460,BUMA.1121.00094,1,422637,435936,+,13299
460,BUMA.1121.00102,1,838706,851898,-,13192
460,BUMA.1121.00111,1,560320,573457,+,13137
460,BUMA.1121.00089,1,438433,451714,+,13281
460,BUMA.1121.00084,1,649760,663053,+,13293
460,BUMA.1121.00029,1,458166,471303,-,13137
460,BUMA.1121.00012,1,3203364,3216568,+,13204
460,BUMA.1121.00087,1,554885,567938,-,13053
460,BUMA.1121.00043,1,418078,431207,+,13129
460,BUMA.1121.00046,1,1302431,1315468,-,13037
460,BUMA.1121.00037,1,3065298,3078493,+,13195
460,BUMA.1121.00080,1,468008,481337,+,13329
460,BUMA.1121.00079,1,462127,475447,+,13320
460,BUMA.1121.00045,1,3667375,3680663,-,13288
460,BUMA.1121.00071,1,439790,453064,+,13274
460,BUMA.1121.00056,1,3473709,3486990,-,13281
460,BUMA.1121.00065,1,453128,466309,+,13181
460,BUMA.1121.00058,1,121068,134387,-,13319
460,BUMA.1121.00007,1,3689146,3702340,-,13194
460,BUMA.1121.00067,1,3972537,3985682,-,13145
460,BUMA.1121.00090,1,2525930,2539066,+,13136
460,BUMA.1121.00051,1,424156,437509,+,13353
460,BUMA.1121.00020,1,909272,922317,+,13045
460,BUMA.1121.00103,1,3989081,4002331,-,13250
460,BUMA.1121.00048,1,3116471,3129508,-,13037
460,BUMA.1121.00047,1,2543435,2556748,-,13313
460,BUMA.1121.00042,1,3287858,3300881,-,13023
460,BUMA.1121.00055,1,35,12590,+,12555
460,BUMA.1121.00031,1,1765322,1778504,+,13182
460,BUMA.1121.00040,1,542290,555326,+,13036
460,BUMA.1121.00044,1,109866,122911,+,13045
460,BUMA.1121.00088,1,1313888,1326934,+,13046
460,BUMA.1121.00069,1,412808,426031,+,13223
460,BUMA.1121.00064,1,464922,478129,+,13207
460,BUMA.1121.00105,1,780467,794260,-,13793
460,BUMA.1121.00015,1,189425,202462,-,13037
460,BUMA.1121.00059,1,3672809,3686140,+,13331
460,BUMA.1121.00022,1,670394,683439,-,13045
460,BUMA.1121.00052,1,601846,614883,-,13037
460,BUMA.1121.00101,1,2039299,2052442,-,13143
460,BUMA.1121.00001,1,3672476,3685627,-,13151
460,BUMA.1121.00038,1,3323790,3336827,-,13037
460,BUMA.1121.00068,1,3289785,3303225,+,13440
460,BUMA.1121.00099,1,1982335,1995544,-,13209
460,BUMA.1121.00091,1,78570,91863,-,13293
460,BUMA.1121.00098,1,3145285,3158447,+,13162
460,BUMA.1121.00013,1,371392,384429,+,13037
460,BUMA.1121.00049,1,1420225,1433470,-,13245
460,BUMA.1121.00072,1,423506,436744,+,13238
460,BUMA.1121.00076,1,929353,942582,-,13229
460,BUMA.1121.00083,1,1233159,1246453,-,13294
460,BUMA.1121.00078,1,1559832,1573149,-,13317
460,BUMA.1121.00095,1,1243056,1256304,-,13248
460,BUMA.1121.00077,1,3117017,3130309,+,13292
460,BUMA.1121.00063,1,448536,461830,+,13294
460,BUMA.1121.00061,1,451532,464808,+,13276
460,BUMA.1121.00050,1,1436261,1449298,+,13037
460,BUMA.1121.00081,1,3323975,3337012,-,13037
460,BUMA.1121.00074,1,3448559,3461724,-,13165
460,BUMA.1121.00062,1,145837,159148,-,13311
460,BUMA.1121.00060,1,1893045,1906325,-,13280
460,BUMA.1121.00070,1,423107,436380,+,13273
460,BUMA.1121.00075,1,3869624,3882853,+,13229
460,BUMA.1121.00041,1,1687762,1701066,+,13304
460,BUMA.1121.00073,1,449596,462871,+,13275
460,BUMA.1121.00017,1,779378,792423,+,13045
460,BUMA.1121.00066,1,420378,433672,+,13294
460,BUMA.1121.00107,1,266201,279408,+,13207
460,BUMA.1121.00085,1,198674,211711,-,13037
460,BUMA.1121.00030,1,779438,792483,+,13045
460,BUMA.1121.00112,1,2650539,2663685,-,13146
460,BUMA.1121.00002,1,872388,885449,+,13061
460,BUMA.1121.00082,1,458374,471668,+,13294
460,BUMA.1121.00014,1,2438989,2452185,-,13196
460,BUMA.1121.00011,1,1192511,1205753,-,13242
460,BUMA.1121.00019,1,844372,857417,+,13045
460,BUMA.1121.00057,1,1518316,1531632,+,13316
460,BUMA.1121.00018,1,925692,938829,+,13137
460,BUMA.1121.00039,1,534930,548098,+,13168
460,BUMA.1121.00016,1,2525533,2538678,+,13145
460,BUMA.1121.00004,1,844287,857332,+,13045
460,BUMA.1121.00005,1,3137272,3150557,-,13285
460,BUMA.1121.00100,1,875060,888264,-,13204
460,BUMA.1121.00006,1,3323867,3336904,-,13037
461,BUMA.1121.00027,1,2636578,2653524,+,16946
461,BUMA.1121.00025,1,2299633,2316548,-,16915
461,BUMA.1121.00021,1,1076695,1093653,+,16958
461,BUMA.1121.00023,1,2793389,2810262,+,16873
461,BUMA.1121.00024,1,981110,997984,+,16874
461,BUMA.1121.00033,1,2697934,2714856,+,16922
461,BUMA.1121.00034,1,1018540,1035414,+,16874
461,BUMA.1121.00036,1,3072527,3089413,+,16886
461,BUMA.1121.00032,1,2511625,2528499,+,16874
461,BUMA.1121.00009,1,1120577,1137580,-,17003
461,BUMA.1121.00008,1,984855,1001729,+,16874
461,BUMA.1121.00003,1,2935618,2952521,+,16903
461,BUMA.1121.00109,1,1415920,1432856,-,16936
461,BUMA.1121.00053,1,159111,176097,+,16986
461,BUMA.1121.00110,1,331575,348560,-,16985
461,BUMA.1121.00104,1,823686,840659,-,16973
461,BUMA.1121.00086,1,2786872,2803752,+,16880
461,BUMA.1121.00092,1,3407432,3424374,-,16942
461,BUMA.1121.00096,1,2804257,2821166,-,16909
461,BUMA.1121.00054,1,825315,842195,+,16880
461,BUMA.1121.00097,1,3571045,3587959,-,16914
461,BUMA.1121.00093,1,1202051,1218994,+,16943
461,BUMA.1121.00106,1,222206,239128,+,16922
461,BUMA.1121.00010,1,864803,881683,+,16880
461,BUMA.1121.00035,1,1517082,1533980,+,16898
461,BUMA.1121.00108,1,1424186,1441159,+,16973
461,BUMA.1121.00028,1,981109,997983,+,16874
461,BUMA.1121.00094,1,440489,457439,+,16950
461,BUMA.1121.00102,1,793664,810631,-,16967
461,BUMA.1121.00111,1,577955,594889,+,16934
461,BUMA.1121.00089,1,456267,473241,+,16974
461,BUMA.1121.00084,1,667585,684531,+,16946
461,BUMA.1121.00029,1,436717,453668,-,16951
461,BUMA.1121.00012,1,3221056,3237990,+,16934
461,BUMA.1121.00087,1,532004,548883,-,16879
461,BUMA.1121.00043,1,435705,452639,+,16934
461,BUMA.1121.00046,1,1279551,1296430,-,16879
461,BUMA.1121.00037,1,3082991,3099925,+,16934
461,BUMA.1121.00080,1,485890,502864,+,16974
461,BUMA.1121.00079,1,479978,496921,+,16943
461,BUMA.1121.00045,1,3645978,3662876,-,16898
461,BUMA.1121.00071,1,457618,474564,+,16946
461,BUMA.1121.00056,1,3452183,3469156,-,16973
461,BUMA.1121.00065,1,470819,487771,+,16952
461,BUMA.1121.00058,1,99518,116493,-,16975
461,BUMA.1121.00007,1,3667664,3684636,-,16972
461,BUMA.1121.00067,1,3951057,3967994,-,16937
461,BUMA.1121.00090,1,2543564,2560504,+,16940
461,BUMA.1121.00051,1,450590,467534,+,16944
461,BUMA.1121.00020,1,1046053,1062927,+,16874
461,BUMA.1121.00103,1,3967566,3984518,-,16952
461,BUMA.1121.00048,1,3093591,3110470,-,16879
461,BUMA.1121.00047,1,2521909,2538882,-,16973
461,BUMA.1121.00042,1,3264977,3281856,-,16879
461,BUMA.1121.00055,1,17165,34127,+,16962
461,BUMA.1121.00031,1,1783002,1799924,+,16922
461,BUMA.1121.00040,1,280610,297490,+,16880
461,BUMA.1121.00044,1,246647,263521,+,16874
461,BUMA.1121.00088,1,1331363,1348315,+,16952
461,BUMA.1121.00069,1,430585,447531,+,16946
461,BUMA.1121.00064,1,482683,499630,+,16947
461,BUMA.1121.00105,1,758997,775927,-,16930
461,BUMA.1121.00015,1,166545,183424,-,16879
461,BUMA.1121.00059,1,3690650,3707588,+,16938
461,BUMA.1121.00026,1,1055833,1072712,-,16879
461,BUMA.1121.00022,1,424761,441641,+,16880
461,BUMA.1121.00052,1,578966,595845,-,16879
461,BUMA.1121.00101,1,2017737,2034712,-,16975
461,BUMA.1121.00001,1,3644488,3661385,-,16897
461,BUMA.1121.00038,1,3300910,3317789,-,16879
461,BUMA.1121.00068,1,3307797,3324743,+,16946
461,BUMA.1121.00099,1,1959579,1976522,-,16943
461,BUMA.1121.00091,1,57093,74050,-,16957
461,BUMA.1121.00098,1,3162945,3179861,+,16916
461,BUMA.1121.00013,1,390430,407310,+,16880
461,BUMA.1121.00049,1,1398729,1415714,-,16985
461,BUMA.1121.00072,1,441272,458218,+,16946
461,BUMA.1121.00076,1,907915,924843,-,16928
461,BUMA.1121.00083,1,1211660,1228605,-,16945
461,BUMA.1121.00078,1,1538360,1555337,-,16977
461,BUMA.1121.00095,1,1221573,1238548,-,16975
461,BUMA.1121.00077,1,3134852,3151838,+,16986
461,BUMA.1121.00063,1,466384,483330,+,16946
461,BUMA.1121.00061,1,469350,486277,+,16927
461,BUMA.1121.00050,1,1455299,1472179,+,16880
461,BUMA.1121.00081,1,3301095,3317974,-,16879
461,BUMA.1121.00074,1,3427063,3444027,-,16964
461,BUMA.1121.00062,1,124357,141306,-,16949
461,BUMA.1121.00060,1,1871648,1888546,-,16898
461,BUMA.1121.00070,1,440934,457811,+,16877
461,BUMA.1121.00075,1,3887363,3904314,+,16951
461,BUMA.1121.00041,1,1705589,1722515,+,16926
461,BUMA.1121.00073,1,467425,484371,+,16946
461,BUMA.1121.00017,1,916159,933033,+,16874
461,BUMA.1121.00066,1,438202,455148,+,16946
461,BUMA.1121.00107,1,283853,300814,+,16961
461,BUMA.1121.00085,1,175794,192673,-,16879
461,BUMA.1121.00030,1,916219,933093,+,16874
461,BUMA.1121.00112,1,2629075,2646041,-,16966
461,BUMA.1121.00002,1,891450,908330,+,16880
461,BUMA.1121.00082,1,476222,493168,+,16946
461,BUMA.1121.00014,1,2417576,2434491,-,16915
461,BUMA.1121.00011,1,1171018,1187979,-,16961
461,BUMA.1121.00019,1,981153,998027,+,16874
461,BUMA.1121.00057,1,1536186,1553126,+,16940
461,BUMA.1121.00018,1,943328,960238,+,16910
461,BUMA.1121.00039,1,552617,569569,+,16952
461,BUMA.1121.00016,1,2543139,2560109,+,16970
461,BUMA.1121.00004,1,982307,999181,+,16874
461,BUMA.1121.00005,1,3115767,3132774,-,17007
461,BUMA.1121.00100,1,853639,870562,-,16923
461,BUMA.1121.00006,1,3300987,3317866,-,16879
462,BUMA.1121.00027,1,2654794,2664764,+,9970
462,BUMA.1121.00025,1,2288394,2298363,-,9969
462,BUMA.1121.00021,1,1094923,1104876,+,9953
462,BUMA.1121.00023,1,2811532,2821501,+,9969
462,BUMA.1121.00024,1,999254,1009221,+,9967
462,BUMA.1121.00033,1,2716126,2726095,+,9969
462,BUMA.1121.00034,1,1036684,1046651,+,9967
462,BUMA.1121.00036,1,3090683,3100650,+,9967
462,BUMA.1121.00032,1,2529769,2539736,+,9967
462,BUMA.1121.00009,1,1109336,1119307,-,9971
462,BUMA.1121.00008,1,1002999,1012966,+,9967
462,BUMA.1121.00003,1,2953791,2963760,+,9969
462,BUMA.1121.00109,1,1404680,1414650,-,9970
462,BUMA.1121.00053,1,177367,187337,+,9970
462,BUMA.1121.00110,1,320335,330305,-,9970
462,BUMA.1121.00104,1,812446,822416,-,9970
462,BUMA.1121.00086,1,2805022,2814989,+,9967
462,BUMA.1121.00092,1,3396191,3406162,-,9971
462,BUMA.1121.00096,1,2793017,2802987,-,9970
462,BUMA.1121.00054,1,843465,853432,+,9967
462,BUMA.1121.00097,1,3559821,3569775,-,9954
462,BUMA.1121.00093,1,1220264,1230235,+,9971
462,BUMA.1121.00106,1,240398,250380,+,9982
462,BUMA.1121.00010,1,882953,892920,+,9967
462,BUMA.1121.00035,1,1535250,1545219,+,9969
462,BUMA.1121.00108,1,1442429,1452398,+,9969
462,BUMA.1121.00028,1,999253,1009220,+,9967
462,BUMA.1121.00094,1,458709,468680,+,9971
462,BUMA.1121.00102,1,782509,792394,-,9885
462,BUMA.1121.00111,1,596159,606128,+,9969
462,BUMA.1121.00089,1,474511,484482,+,9971
462,BUMA.1121.00084,1,685801,695771,+,9970
462,BUMA.1121.00029,1,425478,435447,-,9969
462,BUMA.1121.00012,1,3239260,3249229,+,9969
462,BUMA.1121.00087,1,520767,530734,-,9967
462,BUMA.1121.00043,1,453909,463878,+,9969
462,BUMA.1121.00046,1,1268314,1278281,-,9967
462,BUMA.1121.00037,1,3101195,3111164,+,9969
462,BUMA.1121.00080,1,504134,514105,+,9971
462,BUMA.1121.00079,1,498191,508162,+,9971
462,BUMA.1121.00045,1,3634738,3644708,-,9970
462,BUMA.1121.00071,1,475834,485804,+,9970
462,BUMA.1121.00056,1,3440942,3450913,-,9971
462,BUMA.1121.00065,1,489041,499007,+,9966
462,BUMA.1121.00058,1,88278,98248,-,9970
462,BUMA.1121.00007,1,3656425,3666394,-,9969
462,BUMA.1121.00067,1,3939816,3949787,-,9971
462,BUMA.1121.00090,1,2561774,2571744,+,9970
462,BUMA.1121.00051,1,468804,478774,+,9970
462,BUMA.1121.00020,1,1064197,1074164,+,9967
462,BUMA.1121.00103,1,3956343,3966296,-,9953
462,BUMA.1121.00048,1,3082354,3092321,-,9967
462,BUMA.1121.00047,1,2510668,2520639,-,9971
462,BUMA.1121.00042,1,3253740,3263707,-,9967
462,BUMA.1121.00055,1,35397,45368,+,9971
462,BUMA.1121.00031,1,1801194,1811163,+,9969
462,BUMA.1121.00040,1,298760,308727,+,9967
462,BUMA.1121.00044,1,264791,274758,+,9967
462,BUMA.1121.00088,1,1349585,1359555,+,9970
462,BUMA.1121.00069,1,448801,458771,+,9970
462,BUMA.1121.00064,1,500900,510871,+,9971
462,BUMA.1121.00105,1,747757,757727,-,9970
462,BUMA.1121.00015,1,155308,165275,-,9967
462,BUMA.1121.00059,1,3708858,3718840,+,9982
462,BUMA.1121.00026,1,1044596,1054563,-,9967
462,BUMA.1121.00022,1,442911,452878,+,9967
462,BUMA.1121.00052,1,567729,577696,-,9967
462,BUMA.1121.00101,1,2006496,2016467,-,9971
462,BUMA.1121.00001,1,3633249,3643218,-,9969
462,BUMA.1121.00038,1,3289673,3299640,-,9967
462,BUMA.1121.00068,1,3326013,3335983,+,9970
462,BUMA.1121.00099,1,1948339,1958309,-,9970
462,BUMA.1121.00091,1,45853,55823,-,9970
462,BUMA.1121.00098,1,3181131,3191100,+,9969
462,BUMA.1121.00013,1,408580,418547,+,9967
462,BUMA.1121.00049,1,1387477,1397459,-,9982
462,BUMA.1121.00072,1,459488,469458,+,9970
462,BUMA.1121.00076,1,896678,906645,-,9967
462,BUMA.1121.00083,1,1200420,1210390,-,9970
462,BUMA.1121.00078,1,1527130,1537090,-,9960
462,BUMA.1121.00095,1,1210333,1220303,-,9970
462,BUMA.1121.00077,1,3153108,3163078,+,9970
462,BUMA.1121.00063,1,484600,494570,+,9970
462,BUMA.1121.00061,1,487547,497517,+,9970
462,BUMA.1121.00050,1,1473449,1483416,+,9967
462,BUMA.1121.00081,1,3289858,3299825,-,9967
462,BUMA.1121.00074,1,3415822,3425793,-,9971
462,BUMA.1121.00062,1,113117,123087,-,9970
462,BUMA.1121.00060,1,1860408,1870378,-,9970
462,BUMA.1121.00070,1,459081,469051,+,9970
462,BUMA.1121.00075,1,3905584,3915551,+,9967
462,BUMA.1121.00041,1,1723785,1733755,+,9970
462,BUMA.1121.00073,1,485641,495611,+,9970
462,BUMA.1121.00017,1,934303,944270,+,9967
462,BUMA.1121.00066,1,456418,466388,+,9970
462,BUMA.1121.00107,1,302084,312054,+,9970
462,BUMA.1121.00085,1,164557,174524,-,9967
462,BUMA.1121.00030,1,934363,944330,+,9967
462,BUMA.1121.00112,1,2617835,2627805,-,9970
462,BUMA.1121.00002,1,909600,919567,+,9967
462,BUMA.1121.00082,1,494438,504408,+,9970
462,BUMA.1121.00014,1,2406337,2416306,-,9969
462,BUMA.1121.00011,1,1159779,1169748,-,9969
462,BUMA.1121.00019,1,999297,1009264,+,9967
462,BUMA.1121.00057,1,1554396,1564366,+,9970
462,BUMA.1121.00018,1,961508,971477,+,9969
462,BUMA.1121.00039,1,570839,580808,+,9969
462,BUMA.1121.00016,1,2561379,2571348,+,9969
462,BUMA.1121.00004,1,1000451,1010418,+,9967
462,BUMA.1121.00005,1,3104533,3114503,-,9970
462,BUMA.1121.00100,1,842399,852369,-,9970
462,BUMA.1121.00006,1,3289750,3299717,-,9967
463,BUMA.1121.00027,1,2665043,2671496,+,6453
463,BUMA.1121.00025,1,2281672,2288114,-,6442
463,BUMA.1121.00021,1,1106767,1113232,+,6465
463,BUMA.1121.00023,1,2821780,2828265,+,6485
463,BUMA.1121.00024,1,228990,235485,+,6495
463,BUMA.1121.00033,1,2726374,2732848,+,6474
463,BUMA.1121.00034,1,229004,235499,+,6495
463,BUMA.1121.00036,1,3146364,3152838,-,6474
463,BUMA.1121.00032,1,1825985,1832490,+,6505
463,BUMA.1121.00009,1,1102592,1109056,-,6464
463,BUMA.1121.00008,1,229018,235513,+,6495
463,BUMA.1121.00003,1,2964039,2970504,+,6465
463,BUMA.1121.00109,1,1397936,1404400,-,6464
463,BUMA.1121.00053,1,187616,194071,+,6455
463,BUMA.1121.00110,1,313584,320055,-,6471
463,BUMA.1121.00104,1,805702,812166,-,6464
463,BUMA.1121.00086,1,2860640,2867114,-,6474
463,BUMA.1121.00092,1,3389447,3395911,-,6464
463,BUMA.1121.00096,1,2786283,2792737,-,6454
463,BUMA.1121.00054,1,899111,905605,-,6494
463,BUMA.1121.00097,1,3553150,3559525,-,6375
463,BUMA.1121.00093,1,1230514,1236979,+,6465
463,BUMA.1121.00106,1,250655,257124,+,6469
463,BUMA.1121.00010,1,1132019,1138503,-,6484
463,BUMA.1121.00035,1,1545498,1551983,+,6485
463,BUMA.1121.00108,1,1452677,1459142,+,6465
463,BUMA.1121.00028,1,229004,235499,+,6495
463,BUMA.1121.00094,1,468959,475259,+,6300
463,BUMA.1121.00102,1,775806,782229,-,6423
463,BUMA.1121.00111,1,606407,612850,+,6443
463,BUMA.1121.00089,1,484761,491226,+,6465
463,BUMA.1121.00084,1,696046,702515,+,6469
463,BUMA.1121.00029,1,418714,425198,-,6484
463,BUMA.1121.00012,1,3249508,3255981,+,6473
463,BUMA.1121.00087,1,468641,475116,+,6475
463,BUMA.1121.00043,1,464157,470642,+,6485
463,BUMA.1121.00046,1,1216169,1222654,+,6485
463,BUMA.1121.00037,1,3111443,3117918,+,6475
463,BUMA.1121.00080,1,514384,520849,+,6465
463,BUMA.1121.00079,1,508441,514904,+,6463
463,BUMA.1121.00045,1,3627994,3634458,-,6464
463,BUMA.1121.00071,1,486083,492538,+,6455
463,BUMA.1121.00056,1,3434198,3440662,-,6464
463,BUMA.1121.00065,1,500885,507350,+,6465
463,BUMA.1121.00058,1,81544,87998,-,6454
463,BUMA.1121.00007,1,3649681,3656145,-,6464
463,BUMA.1121.00067,1,3933072,3939536,-,6464
463,BUMA.1121.00090,1,2572023,2578466,+,6443
463,BUMA.1121.00051,1,479053,485518,+,6465
463,BUMA.1121.00020,1,229011,235506,+,6495
463,BUMA.1121.00103,1,3948010,3954452,-,6442
463,BUMA.1121.00048,1,3030181,3036676,+,6495
463,BUMA.1121.00047,1,2503934,2510388,-,6454
463,BUMA.1121.00042,1,3356402,3362876,-,6474
463,BUMA.1121.00055,1,45647,52112,+,6465
463,BUMA.1121.00031,1,1811442,1817917,+,6475
463,BUMA.1121.00040,1,720648,727133,+,6485
463,BUMA.1121.00044,1,3031007,3037502,+,6495
463,BUMA.1121.00088,1,1359834,1366269,+,6435
463,BUMA.1121.00069,1,459050,465505,+,6455
463,BUMA.1121.00064,1,511150,517615,+,6465
463,BUMA.1121.00105,1,741013,747477,-,6464
463,BUMA.1121.00015,1,103119,109614,+,6495
463,BUMA.1121.00059,1,3719119,3725574,+,6455
463,BUMA.1121.00026,1,1119211,1125685,-,6474
463,BUMA.1121.00022,1,498544,505018,-,6474
463,BUMA.1121.00052,1,514387,520862,+,6475
463,BUMA.1121.00101,1,1999720,2006216,-,6496
463,BUMA.1121.00001,1,3626475,3632969,-,6494
463,BUMA.1121.00038,1,3237499,3243994,+,6495
463,BUMA.1121.00068,1,3336262,3342727,+,6465
463,BUMA.1121.00099,1,1941595,1948059,-,6464
463,BUMA.1121.00091,1,39079,45573,-,6494
463,BUMA.1121.00098,1,3191379,3197832,+,6453
463,BUMA.1121.00013,1,465414,471888,-,6474
463,BUMA.1121.00049,1,1380723,1387202,-,6479
463,BUMA.1121.00072,1,469737,476192,+,6455
463,BUMA.1121.00076,1,888335,894799,-,6464
463,BUMA.1121.00083,1,1193686,1200140,-,6454
463,BUMA.1121.00078,1,1520412,1526850,-,6438
463,BUMA.1121.00095,1,1203601,1210053,-,6452
463,BUMA.1121.00077,1,3163357,3169829,+,6472
463,BUMA.1121.00063,1,494849,501304,+,6455
463,BUMA.1121.00061,1,497796,504251,+,6455
463,BUMA.1121.00050,1,1529076,1535560,-,6484
463,BUMA.1121.00081,1,3237684,3244179,+,6495
463,BUMA.1121.00074,1,3409078,3415542,-,6464
463,BUMA.1121.00062,1,106373,112837,-,6464
463,BUMA.1121.00060,1,1853664,1860128,-,6464
463,BUMA.1121.00070,1,469330,475785,+,6455
463,BUMA.1121.00075,1,3917428,3923891,+,6463
463,BUMA.1121.00041,1,1734034,1740509,+,6475
463,BUMA.1121.00073,1,495890,502345,+,6455
463,BUMA.1121.00017,1,229004,235499,+,6495
463,BUMA.1121.00066,1,466667,473122,+,6455
463,BUMA.1121.00107,1,312333,318808,+,6475
463,BUMA.1121.00085,1,111215,117690,+,6475
463,BUMA.1121.00030,1,229004,235499,+,6495
463,BUMA.1121.00112,1,2611079,2617555,-,6476
463,BUMA.1121.00002,1,1158693,1165177,-,6484
463,BUMA.1121.00082,1,504687,511142,+,6455
463,BUMA.1121.00014,1,2399583,2406057,-,6474
463,BUMA.1121.00011,1,1153035,1159499,-,6464
463,BUMA.1121.00019,1,229011,235506,+,6495
463,BUMA.1121.00057,1,1564645,1571100,+,6455
463,BUMA.1121.00018,1,971756,978199,+,6443
463,BUMA.1121.00039,1,581087,587562,+,6475
463,BUMA.1121.00016,1,2571627,2578111,+,6484
463,BUMA.1121.00004,1,228996,235491,+,6495
463,BUMA.1121.00005,1,3097769,3104253,-,6484
463,BUMA.1121.00100,1,835650,842119,-,6469
463,BUMA.1121.00006,1,3237576,3244071,+,6495
464,BUMA.1121.00027,1,2671497,2680063,+,8566
464,BUMA.1121.00025,1,2273058,2281670,-,8612
464,BUMA.1121.00021,1,1113233,1121837,+,8604
464,BUMA.1121.00023,1,2828266,2837005,+,8739
464,BUMA.1121.00024,1,235486,244045,+,8559
464,BUMA.1121.00033,1,2732849,2741469,+,8620
464,BUMA.1121.00034,1,235500,244059,+,8559
464,BUMA.1121.00036,1,3137804,3146362,-,8558
464,BUMA.1121.00032,1,1832491,1841050,+,8559
464,BUMA.1121.00009,1,1093960,1102590,-,8630
464,BUMA.1121.00008,1,235514,244073,+,8559
464,BUMA.1121.00003,1,2970505,2979145,+,8640
464,BUMA.1121.00109,1,1389376,1397934,-,8558
464,BUMA.1121.00053,1,194072,202703,+,8631
464,BUMA.1121.00110,1,304952,313582,-,8630
464,BUMA.1121.00104,1,797124,805700,-,8576
464,BUMA.1121.00086,1,2852080,2860638,-,8558
464,BUMA.1121.00092,1,3380851,3389445,-,8594
464,BUMA.1121.00096,1,2777696,2786281,-,8585
464,BUMA.1121.00054,1,890551,899109,-,8558
464,BUMA.1121.00097,1,3544483,3553148,-,8665
464,BUMA.1121.00093,1,1236980,1245575,+,8595
464,BUMA.1121.00106,1,257125,265693,+,8568
464,BUMA.1121.00010,1,1123459,1132017,-,8558
464,BUMA.1121.00035,1,1551984,1560624,+,8640
464,BUMA.1121.00108,1,1459143,1467710,+,8567
464,BUMA.1121.00028,1,235500,244059,+,8559
464,BUMA.1121.00094,1,475260,483984,+,8724
464,BUMA.1121.00102,1,741178,749779,-,8601
464,BUMA.1121.00111,1,612851,621455,+,8604
464,BUMA.1121.00089,1,491227,499956,+,8729
464,BUMA.1121.00084,1,702516,711093,+,8577
464,BUMA.1121.00029,1,410064,418712,-,8648
464,BUMA.1121.00012,1,3255982,3264604,+,8622
464,BUMA.1121.00087,1,475117,483676,+,8559
464,BUMA.1121.00043,1,470643,479274,+,8631
464,BUMA.1121.00046,1,1222655,1231214,+,8559
464,BUMA.1121.00037,1,3117919,3126496,+,8577
464,BUMA.1121.00080,1,520850,529585,+,8735
464,BUMA.1121.00079,1,514905,523621,+,8716
464,BUMA.1121.00045,1,3619398,3627992,-,8594
464,BUMA.1121.00071,1,492539,501113,+,8574
464,BUMA.1121.00056,1,3425539,3434196,-,8657
464,BUMA.1121.00065,1,507351,515928,+,8577
464,BUMA.1121.00058,1,72966,81542,-,8576
464,BUMA.1121.00007,1,3641085,3649679,-,8594
464,BUMA.1121.00067,1,3924324,3933070,-,8746
464,BUMA.1121.00090,1,2578467,2587071,+,8604
464,BUMA.1121.00051,1,485519,494229,+,8710
464,BUMA.1121.00020,1,235507,244066,+,8559
464,BUMA.1121.00103,1,3939459,3948008,-,8549
464,BUMA.1121.00048,1,3036677,3045236,+,8559
464,BUMA.1121.00047,1,2495275,2503932,-,8657
464,BUMA.1121.00042,1,3347815,3356400,-,8585
464,BUMA.1121.00055,1,52113,60753,+,8640
464,BUMA.1121.00031,1,1817918,1826548,+,8630
464,BUMA.1121.00040,1,727134,735693,+,8559
464,BUMA.1121.00044,1,3037503,3046062,+,8559
464,BUMA.1121.00088,1,1366270,1374847,+,8577
464,BUMA.1121.00069,1,465506,474093,+,8587
464,BUMA.1121.00064,1,517616,526175,+,8559
464,BUMA.1121.00105,1,732345,741011,-,8666
464,BUMA.1121.00015,1,109615,118174,+,8559
464,BUMA.1121.00059,1,3725575,3734143,+,8568
464,BUMA.1121.00026,1,1110633,1119209,-,8576
464,BUMA.1121.00022,1,489984,498542,-,8558
464,BUMA.1121.00052,1,520863,529422,+,8559
464,BUMA.1121.00101,1,1991142,1999718,-,8576
464,BUMA.1121.00001,1,3617843,3626473,-,8630
464,BUMA.1121.00038,1,3243995,3252554,+,8559
464,BUMA.1121.00068,1,3342728,3351413,+,8685
464,BUMA.1121.00099,1,1932936,1941593,-,8657
464,BUMA.1121.00091,1,30254,39077,-,8823
464,BUMA.1121.00098,1,3197833,3206607,+,8774
464,BUMA.1121.00013,1,456854,465412,-,8558
464,BUMA.1121.00049,1,1372109,1380721,-,8612
464,BUMA.1121.00072,1,476193,484715,+,8522
464,BUMA.1121.00076,1,879739,888333,-,8594
464,BUMA.1121.00083,1,1185090,1193684,-,8594
464,BUMA.1121.00078,1,1511840,1520410,-,8570
464,BUMA.1121.00095,1,1194987,1203599,-,8612
464,BUMA.1121.00077,1,3169830,3178461,+,8631
464,BUMA.1121.00063,1,501305,509799,+,8494
464,BUMA.1121.00061,1,504252,512847,+,8595
464,BUMA.1121.00050,1,1520516,1529074,-,8558
464,BUMA.1121.00081,1,3244180,3252739,+,8559
464,BUMA.1121.00074,1,3400554,3409076,-,8522
464,BUMA.1121.00062,1,97858,106371,-,8513
464,BUMA.1121.00060,1,1845068,1853662,-,8594
464,BUMA.1121.00070,1,475786,484287,+,8501
464,BUMA.1121.00075,1,3923892,3932431,+,8539
464,BUMA.1121.00041,1,1740510,1749141,+,8631
464,BUMA.1121.00073,1,502346,510910,+,8564
464,BUMA.1121.00017,1,235500,244059,+,8559
464,BUMA.1121.00066,1,473123,481718,+,8595
464,BUMA.1121.00107,1,318809,327588,+,8779
464,BUMA.1121.00085,1,117691,126250,+,8559
464,BUMA.1121.00030,1,235500,244059,+,8559
464,BUMA.1121.00112,1,2602528,2611077,-,8549
464,BUMA.1121.00002,1,1150133,1158691,-,8558
464,BUMA.1121.00082,1,511143,519738,+,8595
464,BUMA.1121.00014,1,2390933,2399581,-,8648
464,BUMA.1121.00011,1,1144439,1153033,-,8594
464,BUMA.1121.00019,1,235507,244066,+,8559
464,BUMA.1121.00057,1,1571101,1579714,+,8613
464,BUMA.1121.00018,1,978200,986812,+,8612
464,BUMA.1121.00039,1,587563,596203,+,8640
464,BUMA.1121.00016,1,2578112,2586698,+,8586
464,BUMA.1121.00004,1,235492,244051,+,8559
464,BUMA.1121.00005,1,3089192,3097767,-,8575
464,BUMA.1121.00100,1,827018,835648,-,8630
464,BUMA.1121.00006,1,3244072,3252631,+,8559
465,BUMA.1121.00027,1,2680090,2710162,+,30072
465,BUMA.1121.00025,1,2242859,2273031,-,30172
465,BUMA.1121.00021,1,1121864,1151863,+,29999
465,BUMA.1121.00023,1,2837032,2867182,+,30150
465,BUMA.1121.00024,1,244072,274049,+,29977
465,BUMA.1121.00033,1,2741496,2771485,+,29989
465,BUMA.1121.00034,1,244086,274063,+,29977
465,BUMA.1121.00036,1,3107730,3137777,-,30047
465,BUMA.1121.00032,1,1841077,1871054,+,29977
465,BUMA.1121.00009,1,1063909,1093933,-,30024
465,BUMA.1121.00008,1,244100,274077,+,29977
465,BUMA.1121.00003,1,2979172,3009214,+,30042
465,BUMA.1121.00109,1,1359292,1389349,-,30057
465,BUMA.1121.00053,1,202730,232793,+,30063
465,BUMA.1121.00110,1,274879,304925,-,30046
465,BUMA.1121.00104,1,767025,797097,-,30072
465,BUMA.1121.00086,1,2822069,2852053,-,29984
465,BUMA.1121.00092,1,3350728,3380824,-,30096
465,BUMA.1121.00096,1,2747676,2777669,-,29993
465,BUMA.1121.00054,1,860513,890524,-,30011
465,BUMA.1121.00097,1,3514393,3544456,-,30063
465,BUMA.1121.00093,1,1245602,1275698,+,30096
465,BUMA.1121.00106,1,265720,295811,+,30091
465,BUMA.1121.00010,1,1093448,1123432,-,29984
465,BUMA.1121.00035,1,1560651,1590741,+,30090
465,BUMA.1121.00108,1,1467737,1497841,+,30104
465,BUMA.1121.00028,1,244086,274063,+,29977
465,BUMA.1121.00094,1,484011,514060,+,30049
465,BUMA.1121.00102,1,711047,741151,-,30104
465,BUMA.1121.00111,1,621482,651566,+,30084
465,BUMA.1121.00089,1,499983,530019,+,30036
465,BUMA.1121.00084,1,711120,741187,+,30067
465,BUMA.1121.00029,1,379989,410037,-,30048
465,BUMA.1121.00012,1,3264631,3294780,+,30149
465,BUMA.1121.00087,1,483703,513687,+,29984
465,BUMA.1121.00043,1,479301,509369,+,30068
465,BUMA.1121.00046,1,1231241,1261234,+,29993
465,BUMA.1121.00037,1,3126523,3156603,+,30080
465,BUMA.1121.00080,1,529612,559636,+,30024
465,BUMA.1121.00079,1,523648,553724,+,30076
465,BUMA.1121.00045,1,3589298,3619371,-,30073
465,BUMA.1121.00071,1,501140,531232,+,30092
465,BUMA.1121.00056,1,3395476,3425512,-,30036
465,BUMA.1121.00065,1,515955,545965,+,30010
465,BUMA.1121.00058,1,42875,72939,-,30064
465,BUMA.1121.00007,1,3610961,3641058,-,30097
465,BUMA.1121.00067,1,3894149,3924297,-,30148
465,BUMA.1121.00090,1,2587098,2617188,+,30090
465,BUMA.1121.00051,1,494256,524287,+,30031
465,BUMA.1121.00020,1,244093,274070,+,29977
465,BUMA.1121.00103,1,3909396,3939432,-,30036
465,BUMA.1121.00048,1,3045263,3075274,+,30011
465,BUMA.1121.00047,1,2465205,2495248,-,30043
465,BUMA.1121.00042,1,3317751,3347788,-,30037
465,BUMA.1121.00055,1,60780,90794,+,30014
465,BUMA.1121.00031,1,1826575,1856627,+,30052
465,BUMA.1121.00040,1,735720,765794,+,30074
465,BUMA.1121.00044,1,3046089,3076066,+,29977
465,BUMA.1121.00088,1,1374874,1404943,+,30069
465,BUMA.1121.00069,1,474120,504206,+,30086
465,BUMA.1121.00064,1,526202,556323,+,30121
465,BUMA.1121.00105,1,702260,732318,-,30058
465,BUMA.1121.00015,1,118201,148228,+,30027
465,BUMA.1121.00059,1,3734170,3764261,+,30091
465,BUMA.1121.00026,1,1080534,1110606,-,30072
465,BUMA.1121.00022,1,459959,489957,-,29998
465,BUMA.1121.00052,1,529449,559481,+,30032
465,BUMA.1121.00101,1,1961075,1991115,-,30040
465,BUMA.1121.00001,1,3587825,3617816,-,29991
465,BUMA.1121.00038,1,3252581,3282592,+,30011
465,BUMA.1121.00068,1,3351440,3381409,+,29969
465,BUMA.1121.00099,1,1902912,1932909,-,29997
465,BUMA.1121.00091,1,56,30227,-,30171
465,BUMA.1121.00098,1,3206634,3236676,+,30042
465,BUMA.1121.00013,1,426795,456827,-,30032
465,BUMA.1121.00049,1,1341957,1372082,-,30125
465,BUMA.1121.00072,1,484742,514834,+,30092
465,BUMA.1121.00076,1,849646,879712,-,30066
465,BUMA.1121.00083,1,1154971,1185063,-,30092
465,BUMA.1121.00078,1,1481657,1511813,-,30156
465,BUMA.1121.00095,1,1164842,1194960,-,30118
465,BUMA.1121.00077,1,3178488,3208528,+,30040
465,BUMA.1121.00063,1,509826,539917,+,30091
465,BUMA.1121.00061,1,512874,542962,+,30088
465,BUMA.1121.00050,1,1490496,1520489,-,29993
465,BUMA.1121.00081,1,3252766,3282777,+,30011
465,BUMA.1121.00074,1,3370438,3400527,-,30089
465,BUMA.1121.00062,1,67728,97831,-,30103
465,BUMA.1121.00060,1,1814968,1845041,-,30073
465,BUMA.1121.00070,1,484314,514406,+,30092
465,BUMA.1121.00075,1,81,30142,+,30061
465,BUMA.1121.00041,1,1749168,1779292,+,30124
465,BUMA.1121.00073,1,510937,541029,+,30092
465,BUMA.1121.00017,1,244086,274063,+,29977
465,BUMA.1121.00066,1,481745,511837,+,30092
465,BUMA.1121.00107,1,327615,357694,+,30079
465,BUMA.1121.00085,1,126277,156309,+,30032
465,BUMA.1121.00030,1,244086,274063,+,29977
465,BUMA.1121.00112,1,2572393,2602501,-,30108
465,BUMA.1121.00002,1,1120122,1150106,-,29984
465,BUMA.1121.00082,1,519765,549857,+,30092
465,BUMA.1121.00014,1,2360876,2390906,-,30030
465,BUMA.1121.00011,1,1114233,1144412,-,30179
465,BUMA.1121.00019,1,244093,274070,+,29977
465,BUMA.1121.00057,1,1579741,1609793,+,30052
465,BUMA.1121.00018,1,986839,1017011,+,30172
465,BUMA.1121.00039,1,596230,626252,+,30022
465,BUMA.1121.00016,1,2586725,2616908,+,30183
465,BUMA.1121.00004,1,244078,274055,+,29977
465,BUMA.1121.00005,1,3059121,3089165,-,30044
465,BUMA.1121.00100,1,796953,826991,-,30038
465,BUMA.1121.00006,1,3252658,3282669,+,30011
466,BUMA.1121.00027,1,2710169,2714270,+,4101
466,BUMA.1121.00025,1,2238738,2242854,-,4116
466,BUMA.1121.00021,1,1151868,1155984,+,4116
466,BUMA.1121.00023,1,2867187,2871303,+,4116
466,BUMA.1121.00024,1,274054,278179,+,4125
466,BUMA.1121.00033,1,2771490,2775606,+,4116
466,BUMA.1121.00034,1,274068,278193,+,4125
466,BUMA.1121.00036,1,3103600,3107725,-,4125
466,BUMA.1121.00032,1,1871059,1875184,+,4125
466,BUMA.1121.00009,1,1059778,1063904,-,4126
466,BUMA.1121.00008,1,274082,278207,+,4125
466,BUMA.1121.00003,1,3009219,3013345,+,4126
466,BUMA.1121.00109,1,1355176,1359287,-,4111
466,BUMA.1121.00053,1,232798,236914,+,4116
466,BUMA.1121.00110,1,270747,274874,-,4127
466,BUMA.1121.00104,1,762897,767018,-,4121
466,BUMA.1121.00086,1,2817939,2822064,-,4125
466,BUMA.1121.00092,1,3346600,3350721,-,4121
466,BUMA.1121.00096,1,2743560,2747671,-,4111
466,BUMA.1121.00054,1,856383,860508,-,4125
466,BUMA.1121.00097,1,3510265,3514386,-,4121
466,BUMA.1121.00093,1,1275705,1279826,+,4121
466,BUMA.1121.00106,1,295818,299944,+,4126
466,BUMA.1121.00010,1,1089318,1093443,-,4125
466,BUMA.1121.00035,1,1590746,1594862,+,4116
466,BUMA.1121.00108,1,1497848,1501974,+,4126
466,BUMA.1121.00028,1,274068,278193,+,4125
466,BUMA.1121.00094,1,514067,518188,+,4121
466,BUMA.1121.00102,1,706914,711040,-,4126
466,BUMA.1121.00111,1,651571,655687,+,4116
466,BUMA.1121.00089,1,530026,534147,+,4121
466,BUMA.1121.00084,1,741194,745320,+,4126
466,BUMA.1121.00029,1,375868,379984,-,4116
466,BUMA.1121.00012,1,3294785,3298901,+,4116
466,BUMA.1121.00087,1,513692,517817,+,4125
466,BUMA.1121.00043,1,509374,513504,+,4130
466,BUMA.1121.00046,1,1261239,1265364,+,4125
466,BUMA.1121.00037,1,3156610,3160724,+,4114
466,BUMA.1121.00080,1,559643,563764,+,4121
466,BUMA.1121.00079,1,553731,557852,+,4121
466,BUMA.1121.00045,1,3585167,3589293,-,4126
466,BUMA.1121.00071,1,531239,535340,+,4101
466,BUMA.1121.00056,1,3391348,3395469,-,4121
466,BUMA.1121.00065,1,545970,550070,+,4100
466,BUMA.1121.00058,1,38742,42870,-,4128
466,BUMA.1121.00007,1,3606862,3610956,-,4094
466,BUMA.1121.00067,1,3890021,3894144,-,4123
466,BUMA.1121.00090,1,2617193,2621309,+,4116
466,BUMA.1121.00051,1,524294,528415,+,4121
466,BUMA.1121.00020,1,274075,278200,+,4125
466,BUMA.1121.00103,1,3905263,3909391,-,4128
466,BUMA.1121.00048,1,3075279,3079404,+,4125
466,BUMA.1121.00047,1,2461077,2465198,-,4121
466,BUMA.1121.00042,1,3313646,3317746,-,4100
466,BUMA.1121.00055,1,90801,94899,+,4098
466,BUMA.1121.00031,1,1856634,1860747,+,4113
466,BUMA.1121.00040,1,765799,769924,+,4125
466,BUMA.1121.00044,1,3076071,3080196,+,4125
466,BUMA.1121.00088,1,1404948,1409072,+,4124
466,BUMA.1121.00069,1,504213,508314,+,4101
466,BUMA.1121.00064,1,556328,560452,+,4124
466,BUMA.1121.00105,1,698130,702255,-,4125
466,BUMA.1121.00015,1,148233,152358,+,4125
466,BUMA.1121.00059,1,3764268,3768389,+,4121
466,BUMA.1121.00026,1,1076429,1080529,-,4100
466,BUMA.1121.00022,1,455829,459954,-,4125
466,BUMA.1121.00052,1,559486,563611,+,4125
466,BUMA.1121.00101,1,1956942,1961070,-,4128
466,BUMA.1121.00001,1,3583704,3587820,-,4116
466,BUMA.1121.00038,1,3282597,3286722,+,4125
466,BUMA.1121.00068,1,3381414,3385541,+,4127
466,BUMA.1121.00099,1,1898780,1902905,-,4125
466,BUMA.1121.00091,1,4017709,4021786,-,4077
466,BUMA.1121.00098,1,3236683,3240806,+,4123
466,BUMA.1121.00013,1,422665,426790,-,4125
466,BUMA.1121.00049,1,1337829,1341950,-,4121
466,BUMA.1121.00072,1,514839,518942,+,4103
466,BUMA.1121.00076,1,845513,849639,-,4126
466,BUMA.1121.00083,1,1150863,1154964,-,4101
466,BUMA.1121.00078,1,1477523,1481650,-,4127
466,BUMA.1121.00095,1,1160734,1164835,-,4101
466,BUMA.1121.00077,1,3208533,3212660,+,4127
466,BUMA.1121.00063,1,539924,544025,+,4101
466,BUMA.1121.00061,1,542967,547070,+,4103
466,BUMA.1121.00050,1,1486366,1490491,-,4125
466,BUMA.1121.00081,1,3282782,3286907,+,4125
466,BUMA.1121.00074,1,3366309,3370433,-,4124
466,BUMA.1121.00062,1,63600,67723,-,4123
466,BUMA.1121.00060,1,1810837,1814963,-,4126
466,BUMA.1121.00070,1,514411,518513,+,4102
466,BUMA.1121.00075,1,30149,34275,+,4126
466,BUMA.1121.00041,1,1779299,1783425,+,4126
466,BUMA.1121.00073,1,541034,545136,+,4102
466,BUMA.1121.00017,1,274068,278193,+,4125
466,BUMA.1121.00066,1,511844,515945,+,4101
466,BUMA.1121.00107,1,357699,361826,+,4127
466,BUMA.1121.00085,1,156314,160439,+,4125
466,BUMA.1121.00030,1,274068,278193,+,4125
466,BUMA.1121.00112,1,2568260,2572388,-,4128
466,BUMA.1121.00002,1,1115992,1120117,-,4125
466,BUMA.1121.00082,1,549864,553965,+,4101
466,BUMA.1121.00014,1,2356755,2360871,-,4116
466,BUMA.1121.00011,1,1110103,1114226,-,4123
466,BUMA.1121.00019,1,274075,278200,+,4125
466,BUMA.1121.00057,1,1609800,1613901,+,4101
466,BUMA.1121.00018,1,1017016,1021132,+,4116
466,BUMA.1121.00039,1,626257,630373,+,4116
466,BUMA.1121.00016,1,2616913,2621028,+,4115
466,BUMA.1121.00004,1,274060,278185,+,4125
466,BUMA.1121.00005,1,3055013,3059116,-,4103
466,BUMA.1121.00100,1,792821,796948,-,4127
466,BUMA.1121.00006,1,3282674,3286799,+,4125
467,BUMA.1121.00027,1,2714355,2724404,+,10049
467,BUMA.1121.00025,1,2228613,2238653,-,10040
467,BUMA.1121.00021,1,1156069,1166109,+,10040
467,BUMA.1121.00023,1,2871388,2881408,+,10020
467,BUMA.1121.00024,1,217011,227061,-,10050
467,BUMA.1121.00033,1,2775691,2785731,+,10040
467,BUMA.1121.00034,1,217025,227075,-,10050
467,BUMA.1121.00036,1,3154768,3164818,+,10050
467,BUMA.1121.00032,1,1814006,1824056,-,10050
467,BUMA.1121.00009,1,1049616,1059693,-,10077
467,BUMA.1121.00008,1,217039,227089,-,10050
467,BUMA.1121.00003,1,3013430,3023467,+,10037
467,BUMA.1121.00109,1,1343732,1353778,-,10046
467,BUMA.1121.00053,1,236999,247046,+,10047
467,BUMA.1121.00110,1,260604,270662,-,10058
467,BUMA.1121.00104,1,752777,762807,-,10030
467,BUMA.1121.00086,1,2869044,2879094,+,10050
467,BUMA.1121.00092,1,3336453,3346510,-,10057
467,BUMA.1121.00096,1,2733424,2743475,-,10051
467,BUMA.1121.00054,1,907536,917586,+,10050
467,BUMA.1121.00097,1,3500124,3510180,-,10056
467,BUMA.1121.00093,1,1279916,1289973,+,10057
467,BUMA.1121.00106,1,300029,310059,+,10030
467,BUMA.1121.00010,1,1140434,1150484,+,10050
467,BUMA.1121.00035,1,1594947,1604987,+,10040
467,BUMA.1121.00108,1,1502059,1512115,+,10056
467,BUMA.1121.00028,1,217025,227075,-,10050
467,BUMA.1121.00094,1,518278,528323,+,10045
467,BUMA.1121.00102,1,696778,706829,-,10051
467,BUMA.1121.00111,1,655772,665811,+,10039
467,BUMA.1121.00089,1,534237,544282,+,10045
467,BUMA.1121.00084,1,745405,755445,+,10040
467,BUMA.1121.00029,1,365743,375783,-,10040
467,BUMA.1121.00012,1,3298986,3309026,+,10040
467,BUMA.1121.00087,1,456662,466712,-,10050
467,BUMA.1121.00043,1,513589,523666,+,10077
467,BUMA.1121.00046,1,1204192,1214242,-,10050
467,BUMA.1121.00037,1,3160809,3170845,+,10036
467,BUMA.1121.00080,1,563854,573899,+,10045
467,BUMA.1121.00079,1,557942,567985,+,10043
467,BUMA.1121.00045,1,3575031,3585082,-,10051
467,BUMA.1121.00071,1,535425,545475,+,10050
467,BUMA.1121.00056,1,3381213,3391258,-,10045
467,BUMA.1121.00065,1,550155,560219,+,10064
467,BUMA.1121.00058,1,28619,38657,-,10038
467,BUMA.1121.00007,1,3596726,3606772,-,10046
467,BUMA.1121.00067,1,3879874,3889931,-,10057
467,BUMA.1121.00090,1,2621394,2631434,+,10040
467,BUMA.1121.00051,1,528505,538549,+,10044
467,BUMA.1121.00020,1,217032,227082,-,10050
467,BUMA.1121.00103,1,3893814,3903864,-,10050
467,BUMA.1121.00048,1,3018201,3028251,-,10050
467,BUMA.1121.00047,1,2450942,2460987,-,10045
467,BUMA.1121.00042,1,816417,826467,+,10050
467,BUMA.1121.00055,1,94984,105041,+,10057
467,BUMA.1121.00031,1,1860832,1870872,+,10040
467,BUMA.1121.00040,1,708672,718720,-,10048
467,BUMA.1121.00044,1,3019028,3029078,-,10050
467,BUMA.1121.00088,1,1409162,1419202,+,10040
467,BUMA.1121.00069,1,508399,518440,+,10041
467,BUMA.1121.00064,1,560542,570599,+,10057
467,BUMA.1121.00105,1,687983,698040,-,10057
467,BUMA.1121.00015,1,91140,101190,-,10050
467,BUMA.1121.00059,1,3768479,3778540,+,10061
467,BUMA.1121.00026,1,1127618,1137668,+,10050
467,BUMA.1121.00022,1,506976,517026,+,10050
467,BUMA.1121.00052,1,502408,512458,-,10050
467,BUMA.1121.00101,1,1946799,1956857,-,10058
467,BUMA.1121.00001,1,3573579,3583619,-,10040
467,BUMA.1121.00038,1,3225519,3235569,-,10050
467,BUMA.1121.00068,1,3385626,3395637,+,10011
467,BUMA.1121.00099,1,1888649,1898695,-,10046
467,BUMA.1121.00091,1,4007567,4017624,-,10057
467,BUMA.1121.00098,1,3240891,3250942,+,10051
467,BUMA.1121.00013,1,473818,483862,+,10044
467,BUMA.1121.00049,1,1326386,1336426,-,10040
467,BUMA.1121.00072,1,519027,529077,+,10050
467,BUMA.1121.00076,1,835378,845428,-,10050
467,BUMA.1121.00083,1,1140728,1150778,-,10050
467,BUMA.1121.00078,1,1467401,1477438,-,10037
467,BUMA.1121.00095,1,1150603,1160648,-,10045
467,BUMA.1121.00077,1,3212745,3222803,+,10058
467,BUMA.1121.00063,1,544110,554160,+,10050
467,BUMA.1121.00061,1,547155,557205,+,10050
467,BUMA.1121.00050,1,1537487,1547537,+,10050
467,BUMA.1121.00081,1,3225704,3235754,-,10050
467,BUMA.1121.00074,1,3356162,3366219,-,10057
467,BUMA.1121.00062,1,53453,63510,-,10057
467,BUMA.1121.00060,1,1800701,1810752,-,10051
467,BUMA.1121.00070,1,518598,528648,+,10050
467,BUMA.1121.00075,1,34360,44409,+,10049
467,BUMA.1121.00041,1,1783510,1793561,+,10051
467,BUMA.1121.00073,1,545221,555271,+,10050
467,BUMA.1121.00017,1,217025,227075,-,10050
467,BUMA.1121.00066,1,516030,526080,+,10050
467,BUMA.1121.00107,1,361911,371967,+,10056
467,BUMA.1121.00085,1,99236,109286,-,10050
467,BUMA.1121.00030,1,217025,227075,-,10050
467,BUMA.1121.00112,1,2558144,2568175,-,10031
467,BUMA.1121.00002,1,1167108,1177158,+,10050
467,BUMA.1121.00082,1,554050,564100,+,10050
467,BUMA.1121.00014,1,2346630,2356670,-,10040
467,BUMA.1121.00011,1,1099961,1110018,-,10057
467,BUMA.1121.00019,1,217032,227082,-,10050
467,BUMA.1121.00057,1,1613986,1624050,+,10064
467,BUMA.1121.00018,1,1021217,1031256,+,10039
467,BUMA.1121.00039,1,630458,640480,+,10022
467,BUMA.1121.00016,1,2621113,2631153,+,10040
467,BUMA.1121.00004,1,217018,227067,-,10049
467,BUMA.1121.00005,1,3044877,3054928,-,10051
467,BUMA.1121.00100,1,782680,792736,-,10056
467,BUMA.1121.00006,1,3225596,3235646,-,10050
468,BUMA.1121.00027,1,2726055,2752971,+,26916
468,BUMA.1121.00025,1,2200036,2226961,-,26925
468,BUMA.1121.00021,1,1167760,1194686,+,26926
468,BUMA.1121.00023,1,2883059,2909997,+,26938
468,BUMA.1121.00024,1,188412,215366,-,26954
468,BUMA.1121.00033,1,2787389,2814315,+,26926
468,BUMA.1121.00034,1,188426,215380,-,26954
468,BUMA.1121.00036,1,3166462,3193405,+,26943
468,BUMA.1121.00032,1,1785407,1812361,-,26954
468,BUMA.1121.00009,1,1021037,1047964,-,26927
468,BUMA.1121.00008,1,188440,215394,-,26954
468,BUMA.1121.00003,1,3025118,3052020,+,26902
468,BUMA.1121.00109,1,1315151,1342080,-,26929
468,BUMA.1121.00053,1,248697,275614,+,26917
468,BUMA.1121.00110,1,232033,258952,-,26919
468,BUMA.1121.00104,1,724206,751125,-,26919
468,BUMA.1121.00086,1,2880738,2907681,+,26943
468,BUMA.1121.00092,1,3307864,3334801,-,26937
468,BUMA.1121.00096,1,2704810,2731772,-,26962
468,BUMA.1121.00054,1,919230,946161,+,26931
468,BUMA.1121.00097,1,3471547,3498472,-,26925
468,BUMA.1121.00093,1,1291624,1318562,+,26938
468,BUMA.1121.00106,1,311710,338636,+,26926
468,BUMA.1121.00010,1,1152128,1179047,+,26919
468,BUMA.1121.00035,1,1606645,1633571,+,26926
468,BUMA.1121.00108,1,1513759,1540679,+,26920
468,BUMA.1121.00028,1,188426,215380,-,26954
468,BUMA.1121.00094,1,529974,556906,+,26932
468,BUMA.1121.00102,1,668189,695126,-,26937
468,BUMA.1121.00111,1,667475,694401,+,26926
468,BUMA.1121.00089,1,545933,572854,+,26921
468,BUMA.1121.00084,1,757096,784022,+,26926
468,BUMA.1121.00029,1,335805,364084,-,28279
468,BUMA.1121.00012,1,3310684,3337610,+,26926
468,BUMA.1121.00087,1,428075,455017,-,26942
468,BUMA.1121.00043,1,525324,552250,+,26926
468,BUMA.1121.00046,1,1175617,1202547,-,26930
468,BUMA.1121.00037,1,3172496,3199422,+,26926
468,BUMA.1121.00080,1,575550,602482,+,26932
468,BUMA.1121.00079,1,569636,596569,+,26933
468,BUMA.1121.00045,1,3546455,3573379,-,26924
468,BUMA.1121.00071,1,547126,574042,+,26916
468,BUMA.1121.00056,1,3352629,3379561,-,26932
468,BUMA.1121.00065,1,561870,588796,+,26926
468,BUMA.1121.00058,1,42,26967,-,26925
468,BUMA.1121.00007,1,3568151,3595074,-,26923
468,BUMA.1121.00067,1,3851308,3878222,-,26914
468,BUMA.1121.00090,1,2633085,2660011,+,26926
468,BUMA.1121.00051,1,540200,567132,+,26932
468,BUMA.1121.00020,1,188433,215387,-,26954
468,BUMA.1121.00103,1,3865231,3892162,-,26931
468,BUMA.1121.00048,1,2989626,3016556,-,26930
468,BUMA.1121.00047,1,2422358,2449290,-,26932
468,BUMA.1121.00042,1,828111,855019,+,26908
468,BUMA.1121.00055,1,106692,133618,+,26926
468,BUMA.1121.00031,1,1872523,1899453,+,26930
468,BUMA.1121.00040,1,680097,707027,-,26930
468,BUMA.1121.00044,1,2990429,3017383,-,26954
468,BUMA.1121.00088,1,1420853,1447779,+,26926
468,BUMA.1121.00069,1,520091,547007,+,26916
468,BUMA.1121.00064,1,572250,599167,+,26917
468,BUMA.1121.00105,1,659406,686331,-,26925
468,BUMA.1121.00015,1,62565,89495,-,26930
468,BUMA.1121.00059,1,3780191,3807117,+,26926
468,BUMA.1121.00026,1,1139312,1166231,+,26919
468,BUMA.1121.00022,1,518670,545613,+,26943
468,BUMA.1121.00052,1,473845,500763,-,26918
468,BUMA.1121.00101,1,1918234,1945147,-,26913
468,BUMA.1121.00001,1,3544994,3571920,-,26926
468,BUMA.1121.00038,1,3196944,3223874,-,26930
468,BUMA.1121.00068,1,3397288,3424216,+,26928
468,BUMA.1121.00099,1,1860064,1886997,-,26933
468,BUMA.1121.00091,1,3978988,4005915,-,26927
468,BUMA.1121.00098,1,3252593,3279541,+,26948
468,BUMA.1121.00013,1,485506,512425,+,26919
468,BUMA.1121.00049,1,1297802,1324727,-,26925
468,BUMA.1121.00072,1,530728,557642,+,26914
468,BUMA.1121.00076,1,806816,833726,-,26910
468,BUMA.1121.00083,1,1112160,1139076,-,26916
468,BUMA.1121.00078,1,1438814,1465742,-,26928
468,BUMA.1121.00095,1,1122039,1148951,-,26912
468,BUMA.1121.00077,1,3224454,3251378,+,26924
468,BUMA.1121.00063,1,555811,582727,+,26916
468,BUMA.1121.00061,1,558856,585770,+,26914
468,BUMA.1121.00050,1,1549181,1576112,+,26931
468,BUMA.1121.00081,1,3197129,3224059,-,26930
468,BUMA.1121.00074,1,3327594,3354510,-,26916
468,BUMA.1121.00062,1,24876,51801,-,26925
468,BUMA.1121.00060,1,1772125,1799049,-,26924
468,BUMA.1121.00070,1,530299,557212,+,26913
468,BUMA.1121.00075,1,46060,72970,+,26910
468,BUMA.1121.00041,1,1795212,1822138,+,26926
468,BUMA.1121.00073,1,556922,583837,+,26915
468,BUMA.1121.00017,1,188426,215380,-,26954
468,BUMA.1121.00066,1,527731,554647,+,26916
468,BUMA.1121.00107,1,373618,400535,+,26917
468,BUMA.1121.00085,1,70673,97591,-,26918
468,BUMA.1121.00030,1,188426,215380,-,26954
468,BUMA.1121.00112,1,2529585,2556492,-,26907
468,BUMA.1121.00002,1,1178802,1205721,+,26919
468,BUMA.1121.00082,1,565751,592668,+,26917
468,BUMA.1121.00014,1,2318053,2344978,-,26925
468,BUMA.1121.00011,1,1071384,1098309,-,26925
468,BUMA.1121.00019,1,188433,215387,-,26954
468,BUMA.1121.00057,1,1626159,1653076,+,26917
468,BUMA.1121.00018,1,1032907,1059833,+,26926
468,BUMA.1121.00039,1,642131,669057,+,26926
468,BUMA.1121.00016,1,2632811,2659748,+,26937
468,BUMA.1121.00004,1,188419,215373,-,26954
468,BUMA.1121.00005,1,3016302,3043225,-,26923
468,BUMA.1121.00100,1,754090,781028,-,26938
468,BUMA.1121.00006,1,3197021,3223951,-,26930
469,BUMA.1121.00027,1,2753110,2762221,+,9111
469,BUMA.1121.00025,1,2190636,2199896,-,9260
469,BUMA.1121.00021,1,1194825,1203953,+,9128
469,BUMA.1121.00023,1,2910136,2919264,+,9128
469,BUMA.1121.00024,1,179015,188272,-,9257
469,BUMA.1121.00033,1,2814454,2823583,+,9129
469,BUMA.1121.00034,1,179029,188286,-,9257
469,BUMA.1121.00036,1,3193544,3202640,+,9096
469,BUMA.1121.00032,1,1776016,1785267,-,9251
469,BUMA.1121.00009,1,1011703,1020897,-,9194
469,BUMA.1121.00008,1,179043,188300,-,9257
469,BUMA.1121.00003,1,3052144,3061289,+,9145
469,BUMA.1121.00109,1,1305746,1315011,-,9265
469,BUMA.1121.00053,1,275753,284882,+,9129
469,BUMA.1121.00110,1,222636,231893,-,9257
469,BUMA.1121.00104,1,714818,724066,-,9248
469,BUMA.1121.00086,1,2907820,2916916,+,9096
469,BUMA.1121.00092,1,3298479,3307724,-,9245
469,BUMA.1121.00096,1,2695424,2704686,-,9262
469,BUMA.1121.00054,1,946300,955396,+,9096
469,BUMA.1121.00097,1,3462166,3471407,-,9241
469,BUMA.1121.00093,1,1318701,1327812,+,9111
469,BUMA.1121.00106,1,338775,347886,+,9111
469,BUMA.1121.00010,1,1179186,1188282,+,9096
469,BUMA.1121.00035,1,1633710,1642838,+,9128
469,BUMA.1121.00108,1,1540818,1549928,+,9110
469,BUMA.1121.00028,1,179029,188286,-,9257
469,BUMA.1121.00094,1,557045,566174,+,9129
469,BUMA.1121.00102,1,658792,668049,-,9257
469,BUMA.1121.00111,1,694540,703668,+,9128
469,BUMA.1121.00089,1,572993,582104,+,9111
469,BUMA.1121.00084,1,784161,793273,+,9112
469,BUMA.1121.00029,1,326388,335665,-,9277
469,BUMA.1121.00012,1,3337749,3346877,+,9128
469,BUMA.1121.00087,1,418828,427935,-,9107
469,BUMA.1121.00043,1,552389,561517,+,9128
469,BUMA.1121.00046,1,1166214,1175477,-,9263
469,BUMA.1121.00037,1,3199561,3208689,+,9128
469,BUMA.1121.00080,1,602621,611732,+,9111
469,BUMA.1121.00079,1,596708,605819,+,9111
469,BUMA.1121.00045,1,3537073,3546315,-,9242
469,BUMA.1121.00071,1,574181,583292,+,9111
469,BUMA.1121.00056,1,3343247,3352489,-,9242
469,BUMA.1121.00065,1,588935,598046,+,9111
469,BUMA.1121.00058,1,4049048,4058327,-,9279
469,BUMA.1121.00007,1,3558763,3568011,-,9248
469,BUMA.1121.00067,1,3841905,3851168,-,9263
469,BUMA.1121.00090,1,2660150,2669278,+,9128
469,BUMA.1121.00051,1,567271,576382,+,9111
469,BUMA.1121.00020,1,179036,188293,-,9257
469,BUMA.1121.00103,1,3855841,3865091,-,9250
469,BUMA.1121.00048,1,2980214,2989486,-,9272
469,BUMA.1121.00047,1,2412976,2422218,-,9242
469,BUMA.1121.00042,1,855158,864254,+,9096
469,BUMA.1121.00055,1,133757,142868,+,9111
469,BUMA.1121.00031,1,1899592,1908720,+,9128
469,BUMA.1121.00040,1,670691,679957,-,9266
469,BUMA.1121.00044,1,2981032,2990289,-,9257
469,BUMA.1121.00088,1,1447918,1457029,+,9111
469,BUMA.1121.00069,1,547146,556257,+,9111
469,BUMA.1121.00064,1,599306,608436,+,9130
469,BUMA.1121.00105,1,650006,659266,-,9260
469,BUMA.1121.00015,1,53162,62425,-,9263
469,BUMA.1121.00059,1,3807256,3816385,+,9129
469,BUMA.1121.00026,1,1166370,1175466,+,9096
469,BUMA.1121.00022,1,545752,554848,+,9096
469,BUMA.1121.00052,1,464442,473705,-,9263
469,BUMA.1121.00101,1,1908850,1918094,-,9244
469,BUMA.1121.00001,1,3535577,3544854,-,9277
469,BUMA.1121.00038,1,3187532,3196804,-,9272
469,BUMA.1121.00068,1,3424355,3433455,+,9100
469,BUMA.1121.00099,1,1850683,1859924,-,9241
469,BUMA.1121.00091,1,3969651,3978848,-,9197
469,BUMA.1121.00098,1,3279680,3288792,+,9112
469,BUMA.1121.00013,1,512564,521660,+,9096
469,BUMA.1121.00049,1,1288384,1297662,-,9278
469,BUMA.1121.00072,1,557781,566892,+,9111
469,BUMA.1121.00076,1,797445,806676,-,9231
469,BUMA.1121.00083,1,1102830,1112020,-,9190
469,BUMA.1121.00078,1,1429437,1438674,-,9237
469,BUMA.1121.00095,1,1112653,1121899,-,9246
469,BUMA.1121.00077,1,3251517,3260643,+,9126
469,BUMA.1121.00063,1,582866,591976,+,9110
469,BUMA.1121.00061,1,585909,595020,+,9111
469,BUMA.1121.00050,1,1576251,1585347,+,9096
469,BUMA.1121.00081,1,3187717,3196989,-,9272
469,BUMA.1121.00074,1,3318191,3327454,-,9263
469,BUMA.1121.00062,1,15476,24736,-,9260
469,BUMA.1121.00060,1,1762743,1771985,-,9242
469,BUMA.1121.00070,1,557351,566462,+,9111
469,BUMA.1121.00075,1,73109,82203,+,9094
469,BUMA.1121.00041,1,1822277,1831385,+,9108
469,BUMA.1121.00073,1,583976,593087,+,9111
469,BUMA.1121.00017,1,179029,188286,-,9257
469,BUMA.1121.00066,1,554786,563897,+,9111
469,BUMA.1121.00107,1,400674,409774,+,9100
469,BUMA.1121.00085,1,61270,70533,-,9263
469,BUMA.1121.00030,1,179029,188286,-,9257
469,BUMA.1121.00112,1,2520188,2529445,-,9257
469,BUMA.1121.00002,1,1205860,1214956,+,9096
469,BUMA.1121.00082,1,592807,601918,+,9111
469,BUMA.1121.00014,1,2308636,2317913,-,9277
469,BUMA.1121.00011,1,1062004,1071244,-,9240
469,BUMA.1121.00019,1,179036,188293,-,9257
469,BUMA.1121.00057,1,1653215,1662326,+,9111
469,BUMA.1121.00018,1,1059972,1069101,+,9129
469,BUMA.1121.00039,1,669196,678324,+,9128
469,BUMA.1121.00016,1,2659887,2669015,+,9128
469,BUMA.1121.00004,1,179022,188279,-,9257
469,BUMA.1121.00005,1,3006954,3016162,-,9208
469,BUMA.1121.00100,1,744688,753950,-,9262
469,BUMA.1121.00006,1,3187609,3196881,-,9272
470,BUMA.1121.00027,1,2762453,2766165,+,3712
470,BUMA.1121.00025,1,2186810,2190539,-,3729
470,BUMA.1121.00021,1,1204200,1207957,+,3757
470,BUMA.1121.00023,1,2919505,2923279,+,3774
470,BUMA.1121.00033,1,2823830,2827567,+,3737
470,BUMA.1121.00009,1,1007765,1011545,-,3780
470,BUMA.1121.00003,1,3061503,3065247,+,3744
470,BUMA.1121.00109,1,1301894,1305649,-,3755
470,BUMA.1121.00053,1,285105,288817,+,3712
470,BUMA.1121.00110,1,217459,221209,-,3750
470,BUMA.1121.00104,1,710981,714721,-,3740
470,BUMA.1121.00092,1,3294643,3298382,-,3739
470,BUMA.1121.00096,1,2691575,2695327,-,3752
470,BUMA.1121.00097,1,3458312,3462069,-,3757
470,BUMA.1121.00093,1,1328044,1331783,+,3739
470,BUMA.1121.00106,1,348115,351868,+,3753
470,BUMA.1121.00035,1,1643085,1646841,+,3756
470,BUMA.1121.00108,1,1550160,1553899,+,3739
470,BUMA.1121.00094,1,566403,570152,+,3749
470,BUMA.1121.00102,1,654983,658695,-,3712
470,BUMA.1121.00111,1,703903,707659,+,3756
470,BUMA.1121.00089,1,582333,586082,+,3749
470,BUMA.1121.00084,1,805447,809177,+,3730
470,BUMA.1121.00029,1,322553,326291,-,3738
470,BUMA.1121.00012,1,3347124,3350880,+,3756
470,BUMA.1121.00043,1,561752,565495,+,3743
470,BUMA.1121.00037,1,3208936,3212674,+,3738
470,BUMA.1121.00080,1,611961,615717,+,3756
470,BUMA.1121.00079,1,606048,609765,+,3717
470,BUMA.1121.00045,1,3533247,3536976,-,3729
470,BUMA.1121.00071,1,583549,587261,+,3712
470,BUMA.1121.00056,1,3339401,3343150,-,3749
470,BUMA.1121.00065,1,629305,633045,+,3740
470,BUMA.1121.00058,1,4035748,4039461,-,3713
470,BUMA.1121.00007,1,3554923,3558666,-,3743
470,BUMA.1121.00067,1,3815722,3819478,-,3756
470,BUMA.1121.00090,1,2669525,2673254,+,3729
470,BUMA.1121.00051,1,576611,580328,+,3717
470,BUMA.1121.00103,1,3852012,3855744,-,3732
470,BUMA.1121.00047,1,2409162,2412879,-,3717
470,BUMA.1121.00055,1,143103,146816,+,3713
470,BUMA.1121.00031,1,1951304,1955042,+,3738
470,BUMA.1121.00088,1,1457261,1461001,+,3740
470,BUMA.1121.00069,1,556496,560200,+,3704
470,BUMA.1121.00064,1,608683,612395,+,3712
470,BUMA.1121.00105,1,629256,632988,-,3732
470,BUMA.1121.00059,1,3816614,3820367,+,3753
470,BUMA.1121.00101,1,1905013,1908753,-,3740
470,BUMA.1121.00001,1,3531734,3535480,-,3746
470,BUMA.1121.00068,1,3444395,3448134,+,3739
470,BUMA.1121.00099,1,1846845,1850586,-,3741
470,BUMA.1121.00091,1,3965763,3969502,-,3739
470,BUMA.1121.00098,1,3289063,3292837,+,3774
470,BUMA.1121.00049,1,1284539,1288287,-,3748
470,BUMA.1121.00072,1,567150,570856,+,3706
470,BUMA.1121.00076,1,793608,797348,-,3740
470,BUMA.1121.00083,1,1061151,1064863,-,3712
470,BUMA.1121.00078,1,1425628,1429340,-,3712
470,BUMA.1121.00095,1,1108835,1112556,-,3721
470,BUMA.1121.00077,1,3262203,3265953,+,3750
470,BUMA.1121.00063,1,592215,595927,+,3712
470,BUMA.1121.00061,1,595259,598971,+,3712
470,BUMA.1121.00074,1,3292008,3295764,-,3756
470,BUMA.1121.00062,1,2173,5889,-,3716
470,BUMA.1121.00060,1,1758917,1762646,-,3729
470,BUMA.1121.00070,1,566720,570432,+,3712
470,BUMA.1121.00075,1,82438,86178,+,3740
470,BUMA.1121.00041,1,1831620,1835341,+,3721
470,BUMA.1121.00073,1,593345,597057,+,3712
470,BUMA.1121.00066,1,564193,567905,+,3712
470,BUMA.1121.00107,1,410009,413749,+,3740
470,BUMA.1121.00112,1,2500441,2504189,-,3748
470,BUMA.1121.00082,1,639965,643677,+,3712
470,BUMA.1121.00014,1,2265069,2268807,-,3738
470,BUMA.1121.00011,1,1058159,1061907,-,3748
470,BUMA.1121.00057,1,1662558,1666270,+,3712
470,BUMA.1121.00018,1,1069330,1073058,+,3728
470,BUMA.1121.00039,1,678571,682354,+,3783
470,BUMA.1121.00016,1,2700277,2704015,+,3738
470,BUMA.1121.00005,1,3003075,3006805,-,3730
470,BUMA.1121.00100,1,740874,744591,-,3717
471,BUMA.1121.00027,1,2766223,2770166,+,3943
471,BUMA.1121.00071,1,587312,591263,+,3951
471,BUMA.1121.00064,1,612446,616397,+,3951
471,BUMA.1121.00083,1,1057148,1061100,-,3952
471,BUMA.1121.00041,1,1835392,1839343,+,3951
471,BUMA.1121.00066,1,567956,571907,+,3951
471,BUMA.1121.00082,1,643728,647679,+,3951
471,BUMA.1121.00057,1,1666328,1670272,+,3944
472,BUMA.1121.00027,1,2775919,2783451,+,7532
472,BUMA.1121.00025,1,2176840,2184374,-,7534
472,BUMA.1121.00021,1,1210393,1217926,+,7533
472,BUMA.1121.00023,1,2925715,2933248,+,7533
472,BUMA.1121.00024,1,7175,14644,+,7469
472,BUMA.1121.00033,1,2830003,2837536,+,7533
472,BUMA.1121.00034,1,7175,14644,+,7469
472,BUMA.1121.00036,1,434656,442140,-,7484
472,BUMA.1121.00032,1,1604160,1611629,+,7469
472,BUMA.1121.00009,1,996562,1004096,-,7534
472,BUMA.1121.00008,1,7175,14644,+,7469
472,BUMA.1121.00003,1,3067466,3074999,+,7533
472,BUMA.1121.00109,1,1292508,1300042,-,7534
472,BUMA.1121.00053,1,291038,298569,+,7531
472,BUMA.1121.00110,1,207469,215006,-,7537
472,BUMA.1121.00104,1,701011,708545,-,7534
472,BUMA.1121.00086,1,2444570,2452040,+,7470
472,BUMA.1121.00092,1,3282082,3289607,-,7525
472,BUMA.1121.00096,1,2680511,2688045,-,7534
472,BUMA.1121.00054,1,618423,625898,-,7475
472,BUMA.1121.00097,1,3443112,3450646,-,7534
472,BUMA.1121.00093,1,1336819,1344343,+,7524
472,BUMA.1121.00106,1,355398,362931,+,7533
472,BUMA.1121.00010,1,420451,427921,+,7470
472,BUMA.1121.00035,1,1649277,1656810,+,7533
472,BUMA.1121.00108,1,1558674,1566207,+,7533
472,BUMA.1121.00028,1,7175,14644,+,7469
472,BUMA.1121.00094,1,572604,580137,+,7533
472,BUMA.1121.00102,1,645598,653132,-,7534
472,BUMA.1121.00111,1,710095,717628,+,7533
472,BUMA.1121.00089,1,588535,596068,+,7533
472,BUMA.1121.00084,1,811028,818561,+,7533
472,BUMA.1121.00029,1,312583,320117,-,7534
472,BUMA.1121.00012,1,3354651,3362184,+,7533
472,BUMA.1121.00087,1,883577,891048,-,7471
472,BUMA.1121.00043,1,567931,575464,+,7533
472,BUMA.1121.00046,1,1616791,1624261,+,7470
472,BUMA.1121.00037,1,3216346,3223879,+,7533
472,BUMA.1121.00080,1,620753,628286,+,7533
472,BUMA.1121.00079,1,612199,619731,+,7532
472,BUMA.1121.00045,1,3521684,3529218,-,7534
472,BUMA.1121.00071,1,597018,604551,+,7533
472,BUMA.1121.00056,1,3329414,3336948,-,7534
472,BUMA.1121.00065,1,635481,643014,+,7533
472,BUMA.1121.00058,1,4025762,4033296,-,7534
472,BUMA.1121.00007,1,3543859,3551393,-,7534
472,BUMA.1121.00067,1,3803152,3810686,-,7534
472,BUMA.1121.00090,1,2675689,2683222,+,7533
472,BUMA.1121.00051,1,582764,590297,+,7533
472,BUMA.1121.00020,1,7175,14644,+,7469
472,BUMA.1121.00103,1,3841014,3848548,-,7534
472,BUMA.1121.00048,1,3309889,3317364,+,7475
472,BUMA.1121.00047,1,2399192,2406726,-,7534
472,BUMA.1121.00042,1,538221,545737,+,7516
472,BUMA.1121.00055,1,150346,157879,+,7533
472,BUMA.1121.00031,1,1957477,1965010,+,7533
472,BUMA.1121.00040,1,6839,14308,+,7469
472,BUMA.1121.00044,1,2809178,2816647,+,7469
472,BUMA.1121.00088,1,1463453,1470986,+,7533
472,BUMA.1121.00069,1,560336,567869,+,7533
472,BUMA.1121.00064,1,622152,629685,+,7533
472,BUMA.1121.00105,1,612426,619960,-,7534
472,BUMA.1121.00015,1,551496,558966,+,7470
472,BUMA.1121.00059,1,3828418,3835951,+,7533
472,BUMA.1121.00026,1,774072,781582,+,7510
472,BUMA.1121.00022,1,1149503,1156974,-,7471
472,BUMA.1121.00052,1,3236503,3243973,+,7470
472,BUMA.1121.00101,1,1892705,1900239,-,7534
472,BUMA.1121.00001,1,3521764,3529298,-,7534
472,BUMA.1121.00038,1,7175,14650,+,7475
472,BUMA.1121.00068,1,3451595,3459126,+,7531
472,BUMA.1121.00099,1,1835781,1843315,-,7534
472,BUMA.1121.00091,1,3956009,3963543,-,7534
472,BUMA.1121.00098,1,3297888,3305421,+,7533
472,BUMA.1121.00013,1,1206969,1214440,-,7471
472,BUMA.1121.00049,1,1273475,1281009,-,7534
472,BUMA.1121.00072,1,570971,578504,+,7533
472,BUMA.1121.00076,1,783650,791172,-,7522
472,BUMA.1121.00083,1,1043860,1051394,-,7534
472,BUMA.1121.00078,1,1416246,1423780,-,7534
472,BUMA.1121.00095,1,1094871,1102405,-,7534
472,BUMA.1121.00077,1,3268406,3275942,+,7536
472,BUMA.1121.00063,1,596364,603897,+,7533
472,BUMA.1121.00061,1,599311,606844,+,7533
472,BUMA.1121.00050,1,1127444,1134915,-,7471
472,BUMA.1121.00081,1,7244,14719,+,7475
472,BUMA.1121.00074,1,3279438,3286972,-,7534
472,BUMA.1121.00062,1,3968985,3976519,-,7534
472,BUMA.1121.00060,1,1747354,1754888,-,7534
472,BUMA.1121.00070,1,570597,578130,+,7533
472,BUMA.1121.00075,1,88613,96134,+,7521
472,BUMA.1121.00041,1,1845099,1852632,+,7533
472,BUMA.1121.00073,1,597222,604755,+,7533
472,BUMA.1121.00017,1,7175,14644,+,7469
472,BUMA.1121.00066,1,577662,585195,+,7533
472,BUMA.1121.00107,1,420179,427712,+,7533
472,BUMA.1121.00085,1,2833449,2840919,+,7470
472,BUMA.1121.00030,1,7175,14644,+,7469
472,BUMA.1121.00112,1,2488000,2495534,-,7534
472,BUMA.1121.00002,1,445775,453245,+,7470
472,BUMA.1121.00082,1,653434,660967,+,7533
472,BUMA.1121.00014,1,2255100,2262634,-,7534
472,BUMA.1121.00011,1,1047459,1054993,-,7534
472,BUMA.1121.00019,1,7175,14644,+,7469
472,BUMA.1121.00057,1,1676027,1683560,+,7533
472,BUMA.1121.00018,1,1075494,1083027,+,7533
472,BUMA.1121.00039,1,686125,693658,+,7533
472,BUMA.1121.00016,1,2706449,2713982,+,7533
472,BUMA.1121.00004,1,7175,14644,+,7469
472,BUMA.1121.00005,1,2993689,3001223,-,7534
472,BUMA.1121.00100,1,724243,733091,-,8848
472,BUMA.1121.00006,1,7175,14650,+,7475
473,BUMA.1121.00027,1,2788827,2823326,+,34499
473,BUMA.1121.00025,1,2136919,2171465,-,34546
473,BUMA.1121.00021,1,1223302,1257848,+,34546
473,BUMA.1121.00023,1,2948760,2983306,+,34546
473,BUMA.1121.00024,1,20016,54514,+,34498
473,BUMA.1121.00033,1,2842911,2877456,+,34545
473,BUMA.1121.00034,1,20016,54514,+,34498
473,BUMA.1121.00036,1,393562,428060,-,34498
473,BUMA.1121.00032,1,1617001,1651499,+,34498
473,BUMA.1121.00009,1,956660,991178,-,34518
473,BUMA.1121.00008,1,20016,54514,+,34498
473,BUMA.1121.00003,1,3080380,3114883,+,34503
473,BUMA.1121.00109,1,1252619,1287133,-,34514
473,BUMA.1121.00053,1,314081,348600,+,34519
473,BUMA.1121.00110,1,156153,190636,-,34483
473,BUMA.1121.00104,1,661109,695627,-,34518
473,BUMA.1121.00086,1,2457412,2491910,+,34498
473,BUMA.1121.00092,1,3242190,3276707,-,34517
473,BUMA.1121.00096,1,2640674,2675130,-,34456
473,BUMA.1121.00054,1,578560,613052,-,34492
473,BUMA.1121.00097,1,3393088,3427602,-,34514
473,BUMA.1121.00093,1,1349719,1384236,+,34517
473,BUMA.1121.00106,1,368307,402820,+,34513
473,BUMA.1121.00010,1,433293,467790,+,34497
473,BUMA.1121.00035,1,1672322,1706855,+,34533
473,BUMA.1121.00108,1,1581718,1616226,+,34508
473,BUMA.1121.00028,1,20016,54514,+,34498
473,BUMA.1121.00094,1,585513,620026,+,34513
473,BUMA.1121.00102,1,595618,630091,-,34473
473,BUMA.1121.00111,1,734732,769280,+,34548
473,BUMA.1121.00089,1,601444,635957,+,34513
473,BUMA.1121.00084,1,823937,858428,+,34491
473,BUMA.1121.00029,1,262539,297072,-,34533
473,BUMA.1121.00012,1,3367560,3402093,+,34533
473,BUMA.1121.00087,1,843708,878206,-,34498
473,BUMA.1121.00043,1,580840,615384,+,34544
473,BUMA.1121.00046,1,1629633,1664134,+,34501
473,BUMA.1121.00037,1,3229255,3263801,+,34546
473,BUMA.1121.00080,1,633671,668191,+,34520
473,BUMA.1121.00079,1,625100,659620,+,34520
473,BUMA.1121.00045,1,3471635,3506173,-,34538
473,BUMA.1121.00071,1,609927,644435,+,34508
473,BUMA.1121.00056,1,3289526,3324039,-,34513
473,BUMA.1121.00065,1,648390,682923,+,34533
473,BUMA.1121.00058,1,3984524,4019074,-,34550
473,BUMA.1121.00007,1,3493863,3528353,-,34490
473,BUMA.1121.00067,1,3763255,3797768,-,34513
473,BUMA.1121.00090,1,2698734,2733253,+,34519
473,BUMA.1121.00051,1,595667,630178,+,34511
473,BUMA.1121.00020,1,20016,54514,+,34498
473,BUMA.1121.00103,1,3790990,3825504,-,34514
473,BUMA.1121.00048,1,3322736,3357228,+,34492
473,BUMA.1121.00047,1,2359303,2393823,-,34520
473,BUMA.1121.00042,1,550397,584887,+,34490
473,BUMA.1121.00055,1,173397,207900,+,34503
473,BUMA.1121.00031,1,1980522,2015068,+,34546
473,BUMA.1121.00040,1,19680,54178,+,34498
473,BUMA.1121.00044,1,2822019,2856517,+,34498
473,BUMA.1121.00088,1,1476362,1510875,+,34513
473,BUMA.1121.00069,1,573245,607735,+,34490
473,BUMA.1121.00064,1,635070,669573,+,34503
473,BUMA.1121.00105,1,572539,607051,-,34512
473,BUMA.1121.00015,1,564338,598839,+,34501
473,BUMA.1121.00059,1,3841327,3875828,+,34501
473,BUMA.1121.00026,1,786242,820685,+,34443
473,BUMA.1121.00022,1,1109634,1144132,-,34498
473,BUMA.1121.00052,1,3249345,3283843,+,34498
473,BUMA.1121.00101,1,1852823,1887325,-,34502
473,BUMA.1121.00001,1,3471721,3506253,-,34532
473,BUMA.1121.00038,1,20022,54514,+,34492
473,BUMA.1121.00068,1,3464507,3498968,+,34461
473,BUMA.1121.00099,1,1795910,1830398,-,34488
473,BUMA.1121.00091,1,3905981,3940502,-,34521
473,BUMA.1121.00098,1,3312119,3346620,+,34501
473,BUMA.1121.00013,1,1167100,1201598,-,34498
473,BUMA.1121.00049,1,1232265,1266770,-,34505
473,BUMA.1121.00072,1,583880,618388,+,34508
473,BUMA.1121.00076,1,743774,778275,-,34501
473,BUMA.1121.00083,1,1003977,1038485,-,34508
473,BUMA.1121.00078,1,1376367,1410875,-,34508
473,BUMA.1121.00095,1,1044859,1079360,-,34501
473,BUMA.1121.00077,1,3292776,3327256,+,34480
473,BUMA.1121.00063,1,609273,643775,+,34502
473,BUMA.1121.00061,1,612220,646728,+,34508
473,BUMA.1121.00050,1,1087572,1122073,-,34501
473,BUMA.1121.00081,1,20091,54583,+,34492
473,BUMA.1121.00074,1,3239541,3274054,-,34513
473,BUMA.1121.00062,1,3929104,3963605,-,34501
473,BUMA.1121.00060,1,1697305,1731843,-,34538
473,BUMA.1121.00070,1,583506,618014,+,34508
473,BUMA.1121.00075,1,101510,136011,+,34501
473,BUMA.1121.00041,1,1868144,1902678,+,34534
473,BUMA.1121.00073,1,610131,644639,+,34508
473,BUMA.1121.00017,1,20016,54514,+,34498
473,BUMA.1121.00066,1,590571,625079,+,34508
473,BUMA.1121.00107,1,443225,477726,+,34501
473,BUMA.1121.00085,1,2846291,2880789,+,34498
473,BUMA.1121.00030,1,20016,54514,+,34498
473,BUMA.1121.00112,1,2448102,2482616,-,34514
473,BUMA.1121.00002,1,458617,493115,+,34498
473,BUMA.1121.00082,1,666343,700851,+,34508
473,BUMA.1121.00014,1,2205043,2239589,-,34546
473,BUMA.1121.00011,1,1007596,1042088,-,34492
473,BUMA.1121.00019,1,20016,54514,+,34498
473,BUMA.1121.00057,1,1688936,1723436,+,34500
473,BUMA.1121.00018,1,1088403,1122949,+,34546
473,BUMA.1121.00039,1,699034,733575,+,34541
473,BUMA.1121.00016,1,2719358,2753916,+,34558
473,BUMA.1121.00004,1,20016,54514,+,34498
473,BUMA.1121.00005,1,2953780,2988307,-,34527
473,BUMA.1121.00100,1,684373,718866,-,34493
473,BUMA.1121.00006,1,20022,54514,+,34492
474,BUMA.1121.00027,1,2823327,2827419,+,4092
474,BUMA.1121.00025,1,2132825,2136917,-,4092
474,BUMA.1121.00021,1,1257849,1261941,+,4092
474,BUMA.1121.00023,1,2983307,2987399,+,4092
474,BUMA.1121.00024,1,54515,58621,+,4106
474,BUMA.1121.00033,1,2877457,2881549,+,4092
474,BUMA.1121.00034,1,54515,58621,+,4106
474,BUMA.1121.00036,1,389455,393560,-,4105
474,BUMA.1121.00032,1,1651500,1655606,+,4106
474,BUMA.1121.00009,1,952566,956658,-,4092
474,BUMA.1121.00008,1,54515,58621,+,4106
474,BUMA.1121.00003,1,3114884,3118975,+,4091
474,BUMA.1121.00109,1,1248534,1252617,-,4083
474,BUMA.1121.00053,1,348601,352692,+,4091
474,BUMA.1121.00110,1,152045,156151,-,4106
474,BUMA.1121.00104,1,657016,661107,-,4091
474,BUMA.1121.00086,1,2491911,2496017,+,4106
474,BUMA.1121.00092,1,3238096,3242188,-,4092
474,BUMA.1121.00096,1,2636588,2640672,-,4084
474,BUMA.1121.00054,1,574453,578558,-,4105
474,BUMA.1121.00097,1,3388995,3393086,-,4091
474,BUMA.1121.00093,1,1384237,1388329,+,4092
474,BUMA.1121.00106,1,402821,406912,+,4091
474,BUMA.1121.00010,1,467791,471896,+,4105
474,BUMA.1121.00035,1,1706856,1710948,+,4092
474,BUMA.1121.00108,1,1616227,1620318,+,4091
474,BUMA.1121.00028,1,54515,58621,+,4106
474,BUMA.1121.00094,1,620027,624118,+,4091
474,BUMA.1121.00102,1,591525,595616,-,4091
474,BUMA.1121.00111,1,769281,773373,+,4092
474,BUMA.1121.00089,1,635958,640049,+,4091
474,BUMA.1121.00084,1,858429,862520,+,4091
474,BUMA.1121.00029,1,258445,262537,-,4092
474,BUMA.1121.00012,1,3402094,3406186,+,4092
474,BUMA.1121.00087,1,839601,843706,-,4105
474,BUMA.1121.00043,1,615385,619477,+,4092
474,BUMA.1121.00046,1,1664135,1668241,+,4106
474,BUMA.1121.00037,1,3263802,3267894,+,4092
474,BUMA.1121.00080,1,668192,672283,+,4091
474,BUMA.1121.00079,1,659621,663712,+,4091
474,BUMA.1121.00045,1,3467528,3471633,-,4105
474,BUMA.1121.00071,1,644436,648527,+,4091
474,BUMA.1121.00056,1,3285433,3289524,-,4091
474,BUMA.1121.00065,1,682924,687015,+,4091
474,BUMA.1121.00058,1,3980430,3984522,-,4092
474,BUMA.1121.00007,1,3489765,3493861,-,4096
474,BUMA.1121.00067,1,3759162,3763253,-,4091
474,BUMA.1121.00090,1,2733254,2737346,+,4092
474,BUMA.1121.00051,1,630179,634269,+,4090
474,BUMA.1121.00020,1,54515,58621,+,4106
474,BUMA.1121.00103,1,3786891,3790988,-,4097
474,BUMA.1121.00048,1,3357229,3361335,+,4106
474,BUMA.1121.00047,1,2355209,2359301,-,4092
474,BUMA.1121.00042,1,584888,588994,+,4106
474,BUMA.1121.00055,1,207901,211993,+,4092
474,BUMA.1121.00031,1,2015069,2019161,+,4092
474,BUMA.1121.00040,1,54179,58285,+,4106
474,BUMA.1121.00044,1,2856518,2860624,+,4106
474,BUMA.1121.00088,1,1510876,1514968,+,4092
474,BUMA.1121.00069,1,607736,611828,+,4092
474,BUMA.1121.00064,1,669574,673665,+,4091
474,BUMA.1121.00105,1,568447,572537,-,4090
474,BUMA.1121.00015,1,598840,602946,+,4106
474,BUMA.1121.00059,1,3875829,3879921,+,4092
474,BUMA.1121.00022,1,1105527,1109632,-,4105
474,BUMA.1121.00052,1,3283844,3287950,+,4106
474,BUMA.1121.00101,1,1848730,1852821,-,4091
474,BUMA.1121.00001,1,3467627,3471719,-,4092
474,BUMA.1121.00038,1,54515,58621,+,4106
474,BUMA.1121.00068,1,3498969,3503051,+,4082
474,BUMA.1121.00099,1,1791817,1795908,-,4091
474,BUMA.1121.00091,1,3901888,3905979,-,4091
474,BUMA.1121.00098,1,3346621,3350712,+,4091
474,BUMA.1121.00013,1,1162993,1167098,-,4105
474,BUMA.1121.00049,1,1228172,1232263,-,4091
474,BUMA.1121.00072,1,618389,622481,+,4092
474,BUMA.1121.00076,1,739681,743772,-,4091
474,BUMA.1121.00083,1,999883,1003975,-,4092
474,BUMA.1121.00078,1,1372262,1376365,-,4103
474,BUMA.1121.00095,1,1040766,1044857,-,4091
474,BUMA.1121.00077,1,3327257,3331362,+,4105
474,BUMA.1121.00063,1,643776,647868,+,4092
474,BUMA.1121.00061,1,646729,650821,+,4092
474,BUMA.1121.00050,1,1083465,1087570,-,4105
474,BUMA.1121.00081,1,54584,58690,+,4106
474,BUMA.1121.00074,1,3235448,3239539,-,4091
474,BUMA.1121.00062,1,3925011,3929102,-,4091
474,BUMA.1121.00060,1,1693198,1697303,-,4105
474,BUMA.1121.00070,1,618015,622107,+,4092
474,BUMA.1121.00075,1,136012,140103,+,4091
474,BUMA.1121.00041,1,1902679,1906771,+,4092
474,BUMA.1121.00073,1,644640,648732,+,4092
474,BUMA.1121.00017,1,54515,58621,+,4106
474,BUMA.1121.00066,1,625080,629172,+,4092
474,BUMA.1121.00107,1,477727,481821,+,4094
474,BUMA.1121.00085,1,2880790,2884896,+,4106
474,BUMA.1121.00030,1,54515,58621,+,4106
474,BUMA.1121.00112,1,2444009,2448100,-,4091
474,BUMA.1121.00002,1,493116,497222,+,4106
474,BUMA.1121.00082,1,700852,704944,+,4092
474,BUMA.1121.00014,1,2200949,2205041,-,4092
474,BUMA.1121.00011,1,1003487,1007594,-,4107
474,BUMA.1121.00019,1,54515,58621,+,4106
474,BUMA.1121.00057,1,1723437,1727529,+,4092
474,BUMA.1121.00018,1,1122950,1127042,+,4092
474,BUMA.1121.00039,1,733576,737668,+,4092
474,BUMA.1121.00016,1,2753917,2758009,+,4092
474,BUMA.1121.00004,1,54515,58621,+,4106
474,BUMA.1121.00005,1,2949686,2953778,-,4092
474,BUMA.1121.00100,1,680280,684371,-,4091
474,BUMA.1121.00006,1,54515,58621,+,4106
475,BUMA.1121.00027,1,2827421,2854744,+,27323
475,BUMA.1121.00025,1,2105481,2132824,-,27343
475,BUMA.1121.00021,1,1261943,1289278,+,27335
475,BUMA.1121.00023,1,2987401,3014771,+,27370
475,BUMA.1121.00024,1,3381681,3408949,-,27268
475,BUMA.1121.00033,1,2881551,2908880,+,27329
475,BUMA.1121.00034,1,3483225,3510508,-,27283
475,BUMA.1121.00036,1,512719,539987,+,27268
475,BUMA.1121.00032,1,1506399,1533667,-,27268
475,BUMA.1121.00009,1,925268,952565,-,27297
475,BUMA.1121.00008,1,3464495,3491763,-,27268
475,BUMA.1121.00003,1,3118977,3146316,+,27339
475,BUMA.1121.00109,1,1221183,1248533,-,27350
475,BUMA.1121.00053,1,352694,380057,+,27363
475,BUMA.1121.00110,1,123146,150466,-,27320
475,BUMA.1121.00104,1,629699,657015,-,27316
475,BUMA.1121.00086,1,2340130,2367398,+,27268
475,BUMA.1121.00092,1,3210752,3238095,-,27343
475,BUMA.1121.00096,1,2609254,2636587,-,27333
475,BUMA.1121.00054,1,425545,452813,-,27268
475,BUMA.1121.00097,1,3361661,3388994,-,27333
475,BUMA.1121.00093,1,1388331,1415674,+,27343
475,BUMA.1121.00106,1,406914,434240,+,27326
475,BUMA.1121.00010,1,1683922,1711190,+,27268
475,BUMA.1121.00035,1,1710950,1738295,+,27345
475,BUMA.1121.00108,1,1620320,1647647,+,27327
475,BUMA.1121.00028,1,3452874,3480142,-,27268
475,BUMA.1121.00094,1,624120,651447,+,27327
475,BUMA.1121.00102,1,564184,591524,-,27340
475,BUMA.1121.00111,1,773375,800717,+,27342
475,BUMA.1121.00089,1,640051,667377,+,27326
475,BUMA.1121.00084,1,862522,889887,+,27365
475,BUMA.1121.00029,1,231100,258444,-,27344
475,BUMA.1121.00012,1,3406188,3433537,+,27349
475,BUMA.1121.00087,1,968220,995488,-,27268
475,BUMA.1121.00043,1,619479,646817,+,27338
475,BUMA.1121.00046,1,1669821,1697089,+,27268
475,BUMA.1121.00037,1,3267896,3295278,+,27382
475,BUMA.1121.00080,1,672285,699640,+,27355
475,BUMA.1121.00079,1,663714,691047,+,27333
475,BUMA.1121.00045,1,3438614,3465947,-,27333
475,BUMA.1121.00071,1,648529,675796,+,27267
475,BUMA.1121.00056,1,3258106,3285432,-,27326
475,BUMA.1121.00065,1,687017,714387,+,27370
475,BUMA.1121.00058,1,3953103,3980429,-,27326
475,BUMA.1121.00007,1,3462458,3489764,-,27306
475,BUMA.1121.00067,1,3731825,3759161,-,27336
475,BUMA.1121.00090,1,2737348,2764697,+,27349
475,BUMA.1121.00051,1,634271,661636,+,27365
475,BUMA.1121.00020,1,3517709,3544977,-,27268
475,BUMA.1121.00103,1,3757976,3785310,-,27334
475,BUMA.1121.00048,1,3482975,3510187,+,27212
475,BUMA.1121.00047,1,2327833,2355208,-,27375
475,BUMA.1121.00042,1,440347,467635,-,27288
475,BUMA.1121.00055,1,211995,239334,+,27339
475,BUMA.1121.00031,1,2019163,2046583,+,27420
475,BUMA.1121.00040,1,3464428,3491681,-,27253
475,BUMA.1121.00044,1,2711395,2738678,-,27283
475,BUMA.1121.00088,1,1514970,1542306,+,27336
475,BUMA.1121.00069,1,611830,639154,+,27324
475,BUMA.1121.00064,1,673667,701000,+,27333
475,BUMA.1121.00105,1,541094,568446,-,27352
475,BUMA.1121.00015,1,604525,631793,+,27268
475,BUMA.1121.00059,1,3879923,3907242,+,27319
475,BUMA.1121.00026,1,675240,702538,-,27298
475,BUMA.1121.00022,1,1234163,1261431,-,27268
475,BUMA.1121.00052,1,3138866,3166134,-,27268
475,BUMA.1121.00101,1,1821427,1848729,-,27302
475,BUMA.1121.00001,1,3440281,3467626,-,27345
475,BUMA.1121.00038,1,180261,207529,+,27268
475,BUMA.1121.00068,1,3503053,3530403,+,27350
475,BUMA.1121.00099,1,1764505,1791816,-,27311
475,BUMA.1121.00091,1,3874564,3901887,-,27323
475,BUMA.1121.00098,1,3350714,3378061,+,27347
475,BUMA.1121.00013,1,3430994,3458262,-,27268
475,BUMA.1121.00049,1,1200846,1228171,-,27325
475,BUMA.1121.00072,1,622483,649807,+,27324
475,BUMA.1121.00076,1,712345,739680,-,27335
475,BUMA.1121.00083,1,972558,999882,-,27324
475,BUMA.1121.00078,1,1343324,1370682,-,27358
475,BUMA.1121.00095,1,1013440,1040765,-,27325
475,BUMA.1121.00077,1,3332939,3360262,+,27323
475,BUMA.1121.00063,1,647870,675194,+,27324
475,BUMA.1121.00061,1,650823,678147,+,27324
475,BUMA.1121.00050,1,1054617,1081885,-,27268
475,BUMA.1121.00081,1,180330,207598,+,27268
475,BUMA.1121.00074,1,3208114,3235447,-,27333
475,BUMA.1121.00062,1,3897634,3925010,-,27376
475,BUMA.1121.00060,1,1664284,1691617,-,27333
475,BUMA.1121.00070,1,622109,649433,+,27324
475,BUMA.1121.00075,1,140105,167439,+,27334
475,BUMA.1121.00041,1,1906773,1934099,+,27326
475,BUMA.1121.00073,1,648734,676058,+,27324
475,BUMA.1121.00017,1,3380890,3408173,-,27283
475,BUMA.1121.00066,1,629174,656498,+,27324
475,BUMA.1121.00107,1,481823,509163,+,27340
475,BUMA.1121.00085,1,2735812,2763080,-,27268
475,BUMA.1121.00030,1,3380955,3408238,-,27283
475,BUMA.1121.00112,1,2416679,2444008,-,27329
475,BUMA.1121.00002,1,1709610,1736878,+,27268
475,BUMA.1121.00082,1,704946,732270,+,27324
475,BUMA.1121.00014,1,2173576,2200948,-,27372
475,BUMA.1121.00011,1,974574,1001908,-,27334
475,BUMA.1121.00019,1,3404222,3431490,-,27268
475,BUMA.1121.00057,1,1727531,1754855,+,27324
475,BUMA.1121.00018,1,1127044,1154387,+,27343
475,BUMA.1121.00039,1,737670,765026,+,27356
475,BUMA.1121.00016,1,2758011,2785378,+,27367
475,BUMA.1121.00004,1,3533124,3560392,-,27268
475,BUMA.1121.00005,1,2922376,2949685,-,27309
475,BUMA.1121.00100,1,652959,680279,-,27320
475,BUMA.1121.00006,1,180261,207529,+,27268
476,BUMA.1121.00027,1,2854745,2864687,+,9942
476,BUMA.1121.00025,1,2095546,2105479,-,9933
476,BUMA.1121.00021,1,1289279,1299421,+,10142
476,BUMA.1121.00023,1,3014772,3024924,+,10152
476,BUMA.1121.00024,1,3371695,3381679,-,9984
476,BUMA.1121.00033,1,2908881,2918971,+,10090
476,BUMA.1121.00034,1,3473239,3483223,-,9984
476,BUMA.1121.00036,1,539988,549973,+,9985
476,BUMA.1121.00032,1,1496413,1506397,-,9984
476,BUMA.1121.00009,1,915167,925266,-,10099
476,BUMA.1121.00008,1,3454509,3464493,-,9984
476,BUMA.1121.00003,1,3146317,3156261,+,9944
476,BUMA.1121.00109,1,1211104,1221181,-,10077
476,BUMA.1121.00053,1,380058,390051,+,9993
476,BUMA.1121.00110,1,113067,123144,-,10077
476,BUMA.1121.00104,1,619715,629697,-,9982
476,BUMA.1121.00086,1,2367399,2377384,+,9985
476,BUMA.1121.00092,1,3200809,3210750,-,9941
476,BUMA.1121.00096,1,2599163,2609252,-,10089
476,BUMA.1121.00054,1,415559,425543,-,9984
476,BUMA.1121.00097,1,3351565,3361659,-,10094
476,BUMA.1121.00093,1,1415675,1425617,+,9942
476,BUMA.1121.00106,1,434241,444331,+,10090
476,BUMA.1121.00010,1,1711191,1721176,+,9985
476,BUMA.1121.00035,1,1738296,1748386,+,10090
476,BUMA.1121.00108,1,1647648,1657644,+,9996
476,BUMA.1121.00028,1,3442888,3452872,-,9984
476,BUMA.1121.00094,1,651448,661434,+,9986
476,BUMA.1121.00102,1,554222,564182,-,9960
476,BUMA.1121.00111,1,800718,810808,+,10090
476,BUMA.1121.00089,1,667378,677364,+,9986
476,BUMA.1121.00084,1,889888,899874,+,9986
476,BUMA.1121.00029,1,221009,231098,-,10089
476,BUMA.1121.00012,1,3433538,3443576,+,10038
476,BUMA.1121.00087,1,958234,968218,-,9984
476,BUMA.1121.00043,1,646818,656918,+,10100
476,BUMA.1121.00046,1,1697090,1707075,+,9985
476,BUMA.1121.00037,1,3295279,3305327,+,10048
476,BUMA.1121.00080,1,699641,709627,+,9986
476,BUMA.1121.00079,1,691048,701137,+,10089
476,BUMA.1121.00045,1,3428695,3438612,-,9917
476,BUMA.1121.00071,1,675797,685780,+,9983
476,BUMA.1121.00056,1,3248119,3258104,-,9985
476,BUMA.1121.00065,1,714388,724374,+,9986
476,BUMA.1121.00058,1,3943012,3953101,-,10089
476,BUMA.1121.00007,1,3452513,3462456,-,9943
476,BUMA.1121.00067,1,3721786,3731823,-,10037
476,BUMA.1121.00090,1,2764698,2774840,+,10142
476,BUMA.1121.00051,1,661637,671622,+,9985
476,BUMA.1121.00020,1,3507723,3517707,-,9984
476,BUMA.1121.00103,1,3747885,3757974,-,10089
476,BUMA.1121.00048,1,42,10042,+,10000
476,BUMA.1121.00047,1,2317846,2327831,-,9985
476,BUMA.1121.00042,1,430361,440345,-,9984
476,BUMA.1121.00055,1,239335,249281,+,9946
476,BUMA.1121.00031,1,2046584,2056622,+,10038
476,BUMA.1121.00040,1,3454442,3464426,-,9984
476,BUMA.1121.00044,1,2701409,2711393,-,9984
476,BUMA.1121.00088,1,1542307,1552293,+,9986
476,BUMA.1121.00069,1,639155,649140,+,9985
476,BUMA.1121.00064,1,701001,711039,+,10038
476,BUMA.1121.00105,1,531160,541092,-,9932
476,BUMA.1121.00015,1,631794,641779,+,9985
476,BUMA.1121.00059,1,3907243,3917229,+,9986
476,BUMA.1121.00026,1,665254,675238,-,9984
476,BUMA.1121.00022,1,1224177,1234161,-,9984
476,BUMA.1121.00052,1,3128880,3138864,-,9984
476,BUMA.1121.00101,1,1811435,1821425,-,9990
476,BUMA.1121.00001,1,3430138,3440279,-,10141
476,BUMA.1121.00038,1,207530,217515,+,9985
476,BUMA.1121.00068,1,3530404,3540395,+,9991
476,BUMA.1121.00099,1,1754448,1764503,-,10055
476,BUMA.1121.00091,1,3864483,3874562,-,10079
476,BUMA.1121.00098,1,3378062,3388062,+,10000
476,BUMA.1121.00013,1,3421008,3430992,-,9984
476,BUMA.1121.00049,1,1190859,1200844,-,9985
476,BUMA.1121.00072,1,649808,659794,+,9986
476,BUMA.1121.00076,1,702339,712343,-,10004
476,BUMA.1121.00083,1,962571,972556,-,9985
476,BUMA.1121.00078,1,1333273,1343322,-,10049
476,BUMA.1121.00095,1,1003339,1013438,-,10099
476,BUMA.1121.00077,1,3360263,3370393,+,10130
476,BUMA.1121.00063,1,675195,685139,+,9944
476,BUMA.1121.00061,1,678148,688134,+,9986
476,BUMA.1121.00050,1,1044631,1054615,-,9984
476,BUMA.1121.00081,1,207599,217584,+,9985
476,BUMA.1121.00074,1,3198076,3208112,-,10036
476,BUMA.1121.00062,1,3887648,3897632,-,9984
476,BUMA.1121.00060,1,1654365,1664282,-,9917
476,BUMA.1121.00070,1,649434,659417,+,9983
476,BUMA.1121.00075,1,167440,177445,+,10005
476,BUMA.1121.00041,1,1934100,1944294,+,10194
476,BUMA.1121.00073,1,676059,686042,+,9983
476,BUMA.1121.00017,1,3370904,3380888,-,9984
476,BUMA.1121.00066,1,656499,666482,+,9983
476,BUMA.1121.00107,1,509164,519154,+,9990
476,BUMA.1121.00085,1,2725826,2735810,-,9984
476,BUMA.1121.00030,1,3370969,3380953,-,9984
476,BUMA.1121.00112,1,2406588,2416677,-,10089
476,BUMA.1121.00002,1,1736879,1746864,+,9985
476,BUMA.1121.00082,1,732271,742257,+,9986
476,BUMA.1121.00014,1,2163485,2173574,-,10089
476,BUMA.1121.00011,1,964577,974572,-,9995
476,BUMA.1121.00019,1,3394236,3404220,-,9984
476,BUMA.1121.00057,1,1754856,1764842,+,9986
476,BUMA.1121.00018,1,1154388,1164322,+,9934
476,BUMA.1121.00039,1,765027,775065,+,10038
476,BUMA.1121.00016,1,2785379,2795469,+,10090
476,BUMA.1121.00004,1,3523138,3533122,-,9984
476,BUMA.1121.00005,1,2912343,2922374,-,10031
476,BUMA.1121.00100,1,642936,652957,-,10021
476,BUMA.1121.00006,1,207530,217515,+,9985
477,BUMA.1121.00027,1,2865471,2903734,+,38263
477,BUMA.1121.00025,1,2056390,2094762,-,38372
477,BUMA.1121.00021,1,1300205,1338486,+,38281
477,BUMA.1121.00023,1,3025708,3063974,+,38266
477,BUMA.1121.00024,1,3332510,3370911,-,38401
477,BUMA.1121.00033,1,2919755,2958035,+,38280
477,BUMA.1121.00034,1,3434062,3472455,-,38393
477,BUMA.1121.00036,1,550757,589101,+,38344
477,BUMA.1121.00032,1,1457220,1495629,-,38409
477,BUMA.1121.00009,1,876024,914383,-,38359
477,BUMA.1121.00008,1,3415316,3453725,-,38409
477,BUMA.1121.00003,1,3157044,3195415,+,38371
477,BUMA.1121.00109,1,1171847,1210311,-,38464
477,BUMA.1121.00053,1,390835,429302,+,38467
477,BUMA.1121.00110,1,73835,112274,-,38439
477,BUMA.1121.00104,1,580577,618931,-,38354
477,BUMA.1121.00086,1,2378168,2416471,+,38303
477,BUMA.1121.00092,1,3161691,3200025,-,38334
477,BUMA.1121.00096,1,2560069,2598379,-,38310
477,BUMA.1121.00054,1,376499,414775,-,38276
477,BUMA.1121.00097,1,3312462,3350781,-,38319
477,BUMA.1121.00093,1,1426401,1464734,+,38333
477,BUMA.1121.00106,1,445115,483466,+,38351
477,BUMA.1121.00010,1,1721960,1760351,+,38391
477,BUMA.1121.00035,1,1749170,1787440,+,38270
477,BUMA.1121.00108,1,1658428,1696689,+,38261
477,BUMA.1121.00028,1,3403710,3442104,-,38394
477,BUMA.1121.00094,1,662218,700588,+,38370
477,BUMA.1121.00102,1,515043,553438,-,38395
477,BUMA.1121.00111,1,811592,850001,+,38409
477,BUMA.1121.00089,1,678148,716541,+,38393
477,BUMA.1121.00084,1,900658,938912,+,38254
477,BUMA.1121.00029,1,181948,220225,-,38277
477,BUMA.1121.00012,1,3444360,3482650,+,38290
477,BUMA.1121.00087,1,919146,957450,-,38304
477,BUMA.1121.00043,1,657702,695977,+,38275
477,BUMA.1121.00046,1,1707859,1746203,+,38344
477,BUMA.1121.00037,1,3306111,3344392,+,38281
477,BUMA.1121.00080,1,710411,748827,+,38416
477,BUMA.1121.00079,1,701920,740291,+,38371
477,BUMA.1121.00045,1,3389576,3427909,-,38333
477,BUMA.1121.00071,1,686564,724836,+,38272
477,BUMA.1121.00056,1,3208940,3247335,-,38395
477,BUMA.1121.00065,1,725158,763479,+,38321
477,BUMA.1121.00058,1,3903896,3942228,-,38332
477,BUMA.1121.00007,1,3413169,3451729,-,38560
477,BUMA.1121.00067,1,3682672,3721002,-,38330
477,BUMA.1121.00090,1,2775624,2813915,+,38291
477,BUMA.1121.00051,1,672406,710807,+,38401
477,BUMA.1121.00020,1,3468530,3506939,-,38409
477,BUMA.1121.00103,1,3708763,3747101,-,38338
477,BUMA.1121.00048,1,10826,49101,+,38275
477,BUMA.1121.00047,1,2278685,2317062,-,38377
477,BUMA.1121.00042,1,391261,429577,-,38316
477,BUMA.1121.00055,1,250065,288366,+,38301
477,BUMA.1121.00031,1,2057406,2095695,+,38289
477,BUMA.1121.00040,1,3415325,3453658,-,38333
477,BUMA.1121.00044,1,2662232,2700625,-,38393
477,BUMA.1121.00088,1,1553077,1591393,+,38316
477,BUMA.1121.00069,1,649924,688198,+,38274
477,BUMA.1121.00064,1,711823,750245,+,38422
477,BUMA.1121.00105,1,492022,530376,-,38354
477,BUMA.1121.00015,1,642563,680848,+,38285
477,BUMA.1121.00059,1,3918013,3956399,+,38386
477,BUMA.1121.00026,1,626136,664470,-,38334
477,BUMA.1121.00022,1,1185079,1223393,-,38314
477,BUMA.1121.00052,1,3089708,3128096,-,38388
477,BUMA.1121.00101,1,1772283,1810651,-,38368
477,BUMA.1121.00001,1,3391037,3429354,-,38317
477,BUMA.1121.00038,1,218299,256574,+,38275
477,BUMA.1121.00068,1,3541179,3579375,+,38196
477,BUMA.1121.00099,1,1715167,1753664,-,38497
477,BUMA.1121.00091,1,3825197,3863699,-,38502
477,BUMA.1121.00098,1,3388845,3427181,+,38336
477,BUMA.1121.00013,1,3381804,3420224,-,38420
477,BUMA.1121.00049,1,1151770,1190075,-,38305
477,BUMA.1121.00072,1,660578,698850,+,38272
477,BUMA.1121.00076,1,663151,701555,-,38404
477,BUMA.1121.00083,1,923512,961787,-,38275
477,BUMA.1121.00078,1,1294165,1332489,-,38324
477,BUMA.1121.00095,1,964233,1002555,-,38322
477,BUMA.1121.00077,1,3371186,3409624,+,38438
477,BUMA.1121.00063,1,685923,724100,+,38177
477,BUMA.1121.00061,1,688918,727186,+,38268
477,BUMA.1121.00050,1,1005494,1043847,-,38353
477,BUMA.1121.00081,1,218368,256643,+,38275
477,BUMA.1121.00074,1,3158842,3197292,-,38450
477,BUMA.1121.00062,1,3848540,3886864,-,38324
477,BUMA.1121.00060,1,1615246,1653579,-,38333
477,BUMA.1121.00070,1,660201,698472,+,38271
477,BUMA.1121.00075,1,178228,216633,+,38405
477,BUMA.1121.00041,1,1945078,1983377,+,38299
477,BUMA.1121.00073,1,686826,725099,+,38273
477,BUMA.1121.00017,1,3331727,3370120,-,38393
477,BUMA.1121.00066,1,667266,705540,+,38274
477,BUMA.1121.00107,1,519938,558335,+,38397
477,BUMA.1121.00085,1,2686654,2725042,-,38388
477,BUMA.1121.00030,1,3331792,3370185,-,38393
477,BUMA.1121.00112,1,2367400,2405804,-,38404
477,BUMA.1121.00002,1,1747648,1786040,+,38392
477,BUMA.1121.00082,1,743041,781315,+,38274
477,BUMA.1121.00014,1,2124385,2162701,-,38316
477,BUMA.1121.00011,1,925356,963793,-,38437
477,BUMA.1121.00019,1,3355043,3393452,-,38409
477,BUMA.1121.00057,1,1765626,1803890,+,38264
477,BUMA.1121.00018,1,1165106,1203485,+,38379
477,BUMA.1121.00039,1,794964,833192,+,38228
477,BUMA.1121.00016,1,2796253,2834581,+,38328
477,BUMA.1121.00004,1,3483950,3522354,-,38404
477,BUMA.1121.00005,1,2873289,2911560,-,38271
477,BUMA.1121.00100,1,603837,642150,-,38313
477,BUMA.1121.00006,1,218299,256574,+,38275
478,BUMA.1121.00027,1,2904374,2920827,+,16453
478,BUMA.1121.00025,1,2039269,2055751,-,16482
478,BUMA.1121.00021,1,1339126,1355658,+,16532
478,BUMA.1121.00023,1,3064614,3081066,+,16452
478,BUMA.1121.00024,1,3315446,3331871,-,16425
478,BUMA.1121.00033,1,2958675,2975150,+,16475
478,BUMA.1121.00034,1,3416998,3433423,-,16425
478,BUMA.1121.00036,1,589741,606189,+,16448
478,BUMA.1121.00032,1,1440156,1456581,-,16425
478,BUMA.1121.00009,1,858845,875385,-,16540
478,BUMA.1121.00008,1,3398252,3414677,-,16425
478,BUMA.1121.00003,1,3196055,3212489,+,16434
478,BUMA.1121.00109,1,1154749,1171208,-,16459
478,BUMA.1121.00053,1,429943,446322,+,16379
478,BUMA.1121.00110,1,56679,73205,-,16526
478,BUMA.1121.00104,1,563389,579938,-,16549
478,BUMA.1121.00086,1,2417111,2433534,+,16423
478,BUMA.1121.00092,1,3144600,3161052,-,16452
478,BUMA.1121.00096,1,2542897,2559430,-,16533
478,BUMA.1121.00054,1,359395,375860,-,16465
478,BUMA.1121.00097,1,3295355,3311814,-,16459
478,BUMA.1121.00093,1,1465374,1481826,+,16452
478,BUMA.1121.00106,1,484106,500678,+,16572
478,BUMA.1121.00010,1,1760991,1777478,+,16487
478,BUMA.1121.00035,1,1788080,1804522,+,16442
478,BUMA.1121.00108,1,1697329,1713747,+,16418
478,BUMA.1121.00028,1,3386646,3403071,-,16425
478,BUMA.1121.00094,1,701228,717782,+,16554
478,BUMA.1121.00102,1,497845,514404,-,16559
478,BUMA.1121.00111,1,850641,867037,+,16396
478,BUMA.1121.00089,1,717181,733741,+,16560
478,BUMA.1121.00084,1,939553,956040,+,16487
478,BUMA.1121.00029,1,164857,181309,-,16452
478,BUMA.1121.00012,1,3483290,3499767,+,16477
478,BUMA.1121.00087,1,902084,918507,-,16423
478,BUMA.1121.00043,1,696617,713238,+,16621
478,BUMA.1121.00046,1,1746843,1763318,+,16475
478,BUMA.1121.00037,1,3345032,3361476,+,16444
478,BUMA.1121.00080,1,749467,766087,+,16620
478,BUMA.1121.00079,1,740931,757474,+,16543
478,BUMA.1121.00045,1,3372470,3388936,-,16466
478,BUMA.1121.00071,1,725476,741896,+,16420
478,BUMA.1121.00056,1,3191778,3208301,-,16523
478,BUMA.1121.00065,1,764119,780555,+,16436
478,BUMA.1121.00058,1,3886642,3903263,-,16621
478,BUMA.1121.00007,1,3396054,3412530,-,16476
478,BUMA.1121.00067,1,3665493,3682033,-,16540
478,BUMA.1121.00090,1,2814555,2831009,+,16454
478,BUMA.1121.00051,1,711447,727988,+,16541
478,BUMA.1121.00020,1,3451466,3467891,-,16425
478,BUMA.1121.00103,1,3691693,3708124,-,16431
478,BUMA.1121.00048,1,49741,66206,+,16465
478,BUMA.1121.00047,1,2261518,2278046,-,16528
478,BUMA.1121.00042,1,374187,390622,-,16435
478,BUMA.1121.00055,1,289006,305449,+,16443
478,BUMA.1121.00031,1,2096335,2112805,+,16470
478,BUMA.1121.00040,1,3398189,3414686,-,16497
478,BUMA.1121.00044,1,2645168,2661593,-,16425
478,BUMA.1121.00088,1,1592033,1608606,+,16573
478,BUMA.1121.00069,1,688838,705460,+,16622
478,BUMA.1121.00064,1,750886,767333,+,16447
478,BUMA.1121.00105,1,474924,491383,-,16459
478,BUMA.1121.00015,1,681488,698023,+,16535
478,BUMA.1121.00059,1,3957040,3973474,+,16434
478,BUMA.1121.00026,1,609016,625497,-,16481
478,BUMA.1121.00022,1,1168001,1184440,-,16439
478,BUMA.1121.00052,1,3072650,3089069,-,16419
478,BUMA.1121.00101,1,1755176,1771644,-,16468
478,BUMA.1121.00001,1,3373940,3390398,-,16458
478,BUMA.1121.00038,1,257214,273679,+,16465
478,BUMA.1121.00068,1,3580015,3596420,+,16405
478,BUMA.1121.00099,1,1698132,1714519,-,16387
478,BUMA.1121.00091,1,3808110,3824558,-,16448
478,BUMA.1121.00098,1,3427821,3444241,+,16420
478,BUMA.1121.00013,1,3364754,3381165,-,16411
478,BUMA.1121.00049,1,1133221,1149650,-,16429
478,BUMA.1121.00072,1,699490,716112,+,16622
478,BUMA.1121.00076,1,645939,662512,-,16573
478,BUMA.1121.00083,1,906217,922873,-,16656
478,BUMA.1121.00078,1,1277139,1293526,-,16387
478,BUMA.1121.00095,1,947145,963585,-,16440
478,BUMA.1121.00077,1,3410255,3426821,+,16566
478,BUMA.1121.00063,1,724740,741347,+,16607
478,BUMA.1121.00061,1,727826,744445,+,16619
478,BUMA.1121.00050,1,988380,1004855,-,16475
478,BUMA.1121.00081,1,257283,273748,+,16465
478,BUMA.1121.00074,1,3141760,3158202,-,16442
478,BUMA.1121.00062,1,3831422,3847901,-,16479
478,BUMA.1121.00060,1,1598146,1614606,-,16460
478,BUMA.1121.00070,1,699111,715606,+,16495
478,BUMA.1121.00075,1,217273,233806,+,16533
478,BUMA.1121.00041,1,1985497,2001978,+,16481
478,BUMA.1121.00073,1,725739,742361,+,16622
478,BUMA.1121.00017,1,3314663,3331088,-,16425
478,BUMA.1121.00066,1,706180,722799,+,16619
478,BUMA.1121.00107,1,558975,575439,+,16464
478,BUMA.1121.00085,1,2669596,2686015,-,16419
478,BUMA.1121.00030,1,3314730,3331153,-,16423
478,BUMA.1121.00112,1,2350346,2366761,-,16415
478,BUMA.1121.00002,1,1786680,1803167,+,16487
478,BUMA.1121.00082,1,781955,798577,+,16622
478,BUMA.1121.00014,1,2107254,2123746,-,16492
478,BUMA.1121.00011,1,908137,924718,-,16581
478,BUMA.1121.00019,1,3337979,3354404,-,16425
478,BUMA.1121.00057,1,1804530,1821065,+,16535
478,BUMA.1121.00018,1,1204125,1220607,+,16482
478,BUMA.1121.00039,1,833832,850370,+,16538
478,BUMA.1121.00016,1,2835221,2851687,+,16466
478,BUMA.1121.00004,1,3466886,3483311,-,16425
478,BUMA.1121.00005,1,2856210,2872650,-,16440
478,BUMA.1121.00100,1,586739,603197,-,16458
478,BUMA.1121.00006,1,257214,273679,+,16465
479,BUMA.1121.00027,1,2920852,2928598,+,7746
479,BUMA.1121.00025,1,2031407,2039235,-,7828
479,BUMA.1121.00021,1,1355680,1363529,+,7849
479,BUMA.1121.00023,1,3081088,3088928,+,7840
479,BUMA.1121.00024,1,3307582,3315423,-,7841
479,BUMA.1121.00033,1,2975172,2983028,+,7856
479,BUMA.1121.00034,1,3409134,3416975,-,7841
479,BUMA.1121.00036,1,606212,614062,+,7850
479,BUMA.1121.00032,1,1432292,1440133,-,7841
479,BUMA.1121.00009,1,851076,858823,-,7747
479,BUMA.1121.00008,1,3390388,3398229,-,7841
479,BUMA.1121.00003,1,3212513,3220340,+,7827
479,BUMA.1121.00109,1,1146923,1154727,-,7804
479,BUMA.1121.00053,1,446345,454191,+,7846
479,BUMA.1121.00110,1,48827,56645,-,7818
479,BUMA.1121.00104,1,555539,563367,-,7828
479,BUMA.1121.00086,1,2433557,2441407,+,7850
479,BUMA.1121.00092,1,3136720,3144566,-,7846
479,BUMA.1121.00096,1,2535040,2542875,-,7835
479,BUMA.1121.00054,1,351522,359372,-,7850
479,BUMA.1121.00097,1,3287567,3295333,-,7766
479,BUMA.1121.00093,1,1481848,1489706,+,7858
479,BUMA.1121.00106,1,500726,508554,+,7828
479,BUMA.1121.00010,1,1777501,1785342,+,7841
479,BUMA.1121.00035,1,1804544,1812362,+,7818
479,BUMA.1121.00108,1,1713795,1721645,+,7850
479,BUMA.1121.00028,1,3378782,3386623,-,7841
479,BUMA.1121.00094,1,717830,725636,+,7806
479,BUMA.1121.00102,1,490011,497811,-,7800
479,BUMA.1121.00111,1,867059,874877,+,7818
479,BUMA.1121.00089,1,733790,741587,+,7797
479,BUMA.1121.00084,1,956062,963902,+,7840
479,BUMA.1121.00029,1,157017,164823,-,7806
479,BUMA.1121.00012,1,3499789,3507630,+,7841
479,BUMA.1121.00087,1,894211,902061,-,7850
479,BUMA.1121.00043,1,713260,721106,+,7846
479,BUMA.1121.00046,1,1763341,1771200,+,7859
479,BUMA.1121.00037,1,3361498,3369339,+,7841
479,BUMA.1121.00080,1,766135,773959,+,7824
479,BUMA.1121.00079,1,757521,765349,+,7828
479,BUMA.1121.00045,1,3364620,3372436,-,7816
479,BUMA.1121.00071,1,741944,749750,+,7806
479,BUMA.1121.00056,1,3183959,3191756,-,7797
479,BUMA.1121.00065,1,780577,788414,+,7837
479,BUMA.1121.00058,1,3878899,3886608,-,7709
479,BUMA.1121.00007,1,3388257,3396032,-,7775
479,BUMA.1121.00067,1,3656176,3663981,-,7805
479,BUMA.1121.00090,1,2831031,2838916,+,7885
479,BUMA.1121.00051,1,728036,735851,+,7815
479,BUMA.1121.00020,1,3443602,3451443,-,7841
479,BUMA.1121.00103,1,3683923,3691671,-,7748
479,BUMA.1121.00048,1,66229,74079,+,7850
479,BUMA.1121.00047,1,2253672,2261496,-,7824
479,BUMA.1121.00042,1,366332,374164,-,7832
479,BUMA.1121.00055,1,305471,313282,+,7811
479,BUMA.1121.00031,1,2112826,2120666,+,7840
479,BUMA.1121.00040,1,3390335,3398167,-,7832
479,BUMA.1121.00044,1,2637304,2645145,-,7841
479,BUMA.1121.00088,1,1608628,1616468,+,7840
479,BUMA.1121.00069,1,705508,713280,+,7772
479,BUMA.1121.00064,1,767355,775204,+,7849
479,BUMA.1121.00105,1,467141,474890,-,7749
479,BUMA.1121.00015,1,698046,705905,+,7859
479,BUMA.1121.00059,1,3973496,3981302,+,7806
479,BUMA.1121.00026,1,601161,608993,-,7832
479,BUMA.1121.00022,1,1160137,1167978,-,7841
479,BUMA.1121.00052,1,3064768,3072627,-,7859
479,BUMA.1121.00101,1,1747313,1755154,-,7841
479,BUMA.1121.00001,1,3366138,3373906,-,7768
479,BUMA.1121.00038,1,273702,281552,+,7850
479,BUMA.1121.00068,1,3596468,3604294,+,7826
479,BUMA.1121.00099,1,1690300,1698122,-,7822
479,BUMA.1121.00091,1,3800242,3808076,-,7834
479,BUMA.1121.00098,1,3444281,3452054,+,7773
479,BUMA.1121.00013,1,3356863,3364731,-,7868
479,BUMA.1121.00049,1,1125362,1133187,-,7825
479,BUMA.1121.00072,1,716160,723966,+,7806
479,BUMA.1121.00076,1,638077,645905,-,7828
479,BUMA.1121.00083,1,898389,906195,-,7806
479,BUMA.1121.00078,1,1269284,1277104,-,7820
479,BUMA.1121.00095,1,939318,947123,-,7805
479,BUMA.1121.00077,1,3426843,3434673,+,7830
479,BUMA.1121.00063,1,741395,749154,+,7759
479,BUMA.1121.00061,1,744467,752273,+,7806
479,BUMA.1121.00050,1,980498,988357,-,7859
479,BUMA.1121.00081,1,273771,281621,+,7850
479,BUMA.1121.00074,1,3133889,3141726,-,7837
479,BUMA.1121.00062,1,3823638,3831388,-,7750
479,BUMA.1121.00060,1,1590296,1598112,-,7816
479,BUMA.1121.00070,1,715654,723427,+,7773
479,BUMA.1121.00075,1,233828,241668,+,7840
479,BUMA.1121.00041,1,2002000,2009763,+,7763
479,BUMA.1121.00073,1,742409,750183,+,7774
479,BUMA.1121.00017,1,3306799,3314640,-,7841
479,BUMA.1121.00066,1,722841,730576,+,7735
479,BUMA.1121.00107,1,575461,583314,+,7853
479,BUMA.1121.00085,1,2661714,2669573,-,7859
479,BUMA.1121.00030,1,3306866,3314707,-,7841
479,BUMA.1121.00112,1,2342487,2350324,-,7837
479,BUMA.1121.00002,1,1803190,1811031,+,7841
479,BUMA.1121.00082,1,798625,806431,+,7806
479,BUMA.1121.00014,1,2099392,2107220,-,7828
479,BUMA.1121.00011,1,900365,908103,-,7738
479,BUMA.1121.00019,1,3330115,3337956,-,7841
479,BUMA.1121.00057,1,1821113,1828928,+,7815
479,BUMA.1121.00018,1,1220629,1228469,+,7840
479,BUMA.1121.00039,1,850392,858230,+,7838
479,BUMA.1121.00016,1,2851709,2859559,+,7850
479,BUMA.1121.00004,1,3459022,3466863,-,7841
479,BUMA.1121.00005,1,2848339,2856176,-,7837
479,BUMA.1121.00100,1,578872,586717,-,7845
479,BUMA.1121.00006,1,273702,281552,+,7850
480,BUMA.1121.00027,1,2930494,2943529,+,13035
480,BUMA.1121.00025,1,2016461,2029510,-,13049
480,BUMA.1121.00021,1,1365425,1378380,+,12955
480,BUMA.1121.00023,1,3090824,3103877,+,13053
480,BUMA.1121.00033,1,2986522,2999575,+,13053
480,BUMA.1121.00009,1,836169,849179,-,13010
480,BUMA.1121.00003,1,3222239,3235286,+,13047
480,BUMA.1121.00109,1,1131981,1145026,-,13045
480,BUMA.1121.00053,1,456087,469141,+,13054
480,BUMA.1121.00110,1,33875,46930,-,13055
480,BUMA.1121.00104,1,540614,553642,-,13028
480,BUMA.1121.00092,1,3121791,3134823,-,13032
480,BUMA.1121.00096,1,2520095,2533140,-,13045
480,BUMA.1121.00097,1,3272619,3285667,-,13048
480,BUMA.1121.00093,1,1491602,1504634,+,13032
480,BUMA.1121.00106,1,510450,523488,+,13038
480,BUMA.1121.00035,1,1814258,1827296,+,13038
480,BUMA.1121.00108,1,1723541,1736590,+,13049
480,BUMA.1121.00094,1,727532,740573,+,13041
480,BUMA.1121.00102,1,475068,488111,-,13043
480,BUMA.1121.00111,1,876776,889814,+,13038
480,BUMA.1121.00089,1,743483,756532,+,13049
480,BUMA.1121.00084,1,965798,978835,+,13037
480,BUMA.1121.00029,1,142082,155120,-,13038
480,BUMA.1121.00012,1,3509526,3522562,+,13036
480,BUMA.1121.00043,1,723005,736049,+,13044
480,BUMA.1121.00037,1,3371235,3384273,+,13038
480,BUMA.1121.00080,1,775855,788903,+,13048
480,BUMA.1121.00079,1,767245,780298,+,13053
480,BUMA.1121.00045,1,3349703,3362723,-,13020
480,BUMA.1121.00071,1,751646,764702,+,13056
480,BUMA.1121.00056,1,3169013,3182062,-,13049
480,BUMA.1121.00065,1,790313,803350,+,13037
480,BUMA.1121.00058,1,3863964,3877002,-,13038
480,BUMA.1121.00007,1,3373324,3386360,-,13036
480,BUMA.1121.00067,1,3641241,3654279,-,13038
480,BUMA.1121.00090,1,2840812,2853850,+,13038
480,BUMA.1121.00051,1,737747,750796,+,13049
480,BUMA.1121.00103,1,3668992,3682026,-,13034
480,BUMA.1121.00047,1,2238726,2251775,-,13049
480,BUMA.1121.00055,1,315178,328234,+,13056
480,BUMA.1121.00031,1,2122562,2135600,+,13038
480,BUMA.1121.00088,1,1618364,1631401,+,13037
480,BUMA.1121.00069,1,715179,728244,+,13065
480,BUMA.1121.00064,1,777100,790154,+,13054
480,BUMA.1121.00105,1,452194,465244,-,13050
480,BUMA.1121.00059,1,3983198,3996253,+,13055
480,BUMA.1121.00101,1,1732379,1745416,-,13037
480,BUMA.1121.00001,1,3351203,3364241,-,13038
480,BUMA.1121.00068,1,3606190,3619205,+,13015
480,BUMA.1121.00099,1,1675347,1688400,-,13053
480,BUMA.1121.00091,1,3785316,3798345,-,13029
480,BUMA.1121.00098,1,3453950,3466999,+,13049
480,BUMA.1121.00049,1,1110427,1123465,-,13038
480,BUMA.1121.00072,1,725862,738918,+,13056
480,BUMA.1121.00076,1,623136,636180,-,13044
480,BUMA.1121.00083,1,883436,896492,-,13056
480,BUMA.1121.00078,1,1254352,1267387,-,13035
480,BUMA.1121.00095,1,924379,937418,-,13039
480,BUMA.1121.00077,1,3436569,3449625,+,13056
480,BUMA.1121.00063,1,751050,764084,+,13034
480,BUMA.1121.00061,1,754169,767225,+,13056
480,BUMA.1121.00074,1,3118938,3131992,-,13054
480,BUMA.1121.00062,1,3808670,3821741,-,13071
480,BUMA.1121.00060,1,1575379,1588399,-,13020
480,BUMA.1121.00070,1,725323,738379,+,13056
480,BUMA.1121.00075,1,243563,256606,+,13043
480,BUMA.1121.00041,1,2011661,2024703,+,13042
480,BUMA.1121.00073,1,752079,765135,+,13056
480,BUMA.1121.00066,1,732472,745528,+,13056
480,BUMA.1121.00107,1,585213,598256,+,13043
480,BUMA.1121.00112,1,2327540,2340590,-,13050
480,BUMA.1121.00082,1,808327,821383,+,13056
480,BUMA.1121.00014,1,2084457,2097495,-,13038
480,BUMA.1121.00011,1,885433,898465,-,13032
480,BUMA.1121.00057,1,1830824,1843874,+,13050
480,BUMA.1121.00018,1,1230365,1243414,+,13049
480,BUMA.1121.00039,1,860126,873164,+,13038
480,BUMA.1121.00016,1,2861455,2874493,+,13038
480,BUMA.1121.00005,1,2833401,2846442,-,13041
480,BUMA.1121.00100,1,563955,576972,-,13017
481,BUMA.1121.00027,1,2953487,2972267,+,18780
481,BUMA.1121.00025,1,1987651,2006502,-,18851
481,BUMA.1121.00021,1,1388323,1407134,+,18811
481,BUMA.1121.00023,1,3113881,3132661,+,18780
481,BUMA.1121.00033,1,3009529,3028322,+,18793
481,BUMA.1121.00009,1,807379,826199,-,18820
481,BUMA.1121.00003,1,3245322,3264206,+,18884
481,BUMA.1121.00109,1,1103130,1121954,-,18824
481,BUMA.1121.00053,1,479246,498038,+,18792
481,BUMA.1121.00110,1,10573,29331,-,18758
481,BUMA.1121.00104,1,512026,530832,-,18806
481,BUMA.1121.00092,1,3093029,3111813,-,18784
481,BUMA.1121.00096,1,2491298,2510123,-,18825
481,BUMA.1121.00097,1,3243812,3262570,-,18758
481,BUMA.1121.00093,1,1514622,1533406,+,18784
481,BUMA.1121.00106,1,533389,552123,+,18734
481,BUMA.1121.00035,1,1837222,1856038,+,18816
481,BUMA.1121.00108,1,1746461,1765283,+,18822
481,BUMA.1121.00094,1,750654,769408,+,18754
481,BUMA.1121.00102,1,446306,465072,-,18766
481,BUMA.1121.00111,1,899874,918746,+,18872
481,BUMA.1121.00089,1,766613,785367,+,18754
481,BUMA.1121.00084,1,988832,1007512,+,18680
481,BUMA.1121.00029,1,113240,132067,-,18827
481,BUMA.1121.00012,1,3532475,3550965,+,18490
481,BUMA.1121.00043,1,746378,765126,+,18748
481,BUMA.1121.00037,1,3394243,3413088,+,18845
481,BUMA.1121.00080,1,798828,817594,+,18766
481,BUMA.1121.00079,1,790411,809148,+,18737
481,BUMA.1121.00045,1,3321039,3339822,-,18783
481,BUMA.1121.00071,1,774663,793361,+,18698
481,BUMA.1121.00056,1,3140224,3158978,-,18754
481,BUMA.1121.00065,1,813275,832016,+,18741
481,BUMA.1121.00058,1,3835314,3854046,-,18732
481,BUMA.1121.00007,1,3344432,3363384,-,18952
481,BUMA.1121.00067,1,3612524,3631290,-,18766
481,BUMA.1121.00090,1,2863784,2882585,+,18801
481,BUMA.1121.00051,1,760821,779581,+,18760
481,BUMA.1121.00103,1,3640350,3659227,-,18877
481,BUMA.1121.00047,1,2209964,2228664,-,18700
481,BUMA.1121.00055,1,338274,356972,+,18698
481,BUMA.1121.00031,1,2145551,2164354,+,18803
481,BUMA.1121.00088,1,1641416,1660215,+,18799
481,BUMA.1121.00069,1,738191,756867,+,18676
481,BUMA.1121.00064,1,800070,818853,+,18783
481,BUMA.1121.00105,1,423524,442279,-,18755
481,BUMA.1121.00059,1,2212,20983,+,18771
481,BUMA.1121.00101,1,1703560,1722331,-,18771
481,BUMA.1121.00001,1,3322373,3341153,-,18780
481,BUMA.1121.00068,1,3629187,3647980,+,18793
481,BUMA.1121.00099,1,1646630,1665468,-,18838
481,BUMA.1121.00091,1,3756402,3775221,-,18819
481,BUMA.1121.00098,1,3476967,3495675,+,18708
481,BUMA.1121.00049,1,1081706,1100491,-,18785
481,BUMA.1121.00072,1,748841,767539,+,18698
481,BUMA.1121.00076,1,594368,613149,-,18781
481,BUMA.1121.00083,1,854778,873476,-,18698
481,BUMA.1121.00078,1,1225380,1244286,-,18906
481,BUMA.1121.00095,1,895669,914404,-,18735
481,BUMA.1121.00077,1,3454169,3472927,+,18758
481,BUMA.1121.00063,1,774012,792706,+,18694
481,BUMA.1121.00061,1,777154,795852,+,18698
481,BUMA.1121.00074,1,3090036,3108825,-,18789
481,BUMA.1121.00062,1,3779901,3798701,-,18800
481,BUMA.1121.00060,1,1546652,1565435,-,18783
481,BUMA.1121.00070,1,748323,767021,+,18698
481,BUMA.1121.00075,1,266629,285416,+,18787
481,BUMA.1121.00041,1,2034699,2053512,+,18813
481,BUMA.1121.00073,1,775077,793775,+,18698
481,BUMA.1121.00066,1,755489,774187,+,18698
481,BUMA.1121.00107,1,608153,626906,+,18753
481,BUMA.1121.00112,1,2298855,2317595,-,18740
481,BUMA.1121.00082,1,831344,850042,+,18698
481,BUMA.1121.00014,1,2055622,2074419,-,18797
481,BUMA.1121.00011,1,856624,875451,-,18827
481,BUMA.1121.00057,1,1853862,1872648,+,18786
481,BUMA.1121.00018,1,1253375,1272221,+,18846
481,BUMA.1121.00039,1,883161,901922,+,18761
481,BUMA.1121.00016,1,2884426,2903179,+,18753
481,BUMA.1121.00005,1,2804753,2823511,-,18758
481,BUMA.1121.00100,1,535184,553950,-,18766
482,BUMA.1121.00027,1,2982780,2995919,+,13139
482,BUMA.1121.00025,1,1905210,1918372,-,13162
482,BUMA.1121.00021,1,1412670,1425823,+,13153
482,BUMA.1121.00023,1,3147003,3160094,+,13091
482,BUMA.1121.00024,1,3290354,3303376,+,13022
482,BUMA.1121.00033,1,3033858,3047007,+,13149
482,BUMA.1121.00034,1,3391906,3404928,+,13022
482,BUMA.1121.00036,1,618267,631290,-,13023
482,BUMA.1121.00032,1,1415064,1428086,+,13022
482,BUMA.1121.00009,1,776794,789849,-,13055
482,BUMA.1121.00008,1,3373160,3386182,+,13022
482,BUMA.1121.00003,1,3281761,3294816,+,13055
482,BUMA.1121.00109,1,1082431,1095507,-,13076
482,BUMA.1121.00053,1,509764,522832,+,13068
482,BUMA.1121.00110,1,3995732,4008750,-,13018
482,BUMA.1121.00104,1,485796,498908,-,13112
482,BUMA.1121.00086,1,8285,21308,-,13023
482,BUMA.1121.00092,1,3069061,3082123,-,13062
482,BUMA.1121.00096,1,2465050,2478158,-,13108
482,BUMA.1121.00054,1,333042,346065,-,13023
482,BUMA.1121.00097,1,3213192,3226281,-,13089
482,BUMA.1121.00093,1,1544312,1557373,+,13061
482,BUMA.1121.00106,1,565239,578350,+,13111
482,BUMA.1121.00010,1,1789548,1802570,-,13022
482,BUMA.1121.00035,1,1861615,1874766,+,13151
482,BUMA.1121.00108,1,1782812,1795866,+,13054
482,BUMA.1121.00028,1,3361554,3374576,+,13022
482,BUMA.1121.00094,1,779921,793002,+,13081
482,BUMA.1121.00102,1,427700,440770,-,13070
482,BUMA.1121.00111,1,924282,937412,+,13130
482,BUMA.1121.00089,1,795880,808962,+,13082
482,BUMA.1121.00084,1,1019238,1032356,+,13118
482,BUMA.1121.00029,1,94497,107663,-,13166
482,BUMA.1121.00012,1,3568383,3581530,+,13147
482,BUMA.1121.00087,1,3295253,3308275,+,13022
482,BUMA.1121.00043,1,770662,783821,+,13159
482,BUMA.1121.00046,1,1775169,1788192,-,13023
482,BUMA.1121.00037,1,3426095,3439228,+,13133
482,BUMA.1121.00080,1,827275,840385,+,13110
482,BUMA.1121.00079,1,820871,833930,+,13059
482,BUMA.1121.00045,1,3264660,3277749,-,13089
482,BUMA.1121.00071,1,796175,809293,+,13118
482,BUMA.1121.00056,1,3116628,3129711,-,13083
482,BUMA.1121.00065,1,842529,855611,+,13082
482,BUMA.1121.00058,1,3809080,3822198,-,13118
482,BUMA.1121.00007,1,3326897,3339943,-,13046
482,BUMA.1121.00067,1,3587696,3600800,-,13104
482,BUMA.1121.00090,1,2888121,2901203,+,13082
482,BUMA.1121.00051,1,798815,811924,+,13109
482,BUMA.1121.00020,1,3426374,3439396,+,13022
482,BUMA.1121.00103,1,3612825,3625915,-,13090
482,BUMA.1121.00048,1,79536,92558,+,13022
482,BUMA.1121.00047,1,2187172,2200283,-,13111
482,BUMA.1121.00042,1,347665,360688,-,13023
482,BUMA.1121.00055,1,371300,384381,+,13081
482,BUMA.1121.00031,1,2178696,2191778,+,13082
482,BUMA.1121.00040,1,3334661,3347682,+,13021
482,BUMA.1121.00044,1,2620076,2633098,+,13022
482,BUMA.1121.00088,1,1671941,1685045,+,13104
482,BUMA.1121.00069,1,759300,772410,+,13110
482,BUMA.1121.00064,1,830577,843638,+,13061
482,BUMA.1121.00105,1,397331,410408,-,13077
482,BUMA.1121.00015,1,709874,722897,-,13023
482,BUMA.1121.00059,1,32707,47094,+,14387
482,BUMA.1121.00026,1,583934,596956,+,13022
482,BUMA.1121.00022,1,1332816,1345839,-,13023
482,BUMA.1121.00052,1,3047776,3060798,+,13022
482,BUMA.1121.00101,1,1676733,1689784,-,13051
482,BUMA.1121.00001,1,3303640,3316796,-,13156
482,BUMA.1121.00038,1,287009,300031,+,13022
482,BUMA.1121.00068,1,3663798,3676860,+,13062
482,BUMA.1121.00099,1,1571641,1584704,-,13063
482,BUMA.1121.00091,1,3737790,3750864,-,13074
482,BUMA.1121.00098,1,3513214,3526291,+,13077
482,BUMA.1121.00013,1,3339871,3352893,+,13022
482,BUMA.1121.00049,1,1047806,1060917,-,13111
482,BUMA.1121.00072,1,770219,783337,+,13118
482,BUMA.1121.00076,1,563746,576836,-,13090
482,BUMA.1121.00083,1,791451,804570,-,13119
482,BUMA.1121.00078,1,1199180,1212263,-,13083
482,BUMA.1121.00095,1,868254,881324,-,13070
482,BUMA.1121.00077,1,3483444,3496512,+,13068
482,BUMA.1121.00063,1,803238,816352,+,13114
482,BUMA.1121.00061,1,806385,819503,+,13118
482,BUMA.1121.00050,1,963506,976528,+,13022
482,BUMA.1121.00081,1,287078,300100,+,13022
482,BUMA.1121.00074,1,3065250,3078312,-,13062
482,BUMA.1121.00062,1,3753681,3766785,-,13104
482,BUMA.1121.00060,1,1490273,1503362,-,13089
482,BUMA.1121.00070,1,777555,790673,+,13118
482,BUMA.1121.00075,1,302947,316035,+,13088
482,BUMA.1121.00041,1,2064025,2078455,+,14430
482,BUMA.1121.00073,1,804309,817427,+,13118
482,BUMA.1121.00017,1,3289571,3302593,+,13022
482,BUMA.1121.00066,1,780284,793395,+,13111
482,BUMA.1121.00107,1,639442,652532,+,13090
482,BUMA.1121.00085,1,2644722,2657744,+,13022
482,BUMA.1121.00030,1,3289638,3302660,+,13022
482,BUMA.1121.00112,1,2268192,2281325,-,13133
482,BUMA.1121.00002,1,1815234,1828257,-,13023
482,BUMA.1121.00082,1,900250,913368,+,13118
482,BUMA.1121.00014,1,2026925,2040008,-,13083
482,BUMA.1121.00011,1,789802,802857,-,13055
482,BUMA.1121.00019,1,3312887,3325909,+,13022
482,BUMA.1121.00057,1,1883161,1896275,+,13114
482,BUMA.1121.00018,1,1341500,1354660,+,13160
482,BUMA.1121.00039,1,907458,920533,+,13075
482,BUMA.1121.00016,1,2908713,2921916,+,13203
482,BUMA.1121.00004,1,3441794,3454816,+,13022
482,BUMA.1121.00005,1,2778676,2791779,-,13103
482,BUMA.1121.00100,1,509002,522075,-,13073
482,BUMA.1121.00006,1,287009,300031,+,13022
483,BUMA.1121.00027,1,2996692,3030019,+,33327
483,BUMA.1121.00025,1,1871168,1904426,-,33258
483,BUMA.1121.00021,1,1426607,1459819,+,33212
483,BUMA.1121.00023,1,3160879,3194162,+,33283
483,BUMA.1121.00024,1,3253137,3286367,-,33230
483,BUMA.1121.00033,1,3047789,3081057,+,33268
483,BUMA.1121.00034,1,3354689,3387919,-,33230
483,BUMA.1121.00036,1,635275,668547,+,33272
483,BUMA.1121.00032,1,1377811,1411077,-,33266
483,BUMA.1121.00009,1,742563,776008,-,33445
483,BUMA.1121.00008,1,3335943,3369173,-,33230
483,BUMA.1121.00003,1,3295600,3328856,+,33256
483,BUMA.1121.00109,1,1048388,1081649,-,33261
483,BUMA.1121.00053,1,523588,556917,+,33329
483,BUMA.1121.00110,1,3961704,3994950,-,33246
483,BUMA.1121.00104,1,451734,485011,-,33277
483,BUMA.1121.00086,1,25295,58528,+,33233
483,BUMA.1121.00092,1,3034978,3068274,-,33296
483,BUMA.1121.00096,1,2430997,2464264,-,33267
483,BUMA.1121.00054,1,297717,330947,-,33230
483,BUMA.1121.00097,1,3179191,3212406,-,33215
483,BUMA.1121.00093,1,1558160,1591451,+,33291
483,BUMA.1121.00106,1,579135,612460,+,33325
483,BUMA.1121.00010,1,1806556,1839762,+,33206
483,BUMA.1121.00035,1,1875548,1908763,+,33215
483,BUMA.1121.00108,1,1796650,1829886,+,33236
483,BUMA.1121.00028,1,3324337,3357567,-,33230
483,BUMA.1121.00094,1,793787,827157,+,33370
483,BUMA.1121.00102,1,393514,426944,-,33430
483,BUMA.1121.00111,1,938195,971580,+,33385
483,BUMA.1121.00089,1,809747,843108,+,33361
483,BUMA.1121.00084,1,1033141,1066447,+,33306
483,BUMA.1121.00029,1,60454,93715,-,33261
483,BUMA.1121.00012,1,3582312,3615590,+,33278
483,BUMA.1121.00087,1,3258033,3291265,-,33232
483,BUMA.1121.00043,1,784603,817891,+,33288
483,BUMA.1121.00046,1,1791775,1825045,+,33270
483,BUMA.1121.00037,1,3440013,3473308,+,33295
483,BUMA.1121.00080,1,841167,874445,+,33278
483,BUMA.1121.00079,1,834712,868054,+,33342
483,BUMA.1121.00045,1,3230663,3263878,-,33215
483,BUMA.1121.00071,1,810075,843364,+,33289
483,BUMA.1121.00056,1,3082543,3115843,-,33300
483,BUMA.1121.00065,1,856367,889574,+,33207
483,BUMA.1121.00058,1,3773720,3808297,-,34577
483,BUMA.1121.00007,1,3292909,3326111,-,33202
483,BUMA.1121.00067,1,3553594,3586914,-,33320
483,BUMA.1121.00090,1,2901988,2935243,+,33255
483,BUMA.1121.00051,1,812706,845977,+,33271
483,BUMA.1121.00020,1,3389157,3422387,-,33230
483,BUMA.1121.00103,1,3578807,3612041,-,33234
483,BUMA.1121.00048,1,94654,127884,+,33230
483,BUMA.1121.00047,1,2153019,2186390,-,33371
483,BUMA.1121.00042,1,311879,345176,-,33297
483,BUMA.1121.00055,1,386583,419954,+,33371
483,BUMA.1121.00031,1,2192563,2225816,+,33253
483,BUMA.1121.00040,1,3349777,3382933,+,33156
483,BUMA.1121.00044,1,2582859,2616089,-,33230
483,BUMA.1121.00088,1,1685830,1719110,+,33280
483,BUMA.1121.00069,1,773175,806394,+,33219
483,BUMA.1121.00064,1,844421,877795,+,33374
483,BUMA.1121.00105,1,363260,396546,-,33286
483,BUMA.1121.00015,1,726480,759707,+,33227
483,BUMA.1121.00059,1,47879,81131,+,33252
483,BUMA.1121.00026,1,546556,579814,-,33258
483,BUMA.1121.00022,1,1349826,1383080,+,33254
483,BUMA.1121.00052,1,993415,1026595,+,33180
483,BUMA.1121.00101,1,1642718,1675949,-,33231
483,BUMA.1121.00001,1,3269531,3302858,-,33327
483,BUMA.1121.00038,1,302127,335357,+,33230
483,BUMA.1121.00068,1,3677645,3711095,+,33450
483,BUMA.1121.00099,1,1537565,1570855,-,33290
483,BUMA.1121.00091,1,3703696,3737010,-,33314
483,BUMA.1121.00098,1,3527055,3560312,+,33257
483,BUMA.1121.00013,1,3520189,3553393,-,33204
483,BUMA.1121.00049,1,1013738,1047021,-,33283
483,BUMA.1121.00072,1,784104,817387,+,33283
483,BUMA.1121.00076,1,529658,562991,-,33333
483,BUMA.1121.00083,1,757378,790669,-,33291
483,BUMA.1121.00078,1,1165116,1198393,-,33277
483,BUMA.1121.00095,1,834294,867470,-,33176
483,BUMA.1121.00077,1,3497294,3530570,+,33276
483,BUMA.1121.00063,1,817118,850405,+,33287
483,BUMA.1121.00061,1,820265,853554,+,33289
483,BUMA.1121.00050,1,926653,959923,-,33270
483,BUMA.1121.00081,1,302196,335426,+,33230
483,BUMA.1121.00074,1,3031106,3064467,-,33361
483,BUMA.1121.00062,1,3719581,3752894,-,33313
483,BUMA.1121.00060,1,1456276,1489491,-,33215
483,BUMA.1121.00070,1,791435,824670,+,33235
483,BUMA.1121.00075,1,316790,350079,+,33289
483,BUMA.1121.00041,1,2079203,2112504,+,33301
483,BUMA.1121.00073,1,818188,851424,+,33236
483,BUMA.1121.00017,1,3252354,3285584,-,33230
483,BUMA.1121.00066,1,794156,827443,+,33287
483,BUMA.1121.00107,1,653318,686721,+,33403
483,BUMA.1121.00085,1,590250,623430,+,33180
483,BUMA.1121.00030,1,3252421,3285651,-,33230
483,BUMA.1121.00112,1,2234106,2267406,-,33300
483,BUMA.1121.00002,1,1832245,1865451,+,33206
483,BUMA.1121.00082,1,914150,947442,+,33292
483,BUMA.1121.00014,1,1992796,2026140,-,33344
483,BUMA.1121.00011,1,755769,789018,-,33249
483,BUMA.1121.00019,1,3275670,3308900,-,33230
483,BUMA.1121.00057,1,1897057,1930310,+,33253
483,BUMA.1121.00018,1,1355444,1388697,+,33253
483,BUMA.1121.00039,1,921318,954546,+,33228
483,BUMA.1121.00016,1,2922698,2956065,+,33367
483,BUMA.1121.00004,1,3404577,3437807,-,33230
483,BUMA.1121.00005,1,2744668,2777891,-,33223
483,BUMA.1121.00100,1,474925,508216,-,33291
483,BUMA.1121.00006,1,302127,335357,+,33230
484,BUMA.1121.00027,1,3035046,3061305,+,26259
484,BUMA.1121.00025,1,1839885,1866153,-,26268
484,BUMA.1121.00021,1,1464856,1491133,+,26277
484,BUMA.1121.00023,1,3199177,3225471,+,26294
484,BUMA.1121.00024,1,3219437,3245659,-,26222
484,BUMA.1121.00033,1,3086072,3112348,+,26276
484,BUMA.1121.00034,1,3320989,3347211,-,26222
484,BUMA.1121.00036,1,675905,702136,+,26231
484,BUMA.1121.00032,1,1344111,1370333,-,26222
484,BUMA.1121.00009,1,711269,737564,-,26295
484,BUMA.1121.00008,1,3302243,3328465,-,26222
484,BUMA.1121.00003,1,3333882,3360419,+,26537
484,BUMA.1121.00109,1,1017096,1043373,-,26277
484,BUMA.1121.00053,1,561952,588304,+,26352
484,BUMA.1121.00110,1,3930489,3956688,-,26199
484,BUMA.1121.00104,1,420497,446786,-,26289
484,BUMA.1121.00086,1,65884,92115,+,26231
484,BUMA.1121.00092,1,3003698,3029963,-,26265
484,BUMA.1121.00096,1,2399708,2425985,-,26277
484,BUMA.1121.00054,1,266028,292239,-,26211
484,BUMA.1121.00097,1,3147852,3174167,-,26315
484,BUMA.1121.00093,1,1596466,1622731,+,26265
484,BUMA.1121.00106,1,617475,643781,+,26306
484,BUMA.1121.00010,1,1846030,1872261,+,26231
484,BUMA.1121.00035,1,1913778,1940088,+,26310
484,BUMA.1121.00108,1,1834891,1861204,+,26313
484,BUMA.1121.00028,1,3290637,3316859,-,26222
484,BUMA.1121.00094,1,832173,858506,+,26333
484,BUMA.1121.00102,1,362254,388491,-,26237
484,BUMA.1121.00111,1,976606,1002891,+,26285
484,BUMA.1121.00089,1,848136,874482,+,26346
484,BUMA.1121.00084,1,1071462,1097767,+,26305
484,BUMA.1121.00029,1,29151,55439,-,26288
484,BUMA.1121.00012,1,3620605,3646883,+,26278
484,BUMA.1121.00087,1,3224446,3250677,-,26231
484,BUMA.1121.00043,1,822929,849220,+,26291
484,BUMA.1121.00046,1,1830522,1856730,+,26208
484,BUMA.1121.00037,1,3478323,3504604,+,26281
484,BUMA.1121.00080,1,879461,905870,+,26409
484,BUMA.1121.00079,1,873069,899345,+,26276
484,BUMA.1121.00045,1,3199362,3225659,-,26297
484,BUMA.1121.00071,1,848375,874636,+,26261
484,BUMA.1121.00056,1,3051170,3077515,-,26345
484,BUMA.1121.00065,1,894610,920923,+,26313
484,BUMA.1121.00058,1,3742418,3768705,-,26287
484,BUMA.1121.00007,1,3261594,3287886,-,26292
484,BUMA.1121.00067,1,3522102,3548579,-,26477
484,BUMA.1121.00090,1,2940269,2966563,+,26294
484,BUMA.1121.00051,1,851005,877391,+,26386
484,BUMA.1121.00020,1,3355457,3381679,-,26222
484,BUMA.1121.00103,1,3547486,3573794,-,26308
484,BUMA.1121.00048,1,133361,159573,+,26212
484,BUMA.1121.00047,1,2121636,2147991,-,26355
484,BUMA.1121.00042,1,279395,305563,-,26168
484,BUMA.1121.00055,1,424986,451256,+,26270
484,BUMA.1121.00031,1,2230831,2257112,+,26281
484,BUMA.1121.00040,1,3302505,3328724,-,26219
484,BUMA.1121.00044,1,2549159,2575381,-,26222
484,BUMA.1121.00088,1,1724125,1750394,+,26269
484,BUMA.1121.00069,1,811409,837673,+,26264
484,BUMA.1121.00064,1,882810,909108,+,26298
484,BUMA.1121.00105,1,331948,358245,-,26297
484,BUMA.1121.00015,1,2327988,2354190,+,26202
484,BUMA.1121.00059,1,86143,112434,+,26291
484,BUMA.1121.00026,1,514018,540240,-,26222
484,BUMA.1121.00022,1,1390436,1416667,+,26231
484,BUMA.1121.00052,1,1034073,1060273,+,26200
484,BUMA.1121.00101,1,1611377,1637706,-,26329
484,BUMA.1121.00001,1,3238210,3264516,-,26306
484,BUMA.1121.00038,1,340834,367046,+,26212
484,BUMA.1121.00068,1,3716116,3742471,+,26355
484,BUMA.1121.00099,1,1506300,1532577,-,26277
484,BUMA.1121.00091,1,3672354,3698674,-,26320
484,BUMA.1121.00098,1,3565316,3591583,+,26267
484,BUMA.1121.00013,1,1230347,1256547,+,26200
484,BUMA.1121.00049,1,982467,1008725,-,26258
484,BUMA.1121.00072,1,822396,848631,+,26235
484,BUMA.1121.00076,1,498340,524634,-,26294
484,BUMA.1121.00083,1,726071,752363,-,26292
484,BUMA.1121.00078,1,1133796,1160093,-,26297
484,BUMA.1121.00095,1,803021,829278,-,26257
484,BUMA.1121.00077,1,3535586,3561788,+,26202
484,BUMA.1121.00063,1,855420,881684,+,26264
484,BUMA.1121.00061,1,858569,884806,+,26237
484,BUMA.1121.00050,1,894968,921175,-,26207
484,BUMA.1121.00081,1,340903,367115,+,26212
484,BUMA.1121.00074,1,2999786,3026091,-,26305
484,BUMA.1121.00062,1,3688270,3714554,-,26284
484,BUMA.1121.00060,1,1424975,1451272,-,26297
484,BUMA.1121.00070,1,829685,855924,+,26239
484,BUMA.1121.00075,1,355103,381396,+,26293
484,BUMA.1121.00041,1,2117539,2143815,+,26276
484,BUMA.1121.00073,1,856439,882676,+,26237
484,BUMA.1121.00017,1,3218654,3244876,-,26222
484,BUMA.1121.00066,1,832458,858722,+,26264
484,BUMA.1121.00107,1,691736,717883,+,26147
484,BUMA.1121.00085,1,630908,657108,+,26200
484,BUMA.1121.00030,1,3218722,3244943,-,26221
484,BUMA.1121.00112,1,2202846,2229100,-,26254
484,BUMA.1121.00002,1,1871630,1897861,+,26231
484,BUMA.1121.00082,1,952457,978749,+,26292
484,BUMA.1121.00014,1,1961500,1987781,-,26281
484,BUMA.1121.00011,1,724490,750757,-,26267
484,BUMA.1121.00019,1,3241970,3268192,-,26222
484,BUMA.1121.00057,1,1935337,1961622,+,26285
484,BUMA.1121.00018,1,1393712,1419979,+,26267
484,BUMA.1121.00039,1,959561,985836,+,26275
484,BUMA.1121.00016,1,2961080,2987369,+,26289
484,BUMA.1121.00004,1,3370877,3397099,-,26222
484,BUMA.1121.00005,1,2713357,2739630,-,26273
484,BUMA.1121.00100,1,443622,469922,-,26300
484,BUMA.1121.00006,1,340834,367046,+,26212
485,BUMA.1121.00027,1,3062360,3090399,+,28039
485,BUMA.1121.00025,1,1810798,1838829,-,28031
485,BUMA.1121.00021,1,1492188,1520213,+,28025
485,BUMA.1121.00023,1,3226526,3254557,+,28031
485,BUMA.1121.00024,1,3190387,3218399,-,28012
485,BUMA.1121.00033,1,3113403,3141408,+,28005
485,BUMA.1121.00034,1,3291939,3319951,-,28012
485,BUMA.1121.00036,1,703173,731186,+,28013
485,BUMA.1121.00032,1,1315061,1343073,-,28012
485,BUMA.1121.00009,1,682158,710213,-,28055
485,BUMA.1121.00008,1,3273193,3301205,-,28012
485,BUMA.1121.00003,1,3361474,3389501,+,28027
485,BUMA.1121.00109,1,988025,1016040,-,28015
485,BUMA.1121.00053,1,589359,617369,+,28010
485,BUMA.1121.00110,1,3901441,3929433,-,27992
485,BUMA.1121.00104,1,391400,419441,-,28041
485,BUMA.1121.00086,1,93152,121157,+,28005
485,BUMA.1121.00092,1,2974647,3002642,-,27995
485,BUMA.1121.00096,1,2370627,2398652,-,28025
485,BUMA.1121.00054,1,236984,264990,-,28006
485,BUMA.1121.00097,1,3118779,3146796,-,28017
485,BUMA.1121.00093,1,1623786,1651782,+,27996
485,BUMA.1121.00106,1,644836,672887,+,28051
485,BUMA.1121.00010,1,1873298,1901311,+,28013
485,BUMA.1121.00035,1,1941143,1969184,+,28041
485,BUMA.1121.00108,1,1862259,1890368,+,28109
485,BUMA.1121.00028,1,3261587,3289599,-,28012
485,BUMA.1121.00094,1,859561,887504,+,27943
485,BUMA.1121.00102,1,333142,361198,-,28056
485,BUMA.1121.00111,1,1003946,1031977,+,28031
485,BUMA.1121.00089,1,875537,903593,+,28056
485,BUMA.1121.00084,1,1098822,1126868,+,28046
485,BUMA.1121.00029,1,55,28095,-,28040
485,BUMA.1121.00012,1,3647938,3675963,+,28025
485,BUMA.1121.00087,1,3195404,3223408,-,28004
485,BUMA.1121.00043,1,850275,878328,+,28053
485,BUMA.1121.00046,1,1857767,1885786,+,28019
485,BUMA.1121.00037,1,3505659,3533704,+,28045
485,BUMA.1121.00080,1,906925,934868,+,27943
485,BUMA.1121.00079,1,900400,928469,+,28069
485,BUMA.1121.00045,1,3170276,3198306,-,28030
485,BUMA.1121.00071,1,875691,903715,+,28024
485,BUMA.1121.00056,1,3022059,3050114,-,28055
485,BUMA.1121.00065,1,921978,949992,+,28014
485,BUMA.1121.00058,1,3713424,3741362,-,27938
485,BUMA.1121.00007,1,3232496,3260538,-,28042
485,BUMA.1121.00067,1,3493023,3521046,-,28023
485,BUMA.1121.00090,1,2967618,2995649,+,28031
485,BUMA.1121.00051,1,878446,906389,+,27943
485,BUMA.1121.00020,1,3326407,3354419,-,28012
485,BUMA.1121.00103,1,3518409,3546430,-,28021
485,BUMA.1121.00048,1,160610,188617,+,28007
485,BUMA.1121.00047,1,2092638,2120580,-,27942
485,BUMA.1121.00042,1,250305,278357,-,28052
485,BUMA.1121.00055,1,452311,480316,+,28005
485,BUMA.1121.00031,1,2258167,2286214,+,28047
485,BUMA.1121.00040,1,3273448,3301467,-,28019
485,BUMA.1121.00044,1,2520109,2548121,-,28012
485,BUMA.1121.00088,1,1751449,1779496,+,28047
485,BUMA.1121.00069,1,838728,866750,+,28022
485,BUMA.1121.00064,1,910163,938178,+,28015
485,BUMA.1121.00105,1,302819,330892,-,28073
485,BUMA.1121.00015,1,2355227,2383246,+,28019
485,BUMA.1121.00059,1,113489,141512,+,28023
485,BUMA.1121.00026,1,484952,512980,-,28028
485,BUMA.1121.00022,1,1417704,1445714,+,28010
485,BUMA.1121.00052,1,1061310,1089330,+,28020
485,BUMA.1121.00101,1,1582307,1610321,-,28014
485,BUMA.1121.00001,1,3209099,3237154,-,28055
485,BUMA.1121.00038,1,368083,396090,+,28007
485,BUMA.1121.00068,1,3743526,3771559,+,28033
485,BUMA.1121.00099,1,1477213,1505244,-,28031
485,BUMA.1121.00091,1,3643277,3671298,-,28021
485,BUMA.1121.00098,1,3592638,3620662,+,28024
485,BUMA.1121.00013,1,1257584,1285592,+,28008
485,BUMA.1121.00049,1,953387,981411,-,28024
485,BUMA.1121.00072,1,849686,877710,+,28024
485,BUMA.1121.00076,1,469234,497284,-,28050
485,BUMA.1121.00083,1,696992,725015,-,28023
485,BUMA.1121.00078,1,1104750,1132740,-,27990
485,BUMA.1121.00095,1,773950,801964,-,28014
485,BUMA.1121.00077,1,3562842,3590834,+,27992
485,BUMA.1121.00063,1,882739,910758,+,28019
485,BUMA.1121.00061,1,885861,913884,+,28023
485,BUMA.1121.00050,1,865912,893930,-,28018
485,BUMA.1121.00081,1,368152,396159,+,28007
485,BUMA.1121.00074,1,2970708,2998730,-,28022
485,BUMA.1121.00062,1,3659199,3687214,-,28015
485,BUMA.1121.00060,1,1395889,1423919,-,28030
485,BUMA.1121.00070,1,856979,885003,+,28024
485,BUMA.1121.00075,1,382451,410501,+,28050
485,BUMA.1121.00041,1,2144870,2172811,+,27941
485,BUMA.1121.00073,1,883731,911755,+,28024
485,BUMA.1121.00017,1,3189604,3217616,-,28012
485,BUMA.1121.00066,1,859777,887801,+,28024
485,BUMA.1121.00107,1,718938,746997,+,28059
485,BUMA.1121.00085,1,658145,686165,+,28020
485,BUMA.1121.00030,1,3189672,3217684,-,28012
485,BUMA.1121.00112,1,2173710,2201790,-,28080
485,BUMA.1121.00002,1,1898898,1926911,+,28013
485,BUMA.1121.00082,1,979804,1007828,+,28024
485,BUMA.1121.00014,1,1932397,1960444,-,28047
485,BUMA.1121.00011,1,695406,723434,-,28028
485,BUMA.1121.00019,1,3212920,3240932,-,28012
485,BUMA.1121.00057,1,1962677,1990688,+,28011
485,BUMA.1121.00018,1,1421034,1449065,+,28031
485,BUMA.1121.00039,1,986891,1014963,+,28072
485,BUMA.1121.00016,1,2988424,3016420,+,27996
485,BUMA.1121.00004,1,3341827,3369839,-,28012
485,BUMA.1121.00005,1,2684272,2712301,-,28029
485,BUMA.1121.00100,1,414529,442566,-,28037
485,BUMA.1121.00006,1,368083,396090,+,28007
486,BUMA.1121.00027,1,3090410,3097925,+,7515
486,BUMA.1121.00025,1,1803295,1810787,-,7492
486,BUMA.1121.00021,1,1520224,1527706,+,7482
486,BUMA.1121.00023,1,3254568,3262062,+,7494
486,BUMA.1121.00024,1,3182891,3190376,-,7485
486,BUMA.1121.00033,1,3141419,3148917,+,7498
486,BUMA.1121.00034,1,3284443,3291928,-,7485
486,BUMA.1121.00036,1,731197,738682,+,7485
486,BUMA.1121.00032,1,1307565,1315050,-,7485
486,BUMA.1121.00009,1,674664,682147,-,7483
486,BUMA.1121.00008,1,3265697,3273182,-,7485
486,BUMA.1121.00003,1,3389512,3396992,+,7480
486,BUMA.1121.00109,1,980551,988014,-,7463
486,BUMA.1121.00053,1,617380,624868,+,7488
486,BUMA.1121.00110,1,3893949,3901430,-,7481
486,BUMA.1121.00104,1,383900,391389,-,7489
486,BUMA.1121.00086,1,121168,128653,+,7485
486,BUMA.1121.00092,1,2967120,2974636,-,7516
486,BUMA.1121.00096,1,2363147,2370616,-,7469
486,BUMA.1121.00054,1,229489,236973,-,7484
486,BUMA.1121.00097,1,3111285,3118768,-,7483
486,BUMA.1121.00093,1,1651793,1659309,+,7516
486,BUMA.1121.00106,1,672898,680386,+,7488
486,BUMA.1121.00010,1,1901322,1908805,+,7483
486,BUMA.1121.00035,1,1969195,1976673,+,7478
486,BUMA.1121.00108,1,1890379,1897868,+,7489
486,BUMA.1121.00028,1,3254091,3261576,-,7485
486,BUMA.1121.00094,1,887515,895007,+,7492
486,BUMA.1121.00102,1,325644,333131,-,7487
486,BUMA.1121.00111,1,1031988,1039471,+,7483
486,BUMA.1121.00089,1,903604,911092,+,7488
486,BUMA.1121.00084,1,1126879,1134388,+,7509
486,BUMA.1121.00029,1,4055069,4062495,-,7426
486,BUMA.1121.00012,1,3675974,3683468,+,7494
486,BUMA.1121.00087,1,3187908,3195393,-,7485
486,BUMA.1121.00043,1,878339,885817,+,7478
486,BUMA.1121.00046,1,1885797,1893282,+,7485
486,BUMA.1121.00037,1,3533715,3541205,+,7490
486,BUMA.1121.00080,1,934879,942388,+,7509
486,BUMA.1121.00079,1,928480,935983,+,7503
486,BUMA.1121.00045,1,3162795,3170265,-,7470
486,BUMA.1121.00071,1,903726,911235,+,7509
486,BUMA.1121.00056,1,3014559,3022048,-,7489
486,BUMA.1121.00065,1,950003,957483,+,7480
486,BUMA.1121.00058,1,3705934,3713413,-,7479
486,BUMA.1121.00007,1,3224996,3232485,-,7489
486,BUMA.1121.00067,1,3485508,3493012,-,7504
486,BUMA.1121.00090,1,2995660,3003154,+,7494
486,BUMA.1121.00051,1,906400,913909,+,7509
486,BUMA.1121.00020,1,3318911,3326396,-,7485
486,BUMA.1121.00103,1,3510911,3518398,-,7487
486,BUMA.1121.00048,1,188628,196112,+,7484
486,BUMA.1121.00047,1,2085117,2092627,-,7510
486,BUMA.1121.00042,1,242816,250294,-,7478
486,BUMA.1121.00055,1,480327,487819,+,7492
486,BUMA.1121.00031,1,2286225,2293719,+,7494
486,BUMA.1121.00040,1,3265952,3273437,-,7485
486,BUMA.1121.00044,1,2512613,2520098,-,7485
486,BUMA.1121.00088,1,1779507,1787010,+,7503
486,BUMA.1121.00069,1,866761,874270,+,7509
486,BUMA.1121.00064,1,938189,945675,+,7486
486,BUMA.1121.00105,1,295319,302808,-,7489
486,BUMA.1121.00015,1,2383257,2390742,+,7485
486,BUMA.1121.00059,1,141523,149011,+,7488
486,BUMA.1121.00026,1,477463,484941,-,7478
486,BUMA.1121.00022,1,1445725,1453210,+,7485
486,BUMA.1121.00052,1,1089341,1096824,+,7483
486,BUMA.1121.00101,1,1574815,1582296,-,7481
486,BUMA.1121.00001,1,3201609,3209088,-,7479
486,BUMA.1121.00038,1,396101,403585,+,7484
486,BUMA.1121.00068,1,3771570,3779037,+,7467
486,BUMA.1121.00099,1,1469712,1477202,-,7490
486,BUMA.1121.00091,1,3635777,3643266,-,7489
486,BUMA.1121.00098,1,3620673,3628155,+,7482
486,BUMA.1121.00013,1,1285603,1293086,+,7483
486,BUMA.1121.00049,1,945805,953376,-,7571
486,BUMA.1121.00072,1,877721,885228,+,7507
486,BUMA.1121.00076,1,461726,469223,-,7497
486,BUMA.1121.00083,1,689471,696981,-,7510
486,BUMA.1121.00078,1,1097256,1104739,-,7483
486,BUMA.1121.00095,1,766456,773939,-,7483
486,BUMA.1121.00077,1,3590845,3598324,+,7479
486,BUMA.1121.00063,1,910769,918276,+,7507
486,BUMA.1121.00061,1,913895,921401,+,7506
486,BUMA.1121.00050,1,858416,865901,-,7485
486,BUMA.1121.00081,1,396170,403654,+,7484
486,BUMA.1121.00074,1,2963207,2970697,-,7490
486,BUMA.1121.00062,1,3651699,3659188,-,7489
486,BUMA.1121.00060,1,1388408,1395878,-,7470
486,BUMA.1121.00070,1,885014,892523,+,7509
486,BUMA.1121.00075,1,410512,418008,+,7496
486,BUMA.1121.00041,1,2172822,2180310,+,7488
486,BUMA.1121.00073,1,911766,919275,+,7509
486,BUMA.1121.00017,1,3182108,3189593,-,7485
486,BUMA.1121.00066,1,887812,895321,+,7509
486,BUMA.1121.00107,1,747008,754494,+,7486
486,BUMA.1121.00085,1,686176,693659,+,7483
486,BUMA.1121.00030,1,3182176,3189661,-,7485
486,BUMA.1121.00112,1,2166210,2173699,-,7489
486,BUMA.1121.00002,1,1926922,1934407,+,7485
486,BUMA.1121.00082,1,1007839,1015348,+,7509
486,BUMA.1121.00014,1,1924891,1932386,-,7495
486,BUMA.1121.00011,1,687906,695395,-,7489
486,BUMA.1121.00019,1,3205424,3212909,-,7485
486,BUMA.1121.00057,1,1990699,1998200,+,7501
486,BUMA.1121.00018,1,1449076,1456566,+,7490
486,BUMA.1121.00039,1,1014974,1022456,+,7482
486,BUMA.1121.00016,1,3016431,3023921,+,7490
486,BUMA.1121.00004,1,3334331,3341816,-,7485
486,BUMA.1121.00005,1,2676780,2684261,-,7481
486,BUMA.1121.00100,1,407046,414518,-,7472
486,BUMA.1121.00006,1,396101,403585,+,7484
487,BUMA.1121.00027,1,3097927,3103754,+,5827
487,BUMA.1121.00025,1,1797465,1803293,-,5828
487,BUMA.1121.00021,1,1527708,1533536,+,5828
487,BUMA.1121.00023,1,3262064,3267892,+,5828
487,BUMA.1121.00024,1,1289402,1295232,-,5830
487,BUMA.1121.00033,1,3148919,3154746,+,5827
487,BUMA.1121.00034,1,1326790,1332620,-,5830
487,BUMA.1121.00036,1,2694822,2700652,-,5830
487,BUMA.1121.00032,1,2819868,2825698,-,5830
487,BUMA.1121.00009,1,668830,674663,-,5833
487,BUMA.1121.00008,1,1293116,1298946,-,5830
487,BUMA.1121.00003,1,3396994,3402821,+,5827
487,BUMA.1121.00109,1,974733,980550,-,5817
487,BUMA.1121.00053,1,626465,632292,+,5827
487,BUMA.1121.00110,1,3886527,3892354,-,5827
487,BUMA.1121.00104,1,378065,383899,-,5834
487,BUMA.1121.00086,1,2107271,2113101,-,5830
487,BUMA.1121.00092,1,2959690,2965523,-,5833
487,BUMA.1121.00096,1,2357312,2363146,-,5834
487,BUMA.1121.00054,1,1781220,1787050,+,5830
487,BUMA.1121.00097,1,3105457,3111284,-,5827
487,BUMA.1121.00093,1,1660906,1666739,+,5833
487,BUMA.1121.00106,1,680388,686215,+,5827
487,BUMA.1121.00010,1,399646,405476,+,5830
487,BUMA.1121.00035,1,1976675,1982503,+,5828
487,BUMA.1121.00108,1,1897870,1903697,+,5827
487,BUMA.1121.00028,1,1289446,1295276,-,5830
487,BUMA.1121.00094,1,895009,900836,+,5827
487,BUMA.1121.00102,1,318219,324046,-,5827
487,BUMA.1121.00111,1,1039473,1045301,+,5828
487,BUMA.1121.00089,1,911094,916928,+,5834
487,BUMA.1121.00084,1,1134390,1140217,+,5827
487,BUMA.1121.00029,1,4049240,4055068,-,5828
487,BUMA.1121.00012,1,3683470,3689298,+,5828
487,BUMA.1121.00087,1,1203989,1209819,+,5830
487,BUMA.1121.00043,1,885819,891647,+,5828
487,BUMA.1121.00046,1,410202,416032,-,5830
487,BUMA.1121.00037,1,3541207,3547035,+,5828
487,BUMA.1121.00080,1,942390,948217,+,5827
487,BUMA.1121.00079,1,935985,941812,+,5827
487,BUMA.1121.00045,1,3156967,3162794,-,5827
487,BUMA.1121.00071,1,911237,917064,+,5827
487,BUMA.1121.00056,1,3008724,3014558,-,5834
487,BUMA.1121.00065,1,957485,963312,+,5827
487,BUMA.1121.00058,1,3698503,3704337,-,5834
487,BUMA.1121.00007,1,3219175,3224995,-,5820
487,BUMA.1121.00067,1,3479680,3485507,-,5827
487,BUMA.1121.00090,1,3003156,3008984,+,5828
487,BUMA.1121.00051,1,913911,919738,+,5827
487,BUMA.1121.00020,1,1354335,1360165,-,5830
487,BUMA.1121.00103,1,3505083,3510910,-,5827
487,BUMA.1121.00048,1,2148692,2154522,-,5830
487,BUMA.1121.00047,1,2079289,2085116,-,5827
487,BUMA.1121.00042,1,950626,956456,-,5830
487,BUMA.1121.00055,1,487821,493655,+,5834
487,BUMA.1121.00031,1,2293721,2299575,+,5854
487,BUMA.1121.00040,1,1202417,1208221,+,5804
487,BUMA.1121.00044,1,554888,560718,-,5830
487,BUMA.1121.00088,1,1787012,1792846,+,5834
487,BUMA.1121.00069,1,874272,880099,+,5827
487,BUMA.1121.00064,1,945677,951504,+,5827
487,BUMA.1121.00105,1,289491,295318,-,5827
487,BUMA.1121.00015,1,2888702,2894532,-,5830
487,BUMA.1121.00059,1,149013,154847,+,5834
487,BUMA.1121.00026,1,390699,396529,-,5830
487,BUMA.1121.00022,1,1535642,1541472,+,5830
487,BUMA.1121.00052,1,980553,986383,-,5830
487,BUMA.1121.00101,1,1568981,1574814,-,5833
487,BUMA.1121.00001,1,3195780,3201608,-,5828
487,BUMA.1121.00038,1,2356103,2361933,-,5830
487,BUMA.1121.00068,1,3779039,3784850,+,5811
487,BUMA.1121.00099,1,1463872,1469711,-,5839
487,BUMA.1121.00091,1,3629949,3635776,-,5827
487,BUMA.1121.00098,1,3628157,3633984,+,5827
487,BUMA.1121.00013,1,19,5821,+,5802
487,BUMA.1121.00049,1,939977,945804,-,5827
487,BUMA.1121.00072,1,885230,891057,+,5827
487,BUMA.1121.00076,1,455898,461725,-,5827
487,BUMA.1121.00083,1,683643,689470,-,5827
487,BUMA.1121.00078,1,1091430,1097255,-,5825
487,BUMA.1121.00095,1,759043,764861,-,5818
487,BUMA.1121.00077,1,3599919,3605747,+,5828
487,BUMA.1121.00063,1,918278,924105,+,5827
487,BUMA.1121.00061,1,921403,927230,+,5827
487,BUMA.1121.00050,1,2335834,2341664,+,5830
487,BUMA.1121.00081,1,2356229,2362060,-,5831
487,BUMA.1121.00074,1,2957379,2963206,-,5827
487,BUMA.1121.00062,1,3645871,3651698,-,5827
487,BUMA.1121.00060,1,1382580,1388407,-,5827
487,BUMA.1121.00070,1,892525,898352,+,5827
487,BUMA.1121.00075,1,418010,423837,+,5827
487,BUMA.1121.00041,1,2180312,2186139,+,5827
487,BUMA.1121.00073,1,919277,925104,+,5827
487,BUMA.1121.00017,1,1224427,1230257,-,5830
487,BUMA.1121.00066,1,895323,901150,+,5827
487,BUMA.1121.00107,1,754496,760329,+,5833
487,BUMA.1121.00085,1,577388,583218,-,5830
487,BUMA.1121.00030,1,1224467,1230297,-,5830
487,BUMA.1121.00112,1,2160382,2166209,-,5827
487,BUMA.1121.00002,1,424970,430800,+,5830
487,BUMA.1121.00082,1,1015350,1021177,+,5827
487,BUMA.1121.00014,1,1919034,1924889,-,5855
487,BUMA.1121.00011,1,682071,687905,-,5834
487,BUMA.1121.00019,1,1289458,1295288,-,5830
487,BUMA.1121.00057,1,1998202,2004029,+,5827
487,BUMA.1121.00018,1,1456568,1462396,+,5828
487,BUMA.1121.00039,1,1022458,1028286,+,5828
487,BUMA.1121.00016,1,3023923,3029766,+,5843
487,BUMA.1121.00004,1,1290618,1296448,-,5830
487,BUMA.1121.00005,1,2670952,2676779,-,5827
487,BUMA.1121.00100,1,401218,407045,-,5827
487,BUMA.1121.00006,1,2356020,2361850,-,5830
488,BUMA.1121.00027,1,3107090,3115170,+,8080
488,BUMA.1121.00025,1,1786074,1794158,-,8084
488,BUMA.1121.00021,1,1536849,1544928,+,8079
488,BUMA.1121.00023,1,3271275,3279415,+,8140
488,BUMA.1121.00024,1,1278244,1286274,-,8030
488,BUMA.1121.00033,1,3158099,3166272,+,8173
488,BUMA.1121.00034,1,1315632,1323662,-,8030
488,BUMA.1121.00032,1,2808614,2816740,-,8126
488,BUMA.1121.00009,1,657331,665496,-,8165
488,BUMA.1121.00008,1,1281958,1289988,-,8030
488,BUMA.1121.00003,1,3406099,3414367,+,8268
488,BUMA.1121.00109,1,963132,971415,-,8283
488,BUMA.1121.00053,1,635585,643731,+,8146
488,BUMA.1121.00110,1,3875070,3883218,-,8148
488,BUMA.1121.00104,1,366599,374732,-,8133
488,BUMA.1121.00086,1,2096034,2104143,-,8109
488,BUMA.1121.00092,1,2948252,2956371,-,8119
488,BUMA.1121.00096,1,2345871,2354070,-,8199
488,BUMA.1121.00054,1,1790177,1798180,+,8003
488,BUMA.1121.00097,1,3094097,3102121,-,8024
488,BUMA.1121.00093,1,1670057,1678176,+,8119
488,BUMA.1121.00106,1,689553,697670,+,8117
488,BUMA.1121.00010,1,1615795,1623799,-,8004
488,BUMA.1121.00035,1,1985827,1993904,+,8077
488,BUMA.1121.00108,1,1907011,1915109,+,8098
488,BUMA.1121.00028,1,1278288,1286318,-,8030
488,BUMA.1121.00094,1,904132,912200,+,8068
488,BUMA.1121.00102,1,306864,314901,-,8037
488,BUMA.1121.00111,1,1048630,1056873,+,8243
488,BUMA.1121.00089,1,920224,928281,+,8057
488,BUMA.1121.00084,1,1143549,1151664,+,8115
488,BUMA.1121.00029,1,4037657,4045903,-,8246
488,BUMA.1121.00012,1,3692650,3700911,+,8261
488,BUMA.1121.00087,1,1212946,1220999,+,8053
488,BUMA.1121.00043,1,895158,903255,+,8097
488,BUMA.1121.00046,1,399024,407074,-,8050
488,BUMA.1121.00037,1,3550310,3558425,+,8115
488,BUMA.1121.00080,1,951491,959532,+,8041
488,BUMA.1121.00079,1,945080,953193,+,8113
488,BUMA.1121.00045,1,3145530,3153660,-,8130
488,BUMA.1121.00071,1,920312,928376,+,8064
488,BUMA.1121.00056,1,2997378,3005427,-,8049
488,BUMA.1121.00065,1,966577,974691,+,8114
488,BUMA.1121.00058,1,3687165,3695161,-,7996
488,BUMA.1121.00007,1,3207644,3215858,-,8214
488,BUMA.1121.00067,1,3468300,3476397,-,8097
488,BUMA.1121.00090,1,3012383,3020512,+,8129
488,BUMA.1121.00051,1,923013,931102,+,8089
488,BUMA.1121.00020,1,1343177,1351207,-,8030
488,BUMA.1121.00103,1,3493750,3501828,-,8078
488,BUMA.1121.00048,1,2137562,2145564,-,8002
488,BUMA.1121.00047,1,2067916,2076005,-,8089
488,BUMA.1121.00055,1,496937,505092,+,8155
488,BUMA.1121.00031,1,2302961,2311098,+,8137
488,BUMA.1121.00040,1,1211236,1219321,+,8085
488,BUMA.1121.00044,1,543730,551760,-,8030
488,BUMA.1121.00088,1,1796196,1804282,+,8086
488,BUMA.1121.00069,1,883319,891383,+,8064
488,BUMA.1121.00064,1,954832,962907,+,8075
488,BUMA.1121.00105,1,278014,286155,-,8141
488,BUMA.1121.00015,1,2877479,2885553,-,8074
488,BUMA.1121.00059,1,158152,166269,+,8117
488,BUMA.1121.00026,1,378754,386751,-,7997
488,BUMA.1121.00022,1,1544599,1552668,+,8069
488,BUMA.1121.00052,1,969646,977648,-,8002
488,BUMA.1121.00101,1,1557628,1565706,-,8078
488,BUMA.1121.00001,1,3184168,3192422,-,8254
488,BUMA.1121.00038,1,2344973,2352975,-,8002
488,BUMA.1121.00068,1,3788188,3796333,+,8145
488,BUMA.1121.00099,1,1452360,1460495,-,8135
488,BUMA.1121.00091,1,3618638,3626674,-,8036
488,BUMA.1121.00098,1,3637255,3645417,+,8162
488,BUMA.1121.00013,1,8725,16728,+,8003
488,BUMA.1121.00049,1,928552,936693,-,8141
488,BUMA.1121.00072,1,894271,902300,+,8029
488,BUMA.1121.00076,1,444537,452649,-,8112
488,BUMA.1121.00083,1,672255,680319,-,8064
488,BUMA.1121.00078,1,1080115,1088159,-,8044
488,BUMA.1121.00095,1,747550,755744,-,8194
488,BUMA.1121.00077,1,3609054,3617202,+,8148
488,BUMA.1121.00063,1,927346,935410,+,8064
488,BUMA.1121.00061,1,930469,938545,+,8076
488,BUMA.1121.00050,1,2344791,2352842,+,8051
488,BUMA.1121.00081,1,2345099,2353101,-,8002
488,BUMA.1121.00074,1,2945993,2954027,-,8034
488,BUMA.1121.00062,1,3634532,3642568,-,8036
488,BUMA.1121.00060,1,1371119,1379273,-,8154
488,BUMA.1121.00070,1,901642,909706,+,8064
488,BUMA.1121.00075,1,427083,435187,+,8104
488,BUMA.1121.00041,1,2189444,2197540,+,8096
488,BUMA.1121.00073,1,928415,936479,+,8064
488,BUMA.1121.00017,1,1213269,1221299,-,8030
488,BUMA.1121.00066,1,904404,912468,+,8064
488,BUMA.1121.00107,1,763576,771727,+,8151
488,BUMA.1121.00085,1,566481,574483,-,8002
488,BUMA.1121.00030,1,1213309,1221339,-,8030
488,BUMA.1121.00112,1,2149009,2157056,-,8047
488,BUMA.1121.00002,1,1642150,1650154,-,8004
488,BUMA.1121.00082,1,1024500,1032564,+,8064
488,BUMA.1121.00014,1,1907605,1915709,-,8104
488,BUMA.1121.00011,1,670657,678761,-,8104
488,BUMA.1121.00019,1,1278300,1286330,-,8030
488,BUMA.1121.00057,1,2007313,2015493,+,8180
488,BUMA.1121.00018,1,1465702,1473794,+,8092
488,BUMA.1121.00039,1,1031660,1039847,+,8187
488,BUMA.1121.00016,1,3033095,3041330,+,8235
488,BUMA.1121.00004,1,1279460,1287490,-,8030
488,BUMA.1121.00005,1,2659597,2667702,-,8105
488,BUMA.1121.00100,1,389724,397904,-,8180
488,BUMA.1121.00006,1,2344890,2352892,-,8002
489,BUMA.1121.00027,1,3117288,3122348,+,5060
489,BUMA.1121.00025,1,1778598,1783957,-,5359
489,BUMA.1121.00021,1,1547046,1551707,+,4661
489,BUMA.1121.00023,1,3281533,3286927,+,5394
489,BUMA.1121.00024,1,1271181,1276118,-,4937
489,BUMA.1121.00033,1,3168390,3173057,+,4667
489,BUMA.1121.00034,1,1308569,1313506,-,4937
489,BUMA.1121.00032,1,2801551,2806488,-,4937
489,BUMA.1121.00009,1,650073,655205,-,5132
489,BUMA.1121.00008,1,1274895,1279832,-,4937
489,BUMA.1121.00003,1,3416485,3421885,+,5400
489,BUMA.1121.00109,1,955986,961014,-,5028
489,BUMA.1121.00053,1,645849,650714,+,4865
489,BUMA.1121.00110,1,3867651,3872952,-,5301
489,BUMA.1121.00104,1,359165,364503,-,5338
489,BUMA.1121.00086,1,2088956,2093908,-,4952
489,BUMA.1121.00092,1,2940927,2946135,-,5208
489,BUMA.1121.00096,1,2338492,2343766,-,5274
489,BUMA.1121.00054,1,1800291,1805303,+,5012
489,BUMA.1121.00097,1,3086680,3091959,-,5279
489,BUMA.1121.00093,1,1680293,1685502,+,5209
489,BUMA.1121.00106,1,699788,705112,+,5324
489,BUMA.1121.00010,1,1609116,1613678,-,4562
489,BUMA.1121.00035,1,1996030,2001375,+,5345
489,BUMA.1121.00108,1,1917218,1922453,+,5235
489,BUMA.1121.00028,1,1271225,1276162,-,4937
489,BUMA.1121.00094,1,914317,919398,+,5081
489,BUMA.1121.00102,1,299588,304768,-,5180
489,BUMA.1121.00111,1,1058991,1063680,+,4689
489,BUMA.1121.00089,1,930399,935685,+,5286
489,BUMA.1121.00084,1,1152904,1158288,+,5384
489,BUMA.1121.00029,1,4030210,4035539,-,5329
489,BUMA.1121.00012,1,3703028,3708206,+,5178
489,BUMA.1121.00087,1,1223125,1228078,+,4953
489,BUMA.1121.00043,1,905373,910046,+,4673
489,BUMA.1121.00046,1,391945,396912,-,4967
489,BUMA.1121.00037,1,3560543,3565997,+,5454
489,BUMA.1121.00080,1,961650,966941,+,5291
489,BUMA.1121.00079,1,955310,960610,+,5300
489,BUMA.1121.00045,1,3138012,3143416,-,5404
489,BUMA.1121.00071,1,930493,935554,+,5061
489,BUMA.1121.00056,1,2989975,2995260,-,5285
489,BUMA.1121.00065,1,976787,982041,+,5254
489,BUMA.1121.00058,1,3679906,3685084,-,5178
489,BUMA.1121.00007,1,3200249,3205536,-,5287
489,BUMA.1121.00067,1,3461032,3466182,-,5150
489,BUMA.1121.00090,1,3022630,3027309,+,4679
489,BUMA.1121.00051,1,933219,938520,+,5301
489,BUMA.1121.00020,1,1336114,1341051,-,4937
489,BUMA.1121.00103,1,3486445,3491634,-,5189
489,BUMA.1121.00048,1,2130438,2135450,-,5012
489,BUMA.1121.00047,1,2060498,2065798,-,5300
489,BUMA.1121.00055,1,507199,512396,+,5197
489,BUMA.1121.00031,1,2313233,2318539,+,5306
489,BUMA.1121.00040,1,1221447,1226445,+,4998
489,BUMA.1121.00044,1,536667,541604,-,4937
489,BUMA.1121.00088,1,1806369,1811768,+,5399
489,BUMA.1121.00069,1,893490,898350,+,4860
489,BUMA.1121.00064,1,965035,970215,+,5180
489,BUMA.1121.00105,1,270560,275918,-,5358
489,BUMA.1121.00015,1,2870415,2875367,-,4952
489,BUMA.1121.00059,1,168387,173597,+,5210
489,BUMA.1121.00026,1,371715,376637,-,4922
489,BUMA.1121.00022,1,1554794,1559762,+,4968
489,BUMA.1121.00052,1,962586,967534,-,4948
489,BUMA.1121.00101,1,1550278,1555532,-,5254
489,BUMA.1121.00001,1,3176713,3182042,-,5329
489,BUMA.1121.00038,1,2337849,2342861,-,5012
489,BUMA.1121.00068,1,3798437,3803663,+,5226
489,BUMA.1121.00099,1,1445008,1450264,-,5256
489,BUMA.1121.00091,1,3611303,3616512,-,5209
489,BUMA.1121.00098,1,3647513,3652769,+,5256
489,BUMA.1121.00013,1,18848,23797,+,4949
489,BUMA.1121.00049,1,921109,926456,-,5347
489,BUMA.1121.00072,1,904407,909355,+,4948
489,BUMA.1121.00076,1,437103,442441,-,5338
489,BUMA.1121.00083,1,665078,670138,-,5060
489,BUMA.1121.00078,1,1072885,1077998,-,5113
489,BUMA.1121.00095,1,740221,745434,-,5213
489,BUMA.1121.00077,1,3619320,3624622,+,5302
489,BUMA.1121.00063,1,937527,942588,+,5061
489,BUMA.1121.00061,1,940640,945411,+,4771
489,BUMA.1121.00050,1,2354953,2359921,+,4968
489,BUMA.1121.00081,1,2337975,2342987,-,5012
489,BUMA.1121.00074,1,2938685,2943864,-,5179
489,BUMA.1121.00062,1,3627227,3632415,-,5188
489,BUMA.1121.00060,1,1363601,1369005,-,5404
489,BUMA.1121.00070,1,911813,916620,+,4807
489,BUMA.1121.00075,1,437283,442622,+,5339
489,BUMA.1121.00041,1,2199635,2204922,+,5287
489,BUMA.1121.00073,1,938586,943482,+,4896
489,BUMA.1121.00017,1,1206206,1211143,-,4937
489,BUMA.1121.00066,1,914580,919638,+,5058
489,BUMA.1121.00107,1,773823,779202,+,5379
489,BUMA.1121.00085,1,559421,564369,-,4948
489,BUMA.1121.00030,1,1206246,1211183,-,4937
489,BUMA.1121.00112,1,2142002,2146882,-,4880
489,BUMA.1121.00002,1,1635381,1640033,-,4652
489,BUMA.1121.00082,1,1034681,1039742,+,5061
489,BUMA.1121.00014,1,1900147,1905452,-,5305
489,BUMA.1121.00011,1,663272,668540,-,5268
489,BUMA.1121.00019,1,1271237,1276174,-,4937
489,BUMA.1121.00057,1,2017611,2022672,+,5061
489,BUMA.1121.00018,1,1475911,1481271,+,5360
489,BUMA.1121.00039,1,1041965,1047254,+,5289
489,BUMA.1121.00016,1,3043448,3048092,+,4644
489,BUMA.1121.00004,1,1272397,1277334,-,4937
489,BUMA.1121.00005,1,2652440,2657470,-,5030
489,BUMA.1121.00100,1,382488,387620,-,5132
489,BUMA.1121.00006,1,2337767,2342778,-,5011
490,BUMA.1121.00027,1,3122349,3125702,+,3353
490,BUMA.1121.00025,1,1775235,1778596,-,3361
490,BUMA.1121.00021,1,1551708,1555064,+,3356
490,BUMA.1121.00023,1,3286928,3290284,+,3356
490,BUMA.1121.00024,1,1267809,1271179,-,3370
490,BUMA.1121.00033,1,3173058,3176420,+,3362
490,BUMA.1121.00034,1,1305197,1308567,-,3370
490,BUMA.1121.00032,1,2798179,2801549,-,3370
490,BUMA.1121.00009,1,646709,650071,-,3362
490,BUMA.1121.00008,1,1271523,1274893,-,3370
490,BUMA.1121.00003,1,3421886,3425251,+,3365
490,BUMA.1121.00109,1,952614,955984,-,3370
490,BUMA.1121.00053,1,650715,654077,+,3362
490,BUMA.1121.00110,1,3864285,3867649,-,3364
490,BUMA.1121.00104,1,355790,359163,-,3373
490,BUMA.1121.00086,1,2085584,2088954,-,3370
490,BUMA.1121.00092,1,2937561,2940925,-,3364
490,BUMA.1121.00096,1,2335126,2338490,-,3364
490,BUMA.1121.00054,1,1805304,1808675,+,3371
490,BUMA.1121.00097,1,3083314,3086678,-,3364
490,BUMA.1121.00093,1,1685503,1688868,+,3365
490,BUMA.1121.00106,1,705113,708487,+,3374
490,BUMA.1121.00010,1,1605744,1609114,-,3370
490,BUMA.1121.00035,1,2001376,2004738,+,3362
490,BUMA.1121.00108,1,1922454,1925819,+,3365
490,BUMA.1121.00028,1,1267853,1271223,-,3370
490,BUMA.1121.00094,1,919399,922761,+,3362
490,BUMA.1121.00102,1,296233,299586,-,3353
490,BUMA.1121.00111,1,1063681,1067043,+,3362
490,BUMA.1121.00089,1,935686,939048,+,3362
490,BUMA.1121.00084,1,1158289,1161663,+,3374
490,BUMA.1121.00029,1,4026847,4030208,-,3361
490,BUMA.1121.00012,1,3708207,3711569,+,3362
490,BUMA.1121.00087,1,1228079,1231450,+,3371
490,BUMA.1121.00043,1,910047,913403,+,3356
490,BUMA.1121.00046,1,388573,391943,-,3370
490,BUMA.1121.00037,1,3565998,3569360,+,3362
490,BUMA.1121.00080,1,966942,970307,+,3365
490,BUMA.1121.00079,1,960611,963973,+,3362
490,BUMA.1121.00045,1,3134646,3138010,-,3364
490,BUMA.1121.00071,1,935555,938920,+,3365
490,BUMA.1121.00056,1,2986612,2989973,-,3361
490,BUMA.1121.00065,1,982042,985404,+,3362
490,BUMA.1121.00058,1,3676534,3679904,-,3370
490,BUMA.1121.00007,1,3196874,3200247,-,3373
490,BUMA.1121.00067,1,3457669,3461030,-,3361
490,BUMA.1121.00090,1,3027310,3030672,+,3362
490,BUMA.1121.00051,1,938521,941883,+,3362
490,BUMA.1121.00020,1,1332742,1336112,-,3370
490,BUMA.1121.00103,1,3483092,3486442,-,3350
490,BUMA.1121.00048,1,2127066,2130436,-,3370
490,BUMA.1121.00047,1,2057135,2060496,-,3361
490,BUMA.1121.00055,1,512397,515763,+,3366
490,BUMA.1121.00031,1,2318540,2321902,+,3362
490,BUMA.1121.00040,1,1226446,1229817,+,3371
490,BUMA.1121.00044,1,533295,536665,-,3370
490,BUMA.1121.00088,1,1811769,1815143,+,3374
490,BUMA.1121.00069,1,898351,901715,+,3364
490,BUMA.1121.00064,1,970216,973581,+,3365
490,BUMA.1121.00105,1,265563,268934,-,3371
490,BUMA.1121.00015,1,2867043,2870413,-,3370
490,BUMA.1121.00059,1,173598,176963,+,3365
490,BUMA.1121.00026,1,368343,371713,-,3370
490,BUMA.1121.00022,1,1559763,1563134,+,3371
490,BUMA.1121.00052,1,959214,962584,-,3370
490,BUMA.1121.00101,1,1546912,1550276,-,3364
490,BUMA.1121.00001,1,3173350,3176711,-,3361
490,BUMA.1121.00038,1,2334477,2337847,-,3370
490,BUMA.1121.00068,1,3803664,3807029,+,3365
490,BUMA.1121.00099,1,1441600,1444971,-,3371
490,BUMA.1121.00091,1,3607937,3611301,-,3364
490,BUMA.1121.00098,1,3652770,3656153,+,3383
490,BUMA.1121.00013,1,23798,27169,+,3371
490,BUMA.1121.00049,1,917742,921107,-,3365
490,BUMA.1121.00072,1,909356,912721,+,3365
490,BUMA.1121.00076,1,433728,437101,-,3373
490,BUMA.1121.00083,1,661712,665076,-,3364
490,BUMA.1121.00078,1,1069524,1072883,-,3359
490,BUMA.1121.00095,1,736855,740218,-,3363
490,BUMA.1121.00077,1,3624623,3627988,+,3365
490,BUMA.1121.00063,1,942589,945954,+,3365
490,BUMA.1121.00061,1,945412,948777,+,3365
490,BUMA.1121.00050,1,2359922,2363293,+,3371
490,BUMA.1121.00081,1,2334603,2337973,-,3370
490,BUMA.1121.00074,1,2935319,2938683,-,3364
490,BUMA.1121.00062,1,3623861,3627225,-,3364
490,BUMA.1121.00060,1,1360235,1363599,-,3364
490,BUMA.1121.00070,1,916621,919986,+,3365
490,BUMA.1121.00075,1,442623,445997,+,3374
490,BUMA.1121.00041,1,2204923,2208288,+,3365
490,BUMA.1121.00073,1,943483,946848,+,3365
490,BUMA.1121.00017,1,1202834,1206204,-,3370
490,BUMA.1121.00066,1,919639,923004,+,3365
490,BUMA.1121.00107,1,779203,782577,+,3374
490,BUMA.1121.00085,1,556049,559419,-,3370
490,BUMA.1121.00030,1,1202874,1206244,-,3370
490,BUMA.1121.00112,1,2138618,2142000,-,3382
490,BUMA.1121.00002,1,1632009,1635379,-,3370
490,BUMA.1121.00082,1,1039743,1043108,+,3365
490,BUMA.1121.00014,1,1896784,1900145,-,3361
490,BUMA.1121.00011,1,659906,663270,-,3364
490,BUMA.1121.00019,1,1267865,1271235,-,3370
490,BUMA.1121.00057,1,2022673,2026027,+,3354
490,BUMA.1121.00018,1,1481272,1484634,+,3362
490,BUMA.1121.00039,1,1047255,1050617,+,3362
490,BUMA.1121.00016,1,3048093,3051455,+,3362
490,BUMA.1121.00004,1,1269025,1272395,-,3370
490,BUMA.1121.00005,1,2649068,2652438,-,3370
490,BUMA.1121.00100,1,379122,382486,-,3364
490,BUMA.1121.00006,1,2334395,2337765,-,3370
491,BUMA.1121.00027,1,3125793,3129876,+,4083
491,BUMA.1121.00025,1,1771053,1775144,-,4091
491,BUMA.1121.00021,1,1555155,1559245,+,4090
491,BUMA.1121.00023,1,3290375,3294465,+,4090
491,BUMA.1121.00024,1,3068215,3072322,-,4107
491,BUMA.1121.00033,1,3176511,3180600,+,4089
491,BUMA.1121.00034,1,3176816,3180923,-,4107
491,BUMA.1121.00036,1,2666646,2670752,+,4106
491,BUMA.1121.00032,1,1192889,1196996,-,4107
491,BUMA.1121.00009,1,642513,646618,-,4105
491,BUMA.1121.00008,1,3151021,3155128,-,4107
491,BUMA.1121.00003,1,3425342,3429431,+,4089
491,BUMA.1121.00109,1,948433,952523,-,4090
491,BUMA.1121.00053,1,654168,658258,+,4090
491,BUMA.1121.00110,1,3860104,3864194,-,4090
491,BUMA.1121.00104,1,351599,355699,-,4100
491,BUMA.1121.00086,1,130271,134376,-,4105
491,BUMA.1121.00092,1,2933385,2937470,-,4085
491,BUMA.1121.00096,1,2330928,2335035,-,4107
491,BUMA.1121.00054,1,116157,120264,-,4107
491,BUMA.1121.00097,1,3079126,3083223,-,4097
491,BUMA.1121.00093,1,1688959,1693043,+,4084
491,BUMA.1121.00106,1,708578,712668,+,4090
491,BUMA.1121.00010,1,1910421,1914525,-,4104
491,BUMA.1121.00035,1,2004829,2008919,+,4090
491,BUMA.1121.00108,1,1925910,1930000,+,4090
491,BUMA.1121.00028,1,3139415,3143522,-,4107
491,BUMA.1121.00094,1,922852,926942,+,4090
491,BUMA.1121.00102,1,292051,296142,-,4091
491,BUMA.1121.00111,1,1067134,1071224,+,4090
491,BUMA.1121.00089,1,939139,943229,+,4090
491,BUMA.1121.00084,1,1161754,1165859,+,4105
491,BUMA.1121.00029,1,4022666,4026756,-,4090
491,BUMA.1121.00012,1,3711660,3715743,+,4083
491,BUMA.1121.00087,1,3182185,3186292,+,4107
491,BUMA.1121.00043,1,913494,917584,+,4090
491,BUMA.1121.00046,1,2005096,2009202,+,4106
491,BUMA.1121.00037,1,3569451,3573541,+,4090
491,BUMA.1121.00080,1,970398,974488,+,4090
491,BUMA.1121.00079,1,964064,968154,+,4090
491,BUMA.1121.00045,1,3130443,3134555,-,4112
491,BUMA.1121.00071,1,939011,943110,+,4099
491,BUMA.1121.00056,1,2982430,2986521,-,4091
491,BUMA.1121.00065,1,985495,989585,+,4090
491,BUMA.1121.00058,1,3672352,3676443,-,4091
491,BUMA.1121.00007,1,3192686,3196783,-,4097
491,BUMA.1121.00067,1,3453487,3457578,-,4091
491,BUMA.1121.00090,1,3030763,3034847,+,4084
491,BUMA.1121.00051,1,941974,946064,+,4090
491,BUMA.1121.00020,1,3204235,3208342,-,4107
491,BUMA.1121.00103,1,3478911,3483001,-,4090
491,BUMA.1121.00048,1,305335,309442,+,4107
491,BUMA.1121.00047,1,2052953,2057044,-,4091
491,BUMA.1121.00042,1,941736,945840,-,4104
491,BUMA.1121.00055,1,515854,519949,+,4095
491,BUMA.1121.00031,1,2321993,2326077,+,4084
491,BUMA.1121.00040,1,3260224,3264330,+,4106
491,BUMA.1121.00044,1,2404986,2409093,-,4107
491,BUMA.1121.00088,1,1815234,1819324,+,4090
491,BUMA.1121.00069,1,901806,905922,+,4116
491,BUMA.1121.00064,1,973672,977762,+,4090
491,BUMA.1121.00105,1,261387,265472,-,4085
491,BUMA.1121.00015,1,2495119,2499225,+,4106
491,BUMA.1121.00059,1,177054,181144,+,4090
491,BUMA.1121.00026,1,471740,475845,+,4105
491,BUMA.1121.00022,1,37112,41218,+,4106
491,BUMA.1121.00052,1,1098442,1102547,-,4105
491,BUMA.1121.00101,1,1542725,1546821,-,4096
491,BUMA.1121.00001,1,3169168,3173259,-,4091
491,BUMA.1121.00038,1,512810,516917,+,4107
491,BUMA.1121.00068,1,3807120,3811228,+,4108
491,BUMA.1121.00099,1,1437413,1441509,-,4096
491,BUMA.1121.00091,1,3603755,3607846,-,4091
491,BUMA.1121.00098,1,3656244,3660340,+,4096
491,BUMA.1121.00013,1,1294704,1298809,-,4105
491,BUMA.1121.00049,1,913551,917651,-,4100
491,BUMA.1121.00072,1,912812,916911,+,4099
491,BUMA.1121.00076,1,429537,433637,-,4100
491,BUMA.1121.00083,1,657521,661621,-,4100
491,BUMA.1121.00078,1,1065342,1069433,-,4091
491,BUMA.1121.00095,1,732673,736764,-,4091
491,BUMA.1121.00077,1,3628079,3632184,+,4105
491,BUMA.1121.00063,1,946045,950144,+,4099
491,BUMA.1121.00061,1,948868,952967,+,4099
491,BUMA.1121.00050,1,742496,746601,-,4105
491,BUMA.1121.00081,1,512879,516986,+,4107
491,BUMA.1121.00074,1,2931137,2935228,-,4091
491,BUMA.1121.00062,1,3619679,3623770,-,4091
491,BUMA.1121.00060,1,1356032,1360144,-,4112
491,BUMA.1121.00070,1,920077,924176,+,4099
491,BUMA.1121.00075,1,446088,450187,+,4099
491,BUMA.1121.00041,1,2208379,2212480,+,4101
491,BUMA.1121.00073,1,946939,951038,+,4099
491,BUMA.1121.00017,1,3074481,3078588,-,4107
491,BUMA.1121.00066,1,923095,927194,+,4099
491,BUMA.1121.00107,1,782668,786770,+,4102
491,BUMA.1121.00085,1,695277,699382,-,4105
491,BUMA.1121.00030,1,3074549,3078656,-,4107
491,BUMA.1121.00112,1,2134426,2138527,-,4101
491,BUMA.1121.00002,1,1936026,1940130,-,4104
491,BUMA.1121.00082,1,1043199,1047298,+,4099
491,BUMA.1121.00014,1,1892602,1896693,-,4091
491,BUMA.1121.00011,1,655730,659815,-,4085
491,BUMA.1121.00019,1,3090748,3094855,-,4107
491,BUMA.1121.00057,1,2026118,2030202,+,4084
491,BUMA.1121.00018,1,1484725,1488815,+,4090
491,BUMA.1121.00039,1,1050708,1054798,+,4090
491,BUMA.1121.00016,1,3051546,3055636,+,4090
491,BUMA.1121.00004,1,3219655,3223762,-,4107
491,BUMA.1121.00005,1,2644881,2648977,-,4096
491,BUMA.1121.00100,1,374940,379031,-,4091
491,BUMA.1121.00006,1,512810,516917,+,4107
492,BUMA.1121.00027,1,3134649,3154970,+,20321
492,BUMA.1121.00025,1,1745961,1766280,-,20319
492,BUMA.1121.00021,1,1564019,1584337,+,20318
492,BUMA.1121.00023,1,3299239,3319575,+,20336
492,BUMA.1121.00024,1,1302213,1322542,+,20329
492,BUMA.1121.00033,1,3185373,3205691,+,20318
492,BUMA.1121.00034,1,1339620,1359949,+,20329
492,BUMA.1121.00036,1,2672370,2692697,-,20327
492,BUMA.1121.00032,1,2832697,2853026,+,20329
492,BUMA.1121.00009,1,617424,637756,-,20332
492,BUMA.1121.00008,1,1305946,1326275,+,20329
492,BUMA.1121.00003,1,3434203,3454523,+,20320
492,BUMA.1121.00109,1,923327,943661,-,20334
492,BUMA.1121.00053,1,663031,683349,+,20318
492,BUMA.1121.00110,1,3835004,3855332,-,20328
492,BUMA.1121.00104,1,326553,346827,-,20274
492,BUMA.1121.00086,1,2063898,2084223,-,20325
492,BUMA.1121.00092,1,2908288,2928613,-,20325
492,BUMA.1121.00096,1,2305843,2326163,-,20320
492,BUMA.1121.00054,1,1810006,1830335,+,20329
492,BUMA.1121.00097,1,3054035,3074354,-,20319
492,BUMA.1121.00093,1,1697816,1718140,+,20324
492,BUMA.1121.00106,1,717441,737708,+,20267
492,BUMA.1121.00010,1,371104,391431,-,20327
492,BUMA.1121.00035,1,2013693,2034026,+,20333
492,BUMA.1121.00108,1,1934773,1955090,+,20317
492,BUMA.1121.00028,1,1302276,1322605,+,20329
492,BUMA.1121.00094,1,931715,952037,+,20322
492,BUMA.1121.00102,1,266960,287279,-,20319
492,BUMA.1121.00111,1,1075997,1096331,+,20334
492,BUMA.1121.00089,1,948002,968324,+,20322
492,BUMA.1121.00084,1,1170632,1190906,+,20274
492,BUMA.1121.00029,1,3997561,4017894,-,20333
492,BUMA.1121.00012,1,3720515,3740877,+,20362
492,BUMA.1121.00087,1,1232810,1253136,+,20326
492,BUMA.1121.00043,1,922357,942674,+,20317
492,BUMA.1121.00046,1,366913,387241,-,20328
492,BUMA.1121.00037,1,3578314,3598633,+,20319
492,BUMA.1121.00080,1,979261,999585,+,20324
492,BUMA.1121.00079,1,972927,993250,+,20323
492,BUMA.1121.00045,1,3105344,3125668,-,20324
492,BUMA.1121.00071,1,947883,968185,+,20302
492,BUMA.1121.00056,1,2957335,2977658,-,20323
492,BUMA.1121.00065,1,994358,1014677,+,20319
492,BUMA.1121.00058,1,3647305,3667580,-,20275
492,BUMA.1121.00007,1,3167590,3187915,-,20325
492,BUMA.1121.00067,1,3428401,3448715,-,20314
492,BUMA.1121.00090,1,3039620,3059938,+,20318
492,BUMA.1121.00051,1,950837,971157,+,20320
492,BUMA.1121.00020,1,1367166,1387495,+,20329
492,BUMA.1121.00103,1,3453819,3474139,-,20320
492,BUMA.1121.00048,1,2105406,2125734,-,20328
492,BUMA.1121.00047,1,2027862,2048181,-,20319
492,BUMA.1121.00042,1,2825455,2845775,-,20320
492,BUMA.1121.00055,1,524722,545042,+,20320
492,BUMA.1121.00031,1,2330850,2351168,+,20318
492,BUMA.1121.00040,1,1231148,1251477,+,20329
492,BUMA.1121.00044,1,567718,588047,+,20329
492,BUMA.1121.00088,1,1824097,1844364,+,20267
492,BUMA.1121.00069,1,910678,930997,+,20319
492,BUMA.1121.00064,1,982535,1002851,+,20316
492,BUMA.1121.00105,1,236292,256615,-,20323
492,BUMA.1121.00015,1,2845383,2865711,-,20328
492,BUMA.1121.00059,1,185917,206235,+,20318
492,BUMA.1121.00026,1,403509,423830,+,20321
492,BUMA.1121.00022,1,1564494,1584820,+,20326
492,BUMA.1121.00052,1,3023511,3043841,-,20330
492,BUMA.1121.00101,1,1517634,1537953,-,20319
492,BUMA.1121.00001,1,3144062,3164396,-,20334
492,BUMA.1121.00038,1,2312817,2333145,-,20328
492,BUMA.1121.00068,1,3816001,3836325,+,20324
492,BUMA.1121.00099,1,1412302,1432641,-,20339
492,BUMA.1121.00091,1,3578664,3598983,-,20319
492,BUMA.1121.00098,1,3665115,3685442,+,20327
492,BUMA.1121.00013,1,3315607,3335937,-,20330
492,BUMA.1121.00049,1,888444,908779,-,20335
492,BUMA.1121.00072,1,921684,942003,+,20319
492,BUMA.1121.00076,1,404492,424765,-,20273
492,BUMA.1121.00083,1,632429,652749,-,20320
492,BUMA.1121.00078,1,1040249,1060570,-,20321
492,BUMA.1121.00095,1,707582,727901,-,20319
492,BUMA.1121.00077,1,3636942,3657270,+,20328
492,BUMA.1121.00063,1,954917,975236,+,20319
492,BUMA.1121.00061,1,957740,978059,+,20319
492,BUMA.1121.00050,1,2364624,2384953,+,20329
492,BUMA.1121.00081,1,2312943,2333271,-,20328
492,BUMA.1121.00074,1,2906049,2926365,-,20316
492,BUMA.1121.00062,1,3594588,3614907,-,20319
492,BUMA.1121.00060,1,1330933,1351257,-,20324
492,BUMA.1121.00070,1,928949,949268,+,20319
492,BUMA.1121.00075,1,454960,475232,+,20272
492,BUMA.1121.00041,1,2217253,2237571,+,20318
492,BUMA.1121.00073,1,955811,976130,+,20319
492,BUMA.1121.00017,1,1237257,1257586,+,20329
492,BUMA.1121.00066,1,931967,952286,+,20319
492,BUMA.1121.00107,1,791543,811861,+,20318
492,BUMA.1121.00085,1,2620457,2640787,-,20330
492,BUMA.1121.00030,1,1237297,1257626,+,20329
492,BUMA.1121.00112,1,2109335,2129654,-,20319
492,BUMA.1121.00002,1,396418,416748,-,20330
492,BUMA.1121.00082,1,1052071,1072390,+,20319
492,BUMA.1121.00014,1,1867511,1887830,-,20319
492,BUMA.1121.00011,1,630638,650958,-,20320
492,BUMA.1121.00019,1,1302293,1322622,+,20329
492,BUMA.1121.00057,1,2034975,2055299,+,20324
492,BUMA.1121.00018,1,1493588,1513906,+,20318
492,BUMA.1121.00039,1,1059571,1079889,+,20318
492,BUMA.1121.00016,1,3060409,3080728,+,20319
492,BUMA.1121.00004,1,1303452,1323781,+,20329
492,BUMA.1121.00005,1,2619834,2640109,-,20275
492,BUMA.1121.00100,1,349841,370168,-,20327
492,BUMA.1121.00006,1,2312735,2333063,-,20328
493,BUMA.1121.00027,1,3156596,3167746,+,11150
493,BUMA.1121.00025,1,1733185,1744336,-,11151
493,BUMA.1121.00021,1,1585962,1597089,+,11127
493,BUMA.1121.00023,1,3321200,3332333,+,11133
493,BUMA.1121.00024,1,1567489,1578633,+,11144
493,BUMA.1121.00033,1,3207316,3218466,+,11150
493,BUMA.1121.00034,1,1604915,1616059,+,11144
493,BUMA.1121.00036,1,2534937,2546084,-,11147
493,BUMA.1121.00032,1,3097985,3109129,+,11144
493,BUMA.1121.00009,1,604646,615802,-,11156
493,BUMA.1121.00003,1,3456149,3467293,+,11144
493,BUMA.1121.00109,1,910549,921705,-,11156
493,BUMA.1121.00053,1,684975,696102,+,11127
493,BUMA.1121.00110,1,3822234,3833379,-,11145
493,BUMA.1121.00104,1,313801,324929,-,11128
493,BUMA.1121.00086,1,253644,264790,+,11146
493,BUMA.1121.00092,1,2895536,2906664,-,11128
493,BUMA.1121.00096,1,2293067,2304218,-,11151
493,BUMA.1121.00054,1,2073523,2084658,+,11135
493,BUMA.1121.00097,1,3041254,3052410,-,11156
493,BUMA.1121.00093,1,1719765,1730892,+,11127
493,BUMA.1121.00106,1,739334,750464,+,11130
493,BUMA.1121.00010,1,2688513,2699657,+,11144
493,BUMA.1121.00035,1,2035651,2046772,+,11121
493,BUMA.1121.00108,1,1956716,1967881,+,11165
493,BUMA.1121.00028,1,1567538,1578682,+,11144
493,BUMA.1121.00094,1,955015,966176,+,11161
493,BUMA.1121.00102,1,254248,265335,-,11087
493,BUMA.1121.00111,1,1097956,1109083,+,11127
493,BUMA.1121.00089,1,971302,982463,+,11161
493,BUMA.1121.00084,1,1192532,1203659,+,11127
493,BUMA.1121.00029,1,3984815,3995937,-,11122
493,BUMA.1121.00012,1,3745442,3756592,+,11150
493,BUMA.1121.00087,1,3051792,3062939,-,11147
493,BUMA.1121.00043,1,944299,955426,+,11127
493,BUMA.1121.00046,1,112452,123588,-,11136
493,BUMA.1121.00037,1,3600258,3611385,+,11127
493,BUMA.1121.00080,1,1002563,1013724,+,11161
493,BUMA.1121.00079,1,996228,1007389,+,11161
493,BUMA.1121.00045,1,3092585,3103719,-,11134
493,BUMA.1121.00071,1,969811,980938,+,11127
493,BUMA.1121.00056,1,2943196,2954358,-,11162
493,BUMA.1121.00065,1,1016303,1027464,+,11161
493,BUMA.1121.00058,1,3634529,3645680,-,11151
493,BUMA.1121.00007,1,3154819,3165965,-,11146
493,BUMA.1121.00067,1,3414751,3425913,-,11162
493,BUMA.1121.00090,1,3061563,3072690,+,11127
493,BUMA.1121.00051,1,974135,985296,+,11161
493,BUMA.1121.00020,1,1632460,1643604,+,11144
493,BUMA.1121.00103,1,3441060,3452194,-,11134
493,BUMA.1121.00048,1,1851076,1862212,-,11136
493,BUMA.1121.00047,1,2015076,2026238,-,11162
493,BUMA.1121.00042,1,2807832,2818967,+,11135
493,BUMA.1121.00055,1,546668,557780,+,11112
493,BUMA.1121.00031,1,2352793,2363920,+,11127
493,BUMA.1121.00040,1,1496423,1507567,+,11144
493,BUMA.1121.00044,1,833013,844157,+,11144
493,BUMA.1121.00088,1,1845990,1857117,+,11127
493,BUMA.1121.00069,1,932623,943750,+,11127
493,BUMA.1121.00064,1,1005339,1016489,+,11150
493,BUMA.1121.00105,1,223539,234667,-,11128
493,BUMA.1121.00015,1,977280,988415,+,11135
493,BUMA.1121.00059,1,207858,219008,+,11150
493,BUMA.1121.00026,1,431851,442987,-,11136
493,BUMA.1121.00022,1,1903019,1914165,+,11146
493,BUMA.1121.00052,1,1340392,1351527,+,11135
493,BUMA.1121.00101,1,1504911,1516009,-,11098
493,BUMA.1121.00001,1,3131316,3142438,-,11122
493,BUMA.1121.00038,1,2058493,2069629,-,11136
493,BUMA.1121.00068,1,3837951,3849084,+,11133
493,BUMA.1121.00099,1,1399538,1410677,-,11139
493,BUMA.1121.00091,1,3565921,3577039,-,11118
493,BUMA.1121.00098,1,3687066,3698224,+,11158
493,BUMA.1121.00013,1,1541223,1552358,+,11135
493,BUMA.1121.00049,1,875692,886820,-,11128
493,BUMA.1121.00072,1,943629,954737,+,11108
493,BUMA.1121.00076,1,391719,402868,-,11149
493,BUMA.1121.00083,1,619676,630804,-,11128
493,BUMA.1121.00078,1,1027462,1038624,-,11162
493,BUMA.1121.00095,1,694830,705957,-,11127
493,BUMA.1121.00077,1,3658896,3670037,+,11141
493,BUMA.1121.00063,1,976862,987989,+,11127
493,BUMA.1121.00061,1,979685,990796,+,11111
493,BUMA.1121.00050,1,2628221,2639356,+,11135
493,BUMA.1121.00081,1,2058619,2069755,-,11136
493,BUMA.1121.00074,1,2892410,2903561,-,11151
493,BUMA.1121.00062,1,3581812,3592963,-,11151
493,BUMA.1121.00060,1,1318174,1329308,-,11134
493,BUMA.1121.00070,1,950894,962003,+,11109
493,BUMA.1121.00075,1,476857,488005,+,11148
493,BUMA.1121.00041,1,2239197,2250329,+,11132
493,BUMA.1121.00073,1,977756,988866,+,11110
493,BUMA.1121.00017,1,1502544,1513688,+,11144
493,BUMA.1121.00066,1,953912,965039,+,11127
493,BUMA.1121.00107,1,813487,824637,+,11150
493,BUMA.1121.00085,1,937282,948417,+,11135
493,BUMA.1121.00030,1,1502597,1513741,+,11144
493,BUMA.1121.00112,1,2096563,2107710,-,11147
493,BUMA.1121.00002,1,2710762,2721906,+,11144
493,BUMA.1121.00082,1,1074016,1085143,+,11127
493,BUMA.1121.00014,1,1854759,1865887,-,11128
493,BUMA.1121.00011,1,617863,629013,-,11150
493,BUMA.1121.00019,1,1567593,1578737,+,11144
493,BUMA.1121.00057,1,2056925,2068052,+,11127
493,BUMA.1121.00018,1,1515532,1526682,+,11150
493,BUMA.1121.00039,1,1081514,1092641,+,11127
493,BUMA.1121.00016,1,3082353,3093479,+,11126
493,BUMA.1121.00004,1,1568671,1579815,+,11144
493,BUMA.1121.00005,1,2605497,2616625,-,11128
493,BUMA.1121.00100,1,335757,346914,-,11157
493,BUMA.1121.00006,1,2058406,2069542,-,11136
494,BUMA.1121.00027,1,3167748,3172101,+,4353
494,BUMA.1121.00025,1,1728831,1733184,-,4353
494,BUMA.1121.00021,1,1597091,1601444,+,4353
494,BUMA.1121.00023,1,3332335,3336688,+,4353
494,BUMA.1121.00024,1,1578635,1582980,+,4345
494,BUMA.1121.00033,1,3218468,3222845,+,4377
494,BUMA.1121.00034,1,1616061,1620406,+,4345
494,BUMA.1121.00036,1,2530591,2534936,-,4345
494,BUMA.1121.00032,1,3109131,3113476,+,4345
494,BUMA.1121.00009,1,600292,604645,-,4353
494,BUMA.1121.00008,1,1570531,1574861,+,4330
494,BUMA.1121.00008,1,1577595,1581926,+,4331
494,BUMA.1121.00008,1,1584660,1588991,+,4331
494,BUMA.1121.00008,1,1591725,1596056,+,4331
494,BUMA.1121.00003,1,3467295,3471680,+,4385
494,BUMA.1121.00109,1,906195,910548,-,4353
494,BUMA.1121.00053,1,696104,700500,+,4396
494,BUMA.1121.00110,1,3817840,3822233,-,4393
494,BUMA.1121.00104,1,309447,313800,-,4353
494,BUMA.1121.00086,1,264792,269137,+,4345
494,BUMA.1121.00092,1,2891147,2895535,-,4388
494,BUMA.1121.00096,1,2288713,2293066,-,4353
494,BUMA.1121.00054,1,2084660,2089005,+,4345
494,BUMA.1121.00097,1,3036852,3041253,-,4401
494,BUMA.1121.00093,1,1730894,1735282,+,4388
494,BUMA.1121.00106,1,750466,754819,+,4353
494,BUMA.1121.00010,1,2699659,2704004,+,4345
494,BUMA.1121.00035,1,2046774,2051151,+,4377
494,BUMA.1121.00108,1,1967883,1972282,+,4399
494,BUMA.1121.00028,1,1578684,1583029,+,4345
494,BUMA.1121.00094,1,966178,970523,+,4345
494,BUMA.1121.00102,1,249878,254247,-,4369
494,BUMA.1121.00111,1,1109085,1113438,+,4353
494,BUMA.1121.00089,1,982465,986861,+,4396
494,BUMA.1121.00084,1,1203661,1208014,+,4353
494,BUMA.1121.00029,1,3980437,3984814,-,4377
494,BUMA.1121.00012,1,3756594,3760963,+,4369
494,BUMA.1121.00087,1,3047446,3051791,-,4345
494,BUMA.1121.00043,1,955428,959781,+,4353
494,BUMA.1121.00046,1,108106,112451,-,4345
494,BUMA.1121.00037,1,3611387,3615740,+,4353
494,BUMA.1121.00080,1,1013726,1018122,+,4396
494,BUMA.1121.00079,1,1007391,1011778,+,4387
494,BUMA.1121.00045,1,3088223,3092584,-,4361
494,BUMA.1121.00071,1,980940,985266,+,4326
494,BUMA.1121.00056,1,2938799,2943195,-,4396
494,BUMA.1121.00065,1,1027466,1031854,+,4388
494,BUMA.1121.00058,1,3630140,3634528,-,4388
494,BUMA.1121.00007,1,3150329,3154818,-,4489
494,BUMA.1121.00067,1,3410397,3414750,-,4353
494,BUMA.1121.00090,1,3072692,3077045,+,4353
494,BUMA.1121.00051,1,985298,989694,+,4396
494,BUMA.1121.00020,1,1643606,1647951,+,4345
494,BUMA.1121.00103,1,3436666,3441059,-,4393
494,BUMA.1121.00048,1,1846730,1851075,-,4345
494,BUMA.1121.00047,1,2010679,2015075,-,4396
494,BUMA.1121.00042,1,2818969,2823269,+,4300
494,BUMA.1121.00055,1,557782,562170,+,4388
494,BUMA.1121.00031,1,2363922,2368275,+,4353
494,BUMA.1121.00040,1,1507569,1511914,+,4345
494,BUMA.1121.00044,1,844159,848504,+,4345
494,BUMA.1121.00088,1,1857119,1861472,+,4353
494,BUMA.1121.00069,1,943752,948063,+,4311
494,BUMA.1121.00064,1,1016491,1020844,+,4353
494,BUMA.1121.00105,1,219193,223538,-,4345
494,BUMA.1121.00015,1,988417,992762,+,4345
494,BUMA.1121.00059,1,219010,223363,+,4353
494,BUMA.1121.00026,1,427505,431850,-,4345
494,BUMA.1121.00022,1,1914167,1918512,+,4345
494,BUMA.1121.00052,1,1351529,1355874,+,4345
494,BUMA.1121.00101,1,1500557,1504910,-,4353
494,BUMA.1121.00001,1,3126938,3131315,-,4377
494,BUMA.1121.00038,1,2054147,2058492,-,4345
494,BUMA.1121.00068,1,3849086,3853535,+,4449
494,BUMA.1121.00099,1,1395184,1399537,-,4353
494,BUMA.1121.00091,1,3561543,3565920,-,4377
494,BUMA.1121.00098,1,3698226,3702635,+,4409
494,BUMA.1121.00013,1,1552360,1556705,+,4345
494,BUMA.1121.00049,1,871338,875691,-,4353
494,BUMA.1121.00072,1,954739,959091,+,4352
494,BUMA.1121.00076,1,387365,391718,-,4353
494,BUMA.1121.00083,1,615322,619675,-,4353
494,BUMA.1121.00078,1,1023100,1027461,-,4361
494,BUMA.1121.00095,1,690492,694829,-,4337
494,BUMA.1121.00077,1,3670039,3674432,+,4393
494,BUMA.1121.00063,1,987991,992333,+,4342
494,BUMA.1121.00061,1,990798,995151,+,4353
494,BUMA.1121.00050,1,2639358,2643703,+,4345
494,BUMA.1121.00081,1,2054273,2058618,-,4345
494,BUMA.1121.00074,1,2888056,2892409,-,4353
494,BUMA.1121.00062,1,3577466,3581811,-,4345
494,BUMA.1121.00060,1,1313812,1318173,-,4361
494,BUMA.1121.00070,1,962005,966358,+,4353
494,BUMA.1121.00075,1,488007,492360,+,4353
494,BUMA.1121.00041,1,2250331,2254700,+,4369
494,BUMA.1121.00073,1,988868,993221,+,4353
494,BUMA.1121.00017,1,1513690,1518035,+,4345
494,BUMA.1121.00066,1,965041,969374,+,4333
494,BUMA.1121.00107,1,824639,829008,+,4369
494,BUMA.1121.00085,1,948419,952764,+,4345
494,BUMA.1121.00030,1,1513743,1518088,+,4345
494,BUMA.1121.00112,1,2092185,2096562,-,4377
494,BUMA.1121.00002,1,2721908,2726253,+,4345
494,BUMA.1121.00082,1,1085145,1089498,+,4353
494,BUMA.1121.00014,1,1850405,1854758,-,4353
494,BUMA.1121.00011,1,613509,617862,-,4353
494,BUMA.1121.00019,1,1578739,1583084,+,4345
494,BUMA.1121.00057,1,2068054,2072407,+,4353
494,BUMA.1121.00018,1,1526684,1531037,+,4353
494,BUMA.1121.00039,1,1092643,1097020,+,4377
494,BUMA.1121.00016,1,3093481,3097834,+,4353
494,BUMA.1121.00004,1,1579817,1584162,+,4345
494,BUMA.1121.00005,1,2601151,2605496,-,4345
494,BUMA.1121.00100,1,331395,335756,-,4361
494,BUMA.1121.00006,1,2054060,2058405,-,4345
495,BUMA.1121.00027,1,3173599,3182230,+,8631
495,BUMA.1121.00009,1,590169,598793,-,8624
495,BUMA.1121.00092,1,2881016,2889648,-,8632
495,BUMA.1121.00097,1,3026721,3035353,-,8632
495,BUMA.1121.00093,1,1736780,1745413,+,8633
495,BUMA.1121.00065,1,1033352,1041985,+,8633
495,BUMA.1121.00101,1,1490426,1499058,-,8632
495,BUMA.1121.00072,1,960589,969222,+,8633
495,BUMA.1121.00083,1,605191,613823,-,8632
495,BUMA.1121.00082,1,1090996,1099629,+,8633
495,BUMA.1121.00057,1,2073905,2082538,+,8633
496,BUMA.1121.00027,1,3183182,3193244,+,10062
496,BUMA.1121.00065,1,1042926,1052991,+,10065
497,BUMA.1121.00027,1,3208432,3213138,+,4706
497,BUMA.1121.00025,1,1710134,1714840,-,4706
497,BUMA.1121.00021,1,1623800,1628506,+,4706
497,BUMA.1121.00023,1,3352300,3357006,+,4706
497,BUMA.1121.00024,1,2968215,2972921,-,4706
497,BUMA.1121.00033,1,3236396,3241102,+,4706
497,BUMA.1121.00034,1,3006956,3011662,-,4706
497,BUMA.1121.00036,1,1138327,1143033,+,4706
497,BUMA.1121.00032,1,1036639,1041345,-,4706
497,BUMA.1121.00009,1,574764,579470,-,4706
497,BUMA.1121.00008,1,2981161,2985867,-,4706
497,BUMA.1121.00003,1,3473076,3477782,+,4706
497,BUMA.1121.00109,1,900092,904798,-,4706
497,BUMA.1121.00053,1,721140,725846,+,4706
497,BUMA.1121.00110,1,3799071,3803776,-,4705
497,BUMA.1121.00104,1,303345,308050,-,4705
497,BUMA.1121.00086,1,1655994,1660700,-,4706
497,BUMA.1121.00092,1,2873372,2878078,-,4706
497,BUMA.1121.00096,1,2282610,2287316,-,4706
497,BUMA.1121.00054,1,3453606,3458312,-,4706
497,BUMA.1121.00097,1,3009328,3014034,-,4706
497,BUMA.1121.00093,1,1748351,1753057,+,4706
497,BUMA.1121.00106,1,756216,760921,+,4705
497,BUMA.1121.00010,1,2175354,2180060,+,4706
497,BUMA.1121.00035,1,2058573,2063279,+,4706
497,BUMA.1121.00108,1,1987086,1991792,+,4706
497,BUMA.1121.00028,1,2969555,2974261,-,4706
497,BUMA.1121.00094,1,971920,976625,+,4705
497,BUMA.1121.00102,1,231117,235823,-,4706
497,BUMA.1121.00111,1,1130385,1135091,+,4706
497,BUMA.1121.00089,1,988258,992964,+,4706
497,BUMA.1121.00084,1,1209411,1214116,+,4705
497,BUMA.1121.00029,1,3961600,3966306,-,4706
497,BUMA.1121.00012,1,3774114,3778820,+,4706
497,BUMA.1121.00087,1,1656170,1660876,+,4706
497,BUMA.1121.00043,1,976553,981259,+,4706
497,BUMA.1121.00046,1,2174350,2179056,+,4706
497,BUMA.1121.00037,1,3637110,3641796,+,4686
497,BUMA.1121.00080,1,1019519,1024224,+,4705
497,BUMA.1121.00079,1,1013175,1017880,+,4705
497,BUMA.1121.00045,1,3069955,3074661,-,4706
497,BUMA.1121.00071,1,987627,992333,+,4706
497,BUMA.1121.00056,1,2932696,2937402,-,4706
497,BUMA.1121.00065,1,1056519,1061225,+,4706
497,BUMA.1121.00058,1,3608944,3613649,-,4705
497,BUMA.1121.00007,1,3130824,3135530,-,4706
497,BUMA.1121.00067,1,3404294,3409000,-,4706
497,BUMA.1121.00090,1,3091382,3096088,+,4706
497,BUMA.1121.00051,1,991091,995796,+,4705
497,BUMA.1121.00020,1,3034368,3039074,-,4706
497,BUMA.1121.00103,1,3430564,3435270,-,4706
497,BUMA.1121.00048,1,477397,482103,+,4706
497,BUMA.1121.00047,1,2004591,2009284,-,4693
497,BUMA.1121.00042,1,1337866,1342572,+,4706
497,BUMA.1121.00055,1,583556,588262,+,4706
497,BUMA.1121.00031,1,2375747,2380453,+,4706
497,BUMA.1121.00040,1,2981544,2986250,-,4706
497,BUMA.1121.00044,1,2235126,2239832,-,4706
497,BUMA.1121.00088,1,1862869,1867574,+,4705
497,BUMA.1121.00069,1,951007,955713,+,4706
497,BUMA.1121.00064,1,1022241,1026946,+,4705
497,BUMA.1121.00105,1,213091,217796,-,4705
497,BUMA.1121.00015,1,2664347,2669053,+,4706
497,BUMA.1121.00059,1,224760,229465,+,4705
497,BUMA.1121.00026,1,2401382,2406088,+,4706
497,BUMA.1121.00022,1,3386659,3391365,-,4706
497,BUMA.1121.00052,1,2754292,2758998,-,4706
497,BUMA.1121.00101,1,1473033,1477739,-,4706
497,BUMA.1121.00001,1,3108101,3112807,-,4706
497,BUMA.1121.00038,1,684871,689577,+,4706
497,BUMA.1121.00068,1,3854932,3859638,+,4706
497,BUMA.1121.00099,1,1389082,1393787,-,4705
497,BUMA.1121.00091,1,3555440,3560146,-,4706
497,BUMA.1121.00098,1,3716689,3721395,+,4706
497,BUMA.1121.00013,1,3034418,3039124,-,4706
497,BUMA.1121.00049,1,865236,869941,-,4705
497,BUMA.1121.00072,1,970678,975384,+,4706
497,BUMA.1121.00076,1,381263,385968,-,4705
497,BUMA.1121.00083,1,587794,592500,-,4706
497,BUMA.1121.00078,1,972140,976826,-,4686
497,BUMA.1121.00095,1,684388,689094,-,4706
497,BUMA.1121.00077,1,3688495,3693200,+,4705
497,BUMA.1121.00063,1,994854,999560,+,4706
497,BUMA.1121.00061,1,997544,1002250,+,4706
497,BUMA.1121.00050,1,572642,577348,-,4706
497,BUMA.1121.00081,1,684940,689646,+,4706
497,BUMA.1121.00074,1,2881954,2886659,-,4705
497,BUMA.1121.00062,1,3571364,3576069,-,4705
497,BUMA.1121.00060,1,1295544,1300250,-,4706
497,BUMA.1121.00070,1,968910,973616,+,4706
497,BUMA.1121.00075,1,493757,498462,+,4705
497,BUMA.1121.00041,1,2256096,2260802,+,4706
497,BUMA.1121.00073,1,995794,1000500,+,4706
497,BUMA.1121.00017,1,2904621,2909327,-,4706
497,BUMA.1121.00066,1,971867,976573,+,4706
497,BUMA.1121.00107,1,886312,890998,+,4686
497,BUMA.1121.00085,1,2351238,2355944,-,4706
497,BUMA.1121.00030,1,2904691,2909397,-,4706
497,BUMA.1121.00112,1,2072795,2077501,-,4706
497,BUMA.1121.00002,1,2202213,2206919,+,4706
497,BUMA.1121.00082,1,1112320,1117026,+,4706
497,BUMA.1121.00014,1,1838226,1842932,-,4706
497,BUMA.1121.00011,1,607406,612112,-,4706
497,BUMA.1121.00019,1,2920888,2925594,-,4706
497,BUMA.1121.00057,1,2095229,2099935,+,4706
497,BUMA.1121.00018,1,1545028,1549734,+,4706
497,BUMA.1121.00039,1,1112742,1117448,+,4706
497,BUMA.1121.00016,1,3116752,3121458,+,4706
497,BUMA.1121.00004,1,2969498,2974204,-,4706
497,BUMA.1121.00005,1,2595049,2599755,-,4706
497,BUMA.1121.00100,1,325293,329998,-,4705
497,BUMA.1121.00006,1,684870,689576,+,4706
498,BUMA.1121.00027,1,3216421,3222231,+,5810
498,BUMA.1121.00025,1,1701038,1706850,-,5812
498,BUMA.1121.00021,1,1631790,1637595,+,5805
498,BUMA.1121.00023,1,3360290,3366101,+,5811
498,BUMA.1121.00024,1,2959119,2964931,-,5812
498,BUMA.1121.00033,1,3244386,3250197,+,5811
498,BUMA.1121.00034,1,2997860,3003672,-,5812
498,BUMA.1121.00036,1,1146317,1152128,+,5811
498,BUMA.1121.00032,1,1027543,1033355,-,5812
498,BUMA.1121.00009,1,565668,571480,-,5812
498,BUMA.1121.00008,1,2972065,2977877,-,5812
498,BUMA.1121.00003,1,3481066,3486891,+,5825
498,BUMA.1121.00109,1,890987,896799,-,5812
498,BUMA.1121.00053,1,729130,734950,+,5820
498,BUMA.1121.00110,1,3789975,3795787,-,5812
498,BUMA.1121.00104,1,294240,300061,-,5821
498,BUMA.1121.00086,1,1646898,1652710,-,5812
498,BUMA.1121.00092,1,2864276,2870088,-,5812
498,BUMA.1121.00096,1,2273505,2279317,-,5812
498,BUMA.1121.00054,1,3444510,3450322,-,5812
498,BUMA.1121.00097,1,3000232,3006044,-,5812
498,BUMA.1121.00093,1,1756341,1762152,+,5811
498,BUMA.1121.00106,1,764205,770025,+,5820
498,BUMA.1121.00010,1,2183344,2189155,+,5811
498,BUMA.1121.00035,1,2066563,2072374,+,5811
498,BUMA.1121.00108,1,1995076,2000887,+,5811
498,BUMA.1121.00028,1,2960459,2966271,-,5812
498,BUMA.1121.00094,1,979907,985718,+,5811
498,BUMA.1121.00102,1,222021,227833,-,5812
498,BUMA.1121.00111,1,1138375,1144186,+,5811
498,BUMA.1121.00089,1,996248,1002069,+,5821
498,BUMA.1121.00084,1,1217400,1223211,+,5811
498,BUMA.1121.00029,1,3952504,3958316,-,5812
498,BUMA.1121.00012,1,3782104,3787915,+,5811
498,BUMA.1121.00087,1,1664160,1669971,+,5811
498,BUMA.1121.00043,1,984543,990354,+,5811
498,BUMA.1121.00046,1,2182340,2188151,+,5811
498,BUMA.1121.00037,1,3645080,3650891,+,5811
498,BUMA.1121.00080,1,1027508,1033328,+,5820
498,BUMA.1121.00079,1,1021164,1026984,+,5820
498,BUMA.1121.00045,1,3060859,3066671,-,5812
498,BUMA.1121.00071,1,995616,1001427,+,5811
498,BUMA.1121.00056,1,2923591,2929412,-,5821
498,BUMA.1121.00065,1,1064509,1070320,+,5811
498,BUMA.1121.00058,1,3599839,3605660,-,5821
498,BUMA.1121.00007,1,3121728,3127540,-,5812
498,BUMA.1121.00067,1,3395198,3401010,-,5812
498,BUMA.1121.00090,1,3099372,3105184,+,5812
498,BUMA.1121.00051,1,999080,1004899,+,5819
498,BUMA.1121.00020,1,3025272,3031084,-,5812
498,BUMA.1121.00103,1,3419865,3425677,-,5812
498,BUMA.1121.00048,1,485387,491198,+,5811
498,BUMA.1121.00047,1,1995486,2001307,-,5821
498,BUMA.1121.00042,1,1347452,1353263,+,5811
498,BUMA.1121.00055,1,591546,597366,+,5820
498,BUMA.1121.00031,1,2383737,2389548,+,5811
498,BUMA.1121.00040,1,2972448,2978260,-,5812
498,BUMA.1121.00044,1,2226030,2231842,-,5812
498,BUMA.1121.00088,1,1870858,1876669,+,5811
498,BUMA.1121.00069,1,958996,964807,+,5811
498,BUMA.1121.00064,1,1030230,1036041,+,5811
498,BUMA.1121.00105,1,203995,209807,-,5812
498,BUMA.1121.00015,1,2672337,2678148,+,5811
498,BUMA.1121.00059,1,232749,238560,+,5811
498,BUMA.1121.00026,1,2410968,2416779,+,5811
498,BUMA.1121.00022,1,3377563,3383375,-,5812
498,BUMA.1121.00052,1,2745196,2751008,-,5812
498,BUMA.1121.00101,1,1463937,1469749,-,5812
498,BUMA.1121.00001,1,3099005,3104817,-,5812
498,BUMA.1121.00038,1,692861,698672,+,5811
498,BUMA.1121.00068,1,3862922,3868733,+,5811
498,BUMA.1121.00099,1,1379986,1385798,-,5812
498,BUMA.1121.00091,1,3546335,3552147,-,5812
498,BUMA.1121.00098,1,3724679,3730490,+,5811
498,BUMA.1121.00013,1,3025322,3031134,-,5812
498,BUMA.1121.00049,1,856151,861952,-,5801
498,BUMA.1121.00072,1,978667,984420,+,5753
498,BUMA.1121.00076,1,372158,377979,-,5821
498,BUMA.1121.00083,1,578699,584511,-,5812
498,BUMA.1121.00078,1,963045,968857,-,5812
498,BUMA.1121.00095,1,675300,681112,-,5812
498,BUMA.1121.00077,1,3696484,3702291,+,5807
498,BUMA.1121.00063,1,1002843,1008654,+,5811
498,BUMA.1121.00061,1,1005533,1011344,+,5811
498,BUMA.1121.00050,1,563546,569358,-,5812
498,BUMA.1121.00081,1,692930,698741,+,5811
498,BUMA.1121.00074,1,2872858,2878670,-,5812
498,BUMA.1121.00062,1,3562268,3568080,-,5812
498,BUMA.1121.00060,1,1286448,1292260,-,5812
498,BUMA.1121.00070,1,976899,982710,+,5811
498,BUMA.1121.00075,1,501746,507565,+,5819
498,BUMA.1121.00041,1,2264104,2269915,+,5811
498,BUMA.1121.00073,1,1003783,1009594,+,5811
498,BUMA.1121.00017,1,2895525,2901337,-,5812
498,BUMA.1121.00066,1,979856,985667,+,5811
498,BUMA.1121.00107,1,894282,900093,+,5811
498,BUMA.1121.00085,1,2342142,2347954,-,5812
498,BUMA.1121.00030,1,2895595,2901407,-,5812
498,BUMA.1121.00112,1,2063690,2069502,-,5812
498,BUMA.1121.00002,1,2210203,2216014,+,5811
498,BUMA.1121.00082,1,1120309,1126120,+,5811
498,BUMA.1121.00014,1,1829130,1834942,-,5812
498,BUMA.1121.00011,1,598301,604113,-,5812
498,BUMA.1121.00019,1,2911792,2917604,-,5812
498,BUMA.1121.00057,1,2103218,2109029,+,5811
498,BUMA.1121.00018,1,1553018,1558829,+,5811
498,BUMA.1121.00039,1,1120732,1126543,+,5811
498,BUMA.1121.00016,1,3124742,3130553,+,5811
498,BUMA.1121.00004,1,2960402,2966214,-,5812
498,BUMA.1121.00005,1,2585944,2591756,-,5812
498,BUMA.1121.00100,1,316197,322009,-,5812
498,BUMA.1121.00006,1,692860,698671,+,5811
499,BUMA.1121.00027,1,3225541,3230019,+,4478
499,BUMA.1121.00025,1,1693223,1697729,-,4506
499,BUMA.1121.00021,1,1640905,1645376,+,4471
499,BUMA.1121.00023,1,3369429,3373942,+,4513
499,BUMA.1121.00024,1,2949740,2954210,-,4470
499,BUMA.1121.00033,1,3253507,3257985,+,4478
499,BUMA.1121.00034,1,2988481,2992951,-,4470
499,BUMA.1121.00036,1,1157039,1161516,+,4477
499,BUMA.1121.00032,1,1018171,1022634,-,4463
499,BUMA.1121.00009,1,557842,562341,-,4499
499,BUMA.1121.00008,1,2962686,2967156,-,4470
499,BUMA.1121.00003,1,3490205,3494706,+,4501
499,BUMA.1121.00109,1,883120,887612,-,4492
499,BUMA.1121.00053,1,738260,742779,+,4519
499,BUMA.1121.00110,1,3782170,3786647,-,4477
499,BUMA.1121.00104,1,286469,290940,-,4471
499,BUMA.1121.00086,1,1637502,1641986,-,4484
499,BUMA.1121.00092,1,2856465,2860958,-,4493
499,BUMA.1121.00096,1,2265663,2270121,-,4458
499,BUMA.1121.00054,1,3435122,3439600,-,4478
499,BUMA.1121.00097,1,2992335,2996851,-,4516
499,BUMA.1121.00093,1,1765471,1769964,+,4493
499,BUMA.1121.00106,1,773326,777811,+,4485
499,BUMA.1121.00010,1,2194063,2198547,+,4484
499,BUMA.1121.00035,1,2075702,2080159,+,4457
499,BUMA.1121.00108,1,2004197,2008728,+,4531
499,BUMA.1121.00028,1,2951080,2955550,-,4470
499,BUMA.1121.00094,1,989019,993504,+,4485
499,BUMA.1121.00102,1,214160,218685,-,4525
499,BUMA.1121.00111,1,1147523,1152008,+,4485
499,BUMA.1121.00089,1,1005379,1009864,+,4485
499,BUMA.1121.00084,1,1226521,1231007,+,4486
499,BUMA.1121.00029,1,3944721,3949177,-,4456
499,BUMA.1121.00012,1,3791243,3795713,+,4470
499,BUMA.1121.00087,1,1674884,1679368,+,4484
499,BUMA.1121.00043,1,993673,998200,+,4527
499,BUMA.1121.00046,1,2193062,2197540,+,4478
499,BUMA.1121.00037,1,3654219,3658725,+,4506
499,BUMA.1121.00080,1,1036638,1041158,+,4520
499,BUMA.1121.00079,1,1030285,1034756,+,4471
499,BUMA.1121.00045,1,3052926,3057541,-,4615
499,BUMA.1121.00071,1,1004737,1009213,+,4476
499,BUMA.1121.00056,1,2915797,2920282,-,4485
499,BUMA.1121.00065,1,1073630,1078108,+,4478
499,BUMA.1121.00058,1,3592040,3596539,-,4499
499,BUMA.1121.00007,1,3113912,3118410,-,4498
499,BUMA.1121.00067,1,3387388,3391879,-,4491
499,BUMA.1121.00090,1,3108484,3112962,+,4478
499,BUMA.1121.00051,1,1008209,1012714,+,4505
499,BUMA.1121.00020,1,3015893,3020363,-,4470
499,BUMA.1121.00103,1,3412013,3416533,-,4520
499,BUMA.1121.00048,1,496109,500587,+,4478
499,BUMA.1121.00047,1,1987685,1992149,-,4464
499,BUMA.1121.00042,1,1358192,1362731,+,4539
499,BUMA.1121.00055,1,600676,605196,+,4520
499,BUMA.1121.00031,1,2392858,2397315,+,4457
499,BUMA.1121.00040,1,2963060,2967537,-,4477
499,BUMA.1121.00044,1,2216651,2221121,-,4470
499,BUMA.1121.00088,1,1879979,1884472,+,4493
499,BUMA.1121.00069,1,968117,972605,+,4488
499,BUMA.1121.00064,1,1039352,1043851,+,4499
499,BUMA.1121.00105,1,196101,200680,-,4579
499,BUMA.1121.00015,1,2683060,2687531,+,4471
499,BUMA.1121.00059,1,241916,246417,+,4501
499,BUMA.1121.00026,1,2421699,2426190,+,4491
499,BUMA.1121.00022,1,3368176,3372653,-,4477
499,BUMA.1121.00052,1,2735839,2740296,-,4457
499,BUMA.1121.00101,1,1456111,1460574,-,4463
499,BUMA.1121.00001,1,3091228,3095678,-,4450
499,BUMA.1121.00038,1,703583,708061,+,4478
499,BUMA.1121.00068,1,3872043,3876535,+,4492
499,BUMA.1121.00099,1,1372110,1376631,-,4521
499,BUMA.1121.00091,1,3538560,3543017,-,4457
499,BUMA.1121.00098,1,3733791,3738314,+,4523
499,BUMA.1121.00013,1,3015965,3020422,-,4457
499,BUMA.1121.00049,1,848379,852836,-,4457
499,BUMA.1121.00072,1,987730,992223,+,4493
499,BUMA.1121.00076,1,364371,368858,-,4487
499,BUMA.1121.00083,1,570897,575390,-,4493
499,BUMA.1121.00078,1,955183,959727,-,4544
499,BUMA.1121.00095,1,667419,671897,-,4478
499,BUMA.1121.00077,1,3705620,3710097,+,4477
499,BUMA.1121.00063,1,1011965,1016457,+,4492
499,BUMA.1121.00061,1,1014655,1019147,+,4492
499,BUMA.1121.00050,1,554158,558636,-,4478
499,BUMA.1121.00081,1,703652,708130,+,4478
499,BUMA.1121.00074,1,2865049,2869548,-,4499
499,BUMA.1121.00062,1,3554418,3558959,-,4541
499,BUMA.1121.00060,1,1278515,1283130,-,4615
499,BUMA.1121.00070,1,986021,990513,+,4492
499,BUMA.1121.00075,1,510864,515335,+,4471
499,BUMA.1121.00041,1,2273234,2277726,+,4492
499,BUMA.1121.00073,1,1012905,1017397,+,4492
499,BUMA.1121.00017,1,2886146,2890616,-,4470
499,BUMA.1121.00066,1,988978,993441,+,4463
499,BUMA.1121.00107,1,903421,907953,+,4532
499,BUMA.1121.00085,1,2332785,2337242,-,4457
499,BUMA.1121.00030,1,2886216,2890686,-,4470
499,BUMA.1121.00112,1,2055827,2060372,-,4545
499,BUMA.1121.00002,1,2220925,2225409,+,4484
499,BUMA.1121.00082,1,1129430,1133923,+,4493
499,BUMA.1121.00014,1,1821337,1825821,-,4484
499,BUMA.1121.00011,1,590446,594974,-,4528
499,BUMA.1121.00019,1,2902413,2906883,-,4470
499,BUMA.1121.00057,1,2112339,2116842,+,4503
499,BUMA.1121.00018,1,1562139,1566645,+,4506
499,BUMA.1121.00039,1,1129853,1134331,+,4478
499,BUMA.1121.00016,1,3133881,3138380,+,4499
499,BUMA.1121.00004,1,2951023,2955493,-,4470
499,BUMA.1121.00005,1,2578117,2582635,-,4518
499,BUMA.1121.00100,1,308313,312807,-,4494
499,BUMA.1121.00006,1,703582,708060,+,4478
500,BUMA.1121.00027,1,3235776,3239018,+,3242
500,BUMA.1121.00025,1,1684233,1687476,-,3243
500,BUMA.1121.00021,1,1651123,1654365,+,3242
500,BUMA.1121.00023,1,3379689,3382931,+,3242
500,BUMA.1121.00024,1,2940740,2943983,-,3243
500,BUMA.1121.00033,1,3263732,3266974,+,3242
500,BUMA.1121.00034,1,2979481,2982724,-,3243
500,BUMA.1121.00036,1,1167273,1170515,+,3242
500,BUMA.1121.00032,1,1009171,1012414,-,3243
500,BUMA.1121.00009,1,548842,552085,-,3243
500,BUMA.1121.00008,1,2953686,2956929,-,3243
500,BUMA.1121.00003,1,3500463,3503705,+,3242
500,BUMA.1121.00109,1,874120,877363,-,3243
500,BUMA.1121.00053,1,748536,751778,+,3242
500,BUMA.1121.00110,1,3773170,3776413,-,3243
500,BUMA.1121.00104,1,277465,280708,-,3243
500,BUMA.1121.00086,1,1628485,1631745,-,3260
500,BUMA.1121.00092,1,2847461,2850704,-,3243
500,BUMA.1121.00096,1,2256663,2259906,-,3243
500,BUMA.1121.00054,1,3426122,3429365,-,3243
500,BUMA.1121.00097,1,2983333,2986578,-,3245
500,BUMA.1121.00093,1,1775725,1778967,+,3242
500,BUMA.1121.00106,1,783572,786814,+,3242
500,BUMA.1121.00010,1,2204304,2207546,+,3242
500,BUMA.1121.00035,1,2085906,2089148,+,3242
500,BUMA.1121.00108,1,2014475,2017717,+,3242
500,BUMA.1121.00028,1,2942080,2945323,-,3243
500,BUMA.1121.00094,1,999251,1002493,+,3242
500,BUMA.1121.00102,1,205160,208403,-,3243
500,BUMA.1121.00111,1,1157755,1160997,+,3242
500,BUMA.1121.00089,1,1015611,1018853,+,3242
500,BUMA.1121.00084,1,1236768,1240010,+,3242
500,BUMA.1121.00029,1,3935731,3938974,-,3243
500,BUMA.1121.00012,1,3801460,3804700,+,3240
500,BUMA.1121.00087,1,1685125,1688384,+,3259
500,BUMA.1121.00043,1,1003947,1007189,+,3242
500,BUMA.1121.00046,1,2203297,2206539,+,3242
500,BUMA.1121.00037,1,3664472,3667714,+,3242
500,BUMA.1121.00080,1,1046905,1050147,+,3242
500,BUMA.1121.00079,1,1040503,1043745,+,3242
500,BUMA.1121.00045,1,3043926,3047179,-,3253
500,BUMA.1121.00071,1,1014970,1018212,+,3242
500,BUMA.1121.00056,1,2906807,2910050,-,3243
500,BUMA.1121.00065,1,1083865,1087107,+,3242
500,BUMA.1121.00058,1,3583040,3586283,-,3243
500,BUMA.1121.00007,1,3104910,3108155,-,3245
500,BUMA.1121.00067,1,3378398,3381641,-,3243
500,BUMA.1121.00090,1,3118709,3121951,+,3242
500,BUMA.1121.00051,1,1018461,1021703,+,3242
500,BUMA.1121.00020,1,3006893,3010136,-,3243
500,BUMA.1121.00103,1,3403012,3406255,-,3243
500,BUMA.1121.00048,1,506344,509586,+,3242
500,BUMA.1121.00047,1,1978685,1981928,-,3243
500,BUMA.1121.00042,1,1368488,1371730,+,3242
500,BUMA.1121.00055,1,610953,614195,+,3242
500,BUMA.1121.00031,1,2403062,2406304,+,3242
500,BUMA.1121.00040,1,2954060,2957303,-,3243
500,BUMA.1121.00044,1,2207651,2210894,-,3243
500,BUMA.1121.00088,1,1890233,1893475,+,3242
500,BUMA.1121.00069,1,978362,981604,+,3242
500,BUMA.1121.00064,1,1049598,1052840,+,3242
500,BUMA.1121.00105,1,187099,190342,-,3243
500,BUMA.1121.00015,1,2693288,2696530,+,3242
500,BUMA.1121.00059,1,252174,255416,+,3242
500,BUMA.1121.00026,1,2431947,2435189,+,3242
500,BUMA.1121.00022,1,3359176,3362419,-,3243
500,BUMA.1121.00052,1,2726839,2730082,-,3243
500,BUMA.1121.00101,1,1447119,1450364,-,3245
500,BUMA.1121.00001,1,3082238,3085481,-,3243
500,BUMA.1121.00038,1,713818,717060,+,3242
500,BUMA.1121.00068,1,3882290,3885532,+,3242
500,BUMA.1121.00099,1,1363110,1366353,-,3243
500,BUMA.1121.00091,1,3529570,3532813,-,3243
500,BUMA.1121.00098,1,3744071,3747313,+,3242
500,BUMA.1121.00013,1,3006965,3010208,-,3243
500,BUMA.1121.00049,1,839379,842622,-,3243
500,BUMA.1121.00072,1,997980,1001222,+,3242
500,BUMA.1121.00076,1,355371,358614,-,3243
500,BUMA.1121.00083,1,561897,565140,-,3243
500,BUMA.1121.00078,1,946185,949426,-,3241
500,BUMA.1121.00095,1,658458,661703,-,3245
500,BUMA.1121.00077,1,3715854,3719096,+,3242
500,BUMA.1121.00063,1,1022214,1025456,+,3242
500,BUMA.1121.00061,1,1024904,1028146,+,3242
500,BUMA.1121.00050,1,545158,548401,-,3243
500,BUMA.1121.00081,1,713887,717129,+,3242
500,BUMA.1121.00074,1,2856059,2859302,-,3243
500,BUMA.1121.00062,1,3545418,3548661,-,3243
500,BUMA.1121.00060,1,1269515,1272768,-,3253
500,BUMA.1121.00070,1,996270,999512,+,3242
500,BUMA.1121.00075,1,521092,524334,+,3242
500,BUMA.1121.00041,1,2283483,2286725,+,3242
500,BUMA.1121.00073,1,1023154,1026396,+,3242
500,BUMA.1121.00017,1,2877146,2880389,-,3243
500,BUMA.1121.00066,1,999198,1002440,+,3242
500,BUMA.1121.00107,1,913710,916950,+,3240
500,BUMA.1121.00085,1,2323785,2327028,-,3243
500,BUMA.1121.00030,1,2877216,2880459,-,3243
500,BUMA.1121.00112,1,2046827,2050070,-,3243
500,BUMA.1121.00002,1,2231166,2234408,+,3242
500,BUMA.1121.00082,1,1139680,1142922,+,3242
500,BUMA.1121.00014,1,1812347,1815590,-,3243
500,BUMA.1121.00011,1,581446,584689,-,3243
500,BUMA.1121.00019,1,2893413,2896656,-,3243
500,BUMA.1121.00057,1,2122599,2125841,+,3242
500,BUMA.1121.00018,1,1572392,1575634,+,3242
500,BUMA.1121.00039,1,1140078,1143320,+,3242
500,BUMA.1121.00016,1,3144126,3147368,+,3242
500,BUMA.1121.00004,1,2942023,2945266,-,3243
500,BUMA.1121.00005,1,2569117,2572360,-,3243
500,BUMA.1121.00100,1,299341,302566,-,3225
500,BUMA.1121.00006,1,713817,717059,+,3242
501,BUMA.1121.00027,1,3242440,3245876,+,3436
501,BUMA.1121.00025,1,1677370,1680816,-,3446
501,BUMA.1121.00021,1,1657769,1661213,+,3444
501,BUMA.1121.00023,1,3386347,3389794,+,3447
501,BUMA.1121.00024,1,2933886,2937349,-,3463
501,BUMA.1121.00033,1,3270396,3273843,+,3447
501,BUMA.1121.00034,1,2972621,2976084,-,3463
501,BUMA.1121.00036,1,1173901,1177344,+,3443
501,BUMA.1121.00032,1,1002311,1005774,-,3463
501,BUMA.1121.00009,1,541976,545445,-,3469
501,BUMA.1121.00008,1,2946832,2950295,-,3463
501,BUMA.1121.00003,1,3507169,3510621,+,3452
501,BUMA.1121.00109,1,865982,869370,-,3388
501,BUMA.1121.00053,1,755212,758640,+,3428
501,BUMA.1121.00110,1,3766302,3769749,-,3447
501,BUMA.1121.00104,1,270591,274038,-,3447
501,BUMA.1121.00086,1,1621619,1625082,-,3463
501,BUMA.1121.00092,1,2840557,2844004,-,3447
501,BUMA.1121.00096,1,2249780,2253236,-,3456
501,BUMA.1121.00054,1,3419256,3422719,-,3463
501,BUMA.1121.00097,1,2976407,2979876,-,3469
501,BUMA.1121.00093,1,1782425,1785872,+,3447
501,BUMA.1121.00106,1,790260,793698,+,3438
501,BUMA.1121.00010,1,2210938,2214381,+,3443
501,BUMA.1121.00035,1,2092558,2095994,+,3436
501,BUMA.1121.00108,1,2021133,2024581,+,3448
501,BUMA.1121.00028,1,2935226,2938689,-,3463
501,BUMA.1121.00094,1,1005939,1009376,+,3437
501,BUMA.1121.00102,1,198280,201727,-,3447
501,BUMA.1121.00111,1,1164407,1167854,+,3447
501,BUMA.1121.00089,1,1022287,1025724,+,3437
501,BUMA.1121.00084,1,1243414,1246852,+,3438
501,BUMA.1121.00029,1,3928888,3932334,-,3446
501,BUMA.1121.00012,1,3808134,3811581,+,3447
501,BUMA.1121.00087,1,1691788,1695231,+,3443
501,BUMA.1121.00043,1,1010635,1014082,+,3447
501,BUMA.1121.00046,1,2209955,2213398,+,3443
501,BUMA.1121.00037,1,3671148,3674595,+,3447
501,BUMA.1121.00080,1,1053593,1057030,+,3437
501,BUMA.1121.00079,1,1047195,1050631,+,3436
501,BUMA.1121.00045,1,3037083,3040523,-,3440
501,BUMA.1121.00071,1,1021628,1025074,+,3446
501,BUMA.1121.00056,1,2899937,2903374,-,3437
501,BUMA.1121.00065,1,1090577,1094013,+,3436
501,BUMA.1121.00058,1,3576143,3579601,-,3458
501,BUMA.1121.00007,1,3098033,3101471,-,3438
501,BUMA.1121.00067,1,3371546,3374983,-,3437
501,BUMA.1121.00090,1,3125373,3128820,+,3447
501,BUMA.1121.00051,1,1025149,1028585,+,3436
501,BUMA.1121.00020,1,3000039,3003502,-,3463
501,BUMA.1121.00103,1,3396240,3399555,-,3315
501,BUMA.1121.00048,1,512990,516433,+,3443
501,BUMA.1121.00047,1,1971839,1975276,-,3437
501,BUMA.1121.00042,1,1375164,1378607,+,3443
501,BUMA.1121.00055,1,617605,621047,+,3442
501,BUMA.1121.00031,1,2409726,2413173,+,3447
501,BUMA.1121.00040,1,2947176,2950639,-,3463
501,BUMA.1121.00044,1,2200791,2204254,-,3463
501,BUMA.1121.00088,1,1896915,1900353,+,3438
501,BUMA.1121.00069,1,985020,988465,+,3445
501,BUMA.1121.00064,1,1056250,1059687,+,3437
501,BUMA.1121.00105,1,180255,183702,-,3447
501,BUMA.1121.00015,1,2699916,2703359,+,3443
501,BUMA.1121.00059,1,258832,262260,+,3428
501,BUMA.1121.00026,1,2438659,2442102,+,3443
501,BUMA.1121.00022,1,3352328,3355791,-,3463
501,BUMA.1121.00052,1,2719978,2723430,-,3452
501,BUMA.1121.00101,1,1440236,1443692,-,3456
501,BUMA.1121.00001,1,3075341,3078787,-,3446
501,BUMA.1121.00038,1,720464,723907,+,3443
501,BUMA.1121.00068,1,3888978,3892425,+,3447
501,BUMA.1121.00099,1,1356266,1359713,-,3447
501,BUMA.1121.00091,1,3522714,3526161,-,3447
501,BUMA.1121.00098,1,3750705,3754142,+,3437
501,BUMA.1121.00013,1,3000098,3003550,-,3452
501,BUMA.1121.00049,1,832492,835928,-,3436
501,BUMA.1121.00072,1,1004638,1008084,+,3446
501,BUMA.1121.00076,1,348481,351938,-,3457
501,BUMA.1121.00083,1,555036,558482,-,3446
501,BUMA.1121.00078,1,939283,942752,-,3469
501,BUMA.1121.00095,1,651556,655014,-,3458
501,BUMA.1121.00077,1,3722518,3725963,+,3445
501,BUMA.1121.00063,1,1028872,1032316,+,3444
501,BUMA.1121.00061,1,1031562,1035008,+,3446
501,BUMA.1121.00050,1,538280,541743,-,3463
501,BUMA.1121.00081,1,720533,723976,+,3443
501,BUMA.1121.00074,1,2849207,2852644,-,3437
501,BUMA.1121.00062,1,3538509,3541967,-,3458
501,BUMA.1121.00060,1,1262672,1266112,-,3440
501,BUMA.1121.00070,1,1002928,1006374,+,3446
501,BUMA.1121.00075,1,527768,531215,+,3447
501,BUMA.1121.00041,1,2290147,2293590,+,3443
501,BUMA.1121.00073,1,1029812,1033258,+,3446
501,BUMA.1121.00017,1,2870286,2873749,-,3463
501,BUMA.1121.00066,1,1005856,1009302,+,3446
501,BUMA.1121.00107,1,920348,923786,+,3438
501,BUMA.1121.00085,1,2316924,2320376,-,3452
501,BUMA.1121.00030,1,2870356,2873819,-,3463
501,BUMA.1121.00112,1,2039977,2043430,-,3453
501,BUMA.1121.00002,1,2237800,2241243,+,3443
501,BUMA.1121.00082,1,1146338,1149774,+,3436
501,BUMA.1121.00014,1,1805467,1808914,-,3447
501,BUMA.1121.00011,1,574541,577983,-,3442
501,BUMA.1121.00019,1,2886559,2890022,-,3463
501,BUMA.1121.00057,1,2129275,2132722,+,3447
501,BUMA.1121.00018,1,1579046,1582492,+,3446
501,BUMA.1121.00039,1,1146754,1150190,+,3436
501,BUMA.1121.00016,1,3150808,3154255,+,3447
501,BUMA.1121.00004,1,2935169,2938632,-,3463
501,BUMA.1121.00005,1,2562279,2565716,-,3437
501,BUMA.1121.00100,1,292485,295932,-,3447
501,BUMA.1121.00006,1,720463,723906,+,3443
502,BUMA.1121.00027,1,3246270,3270022,+,23752
502,BUMA.1121.00025,1,1653274,1677050,-,23776
502,BUMA.1121.00021,1,1661537,1685307,+,23770
502,BUMA.1121.00023,1,3390114,3413868,+,23754
502,BUMA.1121.00024,1,2909778,2933534,-,23756
502,BUMA.1121.00033,1,3274163,3297934,+,23771
502,BUMA.1121.00034,1,2948513,2972269,-,23756
502,BUMA.1121.00036,1,1177708,1201464,+,23756
502,BUMA.1121.00032,1,978203,1001959,-,23756
502,BUMA.1121.00009,1,517818,541600,-,23782
502,BUMA.1121.00008,1,2922724,2946480,-,23756
502,BUMA.1121.00003,1,3510933,3534683,+,23750
502,BUMA.1121.00109,1,841818,865600,-,23782
502,BUMA.1121.00053,1,758964,782726,+,23762
502,BUMA.1121.00110,1,3742210,3765974,-,23764
502,BUMA.1121.00104,1,246501,270303,-,23802
502,BUMA.1121.00086,1,1597519,1621275,-,23756
502,BUMA.1121.00092,1,2816500,2840261,-,23761
502,BUMA.1121.00096,1,2225680,2249452,-,23772
502,BUMA.1121.00054,1,3395157,3418904,-,23747
502,BUMA.1121.00097,1,2952282,2976055,-,23773
502,BUMA.1121.00093,1,1786168,1809929,+,23761
502,BUMA.1121.00106,1,794078,817880,+,23802
502,BUMA.1121.00010,1,2214769,2238525,+,23756
502,BUMA.1121.00035,1,2096325,2120088,+,23763
502,BUMA.1121.00108,1,2024901,2048685,+,23784
502,BUMA.1121.00028,1,2911118,2934874,-,23756
502,BUMA.1121.00094,1,1009672,1033430,+,23758
502,BUMA.1121.00102,1,174194,197960,-,23766
502,BUMA.1121.00111,1,1168182,1191948,+,23766
502,BUMA.1121.00089,1,1026020,1049778,+,23758
502,BUMA.1121.00084,1,1247256,1271038,+,23782
502,BUMA.1121.00029,1,3904772,3928535,-,23763
502,BUMA.1121.00012,1,3811901,3835670,+,23769
502,BUMA.1121.00087,1,1695595,1719351,+,23756
502,BUMA.1121.00043,1,1014402,1038174,+,23772
502,BUMA.1121.00046,1,2213770,2237526,+,23756
502,BUMA.1121.00037,1,3674915,3698669,+,23754
502,BUMA.1121.00080,1,1057326,1081091,+,23765
502,BUMA.1121.00079,1,1050927,1074711,+,23784
502,BUMA.1121.00045,1,3012984,3036767,-,23783
502,BUMA.1121.00071,1,1025412,1049157,+,23745
502,BUMA.1121.00056,1,2875883,2899641,-,23758
502,BUMA.1121.00065,1,1094351,1118128,+,23777
502,BUMA.1121.00058,1,3552064,3575839,-,23775
502,BUMA.1121.00007,1,3073926,3097677,-,23751
502,BUMA.1121.00067,1,3347464,3371250,-,23786
502,BUMA.1121.00090,1,3129140,3152894,+,23754
502,BUMA.1121.00051,1,1028881,1052646,+,23765
502,BUMA.1121.00020,1,2975931,2999687,-,23756
502,BUMA.1121.00103,1,3372209,3395912,-,23703
502,BUMA.1121.00048,1,516805,540551,+,23746
502,BUMA.1121.00047,1,1947811,1971543,-,23732
502,BUMA.1121.00042,1,1378995,1402751,+,23756
502,BUMA.1121.00055,1,621375,645156,+,23781
502,BUMA.1121.00031,1,2413493,2437256,+,23763
502,BUMA.1121.00040,1,2921739,2946808,-,25069
502,BUMA.1121.00044,1,2176683,2200439,-,23756
502,BUMA.1121.00088,1,1900741,1924500,+,23759
502,BUMA.1121.00069,1,988810,1012566,+,23756
502,BUMA.1121.00064,1,1060015,1083808,+,23793
502,BUMA.1121.00105,1,156161,179935,-,23774
502,BUMA.1121.00015,1,2703723,2727479,+,23756
502,BUMA.1121.00059,1,262627,286374,+,23747
502,BUMA.1121.00026,1,2442498,2466254,+,23756
502,BUMA.1121.00022,1,3328228,3351984,-,23756
502,BUMA.1121.00052,1,2695862,2719618,-,23756
502,BUMA.1121.00101,1,1416089,1439860,-,23771
502,BUMA.1121.00001,1,3051234,3074996,-,23762
502,BUMA.1121.00038,1,724279,748025,+,23746
502,BUMA.1121.00068,1,3892755,3916534,+,23779
502,BUMA.1121.00099,1,1332167,1355946,-,23779
502,BUMA.1121.00091,1,3498650,3522418,-,23768
502,BUMA.1121.00098,1,3754530,3778319,+,23789
502,BUMA.1121.00013,1,2975990,2999746,-,23756
502,BUMA.1121.00049,1,808393,832156,-,23763
502,BUMA.1121.00072,1,1008442,1032176,+,23734
502,BUMA.1121.00076,1,324416,348177,-,23761
502,BUMA.1121.00083,1,530914,554676,-,23762
502,BUMA.1121.00078,1,915220,938979,-,23759
502,BUMA.1121.00095,1,627444,651220,-,23776
502,BUMA.1121.00077,1,3726291,3750053,+,23762
502,BUMA.1121.00063,1,1032655,1056394,+,23739
502,BUMA.1121.00061,1,1035367,1059112,+,23745
502,BUMA.1121.00050,1,514172,537928,-,23756
502,BUMA.1121.00081,1,724348,748094,+,23746
502,BUMA.1121.00074,1,2825085,2848879,-,23794
502,BUMA.1121.00062,1,3513197,3536956,-,23759
502,BUMA.1121.00060,1,1238573,1262356,-,23783
502,BUMA.1121.00070,1,1006716,1030475,+,23759
502,BUMA.1121.00075,1,531529,555290,+,23761
502,BUMA.1121.00041,1,2293922,2317694,+,23772
502,BUMA.1121.00073,1,1033603,1057362,+,23759
502,BUMA.1121.00017,1,2846178,2869934,-,23756
502,BUMA.1121.00066,1,1009647,1033406,+,23759
502,BUMA.1121.00107,1,924153,947937,+,23784
502,BUMA.1121.00085,1,2292808,2316564,-,23756
502,BUMA.1121.00030,1,2846248,2870004,-,23756
502,BUMA.1121.00112,1,2015918,2039673,-,23755
502,BUMA.1121.00002,1,2241631,2265387,+,23756
502,BUMA.1121.00082,1,1150144,1173906,+,23762
502,BUMA.1121.00014,1,1781384,1805147,-,23763
502,BUMA.1121.00011,1,547843,572925,-,25082
502,BUMA.1121.00019,1,2862451,2886207,-,23756
502,BUMA.1121.00057,1,2133018,2156782,+,23764
502,BUMA.1121.00018,1,1582812,1606587,+,23775
502,BUMA.1121.00039,1,1150553,1174307,+,23754
502,BUMA.1121.00016,1,3154575,3178331,+,23756
502,BUMA.1121.00004,1,2911062,2934817,-,23755
502,BUMA.1121.00005,1,2538272,2561959,-,23687
502,BUMA.1121.00100,1,268375,292157,-,23782
502,BUMA.1121.00006,1,724278,748024,+,23746
503,BUMA.1121.00027,1,3271891,3275351,+,3460
503,BUMA.1121.00025,1,1647942,1651405,-,3463
503,BUMA.1121.00021,1,1687220,1690684,+,3464
503,BUMA.1121.00023,1,3415790,3419254,+,3464
503,BUMA.1121.00024,1,2904489,2907954,-,3465
503,BUMA.1121.00033,1,3299857,3303322,+,3465
503,BUMA.1121.00034,1,2943224,2946689,-,3465
503,BUMA.1121.00036,1,1203288,1206753,+,3465
503,BUMA.1121.00032,1,972914,976379,-,3465
503,BUMA.1121.00009,1,512435,515895,-,3460
503,BUMA.1121.00008,1,2917435,2920900,-,3465
503,BUMA.1121.00003,1,3536669,3540135,+,3466
503,BUMA.1121.00109,1,836477,839941,-,3464
503,BUMA.1121.00053,1,784594,788044,+,3450
503,BUMA.1121.00110,1,3736857,3740297,-,3440
503,BUMA.1121.00104,1,241147,244606,-,3459
503,BUMA.1121.00086,1,1592230,1595695,-,3465
503,BUMA.1121.00092,1,2811081,2814541,-,3460
503,BUMA.1121.00096,1,2220335,2223793,-,3458
503,BUMA.1121.00054,1,3388610,3392075,-,3465
503,BUMA.1121.00097,1,2946871,2950333,-,3462
503,BUMA.1121.00093,1,1811888,1815348,+,3460
503,BUMA.1121.00106,1,819767,823232,+,3465
503,BUMA.1121.00010,1,2343722,2347155,+,3433
503,BUMA.1121.00035,1,2121974,2125439,+,3465
503,BUMA.1121.00108,1,2050571,2054030,+,3459
503,BUMA.1121.00028,1,2905829,2909294,-,3465
503,BUMA.1121.00094,1,1035362,1038821,+,3459
503,BUMA.1121.00102,1,168736,172200,-,3464
503,BUMA.1121.00111,1,1193852,1197317,+,3465
503,BUMA.1121.00089,1,1051701,1055160,+,3459
503,BUMA.1121.00084,1,1272934,1276394,+,3460
503,BUMA.1121.00029,1,3899412,3902877,-,3465
503,BUMA.1121.00012,1,3837592,3841056,+,3464
503,BUMA.1121.00087,1,1721175,1724640,+,3465
503,BUMA.1121.00043,1,1040132,1043596,+,3464
503,BUMA.1121.00046,1,2239359,2242824,+,3465
503,BUMA.1121.00037,1,3700555,3704020,+,3465
503,BUMA.1121.00080,1,1083032,1086490,+,3458
503,BUMA.1121.00079,1,1076598,1080057,+,3459
503,BUMA.1121.00045,1,3007635,3011079,-,3444
503,BUMA.1121.00071,1,1051035,1054495,+,3460
503,BUMA.1121.00056,1,2870501,2873960,-,3459
503,BUMA.1121.00065,1,1120005,1123469,+,3464
503,BUMA.1121.00058,1,3546735,3550195,-,3460
503,BUMA.1121.00007,1,3068556,3072021,-,3465
503,BUMA.1121.00067,1,3342099,3345559,-,3460
503,BUMA.1121.00090,1,3154790,3158255,+,3465
503,BUMA.1121.00051,1,1054587,1058046,+,3459
503,BUMA.1121.00020,1,2970642,2974107,-,3465
503,BUMA.1121.00103,1,3366869,3370332,-,3463
503,BUMA.1121.00048,1,543634,547099,+,3465
503,BUMA.1121.00047,1,1942420,1945879,-,3459
503,BUMA.1121.00055,1,647053,650502,+,3449
503,BUMA.1121.00031,1,2439196,2442660,+,3464
503,BUMA.1121.00040,1,2916441,2919906,-,3465
503,BUMA.1121.00044,1,2171394,2174859,-,3465
503,BUMA.1121.00088,1,1926333,1929798,+,3465
503,BUMA.1121.00069,1,1014444,1017904,+,3460
503,BUMA.1121.00064,1,1085686,1089145,+,3459
503,BUMA.1121.00105,1,150805,154265,-,3460
503,BUMA.1121.00015,1,2729312,2732777,+,3465
503,BUMA.1121.00059,1,288252,291712,+,3460
503,BUMA.1121.00026,1,2468087,2471552,+,3465
503,BUMA.1121.00022,1,3322939,3326404,-,3465
503,BUMA.1121.00052,1,2690659,2694124,-,3465
503,BUMA.1121.00101,1,1410765,1414229,-,3464
503,BUMA.1121.00001,1,3045892,3049357,-,3465
503,BUMA.1121.00038,1,751108,754573,+,3465
503,BUMA.1121.00068,1,3918430,3921869,+,3439
503,BUMA.1121.00099,1,1326737,1330200,-,3463
503,BUMA.1121.00091,1,3493349,3496809,-,3460
503,BUMA.1121.00098,1,3780223,3783687,+,3464
503,BUMA.1121.00013,1,2970692,2974157,-,3465
503,BUMA.1121.00049,1,803061,806525,-,3464
503,BUMA.1121.00072,1,1033970,1037430,+,3460
503,BUMA.1121.00076,1,319023,322474,-,3451
503,BUMA.1121.00083,1,525576,529036,-,3460
503,BUMA.1121.00078,1,909826,913290,-,3464
503,BUMA.1121.00095,1,622112,625576,-,3464
503,BUMA.1121.00077,1,3751966,3755406,+,3440
503,BUMA.1121.00063,1,1058272,1061732,+,3460
503,BUMA.1121.00061,1,1060990,1064450,+,3460
503,BUMA.1121.00050,1,508874,512339,-,3465
503,BUMA.1121.00081,1,751177,754642,+,3465
503,BUMA.1121.00074,1,2819729,2823189,-,3460
503,BUMA.1121.00062,1,3507895,3511355,-,3460
503,BUMA.1121.00060,1,1233224,1236668,-,3444
503,BUMA.1121.00070,1,1032353,1035813,+,3460
503,BUMA.1121.00075,1,557232,560683,+,3451
503,BUMA.1121.00041,1,2319589,2323054,+,3465
503,BUMA.1121.00073,1,1059240,1062700,+,3460
503,BUMA.1121.00017,1,2840889,2844354,-,3465
503,BUMA.1121.00066,1,1035284,1038750,+,3466
503,BUMA.1121.00107,1,949849,953289,+,3440
503,BUMA.1121.00085,1,2287605,2291070,-,3465
503,BUMA.1121.00030,1,2840959,2844424,-,3465
503,BUMA.1121.00112,1,2010599,2014049,-,3450
503,BUMA.1121.00002,1,2370600,2374032,+,3432
503,BUMA.1121.00082,1,1175784,1179244,+,3460
503,BUMA.1121.00014,1,1775971,1779435,-,3464
503,BUMA.1121.00011,1,542442,545902,-,3460
503,BUMA.1121.00019,1,2857162,2860627,-,3465
503,BUMA.1121.00057,1,2158651,2162111,+,3460
503,BUMA.1121.00018,1,1608456,1611919,+,3463
503,BUMA.1121.00039,1,1176212,1179677,+,3465
503,BUMA.1121.00016,1,3180280,3183745,+,3465
503,BUMA.1121.00004,1,2905773,2909238,-,3465
503,BUMA.1121.00005,1,2532901,2536361,-,3460
503,BUMA.1121.00100,1,263068,266534,-,3466
503,BUMA.1121.00006,1,751107,754572,+,3465
504,BUMA.1121.00027,1,3275579,3292935,+,17356
504,BUMA.1121.00025,1,1630333,1647714,-,17381
504,BUMA.1121.00021,1,1690940,1708332,+,17392
504,BUMA.1121.00023,1,3419503,3436783,+,17280
504,BUMA.1121.00024,1,2885334,2902685,-,17351
504,BUMA.1121.00033,1,3303550,3320758,+,17208
504,BUMA.1121.00034,1,2924097,2941420,-,17323
504,BUMA.1121.00036,1,1208564,1225993,+,17429
504,BUMA.1121.00032,1,953742,971110,-,17368
504,BUMA.1121.00009,1,494934,512221,-,17287
504,BUMA.1121.00008,1,2898347,2915631,-,17284
504,BUMA.1121.00003,1,3540328,3557553,+,17225
504,BUMA.1121.00109,1,818882,836200,-,17318
504,BUMA.1121.00053,1,788237,805503,+,17266
504,BUMA.1121.00110,1,3719297,3736617,-,17320
504,BUMA.1121.00104,1,223528,240912,-,17384
504,BUMA.1121.00086,1,1572999,1590412,-,17413
504,BUMA.1121.00092,1,2793499,2810853,-,17354
504,BUMA.1121.00096,1,2202887,2220148,-,17261
504,BUMA.1121.00054,1,3369444,3386785,-,17341
504,BUMA.1121.00097,1,2929370,2946664,-,17294
504,BUMA.1121.00093,1,1815576,1832930,+,17354
504,BUMA.1121.00106,1,823488,840755,+,17267
504,BUMA.1121.00010,1,2348967,2366254,+,17287
504,BUMA.1121.00035,1,2125688,2142961,+,17273
504,BUMA.1121.00108,1,2054328,2071619,+,17291
504,BUMA.1121.00028,1,2886657,2904025,-,17368
504,BUMA.1121.00094,1,1039035,1056412,+,17377
504,BUMA.1121.00102,1,151103,168508,-,17405
504,BUMA.1121.00111,1,1197552,1214815,+,17263
504,BUMA.1121.00089,1,1055374,1072751,+,17377
504,BUMA.1121.00084,1,1276622,1293907,+,17285
504,BUMA.1121.00029,1,3881870,3899170,-,17300
504,BUMA.1121.00012,1,3841333,3858574,+,17241
504,BUMA.1121.00087,1,1726458,1743880,+,17422
504,BUMA.1121.00043,1,1043831,1061049,+,17218
504,BUMA.1121.00046,1,2244628,2262050,+,17422
504,BUMA.1121.00037,1,3704269,3721640,+,17371
504,BUMA.1121.00080,1,1086718,1103994,+,17276
504,BUMA.1121.00079,1,1080285,1097728,+,17443
504,BUMA.1121.00045,1,2990057,3007402,-,17345
504,BUMA.1121.00071,1,1054758,1071953,+,17195
504,BUMA.1121.00056,1,2853018,2870287,-,17269
504,BUMA.1121.00065,1,1123662,1141025,+,17363
504,BUMA.1121.00058,1,3529271,3546535,-,17264
504,BUMA.1121.00007,1,3051006,3068300,-,17294
504,BUMA.1121.00067,1,3324479,3341885,-,17406
504,BUMA.1121.00090,1,3158469,3175768,+,17299
504,BUMA.1121.00051,1,1058260,1075546,+,17286
504,BUMA.1121.00020,1,2951554,2968838,-,17284
504,BUMA.1121.00103,1,3347698,3365058,-,17360
504,BUMA.1121.00048,1,548924,566265,+,17341
504,BUMA.1121.00047,1,1924910,1942206,-,17296
504,BUMA.1121.00042,1,2311476,2328817,-,17341
504,BUMA.1121.00055,1,650696,668017,+,17321
504,BUMA.1121.00031,1,2442909,2460153,+,17244
504,BUMA.1121.00040,1,2897145,2914630,-,17485
504,BUMA.1121.00044,1,2152195,2169590,-,17395
504,BUMA.1121.00088,1,1930026,1947295,+,17269
504,BUMA.1121.00069,1,1018167,1035363,+,17196
504,BUMA.1121.00064,1,1089387,1106761,+,17374
504,BUMA.1121.00105,1,133276,150605,-,17329
504,BUMA.1121.00015,1,2734609,2751995,+,17386
504,BUMA.1121.00059,1,291989,309294,+,17305
504,BUMA.1121.00026,1,2473419,2490733,+,17314
504,BUMA.1121.00022,1,3303751,3321128,-,17377
504,BUMA.1121.00052,1,2671493,2688841,-,17348
504,BUMA.1121.00101,1,1393239,1410523,-,17284
504,BUMA.1121.00001,1,3028272,3045643,-,17371
504,BUMA.1121.00038,1,756398,773739,+,17341
504,BUMA.1121.00068,1,3922102,3939365,+,17263
504,BUMA.1121.00099,1,1309096,1326509,-,17413
504,BUMA.1121.00091,1,3475773,3493163,-,17390
504,BUMA.1121.00098,1,3783971,3801418,+,17447
504,BUMA.1121.00013,1,2951535,2968874,-,17339
504,BUMA.1121.00049,1,785489,802840,-,17351
504,BUMA.1121.00072,1,1037670,1054866,+,17196
504,BUMA.1121.00076,1,301393,318760,-,17367
504,BUMA.1121.00083,1,508117,525313,-,17196
504,BUMA.1121.00078,1,892273,909598,-,17325
504,BUMA.1121.00095,1,604511,621870,-,17359
504,BUMA.1121.00077,1,3755646,3773002,+,17356
504,BUMA.1121.00063,1,1061990,1079186,+,17196
504,BUMA.1121.00061,1,1064713,1081909,+,17196
504,BUMA.1121.00050,1,489659,507072,-,17413
504,BUMA.1121.00081,1,756467,773808,+,17341
504,BUMA.1121.00074,1,2802220,2819515,-,17295
504,BUMA.1121.00062,1,3490260,3507632,-,17372
504,BUMA.1121.00060,1,1215664,1232991,-,17327
504,BUMA.1121.00070,1,1036080,1053272,+,17192
504,BUMA.1121.00075,1,560946,578302,+,17356
504,BUMA.1121.00041,1,2323289,2340707,+,17418
504,BUMA.1121.00073,1,1062967,1080159,+,17192
504,BUMA.1121.00017,1,2821690,2839085,-,17395
504,BUMA.1121.00066,1,1039006,1056200,+,17194
504,BUMA.1121.00107,1,953564,970917,+,17353
504,BUMA.1121.00085,1,2268439,2285787,-,17348
504,BUMA.1121.00030,1,2821760,2839155,-,17395
504,BUMA.1121.00112,1,1993026,2010308,-,17282
504,BUMA.1121.00002,1,2375842,2393138,+,17296
504,BUMA.1121.00082,1,1179507,1196703,+,17196
504,BUMA.1121.00014,1,1758410,1775708,-,17298
504,BUMA.1121.00011,1,524893,542193,-,17300
504,BUMA.1121.00019,1,2838065,2855358,-,17293
504,BUMA.1121.00057,1,2162332,2179701,+,17369
504,BUMA.1121.00018,1,1612147,1629519,+,17372
504,BUMA.1121.00039,1,1179968,1197256,+,17288
504,BUMA.1121.00016,1,3184008,3201322,+,17314
504,BUMA.1121.00004,1,2886575,2903969,-,17394
504,BUMA.1121.00005,1,2515346,2532680,-,17334
504,BUMA.1121.00100,1,245579,262868,-,17289
504,BUMA.1121.00006,1,756397,773738,+,17341
505,BUMA.1121.00027,1,3295841,3306739,+,10898
505,BUMA.1121.00025,1,1616507,1627438,-,10931
505,BUMA.1121.00021,1,1711214,1722149,+,10935
505,BUMA.1121.00023,1,3439636,3450571,+,10935
505,BUMA.1121.00024,1,2871536,2882428,-,10892
505,BUMA.1121.00033,1,3323651,3334582,+,10931
505,BUMA.1121.00034,1,2910299,2921191,-,10892
505,BUMA.1121.00036,1,1228898,1239791,+,10893
505,BUMA.1121.00032,1,939944,950836,-,10892
505,BUMA.1121.00009,1,481101,492030,-,10929
505,BUMA.1121.00008,1,2884550,2895441,-,10891
505,BUMA.1121.00003,1,3560446,3571377,+,10931
505,BUMA.1121.00109,1,805071,816000,-,10929
505,BUMA.1121.00053,1,808397,819327,+,10930
505,BUMA.1121.00110,1,3705497,3716426,-,10929
505,BUMA.1121.00104,1,209723,220621,-,10898
505,BUMA.1121.00086,1,1559201,1570093,-,10892
505,BUMA.1121.00092,1,2779690,2790590,-,10900
505,BUMA.1121.00096,1,2189052,2199981,-,10929
505,BUMA.1121.00054,1,3355646,3366538,-,10892
505,BUMA.1121.00097,1,2915559,2926488,-,10929
505,BUMA.1121.00093,1,1835838,1846739,+,10901
505,BUMA.1121.00106,1,843643,854544,+,10901
505,BUMA.1121.00010,1,2369147,2380040,+,10893
505,BUMA.1121.00035,1,2145844,2156776,+,10932
505,BUMA.1121.00108,1,2074500,2085414,+,10914
505,BUMA.1121.00028,1,2872859,2883751,-,10892
505,BUMA.1121.00094,1,1059317,1070218,+,10901
505,BUMA.1121.00102,1,137218,148148,-,10930
505,BUMA.1121.00111,1,1217698,1228633,+,10935
505,BUMA.1121.00089,1,1075656,1086589,+,10933
505,BUMA.1121.00084,1,1296802,1307737,+,10935
505,BUMA.1121.00029,1,3868056,3878986,-,10930
505,BUMA.1121.00012,1,3861439,3872371,+,10932
505,BUMA.1121.00087,1,1746785,1757678,+,10893
505,BUMA.1121.00043,1,1063931,1074863,+,10932
505,BUMA.1121.00046,1,2264955,2275848,+,10893
505,BUMA.1121.00037,1,3724523,3735458,+,10935
505,BUMA.1121.00080,1,1106889,1117821,+,10932
505,BUMA.1121.00079,1,1100635,1111535,+,10900
505,BUMA.1121.00045,1,2976249,2987162,-,10913
505,BUMA.1121.00071,1,1076162,1087093,+,10931
505,BUMA.1121.00056,1,2839180,2850112,-,10932
505,BUMA.1121.00065,1,1143931,1154861,+,10930
505,BUMA.1121.00058,1,3515430,3526363,-,10933
505,BUMA.1121.00007,1,3037174,3048112,-,10938
505,BUMA.1121.00067,1,3310649,3321583,-,10934
505,BUMA.1121.00090,1,3178651,3189586,+,10935
505,BUMA.1121.00051,1,1078451,1089351,+,10900
505,BUMA.1121.00020,1,2937756,2948648,-,10892
505,BUMA.1121.00103,1,3333873,3344803,-,10930
505,BUMA.1121.00048,1,569170,580063,+,10893
505,BUMA.1121.00047,1,1911072,1922004,-,10932
505,BUMA.1121.00042,1,2297690,2308582,-,10892
505,BUMA.1121.00055,1,670925,681856,+,10931
505,BUMA.1121.00031,1,2463018,2473953,+,10935
505,BUMA.1121.00040,1,2882033,2892924,-,10891
505,BUMA.1121.00044,1,2138397,2149289,-,10892
505,BUMA.1121.00088,1,1950190,1961120,+,10930
505,BUMA.1121.00069,1,1039572,1050503,+,10931
505,BUMA.1121.00064,1,1109667,1120566,+,10899
505,BUMA.1121.00105,1,119471,130369,-,10898
505,BUMA.1121.00015,1,2754900,2765793,+,10893
505,BUMA.1121.00059,1,312187,323074,+,10887
505,BUMA.1121.00026,1,2493626,2504519,+,10893
505,BUMA.1121.00022,1,3289953,3300845,-,10892
505,BUMA.1121.00052,1,1372985,1383878,+,10893
505,BUMA.1121.00101,1,1379378,1390335,-,10957
505,BUMA.1121.00001,1,3014457,3025388,-,10931
505,BUMA.1121.00038,1,776644,787537,+,10893
505,BUMA.1121.00068,1,3942246,3953176,+,10930
505,BUMA.1121.00099,1,1295271,1306202,-,10931
505,BUMA.1121.00091,1,3461908,3472864,-,10956
505,BUMA.1121.00098,1,3804310,3815240,+,10930
505,BUMA.1121.00013,1,1573806,1584699,+,10893
505,BUMA.1121.00049,1,771685,782583,-,10898
505,BUMA.1121.00072,1,1059075,1070006,+,10931
505,BUMA.1121.00076,1,287553,298486,-,10933
505,BUMA.1121.00083,1,492977,503907,-,10930
505,BUMA.1121.00078,1,878453,889379,-,10926
505,BUMA.1121.00095,1,590665,601603,-,10938
505,BUMA.1121.00077,1,3775871,3786801,+,10930
505,BUMA.1121.00063,1,1083337,1094268,+,10931
505,BUMA.1121.00061,1,1086060,1096990,+,10930
505,BUMA.1121.00050,1,475861,486753,-,10892
505,BUMA.1121.00081,1,776713,787606,+,10893
505,BUMA.1121.00074,1,2788390,2799324,-,10934
505,BUMA.1121.00062,1,3476464,3487364,-,10900
505,BUMA.1121.00060,1,1201856,1212769,-,10913
505,BUMA.1121.00070,1,1057030,1067961,+,10931
505,BUMA.1121.00075,1,581208,592142,+,10934
505,BUMA.1121.00041,1,2343615,2354546,+,10931
505,BUMA.1121.00073,1,1083963,1094894,+,10931
505,BUMA.1121.00017,1,2807892,2818784,-,10892
505,BUMA.1121.00066,1,1060409,1071340,+,10931
505,BUMA.1121.00107,1,973774,984704,+,10930
505,BUMA.1121.00085,1,969875,980768,+,10893
505,BUMA.1121.00030,1,2807962,2818854,-,10892
505,BUMA.1121.00112,1,1979240,1990132,-,10892
505,BUMA.1121.00002,1,2396031,2406924,+,10893
505,BUMA.1121.00082,1,1200912,1211843,+,10931
505,BUMA.1121.00014,1,1744622,1755556,-,10934
505,BUMA.1121.00011,1,511069,521999,-,10930
505,BUMA.1121.00019,1,2824267,2835159,-,10892
505,BUMA.1121.00057,1,2182606,2193539,+,10933
505,BUMA.1121.00018,1,1632413,1643345,+,10932
505,BUMA.1121.00039,1,1200139,1211074,+,10935
505,BUMA.1121.00016,1,3204216,3215138,+,10922
505,BUMA.1121.00004,1,2872777,2883669,-,10892
505,BUMA.1121.00005,1,2501510,2512439,-,10929
505,BUMA.1121.00100,1,231814,242711,-,10897
505,BUMA.1121.00006,1,776643,787536,+,10893
506,BUMA.1121.00027,1,3307816,3311905,+,4089
506,BUMA.1121.00025,1,1611330,1615430,-,4100
506,BUMA.1121.00021,1,1723226,1727315,+,4089
506,BUMA.1121.00023,1,3451648,3455737,+,4089
506,BUMA.1121.00024,1,2865794,2869880,-,4086
506,BUMA.1121.00033,1,3335658,3339758,+,4100
506,BUMA.1121.00034,1,2904557,2908643,-,4086
506,BUMA.1121.00036,1,1241445,1245532,+,4087
506,BUMA.1121.00032,1,934202,938288,-,4086
506,BUMA.1121.00009,1,475936,480025,-,4089
506,BUMA.1121.00008,1,2878808,2882894,-,4086
506,BUMA.1121.00003,1,3572454,3576555,+,4101
506,BUMA.1121.00109,1,766493,770593,-,4100
506,BUMA.1121.00053,1,820404,824504,+,4100
506,BUMA.1121.00110,1,3700331,3704420,-,4089
506,BUMA.1121.00104,1,204558,208646,-,4088
506,BUMA.1121.00086,1,1553459,1557545,-,4086
506,BUMA.1121.00092,1,2774524,2778613,-,4089
506,BUMA.1121.00054,1,1027272,1031359,-,4087
506,BUMA.1121.00097,1,2910382,2914482,-,4100
506,BUMA.1121.00093,1,1847816,1851905,+,4089
506,BUMA.1121.00106,1,855621,859710,+,4089
506,BUMA.1121.00035,1,2198969,2203058,+,4089
506,BUMA.1121.00108,1,2086490,2090590,+,4100
506,BUMA.1121.00028,1,2867117,2871203,-,4086
506,BUMA.1121.00094,1,1071294,1075383,+,4089
506,BUMA.1121.00102,1,132052,136141,-,4089
506,BUMA.1121.00111,1,1229709,1233798,+,4089
506,BUMA.1121.00089,1,1087665,1091754,+,4089
506,BUMA.1121.00084,1,1308807,1312896,+,4089
506,BUMA.1121.00029,1,3840775,3844864,-,4089
506,BUMA.1121.00012,1,3873448,3877548,+,4100
506,BUMA.1121.00087,1,1759333,1763420,+,4087
506,BUMA.1121.00043,1,1075931,1080031,+,4100
506,BUMA.1121.00046,1,2285701,2289787,-,4086
506,BUMA.1121.00037,1,3736534,3740622,+,4088
506,BUMA.1121.00080,1,1118898,1122987,+,4089
506,BUMA.1121.00079,1,1112612,1116701,+,4089
506,BUMA.1121.00045,1,2971083,2975172,-,4089
506,BUMA.1121.00071,1,1088169,1092266,+,4097
506,BUMA.1121.00056,1,2834015,2838104,-,4089
506,BUMA.1121.00065,1,1155938,1160038,+,4100
506,BUMA.1121.00058,1,3510265,3514354,-,4089
506,BUMA.1121.00007,1,3032015,3036104,-,4089
506,BUMA.1121.00067,1,3305483,3309572,-,4089
506,BUMA.1121.00090,1,3190663,3194752,+,4089
506,BUMA.1121.00051,1,1090428,1094517,+,4089
506,BUMA.1121.00020,1,2932014,2936100,-,4086
506,BUMA.1121.00103,1,3328707,3332796,-,4089
506,BUMA.1121.00048,1,2904430,2908517,+,4087
506,BUMA.1121.00047,1,1905907,1909996,-,4089
506,BUMA.1121.00055,1,682927,687016,+,4089
506,BUMA.1121.00031,1,2475030,2479119,+,4089
506,BUMA.1121.00040,1,2876291,2880377,-,4086
506,BUMA.1121.00044,1,2132655,2136741,-,4086
506,BUMA.1121.00088,1,1962190,1966279,+,4089
506,BUMA.1121.00069,1,1051579,1055677,+,4098
506,BUMA.1121.00064,1,1121637,1125726,+,4089
506,BUMA.1121.00105,1,114311,118400,-,4089
506,BUMA.1121.00015,1,2775696,2779783,-,4087
506,BUMA.1121.00059,1,324151,328240,+,4089
506,BUMA.1121.00026,1,2506173,2510262,+,4089
506,BUMA.1121.00022,1,3284211,3288299,-,4088
506,BUMA.1121.00052,1,1358498,1362585,+,4087
506,BUMA.1121.00101,1,1374213,1378302,-,4089
506,BUMA.1121.00001,1,2995501,2999590,-,4089
506,BUMA.1121.00038,1,3111746,3115833,+,4087
506,BUMA.1121.00068,1,3954253,3958344,+,4091
506,BUMA.1121.00099,1,1290105,1294194,-,4089
506,BUMA.1121.00091,1,3456742,3460831,-,4089
506,BUMA.1121.00098,1,3816316,3820416,+,4100
506,BUMA.1121.00013,1,1559329,1563416,+,4087
506,BUMA.1121.00049,1,766519,770608,-,4089
506,BUMA.1121.00072,1,1071082,1075179,+,4097
506,BUMA.1121.00076,1,282387,286476,-,4089
506,BUMA.1121.00083,1,487801,491901,-,4100
506,BUMA.1121.00078,1,873288,877377,-,4089
506,BUMA.1121.00095,1,585500,589589,-,4089
506,BUMA.1121.00077,1,3787878,3791970,+,4092
506,BUMA.1121.00063,1,1095344,1099441,+,4097
506,BUMA.1121.00061,1,1098066,1102162,+,4096
506,BUMA.1121.00050,1,461921,466008,+,4087
506,BUMA.1121.00081,1,3111938,3116025,+,4087
506,BUMA.1121.00074,1,2783224,2787313,-,4089
506,BUMA.1121.00062,1,3471298,3475387,-,4089
506,BUMA.1121.00060,1,1196690,1200779,-,4089
506,BUMA.1121.00070,1,1069037,1073134,+,4097
506,BUMA.1121.00075,1,593219,597308,+,4089
506,BUMA.1121.00041,1,2355623,2359712,+,4089
506,BUMA.1121.00073,1,1095970,1100067,+,4097
506,BUMA.1121.00017,1,2802150,2806236,-,4086
506,BUMA.1121.00066,1,1072416,1076513,+,4097
506,BUMA.1121.00107,1,985781,989881,+,4100
506,BUMA.1121.00085,1,955388,959475,+,4087
506,BUMA.1121.00030,1,2802220,2806306,-,4086
506,BUMA.1121.00112,1,1974087,1978176,-,4089
506,BUMA.1121.00082,1,1212919,1217019,+,4100
506,BUMA.1121.00014,1,1739462,1743551,-,4089
506,BUMA.1121.00011,1,505916,510005,-,4089
506,BUMA.1121.00057,1,2194615,2198715,+,4100
506,BUMA.1121.00018,1,1644422,1648522,+,4100
506,BUMA.1121.00039,1,1212151,1216240,+,4089
506,BUMA.1121.00016,1,3216216,3220305,+,4089
506,BUMA.1121.00004,1,2867035,2871121,-,4086
506,BUMA.1121.00005,1,2496333,2500433,-,4100
506,BUMA.1121.00100,1,190522,194611,-,4089
506,BUMA.1121.00006,1,3111823,3115910,+,4087
507,BUMA.1121.00027,1,3312344,3317453,+,5109
507,BUMA.1121.00025,1,1605814,1610928,-,5114
507,BUMA.1121.00021,1,1727747,1732862,+,5115
507,BUMA.1121.00023,1,3456269,3461389,+,5120
507,BUMA.1121.00024,1,2860285,2865400,-,5115
507,BUMA.1121.00033,1,3340140,3345255,+,5115
507,BUMA.1121.00034,1,2899048,2904163,-,5115
507,BUMA.1121.00036,1,1245906,1251020,+,5114
507,BUMA.1121.00032,1,928693,933808,-,5115
507,BUMA.1121.00009,1,470437,475554,-,5117
507,BUMA.1121.00008,1,2873299,2878414,-,5115
507,BUMA.1121.00003,1,3577055,3582168,+,5113
507,BUMA.1121.00109,1,760999,766111,-,5112
507,BUMA.1121.00053,1,824915,830028,+,5113
507,BUMA.1121.00110,1,3694865,3699977,-,5112
507,BUMA.1121.00104,1,199091,204204,-,5113
507,BUMA.1121.00086,1,1547970,1553085,-,5115
507,BUMA.1121.00092,1,2769063,2774160,-,5097
507,BUMA.1121.00054,1,1021763,1026878,-,5115
507,BUMA.1121.00097,1,2904894,2910010,-,5116
507,BUMA.1121.00093,1,1852269,1857365,+,5096
507,BUMA.1121.00106,1,860064,865175,+,5111
507,BUMA.1121.00035,1,2203430,2208545,+,5115
507,BUMA.1121.00108,1,2090963,2096074,+,5111
507,BUMA.1121.00028,1,2861608,2866723,-,5115
507,BUMA.1121.00094,1,1077113,1082227,+,5114
507,BUMA.1121.00102,1,126569,131666,-,5097
507,BUMA.1121.00111,1,1234357,1239470,+,5113
507,BUMA.1121.00089,1,1093484,1098598,+,5114
507,BUMA.1121.00084,1,1313260,1318371,+,5111
507,BUMA.1121.00029,1,3835287,3840403,-,5116
507,BUMA.1121.00012,1,3877939,3883052,+,5113
507,BUMA.1121.00087,1,1763794,1768908,+,5114
507,BUMA.1121.00043,1,1080422,1085535,+,5113
507,BUMA.1121.00046,1,2280212,2285327,-,5115
507,BUMA.1121.00037,1,3741082,3746203,+,5121
507,BUMA.1121.00080,1,1123341,1128455,+,5114
507,BUMA.1121.00079,1,1118431,1123545,+,5114
507,BUMA.1121.00045,1,2965582,2970697,-,5115
507,BUMA.1121.00071,1,1092714,1097828,+,5114
507,BUMA.1121.00056,1,2827170,2832285,-,5115
507,BUMA.1121.00065,1,1160430,1165543,+,5113
507,BUMA.1121.00058,1,3504770,3509883,-,5113
507,BUMA.1121.00007,1,3026514,3031612,-,5098
507,BUMA.1121.00067,1,3300019,3305129,-,5110
507,BUMA.1121.00090,1,3195248,3200361,+,5113
507,BUMA.1121.00051,1,1096247,1101361,+,5114
507,BUMA.1121.00020,1,2926505,2931620,-,5115
507,BUMA.1121.00103,1,3323238,3328352,-,5114
507,BUMA.1121.00048,1,2908911,2914025,+,5114
507,BUMA.1121.00047,1,1899064,1904177,-,5113
507,BUMA.1121.00055,1,687389,692503,+,5114
507,BUMA.1121.00031,1,2479598,2484711,+,5113
507,BUMA.1121.00040,1,2870792,2875907,-,5115
507,BUMA.1121.00044,1,2127146,2132261,-,5115
507,BUMA.1121.00088,1,1966643,1971754,+,5111
507,BUMA.1121.00069,1,1056117,1061231,+,5114
507,BUMA.1121.00064,1,1126080,1131189,+,5109
507,BUMA.1121.00105,1,108771,113885,-,5114
507,BUMA.1121.00015,1,2770197,2775312,-,5115
507,BUMA.1121.00059,1,328604,333715,+,5111
507,BUMA.1121.00026,1,2510646,2515760,+,5114
507,BUMA.1121.00022,1,3278722,3283837,-,5115
507,BUMA.1121.00052,1,1363009,1368123,+,5114
507,BUMA.1121.00101,1,1368746,1373858,-,5112
507,BUMA.1121.00001,1,2986920,2992036,-,5116
507,BUMA.1121.00038,1,3116227,3121341,+,5114
507,BUMA.1121.00068,1,3958708,3963806,+,5098
507,BUMA.1121.00099,1,1284628,1289742,-,5114
507,BUMA.1121.00091,1,3451246,3456359,-,5113
507,BUMA.1121.00098,1,3820779,3825890,+,5111
507,BUMA.1121.00013,1,1563830,1568944,+,5114
507,BUMA.1121.00049,1,761052,766165,-,5113
507,BUMA.1121.00072,1,1075639,1080753,+,5114
507,BUMA.1121.00076,1,276885,281984,-,5099
507,BUMA.1121.00083,1,482225,487340,-,5115
507,BUMA.1121.00078,1,867802,872915,-,5113
507,BUMA.1121.00095,1,580033,585118,-,5085
507,BUMA.1121.00077,1,3792324,3797435,+,5111
507,BUMA.1121.00063,1,1099880,1104994,+,5114
507,BUMA.1121.00061,1,1102612,1107726,+,5114
507,BUMA.1121.00050,1,466382,471496,+,5114
507,BUMA.1121.00081,1,3116419,3121533,+,5114
507,BUMA.1121.00074,1,2777760,2782870,-,5110
507,BUMA.1121.00062,1,3465834,3470944,-,5110
507,BUMA.1121.00060,1,1191189,1196304,-,5115
507,BUMA.1121.00070,1,1073594,1078708,+,5114
507,BUMA.1121.00075,1,597721,602818,+,5097
507,BUMA.1121.00041,1,2360066,2365178,+,5112
507,BUMA.1121.00073,1,1100527,1105641,+,5114
507,BUMA.1121.00017,1,2796641,2801756,-,5115
507,BUMA.1121.00066,1,1076973,1082087,+,5114
507,BUMA.1121.00107,1,990293,995406,+,5113
507,BUMA.1121.00085,1,959899,965013,+,5114
507,BUMA.1121.00030,1,2796711,2801826,-,5115
507,BUMA.1121.00112,1,1968602,1973714,-,5112
507,BUMA.1121.00082,1,1217480,1222594,+,5114
507,BUMA.1121.00014,1,1733869,1738983,-,5114
507,BUMA.1121.00011,1,500405,505520,-,5115
507,BUMA.1121.00057,1,2199145,2204254,+,5109
507,BUMA.1121.00018,1,1648924,1654037,+,5113
507,BUMA.1121.00039,1,1216739,1221846,+,5107
507,BUMA.1121.00016,1,3220765,3225880,+,5115
507,BUMA.1121.00004,1,2861526,2866641,-,5115
507,BUMA.1121.00005,1,2490818,2495931,-,5113
507,BUMA.1121.00100,1,185053,190167,-,5114
507,BUMA.1121.00006,1,3116304,3121418,+,5114
508,BUMA.1121.00027,1,3322225,3337493,+,15268
508,BUMA.1121.00025,1,1521149,1536259,-,15110
508,BUMA.1121.00021,1,1766554,1781656,+,15102
508,BUMA.1121.00023,1,3542843,3557974,+,15131
508,BUMA.1121.00024,1,1326310,1341463,+,15153
508,BUMA.1121.00033,1,3352477,3367609,+,15132
508,BUMA.1121.00034,1,1363717,1378870,+,15153
508,BUMA.1121.00036,1,742458,757604,+,15146
508,BUMA.1121.00032,1,2856794,2871947,+,15153
508,BUMA.1121.00009,1,450556,465656,-,15100
508,BUMA.1121.00008,1,1330043,1345196,+,15153
508,BUMA.1121.00003,1,3600394,3615615,+,15221
508,BUMA.1121.00109,1,740927,756210,-,15283
508,BUMA.1121.00053,1,853213,868407,+,15194
508,BUMA.1121.00110,1,3656535,3671711,-,15176
508,BUMA.1121.00104,1,179175,194326,-,15151
508,BUMA.1121.00086,1,2044983,2060129,-,15146
508,BUMA.1121.00092,1,2735710,2750832,-,15122
508,BUMA.1121.00096,1,2142960,2158115,-,15155
508,BUMA.1121.00054,1,1845024,1860170,-,15146
508,BUMA.1121.00097,1,2870298,2885398,-,15100
508,BUMA.1121.00093,1,1875597,1890719,+,15122
508,BUMA.1121.00106,1,869997,885104,+,15107
508,BUMA.1121.00010,1,2449082,2464236,+,15154
508,BUMA.1121.00035,1,2273250,2288375,+,15125
508,BUMA.1121.00108,1,2100845,2115964,+,15119
508,BUMA.1121.00028,1,1326373,1341526,+,15153
508,BUMA.1121.00094,1,1148125,1163279,+,15154
508,BUMA.1121.00102,1,86727,101993,-,15266
508,BUMA.1121.00111,1,1279280,1294427,+,15147
508,BUMA.1121.00089,1,1116786,1131940,+,15154
508,BUMA.1121.00084,1,1355591,1370699,+,15108
508,BUMA.1121.00029,1,3786692,3801817,-,15125
508,BUMA.1121.00012,1,3939802,3954913,+,15111
508,BUMA.1121.00087,1,1256901,1272048,+,15147
508,BUMA.1121.00043,1,1185140,1200252,+,15112
508,BUMA.1121.00046,1,347995,363143,-,15148
508,BUMA.1121.00037,1,3779346,3794446,+,15100
508,BUMA.1121.00080,1,1146643,1161800,+,15157
508,BUMA.1121.00079,1,1141733,1156916,+,15183
508,BUMA.1121.00045,1,2913739,2928826,-,15087
508,BUMA.1121.00071,1,1102526,1117687,+,15161
508,BUMA.1121.00056,1,2793827,2808983,-,15156
508,BUMA.1121.00065,1,1229467,1244745,+,15278
508,BUMA.1121.00058,1,3422300,3437485,-,15185
508,BUMA.1121.00007,1,2976681,2991800,-,15119
508,BUMA.1121.00067,1,3280080,3295238,-,15158
508,BUMA.1121.00090,1,3284313,3299406,+,15093
508,BUMA.1121.00051,1,1119549,1134704,+,15155
508,BUMA.1121.00020,1,1391263,1406416,+,15153
508,BUMA.1121.00103,1,3284856,3300051,-,15195
508,BUMA.1121.00048,1,2075571,2090717,+,15146
508,BUMA.1121.00047,1,1817179,1832337,-,15158
508,BUMA.1121.00042,1,2790734,2805910,-,15176
508,BUMA.1121.00055,1,697301,712444,+,15143
508,BUMA.1121.00031,1,2562433,2577533,+,15100
508,BUMA.1121.00040,1,1255247,1270394,+,15147
508,BUMA.1121.00044,1,591815,606968,+,15153
508,BUMA.1121.00088,1,2026127,2041239,+,15112
508,BUMA.1121.00069,1,1065811,1080963,+,15152
508,BUMA.1121.00064,1,1135979,1151118,+,15139
508,BUMA.1121.00105,1,75463,90571,-,15108
508,BUMA.1121.00015,1,2311595,2326748,-,15153
508,BUMA.1121.00059,1,338513,353655,+,15142
508,BUMA.1121.00026,1,444909,459912,+,15003
508,BUMA.1121.00022,1,1588588,1603741,+,15153
508,BUMA.1121.00052,1,1103787,1118996,+,15209
508,BUMA.1121.00101,1,1348729,1363925,-,15196
508,BUMA.1121.00001,1,2911183,2926300,-,15117
508,BUMA.1121.00038,1,2282981,2298127,+,15146
508,BUMA.1121.00068,1,3982099,3997284,+,15185
508,BUMA.1121.00099,1,1251232,1266381,-,15149
508,BUMA.1121.00091,1,3410095,3425426,-,15331
508,BUMA.1121.00098,1,3845875,3861036,+,15161
508,BUMA.1121.00013,1,1300049,1315230,+,15181
508,BUMA.1121.00049,1,741116,756255,-,15139
508,BUMA.1121.00072,1,1085336,1100590,+,15254
508,BUMA.1121.00076,1,240124,255252,-,15128
508,BUMA.1121.00083,1,462189,477444,-,15255
508,BUMA.1121.00078,1,816477,831684,-,15207
508,BUMA.1121.00095,1,541646,556859,-,15213
508,BUMA.1121.00077,1,3820589,3835764,+,15175
508,BUMA.1121.00063,1,1109576,1124828,+,15252
508,BUMA.1121.00061,1,1112307,1127530,+,15223
508,BUMA.1121.00050,1,2388724,2403870,+,15146
508,BUMA.1121.00081,1,2283107,2298253,+,15146
508,BUMA.1121.00074,1,2709357,2724498,-,15141
508,BUMA.1121.00062,1,3432366,3447633,-,15267
508,BUMA.1121.00060,1,1139346,1154433,-,15087
508,BUMA.1121.00070,1,1083406,1098650,+,15244
508,BUMA.1121.00075,1,624444,639569,+,15125
508,BUMA.1121.00041,1,2414632,2429777,+,15145
508,BUMA.1121.00073,1,1110341,1125595,+,15254
508,BUMA.1121.00017,1,1261354,1276507,+,15153
508,BUMA.1121.00066,1,1086786,1101942,+,15156
508,BUMA.1121.00107,1,1032259,1047368,+,15109
508,BUMA.1121.00085,1,700622,715831,+,15209
508,BUMA.1121.00030,1,1261394,1276547,+,15153
508,BUMA.1121.00112,1,1915285,1930411,-,15126
508,BUMA.1121.00002,1,2472113,2487267,+,15154
508,BUMA.1121.00082,1,1227376,1242630,+,15254
508,BUMA.1121.00014,1,1639683,1654813,-,15130
508,BUMA.1121.00011,1,466921,482176,-,15255
508,BUMA.1121.00019,1,1326390,1341543,+,15153
508,BUMA.1121.00057,1,2209028,2224268,+,15240
508,BUMA.1121.00018,1,1723593,1738702,+,15109
508,BUMA.1121.00039,1,1263564,1278702,+,15138
508,BUMA.1121.00016,1,3287613,3302730,+,15117
508,BUMA.1121.00004,1,1327549,1342702,+,15153
508,BUMA.1121.00005,1,2451180,2466387,-,15207
508,BUMA.1121.00100,1,165136,180304,-,15168
508,BUMA.1121.00006,1,2282899,2298045,+,15146
509,BUMA.1121.00027,1,3342489,3348328,+,5839
509,BUMA.1121.00025,1,1510493,1516195,-,5702
509,BUMA.1121.00021,1,1786631,1792350,+,5719
509,BUMA.1121.00023,1,3562893,3568544,+,5651
509,BUMA.1121.00024,1,1346443,1352203,+,5760
509,BUMA.1121.00033,1,3372632,3378383,+,5751
509,BUMA.1121.00034,1,1383850,1389594,+,5744
509,BUMA.1121.00036,1,762567,768401,+,5834
509,BUMA.1121.00032,1,2876927,2882663,+,5736
509,BUMA.1121.00009,1,439899,445574,-,5675
509,BUMA.1121.00008,1,1350176,1355960,+,5784
509,BUMA.1121.00003,1,3620604,3626283,+,5679
509,BUMA.1121.00109,1,729979,735960,-,5981
509,BUMA.1121.00053,1,873433,879216,+,5783
509,BUMA.1121.00110,1,3645739,3651497,-,5758
509,BUMA.1121.00104,1,168442,174207,-,5765
509,BUMA.1121.00086,1,2034171,2040010,-,5839
509,BUMA.1121.00092,1,2725048,2730726,-,5678
509,BUMA.1121.00096,1,2132170,2137943,-,5773
509,BUMA.1121.00054,1,1834356,1840051,-,5695
509,BUMA.1121.00097,1,2859655,2865372,-,5717
509,BUMA.1121.00093,1,1895702,1901381,+,5679
509,BUMA.1121.00106,1,890093,895948,+,5855
509,BUMA.1121.00010,1,2469216,2474912,+,5696
509,BUMA.1121.00035,1,2293364,2299091,+,5727
509,BUMA.1121.00108,1,2120897,2126568,+,5671
509,BUMA.1121.00028,1,1346506,1352258,+,5752
509,BUMA.1121.00094,1,1168247,1173998,+,5751
509,BUMA.1121.00102,1,75900,81674,-,5774
509,BUMA.1121.00111,1,1300683,1306370,+,5687
509,BUMA.1121.00089,1,1136922,1142673,+,5751
509,BUMA.1121.00084,1,1375647,1381382,+,5735
509,BUMA.1121.00029,1,3775969,3781703,-,5734
509,BUMA.1121.00012,1,3959881,3965560,+,5679
509,BUMA.1121.00087,1,1277021,1282885,+,5864
509,BUMA.1121.00043,1,1205213,1210972,+,5759
509,BUMA.1121.00046,1,337349,343036,-,5687
509,BUMA.1121.00037,1,3799478,3805213,+,5735
509,BUMA.1121.00080,1,1166832,1172575,+,5743
509,BUMA.1121.00079,1,1161962,1167769,+,5807
509,BUMA.1121.00045,1,2903080,2908750,-,5670
509,BUMA.1121.00071,1,1122600,1128343,+,5743
509,BUMA.1121.00056,1,2783095,2788845,-,5750
509,BUMA.1121.00065,1,1249720,1255446,+,5726
509,BUMA.1121.00058,1,3411506,3417296,-,5790
509,BUMA.1121.00007,1,2965993,2971663,-,5670
509,BUMA.1121.00067,1,3269361,3275062,-,5701
509,BUMA.1121.00090,1,3304325,3309988,+,5663
509,BUMA.1121.00051,1,1139729,1145416,+,5687
509,BUMA.1121.00020,1,1411396,1417172,+,5776
509,BUMA.1121.00103,1,3274213,3279881,-,5668
509,BUMA.1121.00048,1,2095690,2101386,+,5696
509,BUMA.1121.00047,1,1806427,1812161,-,5734
509,BUMA.1121.00042,1,2780009,2785768,-,5759
509,BUMA.1121.00055,1,717496,723231,+,5735
509,BUMA.1121.00031,1,2582494,2588269,+,5775
509,BUMA.1121.00040,1,1275416,1281264,+,5848
509,BUMA.1121.00044,1,611948,617700,+,5752
509,BUMA.1121.00088,1,2046194,2051905,+,5711
509,BUMA.1121.00069,1,1085896,1091639,+,5743
509,BUMA.1121.00064,1,1156093,1161884,+,5791
509,BUMA.1121.00105,1,64726,70459,-,5733
509,BUMA.1121.00015,1,2300831,2306622,-,5791
509,BUMA.1121.00059,1,358651,364394,+,5743
509,BUMA.1121.00026,1,464871,470502,+,5631
509,BUMA.1121.00022,1,1608714,1614650,+,5936
509,BUMA.1121.00052,1,1123969,1129649,+,5680
509,BUMA.1121.00101,1,1338019,1343697,-,5678
509,BUMA.1121.00001,1,2900485,2906187,-,5702
509,BUMA.1121.00038,1,2303100,2308796,+,5696
509,BUMA.1121.00068,1,4002266,4008168,+,5902
509,BUMA.1121.00099,1,1240547,1246225,-,5678
509,BUMA.1121.00091,1,3398083,3403830,-,5747
509,BUMA.1121.00098,1,3866097,3871863,+,5766
509,BUMA.1121.00013,1,1320203,1325883,+,5680
509,BUMA.1121.00049,1,729095,734837,-,5742
509,BUMA.1121.00072,1,1105506,1111249,+,5743
509,BUMA.1121.00076,1,229402,235184,-,5782
509,BUMA.1121.00083,1,451514,457256,-,5742
509,BUMA.1121.00078,1,805844,811522,-,5678
509,BUMA.1121.00095,1,530945,536663,-,5718
509,BUMA.1121.00077,1,3840802,3846577,+,5775
509,BUMA.1121.00063,1,1129761,1135504,+,5743
509,BUMA.1121.00061,1,1132463,1138206,+,5743
509,BUMA.1121.00050,1,2408829,2414517,+,5688
509,BUMA.1121.00081,1,2303226,2308922,+,5696
509,BUMA.1121.00074,1,2698623,2704389,-,5766
509,BUMA.1121.00062,1,3421636,3427370,-,5734
509,BUMA.1121.00060,1,1128687,1134357,-,5670
509,BUMA.1121.00070,1,1103583,1109291,+,5708
509,BUMA.1121.00075,1,644508,650275,+,5767
509,BUMA.1121.00041,1,2434815,2440549,+,5734
509,BUMA.1121.00073,1,1130528,1136271,+,5743
509,BUMA.1121.00017,1,1281487,1287231,+,5744
509,BUMA.1121.00066,1,1106853,1112596,+,5743
509,BUMA.1121.00107,1,1052286,1057965,+,5679
509,BUMA.1121.00085,1,720804,726484,+,5680
509,BUMA.1121.00030,1,1281527,1287279,+,5752
509,BUMA.1121.00112,1,1904496,1910246,-,5750
509,BUMA.1121.00002,1,2492247,2497943,+,5696
509,BUMA.1121.00082,1,1247563,1253306,+,5743
509,BUMA.1121.00014,1,1628841,1634567,-,5726
509,BUMA.1121.00011,1,456304,461974,-,5670
509,BUMA.1121.00019,1,1346523,1352299,+,5776
509,BUMA.1121.00057,1,2230573,2236364,+,5791
509,BUMA.1121.00018,1,1743656,1749351,+,5695
509,BUMA.1121.00039,1,1283705,1289383,+,5678
509,BUMA.1121.00016,1,3307705,3313440,+,5735
509,BUMA.1121.00004,1,1347682,1353466,+,5784
509,BUMA.1121.00005,1,2440474,2446183,-,5709
509,BUMA.1121.00100,1,154505,160175,-,5670
509,BUMA.1121.00006,1,2303018,2308714,+,5696
510,BUMA.1121.00027,1,3348585,3368246,+,19661
510,BUMA.1121.00025,1,1490596,1510236,-,19640
510,BUMA.1121.00021,1,1792607,1812253,+,19646
510,BUMA.1121.00023,1,3568801,3588463,+,19662
510,BUMA.1121.00024,1,1585713,1606731,+,21018
510,BUMA.1121.00033,1,3378640,3398350,+,19710
510,BUMA.1121.00034,1,1623139,1644165,+,21026
510,BUMA.1121.00036,1,2506846,2527858,-,21012
510,BUMA.1121.00032,1,3116209,3137227,+,21018
510,BUMA.1121.00009,1,419963,439642,-,19679
510,BUMA.1121.00008,1,1598789,1619807,+,21018
510,BUMA.1121.00003,1,3626540,3646261,+,19721
510,BUMA.1121.00109,1,710028,729722,-,19694
510,BUMA.1121.00053,1,879473,899153,+,19680
510,BUMA.1121.00110,1,3625781,3645482,-,19701
510,BUMA.1121.00104,1,148481,168185,-,19704
510,BUMA.1121.00086,1,271870,292889,+,21019
510,BUMA.1121.00092,1,2705045,2724791,-,19746
510,BUMA.1121.00096,1,2112251,2131913,-,19662
510,BUMA.1121.00054,1,2091738,2112748,+,21010
510,BUMA.1121.00097,1,2839659,2859398,-,19739
510,BUMA.1121.00093,1,1901638,1921383,+,19745
510,BUMA.1121.00106,1,896205,915909,+,19704
510,BUMA.1121.00010,1,2706737,2727753,+,21016
510,BUMA.1121.00035,1,2299348,2318946,+,19598
510,BUMA.1121.00108,1,2126825,2147840,+,21015
510,BUMA.1121.00028,1,1585762,1606780,+,21018
510,BUMA.1121.00094,1,1174255,1193939,+,19684
510,BUMA.1121.00102,1,55947,75643,-,19696
510,BUMA.1121.00111,1,1306627,1326289,+,19662
510,BUMA.1121.00089,1,1142930,1162590,+,19660
510,BUMA.1121.00084,1,1381639,1401361,+,19722
510,BUMA.1121.00029,1,3756115,3775712,-,19597
510,BUMA.1121.00012,1,3965817,3985589,+,19772
510,BUMA.1121.00087,1,3023693,3044713,-,21020
510,BUMA.1121.00043,1,1211237,1230851,+,19614
510,BUMA.1121.00046,1,84326,105361,-,21035
510,BUMA.1121.00037,1,3805470,3825164,+,19694
510,BUMA.1121.00080,1,1172832,1192588,+,19756
510,BUMA.1121.00079,1,1168026,1187745,+,19719
510,BUMA.1121.00045,1,2883092,2902823,-,19731
510,BUMA.1121.00071,1,1128600,1148298,+,19698
510,BUMA.1121.00056,1,2763177,2782838,-,19661
510,BUMA.1121.00065,1,1255703,1275335,+,19632
510,BUMA.1121.00058,1,3391472,3411249,-,19777
510,BUMA.1121.00007,1,2946038,2965736,-,19698
510,BUMA.1121.00067,1,3249395,3269104,-,19709
510,BUMA.1121.00090,1,3310245,3329934,+,19689
510,BUMA.1121.00051,1,1145673,1165415,+,19742
510,BUMA.1121.00020,1,1650684,1671702,+,21018
510,BUMA.1121.00103,1,3254264,3273956,-,19692
510,BUMA.1121.00048,1,1822986,1843997,-,21011
510,BUMA.1121.00047,1,1786433,1806170,-,19737
510,BUMA.1121.00042,1,2757451,2778521,-,21070
510,BUMA.1121.00055,1,723488,743192,+,19704
510,BUMA.1121.00031,1,2588526,2608156,+,19630
510,BUMA.1121.00040,1,1514646,1535734,+,21088
510,BUMA.1121.00044,1,851237,872263,+,21026
510,BUMA.1121.00088,1,2052162,2071802,+,19640
510,BUMA.1121.00069,1,1091896,1111612,+,19716
510,BUMA.1121.00064,1,1162141,1181886,+,19745
510,BUMA.1121.00105,1,44767,64469,-,19702
510,BUMA.1121.00015,1,995495,1016505,+,21010
510,BUMA.1121.00059,1,364651,384320,+,19669
510,BUMA.1121.00026,1,345965,367046,-,21081
510,BUMA.1121.00022,1,1921245,1942264,+,21019
510,BUMA.1121.00052,1,1385232,1406258,+,21026
510,BUMA.1121.00101,1,1318056,1337762,-,19706
510,BUMA.1121.00001,1,2880629,2900228,-,19599
510,BUMA.1121.00038,1,2030403,2051414,-,21011
510,BUMA.1121.00068,1,4008425,4028152,+,19727
510,BUMA.1121.00099,1,1220591,1240290,-,19699
510,BUMA.1121.00091,1,3378096,3397826,-,19730
510,BUMA.1121.00098,1,3872120,3891813,+,19693
510,BUMA.1121.00013,1,1586053,1607063,+,21010
510,BUMA.1121.00049,1,709124,728838,-,19714
510,BUMA.1121.00072,1,1111506,1131218,+,19712
510,BUMA.1121.00076,1,209441,229145,-,19704
510,BUMA.1121.00083,1,431540,451257,-,19717
510,BUMA.1121.00078,1,785892,805587,-,19695
510,BUMA.1121.00095,1,509594,530688,-,21094
510,BUMA.1121.00077,1,3846834,3866534,+,19700
510,BUMA.1121.00063,1,1135761,1155477,+,19716
510,BUMA.1121.00061,1,1138463,1158178,+,19715
510,BUMA.1121.00050,1,2646448,2667482,+,21034
510,BUMA.1121.00081,1,2030529,2051540,-,21011
510,BUMA.1121.00074,1,2678620,2698366,-,19746
510,BUMA.1121.00062,1,3401614,3421379,-,19765
510,BUMA.1121.00060,1,1108723,1128430,-,19707
510,BUMA.1121.00070,1,1109548,1129264,+,19716
510,BUMA.1121.00075,1,650532,670227,+,19695
510,BUMA.1121.00041,1,2440806,2460471,+,19665
510,BUMA.1121.00073,1,1136528,1156244,+,19716
510,BUMA.1121.00017,1,1520768,1541794,+,21026
510,BUMA.1121.00066,1,1112853,1132569,+,19716
510,BUMA.1121.00107,1,1058222,1077945,+,19723
510,BUMA.1121.00085,1,982122,1003148,+,21026
510,BUMA.1121.00030,1,1520821,1541847,+,21026
510,BUMA.1121.00112,1,1884541,1904239,-,19698
510,BUMA.1121.00002,1,2728986,2750001,+,21015
510,BUMA.1121.00082,1,1253563,1273279,+,19716
510,BUMA.1121.00014,1,1608849,1628584,-,19735
510,BUMA.1121.00011,1,435043,456047,-,21004
510,BUMA.1121.00019,1,1585817,1606835,+,21018
510,BUMA.1121.00057,1,2236621,2256288,+,19667
510,BUMA.1121.00018,1,1749608,1769246,+,19638
510,BUMA.1121.00039,1,1289640,1309286,+,19646
510,BUMA.1121.00016,1,3313697,3334702,+,21005
510,BUMA.1121.00004,1,1586895,1607913,+,21018
510,BUMA.1121.00005,1,2419176,2440217,-,21041
510,BUMA.1121.00100,1,134558,154248,-,19690
510,BUMA.1121.00006,1,2030316,2051327,-,21011
511,BUMA.1121.00027,1,3369910,3376402,+,6492
511,BUMA.1121.00025,1,1482441,1488933,-,6492
511,BUMA.1121.00021,1,1813917,1820409,+,6492
511,BUMA.1121.00023,1,3590127,3596609,+,6482
511,BUMA.1121.00024,1,1608395,1614887,+,6492
511,BUMA.1121.00033,1,3400014,3406505,+,6491
511,BUMA.1121.00034,1,1645829,1652321,+,6492
511,BUMA.1121.00036,1,2498691,2505183,-,6492
511,BUMA.1121.00032,1,3138891,3145383,+,6492
511,BUMA.1121.00009,1,411808,418300,-,6492
511,BUMA.1121.00008,1,1621471,1627963,+,6492
511,BUMA.1121.00003,1,3647925,3654417,+,6492
511,BUMA.1121.00109,1,701873,708365,-,6492
511,BUMA.1121.00053,1,900817,907309,+,6492
511,BUMA.1121.00110,1,3617627,3624119,-,6492
511,BUMA.1121.00104,1,140326,146818,-,6492
511,BUMA.1121.00086,1,294553,301045,+,6492
511,BUMA.1121.00092,1,2696890,2703382,-,6492
511,BUMA.1121.00096,1,2104096,2110588,-,6492
511,BUMA.1121.00054,1,2114412,2120904,+,6492
511,BUMA.1121.00097,1,2831504,2837996,-,6492
511,BUMA.1121.00093,1,1923047,1929539,+,6492
511,BUMA.1121.00106,1,917573,924065,+,6492
511,BUMA.1121.00010,1,2729417,2735909,+,6492
511,BUMA.1121.00035,1,2320610,2327092,+,6482
511,BUMA.1121.00108,1,2149503,2155995,+,6492
511,BUMA.1121.00028,1,1608444,1614936,+,6492
511,BUMA.1121.00094,1,1195602,1202094,+,6492
511,BUMA.1121.00102,1,47792,54284,-,6492
511,BUMA.1121.00111,1,1327953,1334445,+,6492
511,BUMA.1121.00089,1,1164254,1170746,+,6492
511,BUMA.1121.00084,1,1403025,1409517,+,6492
511,BUMA.1121.00029,1,3747971,3754452,-,6481
511,BUMA.1121.00012,1,3987253,3993735,+,6482
511,BUMA.1121.00087,1,3015538,3022030,-,6492
511,BUMA.1121.00043,1,1232515,1238997,+,6482
511,BUMA.1121.00046,1,76171,82663,-,6492
511,BUMA.1121.00037,1,3826828,3834674,+,7846
511,BUMA.1121.00080,1,1194252,1200744,+,6492
511,BUMA.1121.00079,1,1189409,1195901,+,6492
511,BUMA.1121.00045,1,2874938,2881430,-,6492
511,BUMA.1121.00071,1,1149962,1156446,+,6484
511,BUMA.1121.00056,1,2755022,2761514,-,6492
511,BUMA.1121.00065,1,1276999,1283491,+,6492
511,BUMA.1121.00058,1,3383344,3389836,-,6492
511,BUMA.1121.00007,1,2937883,2944375,-,6492
511,BUMA.1121.00067,1,3241240,3247732,-,6492
511,BUMA.1121.00090,1,3331598,3338080,+,6482
511,BUMA.1121.00051,1,1167079,1173571,+,6492
511,BUMA.1121.00020,1,1673366,1679858,+,6492
511,BUMA.1121.00103,1,3246109,3252601,-,6492
511,BUMA.1121.00048,1,1814831,1821323,-,6492
511,BUMA.1121.00047,1,1776921,1784770,-,7849
511,BUMA.1121.00042,1,2749309,2755801,-,6492
511,BUMA.1121.00055,1,744856,751348,+,6492
511,BUMA.1121.00031,1,2609820,2616312,+,6492
511,BUMA.1121.00040,1,1537398,1543890,+,6492
511,BUMA.1121.00044,1,873927,880419,+,6492
511,BUMA.1121.00088,1,2073466,2079958,+,6492
511,BUMA.1121.00069,1,1113276,1119760,+,6484
511,BUMA.1121.00064,1,1183550,1190042,+,6492
511,BUMA.1121.00105,1,36612,43104,-,6492
511,BUMA.1121.00015,1,1018169,1024661,+,6492
511,BUMA.1121.00059,1,385984,392476,+,6492
511,BUMA.1121.00026,1,337823,344315,-,6492
511,BUMA.1121.00022,1,1943928,1950420,+,6492
511,BUMA.1121.00052,1,1407922,1414414,+,6492
511,BUMA.1121.00101,1,1309901,1316393,-,6492
511,BUMA.1121.00001,1,2872484,2878966,-,6482
511,BUMA.1121.00038,1,2022248,2028740,-,6492
511,BUMA.1121.00068,1,4029815,4036308,+,6493
511,BUMA.1121.00099,1,1212436,1218928,-,6492
511,BUMA.1121.00091,1,3369941,3376433,-,6492
511,BUMA.1121.00098,1,3893466,3899958,+,6492
511,BUMA.1121.00013,1,1608727,1615219,+,6492
511,BUMA.1121.00049,1,700970,707462,-,6492
511,BUMA.1121.00072,1,1132882,1139366,+,6484
511,BUMA.1121.00076,1,201286,207778,-,6492
511,BUMA.1121.00083,1,423393,429877,-,6484
511,BUMA.1121.00078,1,777741,784233,-,6492
511,BUMA.1121.00095,1,501439,507931,-,6492
511,BUMA.1121.00077,1,3868198,3874690,+,6492
511,BUMA.1121.00063,1,1157141,1163625,+,6484
511,BUMA.1121.00061,1,1159842,1166326,+,6484
511,BUMA.1121.00050,1,2669146,2675638,+,6492
511,BUMA.1121.00081,1,2022374,2028866,-,6492
511,BUMA.1121.00074,1,2670465,2676957,-,6492
511,BUMA.1121.00062,1,3393459,3399951,-,6492
511,BUMA.1121.00060,1,1100569,1107061,-,6492
511,BUMA.1121.00070,1,1130928,1137412,+,6484
511,BUMA.1121.00075,1,671891,678383,+,6492
511,BUMA.1121.00041,1,2462135,2468627,+,6492
511,BUMA.1121.00073,1,1157908,1164392,+,6484
511,BUMA.1121.00017,1,1543458,1549950,+,6492
511,BUMA.1121.00066,1,1134233,1140717,+,6484
511,BUMA.1121.00107,1,1079609,1086101,+,6492
511,BUMA.1121.00085,1,1004812,1011304,+,6492
511,BUMA.1121.00030,1,1543511,1550003,+,6492
511,BUMA.1121.00112,1,1876386,1882877,-,6491
511,BUMA.1121.00002,1,2751665,2758157,+,6492
511,BUMA.1121.00082,1,1274943,1281427,+,6484
511,BUMA.1121.00014,1,1600694,1607186,-,6492
511,BUMA.1121.00011,1,426893,433380,-,6487
511,BUMA.1121.00019,1,1608499,1614991,+,6492
511,BUMA.1121.00057,1,2257952,2264444,+,6492
511,BUMA.1121.00018,1,1770910,1777402,+,6492
511,BUMA.1121.00039,1,1310950,1318786,+,7836
511,BUMA.1121.00016,1,3336366,3342847,+,6481
511,BUMA.1121.00004,1,1609577,1616069,+,6492
511,BUMA.1121.00005,1,2411024,2417516,-,6492
511,BUMA.1121.00100,1,126403,132895,-,6492
511,BUMA.1121.00006,1,2022161,2028653,-,6492
512,BUMA.1121.00027,1,3377553,3384403,+,6850
512,BUMA.1121.00025,1,1474501,1481331,-,6830
512,BUMA.1121.00021,1,1821524,1828354,+,6830
512,BUMA.1121.00023,1,3597712,3604534,+,6822
512,BUMA.1121.00024,1,1616038,1622549,+,6511
512,BUMA.1121.00033,1,3407644,3414484,+,6840
512,BUMA.1121.00034,1,1653472,1659983,+,6511
512,BUMA.1121.00036,1,2490986,2497497,-,6511
512,BUMA.1121.00032,1,3146546,3153057,+,6511
512,BUMA.1121.00009,1,403952,410716,-,6764
512,BUMA.1121.00008,1,1629114,1635642,+,6528
512,BUMA.1121.00003,1,3655520,3662359,+,6839
512,BUMA.1121.00109,1,693852,700787,-,6935
512,BUMA.1121.00053,1,908430,915320,+,6890
512,BUMA.1121.00110,1,3609557,3616529,-,6972
512,BUMA.1121.00104,1,132308,139198,-,6890
512,BUMA.1121.00086,1,302202,308713,+,6511
512,BUMA.1121.00092,1,2689124,2695798,-,6674
512,BUMA.1121.00096,1,2096144,2102998,-,6854
512,BUMA.1121.00054,1,2122073,2128584,+,6511
512,BUMA.1121.00097,1,2823556,2830406,-,6850
512,BUMA.1121.00093,1,1930630,1937304,+,6674
512,BUMA.1121.00106,1,925186,932073,+,6887
512,BUMA.1121.00010,1,2737072,2743583,+,6511
512,BUMA.1121.00035,1,2328213,2335043,+,6830
512,BUMA.1121.00108,1,2158442,2165278,+,6836
512,BUMA.1121.00028,1,1616087,1622598,+,6511
512,BUMA.1121.00094,1,1203203,1210084,+,6881
512,BUMA.1121.00102,1,39771,46634,-,6863
512,BUMA.1121.00111,1,1335554,1342384,+,6830
512,BUMA.1121.00089,1,1171861,1178742,+,6881
512,BUMA.1121.00084,1,1410626,1417507,+,6881
512,BUMA.1121.00029,1,3740027,3746867,-,6840
512,BUMA.1121.00012,1,3994850,4001680,+,6830
512,BUMA.1121.00087,1,3007869,3014380,-,6511
512,BUMA.1121.00043,1,1240118,1246735,+,6617
512,BUMA.1121.00046,1,68508,75019,-,6511
512,BUMA.1121.00037,1,3835789,3842619,+,6830
512,BUMA.1121.00080,1,1201835,1208682,+,6847
512,BUMA.1121.00079,1,1196992,1203835,+,6843
512,BUMA.1121.00045,1,2866920,2873846,-,6926
512,BUMA.1121.00071,1,1157609,1164253,+,6644
512,BUMA.1121.00056,1,2747024,2753906,-,6882
512,BUMA.1121.00065,1,1284642,1291304,+,6662
512,BUMA.1121.00058,1,3375571,3382258,-,6687
512,BUMA.1121.00007,1,2929873,2936725,-,6852
512,BUMA.1121.00067,1,3233217,3240142,-,6925
512,BUMA.1121.00090,1,3339189,3346019,+,6830
512,BUMA.1121.00051,1,1174686,1181529,+,6843
512,BUMA.1121.00020,1,1681009,1687520,+,6511
512,BUMA.1121.00103,1,3238059,3245029,-,6970
512,BUMA.1121.00048,1,1807150,1813661,-,6511
512,BUMA.1121.00047,1,1768982,1775829,-,6847
512,BUMA.1121.00042,1,2741700,2748151,-,6451
512,BUMA.1121.00055,1,752445,759283,+,6838
512,BUMA.1121.00031,1,2617427,2624257,+,6830
512,BUMA.1121.00040,1,1545029,1551540,+,6511
512,BUMA.1121.00044,1,881570,888081,+,6511
512,BUMA.1121.00088,1,2081067,2087948,+,6881
512,BUMA.1121.00069,1,1120923,1127410,+,6487
512,BUMA.1121.00064,1,1191127,1197978,+,6851
512,BUMA.1121.00105,1,28633,35514,-,6881
512,BUMA.1121.00015,1,1025818,1032329,+,6511
512,BUMA.1121.00059,1,393585,400375,+,6790
512,BUMA.1121.00026,1,330169,336671,-,6502
512,BUMA.1121.00022,1,1951625,1958136,+,6511
512,BUMA.1121.00052,1,1415595,1422106,+,6511
512,BUMA.1121.00101,1,1302046,1308828,-,6782
512,BUMA.1121.00001,1,2864606,2871368,-,6762
512,BUMA.1121.00038,1,2014567,2021078,-,6511
512,BUMA.1121.00068,1,4037393,4044257,+,6864
512,BUMA.1121.00099,1,1204482,1211332,-,6850
512,BUMA.1121.00091,1,3361871,3368816,-,6945
512,BUMA.1121.00098,1,3901049,3907898,+,6849
512,BUMA.1121.00013,1,1616406,1622916,+,6510
512,BUMA.1121.00049,1,692911,699836,-,6925
512,BUMA.1121.00072,1,1140521,1147008,+,6487
512,BUMA.1121.00076,1,193520,200188,-,6668
512,BUMA.1121.00083,1,415384,422235,-,6851
512,BUMA.1121.00078,1,769727,776607,-,6880
512,BUMA.1121.00095,1,493493,500353,-,6860
512,BUMA.1121.00077,1,3875787,3882760,+,6973
512,BUMA.1121.00063,1,1164788,1171277,+,6489
512,BUMA.1121.00061,1,1167489,1174130,+,6641
512,BUMA.1121.00050,1,2676789,2683300,+,6511
512,BUMA.1121.00081,1,2014693,2021204,-,6511
512,BUMA.1121.00074,1,2662516,2669367,-,6851
512,BUMA.1121.00062,1,3385468,3392319,-,6851
512,BUMA.1121.00060,1,1092551,1099477,-,6926
512,BUMA.1121.00070,1,1138575,1145146,+,6571
512,BUMA.1121.00075,1,679474,686136,+,6662
512,BUMA.1121.00041,1,2469754,2476634,+,6880
512,BUMA.1121.00073,1,1165555,1172313,+,6758
512,BUMA.1121.00017,1,1551101,1557612,+,6511
512,BUMA.1121.00066,1,1141880,1148319,+,6439
512,BUMA.1121.00107,1,1087180,1094029,+,6849
512,BUMA.1121.00085,1,1012485,1018996,+,6511
512,BUMA.1121.00030,1,1551154,1557665,+,6511
512,BUMA.1121.00112,1,1868386,1875300,-,6914
512,BUMA.1121.00002,1,2759320,2765831,+,6511
512,BUMA.1121.00082,1,1282590,1289441,+,6851
512,BUMA.1121.00014,1,1592748,1599578,-,6830
512,BUMA.1121.00011,1,418941,425801,-,6860
512,BUMA.1121.00019,1,1616142,1622653,+,6511
512,BUMA.1121.00057,1,2265589,2272440,+,6851
512,BUMA.1121.00018,1,1778511,1785341,+,6830
512,BUMA.1121.00039,1,1319913,1326743,+,6830
512,BUMA.1121.00016,1,3343992,3350834,+,6842
512,BUMA.1121.00004,1,1617226,1623736,+,6510
512,BUMA.1121.00005,1,2403310,2409854,-,6544
512,BUMA.1121.00100,1,118391,125251,-,6860
512,BUMA.1121.00006,1,2014480,2020991,-,6511
513,BUMA.1121.00027,1,3386196,3393979,+,7783
513,BUMA.1121.00025,1,1464965,1472769,-,7804
513,BUMA.1121.00021,1,1830097,1837900,+,7803
513,BUMA.1121.00023,1,3606257,3614060,+,7803
513,BUMA.1121.00024,1,1624252,1632069,+,7817
513,BUMA.1121.00033,1,3416217,3424028,+,7811
513,BUMA.1121.00034,1,1661686,1669503,+,7817
513,BUMA.1121.00036,1,2481458,2489284,-,7826
513,BUMA.1121.00032,1,3154760,3162585,+,7825
513,BUMA.1121.00009,1,394499,402266,-,7767
513,BUMA.1121.00008,1,1637345,1645162,+,7817
513,BUMA.1121.00003,1,3664082,3671843,+,7761
513,BUMA.1121.00109,1,684312,692127,-,7815
513,BUMA.1121.00053,1,917063,924866,+,7803
513,BUMA.1121.00110,1,3600045,3607832,-,7787
513,BUMA.1121.00104,1,122748,130576,-,7828
513,BUMA.1121.00086,1,310416,318249,+,7833
513,BUMA.1121.00092,1,2679592,2687412,-,7820
513,BUMA.1121.00096,1,2086651,2094419,-,7768
513,BUMA.1121.00054,1,2130287,2138120,+,7833
513,BUMA.1121.00097,1,2814002,2821841,-,7839
513,BUMA.1121.00093,1,1939017,1946836,+,7819
513,BUMA.1121.00106,1,933806,941633,+,7827
513,BUMA.1121.00010,1,2745286,2753111,+,7825
513,BUMA.1121.00035,1,2336766,2344569,+,7803
513,BUMA.1121.00108,1,2167001,2174802,+,7801
513,BUMA.1121.00028,1,1624301,1632118,+,7817
513,BUMA.1121.00094,1,1211817,1219628,+,7811
513,BUMA.1121.00102,1,30274,38069,-,7795
513,BUMA.1121.00111,1,1344106,1351908,+,7802
513,BUMA.1121.00089,1,1180475,1188296,+,7821
513,BUMA.1121.00084,1,1419220,1427045,+,7825
513,BUMA.1121.00029,1,3730493,3738305,-,7812
513,BUMA.1121.00012,1,4003403,4011182,+,7779
513,BUMA.1121.00087,1,2998333,3006167,-,7834
513,BUMA.1121.00043,1,1248458,1256262,+,7804
513,BUMA.1121.00046,1,58972,66806,-,7834
513,BUMA.1121.00037,1,3844332,3852145,+,7813
513,BUMA.1121.00080,1,1210415,1218192,+,7777
513,BUMA.1121.00079,1,1205568,1213344,+,7776
513,BUMA.1121.00045,1,2857405,2865188,-,7783
513,BUMA.1121.00071,1,1165988,1173780,+,7792
513,BUMA.1121.00056,1,2737470,2745292,-,7822
513,BUMA.1121.00065,1,1293027,1300845,+,7818
513,BUMA.1121.00058,1,3366018,3373879,-,7861
513,BUMA.1121.00007,1,2920390,2928161,-,7771
513,BUMA.1121.00067,1,3223690,3231485,-,7795
513,BUMA.1121.00090,1,3347762,3355557,+,7795
513,BUMA.1121.00051,1,1183260,1191054,+,7794
513,BUMA.1121.00020,1,1689223,1697040,+,7817
513,BUMA.1121.00103,1,3228581,3236405,-,7824
513,BUMA.1121.00048,1,1797614,1805448,-,7834
513,BUMA.1121.00047,1,1759449,1767250,-,7801
513,BUMA.1121.00042,1,2732146,2739988,-,7842
513,BUMA.1121.00055,1,761016,768842,+,7826
513,BUMA.1121.00031,1,2626000,2633795,+,7795
513,BUMA.1121.00040,1,1553233,1561042,+,7809
513,BUMA.1121.00044,1,889784,897601,+,7817
513,BUMA.1121.00088,1,2089681,2097482,+,7801
513,BUMA.1121.00069,1,1129146,1136938,+,7792
513,BUMA.1121.00064,1,1199711,1207530,+,7819
513,BUMA.1121.00105,1,19087,26891,-,7804
513,BUMA.1121.00015,1,1034032,1041865,+,7833
513,BUMA.1121.00059,1,402108,409887,+,7779
513,BUMA.1121.00026,1,320631,328457,-,7826
513,BUMA.1121.00022,1,1959839,1967664,+,7825
513,BUMA.1121.00052,1,1423819,1431644,+,7825
513,BUMA.1121.00101,1,1292540,1300321,-,7781
513,BUMA.1121.00001,1,2855080,2862884,-,7804
513,BUMA.1121.00038,1,2005031,2012865,-,7834
513,BUMA.1121.00068,1,4045935,4053757,+,7822
513,BUMA.1121.00099,1,1194983,1202770,-,7787
513,BUMA.1121.00091,1,3352417,3360159,-,7742
513,BUMA.1121.00098,1,3909611,3917397,+,7786
513,BUMA.1121.00013,1,1624629,1632454,+,7825
513,BUMA.1121.00049,1,683420,691199,-,7779
513,BUMA.1121.00072,1,1148725,1156517,+,7792
513,BUMA.1121.00076,1,183964,191768,-,7804
513,BUMA.1121.00083,1,405819,413612,-,7793
513,BUMA.1121.00078,1,760208,768015,-,7807
513,BUMA.1121.00095,1,484090,491831,-,7741
513,BUMA.1121.00077,1,3884486,3892273,+,7787
513,BUMA.1121.00063,1,1173050,1180842,+,7792
513,BUMA.1121.00061,1,1175876,1183668,+,7792
513,BUMA.1121.00050,1,2685003,2692836,+,7833
513,BUMA.1121.00081,1,2005157,2012991,-,7834
513,BUMA.1121.00074,1,2652954,2660774,-,7820
513,BUMA.1121.00062,1,3375936,3383746,-,7810
513,BUMA.1121.00060,1,1083036,1090819,-,7783
513,BUMA.1121.00070,1,1146872,1154664,+,7792
513,BUMA.1121.00075,1,687889,695692,+,7803
513,BUMA.1121.00041,1,2478347,2486141,+,7794
513,BUMA.1121.00073,1,1174060,1181852,+,7792
513,BUMA.1121.00017,1,1559315,1567132,+,7817
513,BUMA.1121.00066,1,1150073,1157865,+,7792
513,BUMA.1121.00107,1,1095755,1103561,+,7806
513,BUMA.1121.00085,1,1020709,1028534,+,7825
513,BUMA.1121.00030,1,1559368,1567185,+,7817
513,BUMA.1121.00112,1,1858906,1866671,-,7765
513,BUMA.1121.00002,1,2767534,2775359,+,7825
513,BUMA.1121.00082,1,1291214,1299006,+,7792
513,BUMA.1121.00014,1,1583210,1591006,-,7796
513,BUMA.1121.00011,1,408200,415992,-,7792
513,BUMA.1121.00019,1,1624356,1632173,+,7817
513,BUMA.1121.00057,1,2274233,2282017,+,7784
513,BUMA.1121.00018,1,1787074,1794877,+,7803
513,BUMA.1121.00039,1,1328456,1336260,+,7804
513,BUMA.1121.00016,1,3352557,3360361,+,7804
513,BUMA.1121.00004,1,1625439,1633256,+,7817
513,BUMA.1121.00005,1,2393786,2401602,-,7816
513,BUMA.1121.00100,1,108809,116676,-,7867
513,BUMA.1121.00006,1,2004944,2012778,-,7834
514,BUMA.1121.00027,1,3397198,3403939,+,6741
514,BUMA.1121.00025,1,1455003,1461747,-,6744
514,BUMA.1121.00021,1,1841119,1847863,+,6744
514,BUMA.1121.00023,1,3617279,3624022,+,6743
514,BUMA.1121.00024,1,1635288,1642031,+,6743
514,BUMA.1121.00033,1,3427247,3433990,+,6743
514,BUMA.1121.00034,1,1672722,1679465,+,6743
514,BUMA.1121.00036,1,2471496,2478240,-,6744
514,BUMA.1121.00032,1,3165804,3172547,+,6743
514,BUMA.1121.00009,1,384531,391281,-,6750
514,BUMA.1121.00008,1,1648381,1655124,+,6743
514,BUMA.1121.00003,1,3675069,3681811,+,6742
514,BUMA.1121.00109,1,674345,681094,-,6749
514,BUMA.1121.00053,1,928085,934827,+,6742
514,BUMA.1121.00110,1,3590084,3596819,-,6735
514,BUMA.1121.00104,1,112786,119530,-,6744
514,BUMA.1121.00086,1,321468,328211,+,6743
514,BUMA.1121.00092,1,2669630,2676374,-,6744
514,BUMA.1121.00096,1,2076689,2083433,-,6744
514,BUMA.1121.00054,1,2141339,2148082,+,6743
514,BUMA.1121.00097,1,2804041,2810784,-,6743
514,BUMA.1121.00093,1,1950055,1956798,+,6743
514,BUMA.1121.00106,1,944852,951595,+,6743
514,BUMA.1121.00010,1,2756330,2763073,+,6743
514,BUMA.1121.00035,1,2347788,2354530,+,6742
514,BUMA.1121.00108,1,2178021,2184775,+,6754
514,BUMA.1121.00028,1,1635337,1642080,+,6743
514,BUMA.1121.00094,1,1222847,1229590,+,6743
514,BUMA.1121.00102,1,20312,27056,-,6744
514,BUMA.1121.00111,1,1355127,1361870,+,6743
514,BUMA.1121.00089,1,1191515,1198258,+,6743
514,BUMA.1121.00084,1,1430264,1437007,+,6743
514,BUMA.1121.00029,1,3720532,3727275,-,6743
514,BUMA.1121.00012,1,4014401,4021144,+,6743
514,BUMA.1121.00087,1,2988371,2995115,-,6744
514,BUMA.1121.00043,1,1259481,1266224,+,6743
514,BUMA.1121.00046,1,49010,55754,-,6744
514,BUMA.1121.00037,1,3855364,3862107,+,6743
514,BUMA.1121.00080,1,1221418,1228154,+,6736
514,BUMA.1121.00079,1,1216570,1223306,+,6736
514,BUMA.1121.00045,1,2847443,2854187,-,6744
514,BUMA.1121.00071,1,1176999,1183740,+,6741
514,BUMA.1121.00056,1,2727508,2734252,-,6744
514,BUMA.1121.00065,1,1304064,1310807,+,6743
514,BUMA.1121.00058,1,3356056,3362800,-,6744
514,BUMA.1121.00007,1,2910428,2917164,-,6736
514,BUMA.1121.00067,1,3213728,3220464,-,6736
514,BUMA.1121.00090,1,3358776,3365519,+,6743
514,BUMA.1121.00051,1,1194280,1201016,+,6736
514,BUMA.1121.00020,1,1700259,1707002,+,6743
514,BUMA.1121.00103,1,3218620,3225363,-,6743
514,BUMA.1121.00048,1,1787652,1794396,-,6744
514,BUMA.1121.00047,1,1749487,1756231,-,6744
514,BUMA.1121.00042,1,2722184,2728928,-,6744
514,BUMA.1121.00055,1,772061,778802,+,6741
514,BUMA.1121.00031,1,2637014,2643757,+,6743
514,BUMA.1121.00040,1,1564261,1571004,+,6743
514,BUMA.1121.00044,1,900820,907563,+,6743
514,BUMA.1121.00088,1,2100701,2107444,+,6743
514,BUMA.1121.00069,1,1140157,1146898,+,6741
514,BUMA.1121.00064,1,1210749,1217492,+,6743
514,BUMA.1121.00105,1,9125,15865,-,6740
514,BUMA.1121.00015,1,1045084,1051827,+,6743
514,BUMA.1121.00059,1,413106,419849,+,6743
514,BUMA.1121.00026,1,310669,317413,-,6744
514,BUMA.1121.00022,1,1970883,1977626,+,6743
514,BUMA.1121.00052,1,1434863,1441606,+,6743
514,BUMA.1121.00101,1,1282578,1289322,-,6744
514,BUMA.1121.00001,1,2845119,2851862,-,6743
514,BUMA.1121.00038,1,1995069,2001813,-,6744
514,BUMA.1121.00068,1,4056976,4063719,+,6743
514,BUMA.1121.00099,1,1185015,1191765,-,6750
514,BUMA.1121.00091,1,3342455,3349199,-,6744
514,BUMA.1121.00098,1,3920623,3927359,+,6736
514,BUMA.1121.00013,1,1635673,1642416,+,6743
514,BUMA.1121.00049,1,673459,680202,-,6743
514,BUMA.1121.00072,1,1159736,1166477,+,6741
514,BUMA.1121.00076,1,174003,180746,-,6743
514,BUMA.1121.00083,1,395859,402601,-,6742
514,BUMA.1121.00078,1,750246,756990,-,6744
514,BUMA.1121.00095,1,474141,480885,-,6744
514,BUMA.1121.00077,1,3895499,3902234,+,6735
514,BUMA.1121.00063,1,1184061,1190802,+,6741
514,BUMA.1121.00061,1,1186887,1193628,+,6741
514,BUMA.1121.00050,1,2696055,2702798,+,6743
514,BUMA.1121.00081,1,1995195,2001939,-,6744
514,BUMA.1121.00074,1,2642992,2649736,-,6744
514,BUMA.1121.00062,1,3365975,3372718,-,6743
514,BUMA.1121.00060,1,1073065,1079818,-,6753
514,BUMA.1121.00070,1,1157883,1164624,+,6741
514,BUMA.1121.00075,1,698911,705653,+,6742
514,BUMA.1121.00041,1,2489360,2496103,+,6743
514,BUMA.1121.00073,1,1185071,1191812,+,6741
514,BUMA.1121.00017,1,1570351,1577094,+,6743
514,BUMA.1121.00066,1,1161084,1167825,+,6741
514,BUMA.1121.00107,1,1106780,1113522,+,6742
514,BUMA.1121.00085,1,1031753,1038496,+,6743
514,BUMA.1121.00030,1,1570404,1577147,+,6743
514,BUMA.1121.00112,1,1848945,1855684,-,6739
514,BUMA.1121.00002,1,2778578,2785321,+,6743
514,BUMA.1121.00082,1,1302225,1308966,+,6741
514,BUMA.1121.00014,1,1573248,1579992,-,6744
514,BUMA.1121.00011,1,398238,404974,-,6736
514,BUMA.1121.00019,1,1635392,1642135,+,6743
514,BUMA.1121.00057,1,2285236,2291977,+,6741
514,BUMA.1121.00018,1,1798096,1804839,+,6743
514,BUMA.1121.00039,1,1339479,1346222,+,6743
514,BUMA.1121.00016,1,3363580,3370322,+,6742
514,BUMA.1121.00004,1,1636475,1643218,+,6743
514,BUMA.1121.00005,1,2383825,2390568,-,6743
514,BUMA.1121.00006,1,1994982,2001726,-,6744
515,BUMA.1121.00027,1,3403941,3412869,+,8928
515,BUMA.1121.00025,1,1446085,1455002,-,8917
515,BUMA.1121.00021,1,1847865,1856806,+,8941
515,BUMA.1121.00023,1,3624024,3632945,+,8921
515,BUMA.1121.00024,1,1642033,1650909,+,8876
515,BUMA.1121.00033,1,3433992,3442913,+,8921
515,BUMA.1121.00034,1,1679467,1688343,+,8876
515,BUMA.1121.00036,1,2462619,2471495,-,8876
515,BUMA.1121.00032,1,3172549,3181425,+,8876
515,BUMA.1121.00009,1,375627,384530,-,8903
515,BUMA.1121.00008,1,1655126,1664002,+,8876
515,BUMA.1121.00003,1,3681813,3690771,+,8958
515,BUMA.1121.00109,1,665413,674344,-,8931
515,BUMA.1121.00053,1,934829,943748,+,8919
515,BUMA.1121.00110,1,3580977,3590083,-,9106
515,BUMA.1121.00104,1,103897,112785,-,8888
515,BUMA.1121.00086,1,328213,337089,+,8876
515,BUMA.1121.00092,1,2660739,2669629,-,8890
515,BUMA.1121.00096,1,2067720,2076688,-,8968
515,BUMA.1121.00054,1,2148084,2156960,+,8876
515,BUMA.1121.00097,1,2795057,2804040,-,8983
515,BUMA.1121.00093,1,1956800,1965683,+,8883
515,BUMA.1121.00106,1,951597,960543,+,8946
515,BUMA.1121.00010,1,2763075,2771951,+,8876
515,BUMA.1121.00035,1,2354532,2363480,+,8948
515,BUMA.1121.00108,1,2184777,2193777,+,9000
515,BUMA.1121.00028,1,1642082,1650958,+,8876
515,BUMA.1121.00094,1,1229592,1238498,+,8906
515,BUMA.1121.00102,1,11439,20311,-,8872
515,BUMA.1121.00111,1,1361872,1370802,+,8930
515,BUMA.1121.00089,1,1198260,1207166,+,8906
515,BUMA.1121.00084,1,1437009,1445923,+,8914
515,BUMA.1121.00029,1,3711608,3720531,-,8923
515,BUMA.1121.00012,1,4021146,4030096,+,8950
515,BUMA.1121.00087,1,2979494,2988370,-,8876
515,BUMA.1121.00043,1,1266226,1275124,+,8898
515,BUMA.1121.00046,1,40133,49009,-,8876
515,BUMA.1121.00037,1,3862109,3871056,+,8947
515,BUMA.1121.00080,1,1228156,1237125,+,8969
515,BUMA.1121.00079,1,1223308,1232201,+,8893
515,BUMA.1121.00045,1,2838465,2847442,-,8977
515,BUMA.1121.00071,1,1183742,1192666,+,8924
515,BUMA.1121.00056,1,2718589,2727507,-,8918
515,BUMA.1121.00065,1,1310809,1319719,+,8910
515,BUMA.1121.00058,1,3347143,3356055,-,8912
515,BUMA.1121.00007,1,2901473,2910427,-,8954
515,BUMA.1121.00067,1,3204760,3213727,-,8967
515,BUMA.1121.00090,1,3365521,3374442,+,8921
515,BUMA.1121.00051,1,1201018,1209966,+,8948
515,BUMA.1121.00020,1,1707004,1715880,+,8876
515,BUMA.1121.00103,1,3209705,3218619,-,8914
515,BUMA.1121.00048,1,1778775,1787651,-,8876
515,BUMA.1121.00047,1,1740532,1749486,-,8954
515,BUMA.1121.00042,1,2713306,2722183,-,8877
515,BUMA.1121.00055,1,778804,787740,+,8936
515,BUMA.1121.00031,1,2643759,2652657,+,8898
515,BUMA.1121.00040,1,1571006,1579890,+,8884
515,BUMA.1121.00044,1,907565,916441,+,8876
515,BUMA.1121.00088,1,2107446,2116366,+,8920
515,BUMA.1121.00069,1,1146900,1155822,+,8922
515,BUMA.1121.00064,1,1217494,1226435,+,8941
515,BUMA.1121.00105,1,170,9124,-,8954
515,BUMA.1121.00015,1,1051829,1060714,+,8885
515,BUMA.1121.00059,1,419851,428787,+,8936
515,BUMA.1121.00026,1,301791,310668,-,8877
515,BUMA.1121.00022,1,1977628,1986504,+,8876
515,BUMA.1121.00052,1,1441608,1450484,+,8876
515,BUMA.1121.00101,1,1273586,1282577,-,8991
515,BUMA.1121.00001,1,2836206,2845118,-,8912
515,BUMA.1121.00038,1,1986192,1995068,-,8876
515,BUMA.1121.00068,1,4063721,4072585,+,8864
515,BUMA.1121.00099,1,1176084,1185014,-,8930
515,BUMA.1121.00091,1,3333507,3342454,-,8947
515,BUMA.1121.00098,1,3927361,3936278,+,8917
515,BUMA.1121.00013,1,1642418,1651294,+,8876
515,BUMA.1121.00049,1,664522,673458,-,8936
515,BUMA.1121.00072,1,1166479,1175410,+,8931
515,BUMA.1121.00076,1,165058,174002,-,8944
515,BUMA.1121.00083,1,386915,395858,-,8943
515,BUMA.1121.00078,1,741234,750245,-,9011
515,BUMA.1121.00095,1,465196,474140,-,8944
515,BUMA.1121.00077,1,3902236,3911330,+,9094
515,BUMA.1121.00063,1,1190804,1199721,+,8917
515,BUMA.1121.00061,1,1193630,1202554,+,8924
515,BUMA.1121.00050,1,2702800,2711676,+,8876
515,BUMA.1121.00081,1,1986318,1995194,-,8876
515,BUMA.1121.00074,1,2634023,2642991,-,8968
515,BUMA.1121.00062,1,3357038,3365974,-,8936
515,BUMA.1121.00060,1,1064087,1073064,-,8977
515,BUMA.1121.00070,1,1164626,1173550,+,8924
515,BUMA.1121.00075,1,705655,714587,+,8932
515,BUMA.1121.00041,1,2496105,2504885,+,8780
515,BUMA.1121.00073,1,1191814,1200745,+,8931
515,BUMA.1121.00017,1,1577096,1585972,+,8876
515,BUMA.1121.00066,1,1167827,1176743,+,8916
515,BUMA.1121.00107,1,1113524,1122453,+,8929
515,BUMA.1121.00085,1,1038498,1047374,+,8876
515,BUMA.1121.00030,1,1577149,1586025,+,8876
515,BUMA.1121.00112,1,1840038,1848944,-,8906
515,BUMA.1121.00002,1,2785323,2794199,+,8876
515,BUMA.1121.00082,1,1308968,1317899,+,8931
515,BUMA.1121.00014,1,1564340,1573247,-,8907
515,BUMA.1121.00011,1,389299,398237,-,8938
515,BUMA.1121.00019,1,1642137,1651013,+,8876
515,BUMA.1121.00057,1,2291979,2300901,+,8922
515,BUMA.1121.00018,1,1804841,1813758,+,8917
515,BUMA.1121.00039,1,1346224,1355181,+,8957
515,BUMA.1121.00016,1,3370324,3379230,+,8906
515,BUMA.1121.00004,1,1643220,1652096,+,8876
515,BUMA.1121.00005,1,2374943,2383824,-,8881
515,BUMA.1121.00100,1,91095,100089,-,8994
515,BUMA.1121.00006,1,1986105,1994981,-,8876
516,BUMA.1121.00027,1,3412997,3417049,+,4052
516,BUMA.1121.00025,1,1441945,1445969,-,4024
516,BUMA.1121.00021,1,1856922,1861016,+,4094
516,BUMA.1121.00023,1,3633061,3637105,+,4044
516,BUMA.1121.00024,1,1651029,1655081,+,4052
516,BUMA.1121.00033,1,3443029,3447081,+,4052
516,BUMA.1121.00034,1,1688463,1692515,+,4052
516,BUMA.1121.00036,1,2458447,2462499,-,4052
516,BUMA.1121.00032,1,3181545,3185597,+,4052
516,BUMA.1121.00009,1,371471,375511,-,4040
516,BUMA.1121.00008,1,1664122,1668174,+,4052
516,BUMA.1121.00003,1,3690887,3694939,+,4052
516,BUMA.1121.00109,1,661245,665297,-,4052
516,BUMA.1121.00053,1,943864,947916,+,4052
516,BUMA.1121.00110,1,3576809,3580861,-,4052
516,BUMA.1121.00104,1,99729,103781,-,4052
516,BUMA.1121.00086,1,337209,341261,+,4052
516,BUMA.1121.00092,1,2656571,2660623,-,4052
516,BUMA.1121.00096,1,2063552,2067604,-,4052
516,BUMA.1121.00054,1,2157080,2161132,+,4052
516,BUMA.1121.00097,1,2790933,2794941,-,4008
516,BUMA.1121.00093,1,1965799,1969851,+,4052
516,BUMA.1121.00106,1,960659,964711,+,4052
516,BUMA.1121.00010,1,2772071,2776123,+,4052
516,BUMA.1121.00035,1,2363596,2367648,+,4052
516,BUMA.1121.00108,1,2193893,2197945,+,4052
516,BUMA.1121.00028,1,1651078,1655130,+,4052
516,BUMA.1121.00094,1,1238626,1242678,+,4052
516,BUMA.1121.00102,1,7271,11323,-,4052
516,BUMA.1121.00111,1,1370918,1374991,+,4073
516,BUMA.1121.00089,1,1207294,1211346,+,4052
516,BUMA.1121.00084,1,1446039,1450091,+,4052
516,BUMA.1121.00029,1,3707440,3711492,-,4052
516,BUMA.1121.00012,1,4030212,4034235,+,4023
516,BUMA.1121.00087,1,2975322,2979374,-,4052
516,BUMA.1121.00043,1,1275240,1279284,+,4044
516,BUMA.1121.00046,1,35961,40013,-,4052
516,BUMA.1121.00037,1,3871172,3875224,+,4052
516,BUMA.1121.00080,1,1237253,1241305,+,4052
516,BUMA.1121.00079,1,1232329,1236381,+,4052
516,BUMA.1121.00045,1,2834297,2838349,-,4052
516,BUMA.1121.00071,1,1192794,1196846,+,4052
516,BUMA.1121.00056,1,2714421,2718473,-,4052
516,BUMA.1121.00065,1,1319835,1323887,+,4052
516,BUMA.1121.00058,1,3342975,3347027,-,4052
516,BUMA.1121.00007,1,2897326,2901357,-,4031
516,BUMA.1121.00067,1,3200592,3204644,-,4052
516,BUMA.1121.00090,1,3374558,3378631,+,4073
516,BUMA.1121.00051,1,1210094,1214146,+,4052
516,BUMA.1121.00020,1,1716000,1720052,+,4052
516,BUMA.1121.00103,1,3205558,3209589,-,4031
516,BUMA.1121.00048,1,1774603,1778655,-,4052
516,BUMA.1121.00047,1,1736364,1740416,-,4052
516,BUMA.1121.00042,1,2709134,2713186,-,4052
516,BUMA.1121.00055,1,787856,791908,+,4052
516,BUMA.1121.00031,1,2652773,2656825,+,4052
516,BUMA.1121.00040,1,1580010,1584062,+,4052
516,BUMA.1121.00044,1,916561,920613,+,4052
516,BUMA.1121.00088,1,2116494,2120546,+,4052
516,BUMA.1121.00069,1,1155938,1159990,+,4052
516,BUMA.1121.00064,1,1226551,1230603,+,4052
516,BUMA.1121.00105,1,4013694,4017692,-,3998
516,BUMA.1121.00015,1,1060834,1064886,+,4052
516,BUMA.1121.00059,1,428903,432955,+,4052
516,BUMA.1121.00026,1,297619,301671,-,4052
516,BUMA.1121.00022,1,1986624,1990676,+,4052
516,BUMA.1121.00052,1,1450604,1454656,+,4052
516,BUMA.1121.00101,1,1269418,1273470,-,4052
516,BUMA.1121.00001,1,2832038,2836090,-,4052
516,BUMA.1121.00038,1,1982020,1986072,-,4052
516,BUMA.1121.00068,1,4072713,4076765,+,4052
516,BUMA.1121.00099,1,1171916,1175968,-,4052
516,BUMA.1121.00091,1,3329339,3333391,-,4052
516,BUMA.1121.00098,1,3936394,3940446,+,4052
516,BUMA.1121.00013,1,1651414,1655466,+,4052
516,BUMA.1121.00049,1,660354,664406,-,4052
516,BUMA.1121.00072,1,1175538,1179590,+,4052
516,BUMA.1121.00076,1,160890,164942,-,4052
516,BUMA.1121.00083,1,382747,386799,-,4052
516,BUMA.1121.00078,1,737066,741118,-,4052
516,BUMA.1121.00095,1,461093,465080,-,3987
516,BUMA.1121.00077,1,3911458,3915510,+,4052
516,BUMA.1121.00063,1,1199857,1203909,+,4052
516,BUMA.1121.00061,1,1202682,1206734,+,4052
516,BUMA.1121.00050,1,2711796,2715848,+,4052
516,BUMA.1121.00081,1,1982146,1986198,-,4052
516,BUMA.1121.00074,1,2629855,2633907,-,4052
516,BUMA.1121.00062,1,3352870,3356922,-,4052
516,BUMA.1121.00060,1,1059919,1063971,-,4052
516,BUMA.1121.00070,1,1173678,1177730,+,4052
516,BUMA.1121.00075,1,714715,718767,+,4052
516,BUMA.1121.00041,1,2505001,2509032,+,4031
516,BUMA.1121.00073,1,1200873,1204925,+,4052
516,BUMA.1121.00017,1,1586092,1590144,+,4052
516,BUMA.1121.00066,1,1176871,1180923,+,4052
516,BUMA.1121.00107,1,1122569,1126621,+,4052
516,BUMA.1121.00085,1,1047494,1051546,+,4052
516,BUMA.1121.00030,1,1586145,1590197,+,4052
516,BUMA.1121.00112,1,1835876,1839922,-,4046
516,BUMA.1121.00002,1,2794319,2798371,+,4052
516,BUMA.1121.00082,1,1318027,1322079,+,4052
516,BUMA.1121.00014,1,1560172,1564224,-,4052
516,BUMA.1121.00011,1,385131,389183,-,4052
516,BUMA.1121.00019,1,1651133,1655185,+,4052
516,BUMA.1121.00057,1,2301049,2305101,+,4052
516,BUMA.1121.00018,1,1813874,1817897,+,4023
516,BUMA.1121.00039,1,1355297,1359349,+,4052
516,BUMA.1121.00016,1,3379346,3383398,+,4052
516,BUMA.1121.00004,1,1652216,1656268,+,4052
516,BUMA.1121.00005,1,2370775,2374827,-,4052
516,BUMA.1121.00100,1,86927,90979,-,4052
516,BUMA.1121.00006,1,1981933,1985985,-,4052
517,BUMA.1121.00027,1,3417407,3424374,+,6967
517,BUMA.1121.00025,1,1434592,1441559,-,6967
517,BUMA.1121.00021,1,1861374,1868341,+,6967
517,BUMA.1121.00023,1,3637493,3644460,+,6967
517,BUMA.1121.00024,1,1655439,1662406,+,6967
517,BUMA.1121.00033,1,3447439,3454406,+,6967
517,BUMA.1121.00034,1,1692873,1699840,+,6967
517,BUMA.1121.00036,1,2451122,2458089,-,6967
517,BUMA.1121.00032,1,3185955,3192922,+,6967
517,BUMA.1121.00009,1,364146,371113,-,6967
517,BUMA.1121.00008,1,1668532,1675499,+,6967
517,BUMA.1121.00003,1,3695297,3702264,+,6967
517,BUMA.1121.00109,1,653920,660887,-,6967
517,BUMA.1121.00053,1,948274,955241,+,6967
517,BUMA.1121.00110,1,3569484,3576451,-,6967
517,BUMA.1121.00104,1,92404,99371,-,6967
517,BUMA.1121.00086,1,341619,348586,+,6967
517,BUMA.1121.00092,1,2649246,2656213,-,6967
517,BUMA.1121.00096,1,2047612,2054572,-,6960
517,BUMA.1121.00054,1,2161490,2168457,+,6967
517,BUMA.1121.00097,1,2783608,2790575,-,6967
517,BUMA.1121.00093,1,1970209,1977176,+,6967
517,BUMA.1121.00106,1,965069,972036,+,6967
517,BUMA.1121.00010,1,2776481,2783448,+,6967
517,BUMA.1121.00035,1,2378769,2385729,+,6960
517,BUMA.1121.00108,1,2198303,2205270,+,6967
517,BUMA.1121.00028,1,1655488,1662455,+,6967
517,BUMA.1121.00094,1,1243036,1250003,+,6967
517,BUMA.1121.00102,1,1,6913,-,6912
517,BUMA.1121.00111,1,1375349,1382316,+,6967
517,BUMA.1121.00089,1,1211704,1218671,+,6967
517,BUMA.1121.00084,1,1450449,1457416,+,6967
517,BUMA.1121.00029,1,3700115,3707082,-,6967
517,BUMA.1121.00012,1,4046327,4053290,+,6963
517,BUMA.1121.00087,1,2967997,2974964,-,6967
517,BUMA.1121.00043,1,1279672,1286639,+,6967
517,BUMA.1121.00046,1,28636,35603,-,6967
517,BUMA.1121.00037,1,3875582,3882549,+,6967
517,BUMA.1121.00080,1,1241663,1248630,+,6967
517,BUMA.1121.00079,1,1236739,1243706,+,6967
517,BUMA.1121.00045,1,2826972,2833939,-,6967
517,BUMA.1121.00071,1,1197204,1204195,+,6991
517,BUMA.1121.00056,1,2707096,2714063,-,6967
517,BUMA.1121.00065,1,1324245,1331212,+,6967
517,BUMA.1121.00058,1,3335650,3342617,-,6967
517,BUMA.1121.00007,1,2890001,2896968,-,6967
517,BUMA.1121.00067,1,3193267,3200234,-,6967
517,BUMA.1121.00090,1,3378989,3385956,+,6967
517,BUMA.1121.00051,1,1214504,1221471,+,6967
517,BUMA.1121.00020,1,1720410,1727377,+,6967
517,BUMA.1121.00103,1,3182145,3189112,-,6967
517,BUMA.1121.00048,1,1767278,1774245,-,6967
517,BUMA.1121.00047,1,1729039,1736006,-,6967
517,BUMA.1121.00042,1,2701809,2708776,-,6967
517,BUMA.1121.00055,1,809477,816444,+,6967
517,BUMA.1121.00031,1,2657183,2664150,+,6967
517,BUMA.1121.00040,1,1584420,1591387,+,6967
517,BUMA.1121.00044,1,920971,927938,+,6967
517,BUMA.1121.00088,1,2120904,2127871,+,6967
517,BUMA.1121.00069,1,1160348,1167340,+,6992
517,BUMA.1121.00064,1,1230961,1237928,+,6967
517,BUMA.1121.00105,1,4006369,4013336,-,6967
517,BUMA.1121.00015,1,1065244,1072211,+,6967
517,BUMA.1121.00059,1,433313,440280,+,6967
517,BUMA.1121.00026,1,290294,297261,-,6967
517,BUMA.1121.00022,1,1991034,1998001,+,6967
517,BUMA.1121.00052,1,1455014,1461981,+,6967
517,BUMA.1121.00101,1,1262093,1269060,-,6967
517,BUMA.1121.00001,1,2824713,2831680,-,6967
517,BUMA.1121.00038,1,1974695,1981662,-,6967
517,BUMA.1121.00068,1,4077123,4084090,+,6967
517,BUMA.1121.00099,1,1164591,1171558,-,6967
517,BUMA.1121.00091,1,3322014,3328981,-,6967
517,BUMA.1121.00098,1,3957186,3964149,+,6963
517,BUMA.1121.00013,1,1655824,1662791,+,6967
517,BUMA.1121.00049,1,653029,659996,-,6967
517,BUMA.1121.00072,1,1179948,1186940,+,6992
517,BUMA.1121.00076,1,153565,160532,-,6967
517,BUMA.1121.00083,1,360215,367175,-,6960
517,BUMA.1121.00078,1,729741,736708,-,6967
517,BUMA.1121.00095,1,453768,460735,-,6967
517,BUMA.1121.00077,1,3915868,3922833,+,6965
517,BUMA.1121.00063,1,1204253,1211244,+,6991
517,BUMA.1121.00061,1,1207092,1214083,+,6991
517,BUMA.1121.00050,1,2716206,2723173,+,6967
517,BUMA.1121.00081,1,1974821,1981788,-,6967
517,BUMA.1121.00074,1,2622530,2629497,-,6967
517,BUMA.1121.00062,1,3345545,3352512,-,6967
517,BUMA.1121.00060,1,1052594,1059561,-,6967
517,BUMA.1121.00070,1,1178088,1185079,+,6991
517,BUMA.1121.00075,1,719124,726090,+,6966
517,BUMA.1121.00041,1,2527984,2534951,+,6967
517,BUMA.1121.00073,1,1205283,1212277,+,6994
517,BUMA.1121.00017,1,1590502,1597469,+,6967
517,BUMA.1121.00066,1,1181281,1188272,+,6991
517,BUMA.1121.00107,1,1126979,1133946,+,6967
517,BUMA.1121.00085,1,1051904,1058871,+,6967
517,BUMA.1121.00030,1,1590555,1597522,+,6967
517,BUMA.1121.00112,1,1828539,1835518,-,6979
517,BUMA.1121.00002,1,2798729,2805696,+,6967
517,BUMA.1121.00082,1,1337651,1344611,+,6960
517,BUMA.1121.00014,1,1552847,1559814,-,6967
517,BUMA.1121.00011,1,361720,368683,-,6963
517,BUMA.1121.00019,1,1655543,1662510,+,6967
517,BUMA.1121.00057,1,2305459,2312426,+,6967
517,BUMA.1121.00018,1,1818284,1825251,+,6967
517,BUMA.1121.00039,1,1359707,1366674,+,6967
517,BUMA.1121.00016,1,3383756,3390723,+,6967
517,BUMA.1121.00004,1,1656626,1663623,+,6997
517,BUMA.1121.00005,1,2363466,2370433,-,6967
517,BUMA.1121.00100,1,79602,86569,-,6967
517,BUMA.1121.00006,1,1974608,1981575,-,6967
518,BUMA.1121.00027,1,3424375,3438250,+,13875
518,BUMA.1121.00025,1,1420655,1434590,-,13935
518,BUMA.1121.00021,1,1868342,1882150,+,13808
518,BUMA.1121.00023,1,3644461,3658329,+,13868
518,BUMA.1121.00024,1,1662407,1676197,+,13790
518,BUMA.1121.00033,1,3454407,3468099,+,13692
518,BUMA.1121.00034,1,1699841,1713659,+,13818
518,BUMA.1121.00036,1,2437261,2451120,-,13859
518,BUMA.1121.00032,1,3192923,3206734,+,13811
518,BUMA.1121.00009,1,350409,364144,-,13735
518,BUMA.1121.00008,1,1675500,1689297,+,13797
518,BUMA.1121.00003,1,3702265,3716138,+,13873
518,BUMA.1121.00109,1,639776,653918,-,14142
518,BUMA.1121.00053,1,955242,969090,+,13848
518,BUMA.1121.00110,1,3555595,3569482,-,13887
518,BUMA.1121.00104,1,78594,92402,-,13808
518,BUMA.1121.00086,1,348587,362557,+,13970
518,BUMA.1121.00092,1,2635258,2649244,-,13986
518,BUMA.1121.00096,1,2033650,2047610,-,13960
518,BUMA.1121.00054,1,2168458,2182338,+,13880
518,BUMA.1121.00097,1,2769623,2783606,-,13983
518,BUMA.1121.00093,1,1977177,1991157,+,13980
518,BUMA.1121.00106,1,972037,985972,+,13935
518,BUMA.1121.00010,1,2783449,2797330,+,13881
518,BUMA.1121.00035,1,2385730,2399481,+,13751
518,BUMA.1121.00108,1,2205271,2219000,+,13729
518,BUMA.1121.00028,1,1662456,1676246,+,13790
518,BUMA.1121.00094,1,1250004,1264048,+,14044
518,BUMA.1121.00102,1,4171307,4185307,-,14000
518,BUMA.1121.00111,1,1382317,1396193,+,13876
518,BUMA.1121.00089,1,1218672,1232724,+,14052
518,BUMA.1121.00084,1,1457417,1471436,+,14019
518,BUMA.1121.00029,1,3686274,3700113,-,13839
518,BUMA.1121.00012,1,4053291,4067118,+,13827
518,BUMA.1121.00087,1,2954215,2967995,-,13780
518,BUMA.1121.00043,1,1286640,1300537,+,13897
518,BUMA.1121.00046,1,14747,28634,-,13887
518,BUMA.1121.00037,1,3882550,3896297,+,13747
518,BUMA.1121.00080,1,1248631,1262684,+,14053
518,BUMA.1121.00079,1,1243707,1257813,+,14106
518,BUMA.1121.00045,1,2813069,2826970,-,13901
518,BUMA.1121.00071,1,1204196,1218062,+,13866
518,BUMA.1121.00056,1,2693152,2707094,-,13942
518,BUMA.1121.00065,1,1331213,1344964,+,13751
518,BUMA.1121.00058,1,3321674,3335648,-,13974
518,BUMA.1121.00007,1,2875991,2889999,-,14008
518,BUMA.1121.00067,1,3179352,3193265,-,13913
518,BUMA.1121.00090,1,3385957,3399871,+,13914
518,BUMA.1121.00051,1,1221472,1235499,+,14027
518,BUMA.1121.00020,1,1727378,1741182,+,13804
518,BUMA.1121.00103,1,3168416,3182143,-,13727
518,BUMA.1121.00048,1,1753397,1767276,-,13879
518,BUMA.1121.00047,1,1714918,1729037,-,14119
518,BUMA.1121.00042,1,2688049,2701807,-,13758
518,BUMA.1121.00055,1,816445,830200,+,13755
518,BUMA.1121.00031,1,2664151,2677938,+,13787
518,BUMA.1121.00040,1,1591388,1605233,+,13845
518,BUMA.1121.00044,1,927939,941757,+,13818
518,BUMA.1121.00088,1,2127872,2141848,+,13976
518,BUMA.1121.00069,1,1167341,1181175,+,13834
518,BUMA.1121.00064,1,1237929,1251729,+,13800
518,BUMA.1121.00105,1,3992409,4006367,-,13958
518,BUMA.1121.00015,1,1072212,1086106,+,13894
518,BUMA.1121.00059,1,440281,454058,+,13777
518,BUMA.1121.00026,1,276514,290292,-,13778
518,BUMA.1121.00022,1,1998002,2011825,+,13823
518,BUMA.1121.00052,1,1461982,1475856,+,13874
518,BUMA.1121.00101,1,1248186,1262091,-,13905
518,BUMA.1121.00001,1,2810960,2824711,-,13751
518,BUMA.1121.00038,1,1960821,1974693,-,13872
518,BUMA.1121.00068,1,4084091,4097934,+,13843
518,BUMA.1121.00099,1,1150569,1164589,-,14020
518,BUMA.1121.00091,1,3308097,3322012,-,13915
518,BUMA.1121.00098,1,3964150,3977998,+,13848
518,BUMA.1121.00013,1,1662792,1676721,+,13929
518,BUMA.1121.00049,1,639210,653027,-,13817
518,BUMA.1121.00072,1,1186941,1200783,+,13842
518,BUMA.1121.00076,1,139783,153563,-,13780
518,BUMA.1121.00083,1,346288,360213,-,13925
518,BUMA.1121.00078,1,715749,729739,-,13990
518,BUMA.1121.00095,1,440016,453766,-,13750
518,BUMA.1121.00077,1,3922834,3936732,+,13898
518,BUMA.1121.00063,1,1211245,1225087,+,13842
518,BUMA.1121.00061,1,1214084,1228016,+,13932
518,BUMA.1121.00050,1,2723174,2737056,+,13882
518,BUMA.1121.00081,1,1960940,1974819,-,13879
518,BUMA.1121.00074,1,2608688,2622528,-,13840
518,BUMA.1121.00062,1,3331601,3345543,-,13942
518,BUMA.1121.00060,1,1038803,1052592,-,13789
518,BUMA.1121.00070,1,1185080,1198988,+,13908
518,BUMA.1121.00075,1,726091,739877,+,13786
518,BUMA.1121.00041,1,2534952,2548759,+,13807
518,BUMA.1121.00073,1,1212278,1226192,+,13914
518,BUMA.1121.00017,1,1597470,1611288,+,13818
518,BUMA.1121.00066,1,1188273,1202145,+,13872
518,BUMA.1121.00107,1,1133947,1147848,+,13901
518,BUMA.1121.00085,1,1058872,1072767,+,13895
518,BUMA.1121.00030,1,1597523,1611341,+,13818
518,BUMA.1121.00112,1,1814569,1828537,-,13968
518,BUMA.1121.00002,1,2805697,2819494,+,13797
518,BUMA.1121.00082,1,1344612,1358545,+,13933
518,BUMA.1121.00014,1,1539081,1552845,-,13764
518,BUMA.1121.00011,1,347819,361718,-,13899
518,BUMA.1121.00019,1,1662511,1676322,+,13811
518,BUMA.1121.00057,1,2312427,2326338,+,13911
518,BUMA.1121.00018,1,1825252,1839219,+,13967
518,BUMA.1121.00039,1,1366675,1380543,+,13868
518,BUMA.1121.00016,1,3390724,3404573,+,13849
518,BUMA.1121.00004,1,1663624,1677456,+,13832
518,BUMA.1121.00005,1,2349637,2363464,-,13827
518,BUMA.1121.00100,1,65726,79600,-,13874
518,BUMA.1121.00006,1,1960727,1974606,-,13879
519,BUMA.1121.00027,1,3438251,3443344,+,5093
519,BUMA.1121.00025,1,1415544,1420653,-,5109
519,BUMA.1121.00021,1,1882151,1887252,+,5101
519,BUMA.1121.00023,1,3658330,3663408,+,5078
519,BUMA.1121.00024,1,1676198,1681219,+,5021
519,BUMA.1121.00033,1,3468100,3473210,+,5110
519,BUMA.1121.00034,1,1713660,1718681,+,5021
519,BUMA.1121.00036,1,2432239,2437259,-,5020
519,BUMA.1121.00032,1,3206735,3211756,+,5021
519,BUMA.1121.00009,1,345312,350407,-,5095
519,BUMA.1121.00008,1,1689298,1694319,+,5021
519,BUMA.1121.00003,1,3716148,3721259,+,5111
519,BUMA.1121.00109,1,634670,639774,-,5104
519,BUMA.1121.00053,1,969091,974185,+,5094
519,BUMA.1121.00110,1,3550510,3555593,-,5083
519,BUMA.1121.00104,1,73509,78592,-,5083
519,BUMA.1121.00086,1,362558,367579,+,5021
519,BUMA.1121.00092,1,2630154,2635256,-,5102
519,BUMA.1121.00096,1,2028544,2033648,-,5104
519,BUMA.1121.00054,1,2182339,2187360,+,5021
519,BUMA.1121.00097,1,2764519,2769621,-,5102
519,BUMA.1121.00093,1,1991158,1996261,+,5103
519,BUMA.1121.00106,1,985973,991076,+,5103
519,BUMA.1121.00010,1,2797331,2802352,+,5021
519,BUMA.1121.00035,1,2399482,2404574,+,5092
519,BUMA.1121.00108,1,2219001,2224094,+,5093
519,BUMA.1121.00028,1,1676247,1681268,+,5021
519,BUMA.1121.00094,1,1264058,1269167,+,5109
519,BUMA.1121.00102,1,4166203,4171305,-,5102
519,BUMA.1121.00111,1,1396194,1401304,+,5110
519,BUMA.1121.00089,1,1232734,1237843,+,5109
519,BUMA.1121.00084,1,1471437,1476531,+,5094
519,BUMA.1121.00029,1,3681181,3686272,-,5091
519,BUMA.1121.00012,1,4067119,4072229,+,5110
519,BUMA.1121.00087,1,2949193,2954213,-,5020
519,BUMA.1121.00043,1,1300538,1305634,+,5096
519,BUMA.1121.00046,1,9725,14745,-,5020
519,BUMA.1121.00037,1,3896298,3901408,+,5110
519,BUMA.1121.00080,1,1262694,1267803,+,5109
519,BUMA.1121.00079,1,1257814,1262908,+,5094
519,BUMA.1121.00045,1,2808002,2813067,-,5065
519,BUMA.1121.00071,1,1218063,1223147,+,5084
519,BUMA.1121.00056,1,2688057,2693150,-,5093
519,BUMA.1121.00065,1,1344965,1350094,+,5129
519,BUMA.1121.00058,1,3316580,3321672,-,5092
519,BUMA.1121.00007,1,2870897,2875989,-,5092
519,BUMA.1121.00067,1,3172780,3177889,-,5109
519,BUMA.1121.00090,1,3399872,3404982,+,5110
519,BUMA.1121.00051,1,1235500,1240594,+,5094
519,BUMA.1121.00020,1,1741183,1746204,+,5021
519,BUMA.1121.00103,1,3163321,3168414,-,5093
519,BUMA.1121.00048,1,1748375,1753395,-,5020
519,BUMA.1121.00047,1,1709823,1714916,-,5093
519,BUMA.1121.00042,1,2683027,2688047,-,5020
519,BUMA.1121.00055,1,831662,836780,+,5118
519,BUMA.1121.00031,1,2677939,2683044,+,5105
519,BUMA.1121.00040,1,1605234,1610246,+,5012
519,BUMA.1121.00044,1,941758,946779,+,5021
519,BUMA.1121.00088,1,2141849,2146943,+,5094
519,BUMA.1121.00069,1,1181176,1186260,+,5084
519,BUMA.1121.00064,1,1251730,1256824,+,5094
519,BUMA.1121.00105,1,3987305,3992407,-,5102
519,BUMA.1121.00015,1,1086107,1091128,+,5021
519,BUMA.1121.00059,1,454059,459162,+,5103
519,BUMA.1121.00026,1,271492,276512,-,5020
519,BUMA.1121.00022,1,2011826,2016847,+,5021
519,BUMA.1121.00052,1,1475857,1480878,+,5021
519,BUMA.1121.00101,1,1243098,1248184,-,5086
519,BUMA.1121.00001,1,2805867,2810958,-,5091
519,BUMA.1121.00038,1,1955799,1960819,-,5020
519,BUMA.1121.00068,1,4097935,4103047,+,5112
519,BUMA.1121.00099,1,1145481,1150567,-,5086
519,BUMA.1121.00091,1,3302993,3308095,-,5102
519,BUMA.1121.00098,1,3978008,3983089,+,5081
519,BUMA.1121.00013,1,1676722,1681743,+,5021
519,BUMA.1121.00049,1,634098,639208,-,5110
519,BUMA.1121.00072,1,1200784,1205868,+,5084
519,BUMA.1121.00076,1,134698,139781,-,5083
519,BUMA.1121.00083,1,341204,346286,-,5082
519,BUMA.1121.00078,1,710654,715747,-,5093
519,BUMA.1121.00095,1,434921,440014,-,5093
519,BUMA.1121.00077,1,3936733,3941817,+,5084
519,BUMA.1121.00063,1,1225088,1230172,+,5084
519,BUMA.1121.00061,1,1228017,1233101,+,5084
519,BUMA.1121.00050,1,2737057,2742078,+,5021
519,BUMA.1121.00081,1,1955918,1960938,-,5020
519,BUMA.1121.00074,1,2603593,2608686,-,5093
519,BUMA.1121.00062,1,3326497,3331599,-,5102
519,BUMA.1121.00060,1,1033736,1038801,-,5065
519,BUMA.1121.00070,1,1198989,1204073,+,5084
519,BUMA.1121.00075,1,739878,744962,+,5084
519,BUMA.1121.00041,1,2548760,2553874,+,5114
519,BUMA.1121.00073,1,1226193,1231277,+,5084
519,BUMA.1121.00017,1,1611289,1616310,+,5021
519,BUMA.1121.00066,1,1202146,1207230,+,5084
519,BUMA.1121.00107,1,1147849,1152990,+,5141
519,BUMA.1121.00085,1,1072768,1077789,+,5021
519,BUMA.1121.00030,1,1611342,1616363,+,5021
519,BUMA.1121.00112,1,1809465,1814567,-,5102
519,BUMA.1121.00002,1,2819495,2824516,+,5021
519,BUMA.1121.00082,1,1358546,1363629,+,5083
519,BUMA.1121.00014,1,1533984,1539079,-,5095
519,BUMA.1121.00011,1,342722,347817,-,5095
519,BUMA.1121.00019,1,1676323,1681344,+,5021
519,BUMA.1121.00057,1,2326339,2331440,+,5101
519,BUMA.1121.00018,1,1839220,1844330,+,5110
519,BUMA.1121.00039,1,1380544,1385654,+,5110
519,BUMA.1121.00016,1,3404574,3409657,+,5083
519,BUMA.1121.00004,1,1677457,1682478,+,5021
519,BUMA.1121.00005,1,2344524,2349635,-,5111
519,BUMA.1121.00100,1,60571,65724,-,5153
519,BUMA.1121.00006,1,1955705,1960725,-,5020
520,BUMA.1121.00027,1,3443360,3451766,+,8406
520,BUMA.1121.00025,1,1407085,1415529,-,8444
520,BUMA.1121.00021,1,1887267,1895705,+,8438
520,BUMA.1121.00023,1,3663437,3671852,+,8415
520,BUMA.1121.00024,1,1681234,1690995,+,9761
520,BUMA.1121.00033,1,3473225,3481622,+,8397
520,BUMA.1121.00034,1,1718696,1728450,+,9754
520,BUMA.1121.00036,1,2422406,2432224,-,9818
520,BUMA.1121.00032,1,3211771,3221523,+,9752
520,BUMA.1121.00009,1,336807,345297,-,8490
520,BUMA.1121.00008,1,1694334,1704095,+,9761
520,BUMA.1121.00003,1,3721274,3729737,+,8463
520,BUMA.1121.00109,1,626231,634655,-,8424
520,BUMA.1121.00053,1,974200,982622,+,8422
520,BUMA.1121.00110,1,3542122,3550495,-,8373
520,BUMA.1121.00104,1,65069,73494,-,8425
520,BUMA.1121.00086,1,367594,377377,+,9783
520,BUMA.1121.00092,1,2621702,2630139,-,8437
520,BUMA.1121.00096,1,2020091,2028529,-,8438
520,BUMA.1121.00054,1,2187375,2197153,+,9778
520,BUMA.1121.00097,1,2754709,2764504,-,9795
520,BUMA.1121.00093,1,1996276,2004700,+,8424
520,BUMA.1121.00106,1,991091,999536,+,8445
520,BUMA.1121.00010,1,2802367,2812120,+,9753
520,BUMA.1121.00035,1,2404589,2413002,+,8413
520,BUMA.1121.00108,1,2224109,2232607,+,8498
520,BUMA.1121.00028,1,1681283,1691030,+,9747
520,BUMA.1121.00094,1,1269182,1277629,+,8447
520,BUMA.1121.00102,1,4157746,4166188,-,8442
520,BUMA.1121.00111,1,1401319,1409743,+,8424
520,BUMA.1121.00089,1,1237858,1246305,+,8447
520,BUMA.1121.00084,1,1476546,1485015,+,8469
520,BUMA.1121.00029,1,3672740,3681166,-,8426
520,BUMA.1121.00012,1,4072244,4080674,+,8430
520,BUMA.1121.00087,1,2939395,2949178,-,9783
520,BUMA.1121.00043,1,1305649,1314072,+,8423
520,BUMA.1121.00046,1,1,9710,-,9709
520,BUMA.1121.00037,1,3901423,3909824,+,8401
520,BUMA.1121.00080,1,1267818,1276269,+,8451
520,BUMA.1121.00079,1,1262923,1271425,+,8502
520,BUMA.1121.00045,1,2799539,2807987,-,8448
520,BUMA.1121.00071,1,1223162,1231607,+,8445
520,BUMA.1121.00056,1,2679595,2688042,-,8447
520,BUMA.1121.00065,1,1350109,1358525,+,8416
520,BUMA.1121.00058,1,3308147,3316564,-,8417
520,BUMA.1121.00007,1,2862438,2870882,-,8444
520,BUMA.1121.00067,1,3164342,3172765,-,8423
520,BUMA.1121.00090,1,3404997,3413413,+,8416
520,BUMA.1121.00051,1,1240609,1249096,+,8487
520,BUMA.1121.00020,1,1746219,1755980,+,9761
520,BUMA.1121.00103,1,3154844,3163306,-,8462
520,BUMA.1121.00048,1,1738584,1748360,-,9776
520,BUMA.1121.00047,1,1701347,1709808,-,8461
520,BUMA.1121.00042,1,2673243,2683012,-,9769
520,BUMA.1121.00055,1,836795,845243,+,8448
520,BUMA.1121.00031,1,2683073,2691472,+,8399
520,BUMA.1121.00040,1,1610261,1620037,+,9776
520,BUMA.1121.00044,1,946794,956548,+,9754
520,BUMA.1121.00088,1,2146958,2155413,+,8455
520,BUMA.1121.00069,1,1186275,1194712,+,8437
520,BUMA.1121.00064,1,1256839,1265312,+,8473
520,BUMA.1121.00105,1,3978809,3987290,-,8481
520,BUMA.1121.00015,1,1091143,1100940,+,9797
520,BUMA.1121.00059,1,459177,467636,+,8459
520,BUMA.1121.00026,1,261729,271477,-,9748
520,BUMA.1121.00022,1,2016862,2026653,+,9791
520,BUMA.1121.00052,1,1480893,1490669,+,9776
520,BUMA.1121.00101,1,1234579,1243083,-,8504
520,BUMA.1121.00001,1,2797426,2805852,-,8426
520,BUMA.1121.00038,1,1946006,1955784,-,9778
520,BUMA.1121.00068,1,4103062,4111513,+,8451
520,BUMA.1121.00099,1,1137034,1145466,-,8432
520,BUMA.1121.00091,1,3294548,3302978,-,8430
520,BUMA.1121.00098,1,4013141,4021580,+,8439
520,BUMA.1121.00013,1,1681758,1691562,+,9804
520,BUMA.1121.00049,1,625617,634082,-,8465
520,BUMA.1121.00072,1,1205883,1214328,+,8445
520,BUMA.1121.00076,1,126209,134683,-,8474
520,BUMA.1121.00083,1,332730,341188,-,8458
520,BUMA.1121.00078,1,702167,710639,-,8472
520,BUMA.1121.00095,1,426449,434906,-,8457
520,BUMA.1121.00077,1,3941832,3950205,+,8373
520,BUMA.1121.00063,1,1230187,1238632,+,8445
520,BUMA.1121.00061,1,1233116,1241559,+,8443
520,BUMA.1121.00050,1,2742093,2751846,+,9753
520,BUMA.1121.00081,1,1946125,1955903,-,9778
520,BUMA.1121.00074,1,2595085,2603578,-,8493
520,BUMA.1121.00062,1,3318038,3326482,-,8444
520,BUMA.1121.00060,1,1025273,1033721,-,8448
520,BUMA.1121.00070,1,1204088,1212527,+,8439
520,BUMA.1121.00075,1,744977,753443,+,8466
520,BUMA.1121.00041,1,2553889,2562360,+,8471
520,BUMA.1121.00073,1,1231292,1239737,+,8445
520,BUMA.1121.00017,1,1616325,1626079,+,9754
520,BUMA.1121.00066,1,1207245,1215690,+,8445
520,BUMA.1121.00107,1,1153005,1161447,+,8442
520,BUMA.1121.00085,1,1077804,1087580,+,9776
520,BUMA.1121.00030,1,1616378,1626132,+,9754
520,BUMA.1121.00112,1,1801010,1809450,-,8440
520,BUMA.1121.00002,1,2824531,2834285,+,9754
520,BUMA.1121.00082,1,1363645,1372090,+,8445
520,BUMA.1121.00014,1,1525543,1533955,-,8412
520,BUMA.1121.00011,1,334245,342707,-,8462
520,BUMA.1121.00019,1,1681359,1691120,+,9761
520,BUMA.1121.00057,1,2331456,2339901,+,8445
520,BUMA.1121.00018,1,1844345,1852776,+,8431
520,BUMA.1121.00039,1,1385669,1394097,+,8428
520,BUMA.1121.00016,1,3409672,3418137,+,8465
520,BUMA.1121.00004,1,1682493,1692254,+,9761
520,BUMA.1121.00005,1,2336038,2344509,-,8471
520,BUMA.1121.00100,1,52116,60556,-,8440
520,BUMA.1121.00006,1,1945912,1955690,-,9778
521,BUMA.1121.00027,1,3452408,3462912,+,10504
521,BUMA.1121.00025,1,1395951,1406456,-,10505
521,BUMA.1121.00021,1,1896347,1906851,+,10504
521,BUMA.1121.00023,1,3672494,3682998,+,10504
521,BUMA.1121.00024,1,1691624,1702128,+,10504
521,BUMA.1121.00033,1,3482264,3492768,+,10504
521,BUMA.1121.00034,1,1729079,1739583,+,10504
521,BUMA.1121.00036,1,2411272,2421777,-,10505
521,BUMA.1121.00032,1,3222152,3232656,+,10504
521,BUMA.1121.00009,1,325673,336178,-,10505
521,BUMA.1121.00008,1,1704724,1715228,+,10504
521,BUMA.1121.00003,1,3730379,3740883,+,10504
521,BUMA.1121.00109,1,615097,625602,-,10505
521,BUMA.1121.00053,1,983251,993755,+,10504
521,BUMA.1121.00110,1,3530988,3541493,-,10505
521,BUMA.1121.00104,1,53935,64440,-,10505
521,BUMA.1121.00086,1,378006,388510,+,10504
521,BUMA.1121.00092,1,2610568,2621073,-,10505
521,BUMA.1121.00096,1,2008949,2019454,-,10505
521,BUMA.1121.00054,1,2197782,2208286,+,10504
521,BUMA.1121.00097,1,2743575,2754080,-,10505
521,BUMA.1121.00093,1,2005342,2015846,+,10504
521,BUMA.1121.00106,1,1000178,1010682,+,10504
521,BUMA.1121.00010,1,2812749,2823253,+,10504
521,BUMA.1121.00035,1,2413644,2424148,+,10504
521,BUMA.1121.00108,1,2233236,2243740,+,10504
521,BUMA.1121.00028,1,1691659,1702163,+,10504
521,BUMA.1121.00094,1,1278271,1288775,+,10504
521,BUMA.1121.00102,1,4146616,4157117,-,10501
521,BUMA.1121.00111,1,1410385,1420886,+,10501
521,BUMA.1121.00089,1,1246934,1257438,+,10504
521,BUMA.1121.00084,1,1485644,1496148,+,10504
521,BUMA.1121.00029,1,3661606,3672111,-,10505
521,BUMA.1121.00012,1,4081316,4091820,+,10504
521,BUMA.1121.00087,1,2928261,2938766,-,10505
521,BUMA.1121.00043,1,1314714,1325218,+,10504
521,BUMA.1121.00046,1,3496559,3508379,-,11820
521,BUMA.1121.00037,1,3910466,3920970,+,10504
521,BUMA.1121.00080,1,1276898,1287402,+,10504
521,BUMA.1121.00079,1,1272054,1282557,+,10503
521,BUMA.1121.00045,1,2788405,2798910,-,10505
521,BUMA.1121.00071,1,1232249,1242753,+,10504
521,BUMA.1121.00056,1,2668461,2678966,-,10505
521,BUMA.1121.00065,1,1359167,1369671,+,10504
521,BUMA.1121.00058,1,3297013,3307518,-,10505
521,BUMA.1121.00007,1,2851307,2861809,-,10502
521,BUMA.1121.00067,1,3153208,3163713,-,10505
521,BUMA.1121.00090,1,3414055,3424559,+,10504
521,BUMA.1121.00051,1,1249725,1260229,+,10504
521,BUMA.1121.00020,1,1756609,1767113,+,10504
521,BUMA.1121.00103,1,3143710,3154215,-,10505
521,BUMA.1121.00048,1,1727450,1737955,-,10505
521,BUMA.1121.00047,1,1690213,1700718,-,10505
521,BUMA.1121.00042,1,2662113,2672614,-,10501
521,BUMA.1121.00055,1,845885,856389,+,10504
521,BUMA.1121.00031,1,2692114,2702618,+,10504
521,BUMA.1121.00040,1,1620666,1631173,+,10507
521,BUMA.1121.00044,1,957177,967681,+,10504
521,BUMA.1121.00088,1,2156042,2166546,+,10504
521,BUMA.1121.00069,1,1195354,1205858,+,10504
521,BUMA.1121.00064,1,1265954,1276458,+,10504
521,BUMA.1121.00105,1,3967675,3978180,-,10505
521,BUMA.1121.00015,1,1101569,1112073,+,10504
521,BUMA.1121.00059,1,468278,478782,+,10504
521,BUMA.1121.00026,1,250595,261100,-,10505
521,BUMA.1121.00022,1,2027282,2037786,+,10504
521,BUMA.1121.00052,1,1491298,1501802,+,10504
521,BUMA.1121.00101,1,1223448,1233950,-,10502
521,BUMA.1121.00001,1,2786292,2796797,-,10505
521,BUMA.1121.00038,1,1934872,1945377,-,10505
521,BUMA.1121.00068,1,1,10448,+,10447
521,BUMA.1121.00099,1,1125900,1136405,-,10505
521,BUMA.1121.00091,1,3283414,3293919,-,10505
521,BUMA.1121.00098,1,4022209,4032713,+,10504
521,BUMA.1121.00013,1,1692191,1702695,+,10504
521,BUMA.1121.00049,1,614483,624988,-,10505
521,BUMA.1121.00072,1,1214970,1225474,+,10504
521,BUMA.1121.00076,1,115075,125580,-,10505
521,BUMA.1121.00083,1,321596,332101,-,10505
521,BUMA.1121.00078,1,691035,701538,-,10503
521,BUMA.1121.00095,1,415312,425820,-,10508
521,BUMA.1121.00077,1,3950834,3961337,+,10503
521,BUMA.1121.00063,1,1239274,1249778,+,10504
521,BUMA.1121.00061,1,1242201,1252705,+,10504
521,BUMA.1121.00050,1,2752475,2764293,+,11818
521,BUMA.1121.00081,1,1934991,1945496,-,10505
521,BUMA.1121.00074,1,2583951,2594456,-,10505
521,BUMA.1121.00062,1,3306904,3317409,-,10505
521,BUMA.1121.00060,1,1014139,1024644,-,10505
521,BUMA.1121.00070,1,1213169,1223673,+,10504
521,BUMA.1121.00075,1,754072,764576,+,10504
521,BUMA.1121.00041,1,2562989,2573493,+,10504
521,BUMA.1121.00073,1,1240379,1250883,+,10504
521,BUMA.1121.00017,1,1626708,1637212,+,10504
521,BUMA.1121.00066,1,1216332,1226836,+,10504
521,BUMA.1121.00107,1,1162076,1172577,+,10501
521,BUMA.1121.00085,1,1088209,1098713,+,10504
521,BUMA.1121.00030,1,1626761,1637265,+,10504
521,BUMA.1121.00112,1,1789876,1800381,-,10505
521,BUMA.1121.00002,1,2834914,2845418,+,10504
521,BUMA.1121.00082,1,1372732,1383236,+,10504
521,BUMA.1121.00014,1,1514409,1524914,-,10505
521,BUMA.1121.00011,1,323111,333616,-,10505
521,BUMA.1121.00019,1,1691749,1702253,+,10504
521,BUMA.1121.00057,1,2340543,2351047,+,10504
521,BUMA.1121.00018,1,1853418,1863922,+,10504
521,BUMA.1121.00039,1,1394739,1405244,+,10505
521,BUMA.1121.00016,1,3418779,3429283,+,10504
521,BUMA.1121.00004,1,1692883,1703387,+,10504
521,BUMA.1121.00005,1,2324904,2335409,-,10505
521,BUMA.1121.00100,1,40982,51487,-,10505
521,BUMA.1121.00006,1,1934778,1945283,-,10505
522,BUMA.1121.00027,1,3465982,3503826,+,37844
522,BUMA.1121.00025,1,1355021,1392880,-,37859
522,BUMA.1121.00021,1,1909922,1947782,+,37860
522,BUMA.1121.00023,1,3686069,3723928,+,37859
522,BUMA.1121.00024,1,1705202,1743058,+,37856
522,BUMA.1121.00033,1,3495845,3533704,+,37859
522,BUMA.1121.00034,1,1742657,1780513,+,37856
522,BUMA.1121.00036,1,2370342,2408198,-,37856
522,BUMA.1121.00032,1,3235730,3273586,+,37856
522,BUMA.1121.00009,1,284756,322602,-,37846
522,BUMA.1121.00008,1,1718302,1756158,+,37856
522,BUMA.1121.00003,1,3743953,3781833,+,37880
522,BUMA.1121.00109,1,574164,612020,-,37856
522,BUMA.1121.00053,1,996826,1034683,+,37857
522,BUMA.1121.00110,1,3490038,3527917,-,37879
522,BUMA.1121.00104,1,13016,50864,-,37848
522,BUMA.1121.00086,1,391584,429440,+,37856
522,BUMA.1121.00092,1,2569653,2607498,-,37845
522,BUMA.1121.00096,1,1968052,2005878,-,37826
522,BUMA.1121.00054,1,2212618,2250456,+,37838
522,BUMA.1121.00097,1,2702642,2740504,-,37862
522,BUMA.1121.00093,1,2018916,2056761,+,37845
522,BUMA.1121.00106,1,1013753,1051570,+,37817
522,BUMA.1121.00010,1,2827567,2865423,+,37856
522,BUMA.1121.00035,1,2427219,2465083,+,37864
522,BUMA.1121.00108,1,2246810,2284599,+,37789
522,BUMA.1121.00028,1,1705237,1743093,+,37856
522,BUMA.1121.00094,1,1291845,1329707,+,37862
522,BUMA.1121.00102,1,4105682,4143545,-,37863
522,BUMA.1121.00111,1,1423957,1461817,+,37860
522,BUMA.1121.00089,1,1260508,1298370,+,37862
522,BUMA.1121.00084,1,1499219,1537063,+,37844
522,BUMA.1121.00029,1,3620671,3658535,-,37864
522,BUMA.1121.00012,1,4094891,4132718,+,37827
522,BUMA.1121.00087,1,2887331,2925187,-,37856
522,BUMA.1121.00043,1,1328289,1366144,+,37855
522,BUMA.1121.00046,1,3454389,3492227,-,37838
522,BUMA.1121.00037,1,3924041,3961900,+,37859
522,BUMA.1121.00080,1,1290467,1328329,+,37862
522,BUMA.1121.00079,1,1285628,1323482,+,37854
522,BUMA.1121.00045,1,2747490,2785334,-,37844
522,BUMA.1121.00071,1,1245823,1283668,+,37845
522,BUMA.1121.00056,1,2627529,2665391,-,37862
522,BUMA.1121.00065,1,1372742,1410537,+,37795
522,BUMA.1121.00058,1,3256099,3293943,-,37844
522,BUMA.1121.00007,1,2810387,2848224,-,37837
522,BUMA.1121.00067,1,3112281,3150143,-,37862
522,BUMA.1121.00090,1,3427630,3465493,+,37863
522,BUMA.1121.00051,1,1263294,1301154,+,37860
522,BUMA.1121.00020,1,1770187,1808043,+,37856
522,BUMA.1121.00103,1,3102777,3140640,-,37863
522,BUMA.1121.00048,1,1685280,1723118,-,37838
522,BUMA.1121.00047,1,1649281,1687143,-,37862
522,BUMA.1121.00042,1,2621183,2659039,-,37856
522,BUMA.1121.00055,1,859454,897337,+,37883
522,BUMA.1121.00031,1,2705689,2743543,+,37854
522,BUMA.1121.00040,1,1634247,1672103,+,37856
522,BUMA.1121.00044,1,970755,1008611,+,37856
522,BUMA.1121.00088,1,2169617,2207434,+,37817
522,BUMA.1121.00069,1,1208928,1246772,+,37844
522,BUMA.1121.00064,1,1279529,1317374,+,37845
522,BUMA.1121.00105,1,3926753,3964605,-,37852
522,BUMA.1121.00015,1,1116405,1154243,+,37838
522,BUMA.1121.00059,1,481852,519696,+,37844
522,BUMA.1121.00026,1,209743,247521,-,37778
522,BUMA.1121.00022,1,2040860,2078716,+,37856
522,BUMA.1121.00052,1,1504876,1542732,+,37856
522,BUMA.1121.00101,1,1182523,1220378,-,37855
522,BUMA.1121.00001,1,2745358,2783221,-,37863
522,BUMA.1121.00038,1,1892702,1930540,-,37838
522,BUMA.1121.00068,1,13518,51373,+,37855
522,BUMA.1121.00099,1,1084983,1122832,-,37849
522,BUMA.1121.00091,1,3242499,3280343,-,37844
522,BUMA.1121.00098,1,4035784,4073645,+,37861
522,BUMA.1121.00013,1,1705769,1743625,+,37856
522,BUMA.1121.00049,1,573568,611412,-,37844
522,BUMA.1121.00072,1,1228544,1266284,+,37740
522,BUMA.1121.00076,1,74146,112005,-,37859
522,BUMA.1121.00083,1,280681,318526,-,37845
522,BUMA.1121.00078,1,650105,687965,-,37860
522,BUMA.1121.00095,1,374387,412242,-,37855
522,BUMA.1121.00077,1,3964406,4002289,+,37883
522,BUMA.1121.00063,1,1252848,1290693,+,37845
522,BUMA.1121.00061,1,1255775,1293620,+,37845
522,BUMA.1121.00050,1,2768625,2806463,+,37838
522,BUMA.1121.00081,1,1892821,1930659,-,37838
522,BUMA.1121.00074,1,2543035,2580880,-,37845
522,BUMA.1121.00062,1,3265990,3303834,-,37844
522,BUMA.1121.00060,1,973224,1011068,-,37844
522,BUMA.1121.00070,1,1226743,1264588,+,37845
522,BUMA.1121.00075,1,767646,805505,+,37859
522,BUMA.1121.00041,1,2576563,2614453,+,37890
522,BUMA.1121.00073,1,1253953,1291798,+,37845
522,BUMA.1121.00017,1,1640286,1678142,+,37856
522,BUMA.1121.00066,1,1229906,1267751,+,37845
522,BUMA.1121.00107,1,1175648,1213489,+,37841
522,BUMA.1121.00085,1,1101787,1139643,+,37856
522,BUMA.1121.00030,1,1640339,1678195,+,37856
522,BUMA.1121.00112,1,1748951,1786805,-,37854
522,BUMA.1121.00002,1,2849732,2887588,+,37856
522,BUMA.1121.00082,1,1386306,1424151,+,37845
522,BUMA.1121.00014,1,1473484,1511338,-,37854
522,BUMA.1121.00011,1,282179,320040,-,37861
522,BUMA.1121.00019,1,1705327,1743183,+,37856
522,BUMA.1121.00057,1,2354117,2391962,+,37845
522,BUMA.1121.00018,1,1866993,1904852,+,37859
522,BUMA.1121.00039,1,1408315,1446100,+,37785
522,BUMA.1121.00016,1,3432354,3470212,+,37858
522,BUMA.1121.00004,1,1706461,1744317,+,37856
522,BUMA.1121.00005,1,2283989,2321833,-,37844
522,BUMA.1121.00100,1,41,37908,-,37867
522,BUMA.1121.00006,1,1892608,1930446,-,37838
523,BUMA.1121.00027,1,3503828,3507658,+,3830
523,BUMA.1121.00025,1,1351190,1355020,-,3830
523,BUMA.1121.00021,1,1947784,1951614,+,3830
523,BUMA.1121.00023,1,3723930,3727760,+,3830
523,BUMA.1121.00024,1,1743060,1746890,+,3830
523,BUMA.1121.00033,1,3533706,3537536,+,3830
523,BUMA.1121.00034,1,1780515,1784345,+,3830
523,BUMA.1121.00036,1,2366511,2370341,-,3830
523,BUMA.1121.00032,1,3273588,3277418,+,3830
523,BUMA.1121.00009,1,280925,284755,-,3830
523,BUMA.1121.00008,1,1756160,1759990,+,3830
523,BUMA.1121.00003,1,3781835,3785665,+,3830
523,BUMA.1121.00109,1,570390,574163,-,3773
523,BUMA.1121.00053,1,1034685,1038515,+,3830
523,BUMA.1121.00110,1,3486207,3490037,-,3830
523,BUMA.1121.00104,1,9185,13015,-,3830
523,BUMA.1121.00086,1,429442,433272,+,3830
523,BUMA.1121.00092,1,2565822,2569652,-,3830
523,BUMA.1121.00096,1,1964221,1968051,-,3830
523,BUMA.1121.00054,1,2250458,2254288,+,3830
523,BUMA.1121.00097,1,2698811,2702641,-,3830
523,BUMA.1121.00093,1,2056763,2060593,+,3830
523,BUMA.1121.00106,1,1051572,1055402,+,3830
523,BUMA.1121.00010,1,2865425,2869255,+,3830
523,BUMA.1121.00035,1,2465085,2468915,+,3830
523,BUMA.1121.00108,1,2284601,2288431,+,3830
523,BUMA.1121.00028,1,1743095,1746925,+,3830
523,BUMA.1121.00094,1,1329709,1333539,+,3830
523,BUMA.1121.00102,1,4101851,4105681,-,3830
523,BUMA.1121.00111,1,1461819,1465649,+,3830
523,BUMA.1121.00089,1,1298372,1302202,+,3830
523,BUMA.1121.00084,1,1537065,1540895,+,3830
523,BUMA.1121.00029,1,3616840,3620670,-,3830
523,BUMA.1121.00012,1,4132720,4136550,+,3830
523,BUMA.1121.00087,1,2883500,2887330,-,3830
523,BUMA.1121.00043,1,1366146,1369976,+,3830
523,BUMA.1121.00046,1,3450558,3454388,-,3830
523,BUMA.1121.00037,1,3961902,3965732,+,3830
523,BUMA.1121.00080,1,1328331,1332161,+,3830
523,BUMA.1121.00079,1,1323484,1327314,+,3830
523,BUMA.1121.00045,1,2743659,2747489,-,3830
523,BUMA.1121.00071,1,1283670,1287500,+,3830
523,BUMA.1121.00056,1,2623698,2627528,-,3830
523,BUMA.1121.00065,1,1410539,1414369,+,3830
523,BUMA.1121.00058,1,3252268,3256098,-,3830
523,BUMA.1121.00007,1,2806556,2810386,-,3830
523,BUMA.1121.00067,1,3108450,3112280,-,3830
523,BUMA.1121.00090,1,3465495,3469325,+,3830
523,BUMA.1121.00051,1,1301156,1304986,+,3830
523,BUMA.1121.00020,1,1808045,1811875,+,3830
523,BUMA.1121.00103,1,3098946,3102776,-,3830
523,BUMA.1121.00048,1,1681449,1685279,-,3830
523,BUMA.1121.00047,1,1645450,1649280,-,3830
523,BUMA.1121.00042,1,2617362,2621182,-,3820
523,BUMA.1121.00055,1,897339,901169,+,3830
523,BUMA.1121.00031,1,2743545,2747375,+,3830
523,BUMA.1121.00040,1,1672105,1675935,+,3830
523,BUMA.1121.00044,1,1008613,1012443,+,3830
523,BUMA.1121.00088,1,2207436,2211266,+,3830
523,BUMA.1121.00069,1,1246774,1250604,+,3830
523,BUMA.1121.00064,1,1317376,1321206,+,3830
523,BUMA.1121.00105,1,3922922,3926752,-,3830
523,BUMA.1121.00015,1,1154245,1158075,+,3830
523,BUMA.1121.00059,1,519698,523528,+,3830
523,BUMA.1121.00026,1,205912,209742,-,3830
523,BUMA.1121.00022,1,2078718,2082548,+,3830
523,BUMA.1121.00052,1,1542734,1546564,+,3830
523,BUMA.1121.00101,1,1178749,1182522,-,3773
523,BUMA.1121.00001,1,2741527,2745357,-,3830
523,BUMA.1121.00038,1,1888871,1892701,-,3830
523,BUMA.1121.00068,1,51375,55205,+,3830
523,BUMA.1121.00099,1,1081152,1084982,-,3830
523,BUMA.1121.00091,1,3238668,3242498,-,3830
523,BUMA.1121.00098,1,4073647,4077477,+,3830
523,BUMA.1121.00013,1,1743627,1747457,+,3830
523,BUMA.1121.00049,1,569737,573567,-,3830
523,BUMA.1121.00072,1,1266286,1270116,+,3830
523,BUMA.1121.00076,1,70315,74145,-,3830
523,BUMA.1121.00083,1,276850,280680,-,3830
523,BUMA.1121.00078,1,646276,650104,-,3828
523,BUMA.1121.00095,1,370556,374386,-,3830
523,BUMA.1121.00077,1,4002291,4006121,+,3830
523,BUMA.1121.00063,1,1290695,1294525,+,3830
523,BUMA.1121.00061,1,1293622,1297452,+,3830
523,BUMA.1121.00050,1,2806465,2810295,+,3830
523,BUMA.1121.00081,1,1888990,1892820,-,3830
523,BUMA.1121.00074,1,2539204,2543034,-,3830
523,BUMA.1121.00062,1,3262159,3265989,-,3830
523,BUMA.1121.00060,1,969393,973223,-,3830
523,BUMA.1121.00070,1,1264590,1268420,+,3830
523,BUMA.1121.00075,1,805507,809337,+,3830
523,BUMA.1121.00041,1,2614455,2618285,+,3830
523,BUMA.1121.00073,1,1291800,1295630,+,3830
523,BUMA.1121.00017,1,1678144,1681974,+,3830
523,BUMA.1121.00066,1,1267753,1271583,+,3830
523,BUMA.1121.00107,1,1213491,1217321,+,3830
523,BUMA.1121.00085,1,1139645,1143475,+,3830
523,BUMA.1121.00030,1,1678197,1682027,+,3830
523,BUMA.1121.00112,1,1745120,1748950,-,3830
523,BUMA.1121.00002,1,2887590,2891420,+,3830
523,BUMA.1121.00082,1,1424153,1427983,+,3830
523,BUMA.1121.00014,1,1469653,1473483,-,3830
523,BUMA.1121.00011,1,278347,282178,-,3831
523,BUMA.1121.00019,1,1743185,1747015,+,3830
523,BUMA.1121.00057,1,2391964,2395794,+,3830
523,BUMA.1121.00018,1,1904854,1908684,+,3830
523,BUMA.1121.00039,1,1446102,1449932,+,3830
523,BUMA.1121.00016,1,3470214,3474044,+,3830
523,BUMA.1121.00004,1,1744319,1748149,+,3830
523,BUMA.1121.00005,1,2280158,2283988,-,3830
523,BUMA.1121.00100,1,4018012,4021787,-,3775
523,BUMA.1121.00006,1,1888777,1892607,-,3830
524,BUMA.1121.00027,1,3606001,3629470,+,23469
524,BUMA.1121.00025,1,1229456,1253078,-,23622
524,BUMA.1121.00021,1,2065641,2089279,+,23638
524,BUMA.1121.00023,1,3827011,3850700,+,23689
524,BUMA.1121.00024,1,1810537,1834061,+,23524
524,BUMA.1121.00033,1,3674728,3698288,+,23560
524,BUMA.1121.00034,1,1848020,1871547,+,23527
524,BUMA.1121.00036,1,2279515,2302973,-,23458
524,BUMA.1121.00032,1,3341000,3364539,+,23539
524,BUMA.1121.00009,1,159228,182828,-,23600
524,BUMA.1121.00008,1,1823608,1847134,+,23526
524,BUMA.1121.00003,1,3882261,3905967,+,23706
524,BUMA.1121.00109,1,490970,514645,-,23675
524,BUMA.1121.00053,1,1137888,1161438,+,23550
524,BUMA.1121.00110,1,3364544,3388132,-,23588
524,BUMA.1121.00104,1,3802881,3826524,-,23643
524,BUMA.1121.00086,1,496975,520481,+,23506
524,BUMA.1121.00092,1,2444042,2467702,-,23660
524,BUMA.1121.00096,1,1840994,1864612,-,23618
524,BUMA.1121.00054,1,981238,1004708,+,23470
524,BUMA.1121.00097,1,2577053,2600600,-,23547
524,BUMA.1121.00093,1,2158635,2182277,+,23642
524,BUMA.1121.00106,1,1164053,1187639,+,23586
524,BUMA.1121.00010,1,2933807,2957349,+,23542
524,BUMA.1121.00035,1,2567169,2590635,+,23466
524,BUMA.1121.00108,1,2386534,2410053,+,23519
524,BUMA.1121.00028,1,1810584,1834108,+,23524
524,BUMA.1121.00094,1,1441852,1465496,+,23644
524,BUMA.1121.00102,1,3979579,4003086,-,23507
524,BUMA.1121.00111,1,1563682,1587252,+,23570
524,BUMA.1121.00089,1,1410494,1434138,+,23644
524,BUMA.1121.00084,1,1638957,1662556,+,23599
524,BUMA.1121.00029,1,3493880,3517336,-,23456
524,BUMA.1121.00012,1,106930,130553,+,23623
524,BUMA.1121.00087,1,2796277,2819783,-,23506
524,BUMA.1121.00043,1,1468358,1491962,+,23604
524,BUMA.1121.00046,1,2314965,2338438,+,23473
524,BUMA.1121.00037,1,36358,60004,+,23646
524,BUMA.1121.00080,1,1440498,1464055,+,23557
524,BUMA.1121.00079,1,1435716,1459405,+,23689
524,BUMA.1121.00045,1,2622232,2645809,-,23577
524,BUMA.1121.00071,1,1385467,1408941,+,23474
524,BUMA.1121.00056,1,2491762,2515406,-,23644
524,BUMA.1121.00065,1,1512322,1535786,+,23464
524,BUMA.1121.00058,1,3130597,3154241,-,23644
524,BUMA.1121.00007,1,2683685,2707324,-,23639
524,BUMA.1121.00067,1,2975226,2998836,-,23610
524,BUMA.1121.00090,1,3567500,3591162,+,23662
524,BUMA.1121.00051,1,1413295,1436949,+,23654
524,BUMA.1121.00020,1,1875417,1898944,+,23527
524,BUMA.1121.00103,1,2977352,3000876,-,23524
524,BUMA.1121.00048,1,2931081,2954551,-,23470
524,BUMA.1121.00047,1,1513415,1537079,-,23664
524,BUMA.1121.00042,1,2529238,2552740,-,23502
524,BUMA.1121.00055,1,999173,1022696,+,23523
524,BUMA.1121.00031,1,2846731,2870317,+,23586
524,BUMA.1121.00040,1,1739636,1763133,+,23497
524,BUMA.1121.00044,1,1076146,1099673,+,23527
524,BUMA.1121.00088,1,2309611,2333234,+,23623
524,BUMA.1121.00069,1,1348601,1372048,+,23447
524,BUMA.1121.00064,1,1419176,1442696,+,23520
524,BUMA.1121.00105,1,3801127,3824637,-,23510
524,BUMA.1121.00015,1,2804951,2828406,+,23455
524,BUMA.1121.00059,1,621387,645050,+,23663
524,BUMA.1121.00026,1,118544,142245,-,23701
524,BUMA.1121.00022,1,2146412,2169916,+,23504
524,BUMA.1121.00052,1,1609130,1632609,+,23479
524,BUMA.1121.00101,1,1057187,1080650,-,23463
524,BUMA.1121.00001,1,2619775,2643244,-,23469
524,BUMA.1121.00038,1,3138397,3161867,-,23470
524,BUMA.1121.00068,1,155014,178644,+,23630
524,BUMA.1121.00099,1,957441,981135,-,23694
524,BUMA.1121.00091,1,3116991,3140692,-,23701
524,BUMA.1121.00098,1,4177066,4200667,+,23601
524,BUMA.1121.00013,1,1810097,1833573,+,23476
524,BUMA.1121.00049,1,437873,461519,-,23646
524,BUMA.1121.00072,1,1368041,1391515,+,23474
524,BUMA.1121.00076,1,3881850,3905466,-,23616
524,BUMA.1121.00083,1,155295,178776,-,23481
524,BUMA.1121.00078,1,524751,548312,-,23561
524,BUMA.1121.00095,1,248936,272547,-,23611
524,BUMA.1121.00077,1,94640,118227,+,23587
524,BUMA.1121.00063,1,1392513,1415950,+,23437
524,BUMA.1121.00061,1,1395437,1418907,+,23470
524,BUMA.1121.00050,1,413277,436750,-,23473
524,BUMA.1121.00081,1,3138582,3162052,-,23470
524,BUMA.1121.00074,1,2417543,2441127,-,23584
524,BUMA.1121.00062,1,3140243,3163855,-,23612
524,BUMA.1121.00060,1,847972,871550,-,23578
524,BUMA.1121.00070,1,1366416,1389848,+,23432
524,BUMA.1121.00075,1,907491,931139,+,23648
524,BUMA.1121.00041,1,2717381,2740965,+,23584
524,BUMA.1121.00073,1,1393645,1417079,+,23434
524,BUMA.1121.00017,1,1745670,1769197,+,23527
524,BUMA.1121.00066,1,1369562,1393002,+,23440
524,BUMA.1121.00107,1,1315623,1339181,+,23558
524,BUMA.1121.00085,1,1206075,1229554,+,23479
524,BUMA.1121.00030,1,1745726,1769253,+,23527
524,BUMA.1121.00112,1,1576253,1599806,-,23553
524,BUMA.1121.00002,1,2956079,2979650,+,23571
524,BUMA.1121.00082,1,1526036,1549517,+,23481
524,BUMA.1121.00014,1,1346641,1370206,-,23565
524,BUMA.1121.00011,1,156512,180135,-,23623
524,BUMA.1121.00019,1,1810662,1834183,+,23521
524,BUMA.1121.00057,1,2494027,2517617,+,23590
524,BUMA.1121.00018,1,2006689,2030317,+,23628
524,BUMA.1121.00039,1,1550343,1573978,+,23635
524,BUMA.1121.00016,1,3572322,3595899,+,23577
524,BUMA.1121.00004,1,1811812,1835345,+,23533
524,BUMA.1121.00005,1,92691,116234,+,23543
524,BUMA.1121.00100,1,3896096,3919861,-,23765
524,BUMA.1121.00006,1,3138474,3161944,-,23470
525,BUMA.1121.00027,1,3629792,3638661,+,8869
525,BUMA.1121.00025,1,1220216,1229134,-,8918
525,BUMA.1121.00021,1,2089601,2098588,+,8987
525,BUMA.1121.00023,1,3851022,3859919,+,8897
525,BUMA.1121.00024,1,1834383,1843307,+,8924
525,BUMA.1121.00033,1,3698610,3707545,+,8935
525,BUMA.1121.00034,1,1871869,1880784,+,8915
525,BUMA.1121.00036,1,2270350,2279193,-,8843
525,BUMA.1121.00032,1,3364861,3373791,+,8930
525,BUMA.1121.00009,1,149936,158896,-,8960
525,BUMA.1121.00008,1,1847456,1856380,+,8924
525,BUMA.1121.00003,1,3906289,3915206,+,8917
525,BUMA.1121.00109,1,481769,490648,-,8879
525,BUMA.1121.00053,1,1161760,1170603,+,8843
525,BUMA.1121.00110,1,3355270,3364222,-,8952
525,BUMA.1121.00104,1,3793633,3802559,-,8926
525,BUMA.1121.00086,1,520803,529649,+,8846
525,BUMA.1121.00092,1,2434811,2443720,-,8909
525,BUMA.1121.00096,1,1831754,1840672,-,8918
525,BUMA.1121.00054,1,1005030,1013906,+,8876
525,BUMA.1121.00097,1,2567851,2576731,-,8880
525,BUMA.1121.00093,1,2182599,2191508,+,8909
525,BUMA.1121.00106,1,1187961,1196912,+,8951
525,BUMA.1121.00010,1,2957671,2966571,+,8900
525,BUMA.1121.00035,1,2590957,2599839,+,8882
525,BUMA.1121.00108,1,2410385,2419284,+,8899
525,BUMA.1121.00028,1,1834430,1843354,+,8924
525,BUMA.1121.00094,1,1465818,1474669,+,8851
525,BUMA.1121.00102,1,3970365,3979257,-,8892
525,BUMA.1121.00111,1,1587574,1596471,+,8897
525,BUMA.1121.00089,1,1434460,1443323,+,8863
525,BUMA.1121.00084,1,1662878,1671706,+,8828
525,BUMA.1121.00029,1,3484676,3493559,-,8883
525,BUMA.1121.00012,1,130875,139838,+,8963
525,BUMA.1121.00087,1,2787109,2795955,-,8846
525,BUMA.1121.00043,1,1492284,1501140,+,8856
525,BUMA.1121.00046,1,2338760,2347729,+,8969
525,BUMA.1121.00037,1,60326,69225,+,8899
525,BUMA.1121.00080,1,1464377,1473369,+,8992
525,BUMA.1121.00079,1,1459727,1468668,+,8941
525,BUMA.1121.00045,1,2613006,2621910,-,8904
525,BUMA.1121.00071,1,1409263,1418177,+,8914
525,BUMA.1121.00056,1,2482577,2491440,-,8863
525,BUMA.1121.00065,1,1536108,1544998,+,8890
525,BUMA.1121.00058,1,3121354,3130275,-,8921
525,BUMA.1121.00007,1,2674307,2683363,-,9056
525,BUMA.1121.00067,1,2966003,2974904,-,8901
525,BUMA.1121.00090,1,3591484,3600366,+,8882
525,BUMA.1121.00051,1,1437271,1446109,+,8838
525,BUMA.1121.00020,1,1899266,1908181,+,8915
525,BUMA.1121.00103,1,2968175,2977030,-,8855
525,BUMA.1121.00048,1,2921883,2930759,-,8876
525,BUMA.1121.00047,1,1504236,1513093,-,8857
525,BUMA.1121.00042,1,2519988,2528916,-,8928
525,BUMA.1121.00055,1,1023018,1031918,+,8900
525,BUMA.1121.00031,1,2870639,2879556,+,8917
525,BUMA.1121.00040,1,1763455,1772384,+,8929
525,BUMA.1121.00044,1,1099995,1108910,+,8915
525,BUMA.1121.00088,1,2333556,2342456,+,8900
525,BUMA.1121.00069,1,1372370,1381249,+,8879
525,BUMA.1121.00064,1,1443018,1451911,+,8893
525,BUMA.1121.00105,1,3791906,3800805,-,8899
525,BUMA.1121.00015,1,2828728,2837652,+,8924
525,BUMA.1121.00059,1,645372,654268,+,8896
525,BUMA.1121.00026,1,109286,118222,-,8936
525,BUMA.1121.00022,1,2170238,2179093,+,8855
525,BUMA.1121.00052,1,1632931,1641876,+,8945
525,BUMA.1121.00101,1,1047979,1056865,-,8886
525,BUMA.1121.00001,1,2610574,2619453,-,8879
525,BUMA.1121.00038,1,3129199,3138075,-,8876
525,BUMA.1121.00068,1,178966,187890,+,8924
525,BUMA.1121.00099,1,948243,957127,-,8884
525,BUMA.1121.00091,1,3107752,3116669,-,8917
525,BUMA.1121.00098,1,4201851,4210716,+,8865
525,BUMA.1121.00013,1,1833895,1842846,+,8951
525,BUMA.1121.00049,1,428649,437551,-,8902
525,BUMA.1121.00072,1,1391837,1400751,+,8914
525,BUMA.1121.00076,1,3872561,3881528,-,8967
525,BUMA.1121.00083,1,146058,154973,-,8915
525,BUMA.1121.00078,1,515440,524429,-,8989
525,BUMA.1121.00095,1,239685,248614,-,8929
525,BUMA.1121.00077,1,118549,127501,+,8952
525,BUMA.1121.00063,1,1416272,1425186,+,8914
525,BUMA.1121.00061,1,1419229,1428143,+,8914
525,BUMA.1121.00050,1,403986,412955,-,8969
525,BUMA.1121.00081,1,3129384,3138260,-,8876
525,BUMA.1121.00074,1,2408311,2417221,-,8910
525,BUMA.1121.00062,1,3130974,3139921,-,8947
525,BUMA.1121.00060,1,838755,847650,-,8895
525,BUMA.1121.00070,1,1390170,1399084,+,8914
525,BUMA.1121.00075,1,931461,940435,+,8974
525,BUMA.1121.00041,1,2741287,2750159,+,8872
525,BUMA.1121.00073,1,1417401,1426315,+,8914
525,BUMA.1121.00017,1,1769519,1778425,+,8906
525,BUMA.1121.00066,1,1393324,1402238,+,8914
525,BUMA.1121.00107,1,1339503,1348450,+,8947
525,BUMA.1121.00085,1,1229876,1238821,+,8945
525,BUMA.1121.00030,1,1769575,1778490,+,8915
525,BUMA.1121.00112,1,1566996,1575931,-,8935
525,BUMA.1121.00002,1,2979972,2988878,+,8906
525,BUMA.1121.00082,1,1549839,1558753,+,8914
525,BUMA.1121.00014,1,1337453,1346319,-,8866
525,BUMA.1121.00011,1,147218,156180,-,8962
525,BUMA.1121.00019,1,1834505,1843420,+,8915
525,BUMA.1121.00057,1,2517939,2526785,+,8846
525,BUMA.1121.00018,1,2030639,2039527,+,8888
525,BUMA.1121.00039,1,1574300,1583217,+,8917
525,BUMA.1121.00016,1,3596221,3605076,+,8855
525,BUMA.1121.00004,1,1835667,1844600,+,8933
525,BUMA.1121.00005,1,116556,125486,+,8930
525,BUMA.1121.00100,1,3886812,3895844,-,9032
525,BUMA.1121.00006,1,3129276,3138152,-,8876
526,BUMA.1121.00027,1,3638970,3642724,+,3754
526,BUMA.1121.00025,1,1215996,1219907,-,3911
526,BUMA.1121.00021,1,2098897,2103098,+,4201
526,BUMA.1121.00023,1,3860228,3864052,+,3824
526,BUMA.1121.00024,1,1843616,1847314,+,3698
526,BUMA.1121.00033,1,3707854,3711668,+,3814
526,BUMA.1121.00034,1,1881093,1884777,+,3684
526,BUMA.1121.00036,1,2266336,2270041,-,3705
526,BUMA.1121.00032,1,3374100,3377798,+,3698
526,BUMA.1121.00009,1,145832,149627,-,3795
526,BUMA.1121.00008,1,1856689,1860405,+,3716
526,BUMA.1121.00003,1,59,3777,+,3718
526,BUMA.1121.00109,1,477572,481460,-,3888
526,BUMA.1121.00053,1,1170912,1174560,+,3648
526,BUMA.1121.00110,1,3351243,3354961,-,3718
526,BUMA.1121.00104,1,3789357,3793324,-,3967
526,BUMA.1121.00086,1,529958,533680,+,3722
526,BUMA.1121.00092,1,2430602,2434502,-,3900
526,BUMA.1121.00096,1,1827615,1831445,-,3830
526,BUMA.1121.00054,1,1014215,1017804,+,3589
526,BUMA.1121.00097,1,2563782,2567543,-,3761
526,BUMA.1121.00093,1,2191817,2195717,+,3900
526,BUMA.1121.00106,1,1197221,1201095,+,3874
526,BUMA.1121.00010,1,2966880,2970482,+,3602
526,BUMA.1121.00035,1,2600148,2604050,+,3902
526,BUMA.1121.00108,1,2419593,2423373,+,3780
526,BUMA.1121.00028,1,1843663,1847361,+,3698
526,BUMA.1121.00094,1,1474978,1478884,+,3906
526,BUMA.1121.00102,1,3966381,3970056,-,3675
526,BUMA.1121.00111,1,1596780,1600987,+,4207
526,BUMA.1121.00089,1,1443632,1447526,+,3894
526,BUMA.1121.00084,1,1672015,1675975,+,3960
526,BUMA.1121.00029,1,3480424,3484367,-,3943
526,BUMA.1121.00012,1,140147,143901,+,3754
526,BUMA.1121.00087,1,2783078,2786800,-,3722
526,BUMA.1121.00043,1,1501449,1505558,+,4109
526,BUMA.1121.00046,1,2348038,2351796,+,3758
526,BUMA.1121.00037,1,69534,73563,+,4029
526,BUMA.1121.00080,1,1473678,1477415,+,3737
526,BUMA.1121.00079,1,1468977,1472757,+,3780
526,BUMA.1121.00045,1,2608814,2612697,-,3883
526,BUMA.1121.00071,1,1418486,1422274,+,3788
526,BUMA.1121.00056,1,2478499,2482269,-,3770
526,BUMA.1121.00065,1,1545307,1549315,+,4008
526,BUMA.1121.00058,1,3117380,3121045,-,3665
526,BUMA.1121.00007,1,2670031,2673998,-,3967
526,BUMA.1121.00067,1,2961811,2965694,-,3883
526,BUMA.1121.00090,1,3600675,3604704,+,4029
526,BUMA.1121.00051,1,1446418,1450317,+,3899
526,BUMA.1121.00020,1,1908490,1912269,+,3779
526,BUMA.1121.00103,1,2964072,2967866,-,3794
526,BUMA.1121.00048,1,2917985,2921574,-,3589
526,BUMA.1121.00047,1,1500023,1503927,-,3904
526,BUMA.1121.00042,1,2515975,2519679,-,3704
526,BUMA.1121.00055,1,1032227,1036145,+,3918
526,BUMA.1121.00031,1,2879865,2883747,+,3882
526,BUMA.1121.00040,1,1772693,1776474,+,3781
526,BUMA.1121.00044,1,1109219,1112917,+,3698
526,BUMA.1121.00088,1,2342765,2346636,+,3871
526,BUMA.1121.00069,1,1381558,1385367,+,3809
526,BUMA.1121.00064,1,1452220,1456022,+,3802
526,BUMA.1121.00105,1,3787807,3791597,-,3790
526,BUMA.1121.00015,1,2837961,2841601,+,3640
526,BUMA.1121.00059,1,654577,658785,+,4208
526,BUMA.1121.00026,1,105215,108977,-,3762
526,BUMA.1121.00022,1,2179402,2183209,+,3807
526,BUMA.1121.00052,1,1642185,1645915,+,3730
526,BUMA.1121.00101,1,1043953,1047670,-,3717
526,BUMA.1121.00001,1,2606399,2610265,-,3866
526,BUMA.1121.00038,1,3125301,3128890,-,3589
526,BUMA.1121.00068,1,188199,191837,+,3638
526,BUMA.1121.00099,1,944201,947934,-,3733
526,BUMA.1121.00091,1,3103586,3107443,-,3857
526,BUMA.1121.00098,1,4211025,4214868,+,3843
526,BUMA.1121.00013,1,1843155,1847009,+,3854
526,BUMA.1121.00049,1,424633,428339,-,3706
526,BUMA.1121.00072,1,1401060,1404727,+,3667
526,BUMA.1121.00076,1,3868517,3872252,-,3735
526,BUMA.1121.00083,1,141940,145749,-,3809
526,BUMA.1121.00078,1,511162,515132,-,3970
526,BUMA.1121.00095,1,235723,239376,-,3653
526,BUMA.1121.00077,1,127808,131587,+,3779
526,BUMA.1121.00063,1,1425495,1429304,+,3809
526,BUMA.1121.00061,1,1428452,1432261,+,3809
526,BUMA.1121.00050,1,399940,403677,-,3737
526,BUMA.1121.00081,1,3125493,3129075,-,3582
526,BUMA.1121.00074,1,2404166,2408002,-,3836
526,BUMA.1121.00062,1,3126860,3130665,-,3805
526,BUMA.1121.00060,1,834556,838446,-,3890
526,BUMA.1121.00070,1,1399393,1403188,+,3795
526,BUMA.1121.00075,1,940743,944487,+,3744
526,BUMA.1121.00041,1,2750468,2754552,+,4084
526,BUMA.1121.00073,1,1426624,1430433,+,3809
526,BUMA.1121.00017,1,1778734,1782423,+,3689
526,BUMA.1121.00066,1,1402547,1406342,+,3795
526,BUMA.1121.00107,1,1348759,1352444,+,3685
526,BUMA.1121.00085,1,1239130,1242860,+,3730
526,BUMA.1121.00030,1,1778799,1782497,+,3698
526,BUMA.1121.00112,1,1562867,1566687,-,3820
526,BUMA.1121.00002,1,2989187,2992843,+,3656
526,BUMA.1121.00082,1,1559062,1562871,+,3809
526,BUMA.1121.00014,1,1333381,1337144,-,3763
526,BUMA.1121.00011,1,143183,146909,-,3726
526,BUMA.1121.00019,1,1843729,1847472,+,3743
526,BUMA.1121.00057,1,2527094,2530907,+,3813
526,BUMA.1121.00018,1,2039836,2043792,+,3956
526,BUMA.1121.00039,1,1583526,1587694,+,4168
526,BUMA.1121.00016,1,3605385,3609237,+,3852
526,BUMA.1121.00004,1,1844909,1848598,+,3689
526,BUMA.1121.00005,1,125795,129576,+,3781
526,BUMA.1121.00100,1,3882753,3886503,-,3750
526,BUMA.1121.00006,1,3125378,3128967,-,3589
527,BUMA.1121.00027,1,3642725,3668396,+,25671
527,BUMA.1121.00025,1,1190404,1215994,-,25590
527,BUMA.1121.00021,1,2103099,2128726,+,25627
527,BUMA.1121.00023,1,3864053,3889709,+,25656
527,BUMA.1121.00024,1,1848563,1874213,+,25650
527,BUMA.1121.00033,1,3711669,3737247,+,25578
527,BUMA.1121.00034,1,1886026,1911684,+,25658
527,BUMA.1121.00036,1,2239334,2265085,-,25751
527,BUMA.1121.00032,1,3379047,3404697,+,25650
527,BUMA.1121.00009,1,120158,145830,-,25672
527,BUMA.1121.00008,1,1861654,1887304,+,25650
527,BUMA.1121.00003,1,3778,29391,+,25613
527,BUMA.1121.00109,1,451798,477570,-,25772
527,BUMA.1121.00053,1,1174561,1200173,+,25612
527,BUMA.1121.00110,1,3325496,3351241,-,25745
527,BUMA.1121.00104,1,3763632,3789355,-,25723
527,BUMA.1121.00086,1,534930,560610,+,25680
527,BUMA.1121.00092,1,2404835,2430600,-,25765
527,BUMA.1121.00096,1,1801932,1827613,-,25681
527,BUMA.1121.00054,1,3328205,3353992,-,25787
527,BUMA.1121.00097,1,2538120,2563780,-,25660
527,BUMA.1121.00093,1,2195718,2221483,+,25765
527,BUMA.1121.00106,1,1201096,1226787,+,25691
527,BUMA.1121.00010,1,2971731,2997441,+,25710
527,BUMA.1121.00035,1,2604051,2629740,+,25689
527,BUMA.1121.00108,1,2423374,2449019,+,25645
527,BUMA.1121.00028,1,1848610,1874260,+,25650
527,BUMA.1121.00094,1,1478885,1504645,+,25760
527,BUMA.1121.00102,1,3940554,3966379,-,25825
527,BUMA.1121.00111,1,1600988,1626743,+,25755
527,BUMA.1121.00089,1,1447527,1473320,+,25793
527,BUMA.1121.00084,1,1675976,1701765,+,25789
527,BUMA.1121.00029,1,3454753,3480422,-,25669
527,BUMA.1121.00012,1,143902,169529,+,25627
527,BUMA.1121.00087,1,2756147,2781827,-,25680
527,BUMA.1121.00043,1,1505559,1531213,+,25654
527,BUMA.1121.00046,1,2353045,2378720,+,25675
527,BUMA.1121.00037,1,73564,99232,+,25668
527,BUMA.1121.00080,1,1477416,1503222,+,25806
527,BUMA.1121.00079,1,1472758,1498515,+,25757
527,BUMA.1121.00045,1,2583129,2608812,-,25683
527,BUMA.1121.00071,1,1422275,1447875,+,25600
527,BUMA.1121.00056,1,2452704,2478497,-,25793
527,BUMA.1121.00065,1,1549316,1575160,+,25844
527,BUMA.1121.00058,1,3091693,3117378,-,25685
527,BUMA.1121.00007,1,2644354,2670029,-,25675
527,BUMA.1121.00067,1,2936110,2961809,-,25699
527,BUMA.1121.00090,1,3604705,3630348,+,25643
527,BUMA.1121.00051,1,1450318,1476030,+,25712
527,BUMA.1121.00020,1,1913518,1939168,+,25650
527,BUMA.1121.00103,1,2938334,2964070,-,25736
527,BUMA.1121.00048,1,581717,607503,+,25786
527,BUMA.1121.00047,1,1474092,1500021,-,25929
527,BUMA.1121.00042,1,2488992,2514726,-,25734
527,BUMA.1121.00055,1,1036146,1061884,+,25738
527,BUMA.1121.00031,1,2883748,2909415,+,25667
527,BUMA.1121.00040,1,1778963,1804803,+,25840
527,BUMA.1121.00044,1,1114166,1139824,+,25658
527,BUMA.1121.00088,1,2346637,2372389,+,25752
527,BUMA.1121.00069,1,1385368,1410974,+,25606
527,BUMA.1121.00064,1,1456023,1481743,+,25720
527,BUMA.1121.00105,1,3762038,3787805,-,25767
527,BUMA.1121.00015,1,2273636,2299343,-,25707
527,BUMA.1121.00059,1,658786,684520,+,25734
527,BUMA.1121.00026,1,78280,103966,-,25686
527,BUMA.1121.00022,1,2184457,2210218,+,25761
527,BUMA.1121.00052,1,1647164,1672880,+,25716
527,BUMA.1121.00101,1,1018362,1043951,-,25589
527,BUMA.1121.00001,1,2580704,2606397,-,25693
527,BUMA.1121.00038,1,789191,814977,+,25786
527,BUMA.1121.00068,1,191838,217659,+,25821
527,BUMA.1121.00099,1,918562,944199,-,25637
527,BUMA.1121.00091,1,3077831,3103584,-,25753
527,BUMA.1121.00098,1,4214869,4240564,+,25695
527,BUMA.1121.00013,1,1848259,1873960,+,25701
527,BUMA.1121.00049,1,398958,424631,-,25673
527,BUMA.1121.00072,1,1404728,1430318,+,25590
527,BUMA.1121.00076,1,3842730,3868515,-,25785
527,BUMA.1121.00083,1,116332,141938,-,25606
527,BUMA.1121.00078,1,485500,511160,-,25660
527,BUMA.1121.00095,1,210088,235721,-,25633
527,BUMA.1121.00077,1,131588,157335,+,25747
527,BUMA.1121.00063,1,1429305,1454886,+,25581
527,BUMA.1121.00061,1,1432262,1457799,+,25537
527,BUMA.1121.00050,1,373015,398691,-,25676
527,BUMA.1121.00081,1,789260,815046,+,25786
527,BUMA.1121.00074,1,2378495,2404164,-,25669
527,BUMA.1121.00062,1,3101182,3126858,-,25676
527,BUMA.1121.00060,1,808872,834554,-,25682
527,BUMA.1121.00070,1,1403189,1428789,+,25600
527,BUMA.1121.00075,1,944488,970281,+,25793
527,BUMA.1121.00041,1,2754553,2780253,+,25700
527,BUMA.1121.00073,1,1430434,1456040,+,25606
527,BUMA.1121.00017,1,1783672,1809330,+,25658
527,BUMA.1121.00066,1,1406343,1431919,+,25576
527,BUMA.1121.00107,1,1352445,1378090,+,25645
527,BUMA.1121.00085,1,1244109,1269825,+,25716
527,BUMA.1121.00030,1,1783746,1809404,+,25658
527,BUMA.1121.00112,1,1537101,1562865,-,25764
527,BUMA.1121.00002,1,2994091,3019864,+,25773
527,BUMA.1121.00082,1,1562872,1588478,+,25606
527,BUMA.1121.00014,1,1307697,1333379,-,25682
527,BUMA.1121.00011,1,117468,143181,-,25713
527,BUMA.1121.00019,1,1848721,1874371,+,25650
527,BUMA.1121.00057,1,2530908,2556549,+,25641
527,BUMA.1121.00018,1,2043793,2069384,+,25591
527,BUMA.1121.00039,1,1587695,1613324,+,25629
527,BUMA.1121.00016,1,3609238,3634945,+,25707
527,BUMA.1121.00004,1,1849847,1875497,+,25650
527,BUMA.1121.00005,1,129577,155247,+,25670
527,BUMA.1121.00100,1,3857064,3882751,-,25687
527,BUMA.1121.00006,1,789190,814971,+,25781
528,BUMA.1121.00027,1,3668398,3682779,+,14381
528,BUMA.1121.00025,1,1176002,1190403,-,14401
528,BUMA.1121.00021,1,2128728,2143130,+,14402
528,BUMA.1121.00023,1,3889711,3904098,+,14387
528,BUMA.1121.00024,1,1874215,1888616,+,14401
528,BUMA.1121.00033,1,3737249,3751665,+,14416
528,BUMA.1121.00034,1,1911686,1926087,+,14401
528,BUMA.1121.00036,1,2224932,2239333,-,14401
528,BUMA.1121.00032,1,3404699,3419100,+,14401
528,BUMA.1121.00009,1,105755,120157,-,14402
528,BUMA.1121.00008,1,1887306,1901707,+,14401
528,BUMA.1121.00003,1,29393,43778,+,14385
528,BUMA.1121.00109,1,437410,451797,-,14387
528,BUMA.1121.00053,1,1200175,1214575,+,14400
528,BUMA.1121.00110,1,3311098,3325495,-,14397
528,BUMA.1121.00104,1,3749233,3763631,-,14398
528,BUMA.1121.00086,1,560612,575013,+,14401
528,BUMA.1121.00092,1,2390432,2404834,-,14402
528,BUMA.1121.00096,1,1787531,1801931,-,14400
528,BUMA.1121.00054,1,3313803,3328204,-,14401
528,BUMA.1121.00097,1,2523721,2538119,-,14398
528,BUMA.1121.00093,1,2221485,2235887,+,14402
528,BUMA.1121.00106,1,1226789,1241187,+,14398
528,BUMA.1121.00010,1,2997443,3011844,+,14401
528,BUMA.1121.00035,1,2629742,2644141,+,14399
528,BUMA.1121.00108,1,2449021,2463385,+,14364
528,BUMA.1121.00028,1,1874262,1888663,+,14401
528,BUMA.1121.00094,1,1504647,1519047,+,14400
528,BUMA.1121.00102,1,3926140,3940553,-,14413
528,BUMA.1121.00111,1,1626745,1641147,+,14402
528,BUMA.1121.00089,1,1473322,1487720,+,14398
528,BUMA.1121.00084,1,1701767,1716164,+,14397
528,BUMA.1121.00029,1,3440353,3454752,-,14399
528,BUMA.1121.00012,1,169531,183918,+,14387
528,BUMA.1121.00087,1,2741745,2756146,-,14401
528,BUMA.1121.00043,1,1531215,1545632,+,14417
528,BUMA.1121.00046,1,2378722,2393123,+,14401
528,BUMA.1121.00037,1,99234,113636,+,14402
528,BUMA.1121.00080,1,1503224,1517624,+,14400
528,BUMA.1121.00079,1,1498517,1512915,+,14398
528,BUMA.1121.00045,1,2568741,2583128,-,14387
528,BUMA.1121.00071,1,1447877,1462275,+,14398
528,BUMA.1121.00056,1,2438304,2452703,-,14399
528,BUMA.1121.00065,1,1575162,1589579,+,14417
528,BUMA.1121.00058,1,3077276,3091692,-,14416
528,BUMA.1121.00007,1,2629973,2644353,-,14380
528,BUMA.1121.00067,1,2921726,2936109,-,14383
528,BUMA.1121.00090,1,3630350,3644752,+,14402
528,BUMA.1121.00051,1,1476032,1490431,+,14399
528,BUMA.1121.00020,1,1939170,1953571,+,14401
528,BUMA.1121.00103,1,2923964,2938333,-,14369
528,BUMA.1121.00048,1,607505,621906,+,14401
528,BUMA.1121.00047,1,1459685,1474091,-,14406
528,BUMA.1121.00042,1,2474575,2488991,-,14416
528,BUMA.1121.00055,1,1061886,1076271,+,14385
528,BUMA.1121.00031,1,2909417,2923819,+,14402
528,BUMA.1121.00040,1,1804805,1819206,+,14401
528,BUMA.1121.00044,1,1139826,1154227,+,14401
528,BUMA.1121.00088,1,2372391,2386790,+,14399
528,BUMA.1121.00069,1,1410976,1425374,+,14398
528,BUMA.1121.00064,1,1481745,1496128,+,14383
528,BUMA.1121.00105,1,3747637,3762037,-,14400
528,BUMA.1121.00015,1,2259234,2273635,-,14401
528,BUMA.1121.00059,1,684522,698920,+,14398
528,BUMA.1121.00026,1,63878,78279,-,14401
528,BUMA.1121.00022,1,2210220,2224621,+,14401
528,BUMA.1121.00052,1,1672882,1687283,+,14401
528,BUMA.1121.00101,1,1003943,1018361,-,14418
528,BUMA.1121.00001,1,2566304,2580703,-,14399
528,BUMA.1121.00038,1,814979,829380,+,14401
528,BUMA.1121.00068,1,217661,232064,+,14403
528,BUMA.1121.00099,1,904141,918561,-,14420
528,BUMA.1121.00091,1,3063430,3077830,-,14400
528,BUMA.1121.00098,1,1,14347,+,14346
528,BUMA.1121.00013,1,1873962,1888363,+,14401
528,BUMA.1121.00049,1,384559,398957,-,14398
528,BUMA.1121.00072,1,1430320,1444700,+,14380
528,BUMA.1121.00076,1,3828325,3842729,-,14404
528,BUMA.1121.00083,1,101933,116331,-,14398
528,BUMA.1121.00078,1,471086,485499,-,14413
528,BUMA.1121.00095,1,195704,210087,-,14383
528,BUMA.1121.00077,1,157337,171734,+,14397
528,BUMA.1121.00063,1,1454888,1469286,+,14398
528,BUMA.1121.00061,1,1457801,1472199,+,14398
528,BUMA.1121.00050,1,358613,373014,-,14401
528,BUMA.1121.00081,1,815048,829449,+,14401
528,BUMA.1121.00074,1,2364111,2378494,-,14383
528,BUMA.1121.00062,1,3086782,3101181,-,14399
528,BUMA.1121.00060,1,794484,808871,-,14387
528,BUMA.1121.00070,1,1428791,1443189,+,14398
528,BUMA.1121.00075,1,970283,984687,+,14404
528,BUMA.1121.00041,1,2780255,2794683,+,14428
528,BUMA.1121.00073,1,1456042,1470440,+,14398
528,BUMA.1121.00017,1,1809332,1823733,+,14401
528,BUMA.1121.00066,1,1431921,1446319,+,14398
528,BUMA.1121.00107,1,1378092,1392512,+,14420
528,BUMA.1121.00085,1,1269827,1284228,+,14401
528,BUMA.1121.00030,1,1809406,1823807,+,14401
528,BUMA.1121.00112,1,1522683,1537100,-,14417
528,BUMA.1121.00002,1,3019866,3034267,+,14401
528,BUMA.1121.00082,1,1588480,1602878,+,14398
528,BUMA.1121.00014,1,1293296,1307696,-,14400
528,BUMA.1121.00011,1,103096,117467,-,14371
528,BUMA.1121.00019,1,1874373,1888774,+,14401
528,BUMA.1121.00057,1,2556551,2570949,+,14398
528,BUMA.1121.00018,1,2069386,2083787,+,14401
528,BUMA.1121.00039,1,1613326,1627687,+,14361
528,BUMA.1121.00016,1,3634947,3649349,+,14402
528,BUMA.1121.00004,1,1875499,1889899,+,14400
528,BUMA.1121.00005,1,155249,169651,+,14402
528,BUMA.1121.00100,1,3842663,3857063,-,14400
528,BUMA.1121.00006,1,814973,829374,+,14401
529,BUMA.1121.00027,1,3684729,3692540,+,7811
529,BUMA.1121.00025,1,1166265,1174051,-,7786
529,BUMA.1121.00021,1,2145081,2152880,+,7799
529,BUMA.1121.00023,1,3934870,3942662,+,7792
529,BUMA.1121.00024,1,1890567,1898332,+,7765
529,BUMA.1121.00033,1,3753616,3761422,+,7806
529,BUMA.1121.00034,1,1928038,1935803,+,7765
529,BUMA.1121.00036,1,2215216,2222981,-,7765
529,BUMA.1121.00032,1,3421051,3428816,+,7765
529,BUMA.1121.00009,1,96058,103805,-,7747
529,BUMA.1121.00008,1,1903658,1911423,+,7765
529,BUMA.1121.00003,1,45730,53519,+,7789
529,BUMA.1121.00109,1,427679,435459,-,7780
529,BUMA.1121.00053,1,1216526,1224338,+,7812
529,BUMA.1121.00110,1,3301401,3309147,-,7746
529,BUMA.1121.00104,1,3739521,3747282,-,7761
529,BUMA.1121.00086,1,576964,584729,+,7765
529,BUMA.1121.00092,1,2325868,2333615,-,7747
529,BUMA.1121.00096,1,1777820,1785581,-,7761
529,BUMA.1121.00054,1,3304087,3311852,-,7765
529,BUMA.1121.00097,1,2455125,2462879,-,7754
529,BUMA.1121.00093,1,2292704,2300451,+,7747
529,BUMA.1121.00106,1,1243138,1250899,+,7761
529,BUMA.1121.00010,1,3013795,3021560,+,7765
529,BUMA.1121.00035,1,2646092,2653884,+,7792
529,BUMA.1121.00108,1,2465335,2473083,+,7748
529,BUMA.1121.00028,1,1890614,1898379,+,7765
529,BUMA.1121.00094,1,1520997,1528744,+,7747
529,BUMA.1121.00102,1,3916398,3924189,-,7791
529,BUMA.1121.00111,1,1643098,1650904,+,7806
529,BUMA.1121.00089,1,1489671,1497418,+,7747
529,BUMA.1121.00084,1,1826058,1833871,+,7813
529,BUMA.1121.00029,1,3430610,3438402,-,7792
529,BUMA.1121.00012,1,185869,193661,+,7792
529,BUMA.1121.00087,1,2732029,2739794,-,7765
529,BUMA.1121.00043,1,1547582,1555367,+,7785
529,BUMA.1121.00046,1,2395074,2402839,+,7765
529,BUMA.1121.00037,1,115587,123379,+,7792
529,BUMA.1121.00080,1,1519574,1527321,+,7747
529,BUMA.1121.00079,1,1514866,1522653,+,7787
529,BUMA.1121.00045,1,2558996,2566790,-,7794
529,BUMA.1121.00071,1,1464225,1472004,+,7779
529,BUMA.1121.00056,1,2428606,2436353,-,7747
529,BUMA.1121.00065,1,1591530,1599301,+,7771
529,BUMA.1121.00058,1,3067579,3075326,-,7747
529,BUMA.1121.00007,1,2564999,2572797,-,7798
529,BUMA.1121.00067,1,2911962,2919775,-,7813
529,BUMA.1121.00090,1,3673156,3680948,+,7792
529,BUMA.1121.00051,1,1492381,1500128,+,7747
529,BUMA.1121.00020,1,1955522,1963287,+,7765
529,BUMA.1121.00103,1,2914228,2922015,-,7787
529,BUMA.1121.00048,1,623857,631622,+,7765
529,BUMA.1121.00047,1,1449941,1457735,-,7794
529,BUMA.1121.00042,1,2463619,2471384,-,7765
529,BUMA.1121.00055,1,1078222,1085992,+,7770
529,BUMA.1121.00031,1,2925770,2933562,+,7792
529,BUMA.1121.00040,1,1821157,1828922,+,7765
529,BUMA.1121.00044,1,1156178,1163943,+,7765
529,BUMA.1121.00088,1,2388740,2396545,+,7805
529,BUMA.1121.00069,1,1427323,1435128,+,7805
529,BUMA.1121.00064,1,1498079,1505899,+,7820
529,BUMA.1121.00105,1,3737921,3745687,-,7766
529,BUMA.1121.00015,1,2249518,2257283,-,7765
529,BUMA.1121.00059,1,700872,708615,+,7743
529,BUMA.1121.00026,1,54629,62394,+,7765
529,BUMA.1121.00022,1,2226572,2234337,+,7765
529,BUMA.1121.00052,1,1689234,1696999,+,7765
529,BUMA.1121.00101,1,994219,1001992,-,7773
529,BUMA.1121.00001,1,2556561,2564353,-,7792
529,BUMA.1121.00038,1,831331,839096,+,7765
529,BUMA.1121.00068,1,234015,241801,+,7786
529,BUMA.1121.00099,1,894409,902190,-,7781
529,BUMA.1121.00091,1,3053669,3061479,-,7810
529,BUMA.1121.00098,1,16298,24031,+,7733
529,BUMA.1121.00013,1,1890314,1898079,+,7765
529,BUMA.1121.00049,1,373628,381349,-,7721
529,BUMA.1121.00072,1,1446650,1454455,+,7805
529,BUMA.1121.00076,1,3818589,3826374,-,7785
529,BUMA.1121.00083,1,92178,99983,-,7805
529,BUMA.1121.00078,1,461357,469136,-,7779
529,BUMA.1121.00095,1,185973,193753,-,7780
529,BUMA.1121.00077,1,173685,181431,+,7746
529,BUMA.1121.00063,1,1471236,1479041,+,7805
529,BUMA.1121.00061,1,1474149,1481954,+,7805
529,BUMA.1121.00050,1,348897,356662,-,7765
529,BUMA.1121.00081,1,831400,839165,+,7765
529,BUMA.1121.00074,1,2354340,2362160,-,7820
529,BUMA.1121.00062,1,3077045,3084832,-,7787
529,BUMA.1121.00060,1,784739,792533,-,7794
529,BUMA.1121.00070,1,1445139,1452943,+,7804
529,BUMA.1121.00075,1,986638,994423,+,7785
529,BUMA.1121.00041,1,2796633,2804405,+,7772
529,BUMA.1121.00073,1,1472390,1480194,+,7804
529,BUMA.1121.00017,1,1825684,1833449,+,7765
529,BUMA.1121.00066,1,1448269,1456074,+,7805
529,BUMA.1121.00107,1,1394462,1402238,+,7776
529,BUMA.1121.00085,1,1286179,1293944,+,7765
529,BUMA.1121.00030,1,1825758,1833523,+,7765
529,BUMA.1121.00112,1,1512950,1520747,-,7797
529,BUMA.1121.00002,1,3036218,3043983,+,7765
529,BUMA.1121.00082,1,1604828,1612633,+,7805
529,BUMA.1121.00014,1,1283546,1291345,-,7799
529,BUMA.1121.00011,1,93359,101145,-,7786
529,BUMA.1121.00019,1,1890725,1898490,+,7765
529,BUMA.1121.00057,1,2572899,2580705,+,7806
529,BUMA.1121.00018,1,2085738,2093523,+,7785
529,BUMA.1121.00039,1,1631011,1638794,+,7783
529,BUMA.1121.00016,1,3651300,3659099,+,7799
529,BUMA.1121.00004,1,1891850,1899615,+,7765
529,BUMA.1121.00005,1,171603,179409,+,7806
529,BUMA.1121.00100,1,3832930,3840711,-,7781
529,BUMA.1121.00006,1,831325,839090,+,7765
530,BUMA.1121.00027,1,3698084,3702927,+,4843
530,BUMA.1121.00025,1,1155852,1160722,-,4870
530,BUMA.1121.00021,1,2158419,2163312,+,4893
530,BUMA.1121.00023,1,3966989,3971868,+,4879
530,BUMA.1121.00024,1,1902008,1906838,+,4830
530,BUMA.1121.00033,1,3802249,3807119,+,4870
530,BUMA.1121.00034,1,1939479,1944309,+,4830
530,BUMA.1121.00036,1,2206681,2211542,-,4861
530,BUMA.1121.00032,1,3432492,3437322,+,4830
530,BUMA.1121.00009,1,85710,90537,-,4827
530,BUMA.1121.00008,1,1915099,1919929,+,4830
530,BUMA.1121.00003,1,72337,77216,+,4879
530,BUMA.1121.00109,1,417295,422137,-,4842
530,BUMA.1121.00053,1,1229880,1234705,+,4825
530,BUMA.1121.00110,1,3290986,3295859,-,4873
530,BUMA.1121.00104,1,3729063,3733978,-,4915
530,BUMA.1121.00086,1,588405,593235,+,4830
530,BUMA.1121.00092,1,2315455,2320325,-,4870
530,BUMA.1121.00096,1,1767435,1772278,-,4843
530,BUMA.1121.00054,1,3295558,3300410,-,4852
530,BUMA.1121.00097,1,2435277,2440133,-,4856
530,BUMA.1121.00093,1,2305993,2310863,+,4870
530,BUMA.1121.00106,1,1256441,1261329,+,4888
530,BUMA.1121.00010,1,3025236,3030066,+,4830
530,BUMA.1121.00035,1,2673460,2678339,+,4879
530,BUMA.1121.00108,1,2478604,2483465,+,4861
530,BUMA.1121.00028,1,1902055,1906885,+,4830
530,BUMA.1121.00094,1,1535497,1540327,+,4830
530,BUMA.1121.00102,1,3905988,3910858,-,4870
530,BUMA.1121.00089,1,1504172,1509002,+,4830
530,BUMA.1121.00084,1,1859294,1864124,+,4830
530,BUMA.1121.00029,1,3411761,3416640,-,4879
530,BUMA.1121.00012,1,227798,232686,+,4888
530,BUMA.1121.00087,1,2723501,2728353,-,4852
530,BUMA.1121.00043,1,1612027,1616866,+,4839
530,BUMA.1121.00046,1,2406515,2411345,+,4830
530,BUMA.1121.00037,1,162933,167803,+,4870
530,BUMA.1121.00080,1,1534075,1538954,+,4879
530,BUMA.1121.00079,1,1529407,1534237,+,4830
530,BUMA.1121.00045,1,2548610,2553453,-,4843
530,BUMA.1121.00071,1,2334698,2339541,-,4843
530,BUMA.1121.00056,1,2417008,2421851,-,4843
530,BUMA.1121.00065,1,1604840,1609710,+,4870
530,BUMA.1121.00058,1,3057169,3062036,-,4867
530,BUMA.1121.00007,1,2554628,2559460,-,4832
530,BUMA.1121.00067,1,2881951,2886848,-,4897
530,BUMA.1121.00090,1,3698468,3703347,+,4879
530,BUMA.1121.00051,1,1515336,1520166,+,4830
530,BUMA.1121.00020,1,1966963,1971793,+,4830
530,BUMA.1121.00103,1,2903852,2908686,-,4834
530,BUMA.1121.00048,1,635298,640128,+,4830
530,BUMA.1121.00047,1,1439541,1444420,-,4879
530,BUMA.1121.00055,1,1091534,1096364,+,4830
530,BUMA.1121.00031,1,2957888,2962767,+,4879
530,BUMA.1121.00040,1,1832598,1837428,+,4830
530,BUMA.1121.00044,1,1167619,1172449,+,4830
530,BUMA.1121.00088,1,2403296,2408139,+,4843
530,BUMA.1121.00069,1,2314465,2319308,-,4843
530,BUMA.1121.00064,1,1529671,1534541,+,4870
530,BUMA.1121.00105,1,3727535,3732378,-,4843
530,BUMA.1121.00015,1,2240989,2245841,-,4852
530,BUMA.1121.00059,1,714157,719027,+,4870
530,BUMA.1121.00026,1,46340,51183,-,4843
530,BUMA.1121.00022,1,2238013,2242843,+,4830
530,BUMA.1121.00052,1,1700675,1705505,+,4830
530,BUMA.1121.00101,1,983845,988679,-,4834
530,BUMA.1121.00001,1,2530563,2535442,-,4879
530,BUMA.1121.00038,1,842772,847602,+,4830
530,BUMA.1121.00068,1,258049,262879,+,4830
530,BUMA.1121.00099,1,836180,841077,-,4897
530,BUMA.1121.00091,1,3043283,3048126,-,4843
530,BUMA.1121.00098,1,85543,90385,+,4842
530,BUMA.1121.00013,1,2384861,2389713,-,4852
530,BUMA.1121.00049,1,350936,355824,-,4888
530,BUMA.1121.00072,1,2317634,2322477,-,4843
530,BUMA.1121.00076,1,3808221,3813064,-,4843
530,BUMA.1121.00083,1,81792,86635,-,4843
530,BUMA.1121.00078,1,441481,446351,-,4870
530,BUMA.1121.00095,1,175597,180431,-,4834
530,BUMA.1121.00077,1,186969,191799,+,4830
530,BUMA.1121.00063,1,2342030,2346873,-,4843
530,BUMA.1121.00061,1,2345121,2349964,-,4843
530,BUMA.1121.00050,1,340368,345220,-,4852
530,BUMA.1121.00081,1,842841,847671,+,4830
530,BUMA.1121.00074,1,2325661,2330567,-,4906
530,BUMA.1121.00062,1,3057166,3062036,-,4870
530,BUMA.1121.00060,1,774353,779196,-,4843
530,BUMA.1121.00070,1,2316101,2320944,-,4843
530,BUMA.1121.00075,1,999947,1004789,+,4842
530,BUMA.1121.00041,1,2809947,2814781,+,4834
530,BUMA.1121.00073,1,2343197,2348040,-,4843
530,BUMA.1121.00017,1,1837125,1841955,+,4830
530,BUMA.1121.00066,1,2318984,2323827,-,4843
530,BUMA.1121.00107,1,1407779,1412662,+,4883
530,BUMA.1121.00085,1,1297620,1302450,+,4830
530,BUMA.1121.00030,1,1837199,1842029,+,4830
530,BUMA.1121.00112,1,1502543,1507411,-,4868
530,BUMA.1121.00002,1,3047660,3052490,+,4830
530,BUMA.1121.00082,1,2500764,2505607,-,4843
530,BUMA.1121.00014,1,1254302,1259217,-,4915
530,BUMA.1121.00011,1,82884,87814,-,4930
530,BUMA.1121.00019,1,1902166,1906996,+,4830
530,BUMA.1121.00057,1,2586247,2591117,+,4870
530,BUMA.1121.00018,1,2099065,2103935,+,4870
530,BUMA.1121.00039,1,1644335,1649174,+,4839
530,BUMA.1121.00016,1,3705042,3709930,+,4888
530,BUMA.1121.00004,1,1903291,1908121,+,4830
530,BUMA.1121.00005,1,221813,226652,+,4839
530,BUMA.1121.00100,1,3822585,3827391,-,4806
530,BUMA.1121.00006,1,842766,847596,+,4830
531,BUMA.1121.00027,1,3703483,3707045,+,3562
531,BUMA.1121.00025,1,1151714,1155276,-,3562
531,BUMA.1121.00021,1,2163901,2167463,+,3562
531,BUMA.1121.00023,1,3972444,3976006,+,3562
531,BUMA.1121.00024,1,1907437,1910999,+,3562
531,BUMA.1121.00033,1,3807696,3811243,+,3547
531,BUMA.1121.00034,1,1944908,1948470,+,3562
531,BUMA.1121.00036,1,2202542,2206104,-,3562
531,BUMA.1121.00032,1,3437921,3441483,+,3562
531,BUMA.1121.00009,1,81592,85154,-,3562
531,BUMA.1121.00008,1,1920528,1924090,+,3562
531,BUMA.1121.00003,1,77772,81331,+,3559
531,BUMA.1121.00109,1,413131,416693,-,3562
531,BUMA.1121.00053,1,1235261,1238823,+,3562
531,BUMA.1121.00110,1,3286835,3290397,-,3562
531,BUMA.1121.00104,1,3724925,3728487,-,3562
531,BUMA.1121.00086,1,593834,597396,+,3562
531,BUMA.1121.00092,1,2311317,2314879,-,3562
531,BUMA.1121.00096,1,1763317,1766879,-,3562
531,BUMA.1121.00054,1,3291419,3294981,-,3562
531,BUMA.1121.00097,1,2431163,2434725,-,3562
531,BUMA.1121.00093,1,2311439,2315001,+,3562
531,BUMA.1121.00106,1,1261905,1265467,+,3562
531,BUMA.1121.00010,1,3030665,3034227,+,3562
531,BUMA.1121.00035,1,2678915,2682477,+,3562
531,BUMA.1121.00108,1,2484020,2487582,+,3562
531,BUMA.1121.00028,1,1907484,1911046,+,3562
531,BUMA.1121.00094,1,1540917,1544479,+,3562
531,BUMA.1121.00102,1,3901876,3905432,-,3556
531,BUMA.1121.00111,1,1703234,1706796,+,3562
531,BUMA.1121.00089,1,1509592,1513154,+,3562
531,BUMA.1121.00084,1,1864714,1868276,+,3562
531,BUMA.1121.00029,1,3407623,3411185,-,3562
531,BUMA.1121.00012,1,233262,236824,+,3562
531,BUMA.1121.00087,1,2719362,2722924,-,3562
531,BUMA.1121.00043,1,1617444,1621006,+,3562
531,BUMA.1121.00046,1,2411944,2415506,+,3562
531,BUMA.1121.00037,1,168406,171968,+,3562
531,BUMA.1121.00080,1,1539530,1543092,+,3562
531,BUMA.1121.00079,1,1534827,1538389,+,3562
531,BUMA.1121.00045,1,2544492,2548054,-,3562
531,BUMA.1121.00071,1,2330580,2334142,-,3562
531,BUMA.1121.00056,1,2412869,2416431,-,3562
531,BUMA.1121.00065,1,1610286,1613791,+,3505
531,BUMA.1121.00058,1,3053039,3056601,-,3562
531,BUMA.1121.00007,1,2550510,2554072,-,3562
531,BUMA.1121.00067,1,2877813,2881375,-,3562
531,BUMA.1121.00090,1,3703902,3707464,+,3562
531,BUMA.1121.00051,1,1520756,1524317,+,3561
531,BUMA.1121.00020,1,1972392,1975954,+,3562
531,BUMA.1121.00103,1,2899730,2903297,-,3567
531,BUMA.1121.00048,1,640727,644289,+,3562
531,BUMA.1121.00047,1,1435429,1438985,-,3556
531,BUMA.1121.00055,1,1096954,1100516,+,3562
531,BUMA.1121.00031,1,2963370,2966932,+,3562
531,BUMA.1121.00040,1,1838027,1841589,+,3562
531,BUMA.1121.00044,1,1173048,1176610,+,3562
531,BUMA.1121.00088,1,2408695,2412257,+,3562
531,BUMA.1121.00069,1,2310347,2313909,-,3562
531,BUMA.1121.00064,1,1535117,1538679,+,3562
531,BUMA.1121.00105,1,3723396,3726958,-,3562
531,BUMA.1121.00015,1,2236850,2240412,-,3562
531,BUMA.1121.00059,1,719603,723165,+,3562
531,BUMA.1121.00026,1,42201,45763,-,3562
531,BUMA.1121.00022,1,2243442,2247004,+,3562
531,BUMA.1121.00052,1,1706104,1709666,+,3562
531,BUMA.1121.00101,1,979727,983289,-,3562
531,BUMA.1121.00001,1,2526425,2529987,-,3562
531,BUMA.1121.00038,1,848201,851763,+,3562
531,BUMA.1121.00068,1,263448,267004,+,3556
531,BUMA.1121.00099,1,832062,835629,-,3567
531,BUMA.1121.00091,1,3039165,3042727,-,3562
531,BUMA.1121.00098,1,90971,94533,+,3562
531,BUMA.1121.00013,1,2380722,2384284,-,3562
531,BUMA.1121.00049,1,346798,350360,-,3562
531,BUMA.1121.00072,1,2313516,2317078,-,3562
531,BUMA.1121.00076,1,3804082,3807644,-,3562
531,BUMA.1121.00083,1,77674,81236,-,3562
531,BUMA.1121.00078,1,437365,440925,-,3560
531,BUMA.1121.00095,1,171479,175046,-,3567
531,BUMA.1121.00077,1,192431,195993,+,3562
531,BUMA.1121.00063,1,2337912,2341474,-,3562
531,BUMA.1121.00061,1,2341003,2344565,-,3562
531,BUMA.1121.00050,1,336229,339791,-,3562
531,BUMA.1121.00081,1,848270,851832,+,3562
531,BUMA.1121.00074,1,2321523,2325085,-,3562
531,BUMA.1121.00062,1,3053028,3056590,-,3562
531,BUMA.1121.00060,1,770235,773797,-,3562
531,BUMA.1121.00070,1,2311983,2315545,-,3562
531,BUMA.1121.00075,1,1005366,1008926,+,3560
531,BUMA.1121.00041,1,2815373,2818935,+,3562
531,BUMA.1121.00073,1,2339079,2342641,-,3562
531,BUMA.1121.00017,1,1842554,1846116,+,3562
531,BUMA.1121.00066,1,2314866,2318428,-,3562
531,BUMA.1121.00107,1,1413231,1416793,+,3562
531,BUMA.1121.00085,1,1303049,1306611,+,3562
531,BUMA.1121.00030,1,1842628,1846190,+,3562
531,BUMA.1121.00112,1,1498425,1501987,-,3562
531,BUMA.1121.00002,1,3053089,3056651,+,3562
531,BUMA.1121.00082,1,2496646,2500208,-,3562
531,BUMA.1121.00014,1,1250164,1253726,-,3562
531,BUMA.1121.00011,1,78736,82304,-,3568
531,BUMA.1121.00019,1,1907595,1911157,+,3562
531,BUMA.1121.00057,1,2591693,2595255,+,3562
531,BUMA.1121.00018,1,2104511,2108073,+,3562
531,BUMA.1121.00039,1,1649763,1653325,+,3562
531,BUMA.1121.00016,1,3710507,3714069,+,3562
531,BUMA.1121.00004,1,1908720,1912282,+,3562
531,BUMA.1121.00005,1,227242,230804,+,3562
531,BUMA.1121.00100,1,3818437,3821999,-,3562
531,BUMA.1121.00006,1,848195,851757,+,3562
532,BUMA.1121.00027,1,3708499,3749331,+,40832
532,BUMA.1121.00025,1,1109496,1150082,-,40586
532,BUMA.1121.00021,1,2168917,2209753,+,40836
532,BUMA.1121.00023,1,3977460,4018234,+,40774
532,BUMA.1121.00024,1,1912470,1953101,+,40631
532,BUMA.1121.00033,1,3812697,3853566,+,40869
532,BUMA.1121.00034,1,1949941,1990572,+,40631
532,BUMA.1121.00036,1,2160447,2201072,-,40625
532,BUMA.1121.00032,1,3442954,3483585,+,40631
532,BUMA.1121.00009,1,39246,79960,-,40714
532,BUMA.1121.00008,1,1925561,1966192,+,40631
532,BUMA.1121.00003,1,82794,122926,+,40132
532,BUMA.1121.00109,1,370789,411499,-,40710
532,BUMA.1121.00053,1,1240277,1281143,+,40866
532,BUMA.1121.00110,1,3243252,3285203,-,41951
532,BUMA.1121.00104,1,3682666,3723293,-,40627
532,BUMA.1121.00086,1,598867,639490,+,40623
532,BUMA.1121.00092,1,2269034,2309685,-,40651
532,BUMA.1121.00096,1,1721057,1761685,-,40628
532,BUMA.1121.00054,1,3249327,3289949,-,40622
532,BUMA.1121.00097,1,2389598,2429531,-,39933
532,BUMA.1121.00093,1,2316455,2357285,+,40830
532,BUMA.1121.00106,1,1266921,1307763,+,40842
532,BUMA.1121.00010,1,3035698,3076318,+,40620
532,BUMA.1121.00035,1,2683931,2724770,+,40839
532,BUMA.1121.00108,1,2489036,2529849,+,40813
532,BUMA.1121.00028,1,1912517,1953148,+,40631
532,BUMA.1121.00094,1,1545933,1586852,+,40919
532,BUMA.1121.00102,1,3859497,3900244,-,40747
532,BUMA.1121.00111,1,1708250,1749113,+,40863
532,BUMA.1121.00089,1,1514608,1555509,+,40901
532,BUMA.1121.00084,1,1869730,1910561,+,40831
532,BUMA.1121.00029,1,3365331,3405991,-,40660
532,BUMA.1121.00012,1,238278,279108,+,40830
532,BUMA.1121.00087,1,2677269,2717892,-,40623
532,BUMA.1121.00043,1,1622460,1663263,+,40803
532,BUMA.1121.00046,1,2416977,2457620,+,40643
532,BUMA.1121.00037,1,173422,214304,+,40882
532,BUMA.1121.00080,1,1544546,1585446,+,40900
532,BUMA.1121.00079,1,1539843,1580754,+,40911
532,BUMA.1121.00045,1,2502202,2542860,-,40658
532,BUMA.1121.00071,1,2288279,2328948,-,40669
532,BUMA.1121.00056,1,2370515,2411237,-,40722
532,BUMA.1121.00065,1,1615245,1657412,+,42167
532,BUMA.1121.00058,1,3010681,3051407,-,40726
532,BUMA.1121.00007,1,2508022,2548878,-,40856
532,BUMA.1121.00067,1,2835494,2876181,-,40687
532,BUMA.1121.00090,1,3708918,3749745,+,40827
532,BUMA.1121.00051,1,1525771,1566692,+,40921
532,BUMA.1121.00020,1,1977425,2018056,+,40631
532,BUMA.1121.00103,1,2857362,2898098,-,40736
532,BUMA.1121.00048,1,645760,686382,+,40622
532,BUMA.1121.00047,1,1393111,1433797,-,40686
532,BUMA.1121.00055,1,1101970,1142815,+,40845
532,BUMA.1121.00031,1,2968386,3009237,+,40851
532,BUMA.1121.00040,1,1843060,1883696,+,40636
532,BUMA.1121.00044,1,1178081,1218712,+,40631
532,BUMA.1121.00088,1,2413711,2454541,+,40830
532,BUMA.1121.00069,1,2268049,2308715,-,40666
532,BUMA.1121.00064,1,1540133,1580971,+,40838
532,BUMA.1121.00105,1,3681094,3721764,-,40670
532,BUMA.1121.00015,1,2194695,2235380,-,40685
532,BUMA.1121.00059,1,724619,765504,+,40885
532,BUMA.1121.00026,1,1,40569,-,40568
532,BUMA.1121.00022,1,2248475,2289099,+,40624
532,BUMA.1121.00052,1,1711137,1751756,+,40619
532,BUMA.1121.00101,1,937419,978095,-,40676
532,BUMA.1121.00001,1,2484136,2524793,-,40657
532,BUMA.1121.00038,1,853234,893856,+,40622
532,BUMA.1121.00068,1,268458,309389,+,40931
532,BUMA.1121.00099,1,790489,830430,-,39941
532,BUMA.1121.00091,1,2996807,3037533,-,40726
532,BUMA.1121.00098,1,95987,136843,+,40856
532,BUMA.1121.00013,1,2338633,2379252,-,40619
532,BUMA.1121.00049,1,304474,345166,-,40692
532,BUMA.1121.00072,1,2271218,2311884,-,40666
532,BUMA.1121.00076,1,3761698,3802450,-,40752
532,BUMA.1121.00083,1,35372,76042,-,40670
532,BUMA.1121.00078,1,395045,435733,-,40688
532,BUMA.1121.00095,1,129161,169847,-,40686
532,BUMA.1121.00077,1,197447,239569,+,42122
532,BUMA.1121.00063,1,2295615,2336280,-,40665
532,BUMA.1121.00061,1,2298707,2339371,-,40664
532,BUMA.1121.00050,1,294116,334759,-,40643
532,BUMA.1121.00081,1,853303,893925,+,40622
532,BUMA.1121.00074,1,2279215,2319891,-,40676
532,BUMA.1121.00062,1,3010774,3051396,-,40622
532,BUMA.1121.00060,1,727945,768603,-,40658
532,BUMA.1121.00070,1,2269684,2310351,-,40667
532,BUMA.1121.00075,1,1010380,1051301,+,40921
532,BUMA.1121.00041,1,2820389,2861345,+,40956
532,BUMA.1121.00073,1,2296780,2337447,-,40667
532,BUMA.1121.00017,1,1847587,1888218,+,40631
532,BUMA.1121.00066,1,2272606,2313234,-,40628
532,BUMA.1121.00107,1,1418247,1459180,+,40933
532,BUMA.1121.00085,1,1308082,1348701,+,40619
532,BUMA.1121.00030,1,1847661,1888292,+,40631
532,BUMA.1121.00112,1,1456859,1496793,-,39934
532,BUMA.1121.00002,1,3058122,3098742,+,40620
532,BUMA.1121.00082,1,2454344,2495014,-,40670
532,BUMA.1121.00014,1,1207863,1248532,-,40669
532,BUMA.1121.00011,1,36369,77104,-,40735
532,BUMA.1121.00019,1,1912628,1953259,+,40631
532,BUMA.1121.00057,1,2596709,2637570,+,40861
532,BUMA.1121.00018,1,2109527,2150292,+,40765
532,BUMA.1121.00039,1,1654779,1695637,+,40858
532,BUMA.1121.00016,1,3715702,3756389,+,40687
532,BUMA.1121.00004,1,1913753,1954384,+,40631
532,BUMA.1121.00005,1,232258,273169,+,40911
532,BUMA.1121.00100,1,3776162,3816805,-,40643
532,BUMA.1121.00006,1,853228,893850,+,40622
533,BUMA.1121.00027,1,3749332,3753193,+,3861
533,BUMA.1121.00025,1,1105625,1109494,-,3869
533,BUMA.1121.00021,1,2209754,2213624,+,3870
533,BUMA.1121.00023,1,4018235,4022105,+,3870
533,BUMA.1121.00024,1,1953102,1956972,+,3870
533,BUMA.1121.00033,1,3853567,3857437,+,3870
533,BUMA.1121.00034,1,1990573,1994443,+,3870
533,BUMA.1121.00036,1,2156576,2160445,-,3869
533,BUMA.1121.00032,1,3483586,3487456,+,3870
533,BUMA.1121.00009,1,35375,39244,-,3869
533,BUMA.1121.00008,1,1966193,1970063,+,3870
533,BUMA.1121.00003,1,122927,126797,+,3870
533,BUMA.1121.00109,1,366918,370787,-,3869
533,BUMA.1121.00053,1,1281144,1285014,+,3870
533,BUMA.1121.00110,1,3239381,3243250,-,3869
533,BUMA.1121.00104,1,3678795,3682664,-,3869
533,BUMA.1121.00086,1,639491,643361,+,3870
533,BUMA.1121.00092,1,2265172,2269032,-,3860
533,BUMA.1121.00096,1,1717186,1721055,-,3869
533,BUMA.1121.00054,1,3245456,3249325,-,3869
533,BUMA.1121.00097,1,2385724,2389596,-,3872
533,BUMA.1121.00093,1,2357286,2361147,+,3861
533,BUMA.1121.00106,1,1307764,1311634,+,3870
533,BUMA.1121.00010,1,3076319,3080189,+,3870
533,BUMA.1121.00035,1,2724771,2728641,+,3870
533,BUMA.1121.00108,1,2529850,2533720,+,3870
533,BUMA.1121.00028,1,1953149,1957019,+,3870
533,BUMA.1121.00094,1,1586853,1590724,+,3871
533,BUMA.1121.00102,1,3855635,3859495,-,3860
533,BUMA.1121.00111,1,1749114,1752984,+,3870
533,BUMA.1121.00089,1,1555510,1559380,+,3870
533,BUMA.1121.00084,1,1910562,1914432,+,3870
533,BUMA.1121.00029,1,3361460,3365329,-,3869
533,BUMA.1121.00012,1,279109,282979,+,3870
533,BUMA.1121.00087,1,2673398,2677267,-,3869
533,BUMA.1121.00043,1,1663264,1667134,+,3870
533,BUMA.1121.00046,1,2457621,2461491,+,3870
533,BUMA.1121.00037,1,214305,218175,+,3870
533,BUMA.1121.00080,1,1585447,1589308,+,3861
533,BUMA.1121.00079,1,1580755,1584625,+,3870
533,BUMA.1121.00045,1,2498331,2502200,-,3869
533,BUMA.1121.00071,1,2284417,2288277,-,3860
533,BUMA.1121.00056,1,2366644,2370513,-,3869
533,BUMA.1121.00065,1,1657413,1661283,+,3870
533,BUMA.1121.00058,1,3006810,3010679,-,3869
533,BUMA.1121.00007,1,2504151,2508020,-,3869
533,BUMA.1121.00067,1,2831632,2835492,-,3860
533,BUMA.1121.00090,1,3749746,3753616,+,3870
533,BUMA.1121.00051,1,1566693,1570563,+,3870
533,BUMA.1121.00020,1,2018057,2021927,+,3870
533,BUMA.1121.00103,1,2853491,2857360,-,3869
533,BUMA.1121.00048,1,686383,690253,+,3870
533,BUMA.1121.00047,1,1389240,1393109,-,3869
533,BUMA.1121.00055,1,1142816,1146686,+,3870
533,BUMA.1121.00031,1,3009238,3013108,+,3870
533,BUMA.1121.00040,1,1883697,1887567,+,3870
533,BUMA.1121.00044,1,1218713,1222583,+,3870
533,BUMA.1121.00088,1,2454542,2458412,+,3870
533,BUMA.1121.00069,1,2264187,2268047,-,3860
533,BUMA.1121.00064,1,1580972,1584833,+,3861
533,BUMA.1121.00105,1,3677223,3681092,-,3869
533,BUMA.1121.00015,1,2190826,2194693,-,3867
533,BUMA.1121.00059,1,765505,769375,+,3870
533,BUMA.1121.00026,1,3546703,3550588,-,3885
533,BUMA.1121.00022,1,2289100,2292970,+,3870
533,BUMA.1121.00052,1,1751757,1755627,+,3870
533,BUMA.1121.00101,1,933557,937417,-,3860
533,BUMA.1121.00001,1,2480265,2484134,-,3869
533,BUMA.1121.00038,1,893857,897727,+,3870
533,BUMA.1121.00068,1,309390,313259,+,3869
533,BUMA.1121.00099,1,786573,790487,-,3914
533,BUMA.1121.00091,1,2992945,2996805,-,3860
533,BUMA.1121.00098,1,136844,140714,+,3870
533,BUMA.1121.00013,1,2334762,2338631,-,3869
533,BUMA.1121.00049,1,300603,304472,-,3869
533,BUMA.1121.00072,1,2267356,2271216,-,3860
533,BUMA.1121.00076,1,3757827,3761696,-,3869
533,BUMA.1121.00083,1,31510,35370,-,3860
533,BUMA.1121.00078,1,391174,395043,-,3869
533,BUMA.1121.00095,1,125290,129159,-,3869
533,BUMA.1121.00077,1,239570,243440,+,3870
533,BUMA.1121.00063,1,2291753,2295613,-,3860
533,BUMA.1121.00061,1,2294845,2298705,-,3860
533,BUMA.1121.00050,1,290245,294114,-,3869
533,BUMA.1121.00081,1,893926,897796,+,3870
533,BUMA.1121.00074,1,2275353,2279213,-,3860
533,BUMA.1121.00062,1,3006912,3010772,-,3860
533,BUMA.1121.00060,1,724074,727943,-,3869
533,BUMA.1121.00070,1,2265822,2269682,-,3860
533,BUMA.1121.00075,1,1051302,1055172,+,3870
533,BUMA.1121.00041,1,2861346,2865207,+,3861
533,BUMA.1121.00073,1,2292918,2296778,-,3860
533,BUMA.1121.00017,1,1888219,1892089,+,3870
533,BUMA.1121.00066,1,2268744,2272604,-,3860
533,BUMA.1121.00107,1,1459181,1463042,+,3861
533,BUMA.1121.00085,1,1348702,1352572,+,3870
533,BUMA.1121.00030,1,1888293,1892163,+,3870
533,BUMA.1121.00112,1,1452997,1456857,-,3860
533,BUMA.1121.00002,1,3098743,3102613,+,3870
533,BUMA.1121.00082,1,2450482,2454342,-,3860
533,BUMA.1121.00014,1,1203992,1207861,-,3869
533,BUMA.1121.00011,1,32498,36367,-,3869
533,BUMA.1121.00019,1,1953260,1957130,+,3870
533,BUMA.1121.00057,1,2637571,2641432,+,3861
533,BUMA.1121.00018,1,2150293,2154163,+,3870
533,BUMA.1121.00039,1,1695638,1699499,+,3861
533,BUMA.1121.00016,1,3756390,3760260,+,3870
533,BUMA.1121.00004,1,1954385,1958255,+,3870
533,BUMA.1121.00005,1,273170,277031,+,3861
533,BUMA.1121.00100,1,3772300,3776160,-,3860
533,BUMA.1121.00006,1,893851,897721,+,3870
534,BUMA.1121.00027,1,3760797,3764862,+,4065
534,BUMA.1121.00025,1,1093234,1097299,-,4065
534,BUMA.1121.00021,1,2221235,2225300,+,4065
534,BUMA.1121.00023,1,4030439,4034504,+,4065
534,BUMA.1121.00033,1,3866459,3870494,+,4035
534,BUMA.1121.00009,1,22984,27048,-,4064
534,BUMA.1121.00003,1,134402,138462,+,4060
534,BUMA.1121.00109,1,355250,359313,-,4063
534,BUMA.1121.00053,1,1292626,1296690,+,4064
534,BUMA.1121.00110,1,3226985,3231048,-,4063
534,BUMA.1121.00104,1,3666396,3670461,-,4065
534,BUMA.1121.00092,1,2253502,2257567,-,4065
534,BUMA.1121.00096,1,1705518,1709581,-,4063
534,BUMA.1121.00097,1,2374054,2378119,-,4065
534,BUMA.1121.00093,1,2368752,2372817,+,4065
534,BUMA.1121.00106,1,1319246,1323311,+,4065
534,BUMA.1121.00035,1,2736975,2741040,+,4065
534,BUMA.1121.00108,1,2542060,2546125,+,4065
534,BUMA.1121.00094,1,1598329,1602393,+,4064
534,BUMA.1121.00102,1,3842613,3846678,-,4065
534,BUMA.1121.00111,1,1761311,1765376,+,4065
534,BUMA.1121.00089,1,1566985,1571049,+,4064
534,BUMA.1121.00084,1,1922766,1926831,+,4065
534,BUMA.1121.00029,1,3349061,3353126,-,4065
534,BUMA.1121.00012,1,291313,295378,+,4065
534,BUMA.1121.00043,1,1675467,1679532,+,4065
534,BUMA.1121.00080,1,1596913,1600977,+,4064
534,BUMA.1121.00079,1,1592230,1596294,+,4064
534,BUMA.1121.00045,1,2486662,2490726,-,4064
534,BUMA.1121.00071,1,2272747,2276812,-,4065
534,BUMA.1121.00056,1,2354975,2359039,-,4064
534,BUMA.1121.00065,1,1668894,1672956,+,4062
534,BUMA.1121.00058,1,2995134,2999199,-,4065
534,BUMA.1121.00007,1,2492481,2496546,-,4065
534,BUMA.1121.00067,1,2819962,2824027,-,4065
534,BUMA.1121.00090,1,3761956,3766021,+,4065
534,BUMA.1121.00051,1,1578168,1582232,+,4064
534,BUMA.1121.00103,1,2841100,2845164,-,4064
534,BUMA.1121.00047,1,1377571,1381635,-,4064
534,BUMA.1121.00055,1,1154297,1158362,+,4065
534,BUMA.1121.00031,1,3020720,3024785,+,4065
534,BUMA.1121.00088,1,2466746,2470811,+,4065
534,BUMA.1121.00069,1,2252518,2256582,-,4064
534,BUMA.1121.00064,1,1592444,1596508,+,4064
534,BUMA.1121.00105,1,3665547,3669612,-,4065
534,BUMA.1121.00059,1,777709,781774,+,4065
534,BUMA.1121.00101,1,921160,925224,-,4064
534,BUMA.1121.00001,1,2467867,2471932,-,4065
534,BUMA.1121.00068,1,320865,324929,+,4064
534,BUMA.1121.00099,1,774180,778244,-,4064
534,BUMA.1121.00091,1,2981274,2985340,-,4066
534,BUMA.1121.00098,1,149054,153118,+,4064
534,BUMA.1121.00049,1,288204,292269,-,4065
534,BUMA.1121.00072,1,2255687,2259751,-,4064
534,BUMA.1121.00076,1,3746157,3750222,-,4065
534,BUMA.1121.00083,1,19840,23905,-,4065
534,BUMA.1121.00078,1,379493,383557,-,4064
534,BUMA.1121.00095,1,113620,117685,-,4065
534,BUMA.1121.00077,1,251772,255835,+,4063
534,BUMA.1121.00063,1,2280084,2284148,-,4064
534,BUMA.1121.00061,1,2283175,2287240,-,4065
534,BUMA.1121.00074,1,2263683,2267748,-,4065
534,BUMA.1121.00062,1,2995240,2999305,-,4065
534,BUMA.1121.00060,1,712405,716469,-,4064
534,BUMA.1121.00070,1,2254152,2258217,-,4065
534,BUMA.1121.00075,1,1062777,1066842,+,4065
534,BUMA.1121.00041,1,2872812,2876875,+,4063
534,BUMA.1121.00073,1,2281248,2285313,-,4065
534,BUMA.1121.00066,1,2257074,2261139,-,4065
534,BUMA.1121.00107,1,1470647,1474710,+,4063
534,BUMA.1121.00112,1,1441304,1445368,-,4064
534,BUMA.1121.00082,1,2438812,2442877,-,4065
534,BUMA.1121.00014,1,1192315,1196380,-,4065
534,BUMA.1121.00011,1,20829,24893,-,4064
534,BUMA.1121.00057,1,2649043,2653108,+,4065
534,BUMA.1121.00018,1,2162489,2166554,+,4065
534,BUMA.1121.00039,1,1707833,1711898,+,4065
534,BUMA.1121.00016,1,3768593,3772658,+,4065
534,BUMA.1121.00005,1,284636,288701,+,4065
534,BUMA.1121.00100,1,3760631,3764695,-,4064
535,BUMA.1121.00027,1,3771046,3784314,+,13268
535,BUMA.1121.00025,1,1069020,1083577,-,14557
535,BUMA.1121.00021,1,2234959,2248218,+,13259
535,BUMA.1121.00023,1,4044162,4057421,+,13259
535,BUMA.1121.00024,1,1960778,1974045,+,13267
535,BUMA.1121.00033,1,3881530,3894791,+,13261
535,BUMA.1121.00034,1,1998249,2011543,+,13294
535,BUMA.1121.00036,1,2139491,2152759,-,13268
535,BUMA.1121.00032,1,27680,40947,+,13267
535,BUMA.1121.00032,1,3491262,3504513,+,13251
535,BUMA.1121.00009,1,383,13648,-,13265
535,BUMA.1121.00008,1,1973869,1987136,+,13267
535,BUMA.1121.00003,1,145969,159230,+,13261
535,BUMA.1121.00109,1,329204,342476,-,13272
535,BUMA.1121.00053,1,1302865,1316145,+,13280
535,BUMA.1121.00110,1,3206544,3219815,-,13271
535,BUMA.1121.00104,1,3635744,3650329,-,14585
535,BUMA.1121.00086,1,647178,660446,+,13268
535,BUMA.1121.00092,1,2224166,2237434,-,13268
535,BUMA.1121.00096,1,1680998,1694252,-,13254
535,BUMA.1121.00054,1,3228370,3241639,-,13269
535,BUMA.1121.00097,1,2344702,2357984,-,13282
535,BUMA.1121.00093,1,2388885,2402152,+,13267
535,BUMA.1121.00106,1,1340734,1354003,+,13269
535,BUMA.1121.00010,1,2244201,2257468,+,13267
535,BUMA.1121.00035,1,2752835,2766096,+,13261
535,BUMA.1121.00108,1,2553296,2566557,+,13261
535,BUMA.1121.00028,1,1960825,1974092,+,13267
535,BUMA.1121.00094,1,1608568,1621838,+,13270
535,BUMA.1121.00102,1,3822168,3835441,-,13273
535,BUMA.1121.00111,1,1775033,1788307,+,13274
535,BUMA.1121.00089,1,1577224,1590493,+,13269
535,BUMA.1121.00084,1,1942898,1957480,+,14582
535,BUMA.1121.00029,1,3322711,3335973,-,13262
535,BUMA.1121.00012,1,305034,318308,+,13274
535,BUMA.1121.00087,1,2656311,2669580,-,13269
535,BUMA.1121.00043,1,1689187,1702461,+,13274
535,BUMA.1121.00046,1,2465308,2478576,+,13268
535,BUMA.1121.00037,1,231247,244518,+,13271
535,BUMA.1121.00080,1,1607152,1620424,+,13272
535,BUMA.1121.00079,1,1602468,1615733,+,13265
535,BUMA.1121.00045,1,2459516,2472752,-,13236
535,BUMA.1121.00071,1,2255085,2268329,-,13244
535,BUMA.1121.00056,1,2335530,2348800,-,13270
535,BUMA.1121.00065,1,1679144,1692424,+,13280
535,BUMA.1121.00058,1,2966408,2979670,-,13262
535,BUMA.1121.00007,1,2469887,2483144,-,13257
535,BUMA.1121.00067,1,2800502,2813774,-,13272
535,BUMA.1121.00090,1,3775677,3788938,+,13261
535,BUMA.1121.00051,1,1588407,1601676,+,13269
535,BUMA.1121.00020,1,2025733,2039000,+,13267
535,BUMA.1121.00103,1,2818517,2831763,-,13246
535,BUMA.1121.00048,1,694070,707338,+,13268
535,BUMA.1121.00047,1,1358126,1371396,-,13270
535,BUMA.1121.00042,1,2446496,2459764,-,13268
535,BUMA.1121.00055,1,1164550,1177818,+,13268
535,BUMA.1121.00031,1,3034443,3047704,+,13261
535,BUMA.1121.00040,1,2471418,2484687,-,13269
535,BUMA.1121.00044,1,1226389,1239656,+,13267
535,BUMA.1121.00088,1,2485883,2499154,+,13271
535,BUMA.1121.00069,1,2237439,2250703,-,13264
535,BUMA.1121.00064,1,1602696,1615973,+,13277
535,BUMA.1121.00105,1,3636218,3649479,-,13261
535,BUMA.1121.00015,1,2173739,2187008,-,13269
535,BUMA.1121.00059,1,787962,801224,+,13262
535,BUMA.1121.00026,1,3529628,3542897,-,13269
535,BUMA.1121.00022,1,2296787,2310055,+,13268
535,BUMA.1121.00052,1,1759444,1772711,+,13267
535,BUMA.1121.00101,1,891820,905092,-,13272
535,BUMA.1121.00001,1,2439718,2452980,-,13262
535,BUMA.1121.00038,1,901544,914812,+,13268
535,BUMA.1121.00068,1,340610,353875,+,13265
535,BUMA.1121.00099,1,743604,756866,-,13262
535,BUMA.1121.00091,1,2951934,2965206,-,13272
535,BUMA.1121.00098,1,170431,183686,+,13255
535,BUMA.1121.00013,1,2317676,2330945,-,13269
535,BUMA.1121.00049,1,257655,270925,-,13270
535,BUMA.1121.00072,1,2238000,2251238,-,13238
535,BUMA.1121.00076,1,3725717,3738987,-,13270
535,BUMA.1121.00083,1,383,13652,-,13269
535,BUMA.1121.00078,1,350761,364031,-,13270
535,BUMA.1121.00095,1,93193,106449,-,13256
535,BUMA.1121.00077,1,263005,276275,+,13270
535,BUMA.1121.00063,1,2262428,2275667,-,13239
535,BUMA.1121.00061,1,2265513,2278757,-,13244
535,BUMA.1121.00050,1,273159,286428,-,13269
535,BUMA.1121.00081,1,901613,914881,+,13268
535,BUMA.1121.00074,1,2244223,2257495,-,13272
535,BUMA.1121.00062,1,2971640,2984910,-,13270
535,BUMA.1121.00060,1,685259,698495,-,13236
535,BUMA.1121.00070,1,2236466,2249733,-,13267
535,BUMA.1121.00075,1,1074012,1087281,+,13269
535,BUMA.1121.00041,1,2892338,2905606,+,13268
535,BUMA.1121.00073,1,2263566,2276831,-,13265
535,BUMA.1121.00017,1,1895895,1909162,+,13267
535,BUMA.1121.00066,1,2239411,2252655,-,13244
535,BUMA.1121.00107,1,1481881,1495124,+,13243
535,BUMA.1121.00085,1,1356389,1369656,+,13267
535,BUMA.1121.00030,1,1895969,1909236,+,13267
535,BUMA.1121.00112,1,1414150,1427394,-,13244
535,BUMA.1121.00002,1,2271062,2284330,+,13268
535,BUMA.1121.00082,1,2419355,2432624,-,13269
535,BUMA.1121.00014,1,1169395,1182657,-,13262
535,BUMA.1121.00011,1,383,13658,-,13275
535,BUMA.1121.00019,1,1960936,1974203,+,13267
535,BUMA.1121.00057,1,2659296,2672564,+,13268
535,BUMA.1121.00018,1,2176211,2190767,+,14556
535,BUMA.1121.00039,1,1721555,1734826,+,13271
535,BUMA.1121.00016,1,3782315,3795579,+,13264
535,BUMA.1121.00004,1,1962061,1975328,+,13267
535,BUMA.1121.00005,1,294889,308157,+,13268
535,BUMA.1121.00100,1,3736431,3751010,-,14579
535,BUMA.1121.00006,1,901538,914806,+,13268
536,BUMA.1121.00027,1,3787066,3792846,+,5780
536,BUMA.1121.00025,1,1060507,1066268,-,5761
536,BUMA.1121.00021,1,2250970,2256741,+,5771
536,BUMA.1121.00023,1,4060173,4065944,+,5771
536,BUMA.1121.00024,1,1976797,1982538,+,5741
536,BUMA.1121.00033,1,3897543,3903311,+,5768
536,BUMA.1121.00034,1,2014295,2020036,+,5741
536,BUMA.1121.00036,1,2130999,2136739,-,5740
536,BUMA.1121.00032,1,43699,49440,+,5741
536,BUMA.1121.00009,1,3968221,3973991,-,5770
536,BUMA.1121.00008,1,1989888,1995629,+,5741
536,BUMA.1121.00003,1,163181,168952,+,5771
536,BUMA.1121.00109,1,320682,326452,-,5770
536,BUMA.1121.00053,1,1318876,1324651,+,5775
536,BUMA.1121.00110,1,3198023,3203792,-,5769
536,BUMA.1121.00104,1,3627198,3632992,-,5794
536,BUMA.1121.00086,1,663198,668939,+,5741
536,BUMA.1121.00092,1,2215635,2221414,-,5779
536,BUMA.1121.00096,1,1672467,1678237,-,5770
536,BUMA.1121.00054,1,3219878,3225618,-,5740
536,BUMA.1121.00097,1,2336172,2341951,-,5779
536,BUMA.1121.00093,1,2404904,2410684,+,5780
536,BUMA.1121.00106,1,1356755,1362544,+,5789
536,BUMA.1121.00010,1,2260220,2265961,+,5741
536,BUMA.1121.00035,1,2768848,2774619,+,5771
536,BUMA.1121.00108,1,2569308,2575079,+,5771
536,BUMA.1121.00028,1,1976844,1982585,+,5741
536,BUMA.1121.00094,1,1624590,1630370,+,5780
536,BUMA.1121.00102,1,3813676,3819437,-,5761
536,BUMA.1121.00111,1,1791059,1796827,+,5768
536,BUMA.1121.00089,1,1593245,1599025,+,5780
536,BUMA.1121.00084,1,1960232,1966007,+,5775
536,BUMA.1121.00029,1,3314193,3319959,-,5766
536,BUMA.1121.00012,1,321060,326819,+,5759
536,BUMA.1121.00087,1,2647819,2653559,-,5740
536,BUMA.1121.00043,1,1705213,1710972,+,5759
536,BUMA.1121.00046,1,2481328,2487069,+,5741
536,BUMA.1121.00037,1,247270,252984,+,5714
536,BUMA.1121.00080,1,1623175,1628955,+,5780
536,BUMA.1121.00079,1,1618485,1624265,+,5780
536,BUMA.1121.00045,1,2450985,2456764,-,5779
536,BUMA.1121.00071,1,2246554,2252333,-,5779
536,BUMA.1121.00056,1,2326999,2332778,-,5779
536,BUMA.1121.00065,1,1695176,1700956,+,5780
536,BUMA.1121.00058,1,2957886,2963656,-,5770
536,BUMA.1121.00007,1,2461381,2467135,-,5754
536,BUMA.1121.00067,1,2791971,2797750,-,5779
536,BUMA.1121.00090,1,3791690,3797461,+,5771
536,BUMA.1121.00051,1,1604428,1610208,+,5780
536,BUMA.1121.00020,1,2041752,2047493,+,5741
536,BUMA.1121.00103,1,2810004,2815765,-,5761
536,BUMA.1121.00048,1,710090,715831,+,5741
536,BUMA.1121.00047,1,1349595,1355374,-,5779
536,BUMA.1121.00042,1,2438004,2443744,-,5740
536,BUMA.1121.00055,1,1180576,1186342,+,5766
536,BUMA.1121.00031,1,3050456,3056227,+,5771
536,BUMA.1121.00040,1,2462926,2468666,-,5740
536,BUMA.1121.00044,1,1242408,1248149,+,5741
536,BUMA.1121.00088,1,2501906,2507686,+,5780
536,BUMA.1121.00069,1,2228908,2234687,-,5779
536,BUMA.1121.00064,1,1618725,1624496,+,5771
536,BUMA.1121.00105,1,3627692,3633466,-,5774
536,BUMA.1121.00015,1,2165247,2170987,-,5740
536,BUMA.1121.00059,1,803976,809751,+,5775
536,BUMA.1121.00026,1,3521136,3526876,-,5740
536,BUMA.1121.00022,1,2312807,2318548,+,5741
536,BUMA.1121.00052,1,1775463,1781204,+,5741
536,BUMA.1121.00101,1,883298,889068,-,5770
536,BUMA.1121.00001,1,2431196,2436966,-,5770
536,BUMA.1121.00038,1,917564,923305,+,5741
536,BUMA.1121.00068,1,357819,363590,+,5771
536,BUMA.1121.00099,1,735088,740852,-,5764
536,BUMA.1121.00091,1,2943430,2949182,-,5752
536,BUMA.1121.00098,1,186438,192100,+,5662
536,BUMA.1121.00013,1,2309184,2314924,-,5740
536,BUMA.1121.00049,1,249115,254903,-,5788
536,BUMA.1121.00072,1,2229469,2235248,-,5779
536,BUMA.1121.00076,1,3717186,3722965,-,5779
536,BUMA.1121.00083,1,4066399,4072178,-,5779
536,BUMA.1121.00078,1,342230,348009,-,5779
536,BUMA.1121.00095,1,84665,90441,-,5776
536,BUMA.1121.00077,1,279027,284797,+,5770
536,BUMA.1121.00063,1,2253913,2259692,-,5779
536,BUMA.1121.00061,1,2256990,2262769,-,5779
536,BUMA.1121.00050,1,264667,270407,-,5740
536,BUMA.1121.00081,1,917633,923374,+,5741
536,BUMA.1121.00074,1,2235692,2241471,-,5779
536,BUMA.1121.00062,1,2963118,2968888,-,5770
536,BUMA.1121.00060,1,676728,682507,-,5779
536,BUMA.1121.00070,1,2227936,2233714,-,5778
536,BUMA.1121.00075,1,1090032,1095812,+,5780
536,BUMA.1121.00041,1,2908358,2914120,+,5762
536,BUMA.1121.00073,1,2255035,2260814,-,5779
536,BUMA.1121.00017,1,1911914,1917655,+,5741
536,BUMA.1121.00066,1,2230880,2236659,-,5779
536,BUMA.1121.00107,1,1497876,1503638,+,5762
536,BUMA.1121.00085,1,1372408,1378149,+,5741
536,BUMA.1121.00030,1,1911988,1917729,+,5741
536,BUMA.1121.00112,1,1405625,1411398,-,5773
536,BUMA.1121.00002,1,2287082,2292823,+,5741
536,BUMA.1121.00082,1,2410824,2416603,-,5779
536,BUMA.1121.00014,1,1160872,1166643,-,5771
536,BUMA.1121.00011,1,4059555,4065329,-,5774
536,BUMA.1121.00019,1,1976955,1982696,+,5741
536,BUMA.1121.00057,1,2675316,2681096,+,5780
536,BUMA.1121.00018,1,2193519,2199281,+,5762
536,BUMA.1121.00039,1,1737578,1743346,+,5768
536,BUMA.1121.00016,1,3798344,3804111,+,5767
536,BUMA.1121.00004,1,1978080,1983821,+,5741
536,BUMA.1121.00005,1,310909,316680,+,5771
536,BUMA.1121.00100,1,3727903,3733682,-,5779
536,BUMA.1121.00006,1,917558,923299,+,5741
537,BUMA.1121.00027,1,3793333,3801034,+,7701
537,BUMA.1121.00025,1,1052317,1060017,-,7700
537,BUMA.1121.00021,1,2257231,2264920,+,7689
537,BUMA.1121.00023,1,4066434,4074159,+,7725
537,BUMA.1121.00024,1,1983026,1990707,+,7681
537,BUMA.1121.00033,1,3903800,3911499,+,7699
537,BUMA.1121.00034,1,2020524,2028205,+,7681
537,BUMA.1121.00036,1,2122830,2130511,-,7681
537,BUMA.1121.00032,1,49928,57609,+,7681
537,BUMA.1121.00009,1,3960021,3967732,-,7711
537,BUMA.1121.00008,1,1996117,2003798,+,7681
537,BUMA.1121.00003,1,169435,177146,+,7711
537,BUMA.1121.00109,1,313238,320194,-,6956
537,BUMA.1121.00053,1,1326589,1334307,+,7718
537,BUMA.1121.00110,1,3189804,3197535,-,7731
537,BUMA.1121.00104,1,3618999,3626708,-,7709
537,BUMA.1121.00086,1,669427,677108,+,7681
537,BUMA.1121.00092,1,2207436,2215147,-,7711
537,BUMA.1121.00096,1,1664266,1671979,-,7713
537,BUMA.1121.00054,1,3211707,3219396,-,7689
537,BUMA.1121.00097,1,2327962,2335684,-,7722
537,BUMA.1121.00093,1,2411172,2418883,+,7711
537,BUMA.1121.00106,1,1363034,1370743,+,7709
537,BUMA.1121.00010,1,2266449,2274130,+,7681
537,BUMA.1121.00035,1,2775112,2782814,+,7702
537,BUMA.1121.00108,1,2575567,2583271,+,7704
537,BUMA.1121.00028,1,1983073,1990754,+,7681
537,BUMA.1121.00094,1,1630858,1638561,+,7703
537,BUMA.1121.00102,1,3805473,3813186,-,7713
537,BUMA.1121.00111,1,1797317,1805017,+,7700
537,BUMA.1121.00089,1,1599513,1607217,+,7704
537,BUMA.1121.00084,1,1966497,1974223,+,7726
537,BUMA.1121.00029,1,3305999,3313700,-,7701
537,BUMA.1121.00012,1,327306,335007,+,7701
537,BUMA.1121.00087,1,2639650,2647331,-,7681
537,BUMA.1121.00043,1,1711462,1719179,+,7717
537,BUMA.1121.00046,1,2487557,2495238,+,7681
537,BUMA.1121.00037,1,253474,261174,+,7700
537,BUMA.1121.00080,1,1629443,1637147,+,7704
537,BUMA.1121.00079,1,1624751,1632455,+,7704
537,BUMA.1121.00045,1,2442753,2450491,-,7738
537,BUMA.1121.00071,1,2238381,2246066,-,7685
537,BUMA.1121.00056,1,2318807,2326511,-,7704
537,BUMA.1121.00065,1,1701444,1709147,+,7703
537,BUMA.1121.00058,1,2948104,2955806,-,7702
537,BUMA.1121.00007,1,2453196,2460893,-,7697
537,BUMA.1121.00067,1,2783782,2791483,-,7701
537,BUMA.1121.00090,1,3797951,3805651,+,7700
537,BUMA.1121.00051,1,1610695,1618399,+,7704
537,BUMA.1121.00020,1,2047981,2055662,+,7681
537,BUMA.1121.00103,1,2801819,2809521,-,7702
537,BUMA.1121.00048,1,716313,724002,+,7689
537,BUMA.1121.00047,1,1341403,1349107,-,7704
537,BUMA.1121.00042,1,2429835,2437516,-,7681
537,BUMA.1121.00055,1,1186825,1194536,+,7711
537,BUMA.1121.00031,1,3056716,3064433,+,7717
537,BUMA.1121.00040,1,2454758,2462439,-,7681
537,BUMA.1121.00044,1,1248637,1256318,+,7681
537,BUMA.1121.00088,1,2508174,2515867,+,7693
537,BUMA.1121.00069,1,2220718,2228418,-,7700
537,BUMA.1121.00064,1,1624984,1632686,+,7702
537,BUMA.1121.00105,1,3619516,3627202,-,7686
537,BUMA.1121.00015,1,2157078,2164759,-,7681
537,BUMA.1121.00059,1,810239,817941,+,7702
537,BUMA.1121.00026,1,3512967,3520648,-,7681
537,BUMA.1121.00022,1,2319036,2326717,+,7681
537,BUMA.1121.00052,1,1781692,1789373,+,7681
537,BUMA.1121.00101,1,875055,882811,-,7756
537,BUMA.1121.00001,1,2423001,2430703,-,7702
537,BUMA.1121.00038,1,923787,931476,+,7689
537,BUMA.1121.00068,1,364082,371793,+,7711
537,BUMA.1121.00099,1,726880,734600,-,7720
537,BUMA.1121.00091,1,2933681,2941356,-,7675
537,BUMA.1121.00098,1,192587,200283,+,7696
537,BUMA.1121.00013,1,2301015,2308696,-,7681
537,BUMA.1121.00049,1,240916,248625,-,7709
537,BUMA.1121.00072,1,2221279,2228981,-,7702
537,BUMA.1121.00076,1,3709055,3716694,-,7639
537,BUMA.1121.00083,1,4058209,4065911,-,7702
537,BUMA.1121.00078,1,334056,341742,-,7686
537,BUMA.1121.00095,1,76466,84177,-,7711
537,BUMA.1121.00077,1,285285,293016,+,7731
537,BUMA.1121.00063,1,2245742,2253425,-,7683
537,BUMA.1121.00061,1,2248819,2256502,-,7683
537,BUMA.1121.00050,1,256498,264179,-,7681
537,BUMA.1121.00081,1,923856,931545,+,7689
537,BUMA.1121.00074,1,2227516,2235204,-,7688
537,BUMA.1121.00062,1,2954923,2962628,-,7705
537,BUMA.1121.00060,1,668497,676235,-,7738
537,BUMA.1121.00070,1,2219752,2227448,-,7696
537,BUMA.1121.00075,1,1096302,1103955,+,7653
537,BUMA.1121.00041,1,2914611,2922293,+,7682
537,BUMA.1121.00073,1,2246845,2254547,-,7702
537,BUMA.1121.00017,1,1918143,1925824,+,7681
537,BUMA.1121.00066,1,2222705,2230392,-,7687
537,BUMA.1121.00107,1,1504125,1511812,+,7687
537,BUMA.1121.00085,1,1378637,1386318,+,7681
537,BUMA.1121.00030,1,1918217,1925898,+,7681
537,BUMA.1121.00112,1,1397416,1405138,-,7722
537,BUMA.1121.00002,1,2293311,2300992,+,7681
537,BUMA.1121.00082,1,2402634,2410336,-,7702
537,BUMA.1121.00014,1,1152665,1160382,-,7717
537,BUMA.1121.00011,1,4051364,4059072,-,7708
537,BUMA.1121.00019,1,1983184,1990865,+,7681
537,BUMA.1121.00057,1,2683176,2690904,+,7728
537,BUMA.1121.00018,1,2199771,2207471,+,7700
537,BUMA.1121.00039,1,1743836,1751536,+,7700
537,BUMA.1121.00016,1,3804601,3812291,+,7690
537,BUMA.1121.00004,1,1984309,1991990,+,7681
537,BUMA.1121.00005,1,317167,324856,+,7689
537,BUMA.1121.00100,1,3719718,3727415,-,7697
537,BUMA.1121.00006,1,923781,931470,+,7689
538,BUMA.1121.00027,1,3803682,3810339,+,6657
538,BUMA.1121.00025,1,1042973,1049669,-,6696
538,BUMA.1121.00021,1,2267561,2274266,+,6705
538,BUMA.1121.00023,1,4076807,4083497,+,6690
538,BUMA.1121.00024,1,1993341,2000074,+,6733
538,BUMA.1121.00033,1,3914147,3920813,+,6666
538,BUMA.1121.00034,1,2030839,2037572,+,6733
538,BUMA.1121.00036,1,2113445,2120196,-,6751
538,BUMA.1121.00032,1,60243,66976,+,6733
538,BUMA.1121.00009,1,3950538,3957369,-,6831
538,BUMA.1121.00008,1,2006432,2013165,+,6733
538,BUMA.1121.00003,1,179787,186507,+,6720
538,BUMA.1121.00109,1,303954,310579,-,6625
538,BUMA.1121.00053,1,1336955,1343614,+,6659
538,BUMA.1121.00110,1,3178839,3185568,-,6729
538,BUMA.1121.00104,1,3609617,3616351,-,6734
538,BUMA.1121.00086,1,679742,686484,+,6742
538,BUMA.1121.00092,1,2197981,2204766,-,6785
538,BUMA.1121.00096,1,1654902,1661625,-,6723
538,BUMA.1121.00054,1,3202322,3209073,-,6751
538,BUMA.1121.00097,1,2318700,2325314,-,6614
538,BUMA.1121.00093,1,2421553,2428338,+,6785
538,BUMA.1121.00106,1,1373391,1380161,+,6770
538,BUMA.1121.00010,1,2276764,2283500,+,6736
538,BUMA.1121.00035,1,2785462,2792128,+,6666
538,BUMA.1121.00108,1,2585912,2592695,+,6783
538,BUMA.1121.00028,1,1993388,2000121,+,6733
538,BUMA.1121.00094,1,1641202,1647865,+,6663
538,BUMA.1121.00102,1,3796060,3802713,-,6653
538,BUMA.1121.00111,1,1807665,1814349,+,6684
538,BUMA.1121.00089,1,1609858,1616521,+,6663
538,BUMA.1121.00084,1,1976885,1983640,+,6755
538,BUMA.1121.00029,1,3296694,3303351,-,6657
538,BUMA.1121.00012,1,337655,344389,+,6734
538,BUMA.1121.00087,1,2630283,2637016,-,6733
538,BUMA.1121.00043,1,1721827,1728538,+,6711
538,BUMA.1121.00046,1,2497872,2504596,+,6724
538,BUMA.1121.00037,1,263822,270514,+,6692
538,BUMA.1121.00080,1,1639827,1646542,+,6715
538,BUMA.1121.00079,1,1635093,1641767,+,6674
538,BUMA.1121.00045,1,2433487,2440105,-,6618
538,BUMA.1121.00071,1,2229083,2235733,-,6650
538,BUMA.1121.00056,1,2309503,2316166,-,6663
538,BUMA.1121.00065,1,1711802,1718490,+,6688
538,BUMA.1121.00058,1,2938650,2945445,-,6795
538,BUMA.1121.00007,1,2443788,2450485,-,6697
538,BUMA.1121.00067,1,2774228,2781081,-,6853
538,BUMA.1121.00090,1,3808299,3814968,+,6669
538,BUMA.1121.00051,1,1621040,1627724,+,6684
538,BUMA.1121.00020,1,2058296,2065029,+,6733
538,BUMA.1121.00103,1,2792494,2799181,-,6687
538,BUMA.1121.00048,1,726636,733387,+,6751
538,BUMA.1121.00047,1,1332087,1338762,-,6675
538,BUMA.1121.00042,1,2420422,2427199,-,6777
538,BUMA.1121.00055,1,1197205,1203978,+,6773
538,BUMA.1121.00031,1,3067081,3073759,+,6678
538,BUMA.1121.00040,1,2445355,2452124,-,6769
538,BUMA.1121.00044,1,1258952,1265685,+,6733
538,BUMA.1121.00088,1,2518515,2525330,+,6815
538,BUMA.1121.00069,1,2211413,2218070,-,6657
538,BUMA.1121.00064,1,1635345,1642099,+,6754
538,BUMA.1121.00105,1,3610113,3616833,-,6720
538,BUMA.1121.00015,1,2147711,2154444,-,6733
538,BUMA.1121.00059,1,820666,827392,+,6726
538,BUMA.1121.00026,1,3503554,3510331,-,6777
538,BUMA.1121.00022,1,2329351,2336120,+,6769
538,BUMA.1121.00052,1,1792007,1798719,+,6712
538,BUMA.1121.00101,1,865697,872407,-,6710
538,BUMA.1121.00001,1,2413687,2420353,-,6666
538,BUMA.1121.00038,1,934110,940861,+,6751
538,BUMA.1121.00068,1,374391,381036,+,6645
538,BUMA.1121.00099,1,717538,724232,-,6694
538,BUMA.1121.00091,1,2924375,2931029,-,6654
538,BUMA.1121.00098,1,202923,209541,+,6618
538,BUMA.1121.00013,1,2291651,2298381,-,6730
538,BUMA.1121.00049,1,231489,238268,-,6779
538,BUMA.1121.00072,1,2211975,2218631,-,6656
538,BUMA.1121.00076,1,3699569,3706361,-,6792
538,BUMA.1121.00083,1,4048904,4055561,-,6657
538,BUMA.1121.00078,1,324719,331409,-,6690
538,BUMA.1121.00095,1,65583,72207,-,6624
538,BUMA.1121.00077,1,297250,303987,+,6737
538,BUMA.1121.00063,1,2236445,2243094,-,6649
538,BUMA.1121.00061,1,2239515,2246171,-,6656
538,BUMA.1121.00050,1,247140,253864,-,6724
538,BUMA.1121.00081,1,934179,940930,+,6751
538,BUMA.1121.00074,1,2217982,2224808,-,6826
538,BUMA.1121.00062,1,2945470,2952222,-,6752
538,BUMA.1121.00060,1,659231,665849,-,6618
538,BUMA.1121.00070,1,2210448,2217104,-,6656
538,BUMA.1121.00075,1,1106632,1113450,+,6818
538,BUMA.1121.00041,1,2924934,2931587,+,6653
538,BUMA.1121.00073,1,2237541,2244197,-,6656
538,BUMA.1121.00017,1,1928458,1935191,+,6733
538,BUMA.1121.00066,1,2213408,2220057,-,6649
538,BUMA.1121.00107,1,1514452,1521234,+,6782
538,BUMA.1121.00085,1,1388952,1395664,+,6712
538,BUMA.1121.00030,1,1928532,1935265,+,6733
538,BUMA.1121.00112,1,1388135,1394775,-,6640
538,BUMA.1121.00002,1,2303626,2310377,+,6751
538,BUMA.1121.00082,1,2393329,2399986,-,6657
538,BUMA.1121.00014,1,1143315,1150017,-,6702
538,BUMA.1121.00011,1,4042001,4048723,-,6722
538,BUMA.1121.00019,1,1993499,2000232,+,6733
538,BUMA.1121.00057,1,2693570,2700451,+,6881
538,BUMA.1121.00018,1,2210119,2216814,+,6695
538,BUMA.1121.00039,1,1754184,1760877,+,6693
538,BUMA.1121.00016,1,3814939,3821605,+,6666
538,BUMA.1121.00004,1,1994624,2001357,+,6733
538,BUMA.1121.00005,1,327504,334216,+,6712
538,BUMA.1121.00100,1,3710331,3717029,-,6698
538,BUMA.1121.00006,1,934102,940853,+,6751
539,BUMA.1121.00027,1,3810813,3825561,+,14748
539,BUMA.1121.00025,1,1027642,1042427,-,14785
539,BUMA.1121.00021,1,2274668,2289445,+,14777
539,BUMA.1121.00023,1,4083998,4098857,+,14859
539,BUMA.1121.00024,1,2001386,2016066,+,14680
539,BUMA.1121.00033,1,3921197,3935946,+,14749
539,BUMA.1121.00034,1,2038884,2053555,+,14671
539,BUMA.1121.00036,1,2097470,2112133,-,14663
539,BUMA.1121.00032,1,68288,82959,+,14671
539,BUMA.1121.00009,1,3935419,3950082,-,14663
539,BUMA.1121.00008,1,2014477,2029148,+,14671
539,BUMA.1121.00003,1,186936,201627,+,14691
539,BUMA.1121.00109,1,288551,303408,-,14857
539,BUMA.1121.00053,1,1344088,1358827,+,14739
539,BUMA.1121.00110,1,3163654,3178365,-,14711
539,BUMA.1121.00104,1,3594485,3609206,-,14721
539,BUMA.1121.00086,1,687796,702449,+,14653
539,BUMA.1121.00092,1,2182507,2197246,-,14739
539,BUMA.1121.00096,1,1639764,1654401,-,14637
539,BUMA.1121.00054,1,3186347,3201010,-,14663
539,BUMA.1121.00097,1,2303441,2318199,-,14758
539,BUMA.1121.00093,1,2429073,2443811,+,14738
539,BUMA.1121.00106,1,1380536,1395265,+,14729
539,BUMA.1121.00010,1,2284812,2299492,+,14680
539,BUMA.1121.00035,1,2792575,2807299,+,14724
539,BUMA.1121.00108,1,2593133,2608315,+,15182
539,BUMA.1121.00028,1,2001433,2016113,+,14680
539,BUMA.1121.00094,1,1648321,1663005,+,14684
539,BUMA.1121.00102,1,3780595,3795379,-,14784
539,BUMA.1121.00111,1,1814796,1829563,+,14767
539,BUMA.1121.00089,1,1616977,1631661,+,14684
539,BUMA.1121.00084,1,1984033,1998705,+,14672
539,BUMA.1121.00029,1,3281441,3296247,-,14806
539,BUMA.1121.00012,1,344962,359695,+,14733
539,BUMA.1121.00087,1,2614316,2628970,-,14654
539,BUMA.1121.00043,1,1729093,1743887,+,14794
539,BUMA.1121.00046,1,2505908,2520588,+,14680
539,BUMA.1121.00037,1,270925,285654,+,14729
539,BUMA.1121.00080,1,1647043,1661745,+,14702
539,BUMA.1121.00079,1,1642258,1656960,+,14702
539,BUMA.1121.00045,1,2418131,2432995,-,14864
539,BUMA.1121.00071,1,2213838,2228589,-,14751
539,BUMA.1121.00056,1,2294362,2309047,-,14685
539,BUMA.1121.00065,1,1718847,1733641,+,14794
539,BUMA.1121.00058,1,2923504,2938230,-,14726
539,BUMA.1121.00007,1,2428605,2443341,-,14736
539,BUMA.1121.00067,1,2758980,2773700,-,14720
539,BUMA.1121.00090,1,3815433,3830200,+,14767
539,BUMA.1121.00051,1,1628337,1643048,+,14711
539,BUMA.1121.00020,1,2066341,2081012,+,14671
539,BUMA.1121.00103,1,2777175,2792002,-,14827
539,BUMA.1121.00048,1,734699,749361,+,14662
539,BUMA.1121.00047,1,1316667,1331388,-,14721
539,BUMA.1121.00042,1,2404447,2419110,-,14663
539,BUMA.1121.00055,1,1204416,1219102,+,14686
539,BUMA.1121.00031,1,3074206,3088946,+,14740
539,BUMA.1121.00040,1,2049194,2063865,+,14671
539,BUMA.1121.00044,1,1266997,1281668,+,14671
539,BUMA.1121.00088,1,2525705,2540397,+,14692
539,BUMA.1121.00069,1,2196257,2210971,-,14714
539,BUMA.1121.00064,1,1642501,1657249,+,14748
539,BUMA.1121.00105,1,3595006,3609738,-,14732
539,BUMA.1121.00015,1,2131736,2146399,-,14663
539,BUMA.1121.00059,1,827911,842631,+,14720
539,BUMA.1121.00026,1,3487579,3502242,-,14663
539,BUMA.1121.00022,1,2337432,2352094,+,14662
539,BUMA.1121.00052,1,1800031,1814702,+,14671
539,BUMA.1121.00101,1,850550,865232,-,14682
539,BUMA.1121.00001,1,2398479,2413231,-,14752
539,BUMA.1121.00038,1,942173,956835,+,14662
539,BUMA.1121.00068,1,381870,396634,+,14764
539,BUMA.1121.00099,1,702379,717082,-,14703
539,BUMA.1121.00091,1,2909062,2923874,-,14812
539,BUMA.1121.00098,1,209961,224734,+,14773
539,BUMA.1121.00013,1,2275667,2290339,-,14672
539,BUMA.1121.00049,1,216368,231078,-,14710
539,BUMA.1121.00072,1,2196707,2211465,-,14758
539,BUMA.1121.00076,1,3684503,3699131,-,14628
539,BUMA.1121.00083,1,4033636,4048394,-,14758
539,BUMA.1121.00078,1,309452,324119,-,14667
539,BUMA.1121.00095,1,50373,65064,-,14691
539,BUMA.1121.00077,1,304461,319172,+,14711
539,BUMA.1121.00063,1,2221200,2235951,-,14751
539,BUMA.1121.00061,1,2224254,2239005,-,14751
539,BUMA.1121.00050,1,231148,245829,-,14681
539,BUMA.1121.00081,1,942242,956904,+,14662
539,BUMA.1121.00074,1,2202878,2217625,-,14747
539,BUMA.1121.00062,1,2930330,2945077,-,14747
539,BUMA.1121.00060,1,643884,658739,-,14855
539,BUMA.1121.00070,1,2195254,2209938,-,14684
539,BUMA.1121.00075,1,1113789,1128412,+,14623
539,BUMA.1121.00041,1,2932034,2946784,+,14750
539,BUMA.1121.00073,1,2222279,2237031,-,14752
539,BUMA.1121.00017,1,1936503,1951174,+,14671
539,BUMA.1121.00066,1,2198191,2212913,-,14722
539,BUMA.1121.00107,1,1521726,1536371,+,14645
539,BUMA.1121.00085,1,1396976,1411647,+,14671
539,BUMA.1121.00030,1,1936577,1951248,+,14671
539,BUMA.1121.00112,1,1372924,1387607,-,14683
539,BUMA.1121.00002,1,2311689,2326369,+,14680
539,BUMA.1121.00082,1,2378061,2392819,-,14758
539,BUMA.1121.00014,1,1128057,1142868,-,14811
539,BUMA.1121.00011,1,4026802,4041473,-,14671
539,BUMA.1121.00019,1,2001544,2016215,+,14671
539,BUMA.1121.00057,1,2700817,2715510,+,14693
539,BUMA.1121.00018,1,2217351,2232135,+,14784
539,BUMA.1121.00039,1,1761342,1776070,+,14728
539,BUMA.1121.00016,1,3822088,3836837,+,14749
539,BUMA.1121.00004,1,2002669,2017340,+,14671
539,BUMA.1121.00005,1,334654,349438,+,14784
539,BUMA.1121.00100,1,3695169,3709830,-,14661
539,BUMA.1121.00006,1,942165,956827,+,14662
540,BUMA.1121.00027,1,3826682,3844702,+,18020
540,BUMA.1121.00025,1,1008499,1026521,-,18022
540,BUMA.1121.00021,1,2290566,2308587,+,18021
540,BUMA.1121.00023,1,779,18801,+,18022
540,BUMA.1121.00024,1,2017187,2035209,+,18022
540,BUMA.1121.00033,1,3937067,3955087,+,18020
540,BUMA.1121.00034,1,2054676,2072698,+,18022
540,BUMA.1121.00036,1,2078327,2096349,-,18022
540,BUMA.1121.00032,1,84080,102102,+,18022
540,BUMA.1121.00009,1,3916281,3934298,-,18017
540,BUMA.1121.00008,1,2030269,2048291,+,18022
540,BUMA.1121.00003,1,202748,220720,+,17972
540,BUMA.1121.00109,1,269408,287430,-,18022
540,BUMA.1121.00053,1,1359948,1377970,+,18022
540,BUMA.1121.00110,1,3144510,3162533,-,18023
540,BUMA.1121.00104,1,3575341,3593364,-,18023
540,BUMA.1121.00086,1,703570,721592,+,18022
540,BUMA.1121.00092,1,2163364,2181386,-,18022
540,BUMA.1121.00096,1,1620620,1638643,-,18023
540,BUMA.1121.00054,1,3167204,3185226,-,18022
540,BUMA.1121.00097,1,2284297,2302320,-,18023
540,BUMA.1121.00093,1,2444932,2462954,+,18022
540,BUMA.1121.00106,1,1396386,1414408,+,18022
540,BUMA.1121.00010,1,2300613,2318635,+,18022
540,BUMA.1121.00035,1,2808420,2826442,+,18022
540,BUMA.1121.00108,1,2609436,2627458,+,18022
540,BUMA.1121.00028,1,2017234,2035256,+,18022
540,BUMA.1121.00094,1,1664126,1682147,+,18021
540,BUMA.1121.00102,1,3761452,3779474,-,18022
540,BUMA.1121.00111,1,1830684,1848706,+,18022
540,BUMA.1121.00089,1,1632782,1650804,+,18022
540,BUMA.1121.00084,1,1999826,2017848,+,18022
540,BUMA.1121.00029,1,3262298,3280320,-,18022
540,BUMA.1121.00012,1,360816,378838,+,18022
540,BUMA.1121.00087,1,2595173,2613195,-,18022
540,BUMA.1121.00043,1,1745008,1763030,+,18022
540,BUMA.1121.00046,1,2521709,2539731,+,18022
540,BUMA.1121.00037,1,286775,304796,+,18021
540,BUMA.1121.00080,1,1662866,1680888,+,18022
540,BUMA.1121.00079,1,1658081,1676101,+,18020
540,BUMA.1121.00045,1,2398987,2417010,-,18023
540,BUMA.1121.00071,1,2194695,2212717,-,18022
540,BUMA.1121.00056,1,2275219,2293241,-,18022
540,BUMA.1121.00065,1,1734762,1752784,+,18022
540,BUMA.1121.00058,1,2904361,2922383,-,18022
540,BUMA.1121.00007,1,2409462,2427484,-,18022
540,BUMA.1121.00067,1,2739837,2757859,-,18022
540,BUMA.1121.00090,1,3831321,3849343,+,18022
540,BUMA.1121.00051,1,1644169,1662190,+,18021
540,BUMA.1121.00020,1,2082133,2100155,+,18022
540,BUMA.1121.00103,1,2758032,2776054,-,18022
540,BUMA.1121.00048,1,750482,768504,+,18022
540,BUMA.1121.00047,1,1297524,1315546,-,18022
540,BUMA.1121.00042,1,2385303,2403326,-,18023
540,BUMA.1121.00055,1,1220223,1238245,+,18022
540,BUMA.1121.00031,1,3090067,3108088,+,18021
540,BUMA.1121.00040,1,2064986,2083008,+,18022
540,BUMA.1121.00044,1,1282789,1300811,+,18022
540,BUMA.1121.00088,1,2541518,2559540,+,18022
540,BUMA.1121.00069,1,2177114,2195136,-,18022
540,BUMA.1121.00064,1,1658370,1676393,+,18023
540,BUMA.1121.00105,1,3575863,3593885,-,18022
540,BUMA.1121.00015,1,2112593,2130615,-,18022
540,BUMA.1121.00059,1,843752,861774,+,18022
540,BUMA.1121.00026,1,3468436,3486458,-,18022
540,BUMA.1121.00022,1,2353215,2371237,+,18022
540,BUMA.1121.00052,1,1815823,1833844,+,18021
540,BUMA.1121.00101,1,831408,849429,-,18021
540,BUMA.1121.00001,1,2379339,2397358,-,18019
540,BUMA.1121.00038,1,957956,975978,+,18022
540,BUMA.1121.00068,1,397755,415777,+,18022
540,BUMA.1121.00099,1,683233,701258,-,18025
540,BUMA.1121.00091,1,2889919,2907941,-,18022
540,BUMA.1121.00098,1,225855,243877,+,18022
540,BUMA.1121.00013,1,2256524,2274546,-,18022
540,BUMA.1121.00049,1,197225,215247,-,18022
540,BUMA.1121.00072,1,2177564,2195586,-,18022
540,BUMA.1121.00076,1,3665360,3683382,-,18022
540,BUMA.1121.00083,1,4014493,4032515,-,18022
540,BUMA.1121.00078,1,290309,308331,-,18022
540,BUMA.1121.00095,1,31230,49252,-,18022
540,BUMA.1121.00077,1,320293,338316,+,18023
540,BUMA.1121.00063,1,2202057,2220079,-,18022
540,BUMA.1121.00061,1,2205111,2223133,-,18022
540,BUMA.1121.00050,1,212005,230027,-,18022
540,BUMA.1121.00081,1,958025,976047,+,18022
540,BUMA.1121.00074,1,2183734,2201757,-,18023
540,BUMA.1121.00062,1,2911187,2929209,-,18022
540,BUMA.1121.00060,1,624740,642763,-,18023
540,BUMA.1121.00070,1,2176111,2194133,-,18022
540,BUMA.1121.00075,1,1129533,1147555,+,18022
540,BUMA.1121.00041,1,2947905,2965925,+,18020
540,BUMA.1121.00073,1,2203136,2221158,-,18022
540,BUMA.1121.00017,1,1952295,1970317,+,18022
540,BUMA.1121.00066,1,2179048,2197070,-,18022
540,BUMA.1121.00107,1,1537492,1555515,+,18023
540,BUMA.1121.00085,1,1412768,1430789,+,18021
540,BUMA.1121.00030,1,1952369,1970391,+,18022
540,BUMA.1121.00112,1,1353781,1371803,-,18022
540,BUMA.1121.00002,1,2327490,2345512,+,18022
540,BUMA.1121.00082,1,2358918,2376940,-,18022
540,BUMA.1121.00014,1,1108914,1126936,-,18022
540,BUMA.1121.00011,1,4007659,4025681,-,18022
540,BUMA.1121.00019,1,2017336,2035358,+,18022
540,BUMA.1121.00057,1,2716631,2734654,+,18023
540,BUMA.1121.00018,1,2233256,2251278,+,18022
540,BUMA.1121.00039,1,1777191,1795213,+,18022
540,BUMA.1121.00016,1,3837958,3855980,+,18022
540,BUMA.1121.00004,1,2018461,2036483,+,18022
540,BUMA.1121.00005,1,350559,368581,+,18022
540,BUMA.1121.00100,1,3676026,3694048,-,18022
540,BUMA.1121.00006,1,957948,975970,+,18022
541,BUMA.1121.00027,1,3844704,3861651,+,16947
541,BUMA.1121.00025,1,991751,1008498,-,16747
541,BUMA.1121.00021,1,2308589,2325483,+,16894
541,BUMA.1121.00023,1,18803,35583,+,16780
541,BUMA.1121.00024,1,2035211,2051933,+,16722
541,BUMA.1121.00033,1,3955089,3971840,+,16751
541,BUMA.1121.00034,1,2072700,2089413,+,16713
541,BUMA.1121.00036,1,2061622,2078326,-,16704
541,BUMA.1121.00032,1,46,16754,+,16708
541,BUMA.1121.00032,1,102104,118826,+,16722
541,BUMA.1121.00009,1,3899479,3916280,-,16801
541,BUMA.1121.00008,1,2048293,2065015,+,16722
541,BUMA.1121.00003,1,220722,237566,+,16844
541,BUMA.1121.00109,1,252555,269407,-,16852
541,BUMA.1121.00053,1,1377972,1394885,+,16913
541,BUMA.1121.00110,1,3127795,3144509,-,16714
541,BUMA.1121.00104,1,3558558,3575340,-,16782
541,BUMA.1121.00086,1,721594,738297,+,16703
541,BUMA.1121.00092,1,2146576,2163363,-,16787
541,BUMA.1121.00096,1,1603885,1620619,-,16734
541,BUMA.1121.00054,1,3150481,3167203,-,16722
541,BUMA.1121.00097,1,2267505,2284296,-,16791
541,BUMA.1121.00093,1,2462956,2479742,+,16786
541,BUMA.1121.00106,1,1414410,1431216,+,16806
541,BUMA.1121.00010,1,2318637,2335365,+,16728
541,BUMA.1121.00035,1,2826444,2843124,+,16680
541,BUMA.1121.00108,1,2627460,2644226,+,16766
541,BUMA.1121.00028,1,2035258,2051980,+,16722
541,BUMA.1121.00094,1,1682149,1698909,+,16760
541,BUMA.1121.00102,1,3744385,3761451,-,17066
541,BUMA.1121.00111,1,1848708,1865472,+,16764
541,BUMA.1121.00089,1,1650806,1667524,+,16718
541,BUMA.1121.00084,1,2017850,2034623,+,16773
541,BUMA.1121.00029,1,3245615,3262297,-,16682
541,BUMA.1121.00012,1,378840,395578,+,16738
541,BUMA.1121.00087,1,2578468,2595172,-,16704
541,BUMA.1121.00043,1,1763032,1779770,+,16738
541,BUMA.1121.00046,1,2539733,2556442,+,16709
541,BUMA.1121.00037,1,304798,321534,+,16736
541,BUMA.1121.00080,1,1680890,1697637,+,16747
541,BUMA.1121.00079,1,1676103,1692823,+,16720
541,BUMA.1121.00045,1,2382249,2398986,-,16737
541,BUMA.1121.00071,1,2177871,2194694,-,16823
541,BUMA.1121.00056,1,2258499,2275218,-,16719
541,BUMA.1121.00065,1,1752786,1769770,+,16984
541,BUMA.1121.00058,1,2887662,2904360,-,16698
541,BUMA.1121.00007,1,2392798,2409461,-,16663
541,BUMA.1121.00067,1,2723056,2739836,-,16780
541,BUMA.1121.00090,1,3849345,3866155,+,16810
541,BUMA.1121.00051,1,1662192,1678976,+,16784
541,BUMA.1121.00020,1,2100157,2116879,+,16722
541,BUMA.1121.00103,1,2741179,2758031,-,16852
541,BUMA.1121.00048,1,768506,785227,+,16721
541,BUMA.1121.00047,1,1280827,1297523,-,16696
541,BUMA.1121.00042,1,2368606,2385302,-,16696
541,BUMA.1121.00055,1,1238247,1255077,+,16830
541,BUMA.1121.00031,1,3108090,3124873,+,16783
541,BUMA.1121.00040,1,2083010,2099713,+,16703
541,BUMA.1121.00044,1,1300813,1317526,+,16713
541,BUMA.1121.00088,1,2559542,2576400,+,16858
541,BUMA.1121.00069,1,2160305,2177113,-,16808
541,BUMA.1121.00064,1,1676395,1693181,+,16786
541,BUMA.1121.00105,1,3559138,3575862,-,16724
541,BUMA.1121.00015,1,2095912,2112592,-,16680
541,BUMA.1121.00059,1,861776,878700,+,16924
541,BUMA.1121.00026,1,3451687,3468435,-,16748
541,BUMA.1121.00022,1,2371239,2387958,+,16719
541,BUMA.1121.00052,1,1833846,1850523,+,16677
541,BUMA.1121.00101,1,814677,831407,-,16730
541,BUMA.1121.00001,1,2362649,2379338,-,16689
541,BUMA.1121.00038,1,975980,992701,+,16721
541,BUMA.1121.00068,1,415779,432554,+,16775
541,BUMA.1121.00099,1,666497,683232,-,16735
541,BUMA.1121.00091,1,2872996,2889918,-,16922
541,BUMA.1121.00098,1,243879,260569,+,16690
541,BUMA.1121.00013,1,2239853,2256523,-,16670
541,BUMA.1121.00049,1,180408,197224,-,16816
541,BUMA.1121.00072,1,2160723,2177563,-,16840
541,BUMA.1121.00076,1,3648564,3665359,-,16795
541,BUMA.1121.00083,1,3997552,4014492,-,16940
541,BUMA.1121.00078,1,273487,290308,-,16821
541,BUMA.1121.00095,1,14514,31229,-,16715
541,BUMA.1121.00077,1,338318,355029,+,16711
541,BUMA.1121.00063,1,2185121,2202056,-,16935
541,BUMA.1121.00061,1,2188170,2205110,-,16940
541,BUMA.1121.00050,1,195294,212004,-,16710
541,BUMA.1121.00081,1,976049,992770,+,16721
541,BUMA.1121.00074,1,2166902,2183733,-,16831
541,BUMA.1121.00062,1,2894409,2911186,-,16777
541,BUMA.1121.00060,1,608002,624739,-,16737
541,BUMA.1121.00070,1,2159319,2176110,-,16791
541,BUMA.1121.00075,1,1147557,1164355,+,16798
541,BUMA.1121.00041,1,2965927,2982838,+,16911
541,BUMA.1121.00073,1,2186344,2203135,-,16791
541,BUMA.1121.00017,1,1970319,1987032,+,16713
541,BUMA.1121.00066,1,2162108,2179047,-,16939
541,BUMA.1121.00107,1,1555517,1572220,+,16703
541,BUMA.1121.00085,1,1430791,1447468,+,16677
541,BUMA.1121.00030,1,1970393,1987106,+,16713
541,BUMA.1121.00112,1,1337085,1353780,-,16695
541,BUMA.1121.00002,1,2345514,2362242,+,16728
541,BUMA.1121.00082,1,2341977,2358917,-,16940
541,BUMA.1121.00014,1,1092137,1108913,-,16776
541,BUMA.1121.00011,1,3990977,4007658,-,16681
541,BUMA.1121.00019,1,2035360,2052073,+,16713
541,BUMA.1121.00057,1,2734656,2751628,+,16972
541,BUMA.1121.00018,1,2251280,2268009,+,16729
541,BUMA.1121.00039,1,1795215,1812018,+,16803
541,BUMA.1121.00016,1,3855982,3872824,+,16842
541,BUMA.1121.00004,1,2036485,2051931,+,15446
541,BUMA.1121.00005,1,368583,385458,+,16875
541,BUMA.1121.00100,1,3659264,3676025,-,16761
541,BUMA.1121.00006,1,975972,992693,+,16721
542,BUMA.1121.00027,1,3861653,3867159,+,5506
542,BUMA.1121.00025,1,938612,944051,-,5439
542,BUMA.1121.00021,1,2325485,2330946,+,5461
542,BUMA.1121.00023,1,35585,41046,+,5461
542,BUMA.1121.00024,1,2051935,2057389,+,5454
542,BUMA.1121.00033,1,3971842,3977303,+,5461
542,BUMA.1121.00034,1,2089415,2094869,+,5454
542,BUMA.1121.00036,1,2056166,2061621,-,5455
542,BUMA.1121.00032,1,16756,22210,+,5454
542,BUMA.1121.00032,1,118828,124282,+,5454
542,BUMA.1121.00009,1,3894007,3899478,-,5471
542,BUMA.1121.00008,1,2065017,2070471,+,5454
542,BUMA.1121.00003,1,237568,243056,+,5488
542,BUMA.1121.00109,1,247021,252554,-,5533
542,BUMA.1121.00053,1,1394887,1400348,+,5461
542,BUMA.1121.00110,1,3122303,3127794,-,5491
542,BUMA.1121.00104,1,3553023,3558557,-,5534
542,BUMA.1121.00086,1,738299,743753,+,5454
542,BUMA.1121.00092,1,2141041,2146575,-,5534
542,BUMA.1121.00096,1,1598413,1603884,-,5471
542,BUMA.1121.00054,1,3145022,3150480,-,5458
542,BUMA.1121.00097,1,2262005,2267504,-,5499
542,BUMA.1121.00093,1,2479744,2485277,+,5533
542,BUMA.1121.00106,1,1431218,1436769,+,5551
542,BUMA.1121.00010,1,2335367,2340821,+,5454
542,BUMA.1121.00035,1,2843126,2848587,+,5461
542,BUMA.1121.00108,1,2644228,2649734,+,5506
542,BUMA.1121.00028,1,2051982,2057436,+,5454
542,BUMA.1121.00094,1,1698911,1704399,+,5488
542,BUMA.1121.00102,1,3738868,3744384,-,5516
542,BUMA.1121.00111,1,1865474,1870935,+,5461
542,BUMA.1121.00089,1,1667526,1673068,+,5542
542,BUMA.1121.00084,1,2034625,2040095,+,5470
542,BUMA.1121.00029,1,3240152,3245614,-,5462
542,BUMA.1121.00012,1,395580,401041,+,5461
542,BUMA.1121.00087,1,2573012,2578467,-,5455
542,BUMA.1121.00043,1,1779772,1785233,+,5461
542,BUMA.1121.00046,1,2556444,2561901,+,5457
542,BUMA.1121.00037,1,321536,326997,+,5461
542,BUMA.1121.00080,1,1697639,1703136,+,5497
542,BUMA.1121.00079,1,1692825,1698331,+,5506
542,BUMA.1121.00045,1,2376749,2382248,-,5499
542,BUMA.1121.00071,1,2172384,2177870,-,5486
542,BUMA.1121.00056,1,2252955,2258498,-,5543
542,BUMA.1121.00065,1,1769772,1775296,+,5524
542,BUMA.1121.00058,1,2882190,2887661,-,5471
542,BUMA.1121.00007,1,2387281,2392797,-,5516
542,BUMA.1121.00067,1,2717539,2723055,-,5516
542,BUMA.1121.00090,1,3866157,3871618,+,5461
542,BUMA.1121.00051,1,1678978,1684484,+,5506
542,BUMA.1121.00020,1,2116881,2122335,+,5454
542,BUMA.1121.00103,1,2735724,2741178,-,5454
542,BUMA.1121.00048,1,785229,790686,+,5457
542,BUMA.1121.00047,1,1275265,1280826,-,5561
542,BUMA.1121.00042,1,2363145,2368605,-,5460
542,BUMA.1121.00055,1,1255079,1260603,+,5524
542,BUMA.1121.00031,1,3124875,3130372,+,5497
542,BUMA.1121.00040,1,2099715,2105172,+,5457
542,BUMA.1121.00044,1,1317528,1322982,+,5454
542,BUMA.1121.00088,1,2576402,2581917,+,5515
542,BUMA.1121.00069,1,2154819,2160304,-,5485
542,BUMA.1121.00064,1,1693183,1698662,+,5479
542,BUMA.1121.00105,1,3553603,3559137,-,5534
542,BUMA.1121.00015,1,2090456,2095911,-,5455
542,BUMA.1121.00059,1,878702,884217,+,5515
542,BUMA.1121.00026,1,3446226,3451686,-,5460
542,BUMA.1121.00022,1,2387960,2393414,+,5454
542,BUMA.1121.00052,1,1850525,1855982,+,5457
542,BUMA.1121.00101,1,809187,814676,-,5489
542,BUMA.1121.00001,1,2357186,2362648,-,5462
542,BUMA.1121.00038,1,992703,998160,+,5457
542,BUMA.1121.00068,1,432556,438035,+,5479
542,BUMA.1121.00099,1,660972,666496,-,5524
542,BUMA.1121.00091,1,2867469,2872995,-,5526
542,BUMA.1121.00098,1,260571,266105,+,5534
542,BUMA.1121.00013,1,2234394,2239852,-,5458
542,BUMA.1121.00049,1,174900,180407,-,5507
542,BUMA.1121.00072,1,2155215,2160722,-,5507
542,BUMA.1121.00076,1,3643073,3648563,-,5490
542,BUMA.1121.00083,1,3992044,3997551,-,5507
542,BUMA.1121.00078,1,268024,273486,-,5462
542,BUMA.1121.00095,1,9024,14513,-,5489
542,BUMA.1121.00077,1,355031,360521,+,5490
542,BUMA.1121.00063,1,2179613,2185120,-,5507
542,BUMA.1121.00061,1,2182683,2188169,-,5486
542,BUMA.1121.00050,1,189835,195293,-,5458
542,BUMA.1121.00081,1,992772,998229,+,5457
542,BUMA.1121.00074,1,2161421,2166901,-,5480
542,BUMA.1121.00062,1,2888901,2894408,-,5507
542,BUMA.1121.00060,1,602502,608001,-,5499
542,BUMA.1121.00070,1,2153833,2159318,-,5485
542,BUMA.1121.00075,1,1164357,1169846,+,5489
542,BUMA.1121.00041,1,2982840,2988303,+,5463
542,BUMA.1121.00073,1,2180856,2186343,-,5487
542,BUMA.1121.00017,1,1987034,1992488,+,5454
542,BUMA.1121.00066,1,2156621,2162107,-,5486
542,BUMA.1121.00107,1,1572222,1577674,+,5452
542,BUMA.1121.00085,1,1447470,1452927,+,5457
542,BUMA.1121.00030,1,1987108,1992562,+,5454
542,BUMA.1121.00112,1,1331577,1337084,-,5507
542,BUMA.1121.00002,1,2362244,2367698,+,5454
542,BUMA.1121.00082,1,2336469,2341976,-,5507
542,BUMA.1121.00014,1,1086665,1092136,-,5471
542,BUMA.1121.00011,1,3985514,3990976,-,5462
542,BUMA.1121.00019,1,2052075,2057529,+,5454
542,BUMA.1121.00057,1,2751630,2757118,+,5488
542,BUMA.1121.00018,1,2315707,2321145,+,5438
542,BUMA.1121.00039,1,1812020,1817481,+,5461
542,BUMA.1121.00016,1,3872826,3878287,+,5461
542,BUMA.1121.00004,1,2051933,2057387,+,5454
542,BUMA.1121.00005,1,385460,390949,+,5489
542,BUMA.1121.00100,1,3653787,3659263,-,5476
542,BUMA.1121.00006,1,992695,998152,+,5457
543,BUMA.1121.00027,1,3867836,3876247,+,8411
543,BUMA.1121.00025,1,927940,936352,-,8412
543,BUMA.1121.00021,1,2331612,2340025,+,8413
543,BUMA.1121.00023,1,41712,50122,+,8410
543,BUMA.1121.00024,1,2128423,2136831,-,8408
543,BUMA.1121.00033,1,3979565,3987974,+,8409
543,BUMA.1121.00034,1,2165903,2174311,-,8408
543,BUMA.1121.00036,1,1864500,1872908,-,8408
543,BUMA.1121.00032,1,195315,203723,-,8408
543,BUMA.1121.00009,1,3884920,3893331,-,8411
543,BUMA.1121.00008,1,2141504,2149912,-,8408
543,BUMA.1121.00003,1,243778,252190,+,8412
543,BUMA.1121.00109,1,236483,244895,-,8412
543,BUMA.1121.00053,1,1401014,1409447,+,8433
543,BUMA.1121.00110,1,3111766,3120177,-,8411
543,BUMA.1121.00104,1,3542318,3550750,-,8432
543,BUMA.1121.00086,1,927022,935430,+,8408
543,BUMA.1121.00092,1,2131900,2140331,-,8431
543,BUMA.1121.00096,1,1589303,1597703,-,8400
543,BUMA.1121.00054,1,2983556,2991964,+,8408
543,BUMA.1121.00097,1,2251468,2259879,-,8411
543,BUMA.1121.00093,1,2485988,2494419,+,8431
543,BUMA.1121.00106,1,1439043,1447475,+,8432
543,BUMA.1121.00010,1,3320514,3328922,+,8408
543,BUMA.1121.00035,1,2849253,2857666,+,8413
543,BUMA.1121.00108,1,2651995,2660405,+,8410
543,BUMA.1121.00028,1,2128470,2136878,-,8408
543,BUMA.1121.00094,1,1706538,1714969,+,8431
543,BUMA.1121.00102,1,3729760,3738192,-,8432
543,BUMA.1121.00111,1,1871601,1880010,+,8409
543,BUMA.1121.00089,1,1675207,1683639,+,8432
543,BUMA.1121.00084,1,2040772,2048736,+,7964
543,BUMA.1121.00029,1,3231074,3239487,-,8413
543,BUMA.1121.00012,1,401707,411431,+,9724
543,BUMA.1121.00087,1,2381353,2389761,-,8408
543,BUMA.1121.00043,1,1785899,1794310,+,8411
543,BUMA.1121.00046,1,2870970,2879378,+,8408
543,BUMA.1121.00037,1,327663,336076,+,8413
543,BUMA.1121.00080,1,1705275,1713707,+,8432
543,BUMA.1121.00079,1,1700470,1708902,+,8432
543,BUMA.1121.00045,1,2367664,2376073,-,8409
543,BUMA.1121.00071,1,2163276,2171708,-,8432
543,BUMA.1121.00056,1,2242385,2250817,-,8432
543,BUMA.1121.00065,1,1777434,1785846,+,8412
543,BUMA.1121.00058,1,2873103,2881514,-,8411
543,BUMA.1121.00007,1,2378204,2386616,-,8412
543,BUMA.1121.00067,1,2706969,2715401,-,8432
543,BUMA.1121.00090,1,3872284,3880697,+,8413
543,BUMA.1121.00051,1,1686623,1695055,+,8432
543,BUMA.1121.00020,1,2193369,2201777,-,8408
543,BUMA.1121.00103,1,2726648,2735059,-,8411
543,BUMA.1121.00048,1,943744,952152,-,8408
543,BUMA.1121.00047,1,1264695,1273127,-,8432
543,BUMA.1121.00042,1,2351364,2359771,-,8407
543,BUMA.1121.00055,1,1262730,1271162,+,8432
543,BUMA.1121.00031,1,3131038,3139448,+,8410
543,BUMA.1121.00040,1,2248001,2256409,-,8408
543,BUMA.1121.00044,1,1394015,1402423,-,8408
543,BUMA.1121.00088,1,2582594,2591026,+,8432
543,BUMA.1121.00069,1,2145711,2154143,-,8432
543,BUMA.1121.00064,1,1700936,1709347,+,8411
543,BUMA.1121.00105,1,3544495,3552927,-,8432
543,BUMA.1121.00015,1,1928993,1937401,+,8408
543,BUMA.1121.00059,1,886491,894904,+,8413
543,BUMA.1121.00026,1,3434434,3442841,-,8407
543,BUMA.1121.00022,1,2657760,2666168,+,8408
543,BUMA.1121.00052,1,1928317,1936725,-,8408
543,BUMA.1121.00101,1,800112,808522,-,8410
543,BUMA.1121.00001,1,2348109,2356521,-,8412
543,BUMA.1121.00038,1,1151220,1159628,-,8408
543,BUMA.1121.00068,1,440162,448570,+,8408
543,BUMA.1121.00099,1,651884,660295,-,8411
543,BUMA.1121.00091,1,2858360,2866793,-,8433
543,BUMA.1121.00098,1,266817,275223,+,8406
543,BUMA.1121.00013,1,2073214,2081622,+,8408
543,BUMA.1121.00049,1,161878,170310,-,8432
543,BUMA.1121.00072,1,2146107,2154539,-,8432
543,BUMA.1121.00076,1,3632504,3640936,-,8432
543,BUMA.1121.00083,1,3982936,3991368,-,8432
543,BUMA.1121.00078,1,258938,267348,-,8410
543,BUMA.1121.00095,1,1,8358,-,8357
543,BUMA.1121.00077,1,362649,371059,+,8410
543,BUMA.1121.00063,1,2170506,2178937,-,8431
543,BUMA.1121.00061,1,2173576,2182007,-,8431
543,BUMA.1121.00050,1,3381824,3390232,-,8408
543,BUMA.1121.00081,1,1151289,1159697,-,8408
543,BUMA.1121.00074,1,2150737,2159148,-,8411
543,BUMA.1121.00062,1,2878331,2886764,-,8433
543,BUMA.1121.00060,1,593417,601826,-,8409
543,BUMA.1121.00070,1,2144725,2153157,-,8432
543,BUMA.1121.00075,1,1171984,1180416,+,8432
543,BUMA.1121.00041,1,2990575,2999007,+,8432
543,BUMA.1121.00073,1,2171748,2180180,-,8432
543,BUMA.1121.00017,1,2063522,2071930,-,8408
543,BUMA.1121.00066,1,2147513,2155945,-,8432
543,BUMA.1121.00107,1,1578340,1586752,+,8412
543,BUMA.1121.00085,1,1525262,1533670,-,8408
543,BUMA.1121.00030,1,2063595,2072003,-,8408
543,BUMA.1121.00112,1,1320907,1329317,-,8410
543,BUMA.1121.00002,1,3342969,3351377,+,8408
543,BUMA.1121.00082,1,2327361,2335793,-,8432
543,BUMA.1121.00014,1,1077589,1085999,-,8410
543,BUMA.1121.00011,1,3976391,3984803,-,8412
543,BUMA.1121.00019,1,2128563,2136971,-,8408
543,BUMA.1121.00057,1,2757795,2766228,+,8433
543,BUMA.1121.00018,1,2323406,2331818,+,8412
543,BUMA.1121.00039,1,1818147,1827871,+,9724
543,BUMA.1121.00016,1,3878953,3887364,+,8411
543,BUMA.1121.00004,1,2128421,2136829,-,8408
543,BUMA.1121.00005,1,391615,400026,+,8411
543,BUMA.1121.00100,1,3643237,3651650,-,8413
543,BUMA.1121.00006,1,1151212,1159620,-,8408
544,BUMA.1121.00027,1,3878654,3895855,+,17201
544,BUMA.1121.00025,1,908312,925511,-,17199
544,BUMA.1121.00021,1,2342447,2359646,+,17199
544,BUMA.1121.00023,1,52649,69847,+,17198
544,BUMA.1121.00024,1,2108837,2126036,-,17199
544,BUMA.1121.00033,1,3990375,4007573,+,17198
544,BUMA.1121.00034,1,2146317,2163516,-,17199
544,BUMA.1121.00036,1,1844893,1862092,-,17199
544,BUMA.1121.00032,1,175729,192928,-,17199
544,BUMA.1121.00009,1,3864375,3882474,-,18099
544,BUMA.1121.00008,1,2121918,2139117,-,17199
544,BUMA.1121.00003,1,254702,272797,+,18095
544,BUMA.1121.00109,1,216818,234016,-,17198
544,BUMA.1121.00053,1,1411882,1429082,+,17200
544,BUMA.1121.00110,1,3092090,3109285,-,17195
544,BUMA.1121.00104,1,3522705,3539903,-,17198
544,BUMA.1121.00086,1,937837,955037,+,17200
544,BUMA.1121.00092,1,2112258,2129457,-,17199
544,BUMA.1121.00096,1,1567006,1585519,-,18513
544,BUMA.1121.00054,1,2994357,3011561,+,17204
544,BUMA.1121.00097,1,2231757,2248955,-,17198
544,BUMA.1121.00093,1,2496861,2514061,+,17200
544,BUMA.1121.00106,1,1449882,1467082,+,17200
544,BUMA.1121.00010,1,3331301,3348496,+,17195
544,BUMA.1121.00035,1,2860137,2877336,+,17199
544,BUMA.1121.00108,1,2662908,2680048,+,17140
544,BUMA.1121.00028,1,2108884,2126083,-,17199
544,BUMA.1121.00094,1,1717397,1734597,+,17200
544,BUMA.1121.00102,1,3710109,3727317,-,17208
544,BUMA.1121.00111,1,1882497,1899696,+,17199
544,BUMA.1121.00089,1,1686044,1703243,+,17199
544,BUMA.1121.00084,1,2051164,2068365,+,17201
544,BUMA.1121.00029,1,3211453,3228652,-,17199
544,BUMA.1121.00012,1,413887,431085,+,17198
544,BUMA.1121.00087,1,2361747,2378946,-,17199
544,BUMA.1121.00043,1,1796754,1813939,+,17185
544,BUMA.1121.00046,1,2881771,2898975,+,17204
544,BUMA.1121.00037,1,338550,355749,+,17199
544,BUMA.1121.00080,1,1716154,1733353,+,17199
544,BUMA.1121.00079,1,1711321,1728520,+,17199
544,BUMA.1121.00045,1,2348078,2365277,-,17199
544,BUMA.1121.00071,1,2143732,2160930,-,17198
544,BUMA.1121.00056,1,2222781,2239980,-,17199
544,BUMA.1121.00065,1,1788281,1805481,+,17200
544,BUMA.1121.00058,1,2853461,2870660,-,17199
544,BUMA.1121.00007,1,2358598,2375793,-,17195
544,BUMA.1121.00067,1,2687347,2704547,-,17200
544,BUMA.1121.00090,1,3883119,3900318,+,17199
544,BUMA.1121.00051,1,1697467,1714666,+,17199
544,BUMA.1121.00020,1,2173783,2190982,-,17199
544,BUMA.1121.00103,1,2706986,2724187,-,17201
544,BUMA.1121.00048,1,924147,941350,-,17203
544,BUMA.1121.00047,1,1245056,1262255,-,17199
544,BUMA.1121.00042,1,2331784,2348956,-,17172
544,BUMA.1121.00055,1,1273562,1290760,+,17198
544,BUMA.1121.00031,1,3141905,3159104,+,17199
544,BUMA.1121.00040,1,2228422,2245621,-,17199
544,BUMA.1121.00044,1,1374429,1391628,-,17199
544,BUMA.1121.00088,1,2593468,2610668,+,17200
544,BUMA.1121.00069,1,2126113,2143311,-,17198
544,BUMA.1121.00064,1,1711761,1728962,+,17201
544,BUMA.1121.00105,1,3524860,3542059,-,17199
544,BUMA.1121.00015,1,1939794,1956998,+,17204
544,BUMA.1121.00059,1,897382,914581,+,17199
544,BUMA.1121.00026,1,3414847,3432019,-,17172
544,BUMA.1121.00022,1,2668561,2685761,+,17200
544,BUMA.1121.00052,1,1908731,1925930,-,17199
544,BUMA.1121.00101,1,780488,797687,-,17199
544,BUMA.1121.00001,1,2328467,2345666,-,17199
544,BUMA.1121.00038,1,1131623,1148826,-,17203
544,BUMA.1121.00068,1,451034,468226,+,17192
544,BUMA.1121.00099,1,632241,649438,-,17197
544,BUMA.1121.00091,1,2838676,2855872,-,17196
544,BUMA.1121.00098,1,277687,294887,+,17200
544,BUMA.1121.00013,1,2084008,2101208,+,17200
544,BUMA.1121.00049,1,142213,159411,-,17198
544,BUMA.1121.00072,1,2126590,2143766,-,17176
544,BUMA.1121.00076,1,3612817,3630016,-,17199
544,BUMA.1121.00083,1,3963337,3980536,-,17199
544,BUMA.1121.00078,1,239311,256509,-,17198
544,BUMA.1121.00095,1,3977329,3994528,-,17199
544,BUMA.1121.00077,1,373541,390736,+,17195
544,BUMA.1121.00063,1,2150979,2168177,-,17198
544,BUMA.1121.00061,1,2153988,2171186,-,17198
544,BUMA.1121.00050,1,3362227,3379430,-,17203
544,BUMA.1121.00081,1,1131692,1148895,-,17203
544,BUMA.1121.00074,1,2131122,2148322,-,17200
544,BUMA.1121.00062,1,2858682,2875881,-,17199
544,BUMA.1121.00060,1,573831,591030,-,17199
544,BUMA.1121.00070,1,2125127,2142325,-,17198
544,BUMA.1121.00075,1,1182903,1200103,+,17200
544,BUMA.1121.00041,1,3001407,3018605,+,17198
544,BUMA.1121.00073,1,2152173,2169371,-,17198
544,BUMA.1121.00017,1,2043936,2061135,-,17199
544,BUMA.1121.00066,1,2127915,2145113,-,17198
544,BUMA.1121.00107,1,1589225,1606423,+,17198
544,BUMA.1121.00085,1,1505676,1522875,-,17199
544,BUMA.1121.00030,1,2044009,2061208,-,17199
544,BUMA.1121.00112,1,1301261,1318432,-,17171
544,BUMA.1121.00002,1,3353756,3370951,+,17195
544,BUMA.1121.00082,1,2307763,2324961,-,17198
544,BUMA.1121.00014,1,1057940,1075139,-,17199
544,BUMA.1121.00011,1,3956766,3973965,-,17199
544,BUMA.1121.00019,1,2108977,2126176,-,17199
544,BUMA.1121.00057,1,2768642,2785843,+,17201
544,BUMA.1121.00018,1,2334247,2351446,+,17199
544,BUMA.1121.00039,1,1830370,1847546,+,17176
544,BUMA.1121.00016,1,3889807,3908319,+,18512
544,BUMA.1121.00004,1,2108835,2126034,-,17199
544,BUMA.1121.00005,1,402423,419620,+,17197
544,BUMA.1121.00100,1,3623656,3640816,-,17160
544,BUMA.1121.00006,1,1131615,1148818,-,17203
545,BUMA.1121.00027,1,3904565,3919976,+,15411
545,BUMA.1121.00025,1,884226,899640,-,15414
545,BUMA.1121.00021,1,2367005,2382405,+,15400
545,BUMA.1121.00023,1,77205,92604,+,15399
545,BUMA.1121.00024,1,2086091,2101462,-,15371
545,BUMA.1121.00033,1,4021487,4036884,+,15397
545,BUMA.1121.00034,1,2123571,2138942,-,15371
545,BUMA.1121.00036,1,1822423,1837781,-,15358
545,BUMA.1121.00032,1,152983,168354,-,15371
545,BUMA.1121.00009,1,3841603,3857014,-,15411
545,BUMA.1121.00008,1,2099172,2114543,-,15371
545,BUMA.1121.00003,1,281777,297198,+,15421
545,BUMA.1121.00109,1,194042,209466,-,15424
545,BUMA.1121.00053,1,1436449,1451820,+,15371
545,BUMA.1121.00110,1,3069304,3084730,-,15426
545,BUMA.1121.00104,1,3499925,3515340,-,15415
545,BUMA.1121.00086,1,962154,977511,+,15357
545,BUMA.1121.00092,1,2089474,2104886,-,15412
545,BUMA.1121.00096,1,1544234,1559645,-,15411
545,BUMA.1121.00054,1,3020175,3035546,+,15371
545,BUMA.1121.00097,1,2208975,2224386,-,15411
545,BUMA.1121.00093,1,2521433,2536845,+,15412
545,BUMA.1121.00106,1,1477403,1492815,+,15412
545,BUMA.1121.00010,1,3355871,3371242,+,15371
545,BUMA.1121.00035,1,2885988,2901387,+,15399
545,BUMA.1121.00108,1,2687412,2702832,+,15420
545,BUMA.1121.00028,1,2086138,2101509,-,15371
545,BUMA.1121.00094,1,1741958,1757370,+,15412
545,BUMA.1121.00102,1,3686058,3701429,-,15371
545,BUMA.1121.00111,1,1913066,1928458,+,15392
545,BUMA.1121.00089,1,1710604,1726016,+,15412
545,BUMA.1121.00084,1,2075740,2091154,+,15414
545,BUMA.1121.00029,1,3187403,3202801,-,15398
545,BUMA.1121.00012,1,439773,455172,+,15399
545,BUMA.1121.00087,1,2339273,2354631,-,15358
545,BUMA.1121.00043,1,1824204,1839603,+,15399
545,BUMA.1121.00046,1,2907590,2922961,+,15371
545,BUMA.1121.00037,1,372761,388160,+,15399
545,BUMA.1121.00080,1,1740714,1756124,+,15410
545,BUMA.1121.00079,1,1735881,1751293,+,15412
545,BUMA.1121.00045,1,2325310,2340721,-,15411
545,BUMA.1121.00071,1,2119646,2135037,-,15391
545,BUMA.1121.00056,1,2200008,2215420,-,15412
545,BUMA.1121.00065,1,1812847,1828258,+,15411
545,BUMA.1121.00058,1,2830712,2846086,-,15374
545,BUMA.1121.00007,1,2335819,2351229,-,15410
545,BUMA.1121.00067,1,2664567,2679990,-,15423
545,BUMA.1121.00090,1,3908990,3924389,+,15399
545,BUMA.1121.00051,1,1722027,1737438,+,15411
545,BUMA.1121.00020,1,2151037,2166408,-,15371
545,BUMA.1121.00103,1,2684234,2699634,-,15400
545,BUMA.1121.00048,1,900164,915534,-,15370
545,BUMA.1121.00047,1,1222283,1237695,-,15412
545,BUMA.1121.00042,1,1779331,1794703,-,15372
545,BUMA.1121.00055,1,1298138,1313551,+,15413
545,BUMA.1121.00031,1,3166463,3181862,+,15399
545,BUMA.1121.00040,1,2205704,2221047,-,15343
545,BUMA.1121.00044,1,1351683,1367054,-,15371
545,BUMA.1121.00088,1,2618043,2633455,+,15412
545,BUMA.1121.00069,1,2102040,2117433,-,15393
545,BUMA.1121.00064,1,1736321,1751745,+,15424
545,BUMA.1121.00105,1,3500535,3515919,-,15384
545,BUMA.1121.00015,1,1965613,1980983,+,15370
545,BUMA.1121.00059,1,921934,937356,+,15422
545,BUMA.1121.00026,1,3204539,3219856,-,15317
545,BUMA.1121.00022,1,2692878,2708235,+,15357
545,BUMA.1121.00052,1,1884745,1900116,-,15371
545,BUMA.1121.00101,1,756113,771527,-,15414
545,BUMA.1121.00001,1,2304417,2319816,-,15399
545,BUMA.1121.00038,1,1107638,1123009,-,15371
545,BUMA.1121.00068,1,475585,490997,+,15412
545,BUMA.1121.00099,1,609467,624875,-,15408
545,BUMA.1121.00091,1,2815934,2831306,-,15372
545,BUMA.1121.00098,1,302244,317620,+,15376
545,BUMA.1121.00013,1,2109823,2125194,+,15371
545,BUMA.1121.00049,1,118117,133530,-,15413
545,BUMA.1121.00072,1,2102483,2117895,-,15412
545,BUMA.1121.00076,1,3588709,3605446,-,16737
545,BUMA.1121.00083,1,3939230,3954642,-,15412
545,BUMA.1121.00078,1,216582,231953,-,15371
545,BUMA.1121.00095,1,3954561,3969979,-,15418
545,BUMA.1121.00077,1,398095,413521,+,15426
545,BUMA.1121.00063,1,2127034,2142428,-,15394
545,BUMA.1121.00061,1,2130016,2145407,-,15391
545,BUMA.1121.00050,1,3338241,3353612,-,15371
545,BUMA.1121.00081,1,1107707,1123078,-,15371
545,BUMA.1121.00074,1,2108341,2123765,-,15424
545,BUMA.1121.00062,1,2834328,2849743,-,15415
545,BUMA.1121.00060,1,551061,566472,-,15411
545,BUMA.1121.00070,1,2101036,2116436,-,15400
545,BUMA.1121.00075,1,1207474,1224211,+,16737
545,BUMA.1121.00041,1,3027320,3042691,+,15371
545,BUMA.1121.00073,1,2128081,2143481,-,15400
545,BUMA.1121.00017,1,2021190,2036561,-,15371
545,BUMA.1121.00066,1,2103828,2119220,-,15392
545,BUMA.1121.00107,1,1613783,1629195,+,15412
545,BUMA.1121.00085,1,1481690,1497061,-,15371
545,BUMA.1121.00030,1,2021263,2036634,-,15371
545,BUMA.1121.00112,1,1278486,1293895,-,15409
545,BUMA.1121.00002,1,3378324,3393695,+,15371
545,BUMA.1121.00082,1,2283656,2299068,-,15412
545,BUMA.1121.00014,1,1035183,1050582,-,15399
545,BUMA.1121.00011,1,3933982,3949394,-,15412
545,BUMA.1121.00019,1,2086231,2101602,-,15371
545,BUMA.1121.00057,1,2794538,2809950,+,15412
545,BUMA.1121.00018,1,2360118,2375532,+,15414
545,BUMA.1121.00039,1,1854905,1870304,+,15399
545,BUMA.1121.00016,1,3915678,3931070,+,15392
545,BUMA.1121.00004,1,2086089,2101460,-,15371
545,BUMA.1121.00005,1,426977,442348,+,15371
545,BUMA.1121.00100,1,3600919,3616300,-,15381
545,BUMA.1121.00006,1,1107630,1123001,-,15371
546,BUMA.1121.00027,1,3919990,3923124,+,3134
546,BUMA.1121.00025,1,881077,884212,-,3135
546,BUMA.1121.00021,1,2382419,2385553,+,3134
546,BUMA.1121.00023,1,92618,95752,+,3134
546,BUMA.1121.00024,1,2082942,2086077,-,3135
546,BUMA.1121.00033,1,4036898,4040032,+,3134
546,BUMA.1121.00034,1,2120422,2123557,-,3135
546,BUMA.1121.00036,1,1819274,1822409,-,3135
546,BUMA.1121.00032,1,149834,152969,-,3135
546,BUMA.1121.00009,1,3838454,3841589,-,3135
546,BUMA.1121.00008,1,2096023,2099158,-,3135
546,BUMA.1121.00003,1,297212,300346,+,3134
546,BUMA.1121.00109,1,190893,194028,-,3135
546,BUMA.1121.00053,1,1451834,1454968,+,3134
546,BUMA.1121.00110,1,3066155,3069290,-,3135
546,BUMA.1121.00104,1,3496776,3499911,-,3135
546,BUMA.1121.00086,1,977525,980659,+,3134
546,BUMA.1121.00092,1,2086325,2089460,-,3135
546,BUMA.1121.00096,1,1541085,1544220,-,3135
546,BUMA.1121.00054,1,3035560,3038694,+,3134
546,BUMA.1121.00097,1,2205826,2208961,-,3135
546,BUMA.1121.00093,1,2536859,2539993,+,3134
546,BUMA.1121.00106,1,1492829,1495963,+,3134
546,BUMA.1121.00010,1,3371256,3374390,+,3134
546,BUMA.1121.00035,1,2901401,2904535,+,3134
546,BUMA.1121.00108,1,2702846,2705980,+,3134
546,BUMA.1121.00028,1,2082989,2086124,-,3135
546,BUMA.1121.00094,1,1757384,1760518,+,3134
546,BUMA.1121.00102,1,3682909,3686044,-,3135
546,BUMA.1121.00111,1,1928472,1931605,+,3133
546,BUMA.1121.00089,1,1726030,1729164,+,3134
546,BUMA.1121.00084,1,2091168,2094302,+,3134
546,BUMA.1121.00029,1,3184254,3187389,-,3135
546,BUMA.1121.00012,1,455186,458320,+,3134
546,BUMA.1121.00087,1,2336124,2339259,-,3135
546,BUMA.1121.00043,1,1839631,1842751,+,3120
546,BUMA.1121.00046,1,2922975,2926109,+,3134
546,BUMA.1121.00037,1,388174,391308,+,3134
546,BUMA.1121.00080,1,1756138,1759272,+,3134
546,BUMA.1121.00079,1,1751307,1754441,+,3134
546,BUMA.1121.00045,1,2322161,2325296,-,3135
546,BUMA.1121.00071,1,2116497,2119632,-,3135
546,BUMA.1121.00056,1,2196859,2199994,-,3135
546,BUMA.1121.00065,1,1828272,1831406,+,3134
546,BUMA.1121.00058,1,2827563,2830698,-,3135
546,BUMA.1121.00007,1,2332670,2335805,-,3135
546,BUMA.1121.00067,1,2661418,2664553,-,3135
546,BUMA.1121.00090,1,3924403,3927537,+,3134
546,BUMA.1121.00051,1,1737452,1740586,+,3134
546,BUMA.1121.00020,1,2147888,2151023,-,3135
546,BUMA.1121.00103,1,2681085,2684220,-,3135
546,BUMA.1121.00048,1,897015,900150,-,3135
546,BUMA.1121.00047,1,1219134,1222269,-,3135
546,BUMA.1121.00042,1,1776182,1779317,-,3135
546,BUMA.1121.00055,1,1313565,1316699,+,3134
546,BUMA.1121.00031,1,3181876,3185010,+,3134
546,BUMA.1121.00040,1,2200930,2204065,-,3135
546,BUMA.1121.00044,1,1348534,1351669,-,3135
546,BUMA.1121.00088,1,2633469,2636603,+,3134
546,BUMA.1121.00069,1,2098891,2102026,-,3135
546,BUMA.1121.00064,1,1751759,1754893,+,3134
546,BUMA.1121.00105,1,3495760,3498895,-,3135
546,BUMA.1121.00015,1,1980997,1984131,+,3134
546,BUMA.1121.00059,1,937370,940504,+,3134
546,BUMA.1121.00026,1,3201390,3204525,-,3135
546,BUMA.1121.00022,1,2708249,2711383,+,3134
546,BUMA.1121.00052,1,1881596,1884731,-,3135
546,BUMA.1121.00101,1,752958,756099,-,3141
546,BUMA.1121.00001,1,2301268,2304403,-,3135
546,BUMA.1121.00038,1,1104489,1107624,-,3135
546,BUMA.1121.00068,1,491011,494145,+,3134
546,BUMA.1121.00099,1,606324,609453,-,3129
546,BUMA.1121.00091,1,2812785,2815920,-,3135
546,BUMA.1121.00098,1,317634,320768,+,3134
546,BUMA.1121.00013,1,2125208,2128342,+,3134
546,BUMA.1121.00049,1,114968,118103,-,3135
546,BUMA.1121.00072,1,2099334,2102469,-,3135
546,BUMA.1121.00076,1,3585560,3588695,-,3135
546,BUMA.1121.00083,1,3936081,3939216,-,3135
546,BUMA.1121.00078,1,213433,216568,-,3135
546,BUMA.1121.00095,1,3951412,3954547,-,3135
546,BUMA.1121.00077,1,413535,416669,+,3134
546,BUMA.1121.00063,1,2123885,2127020,-,3135
546,BUMA.1121.00061,1,2126867,2130002,-,3135
546,BUMA.1121.00050,1,3335092,3338227,-,3135
546,BUMA.1121.00081,1,1104558,1107693,-,3135
546,BUMA.1121.00074,1,2105192,2108327,-,3135
546,BUMA.1121.00062,1,2831179,2834314,-,3135
546,BUMA.1121.00060,1,547912,551047,-,3135
546,BUMA.1121.00070,1,2097887,2101022,-,3135
546,BUMA.1121.00075,1,1224225,1227359,+,3134
546,BUMA.1121.00041,1,3042705,3045839,+,3134
546,BUMA.1121.00073,1,2124932,2128067,-,3135
546,BUMA.1121.00017,1,2018041,2021176,-,3135
546,BUMA.1121.00066,1,2100679,2103814,-,3135
546,BUMA.1121.00107,1,1629209,1632343,+,3134
546,BUMA.1121.00085,1,1478541,1481676,-,3135
546,BUMA.1121.00030,1,2018114,2021249,-,3135
546,BUMA.1121.00112,1,1275343,1278472,-,3129
546,BUMA.1121.00002,1,3393709,3396843,+,3134
546,BUMA.1121.00082,1,2280507,2283642,-,3135
546,BUMA.1121.00014,1,1032034,1035169,-,3135
546,BUMA.1121.00011,1,3930839,3933968,-,3129
546,BUMA.1121.00019,1,2083082,2086217,-,3135
546,BUMA.1121.00057,1,2809964,2813098,+,3134
546,BUMA.1121.00018,1,2375546,2378680,+,3134
546,BUMA.1121.00039,1,1870318,1873452,+,3134
546,BUMA.1121.00016,1,3931084,3934218,+,3134
546,BUMA.1121.00004,1,2082940,2086075,-,3135
546,BUMA.1121.00005,1,442362,445496,+,3134
546,BUMA.1121.00100,1,3597770,3600905,-,3135
546,BUMA.1121.00006,1,1104481,1107616,-,3135
547,BUMA.1121.00027,1,3928846,3942284,+,13438
547,BUMA.1121.00025,1,863523,876947,-,13424
547,BUMA.1121.00021,1,2389684,2403111,+,13427
547,BUMA.1121.00023,1,99883,113321,+,13438
547,BUMA.1121.00024,1,2065430,2078812,-,13382
547,BUMA.1121.00033,1,4044163,4057600,+,13437
547,BUMA.1121.00034,1,2102910,2116292,-,13382
547,BUMA.1121.00036,1,1801755,1815144,-,13389
547,BUMA.1121.00032,1,132322,145704,-,13382
547,BUMA.1121.00009,1,3820884,3834321,-,13437
547,BUMA.1121.00008,1,2078511,2091893,-,13382
547,BUMA.1121.00003,1,306068,319513,+,13445
547,BUMA.1121.00109,1,173296,186763,-,13467
547,BUMA.1121.00053,1,1459099,1472516,+,13417
547,BUMA.1121.00110,1,3048574,3062025,-,13451
547,BUMA.1121.00104,1,3479184,3492646,-,13462
547,BUMA.1121.00086,1,984790,998172,+,13382
547,BUMA.1121.00092,1,2068781,2082195,-,13414
547,BUMA.1121.00096,1,1523504,1536955,-,13451
547,BUMA.1121.00054,1,3042825,3056216,+,13391
547,BUMA.1121.00097,1,2188248,2201697,-,13449
547,BUMA.1121.00093,1,2544124,2557538,+,13414
547,BUMA.1121.00106,1,1501687,1515137,+,13450
547,BUMA.1121.00010,1,3378521,3391912,+,13391
547,BUMA.1121.00035,1,2908666,2922104,+,13438
547,BUMA.1121.00108,1,2710111,2723566,+,13455
547,BUMA.1121.00028,1,2065477,2078859,-,13382
547,BUMA.1121.00094,1,1764649,1778083,+,13434
547,BUMA.1121.00102,1,3663928,3677188,-,13260
547,BUMA.1121.00111,1,1935736,1949192,+,13456
547,BUMA.1121.00089,1,1733295,1746729,+,13434
547,BUMA.1121.00084,1,2098433,2111895,+,13462
547,BUMA.1121.00029,1,3166640,3180124,-,13484
547,BUMA.1121.00012,1,462450,475900,+,13450
547,BUMA.1121.00087,1,2318612,2331994,-,13382
547,BUMA.1121.00043,1,1846882,1860296,+,13414
547,BUMA.1121.00046,1,2930240,2943631,+,13391
547,BUMA.1121.00037,1,397032,410459,+,13427
547,BUMA.1121.00080,1,1763403,1776837,+,13434
547,BUMA.1121.00079,1,1758572,1772006,+,13434
547,BUMA.1121.00045,1,2304597,2318031,-,13434
547,BUMA.1121.00071,1,2097339,2110776,-,13437
547,BUMA.1121.00056,1,2179295,2192729,-,13434
547,BUMA.1121.00065,1,1835537,1848975,+,13438
547,BUMA.1121.00058,1,2810006,2823433,-,13427
547,BUMA.1121.00007,1,2315093,2328541,-,13448
547,BUMA.1121.00067,1,2643854,2657288,-,13434
547,BUMA.1121.00090,1,3931668,3945106,+,13438
547,BUMA.1121.00051,1,1744717,1758151,+,13434
547,BUMA.1121.00020,1,2130376,2143758,-,13382
547,BUMA.1121.00103,1,2660415,2673771,-,13356
547,BUMA.1121.00048,1,879494,892885,-,13391
547,BUMA.1121.00047,1,1201570,1215004,-,13434
547,BUMA.1121.00042,1,1758652,1772052,-,13400
547,BUMA.1121.00055,1,1320830,1334309,+,13479
547,BUMA.1121.00031,1,3190732,3204170,+,13438
547,BUMA.1121.00040,1,2183409,2196800,-,13391
547,BUMA.1121.00044,1,1331022,1344404,-,13382
547,BUMA.1121.00088,1,2642325,2655787,+,13462
547,BUMA.1121.00069,1,2079732,2093170,-,13438
547,BUMA.1121.00064,1,1759024,1772461,+,13437
547,BUMA.1121.00105,1,3476577,3490039,-,13462
547,BUMA.1121.00015,1,1988262,2001653,+,13391
547,BUMA.1121.00059,1,946226,959676,+,13450
547,BUMA.1121.00026,1,3183869,3197260,-,13391
547,BUMA.1121.00022,1,2715514,2728896,+,13382
547,BUMA.1121.00052,1,1864075,1877466,-,13391
547,BUMA.1121.00101,1,735531,748828,-,13297
547,BUMA.1121.00001,1,2283655,2297138,-,13483
547,BUMA.1121.00038,1,1086968,1100359,-,13391
547,BUMA.1121.00068,1,499866,513310,+,13444
547,BUMA.1121.00099,1,588753,602194,-,13441
547,BUMA.1121.00091,1,2795228,2808656,-,13428
547,BUMA.1121.00098,1,326490,339944,+,13454
547,BUMA.1121.00013,1,2132473,2145864,+,13391
547,BUMA.1121.00049,1,97401,110838,-,13437
547,BUMA.1121.00072,1,2080175,2093613,-,13438
547,BUMA.1121.00076,1,3568003,3581430,-,13427
547,BUMA.1121.00083,1,3916922,3930360,-,13438
547,BUMA.1121.00078,1,194275,207714,-,13439
547,BUMA.1121.00095,1,3933810,3947268,-,13458
547,BUMA.1121.00077,1,420798,434249,+,13451
547,BUMA.1121.00063,1,2104727,2118164,-,13437
547,BUMA.1121.00061,1,2107716,2121146,-,13430
547,BUMA.1121.00050,1,3317571,3330962,-,13391
547,BUMA.1121.00081,1,1087037,1100428,-,13391
547,BUMA.1121.00074,1,2087625,2101062,-,13437
547,BUMA.1121.00062,1,2812020,2825458,-,13438
547,BUMA.1121.00060,1,530348,543782,-,13434
547,BUMA.1121.00070,1,2078728,2092166,-,13438
547,BUMA.1121.00075,1,1231490,1244916,+,13426
547,BUMA.1121.00041,1,3049970,3063407,+,13437
547,BUMA.1121.00073,1,2105773,2119211,-,13438
547,BUMA.1121.00017,1,2000529,2013911,-,13382
547,BUMA.1121.00066,1,2081532,2094958,-,13426
547,BUMA.1121.00107,1,1636474,1649908,+,13434
547,BUMA.1121.00085,1,1461020,1474411,-,13391
547,BUMA.1121.00030,1,2000602,2013984,-,13382
547,BUMA.1121.00112,1,1257815,1271213,-,13398
547,BUMA.1121.00002,1,3400974,3414365,+,13391
547,BUMA.1121.00082,1,2261348,2274786,-,13438
547,BUMA.1121.00014,1,1012876,1026313,-,13437
547,BUMA.1121.00011,1,3913347,3926709,-,13362
547,BUMA.1121.00019,1,2065570,2078952,-,13382
547,BUMA.1121.00057,1,2818820,2832258,+,13438
547,BUMA.1121.00018,1,2382811,2396235,+,13424
547,BUMA.1121.00039,1,1878896,1892334,+,13438
547,BUMA.1121.00016,1,3938349,3951786,+,13437
547,BUMA.1121.00004,1,2065428,2078810,-,13382
547,BUMA.1121.00005,1,451218,464655,+,13437
547,BUMA.1121.00100,1,3580282,3593640,-,13358
547,BUMA.1121.00006,1,1086960,1100351,-,13391
548,BUMA.1121.00027,1,3942984,3956805,+,13821
548,BUMA.1121.00025,1,849002,862824,-,13822
548,BUMA.1121.00021,1,2403811,2417634,+,13823
548,BUMA.1121.00023,1,114021,127837,+,13816
548,BUMA.1121.00024,1,2343181,2356897,-,13716
548,BUMA.1121.00033,1,4058300,4072115,+,13815
548,BUMA.1121.00034,1,2381956,2395672,-,13716
548,BUMA.1121.00036,1,1755347,1769063,+,13716
548,BUMA.1121.00032,1,411434,425150,-,13716
548,BUMA.1121.00009,1,3806367,3820184,-,13817
548,BUMA.1121.00008,1,2357564,2371280,-,13716
548,BUMA.1121.00003,1,320213,334014,+,13801
548,BUMA.1121.00109,1,158810,172596,-,13786
548,BUMA.1121.00053,1,1473216,1487032,+,13816
548,BUMA.1121.00110,1,3034100,3047874,-,13774
548,BUMA.1121.00104,1,3464683,3478484,-,13801
548,BUMA.1121.00086,1,1030829,1044545,-,13716
548,BUMA.1121.00092,1,2054256,2068081,-,13825
548,BUMA.1121.00096,1,1509003,1522804,-,13801
548,BUMA.1121.00054,1,2795912,2809628,+,13716
548,BUMA.1121.00097,1,2173742,2187548,-,13806
548,BUMA.1121.00093,1,2558238,2572062,+,13824
548,BUMA.1121.00106,1,1515837,1529644,+,13807
548,BUMA.1121.00010,1,3425779,3439494,-,13715
548,BUMA.1121.00035,1,2922804,2936611,+,13807
548,BUMA.1121.00108,1,2724266,2738081,+,13815
548,BUMA.1121.00028,1,2344572,2358288,-,13716
548,BUMA.1121.00094,1,1778783,1792584,+,13801
548,BUMA.1121.00102,1,3649415,3663228,-,13813
548,BUMA.1121.00111,1,1949892,1963714,+,13822
548,BUMA.1121.00089,1,1747429,1761230,+,13801
548,BUMA.1121.00084,1,2112595,2126396,+,13801
548,BUMA.1121.00029,1,3152133,3165940,-,13807
548,BUMA.1121.00012,1,476600,490407,+,13807
548,BUMA.1121.00087,1,2272240,2285956,+,13716
548,BUMA.1121.00043,1,1860996,1874776,+,13780
548,BUMA.1121.00046,1,2683372,2697088,+,13716
548,BUMA.1121.00037,1,411159,424952,+,13793
548,BUMA.1121.00080,1,1777537,1791338,+,13801
548,BUMA.1121.00079,1,1772706,1786506,+,13800
548,BUMA.1121.00045,1,2290078,2303897,-,13819
548,BUMA.1121.00071,1,2082823,2096639,-,13816
548,BUMA.1121.00056,1,2164794,2178595,-,13801
548,BUMA.1121.00065,1,1849675,1863491,+,13816
548,BUMA.1121.00058,1,2795505,2809306,-,13801
548,BUMA.1121.00007,1,2300575,2314393,-,13818
548,BUMA.1121.00067,1,2629353,2643154,-,13801
548,BUMA.1121.00090,1,3945806,3959631,+,13825
548,BUMA.1121.00051,1,1758851,1772650,+,13799
548,BUMA.1121.00020,1,2409431,2423147,-,13716
548,BUMA.1121.00103,1,2645917,2659715,-,13798
548,BUMA.1121.00048,1,1126085,1139801,-,13716
548,BUMA.1121.00047,1,1187069,1200870,-,13801
548,BUMA.1121.00042,1,1410971,1424773,+,13802
548,BUMA.1121.00055,1,1335009,1348831,+,13822
548,BUMA.1121.00031,1,3204870,3218675,+,13805
548,BUMA.1121.00040,1,2007842,2021558,+,13716
548,BUMA.1121.00044,1,1610076,1623792,-,13716
548,BUMA.1121.00088,1,2656487,2670288,+,13801
548,BUMA.1121.00069,1,2065228,2079032,-,13804
548,BUMA.1121.00064,1,1773161,1786962,+,13801
548,BUMA.1121.00105,1,3462076,3475877,-,13801
548,BUMA.1121.00015,1,1697923,1711639,+,13716
548,BUMA.1121.00059,1,960376,974198,+,13822
548,BUMA.1121.00026,1,2836113,2849915,+,13802
548,BUMA.1121.00022,1,2761567,2775283,-,13716
548,BUMA.1121.00052,1,2154563,2168270,-,13707
548,BUMA.1121.00101,1,721032,734831,-,13799
548,BUMA.1121.00001,1,2269148,2282955,-,13807
548,BUMA.1121.00038,1,1333572,1347288,-,13716
548,BUMA.1121.00068,1,514010,527787,+,13777
548,BUMA.1121.00099,1,574240,588053,-,13813
548,BUMA.1121.00091,1,2780721,2794528,-,13807
548,BUMA.1121.00098,1,340644,354466,+,13822
548,BUMA.1121.00013,1,2434747,2448454,-,13707
548,BUMA.1121.00049,1,82888,96701,-,13813
548,BUMA.1121.00072,1,2065679,2079475,-,13796
548,BUMA.1121.00076,1,3553502,3567303,-,13801
548,BUMA.1121.00083,1,3902400,3916222,-,13822
548,BUMA.1121.00078,1,179764,193575,-,13811
548,BUMA.1121.00095,1,3919289,3933110,-,13821
548,BUMA.1121.00077,1,434948,448722,+,13774
548,BUMA.1121.00063,1,2090236,2104027,-,13791
548,BUMA.1121.00061,1,2093200,2107016,-,13816
548,BUMA.1121.00050,1,54644,68360,-,13716
548,BUMA.1121.00081,1,1333633,1347349,-,13716
548,BUMA.1121.00074,1,2073124,2086925,-,13801
548,BUMA.1121.00062,1,2797519,2811320,-,13801
548,BUMA.1121.00060,1,515829,529648,-,13819
548,BUMA.1121.00070,1,2064235,2078028,-,13793
548,BUMA.1121.00075,1,1245615,1259416,+,13801
548,BUMA.1121.00041,1,3064107,3077920,+,13813
548,BUMA.1121.00073,1,2091251,2105073,-,13822
548,BUMA.1121.00017,1,2279591,2293307,-,13716
548,BUMA.1121.00066,1,2067016,2080832,-,13816
548,BUMA.1121.00107,1,1650608,1664423,+,13815
548,BUMA.1121.00085,1,1751509,1765216,-,13707
548,BUMA.1121.00030,1,2279653,2293369,-,13716
548,BUMA.1121.00112,1,1243301,1257115,-,13814
548,BUMA.1121.00002,1,3448235,3461951,-,13716
548,BUMA.1121.00082,1,2246826,2260648,-,13822
548,BUMA.1121.00014,1,998371,1012176,-,13805
548,BUMA.1121.00011,1,3898831,3912647,-,13816
548,BUMA.1121.00019,1,2309485,2323201,-,13716
548,BUMA.1121.00057,1,2832958,2846780,+,13822
548,BUMA.1121.00018,1,2396934,2410756,+,13822
548,BUMA.1121.00039,1,1893034,1906850,+,13816
548,BUMA.1121.00016,1,3952486,3966293,+,13807
548,BUMA.1121.00004,1,2344469,2358185,-,13716
548,BUMA.1121.00005,1,465355,479139,+,13784
548,BUMA.1121.00100,1,3565791,3579582,-,13791
548,BUMA.1121.00006,1,1333555,1347271,-,13716
549,BUMA.1121.00027,1,3956996,3968870,+,11874
549,BUMA.1121.00025,1,836999,848742,-,11743
549,BUMA.1121.00021,1,2417819,2429741,+,11922
549,BUMA.1121.00023,1,128028,140103,+,12075
549,BUMA.1121.00024,1,2331144,2342894,-,11750
549,BUMA.1121.00033,1,4072300,4084270,+,11970
549,BUMA.1121.00034,1,2369933,2381669,-,11736
549,BUMA.1121.00036,1,1769281,1781112,+,11831
549,BUMA.1121.00032,1,399418,411147,-,11729
549,BUMA.1121.00009,1,3794212,3806080,-,11868
549,BUMA.1121.00008,1,2345541,2357277,-,11736
549,BUMA.1121.00003,1,334205,346129,+,11924
549,BUMA.1121.00109,1,146715,158526,-,11811
549,BUMA.1121.00053,1,1487223,1499153,+,11930
549,BUMA.1121.00110,1,3022169,3033837,-,11668
549,BUMA.1121.00104,1,3452527,3464396,-,11869
549,BUMA.1121.00086,1,1018812,1030542,-,11730
549,BUMA.1121.00092,1,2042144,2053963,-,11819
549,BUMA.1121.00096,1,1496939,1508692,-,11753
549,BUMA.1121.00054,1,2809813,2821660,+,11847
549,BUMA.1121.00097,1,2161716,2173488,-,11772
549,BUMA.1121.00093,1,2572253,2584153,+,11900
549,BUMA.1121.00106,1,1529862,1541799,+,11937
549,BUMA.1121.00010,1,3413789,3425525,-,11736
549,BUMA.1121.00035,1,2936796,2948716,+,11920
549,BUMA.1121.00108,1,2738272,2750111,+,11839
549,BUMA.1121.00028,1,2332549,2344285,-,11736
549,BUMA.1121.00094,1,1792808,1804761,+,11953
549,BUMA.1121.00102,1,3637380,3649170,-,11790
549,BUMA.1121.00111,1,1963899,1975859,+,11960
549,BUMA.1121.00089,1,1761454,1773407,+,11953
549,BUMA.1121.00084,1,2126620,2138538,+,11918
549,BUMA.1121.00029,1,3139838,3151846,-,12008
549,BUMA.1121.00012,1,490592,502488,+,11896
549,BUMA.1121.00087,1,2286174,2297972,+,11798
549,BUMA.1121.00043,1,1876334,1888265,+,11931
549,BUMA.1121.00046,1,2697273,2709132,+,11859
549,BUMA.1121.00037,1,425143,437141,+,11998
549,BUMA.1121.00080,1,1791562,1803466,+,11904
549,BUMA.1121.00079,1,1786730,1798577,+,11847
549,BUMA.1121.00045,1,2278082,2289815,-,11733
549,BUMA.1121.00071,1,2070749,2082530,-,11781
549,BUMA.1121.00056,1,2152722,2164501,-,11779
549,BUMA.1121.00065,1,1863682,1875512,+,11830
549,BUMA.1121.00058,1,2783383,2795212,-,11829
549,BUMA.1121.00007,1,2288609,2300315,-,11706
549,BUMA.1121.00067,1,2617167,2629060,-,11893
549,BUMA.1121.00090,1,3959822,3971748,+,11926
549,BUMA.1121.00051,1,1772874,1784735,+,11861
549,BUMA.1121.00020,1,2397408,2409144,-,11736
549,BUMA.1121.00103,1,2633776,2645624,-,11848
549,BUMA.1121.00048,1,1114053,1125831,-,11778
549,BUMA.1121.00047,1,1174899,1186776,-,11877
549,BUMA.1121.00042,1,1424958,1436763,+,11805
549,BUMA.1121.00055,1,1349022,1361041,+,12019
549,BUMA.1121.00031,1,3218860,3230869,+,12009
549,BUMA.1121.00040,1,2021743,2033648,+,11905
549,BUMA.1121.00044,1,1598053,1609789,-,11736
549,BUMA.1121.00088,1,2670512,2682457,+,11945
549,BUMA.1121.00069,1,2053127,2064935,-,11808
549,BUMA.1121.00064,1,1787186,1799097,+,11911
549,BUMA.1121.00105,1,3450112,3461789,-,11677
549,BUMA.1121.00015,1,1711824,1723704,+,11880
549,BUMA.1121.00059,1,974416,986320,+,11904
549,BUMA.1121.00026,1,2850100,2861905,+,11805
549,BUMA.1121.00022,1,2749525,2761247,-,11722
549,BUMA.1121.00052,1,2142540,2154276,-,11736
549,BUMA.1121.00101,1,708927,720745,-,11818
549,BUMA.1121.00001,1,2256993,2268861,-,11868
549,BUMA.1121.00038,1,1321540,1333318,-,11778
549,BUMA.1121.00068,1,527972,540000,+,12028
549,BUMA.1121.00099,1,562198,573947,-,11749
549,BUMA.1121.00091,1,2768511,2780395,-,11884
549,BUMA.1121.00098,1,354666,366630,+,11964
549,BUMA.1121.00013,1,2422717,2434460,-,11743
549,BUMA.1121.00049,1,70786,82601,-,11815
549,BUMA.1121.00072,1,2053580,2065386,-,11806
549,BUMA.1121.00076,1,3541429,3553242,-,11813
549,BUMA.1121.00083,1,3890293,3902107,-,11814
549,BUMA.1121.00078,1,167635,179504,-,11869
549,BUMA.1121.00095,1,3907267,3919029,-,11762
549,BUMA.1121.00077,1,448916,460751,+,11835
549,BUMA.1121.00063,1,2078161,2089943,-,11782
549,BUMA.1121.00061,1,2081094,2092907,-,11813
549,BUMA.1121.00050,1,42600,54357,-,11757
549,BUMA.1121.00081,1,1321601,1333379,-,11778
549,BUMA.1121.00074,1,2060976,2072831,-,11855
549,BUMA.1121.00062,1,2785429,2797232,-,11803
549,BUMA.1121.00060,1,503826,515566,-,11740
549,BUMA.1121.00070,1,2052156,2063942,-,11786
549,BUMA.1121.00075,1,1259607,1271481,+,11874
549,BUMA.1121.00041,1,3078096,3090057,+,11961
549,BUMA.1121.00073,1,2079172,2090958,-,11786
549,BUMA.1121.00017,1,2267568,2279304,-,11736
549,BUMA.1121.00066,1,2054909,2066723,-,11814
549,BUMA.1121.00107,1,1664608,1676436,+,11828
549,BUMA.1121.00085,1,1739486,1751222,-,11736
549,BUMA.1121.00030,1,2267631,2279366,-,11735
549,BUMA.1121.00112,1,1231195,1243014,-,11819
549,BUMA.1121.00002,1,3436245,3447981,-,11736
549,BUMA.1121.00082,1,2234719,2246533,-,11814
549,BUMA.1121.00014,1,986086,998051,-,11965
549,BUMA.1121.00011,1,3886773,3898544,-,11771
549,BUMA.1121.00019,1,2297462,2309198,-,11736
549,BUMA.1121.00057,1,2846971,2858937,+,11966
549,BUMA.1121.00018,1,2410947,2422745,+,11798
549,BUMA.1121.00039,1,1907035,1918989,+,11954
549,BUMA.1121.00016,1,3966478,3978385,+,11907
549,BUMA.1121.00004,1,2332439,2344182,-,11743
549,BUMA.1121.00005,1,479330,491297,+,11967
549,BUMA.1121.00100,1,3553462,3565416,-,11954
549,BUMA.1121.00006,1,1321523,1333301,-,11778
550,BUMA.1121.00027,1,3973184,3981430,+,8246
550,BUMA.1121.00025,1,824446,832450,-,8004
550,BUMA.1121.00021,1,2434044,2442290,+,8246
550,BUMA.1121.00023,1,144418,152664,+,8246
550,BUMA.1121.00024,1,2318440,2326443,-,8003
550,BUMA.1121.00033,1,4135976,4144222,+,8246
550,BUMA.1121.00034,1,2355799,2363802,-,8003
550,BUMA.1121.00036,1,1787243,1795245,+,8002
550,BUMA.1121.00032,1,385284,393287,-,8003
550,BUMA.1121.00009,1,3781699,3789663,-,7964
550,BUMA.1121.00008,1,2331407,2339410,-,8003
550,BUMA.1121.00003,1,350433,358677,+,8244
550,BUMA.1121.00109,1,134156,142147,-,7991
550,BUMA.1121.00053,1,1503446,1511692,+,8246
550,BUMA.1121.00110,1,3009597,3017601,-,8004
550,BUMA.1121.00104,1,3439974,3447977,-,8003
550,BUMA.1121.00086,1,1004676,1012679,-,8003
550,BUMA.1121.00092,1,2029594,2037597,-,8003
550,BUMA.1121.00096,1,1484387,1492390,-,8003
550,BUMA.1121.00054,1,2827791,2835793,+,8002
550,BUMA.1121.00097,1,2149165,2157168,-,8003
550,BUMA.1121.00093,1,2588456,2596702,+,8246
550,BUMA.1121.00106,1,1546105,1554351,+,8246
550,BUMA.1121.00010,1,3398417,3407658,-,9241
550,BUMA.1121.00035,1,2953021,2961267,+,8246
550,BUMA.1121.00108,1,2754416,2762661,+,8245
550,BUMA.1121.00028,1,2318415,2326418,-,8003
550,BUMA.1121.00094,1,1809066,1817313,+,8247
550,BUMA.1121.00102,1,3536122,3544125,-,8003
550,BUMA.1121.00111,1,1980114,1988360,+,8246
550,BUMA.1121.00089,1,1777712,1785958,+,8246
550,BUMA.1121.00084,1,2144285,2152531,+,8246
550,BUMA.1121.00029,1,3127286,3135289,-,8003
550,BUMA.1121.00012,1,554194,562440,+,8246
550,BUMA.1121.00087,1,2304105,2312107,+,8002
550,BUMA.1121.00043,1,1892570,1900816,+,8246
550,BUMA.1121.00046,1,2715263,2723265,+,8002
550,BUMA.1121.00037,1,441446,449692,+,8246
550,BUMA.1121.00080,1,1807770,1816016,+,8246
550,BUMA.1121.00079,1,1802882,1811128,+,8246
550,BUMA.1121.00045,1,2265530,2273533,-,8003
550,BUMA.1121.00071,1,2058187,2066190,-,8003
550,BUMA.1121.00056,1,2140170,2148173,-,8003
550,BUMA.1121.00065,1,1879816,1888063,+,8247
550,BUMA.1121.00058,1,2769409,2777412,-,8003
550,BUMA.1121.00007,1,2276087,2284090,-,8003
550,BUMA.1121.00067,1,2603174,2611177,-,8003
550,BUMA.1121.00090,1,3976053,3984299,+,8246
550,BUMA.1121.00051,1,1789039,1797285,+,8246
550,BUMA.1121.00020,1,2383274,2391277,-,8003
550,BUMA.1121.00103,1,2621241,2629210,-,7969
550,BUMA.1121.00048,1,1099919,1107922,-,8003
550,BUMA.1121.00047,1,1162348,1170351,-,8003
550,BUMA.1121.00042,1,1442894,1450895,+,8001
550,BUMA.1121.00055,1,1365335,1373581,+,8246
550,BUMA.1121.00031,1,3235173,3243419,+,8246
550,BUMA.1121.00040,1,2039779,2047781,+,8002
550,BUMA.1121.00044,1,1583919,1591922,-,8003
550,BUMA.1121.00088,1,2686756,2695002,+,8246
550,BUMA.1121.00069,1,2040585,2048568,-,7983
550,BUMA.1121.00064,1,1803394,1811639,+,8245
550,BUMA.1121.00105,1,3437562,3445565,-,8003
550,BUMA.1121.00015,1,1729835,1737837,+,8002
550,BUMA.1121.00059,1,990614,998859,+,8245
550,BUMA.1121.00026,1,2868035,2876037,+,8002
550,BUMA.1121.00022,1,2735400,2743403,-,8003
550,BUMA.1121.00052,1,2127171,2135169,-,7998
550,BUMA.1121.00101,1,696398,704400,-,8002
550,BUMA.1121.00001,1,2244441,2252444,-,8003
550,BUMA.1121.00038,1,1307406,1315409,-,8003
550,BUMA.1121.00068,1,544304,552551,+,8247
550,BUMA.1121.00099,1,549657,557650,-,7993
550,BUMA.1121.00091,1,2755959,2763962,-,8003
550,BUMA.1121.00098,1,370915,379074,+,8159
550,BUMA.1121.00013,1,2408588,2416586,-,7998
550,BUMA.1121.00049,1,58233,66236,-,8003
550,BUMA.1121.00072,1,2041018,2049021,-,8003
550,BUMA.1121.00076,1,3528878,3536881,-,8003
550,BUMA.1121.00083,1,3877731,3885734,-,8003
550,BUMA.1121.00078,1,75092,83094,-,8002
550,BUMA.1121.00095,1,3894716,3902719,-,8003
550,BUMA.1121.00077,1,465075,473321,+,8246
550,BUMA.1121.00063,1,2065600,2073603,-,8003
550,BUMA.1121.00061,1,2068532,2076535,-,8003
550,BUMA.1121.00050,1,28466,36469,-,8003
550,BUMA.1121.00081,1,1307467,1315470,-,8003
550,BUMA.1121.00074,1,2048432,2056435,-,8003
550,BUMA.1121.00062,1,2772854,2780871,-,8017
550,BUMA.1121.00060,1,491274,499277,-,8003
550,BUMA.1121.00070,1,2039594,2047597,-,8003
550,BUMA.1121.00075,1,1275785,1284030,+,8245
550,BUMA.1121.00041,1,3094363,3102609,+,8246
550,BUMA.1121.00073,1,2066610,2074613,-,8003
550,BUMA.1121.00017,1,2253434,2261437,-,8003
550,BUMA.1121.00066,1,2042347,2050350,-,8003
550,BUMA.1121.00107,1,1680742,1688988,+,8246
550,BUMA.1121.00085,1,1724117,1732115,-,7998
550,BUMA.1121.00030,1,2253497,2261500,-,8003
550,BUMA.1121.00112,1,1218653,1226656,-,8003
550,BUMA.1121.00002,1,3420871,3430114,-,9243
550,BUMA.1121.00082,1,2222157,2230160,-,8003
550,BUMA.1121.00014,1,973534,981537,-,8003
550,BUMA.1121.00011,1,3874221,3882224,-,8003
550,BUMA.1121.00019,1,2283328,2291331,-,8003
550,BUMA.1121.00057,1,2863242,2871488,+,8246
550,BUMA.1121.00018,1,2427049,2435295,+,8246
550,BUMA.1121.00039,1,1923294,1931540,+,8246
550,BUMA.1121.00016,1,3998072,4006318,+,8246
550,BUMA.1121.00004,1,2318305,2326308,-,8003
550,BUMA.1121.00005,1,495603,503849,+,8246
550,BUMA.1121.00100,1,3540912,3548915,-,8003
550,BUMA.1121.00006,1,1307389,1315392,-,8003
551,BUMA.1121.00027,1,3981685,3995101,+,13416
551,BUMA.1121.00025,1,810788,824192,-,13404
551,BUMA.1121.00021,1,2442546,2455959,+,13413
551,BUMA.1121.00023,1,152919,166332,+,13413
551,BUMA.1121.00024,1,2303653,2317072,-,13419
551,BUMA.1121.00033,1,4144477,4157898,+,13421
551,BUMA.1121.00034,1,2341012,2354431,-,13419
551,BUMA.1121.00036,1,2039845,2053264,-,13419
551,BUMA.1121.00032,1,370497,383916,-,13419
551,BUMA.1121.00009,1,3768063,3781445,-,13382
551,BUMA.1121.00008,1,2316620,2330039,-,13419
551,BUMA.1121.00003,1,358933,372315,+,13382
551,BUMA.1121.00109,1,120514,133901,-,13387
551,BUMA.1121.00053,1,1511947,1525392,+,13445
551,BUMA.1121.00110,1,2995911,3009343,-,13432
551,BUMA.1121.00104,1,3426328,3439719,-,13391
551,BUMA.1121.00086,1,746655,760075,+,13420
551,BUMA.1121.00092,1,2015931,2029340,-,13409
551,BUMA.1121.00096,1,1470711,1484133,-,13422
551,BUMA.1121.00054,1,2837161,2850581,+,13420
551,BUMA.1121.00097,1,2135491,2148911,-,13420
551,BUMA.1121.00093,1,2596957,2610366,+,13409
551,BUMA.1121.00106,1,1554607,1568028,+,13421
551,BUMA.1121.00010,1,3162319,3175740,+,13421
551,BUMA.1121.00035,1,2961522,2974935,+,13413
551,BUMA.1121.00108,1,2762916,2776338,+,13422
551,BUMA.1121.00028,1,2303628,2317047,-,13419
551,BUMA.1121.00094,1,1817569,1830980,+,13411
551,BUMA.1121.00102,1,3522458,3535867,-,13409
551,BUMA.1121.00111,1,1988615,2002026,+,13411
551,BUMA.1121.00089,1,1786214,1799625,+,13411
551,BUMA.1121.00084,1,2152787,2166210,+,13423
551,BUMA.1121.00029,1,3113619,3127032,-,13413
551,BUMA.1121.00012,1,562695,576098,+,13403
551,BUMA.1121.00087,1,2556691,2570110,-,13419
551,BUMA.1121.00043,1,1901071,1914484,+,13413
551,BUMA.1121.00046,1,2724633,2738053,+,13420
551,BUMA.1121.00037,1,449947,463363,+,13416
551,BUMA.1121.00080,1,1816272,1829682,+,13410
551,BUMA.1121.00079,1,1811384,1824784,+,13400
551,BUMA.1121.00045,1,2251862,2265276,-,13414
551,BUMA.1121.00071,1,2044526,2057933,-,13407
551,BUMA.1121.00056,1,2126504,2139915,-,13411
551,BUMA.1121.00065,1,1888317,1901727,+,13410
551,BUMA.1121.00058,1,2755733,2769154,-,13421
551,BUMA.1121.00007,1,2262420,2275833,-,13413
551,BUMA.1121.00067,1,2589509,2602919,-,13410
551,BUMA.1121.00090,1,3984554,3997954,+,13400
551,BUMA.1121.00051,1,1797540,1810949,+,13409
551,BUMA.1121.00020,1,2368487,2381906,-,13419
551,BUMA.1121.00103,1,2607552,2620986,-,13434
551,BUMA.1121.00048,1,1085132,1098553,-,13421
551,BUMA.1121.00047,1,1148682,1162093,-,13411
551,BUMA.1121.00042,1,1452262,1465683,+,13421
551,BUMA.1121.00055,1,1373836,1387245,+,13409
551,BUMA.1121.00031,1,3243674,3257086,+,13412
551,BUMA.1121.00040,1,2430669,2444087,-,13418
551,BUMA.1121.00044,1,1569132,1582551,-,13419
551,BUMA.1121.00088,1,2695258,2708657,+,13399
551,BUMA.1121.00069,1,2026931,2040331,-,13400
551,BUMA.1121.00064,1,1811895,1825304,+,13409
551,BUMA.1121.00105,1,3423899,3437308,-,13409
551,BUMA.1121.00015,1,1739205,1752625,+,13420
551,BUMA.1121.00059,1,999114,1012523,+,13409
551,BUMA.1121.00026,1,2877404,2890825,+,13421
551,BUMA.1121.00022,1,2477250,2490670,+,13420
551,BUMA.1121.00052,1,2112384,2125803,-,13419
551,BUMA.1121.00101,1,682752,696143,-,13391
551,BUMA.1121.00001,1,2230774,2244187,-,13413
551,BUMA.1121.00038,1,1292619,1306038,-,13419
551,BUMA.1121.00068,1,552809,566252,+,13443
551,BUMA.1121.00099,1,535975,549402,-,13427
551,BUMA.1121.00091,1,2742284,2755704,-,13420
551,BUMA.1121.00098,1,379329,392739,+,13410
551,BUMA.1121.00013,1,2393801,2407220,-,13419
551,BUMA.1121.00049,1,44574,57978,-,13404
551,BUMA.1121.00072,1,2027359,2040764,-,13405
551,BUMA.1121.00076,1,3515202,3528624,-,13422
551,BUMA.1121.00083,1,3864070,3877477,-,13407
551,BUMA.1121.00078,1,61440,74838,-,13398
551,BUMA.1121.00095,1,3881043,3894462,-,13419
551,BUMA.1121.00077,1,473576,487006,+,13430
551,BUMA.1121.00063,1,2051945,2065346,-,13401
551,BUMA.1121.00061,1,2054878,2068278,-,13400
551,BUMA.1121.00050,1,13679,27098,-,13419
551,BUMA.1121.00081,1,1292680,1306099,-,13419
551,BUMA.1121.00074,1,2034768,2048177,-,13409
551,BUMA.1121.00062,1,2757738,2771159,-,13421
551,BUMA.1121.00060,1,477606,491020,-,13414
551,BUMA.1121.00070,1,2025939,2039340,-,13401
551,BUMA.1121.00075,1,1284285,1297707,+,13422
551,BUMA.1121.00041,1,3102864,3116249,+,13385
551,BUMA.1121.00073,1,2052954,2066356,-,13402
551,BUMA.1121.00017,1,2238647,2252066,-,13419
551,BUMA.1121.00066,1,2028693,2042093,-,13400
551,BUMA.1121.00107,1,1689242,1702655,+,13413
551,BUMA.1121.00085,1,1709330,1722749,-,13419
551,BUMA.1121.00030,1,2238710,2252129,-,13419
551,BUMA.1121.00112,1,1205002,1218399,-,13397
551,BUMA.1121.00002,1,3184711,3198131,+,13420
551,BUMA.1121.00082,1,2208496,2221903,-,13407
551,BUMA.1121.00014,1,959867,973280,-,13413
551,BUMA.1121.00011,1,3860581,3873966,-,13385
551,BUMA.1121.00019,1,2268541,2281960,-,13419
551,BUMA.1121.00057,1,2871743,2885141,+,13398
551,BUMA.1121.00018,1,2435550,2448955,+,13405
551,BUMA.1121.00039,1,1931795,1945208,+,13413
551,BUMA.1121.00016,1,4006574,4019989,+,13415
551,BUMA.1121.00004,1,2303519,2316938,-,13419
551,BUMA.1121.00005,1,504104,517515,+,13411
551,BUMA.1121.00100,1,3527305,3540658,-,13353
551,BUMA.1121.00006,1,1292602,1306021,-,13419
552,BUMA.1121.00027,1,3995569,4005849,+,10280
552,BUMA.1121.00025,1,800060,810331,-,10271
552,BUMA.1121.00021,1,2456416,2466694,+,10278
552,BUMA.1121.00023,1,168380,178647,+,10267
552,BUMA.1121.00024,1,2290389,2300648,-,10259
552,BUMA.1121.00033,1,4158355,4168632,+,10277
552,BUMA.1121.00034,1,2327748,2338007,-,10259
552,BUMA.1121.00036,1,2026581,2036840,-,10259
552,BUMA.1121.00032,1,357233,367492,-,10259
552,BUMA.1121.00009,1,3757315,3767592,-,10277
552,BUMA.1121.00008,1,2303356,2313615,-,10259
552,BUMA.1121.00003,1,372783,383073,+,10290
552,BUMA.1121.00109,1,109762,120046,-,10284
552,BUMA.1121.00053,1,1525860,1536071,+,10211
552,BUMA.1121.00110,1,2985160,2995443,-,10283
552,BUMA.1121.00104,1,3413980,3424269,-,10289
552,BUMA.1121.00086,1,763080,773338,+,10258
552,BUMA.1121.00092,1,2005195,2015463,-,10268
552,BUMA.1121.00096,1,1459962,1470243,-,10281
552,BUMA.1121.00054,1,2853586,2863853,+,10267
552,BUMA.1121.00097,1,2124753,2135023,-,10270
552,BUMA.1121.00093,1,2610834,2621101,+,10267
552,BUMA.1121.00106,1,1568496,1578786,+,10290
552,BUMA.1121.00010,1,103322,113581,-,10259
552,BUMA.1121.00035,1,2975392,2985661,+,10269
552,BUMA.1121.00108,1,2776797,2787092,+,10295
552,BUMA.1121.00028,1,2290364,2300623,-,10259
552,BUMA.1121.00094,1,1831448,1841727,+,10279
552,BUMA.1121.00102,1,3511707,3521989,-,10282
552,BUMA.1121.00111,1,2002483,2012752,+,10269
552,BUMA.1121.00089,1,1800093,1810372,+,10279
552,BUMA.1121.00084,1,2166678,2176954,+,10276
552,BUMA.1121.00029,1,3102892,3113162,-,10270
552,BUMA.1121.00012,1,576552,586826,+,10274
552,BUMA.1121.00087,1,2543426,2553685,-,10259
552,BUMA.1121.00043,1,1914941,1925210,+,10269
552,BUMA.1121.00046,1,2741058,2751316,+,10258
552,BUMA.1121.00037,1,463817,474085,+,10268
552,BUMA.1121.00080,1,1830150,1840429,+,10279
552,BUMA.1121.00079,1,1825252,1835530,+,10278
552,BUMA.1121.00045,1,2241230,2251408,-,10178
552,BUMA.1121.00071,1,2033776,2044058,-,10282
552,BUMA.1121.00056,1,2115756,2126036,-,10280
552,BUMA.1121.00065,1,1902181,1912446,+,10265
552,BUMA.1121.00058,1,2744974,2755265,-,10291
552,BUMA.1121.00007,1,2251652,2261952,-,10300
552,BUMA.1121.00067,1,2578770,2589041,-,10271
552,BUMA.1121.00090,1,3998411,4008680,+,10269
552,BUMA.1121.00051,1,1811417,1821696,+,10279
552,BUMA.1121.00020,1,2355223,2365482,-,10259
552,BUMA.1121.00103,1,2595205,2605491,-,10286
552,BUMA.1121.00048,1,1071859,1082127,-,10268
552,BUMA.1121.00047,1,1137934,1148214,-,10280
552,BUMA.1121.00042,1,1468037,1478295,+,10258
552,BUMA.1121.00055,1,1387704,1397969,+,10265
552,BUMA.1121.00031,1,3257543,3267812,+,10269
552,BUMA.1121.00040,1,2418643,2428902,-,10259
552,BUMA.1121.00044,1,1555868,1566127,-,10259
552,BUMA.1121.00088,1,2709111,2719388,+,10277
552,BUMA.1121.00069,1,2016187,2026465,-,10278
552,BUMA.1121.00064,1,1825772,1836049,+,10277
552,BUMA.1121.00105,1,3413141,3423431,-,10290
552,BUMA.1121.00015,1,1755630,1765888,+,10258
552,BUMA.1121.00059,1,1012991,1023268,+,10277
552,BUMA.1121.00026,1,2893179,2903427,+,10248
552,BUMA.1121.00022,1,2493675,2503933,+,10258
552,BUMA.1121.00052,1,2099129,2109379,-,10250
552,BUMA.1121.00101,1,672024,682298,-,10274
552,BUMA.1121.00001,1,2220047,2230317,-,10270
552,BUMA.1121.00038,1,1279346,1289614,-,10268
552,BUMA.1121.00068,1,566720,576990,+,10270
552,BUMA.1121.00099,1,525281,535507,-,10226
552,BUMA.1121.00091,1,2731523,2741816,-,10293
552,BUMA.1121.00098,1,393193,403483,+,10290
552,BUMA.1121.00013,1,1900673,1910922,+,10249
552,BUMA.1121.00049,1,33815,44106,-,10291
552,BUMA.1121.00072,1,2016609,2026891,-,10282
552,BUMA.1121.00076,1,3504443,3514734,-,10291
552,BUMA.1121.00083,1,3853320,3863602,-,10282
552,BUMA.1121.00078,1,50694,60972,-,10278
552,BUMA.1121.00095,1,3870293,3880575,-,10282
552,BUMA.1121.00077,1,487474,497754,+,10280
552,BUMA.1121.00063,1,2041226,2051477,-,10251
552,BUMA.1121.00061,1,2044162,2054410,-,10248
552,BUMA.1121.00050,1,415,10674,-,10259
552,BUMA.1121.00081,1,1279407,1289675,-,10268
552,BUMA.1121.00074,1,2024022,2034300,-,10278
552,BUMA.1121.00062,1,2746995,2757270,-,10275
552,BUMA.1121.00060,1,466974,477152,-,10178
552,BUMA.1121.00070,1,2015207,2025471,-,10264
552,BUMA.1121.00075,1,1298175,1308465,+,10290
552,BUMA.1121.00041,1,3116717,3126998,+,10281
552,BUMA.1121.00073,1,2042228,2052486,-,10258
552,BUMA.1121.00017,1,2225383,2235642,-,10259
552,BUMA.1121.00066,1,2017950,2028225,-,10275
552,BUMA.1121.00107,1,1703123,1713407,+,10284
552,BUMA.1121.00085,1,1696075,1706325,-,10250
552,BUMA.1121.00030,1,2225446,2235705,-,10259
552,BUMA.1121.00112,1,1194278,1204543,-,10265
552,BUMA.1121.00002,1,127333,137592,-,10259
552,BUMA.1121.00082,1,2197746,2208028,-,10282
552,BUMA.1121.00014,1,949140,959410,-,10270
552,BUMA.1121.00011,1,3849851,3860110,-,10259
552,BUMA.1121.00019,1,2255277,2265536,-,10259
552,BUMA.1121.00057,1,2885609,2895890,+,10281
552,BUMA.1121.00018,1,2449412,2459681,+,10269
552,BUMA.1121.00039,1,1945665,1955934,+,10269
552,BUMA.1121.00016,1,4020446,4030715,+,10269
552,BUMA.1121.00004,1,2290255,2300514,-,10259
552,BUMA.1121.00005,1,517983,528258,+,10275
552,BUMA.1121.00100,1,3516532,3526837,-,10305
552,BUMA.1121.00006,1,1279329,1289597,-,10268
553,BUMA.1121.00027,1,4006371,4012048,+,5677
553,BUMA.1121.00025,1,793811,799539,-,5728
553,BUMA.1121.00021,1,2467216,2472947,+,5731
553,BUMA.1121.00023,1,179169,184885,+,5716
553,BUMA.1121.00024,1,2284119,2289868,-,5749
553,BUMA.1121.00033,1,4169154,4174867,+,5713
553,BUMA.1121.00034,1,2321478,2327227,-,5749
553,BUMA.1121.00036,1,2020311,2026060,-,5749
553,BUMA.1121.00032,1,350963,356712,-,5749
553,BUMA.1121.00009,1,3751049,3756794,-,5745
553,BUMA.1121.00008,1,2297086,2302835,-,5749
553,BUMA.1121.00003,1,383595,389344,+,5749
553,BUMA.1121.00109,1,103511,109241,-,5730
553,BUMA.1121.00053,1,1536593,1542321,+,5728
553,BUMA.1121.00110,1,2978895,2984639,-,5744
553,BUMA.1121.00104,1,3407715,3413459,-,5744
553,BUMA.1121.00086,1,773860,779621,+,5761
553,BUMA.1121.00092,1,1998944,2004674,-,5730
553,BUMA.1121.00096,1,1453712,1459441,-,5729
553,BUMA.1121.00054,1,2865615,2871364,+,5749
553,BUMA.1121.00097,1,2118498,2124232,-,5734
553,BUMA.1121.00093,1,2621623,2627353,+,5730
553,BUMA.1121.00106,1,1579308,1585052,+,5744
553,BUMA.1121.00010,1,97052,102801,-,5749
553,BUMA.1121.00035,1,2986183,2991899,+,5716
553,BUMA.1121.00108,1,2787614,2793336,+,5722
553,BUMA.1121.00028,1,2284094,2289843,-,5749
553,BUMA.1121.00094,1,1842249,1847979,+,5730
553,BUMA.1121.00102,1,3505458,3511186,-,5728
553,BUMA.1121.00111,1,2013274,2018989,+,5715
553,BUMA.1121.00089,1,1810894,1816624,+,5730
553,BUMA.1121.00084,1,2177476,2183234,+,5758
553,BUMA.1121.00029,1,3096727,3102371,-,5644
553,BUMA.1121.00012,1,587348,593079,+,5731
553,BUMA.1121.00087,1,2537144,2542905,-,5761
553,BUMA.1121.00043,1,1925732,1931474,+,5742
553,BUMA.1121.00046,1,2753078,2758851,+,5773
553,BUMA.1121.00037,1,474607,480347,+,5740
553,BUMA.1121.00080,1,1840951,1846681,+,5730
553,BUMA.1121.00079,1,1836052,1841780,+,5728
553,BUMA.1121.00045,1,2234972,2240709,-,5737
553,BUMA.1121.00071,1,2027521,2033255,-,5734
553,BUMA.1121.00056,1,2109505,2115235,-,5730
553,BUMA.1121.00065,1,1912968,1918699,+,5731
553,BUMA.1121.00058,1,2738721,2744453,-,5732
553,BUMA.1121.00007,1,2245400,2251131,-,5731
553,BUMA.1121.00067,1,2572521,2578249,-,5728
553,BUMA.1121.00090,1,4009202,4014918,+,5716
553,BUMA.1121.00051,1,1822218,1827949,+,5731
553,BUMA.1121.00020,1,2348953,2354702,-,5749
553,BUMA.1121.00103,1,2588953,2594684,-,5731
553,BUMA.1121.00048,1,1064350,1070099,-,5749
553,BUMA.1121.00047,1,1131683,1137413,-,5730
553,BUMA.1121.00042,1,1478817,1484554,+,5737
553,BUMA.1121.00055,1,1398491,1404222,+,5731
553,BUMA.1121.00031,1,3268334,3274061,+,5727
553,BUMA.1121.00040,1,2412385,2418122,-,5737
553,BUMA.1121.00044,1,1549598,1555347,-,5749
553,BUMA.1121.00088,1,2719910,2725677,+,5767
553,BUMA.1121.00069,1,2009933,2015666,-,5733
553,BUMA.1121.00064,1,1836571,1842315,+,5744
553,BUMA.1121.00105,1,3406913,3412620,-,5707
553,BUMA.1121.00015,1,1767408,1773126,+,5718
553,BUMA.1121.00059,1,1023790,1029521,+,5731
553,BUMA.1121.00026,1,2903949,2909686,+,5737
553,BUMA.1121.00022,1,2504455,2510216,+,5761
553,BUMA.1121.00052,1,2092847,2098608,-,5761
553,BUMA.1121.00101,1,665781,671503,-,5722
553,BUMA.1121.00001,1,2213810,2219526,-,5716
553,BUMA.1121.00038,1,1271836,1277585,-,5749
553,BUMA.1121.00068,1,577512,583244,+,5732
553,BUMA.1121.00099,1,519022,524760,-,5738
553,BUMA.1121.00091,1,2725271,2731002,-,5731
553,BUMA.1121.00098,1,404005,409736,+,5731
553,BUMA.1121.00013,1,1911444,1917205,+,5761
553,BUMA.1121.00049,1,27550,33294,-,5744
553,BUMA.1121.00072,1,2010355,2016088,-,5733
553,BUMA.1121.00076,1,3498193,3503922,-,5729
553,BUMA.1121.00083,1,3847065,3852799,-,5734
553,BUMA.1121.00078,1,44430,50173,-,5743
553,BUMA.1121.00095,1,3864035,3869772,-,5737
553,BUMA.1121.00077,1,498278,504020,+,5742
553,BUMA.1121.00063,1,2034971,2040705,-,5734
553,BUMA.1121.00061,1,2037907,2043641,-,5734
553,BUMA.1121.00050,1,3546244,3552017,-,5773
553,BUMA.1121.00081,1,1271897,1277646,-,5749
553,BUMA.1121.00074,1,2017757,2023501,-,5744
553,BUMA.1121.00062,1,2740743,2746474,-,5731
553,BUMA.1121.00060,1,460716,466453,-,5737
553,BUMA.1121.00070,1,2008952,2014686,-,5734
553,BUMA.1121.00075,1,1308987,1314716,+,5729
553,BUMA.1121.00041,1,3127520,3133264,+,5744
553,BUMA.1121.00073,1,2035973,2041707,-,5734
553,BUMA.1121.00017,1,2219113,2224862,-,5749
553,BUMA.1121.00066,1,2011695,2017429,-,5734
553,BUMA.1121.00107,1,1713929,1719658,+,5729
553,BUMA.1121.00085,1,1689793,1695554,-,5761
553,BUMA.1121.00030,1,2219176,2224925,-,5749
553,BUMA.1121.00112,1,1188019,1193757,-,5738
553,BUMA.1121.00002,1,121063,126812,-,5749
553,BUMA.1121.00082,1,2191491,2197225,-,5734
553,BUMA.1121.00014,1,942892,948619,-,5727
553,BUMA.1121.00011,1,3843586,3849330,-,5744
553,BUMA.1121.00019,1,2249007,2254756,-,5749
553,BUMA.1121.00057,1,2896412,2902146,+,5734
553,BUMA.1121.00018,1,2460203,2465931,+,5728
553,BUMA.1121.00039,1,1956456,1962172,+,5716
553,BUMA.1121.00016,1,4031237,4036882,+,5645
553,BUMA.1121.00004,1,2283985,2289734,-,5749
553,BUMA.1121.00005,1,528780,534524,+,5744
553,BUMA.1121.00100,1,3510279,3516011,-,5732
553,BUMA.1121.00006,1,1271819,1277568,-,5749
554,BUMA.1121.00021,2,2031791,2036239,+,4448
554,BUMA.1121.00001,2,693640,698089,-,4449
554,BUMA.1121.00043,2,807920,812369,-,4449
554,BUMA.1121.00029,2,3072053,3076502,-,4449
554,BUMA.1121.00035,2,3089335,3093784,-,4449
554,BUMA.1121.00033,2,2250810,2255256,+,4446
554,BUMA.1121.00012,2,174691,179140,-,4449
555,BUMA.1121.00025,1,946920,984305,+,37385
555,BUMA.1121.00018,1,2275454,2312837,-,37383
556,BUMA.1121.00025,1,1089589,1092724,+,3135
556,BUMA.1121.00021,1,2225809,2228945,-,3136
556,BUMA.1121.00023,1,4035013,4038149,-,3136
556,BUMA.1121.00033,1,3872372,3875520,-,3148
556,BUMA.1121.00009,1,19339,22474,+,3135
556,BUMA.1121.00109,1,351605,354740,+,3135
556,BUMA.1121.00096,1,1701873,1705008,+,3135
556,BUMA.1121.00035,1,2741549,2744685,-,3136
556,BUMA.1121.00111,1,1765885,1769021,-,3136
556,BUMA.1121.00029,1,3345416,3348551,+,3135
556,BUMA.1121.00012,1,295887,299023,-,3136
556,BUMA.1121.00043,1,1680041,1683177,-,3136
556,BUMA.1121.00045,1,2483017,2486159,+,3142
556,BUMA.1121.00058,1,2991489,2994624,+,3135
556,BUMA.1121.00007,1,2488836,2491971,+,3135
556,BUMA.1121.00090,1,3766530,3769665,-,3135
556,BUMA.1121.00103,1,2837455,2840590,+,3135
556,BUMA.1121.00031,1,3025294,3028430,-,3136
556,BUMA.1121.00001,1,2464222,2467357,+,3135
556,BUMA.1121.00068,1,325438,328574,-,3136
556,BUMA.1121.00078,1,375848,378983,+,3135
556,BUMA.1121.00062,1,2991595,2994730,+,3135
556,BUMA.1121.00060,1,708760,711902,+,3142
556,BUMA.1121.00041,1,2877384,2880520,-,3136
556,BUMA.1121.00112,1,1437659,1440794,+,3135
556,BUMA.1121.00014,1,1188670,1191805,+,3135
556,BUMA.1121.00018,1,2167063,2170199,-,3136
556,BUMA.1121.00039,1,1712407,1715543,-,3136
556,BUMA.1121.00016,1,3773167,3776303,-,3136
556,BUMA.1121.00100,1,3756986,3760121,+,3135
557,BUMA.1121.00025,1,1540570,1543871,+,3301
557,BUMA.1121.00058,1,3439287,3442608,+,3321
557,BUMA.1121.00018,1,1715980,1719282,-,3302
558,BUMA.1121.00025,1,1552036,1555120,+,3084
558,BUMA.1121.00023,1,3520928,3524012,-,3084
558,BUMA.1121.00092,1,1190455,1193539,-,3084
558,BUMA.1121.00093,1,3432614,3435698,+,3084
558,BUMA.1121.00035,1,2253403,2256487,-,3084
558,BUMA.1121.00108,1,3626531,3629615,+,3084
558,BUMA.1121.00094,1,1127967,1131051,-,3084
558,BUMA.1121.00012,1,3917339,3920423,-,3084
558,BUMA.1121.00043,1,1166527,1169611,-,3084
558,BUMA.1121.00079,1,2621262,2624346,+,3084
558,BUMA.1121.00065,1,1211487,1214571,-,3084
558,BUMA.1121.00058,1,3452928,3456006,+,3078
558,BUMA.1121.00007,1,1472117,1475201,-,3084
558,BUMA.1121.00090,1,3264460,3267544,-,3084
558,BUMA.1121.00103,1,1819907,1822991,-,3084
558,BUMA.1121.00047,1,1847674,1850758,+,3084
558,BUMA.1121.00055,1,2266046,2269124,+,3078
558,BUMA.1121.00031,1,2544789,2547862,-,3073
558,BUMA.1121.00105,1,2615066,2618135,-,3069
558,BUMA.1121.00059,1,1819084,1822168,+,3084
558,BUMA.1121.00001,1,2939392,2942476,+,3084
558,BUMA.1121.00068,1,1358852,1361933,+,3081
558,BUMA.1121.00099,1,3826894,3829975,-,3081
558,BUMA.1121.00098,1,1245287,1248371,+,3084
558,BUMA.1121.00049,1,3241509,3244593,-,3084
558,BUMA.1121.00076,1,2730664,2733748,-,3084
558,BUMA.1121.00078,1,3422046,3425130,-,3084
558,BUMA.1121.00074,1,2742577,2745661,+,3084
558,BUMA.1121.00062,1,1973662,1976746,-,3084
558,BUMA.1121.00075,1,2080320,2083404,+,3084
558,BUMA.1121.00107,1,2512219,2515303,+,3084
558,BUMA.1121.00112,1,255085,258169,-,3084
558,BUMA.1121.00014,1,1669384,1672457,+,3073
558,BUMA.1121.00018,1,1704732,1707816,-,3084
559,BUMA.1121.00025,1,1558854,1569750,+,10896
559,BUMA.1121.00023,1,3506299,3517194,-,10895
559,BUMA.1121.00092,1,1175806,1186722,-,10916
559,BUMA.1121.00093,1,3439431,3450347,+,10916
559,BUMA.1121.00035,1,2238773,2249669,-,10896
559,BUMA.1121.00108,1,3633348,3644266,+,10918
559,BUMA.1121.00094,1,1113318,1124234,-,10916
559,BUMA.1121.00012,1,3902709,3913605,-,10896
559,BUMA.1121.00043,1,1151897,1162793,-,10896
559,BUMA.1121.00079,1,2628079,2638996,+,10917
559,BUMA.1121.00065,1,1196844,1207754,-,10910
559,BUMA.1121.00058,1,3462098,3473008,+,10910
559,BUMA.1121.00007,1,1457466,1468384,-,10918
559,BUMA.1121.00090,1,3249830,3260726,-,10896
559,BUMA.1121.00103,1,1805277,1816174,-,10897
559,BUMA.1121.00047,1,1854491,1865407,+,10916
559,BUMA.1121.00055,1,2273406,2284780,+,11374
559,BUMA.1121.00031,1,2530162,2541055,-,10893
559,BUMA.1121.00105,1,2598065,2608973,-,10908
559,BUMA.1121.00059,1,1825901,1836817,+,10916
559,BUMA.1121.00001,1,2946210,2957106,+,10896
559,BUMA.1121.00068,1,1365666,1377047,+,11381
559,BUMA.1121.00099,1,3812243,3823161,-,10918
559,BUMA.1121.00098,1,1253699,1264617,+,10918
559,BUMA.1121.00049,1,3226864,3237776,-,10912
559,BUMA.1121.00076,1,2716013,2726931,-,10918
559,BUMA.1121.00078,1,3407395,3418313,-,10918
559,BUMA.1121.00074,1,2749394,2760295,+,10901
559,BUMA.1121.00062,1,1959011,1969929,-,10918
559,BUMA.1121.00075,1,2087137,2098055,+,10918
559,BUMA.1121.00107,1,2519036,2529954,+,10918
559,BUMA.1121.00112,1,238397,249757,-,11360
559,BUMA.1121.00014,1,1676191,1687084,+,10893
559,BUMA.1121.00018,1,1690102,1700998,-,10896
560,BUMA.1121.00025,1,1570941,1576289,+,5348
560,BUMA.1121.00023,1,3499760,3505108,-,5348
560,BUMA.1121.00092,1,1169839,1174216,-,4377
560,BUMA.1121.00093,1,3451937,3456314,+,4377
560,BUMA.1121.00035,1,2232234,2237582,-,5348
560,BUMA.1121.00108,1,3646158,3651749,+,5591
560,BUMA.1121.00094,1,1107303,1111680,-,4377
560,BUMA.1121.00012,1,3896170,3901518,-,5348
560,BUMA.1121.00043,1,1145358,1150706,-,5348
560,BUMA.1121.00079,1,2640586,2644963,+,4377
560,BUMA.1121.00065,1,1190829,1195206,-,4377
560,BUMA.1121.00058,1,3475490,3480828,+,5338
560,BUMA.1121.00007,1,1451521,1455876,-,4355
560,BUMA.1121.00090,1,3243291,3248639,-,5348
560,BUMA.1121.00103,1,1799315,1803687,-,4372
560,BUMA.1121.00047,1,1867045,1871422,+,4377
560,BUMA.1121.00055,1,2286672,2291052,+,4380
560,BUMA.1121.00031,1,2523623,2528971,-,5348
560,BUMA.1121.00105,1,2590836,2596427,-,5591
560,BUMA.1121.00059,1,1838468,1842845,+,4377
560,BUMA.1121.00001,1,2958297,2963645,+,5348
560,BUMA.1121.00068,1,1378637,1383018,+,4381
560,BUMA.1121.00099,1,3805704,3810653,-,4949
560,BUMA.1121.00098,1,1266783,1272374,+,5591
560,BUMA.1121.00049,1,3220770,3225150,-,4380
560,BUMA.1121.00076,1,2708533,2714121,-,5588
560,BUMA.1121.00078,1,3400848,3405805,-,4957
560,BUMA.1121.00074,1,2762009,2766384,+,4375
560,BUMA.1121.00062,1,1953044,1957421,-,4377
560,BUMA.1121.00075,1,2099947,2105535,+,5588
560,BUMA.1121.00107,1,2531544,2535923,+,4379
560,BUMA.1121.00112,1,230560,236151,-,5591
560,BUMA.1121.00014,1,1688275,1693623,+,5348
560,BUMA.1121.00018,1,1683563,1688911,-,5348
561,BUMA.1121.00025,1,1920038,1924105,+,4067
561,BUMA.1121.00099,1,1586371,1590437,+,4066
561,BUMA.1121.00018,1,1335767,1339834,-,4067
562,BUMA.1121.00025,1,1960812,1964171,+,3359
562,BUMA.1121.00018,1,1295700,1299060,-,3360
563,BUMA.1121.00025,1,1968273,1975041,+,6768
563,BUMA.1121.00018,1,1284830,1291598,-,6768
564,BUMA.1121.00025,1,1975896,1979464,+,3568
564,BUMA.1121.00018,1,1280407,1283976,-,3569
565,BUMA.1121.00025,1,1981202,1984426,+,3224
565,BUMA.1121.00018,1,1275445,1278669,-,3224
566,BUMA.1121.00025,1,2640185,2644567,+,4382
566,BUMA.1121.00023,1,2450233,2454141,-,3908
566,BUMA.1121.00012,1,2834274,2838656,-,4382
566,BUMA.1121.00037,1,2752911,2757293,-,4382
566,BUMA.1121.00007,1,4005004,4009386,+,4382
566,BUMA.1121.00090,1,2217105,2221487,-,4382
566,BUMA.1121.00078,1,1929424,1933806,+,4382
566,BUMA.1121.00014,1,2779175,2783553,+,4378
566,BUMA.1121.00018,1,615312,619694,-,4382
566,BUMA.1121.00039,1,208211,212593,-,4382
566,BUMA.1121.00005,1,3473287,3477669,+,4382
567,BUMA.1121.00025,1,2670856,2673918,+,3062
567,BUMA.1121.00018,1,585961,589024,-,3063
568,BUMA.1121.00025,1,2966025,2970526,+,4501
568,BUMA.1121.00018,1,289354,293856,-,4502
569,BUMA.1121.00025,1,2978174,2994727,+,16553
569,BUMA.1121.00018,1,265155,281706,-,16551
570,BUMA.1121.00025,1,2998161,3002091,+,3930
570,BUMA.1121.00018,1,257791,261721,-,3930
571,BUMA.1121.00025,1,3008171,3012005,+,3834
571,BUMA.1121.00018,1,247876,251710,-,3834
572,BUMA.1121.00025,1,3770961,3781367,+,10406
572,BUMA.1121.00021,1,3643993,3654399,-,10406
572,BUMA.1121.00018,1,3628461,3638865,-,10404
573,BUMA.1121.00025,1,3790127,3796351,+,6224
573,BUMA.1121.00021,1,3628993,3635233,-,6240
573,BUMA.1121.00111,1,1683596,1689834,+,6238
573,BUMA.1121.00029,1,1939473,1945694,+,6221
573,BUMA.1121.00012,1,205558,211804,+,6246
573,BUMA.1121.00037,1,134605,140843,+,6238
573,BUMA.1121.00018,1,3613478,3619702,-,6224
574,BUMA.1121.00021,1,236669,242598,+,5929
574,BUMA.1121.00023,1,1958881,1964810,+,5929
574,BUMA.1121.00037,1,2255692,2261621,+,5929
574,BUMA.1121.00031,1,979033,984962,+,5929
574,BUMA.1121.00014,1,3265498,3271427,-,5929
575,BUMA.1121.00021,1,724781,729588,+,4807
575,BUMA.1121.00033,1,2367908,2372714,+,4806
575,BUMA.1121.00003,1,2619030,2623820,+,4790
575,BUMA.1121.00110,1,698777,703575,-,4798
575,BUMA.1121.00043,1,98243,103050,+,4807
575,BUMA.1121.00065,1,111174,115972,+,4798
575,BUMA.1121.00105,1,1099327,1104125,-,4798
575,BUMA.1121.00068,1,2946672,2951502,+,4830
575,BUMA.1121.00095,1,1556723,1561521,-,4798
575,BUMA.1121.00077,1,2779820,2784618,+,4798
575,BUMA.1121.00062,1,464280,469078,-,4798
575,BUMA.1121.00041,1,1341772,1346578,+,4806
575,BUMA.1121.00011,1,1520023,1524829,-,4806
576,BUMA.1121.00021,1,1603310,1609167,+,5857
576,BUMA.1121.00055,1,564031,569889,+,5858
577,BUMA.1121.00021,1,3714532,3718977,+,4445
577,BUMA.1121.00023,1,1388208,1392653,+,4445
577,BUMA.1121.00111,1,3241248,3245693,+,4445
578,BUMA.1121.00023,1,2936212,2946713,+,10501
578,BUMA.1121.00053,1,301533,312034,+,10501
578,BUMA.1121.00110,1,194003,204505,-,10502
578,BUMA.1121.00097,1,3429648,3440148,-,10500
578,BUMA.1121.00035,1,1659774,1670275,+,10501
578,BUMA.1121.00108,1,1569171,1579672,+,10501
578,BUMA.1121.00102,1,632133,642634,-,10501
578,BUMA.1121.00111,1,720592,731093,+,10501
578,BUMA.1121.00029,1,299118,309619,-,10501
578,BUMA.1121.00045,1,3508219,3518720,-,10501
578,BUMA.1121.00007,1,3530398,3540895,-,10497
578,BUMA.1121.00090,1,2686186,2696687,+,10501
578,BUMA.1121.00103,1,3827550,3838050,-,10500
578,BUMA.1121.00055,1,160843,171350,+,10507
578,BUMA.1121.00031,1,1967974,1978475,+,10501
578,BUMA.1121.00001,1,3508299,3518800,-,10501
578,BUMA.1121.00091,1,3942544,3953045,-,10501
578,BUMA.1121.00095,1,1081406,1091907,-,10501
578,BUMA.1121.00077,1,3278906,3289408,+,10502
578,BUMA.1121.00060,1,1733889,1744390,-,10501
578,BUMA.1121.00041,1,1855596,1866097,+,10501
578,BUMA.1121.00107,1,430677,441178,+,10501
578,BUMA.1121.00014,1,2241635,2252136,-,10501
579,BUMA.1121.00023,1,3136659,3144042,+,7383
579,BUMA.1121.00037,1,3417086,3423134,+,6048
579,BUMA.1121.00031,1,2168352,2175735,+,7383
579,BUMA.1121.00014,1,2044234,2051623,-,7389
580,BUMA.1121.00023,1,3914466,3917620,+,3154
580,BUMA.1121.00003,2,1906465,1909597,+,3132
581,BUMA.1121.00023,2,1488640,1495518,+,6878
581,BUMA.1121.00031,2,3058669,3065546,-,6877
581,BUMA.1121.00009,2,50589,57466,-,6877
581,BUMA.1121.00112,2,852647,859524,-,6877
581,BUMA.1121.00090,2,1591608,1598485,-,6877
581,BUMA.1121.00043,2,968397,975305,-,6908
581,BUMA.1121.00014,2,726294,733171,-,6877
581,BUMA.1121.00078,2,1904055,1910932,-,6877
581,BUMA.1121.00075,2,1687743,1694621,+,6878
581,BUMA.1121.00076,2,2281709,2288587,+,6878
581,BUMA.1121.00035,2,762634,769512,+,6878
582,BUMA.1121.00023,2,1518095,1521635,+,3540
582,BUMA.1121.00031,2,3032552,3036092,-,3540
582,BUMA.1121.00009,2,24465,28009,-,3544
582,BUMA.1121.00112,2,826523,830067,-,3544
582,BUMA.1121.00090,2,1565491,1569031,-,3540
582,BUMA.1121.00043,2,942322,945916,-,3594
582,BUMA.1121.00014,2,700177,703717,-,3540
582,BUMA.1121.00078,2,1877939,1881483,-,3544
582,BUMA.1121.00075,2,1717201,1720745,+,3544
582,BUMA.1121.00076,2,2311167,2314711,+,3544
582,BUMA.1121.00035,2,792089,795629,+,3540
583,BUMA.1121.00023,2,1620605,1623729,+,3124
583,BUMA.1121.00053,1,1660397,1663521,-,3124
583,BUMA.1121.00111,2,779713,782837,+,3124
583,BUMA.1121.00102,1,3384300,3387424,+,3124
583,BUMA.1121.00090,2,2623142,2626264,+,3122
583,BUMA.1121.00111,1,2138132,2141256,-,3124
583,BUMA.1121.00084,1,2300835,2303959,-,3124
583,BUMA.1121.00043,2,787818,790940,+,3122
583,BUMA.1121.00090,1,11393,14517,-,3124
583,BUMA.1121.00088,1,2843135,2846259,-,3124
583,BUMA.1121.00105,1,3286169,3289293,+,3124
583,BUMA.1121.00049,1,3939606,3942730,+,3124
583,BUMA.1121.00076,1,3377522,3380646,+,3124
583,BUMA.1121.00033,2,2272237,2275359,-,3122
583,BUMA.1121.00033,2,2395310,2398431,-,3121
583,BUMA.1121.00075,1,1432278,1435402,-,3124
583,BUMA.1121.00041,1,3251119,3254243,-,3124
583,BUMA.1121.00112,1,1067143,1070267,+,3124
583,BUMA.1121.00012,2,154589,157711,+,3122
583,BUMA.1121.00039,1,2080328,2083452,-,3124
583,BUMA.1121.00005,1,653551,656675,-,3124
584,BUMA.1121.00023,2,1626044,1629586,+,3542
584,BUMA.1121.00111,2,785152,788694,+,3542
584,BUMA.1121.00111,1,2132274,2135816,-,3542
584,BUMA.1121.00090,1,5535,9077,-,3542
584,BUMA.1121.00039,1,2074470,2078012,-,3542
585,BUMA.1121.00033,1,627495,631296,+,3801
585,BUMA.1121.00053,1,2153155,2156956,+,3801
585,BUMA.1121.00110,1,2363507,2367309,-,3802
585,BUMA.1121.00092,1,1367474,1371276,-,3802
585,BUMA.1121.00093,1,3255006,3258807,+,3801
585,BUMA.1121.00102,1,2887772,2891574,-,3802
585,BUMA.1121.00029,1,2517267,2521068,-,3801
585,BUMA.1121.00043,1,2513170,2516971,+,3801
585,BUMA.1121.00058,1,2123964,2127766,-,3802
585,BUMA.1121.00090,1,528835,532636,+,3801
585,BUMA.1121.00101,1,38418,42220,-,3802
585,BUMA.1121.00078,1,3605061,3608863,-,3802
585,BUMA.1121.00095,1,3261036,3264838,-,3802
585,BUMA.1121.00077,1,1115927,1119728,+,3801
585,BUMA.1121.00041,1,3737915,3741716,+,3801
585,BUMA.1121.00016,1,554173,557974,+,3801
585,BUMA.1121.00005,1,1157132,1160933,+,3801
586,BUMA.1121.00033,1,3776483,3779807,+,3324
586,BUMA.1121.00043,1,1592204,1595540,+,3336
586,BUMA.1121.00016,1,3679459,3682782,+,3323
587,BUMA.1121.00033,1,3780108,3786516,+,6408
587,BUMA.1121.00016,1,3683083,3689489,+,6406
588,BUMA.1121.00033,1,3793883,3797106,+,3223
588,BUMA.1121.00016,1,3695477,3698701,+,3224
589,BUMA.1121.00033,1,4090222,4103544,+,13322
589,BUMA.1121.00012,1,508439,521762,+,13323
589,BUMA.1121.00078,1,148756,162283,-,13527
590,BUMA.1121.00033,1,4103546,4121408,+,17862
590,BUMA.1121.00012,1,521764,539626,+,17862
590,BUMA.1121.00078,1,129268,147133,-,17865
591,BUMA.1121.00031,2,2858326,2862158,+,3832
591,BUMA.1121.00014,2,526109,529940,+,3831
591,BUMA.1121.00037,2,799448,803279,+,3831
592,BUMA.1121.00031,2,2866367,2872165,+,5798
592,BUMA.1121.00014,2,534143,539834,+,5691
592,BUMA.1121.00037,2,807482,813182,+,5700
593,BUMA.1121.00031,2,2882585,2887120,+,4535
593,BUMA.1121.00014,2,550256,554791,+,4535
593,BUMA.1121.00074,2,482204,486731,-,4527
594,BUMA.1121.00031,2,2888940,2895222,+,6282
594,BUMA.1121.00094,2,550710,556982,+,6272
594,BUMA.1121.00014,2,556611,562894,+,6283
594,BUMA.1121.00074,2,474065,480337,-,6272
594,BUMA.1121.00037,2,829110,835385,+,6275
595,BUMA.1121.00007,2,553117,562814,+,9697
595,BUMA.1121.00083,1,808831,818528,-,9697
595,BUMA.1121.00082,1,886292,895989,+,9697
596,BUMA.1121.00007,2,1471382,1474562,+,3180
596,BUMA.1121.00095,2,3195985,3199180,-,3195
596,BUMA.1121.00107,2,2413880,2417060,-,3180
596,BUMA.1121.00103,2,3350669,3353851,+,3182
596,BUMA.1121.00100,2,2534982,2538162,+,3180
597,BUMA.1121.00007,2,2451348,2455903,+,4555
597,BUMA.1121.00103,2,969834,974373,+,4539
598,BUMA.1121.00007,2,2465247,2487895,+,22648
598,BUMA.1121.00103,2,983731,1006379,+,22648
598,BUMA.1121.00100,1,3272237,3294860,-,22623
599,BUMA.1121.00009,1,791488,806642,+,15154
599,BUMA.1121.00003,1,3264943,3280120,-,15177
599,BUMA.1121.00097,1,3227921,3243075,+,15154
599,BUMA.1121.00108,1,1766032,1781172,-,15140
599,BUMA.1121.00045,1,3305147,3320302,+,15155
599,BUMA.1121.00099,1,1630735,1645891,+,15156
599,BUMA.1121.00098,1,3496412,3511573,-,15161
599,BUMA.1121.00076,1,578476,593629,+,15153
599,BUMA.1121.00060,1,1530760,1545915,+,15155
599,BUMA.1121.00075,1,286155,301307,-,15152
599,BUMA.1121.00112,1,2282965,2298118,+,15153
599,BUMA.1121.00011,1,840731,855887,+,15156
600,BUMA.1121.00009,1,3369217,3375417,+,6200
600,BUMA.1121.00003,1,681601,687801,-,6200
600,BUMA.1121.00097,1,1733816,1740008,+,6192
600,BUMA.1121.00099,1,160478,166685,+,6207
600,BUMA.1121.00098,1,798879,805079,-,6200
600,BUMA.1121.00011,1,3461539,3467739,+,6200
601,BUMA.1121.00009,1,3547698,3553090,+,5392
601,BUMA.1121.00092,1,1794968,1800360,+,5392
601,BUMA.1121.00093,1,2825923,2831316,-,5393
601,BUMA.1121.00108,1,3026634,3032026,-,5392
601,BUMA.1121.00084,1,2391704,2397097,-,5393
601,BUMA.1121.00045,1,2031335,2036727,+,5392
601,BUMA.1121.00058,1,2534913,2540305,+,5392
601,BUMA.1121.00090,1,102697,108090,-,5393
601,BUMA.1121.00055,1,1616842,1622235,-,5393
601,BUMA.1121.00088,1,2934070,2939463,-,5393
601,BUMA.1121.00069,1,1806453,1811853,+,5400
601,BUMA.1121.00101,1,462257,467649,+,5392
601,BUMA.1121.00091,1,2521289,2526681,+,5392
601,BUMA.1121.00083,1,3643048,3648440,+,5392
601,BUMA.1121.00060,1,258644,264036,+,5392
601,BUMA.1121.00112,1,959351,964743,+,5392
601,BUMA.1121.00082,1,1987474,1992866,+,5392
601,BUMA.1121.00011,1,3639977,3645381,+,5404
601,BUMA.1121.00057,1,3100790,3106183,-,5393
601,BUMA.1121.00005,1,744939,750340,-,5401
602,BUMA.1121.00059,2,3132856,3136990,+,4134
602,BUMA.1121.00091,2,3168100,3172233,+,4133
602,BUMA.1121.00053,2,748359,752493,-,4134
602,BUMA.1121.00078,2,2704478,2708611,+,4133
602,BUMA.1121.00099,2,718688,722821,-,4133
602,BUMA.1121.00033,2,1194528,1198663,-,4135
602,BUMA.1121.00062,2,1255690,1259825,+,4135
603,BUMA.1121.00003,1,63359,66404,+,3045
603,BUMA.1121.00099,1,881664,884711,-,3047
604,BUMA.1121.00003,1,1567751,1572057,+,4306
604,BUMA.1121.00043,1,3178445,3182743,+,4298
604,BUMA.1121.00001,1,998545,1002842,-,4297
605,BUMA.1121.00003,1,1995448,2000508,+,5060
605,BUMA.1121.00110,1,1337672,1342791,-,5119
605,BUMA.1121.00077,1,2140527,2145647,+,5120
606,BUMA.1121.00005,2,368726,372880,+,4154
606,BUMA.1121.00091,2,88680,92836,+,4156
607,BUMA.1121.00005,2,374326,384102,+,9776
607,BUMA.1121.00091,2,98464,108240,+,9776
608,BUMA.1121.00005,2,386216,389399,+,3183
608,BUMA.1121.00091,2,110354,113537,+,3183
609,BUMA.1121.00005,2,390030,394224,+,4194
609,BUMA.1121.00095,2,872192,876387,-,4195
609,BUMA.1121.00091,2,114168,118362,+,4194
609,BUMA.1121.00103,2,625459,629634,-,4175
610,BUMA.1121.00005,2,3035460,3052157,+,16697
610,BUMA.1121.00041,2,2543984,2560681,+,16697
611,BUMA.1121.00109,1,774582,782255,+,7673
611,BUMA.1121.00100,1,198619,206292,+,7673
612,BUMA.1121.00109,1,787882,796233,+,8351
612,BUMA.1121.00096,1,2171862,2180214,+,8352
612,BUMA.1121.00100,1,218015,226375,-,8360
613,BUMA.1121.00109,1,1996878,2008114,+,11236
613,BUMA.1121.00112,1,3189908,3201129,+,11221
613,BUMA.1121.00057,1,983019,994250,-,11231
614,BUMA.1121.00109,1,2011154,2014699,+,3545
614,BUMA.1121.00106,1,3648864,3652412,-,3548
614,BUMA.1121.00084,1,3997019,4000562,-,3543
614,BUMA.1121.00088,1,731600,735148,-,3548
614,BUMA.1121.00064,1,3886357,3889905,-,3548
614,BUMA.1121.00112,1,3204188,3207761,+,3573
614,BUMA.1121.00057,1,976436,979979,-,3543
615,BUMA.1121.00109,1,2022208,2025775,+,3567
615,BUMA.1121.00110,1,474527,478100,-,3573
615,BUMA.1121.00064,1,3875272,3878845,-,3573
615,BUMA.1121.00059,1,3562078,3565651,+,3573
615,BUMA.1121.00091,1,198506,202079,-,3573
615,BUMA.1121.00077,1,3005317,3008890,+,3573
615,BUMA.1121.00107,1,159981,163554,+,3573
615,BUMA.1121.00057,1,965445,969018,-,3573
615,BUMA.1121.00100,1,989148,992721,-,3573
616,BUMA.1121.00109,1,2031818,2037234,+,5416
616,BUMA.1121.00057,1,955426,960843,-,5417
617,BUMA.1121.00109,1,2275766,2282519,+,6753
617,BUMA.1121.00104,1,1619700,1626453,+,6753
617,BUMA.1121.00106,1,3390735,3397488,-,6753
617,BUMA.1121.00080,1,3640333,3647086,-,6753
617,BUMA.1121.00067,1,793770,800523,+,6753
617,BUMA.1121.00064,1,3626333,3633086,-,6753
617,BUMA.1121.00049,1,2191310,2198063,+,6753
617,BUMA.1121.00074,2,646031,652784,-,6753
617,BUMA.1121.00011,1,1981396,1988149,+,6753
618,BUMA.1121.00109,1,2282521,2286625,+,4104
618,BUMA.1121.00104,1,1626455,1630559,+,4104
618,BUMA.1121.00106,1,3386630,3390734,-,4104
618,BUMA.1121.00080,1,3636228,3640332,-,4104
618,BUMA.1121.00067,1,800525,804629,+,4104
618,BUMA.1121.00031,1,1928375,1932476,-,4101
618,BUMA.1121.00064,1,3622228,3626332,-,4104
618,BUMA.1121.00049,1,2198065,2202169,+,4104
618,BUMA.1121.00074,2,641926,646030,-,4104
618,BUMA.1121.00014,1,2286364,2290465,+,4101
618,BUMA.1121.00011,1,1988151,1992253,+,4102
619,BUMA.1121.00053,1,2314315,2322561,+,8246
619,BUMA.1121.00102,1,2731528,2739774,-,8246
620,BUMA.1121.00053,1,2344063,2350972,+,6909
620,BUMA.1121.00102,1,2703117,2710027,-,6910
620,BUMA.1121.00111,1,1664536,1671449,-,6913
621,BUMA.1121.00053,1,2354331,2357630,+,3299
621,BUMA.1121.00102,1,2696459,2699758,-,3299
622,BUMA.1121.00053,1,3376739,3380927,+,4188
622,BUMA.1121.00102,1,1677057,1681261,-,4204
622,BUMA.1121.00111,1,3805101,3809289,+,4188
622,BUMA.1121.00065,1,3676438,3680625,+,4187
622,BUMA.1121.00007,1,418101,423529,-,5428
622,BUMA.1121.00090,1,1692127,1696315,+,4188
622,BUMA.1121.00055,1,3295985,3300173,+,4188
622,BUMA.1121.00076,1,1700412,1704601,-,4189
622,BUMA.1121.00078,1,2384573,2388762,-,4189
622,BUMA.1121.00075,1,3107675,3111863,+,4188
622,BUMA.1121.00100,1,1671845,1676041,-,4196
623,BUMA.1121.00053,1,3531389,3536559,+,5170
623,BUMA.1121.00041,1,1023857,1029027,+,5170
624,BUMA.1121.00053,1,3540437,3545307,+,4870
624,BUMA.1121.00041,1,1032905,1037775,+,4870
625,BUMA.1121.00053,1,3919163,3922237,+,3074
625,BUMA.1121.00055,1,3815561,3818635,+,3074
625,BUMA.1121.00068,1,3008223,3011297,+,3074
625,BUMA.1121.00041,1,1406419,1409493,+,3074
626,BUMA.1121.00110,1,454490,458823,+,4333
626,BUMA.1121.00097,1,3693474,3697806,+,4332
626,BUMA.1121.00059,1,3580467,3584800,-,4333
626,BUMA.1121.00101,1,2140412,2144744,+,4332
626,BUMA.1121.00091,1,181427,185760,+,4333
626,BUMA.1121.00077,1,3024592,3028923,-,4331
626,BUMA.1121.00107,1,173967,178299,-,4332
626,BUMA.1121.00039,1,442466,446797,-,4331
626,BUMA.1121.00100,1,972710,977043,+,4333
627,BUMA.1121.00110,1,467275,471261,+,3986
627,BUMA.1121.00059,1,3568917,3572903,-,3986
627,BUMA.1121.00077,1,3012156,3016140,-,3984
628,BUMA.1121.00110,1,722711,731468,+,8757
628,BUMA.1121.00059,1,3313872,3322629,-,8757
628,BUMA.1121.00077,1,2751924,2760681,-,8757
629,BUMA.1121.00110,1,933329,942391,+,9062
629,BUMA.1121.00077,1,2540923,2549985,-,9062
630,BUMA.1121.00110,1,1328766,1336295,+,7529
630,BUMA.1121.00077,1,2147021,2154550,-,7529
631,BUMA.1121.00110,1,2773784,2784697,+,10913
631,BUMA.1121.00080,1,2043571,2054501,-,10930
631,BUMA.1121.00079,1,2038843,2049773,-,10930
631,BUMA.1121.00055,1,1601768,1612698,-,10930
631,BUMA.1121.00064,1,2039532,2050462,-,10930
631,BUMA.1121.00077,1,698328,709242,-,10914
631,BUMA.1121.00112,1,969080,980027,+,10947
632,BUMA.1121.00104,1,506995,510008,+,3013
632,BUMA.1121.00096,1,2486269,2489282,+,3013
632,BUMA.1121.00106,1,554138,557152,-,3014
632,BUMA.1121.00058,1,3830285,3833298,+,3013
632,BUMA.1121.00103,1,3635319,3638332,+,3013
632,BUMA.1121.00055,1,358987,362001,-,3014
632,BUMA.1121.00105,1,418495,421508,+,3013
632,BUMA.1121.00068,1,3651455,3655710,-,4255
632,BUMA.1121.00078,1,1220351,1223364,+,3013
632,BUMA.1121.00095,1,890640,893653,+,3013
632,BUMA.1121.00062,1,3774872,3777885,+,3013
632,BUMA.1121.00005,1,2799722,2802735,+,3013
632,BUMA.1121.00100,1,530155,533168,+,3013
633,BUMA.1121.00104,1,2791193,2798345,+,7152
633,BUMA.1121.00106,1,2190146,2197286,-,7140
633,BUMA.1121.00094,1,2431650,2438802,-,7152
633,BUMA.1121.00089,1,2401335,2408487,-,7152
633,BUMA.1121.00084,1,2815136,2822288,-,7152
633,BUMA.1121.00080,1,2444602,2451754,-,7152
633,BUMA.1121.00079,1,2440393,2447544,-,7151
633,BUMA.1121.00045,1,1605615,1612767,+,7152
633,BUMA.1121.00056,1,1518134,1525286,+,7152
633,BUMA.1121.00007,1,1651662,1658814,+,7152
633,BUMA.1121.00067,1,1964328,1971480,+,7152
633,BUMA.1121.00051,1,2414364,2421516,-,7152
633,BUMA.1121.00047,1,500488,507640,+,7152
633,BUMA.1121.00088,1,3360811,3367963,-,7152
633,BUMA.1121.00064,1,2457621,2464773,-,7152
633,BUMA.1121.00059,1,1633623,1640774,-,7151
633,BUMA.1121.00091,1,2063597,2072035,+,8438
633,BUMA.1121.00049,1,3425137,3432289,+,7152
633,BUMA.1121.00076,1,2911814,2918966,+,7152
633,BUMA.1121.00074,1,1409595,1416747,+,7152
633,BUMA.1121.00060,1,3850874,3858026,+,7152
633,BUMA.1121.00075,1,1895087,1902239,-,7152
633,BUMA.1121.00107,1,2318195,2325347,-,7152
633,BUMA.1121.00112,1,535315,542467,+,7152
633,BUMA.1121.00011,1,3207812,3214964,+,7152
634,BUMA.1121.00111,2,725236,732854,+,7618
634,BUMA.1121.00037,2,634656,642275,+,7619
635,BUMA.1121.00092,1,3083763,3087745,+,3982
635,BUMA.1121.00093,1,1538689,1542671,-,3982
635,BUMA.1121.00080,1,821654,825634,-,3980
635,BUMA.1121.00051,1,783641,787637,-,3996
635,BUMA.1121.00047,1,2201923,2205903,+,3980
636,BUMA.1121.00092,1,3088986,3092302,+,3316
636,BUMA.1121.00093,1,1534148,1537448,-,3300
636,BUMA.1121.00080,1,818351,821653,-,3302
636,BUMA.1121.00051,1,780338,783640,-,3302
636,BUMA.1121.00047,1,2205905,2209222,+,3317
637,BUMA.1121.00092,1,3289608,3294581,+,4973
637,BUMA.1121.00093,1,1331845,1336817,-,4972
637,BUMA.1121.00080,1,615779,620751,-,4972
637,BUMA.1121.00067,1,3810687,3815660,+,4973
637,BUMA.1121.00098,1,3292899,3297886,-,4987
637,BUMA.1121.00074,1,3286973,3291946,+,4973
638,BUMA.1121.00092,1,3958039,3961363,+,3324
638,BUMA.1121.00093,1,665110,668435,-,3325
639,BUMA.1121.00096,1,3195877,3199226,+,3349
639,BUMA.1121.00099,1,2379665,2383014,+,3349
639,BUMA.1121.00098,1,2758473,2761822,-,3349
640,BUMA.1121.00096,1,3203289,3207803,+,4514
640,BUMA.1121.00068,1,2896196,2900713,-,4517
640,BUMA.1121.00099,1,2385828,2390344,+,4516
640,BUMA.1121.00098,1,2751143,2755660,-,4517
641,BUMA.1121.00096,1,3629054,3635189,+,6135
641,BUMA.1121.00067,1,529470,535603,+,6133
641,BUMA.1121.00068,1,2439019,2445154,-,6135
641,BUMA.1121.00095,1,2035549,2041685,+,6136
642,BUMA.1121.00096,1,3637307,3640986,+,3679
642,BUMA.1121.00068,1,2432525,2436207,-,3682
643,BUMA.1121.00096,1,3645030,3648947,+,3917
643,BUMA.1121.00068,1,2424563,2428480,-,3917
643,BUMA.1121.00095,1,2052419,2056342,+,3923
644,BUMA.1121.00096,1,3651748,3659648,+,7900
644,BUMA.1121.00068,1,2413862,2421762,-,7900
644,BUMA.1121.00095,1,2059111,2067011,+,7900
645,BUMA.1121.00097,1,2443873,2453148,+,9275
645,BUMA.1121.00068,1,243777,254296,-,10519
645,BUMA.1121.00078,1,450105,459381,+,9276
645,BUMA.1121.00062,1,3065792,3075068,+,9276
646,BUMA.1121.00097,1,3698073,3701533,+,3460
646,BUMA.1121.00101,1,2145011,2148471,+,3460
647,BUMA.1121.00097,1,3919086,3922869,+,3783
647,BUMA.1121.00108,1,1104332,1108116,-,3784
647,BUMA.1121.00011,1,1503618,1507401,+,3783
648,BUMA.1121.00097,1,3923502,3926549,+,3047
648,BUMA.1121.00108,1,1100653,1103700,-,3047
648,BUMA.1121.00011,1,1508034,1511081,+,3047
648,BUMA.1121.00005,1,3457513,3460528,+,3015
649,BUMA.1121.00097,1,3928283,3931349,+,3066
649,BUMA.1121.00108,1,1097092,1100159,-,3067
649,BUMA.1121.00011,1,1511575,1514641,+,3066
649,BUMA.1121.00005,1,3462309,3465393,+,3084
650,BUMA.1121.00097,1,3965593,3975154,+,9561
650,BUMA.1121.00101,1,2396344,2407145,+,10801
651,BUMA.1121.00009,2,2415580,2418937,+,3357
651,BUMA.1121.00101,2,2890842,2894195,-,3353
651,BUMA.1121.00099,2,706604,709916,+,3312
652,BUMA.1121.00106,1,3297227,3313027,+,15800
652,BUMA.1121.00079,1,3597289,3614329,+,17040
653,BUMA.1121.00106,1,3652613,3661117,+,8504
653,BUMA.1121.00088,1,735349,743856,+,8507
654,BUMA.1121.00094,2,520485,524005,+,3520
654,BUMA.1121.00074,2,507289,510718,-,3429
655,BUMA.1121.00094,2,528165,534864,+,6699
655,BUMA.1121.00074,2,497240,503101,-,5861
656,BUMA.1121.00094,2,544861,550046,+,5185
656,BUMA.1121.00037,2,823176,828501,+,5325
657,BUMA.1121.00094,2,562237,569939,+,7702
657,BUMA.1121.00051,2,519903,527605,+,7702
657,BUMA.1121.00079,2,520203,527905,+,7702
657,BUMA.1121.00047,2,1450381,1458076,+,7695
657,BUMA.1121.00080,2,519926,527628,+,7702
658,BUMA.1121.00101,2,1040157,1047928,+,7771
658,BUMA.1121.00107,2,1419926,1427701,+,7775
659,BUMA.1121.00095,2,880233,905288,+,25055
659,BUMA.1121.00103,2,634793,659848,+,25055
660,BUMA.1121.00095,2,3202631,3208204,+,5573
660,BUMA.1121.00103,2,3341635,3347208,-,5573
661,BUMA.1121.00035,1,1085316,1088613,+,3297
661,BUMA.1121.00029,1,884503,887800,-,3297
661,BUMA.1121.00001,1,8186,11483,-,3297
662,BUMA.1121.00035,1,1088614,1092310,+,3696
662,BUMA.1121.00029,1,880805,884501,-,3696
663,BUMA.1121.00035,1,1108830,1112311,+,3481
663,BUMA.1121.00012,1,2798651,2802132,+,3481
664,BUMA.1121.00035,1,2178620,2181654,+,3034
664,BUMA.1121.00029,1,3860823,3863855,-,3032
665,BUMA.1121.00035,1,2187699,2191207,+,3508
665,BUMA.1121.00029,1,3852624,3856133,-,3509
665,BUMA.1121.00001,1,3007349,3010857,-,3508
666,BUMA.1121.00035,1,2192415,2197876,+,5461
666,BUMA.1121.00029,1,3845956,3851416,-,5460
666,BUMA.1121.00001,1,3000682,3006141,-,5459
667,BUMA.1121.00035,1,2263391,2266393,+,3002
667,BUMA.1121.00012,1,3927326,3930333,+,3007
667,BUMA.1121.00090,1,3274447,3277458,+,3011
668,BUMA.1121.00035,1,2266395,2271574,+,5179
668,BUMA.1121.00012,1,3932951,3938128,+,5177
668,BUMA.1121.00090,1,3277460,3282639,+,5179
669,BUMA.1121.00108,1,1974795,1979424,+,4629
669,BUMA.1121.00007,1,3143191,3147821,-,4630
670,BUMA.1121.00094,1,1141241,1146492,+,5251
670,BUMA.1121.00065,1,1222581,1227834,+,5253
671,BUMA.1121.00094,1,3628680,3631992,+,3312
671,BUMA.1121.00089,1,3600494,3603806,+,3312
671,BUMA.1121.00079,1,3711838,3715150,+,3312
671,BUMA.1121.00056,1,323125,326438,-,3313
671,BUMA.1121.00067,1,537436,540749,+,3313
671,BUMA.1121.00047,1,3365658,3368971,-,3313
671,BUMA.1121.00107,1,3570402,3573719,+,3317
672,BUMA.1121.00094,1,3638092,3644038,+,5946
672,BUMA.1121.00089,1,3609906,3615852,+,5946
672,BUMA.1121.00079,1,3721250,3727196,+,5946
672,BUMA.1121.00056,1,311079,317025,-,5946
672,BUMA.1121.00047,1,3353612,3359558,-,5946
672,BUMA.1121.00107,1,3578458,3584413,+,5955
673,BUMA.1121.00094,1,3811737,3819860,+,8123
673,BUMA.1121.00062,1,773685,781808,-,8123
674,BUMA.1121.00102,1,1485533,1499094,+,13561
674,BUMA.1121.00089,1,3791517,3806433,-,14916
674,BUMA.1121.00080,1,3816246,3831162,-,14916
674,BUMA.1121.00056,1,123070,137985,+,14915
674,BUMA.1121.00090,1,1869055,1882394,-,13339
674,BUMA.1121.00051,1,3788527,3803443,-,14916
674,BUMA.1121.00047,1,3162902,3177817,+,14915
675,BUMA.1121.00102,1,1665154,1670557,+,5403
675,BUMA.1121.00098,1,2287913,2293342,-,5429
676,BUMA.1121.00090,2,2626265,2632981,+,6716
676,BUMA.1121.00043,2,790941,797655,+,6714
676,BUMA.1121.00033,2,2265521,2272235,-,6714
676,BUMA.1121.00012,2,157712,164426,+,6714
677,BUMA.1121.00111,1,1695612,1699038,+,3426
677,BUMA.1121.00037,1,149161,152591,+,3430
678,BUMA.1121.00111,1,3232010,3236652,+,4642
678,BUMA.1121.00095,1,2652909,2657547,-,4638
679,BUMA.1121.00089,1,84263,97306,+,13043
679,BUMA.1121.00056,1,3828125,3841168,-,13043
680,BUMA.1121.00084,1,793842,801798,+,7956
680,BUMA.1121.00058,1,4041898,4048613,-,6715
680,BUMA.1121.00068,1,3435242,3441958,+,6716
680,BUMA.1121.00062,1,8326,15041,-,6715
681,BUMA.1121.00084,1,1338663,1343007,+,4344
681,BUMA.1121.00045,1,2939959,2944304,-,4345
681,BUMA.1121.00088,1,1993218,1997562,+,4344
681,BUMA.1121.00060,1,1165566,1169911,-,4345
681,BUMA.1121.00107,1,1016746,1021091,+,4345
681,BUMA.1121.00112,1,1941546,1945891,-,4345
682,BUMA.1121.00084,1,1717566,1726736,+,9170
682,BUMA.1121.00055,1,2034887,2044061,-,9174
682,BUMA.1121.00112,1,1642885,1652059,-,9174
682,BUMA.1121.00057,1,3514161,3523335,-,9174
683,BUMA.1121.00084,1,1742905,1748244,+,5339
683,BUMA.1121.00055,1,2013107,2018478,-,5371
683,BUMA.1121.00112,1,1621466,1626497,-,5031
683,BUMA.1121.00057,1,3492720,3497834,-,5114
684,BUMA.1121.00084,1,1758092,1761666,+,3574
684,BUMA.1121.00055,1,1999866,2003440,-,3574
684,BUMA.1121.00112,1,1607257,1610834,-,3577
684,BUMA.1121.00057,1,3479479,3483053,-,3574
685,BUMA.1121.00084,1,1841110,1844159,+,3049
685,BUMA.1121.00098,1,831529,834579,-,3050
686,BUMA.1121.00029,1,1866305,1870648,+,4343
686,BUMA.1121.00043,1,3186059,3190402,-,4343
687,BUMA.1121.00001,2,1734952,1738579,+,3627
687,BUMA.1121.00035,2,932285,935908,+,3623
688,BUMA.1121.00012,1,35765,64073,+,28308
688,BUMA.1121.00016,2,2863602,2891388,-,27786
688,BUMA.1121.00035,2,456734,483738,-,27004
689,BUMA.1121.00012,1,3555842,3562127,+,6285
689,BUMA.1121.00045,1,3298841,3305145,-,6304
689,BUMA.1121.00060,1,1524454,1530758,-,6304
690,BUMA.1121.00043,2,904739,910012,+,5273
690,BUMA.1121.00043,1,2796974,2802229,-,5255
690,BUMA.1121.00012,2,271533,276806,+,5273
691,BUMA.1121.00043,2,1896656,1904660,+,8004
691,BUMA.1121.00016,2,62465,70469,+,8004
692,BUMA.1121.00043,2,1911044,1916246,+,5202
692,BUMA.1121.00090,1,3648422,3653621,+,5199
692,BUMA.1121.00016,2,73760,78962,+,5202
693,BUMA.1121.00043,2,1916247,1921972,+,5725
693,BUMA.1121.00016,2,78963,84688,+,5725
694,BUMA.1121.00043,2,1988845,1995099,+,6254
694,BUMA.1121.00033,2,1124117,1130362,-,6245
694,BUMA.1121.00037,2,719380,725598,-,6218
695,BUMA.1121.00043,1,38196,44298,+,6102
695,BUMA.1121.00068,1,2903526,2910871,+,7345
696,BUMA.1121.00043,1,963340,966858,+,3518
696,BUMA.1121.00016,1,3101393,3104910,+,3517
697,BUMA.1121.00043,1,1094243,1116108,+,21865
697,BUMA.1121.00016,1,3244985,3266847,+,21862
698,BUMA.1121.00043,1,1129408,1134614,+,5206
698,BUMA.1121.00016,1,3280829,3286035,+,5206
699,BUMA.1121.00043,1,3983439,3989807,+,6368
699,BUMA.1121.00016,1,1971999,1978351,+,6352
700,BUMA.1121.00043,1,3995184,4006248,+,11064
700,BUMA.1121.00078,1,1889293,1900924,+,11631
701,BUMA.1121.00043,1,4015549,4019288,+,3739
701,BUMA.1121.00078,1,1908767,1912503,+,3736
702,BUMA.1121.00080,1,3011515,3023550,+,12035
702,BUMA.1121.00079,1,3045841,3057876,+,12035
702,BUMA.1121.00047,1,4004072,4016103,-,12031
703,BUMA.1121.00080,1,3024760,3028181,+,3421
703,BUMA.1121.00079,1,3059086,3062507,+,3421
703,BUMA.1121.00047,1,4000649,4004071,-,3422
704,BUMA.1121.00045,1,3081626,3085649,+,4023
704,BUMA.1121.00031,1,996430,1000452,-,4022
704,BUMA.1121.00060,1,1307215,1311238,+,4023
704,BUMA.1121.00014,1,3250008,3254031,+,4023
705,BUMA.1121.00045,1,3279933,3288102,+,8169
705,BUMA.1121.00060,1,1505546,1513715,+,8169
706,BUMA.1121.00045,1,3294567,3298815,+,4248
706,BUMA.1121.00060,1,1520180,1524428,+,4248
707,BUMA.1121.00045,1,3999155,4003172,+,4017
707,BUMA.1121.00060,1,2224791,2228808,+,4017
708,BUMA.1121.00093,2,2403727,2408891,+,5164
708,BUMA.1121.00092,2,536006,541171,-,5165
