block,genome,chr/contig,start,end,orientation,length
668,BUMA.1121.00029,1,3861358,3864456,+,3098
668,BUMA.1121.00035,1,2178019,2181119,-,3100
667,BUMA.1121.00029,1,3856094,3859447,+,3353
667,BUMA.1121.00035,1,2184380,2187737,-,3357
666,BUMA.1121.00029,1,880805,884466,+,3661
666,BUMA.1121.00035,1,1088649,1092310,-,3661
665,BUMA.1121.00094,1,1141331,1146443,+,5112
665,BUMA.1121.00065,1,1222671,1227785,+,5114
664,BUMA.1121.00097,1,3965625,3975141,+,9516
664,BUMA.1121.00101,1,2396376,2407132,+,10756
663,BUMA.1121.00097,1,3698018,3701307,+,3289
663,BUMA.1121.00101,1,2144956,2148245,+,3289
662,BUMA.1121.00109,1,774567,782285,+,7718
662,BUMA.1121.00100,1,198604,206322,+,7718
661,BUMA.1121.00111,1,3231972,3236652,+,4680
661,BUMA.1121.00095,1,2652909,2657586,-,4677
660,BUMA.1121.00108,2,2603999,2612452,+,8453
660,BUMA.1121.00012,2,2572637,2581090,-,8453
659,BUMA.1121.00099,1,844710,880986,+,36276
659,BUMA.1121.00098,1,2293538,2329807,+,36269
659,BUMA.1121.00005,1,181303,218161,-,36858
658,BUMA.1121.00107,1,628484,635355,+,6871
658,BUMA.1121.00101,1,1695112,1701982,-,6870
657,BUMA.1121.00001,1,3119376,3122591,+,3215
657,BUMA.1121.00029,1,3972875,3976090,+,3215
656,BUMA.1121.00001,1,3007349,3010818,+,3469
656,BUMA.1121.00029,1,3852624,3856093,+,3469
656,BUMA.1121.00035,1,2187739,2191207,-,3468
655,BUMA.1121.00001,1,3000665,3006137,+,5472
655,BUMA.1121.00029,1,3845939,3851412,+,5473
655,BUMA.1121.00035,1,2192419,2197893,-,5474
654,BUMA.1121.00001,1,1057232,1060781,+,3549
654,BUMA.1121.00029,1,1924611,1928160,+,3549
653,BUMA.1121.00001,1,8151,11483,+,3332
653,BUMA.1121.00029,1,884468,887800,+,3332
653,BUMA.1121.00035,1,1085316,1088648,-,3332
652,BUMA.1121.00012,1,2798651,2805351,+,6700
652,BUMA.1121.00035,1,1108830,1115530,+,6700
651,BUMA.1121.00102,1,1665033,1670563,+,5530
651,BUMA.1121.00098,1,2287913,2293463,-,5550
650,BUMA.1121.00090,1,3277460,3282769,+,5309
650,BUMA.1121.00012,1,3932951,3938258,+,5307
650,BUMA.1121.00035,1,2266395,2271704,+,5309
649,BUMA.1121.00090,1,3274334,3277458,+,3124
649,BUMA.1121.00012,1,3927213,3930332,+,3119
649,BUMA.1121.00035,1,2263278,2266393,+,3115
648,BUMA.1121.00014,1,2480976,2485410,+,4434
648,BUMA.1121.00023,1,2742375,2746808,-,4433
647,BUMA.1121.00014,1,2298792,2308538,+,9746
647,BUMA.1121.00031,1,1908967,1920198,-,11231
646,BUMA.1121.00014,1,2291142,2297569,+,6427
646,BUMA.1121.00031,1,1921421,1927697,-,6276
645,BUMA.1121.00014,1,2278976,2285756,+,6780
645,BUMA.1121.00031,1,1933083,1939864,-,6781
644,BUMA.1121.00014,1,2268808,2277630,+,8822
644,BUMA.1121.00031,1,1942480,1951302,-,8822
643,BUMA.1121.00084,1,2295340,2298415,+,3075
643,BUMA.1121.00075,1,1426783,1429858,+,3075
643,BUMA.1121.00076,1,3383066,3386141,-,3075
643,BUMA.1121.00105,1,3291713,3294788,-,3075
642,BUMA.1121.00039,1,2555417,2560063,+,4646
642,BUMA.1121.00107,1,856475,859810,-,3335
642,BUMA.1121.00035,1,3573941,3577233,+,3292
641,BUMA.1121.00079,1,3597289,3614748,+,17459
641,BUMA.1121.00106,1,3297227,3313446,+,16219
640,BUMA.1121.00096,1,3195877,3199226,+,3349
640,BUMA.1121.00099,1,2379665,2383014,+,3349
640,BUMA.1121.00098,1,2758473,2761822,-,3349
639,BUMA.1121.00096,1,2171855,2176753,+,4898
639,BUMA.1121.00109,1,787875,792773,+,4898
639,BUMA.1121.00100,1,221476,226375,-,4899
638,BUMA.1121.00021,1,3714696,3718924,+,4228
638,BUMA.1121.00111,1,3241412,3245640,+,4228
638,BUMA.1121.00023,1,1388372,1392600,+,4228
637,BUMA.1121.00007,1,3143375,3147821,+,4446
637,BUMA.1121.00108,1,1974795,1979241,-,4446
636,BUMA.1121.00007,1,573661,577820,+,4159
636,BUMA.1121.00103,1,881629,885785,+,4156
635,BUMA.1121.00007,1,564232,568331,+,4099
635,BUMA.1121.00031,1,818051,822149,-,4098
634,BUMA.1121.00062,1,773669,780938,+,7269
634,BUMA.1121.00094,1,3812607,3819876,-,7269
633,BUMA.1121.00082,1,3102489,3107156,+,4667
633,BUMA.1121.00083,1,2672203,2676871,-,4668
632,BUMA.1121.00082,1,858906,872582,+,13676
632,BUMA.1121.00083,1,832238,845913,-,13675
631,BUMA.1121.00082,1,602368,638853,+,36485
631,BUMA.1121.00083,1,1065974,1102460,-,36486
630,BUMA.1121.00049,2,2329106,2334065,+,4959
630,BUMA.1121.00068,2,2229647,2234607,+,4960
629,BUMA.1121.00104,2,141073,153541,+,12468
629,BUMA.1121.00049,2,1846042,1858510,+,12468
628,BUMA.1121.00104,2,134284,137669,+,3385
628,BUMA.1121.00049,2,1836908,1840292,+,3384
627,BUMA.1121.00110,1,1327295,1336295,+,9000
627,BUMA.1121.00077,1,2147021,2156021,-,9000
626,BUMA.1121.00110,1,933329,942400,+,9071
626,BUMA.1121.00077,1,2540914,2549985,-,9071
625,BUMA.1121.00007,2,553189,562814,+,9625
625,BUMA.1121.00082,1,886364,895989,+,9625
625,BUMA.1121.00083,1,808831,818456,-,9625
624,BUMA.1121.00111,2,725236,732854,+,7618
624,BUMA.1121.00037,2,634656,642302,+,7646
623,BUMA.1121.00091,1,1401467,1409651,+,8184
623,BUMA.1121.00095,1,2599889,2608073,+,8184
623,BUMA.1121.00005,1,1819319,1827503,-,8184
623,BUMA.1121.00041,1,338484,346668,-,8184
622,BUMA.1121.00091,1,1395920,1401465,+,5545
622,BUMA.1121.00095,1,2592892,2598437,+,5545
622,BUMA.1121.00005,1,1827504,1833049,-,5545
622,BUMA.1121.00041,1,346669,352214,-,5545
621,BUMA.1121.00091,1,1387167,1391620,+,4453
621,BUMA.1121.00095,1,2584150,2588593,+,4443
621,BUMA.1121.00005,1,1837348,1841801,-,4453
621,BUMA.1121.00041,1,356513,360966,-,4453
620,BUMA.1121.00091,1,874026,878191,+,4165
620,BUMA.1121.00103,1,728960,733124,+,4164
619,BUMA.1121.00091,1,863885,874025,+,10140
619,BUMA.1121.00103,1,718819,728959,+,10140
619,BUMA.1121.00107,1,3589359,3599507,-,10148
618,BUMA.1121.00112,1,2514168,2520121,+,5953
618,BUMA.1121.00105,1,643974,649939,+,5965
617,BUMA.1121.00112,1,348516,353039,+,4523
617,BUMA.1121.00014,1,166909,171400,+,4491
616,BUMA.1121.00112,1,336975,345004,+,8029
616,BUMA.1121.00014,1,153571,161606,+,8035
615,BUMA.1121.00112,1,331135,334598,+,3463
615,BUMA.1121.00014,1,144809,148278,+,3469
614,BUMA.1121.00112,1,312931,326107,+,13176
614,BUMA.1121.00014,1,125956,139105,+,13149
613,BUMA.1121.00112,1,298154,306626,+,8472
613,BUMA.1121.00014,1,111452,119925,+,8473
612,BUMA.1121.00056,1,3828169,3841213,+,13044
612,BUMA.1121.00089,1,84218,97262,-,13044
611,BUMA.1121.00056,1,323125,326161,+,3036
611,BUMA.1121.00047,1,3365658,3368694,+,3036
611,BUMA.1121.00067,1,537713,540749,-,3036
611,BUMA.1121.00079,1,3712115,3715150,-,3035
611,BUMA.1121.00089,1,3600771,3603806,-,3035
611,BUMA.1121.00107,1,3570679,3573719,-,3040
611,BUMA.1121.00094,1,3628957,3631992,-,3035
610,BUMA.1121.00056,1,313329,317026,+,3697
610,BUMA.1121.00047,1,3355862,3359559,+,3697
610,BUMA.1121.00079,1,3721249,3724947,-,3698
610,BUMA.1121.00089,1,3609905,3613603,-,3698
610,BUMA.1121.00107,1,3578457,3582163,-,3706
610,BUMA.1121.00094,1,3638091,3641789,-,3698
609,BUMA.1121.00103,2,3343121,3347192,+,4071
609,BUMA.1121.00095,2,3202646,3206717,-,4071
608,BUMA.1121.00103,2,983731,1006379,+,22648
608,BUMA.1121.00007,2,2465247,2487895,+,22648
608,BUMA.1121.00100,1,3272237,3294860,-,22623
607,BUMA.1121.00103,2,969834,974373,+,4539
607,BUMA.1121.00007,2,2451348,2455895,+,4547
606,BUMA.1121.00103,2,634793,659864,+,25071
606,BUMA.1121.00095,2,880233,905304,+,25071
605,BUMA.1121.00031,2,2895223,2899090,+,3867
605,BUMA.1121.00014,2,562895,566762,+,3867
605,BUMA.1121.00037,2,835386,839263,+,3877
604,BUMA.1121.00031,2,2882248,2887032,+,4784
604,BUMA.1121.00014,2,549919,554703,+,4784
604,BUMA.1121.00074,2,482291,487098,-,4807
603,BUMA.1121.00031,2,2866524,2872149,+,5625
603,BUMA.1121.00014,2,534300,539818,+,5518
603,BUMA.1121.00037,2,807639,813166,+,5527
602,BUMA.1121.00043,1,3995511,4004127,+,8616
602,BUMA.1121.00078,1,1889620,1898501,+,8881
601,BUMA.1121.00043,1,3186059,3190402,+,4343
601,BUMA.1121.00029,1,1866305,1870648,-,4343
600,BUMA.1121.00043,1,2797805,2802008,+,4203
600,BUMA.1121.00043,2,904961,909177,-,4216
600,BUMA.1121.00012,2,271755,275971,-,4216
599,BUMA.1121.00059,1,3580269,3584860,+,4591
599,BUMA.1121.00091,1,181366,185958,-,4592
599,BUMA.1121.00110,1,454429,459021,-,4592
599,BUMA.1121.00077,1,3024394,3028984,+,4590
599,BUMA.1121.00039,1,442291,446858,+,4567
599,BUMA.1121.00107,1,173769,178360,+,4591
599,BUMA.1121.00097,1,3693413,3698017,-,4604
599,BUMA.1121.00101,1,2140351,2144955,-,4604
599,BUMA.1121.00100,1,972649,977241,-,4592
598,BUMA.1121.00059,1,3568917,3575325,+,6408
598,BUMA.1121.00110,1,464863,471261,-,6398
598,BUMA.1121.00077,1,3012156,3018551,+,6395
597,BUMA.1121.00059,1,3313987,3322894,+,8907
597,BUMA.1121.00110,1,722446,731354,-,8908
597,BUMA.1121.00077,1,2752039,2760946,+,8907
596,BUMA.1121.00053,1,3540437,3545525,+,5088
596,BUMA.1121.00041,1,1032905,1037993,+,5088
595,BUMA.1121.00053,1,3531389,3536246,+,4857
595,BUMA.1121.00041,1,1023857,1028714,+,4857
594,BUMA.1121.00053,1,2344074,2350972,+,6898
594,BUMA.1121.00102,1,2703117,2710015,-,6898
594,BUMA.1121.00111,1,1664536,1671449,-,6913
593,BUMA.1121.00053,1,2314402,2322483,+,8081
593,BUMA.1121.00102,1,2731606,2739687,-,8081
592,BUMA.1121.00053,1,848562,851647,+,3085
592,BUMA.1121.00091,1,3426988,3430073,-,3085
592,BUMA.1121.00110,1,3673274,3676359,-,3085
592,BUMA.1121.00077,1,3815940,3819026,+,3086
592,BUMA.1121.00103,1,3301614,3304697,-,3083
592,BUMA.1121.00102,1,103559,106643,-,3084
592,BUMA.1121.00095,1,558422,561507,-,3085
592,BUMA.1121.00005,1,2467953,2472324,-,4371
591,BUMA.1121.00090,2,2626265,2632962,+,6697
591,BUMA.1121.00033,2,2265546,2272235,-,6689
591,BUMA.1121.00043,2,790941,797630,+,6689
591,BUMA.1121.00012,2,157712,164401,+,6689
590,BUMA.1121.00027,1,3183181,3193244,+,10063
590,BUMA.1121.00065,1,1042926,1052991,+,10065
589,BUMA.1121.00027,1,1966511,1971132,+,4621
589,BUMA.1121.00082,1,3882621,3887222,+,4601
589,BUMA.1121.00083,1,1892149,1896749,-,4600
588,BUMA.1121.00080,1,3024760,3028181,+,3421
588,BUMA.1121.00047,1,4000649,4004066,-,3417
588,BUMA.1121.00079,1,3059086,3062507,+,3421
587,BUMA.1121.00080,1,3011499,3020799,+,9300
587,BUMA.1121.00047,1,4006820,4016119,-,9299
587,BUMA.1121.00079,1,3045825,3055125,+,9300
586,BUMA.1121.00018,1,3628461,3635417,+,6956
586,BUMA.1121.00025,1,3774409,3781367,-,6958
586,BUMA.1121.00021,1,3643993,3650951,+,6958
585,BUMA.1121.00018,1,2271943,2312879,+,40936
585,BUMA.1121.00025,1,946878,987816,-,40938
584,BUMA.1121.00018,1,1533481,1537211,+,3730
584,BUMA.1121.00053,1,709577,713317,+,3740
584,BUMA.1121.00110,1,3811605,3815350,-,3745
584,BUMA.1121.00077,1,3676922,3680664,+,3742
584,BUMA.1121.00025,1,1722656,1726387,-,3731
584,BUMA.1121.00102,1,243645,247376,-,3731
584,BUMA.1121.00098,1,3705137,3708868,+,3731
583,BUMA.1121.00018,1,1335767,1339834,+,4067
583,BUMA.1121.00025,1,1920038,1924105,-,4067
583,BUMA.1121.00099,1,1586371,1590437,-,4066
582,BUMA.1121.00018,1,1313462,1332638,+,19176
582,BUMA.1121.00025,1,1927233,1946410,-,19177
581,BUMA.1121.00018,1,1295700,1298995,+,3295
581,BUMA.1121.00025,1,1960876,1964171,-,3295
580,BUMA.1121.00018,1,1284830,1291605,+,6775
580,BUMA.1121.00025,1,1968266,1975041,-,6775
579,BUMA.1121.00018,1,1280407,1283976,+,3569
579,BUMA.1121.00025,1,1975896,1979464,-,3568
578,BUMA.1121.00018,1,1273499,1279748,+,6249
578,BUMA.1121.00025,1,1980123,1986372,-,6249
577,BUMA.1121.00018,1,289354,294417,+,5063
577,BUMA.1121.00025,1,2965463,2970526,-,5063
576,BUMA.1121.00018,1,262834,281777,+,18943
576,BUMA.1121.00025,1,2978103,2997047,-,18944
575,BUMA.1121.00018,1,257791,261671,+,3880
575,BUMA.1121.00025,1,2998210,3002091,-,3881
574,BUMA.1121.00018,1,247890,251774,+,3884
574,BUMA.1121.00025,1,3008108,3011991,-,3883
573,BUMA.1121.00033,1,4103546,4121408,+,17862
573,BUMA.1121.00078,1,129268,147133,-,17865
573,BUMA.1121.00012,1,521764,539626,+,17862
572,BUMA.1121.00033,1,4090210,4103544,+,13334
572,BUMA.1121.00078,1,148756,162285,-,13529
572,BUMA.1121.00012,1,508427,521762,+,13335
571,BUMA.1121.00110,2,2205902,2210781,+,4879
571,BUMA.1121.00077,2,1405299,1410177,-,4878
570,BUMA.1121.00110,2,2188750,2198791,+,10041
570,BUMA.1121.00077,2,1417288,1427329,-,10041
569,BUMA.1121.00110,2,2180333,2185293,+,4960
569,BUMA.1121.00077,2,1430788,1435748,-,4960
568,BUMA.1121.00110,2,401584,406587,+,5003
568,BUMA.1121.00057,2,1559217,1563752,-,4535
568,BUMA.1121.00027,2,1584645,1589178,+,4533
568,BUMA.1121.00077,2,3210009,3215011,-,5002
568,BUMA.1121.00041,2,1424756,1429317,+,4561
568,BUMA.1121.00082,2,532972,537508,+,4536
568,BUMA.1121.00083,2,2329929,2334465,+,4536
567,BUMA.1121.00110,2,396441,401120,+,4679
567,BUMA.1121.00057,2,1564216,1568895,-,4679
567,BUMA.1121.00027,2,1579505,1584181,+,4676
567,BUMA.1121.00077,2,3215475,3220154,-,4679
567,BUMA.1121.00082,2,527829,532508,+,4679
567,BUMA.1121.00083,2,2324786,2329465,+,4679
566,BUMA.1121.00109,2,3183480,3187271,+,3791
566,BUMA.1121.00062,2,191818,195605,+,3787
566,BUMA.1121.00084,2,197592,201380,-,3788
566,BUMA.1121.00088,2,1494067,1497855,-,3788
566,BUMA.1121.00105,2,932023,935810,+,3787
566,BUMA.1121.00059,2,2104099,2107886,+,3787
566,BUMA.1121.00058,2,2100670,2104458,-,3788
566,BUMA.1121.00106,2,261633,265420,+,3787
565,BUMA.1121.00109,2,3152841,3173721,+,20880
565,BUMA.1121.00062,2,161114,182059,+,20945
565,BUMA.1121.00084,2,212088,233027,-,20939
565,BUMA.1121.00088,2,1508563,1529502,-,20939
565,BUMA.1121.00105,2,901320,922264,+,20944
565,BUMA.1121.00059,2,2073400,2094340,+,20940
565,BUMA.1121.00058,2,2114216,2135144,-,20928
565,BUMA.1121.00106,2,205550,226492,-,20942
564,BUMA.1121.00109,2,3148374,3151914,+,3540
564,BUMA.1121.00062,2,156112,159653,+,3541
564,BUMA.1121.00084,2,235203,238743,-,3540
564,BUMA.1121.00088,2,1531678,1535218,-,3540
564,BUMA.1121.00105,2,895598,899144,+,3546
564,BUMA.1121.00059,2,2069261,2072802,+,3541
564,BUMA.1121.00058,2,2136589,2140130,-,3541
564,BUMA.1121.00106,2,229879,233420,-,3541
563,BUMA.1121.00109,2,3129915,3148373,+,18458
563,BUMA.1121.00062,2,137653,156111,+,18458
563,BUMA.1121.00084,2,238745,257202,-,18457
563,BUMA.1121.00088,2,1535220,1553677,-,18457
563,BUMA.1121.00105,2,875932,894390,+,18458
563,BUMA.1121.00059,2,2050802,2069260,+,18458
563,BUMA.1121.00058,2,2140132,2158588,-,18456
563,BUMA.1121.00106,2,233422,251874,-,18452
562,BUMA.1121.00109,2,3123395,3129914,+,6519
562,BUMA.1121.00109,2,3173723,3180242,-,6519
562,BUMA.1121.00062,2,131134,137652,+,6518
562,BUMA.1121.00062,2,182061,188580,-,6519
562,BUMA.1121.00084,2,205568,212087,+,6519
562,BUMA.1121.00084,2,257204,263723,-,6519
562,BUMA.1121.00088,2,1502043,1508562,+,6519
562,BUMA.1121.00088,2,1553679,1560198,-,6519
562,BUMA.1121.00105,2,869412,875931,+,6519
562,BUMA.1121.00105,2,922266,928785,-,6519
562,BUMA.1121.00059,2,2044282,2050801,+,6519
562,BUMA.1121.00059,2,2094342,2100861,-,6519
562,BUMA.1121.00058,2,2107696,2114215,+,6519
562,BUMA.1121.00058,2,2158590,2165109,-,6519
562,BUMA.1121.00106,2,199030,205549,+,6519
562,BUMA.1121.00106,2,251876,258395,-,6519
561,BUMA.1121.00109,2,2396823,2421085,+,24262
561,BUMA.1121.00047,1,567597,590643,+,23046
561,BUMA.1121.00003,2,459936,482981,-,23045
561,BUMA.1121.00065,2,2286570,2309616,-,23046
561,BUMA.1121.00095,2,1076766,1099784,-,23018
560,BUMA.1121.00109,2,2387287,2391339,+,4052
560,BUMA.1121.00003,2,488186,492287,-,4101
560,BUMA.1121.00065,2,2314132,2318185,-,4053
560,BUMA.1121.00095,2,1105571,1109381,-,3810
559,BUMA.1121.00109,2,1436420,1443820,+,7400
559,BUMA.1121.00104,2,126889,134283,-,7394
559,BUMA.1121.00049,2,1829513,1836907,-,7394
558,BUMA.1121.00093,2,2418376,2422341,+,3965
558,BUMA.1121.00092,2,522556,526521,-,3965
557,BUMA.1121.00093,2,2409772,2417253,+,7481
557,BUMA.1121.00092,2,527644,535125,-,7481
556,BUMA.1121.00093,2,2403725,2408799,+,5074
556,BUMA.1121.00092,2,536098,541173,-,5075
555,BUMA.1121.00094,2,562179,569939,+,7760
555,BUMA.1121.00079,2,520145,527905,+,7760
555,BUMA.1121.00047,2,1450323,1458076,+,7753
555,BUMA.1121.00051,2,519845,527605,+,7760
555,BUMA.1121.00080,2,519868,527628,+,7760
554,BUMA.1121.00094,2,556983,560565,+,3582
554,BUMA.1121.00074,2,470442,474063,-,3621
553,BUMA.1121.00094,2,550233,556982,+,6749
553,BUMA.1121.00031,2,2888532,2895222,+,6690
553,BUMA.1121.00014,2,556203,562894,+,6691
553,BUMA.1121.00074,2,474065,480754,-,6689
553,BUMA.1121.00037,2,828697,835385,+,6688
552,BUMA.1121.00094,2,544428,550046,+,5618
552,BUMA.1121.00037,2,822751,828510,+,5759
551,BUMA.1121.00094,2,537794,542227,+,4433
551,BUMA.1121.00031,2,2875632,2880024,+,4392
551,BUMA.1121.00014,2,543303,547695,+,4392
551,BUMA.1121.00074,2,489306,493741,-,4435
551,BUMA.1121.00037,2,816127,820519,+,4392
550,BUMA.1121.00094,2,528157,534811,+,6654
550,BUMA.1121.00074,2,497383,503126,-,5743
549,BUMA.1121.00074,1,3311792,3318124,+,6332
549,BUMA.1121.00067,1,3835506,3841838,+,6332
548,BUMA.1121.00074,1,3295765,3310669,+,14904
548,BUMA.1121.00067,1,3819479,3834383,+,14904
547,BUMA.1121.00099,2,724149,728180,+,4031
547,BUMA.1121.00091,2,3161405,3166770,-,5365
547,BUMA.1121.00053,2,753822,757853,+,4031
547,BUMA.1121.00078,2,2699118,2703148,-,4030
546,BUMA.1121.00099,2,718688,722866,+,4178
546,BUMA.1121.00062,2,1255651,1259825,-,4174
546,BUMA.1121.00091,2,3168054,3172233,-,4179
546,BUMA.1121.00053,2,748359,752539,+,4180
546,BUMA.1121.00078,2,2704432,2708611,-,4179
546,BUMA.1121.00033,2,1194528,1198708,+,4180
546,BUMA.1121.00059,2,3132811,3136990,-,4179
545,BUMA.1121.00099,2,688924,692243,+,3319
545,BUMA.1121.00007,1,2596669,2599986,-,3317
545,BUMA.1121.00101,2,2908556,2911875,-,3319
545,BUMA.1121.00098,1,55718,59037,+,3319
545,BUMA.1121.00097,1,2486805,2490122,-,3317
545,BUMA.1121.00012,2,1269594,1272913,-,3319
544,BUMA.1121.00016,2,78963,84632,+,5669
544,BUMA.1121.00043,2,1916247,1921916,+,5669
543,BUMA.1121.00016,2,73760,78962,+,5202
543,BUMA.1121.00043,2,1911044,1916246,+,5202
543,BUMA.1121.00090,1,3648422,3653621,+,5199
542,BUMA.1121.00016,2,62465,70469,+,8004
542,BUMA.1121.00043,2,1896656,1904660,+,8004
257,BUMA.1121.00058,1,1945185,1951123,+,5938
257,BUMA.1121.00112,1,356131,362059,+,5928
257,BUMA.1121.00014,1,175455,181386,+,5931
256,BUMA.1121.00058,1,1923394,1939149,+,15755
256,BUMA.1121.00014,1,94940,110696,+,15756
255,BUMA.1121.00058,1,1314799,1318944,+,4145
255,BUMA.1121.00059,1,2426280,2430426,-,4146
254,BUMA.1121.00058,1,1305935,1310529,+,4594
254,BUMA.1121.00059,1,2434696,2439290,-,4594
254,BUMA.1121.00005,1,1940601,1946603,+,6002
253,BUMA.1121.00058,1,1301043,1305933,+,4890
253,BUMA.1121.00059,1,2439291,2444182,-,4891
252,BUMA.1121.00057,1,3998406,4005432,+,7026
252,BUMA.1121.00058,1,1635290,1642306,-,7016
252,BUMA.1121.00045,1,1170324,1177358,-,7034
252,BUMA.1121.00051,1,2854918,2861953,+,7035
252,BUMA.1121.00068,1,1659950,1666932,+,6982
252,BUMA.1121.00061,1,2825552,2832563,+,7011
252,BUMA.1121.00060,1,3415542,3422576,-,7034
252,BUMA.1121.00064,1,2894363,2901371,+,7008
252,BUMA.1121.00016,1,999962,1006968,+,7006
252,BUMA.1121.00003,1,1376430,1383465,+,7035
252,BUMA.1121.00055,1,2568495,2575494,+,6999
252,BUMA.1121.00011,1,2772651,2779541,-,6890
252,BUMA.1121.00037,1,1490399,1497415,+,7016
252,BUMA.1121.00009,1,2687571,2694692,-,7121
252,BUMA.1121.00069,1,2794864,2801870,+,7006
252,BUMA.1121.00088,1,3798897,3805937,+,7040
252,BUMA.1121.00092,1,888496,895508,-,7012
252,BUMA.1121.00074,1,972894,979901,-,7007
252,BUMA.1121.00070,1,2796669,2803676,+,7007
252,BUMA.1121.00093,1,3730599,3737612,+,7013
252,BUMA.1121.00063,1,2822388,2829390,+,7002
252,BUMA.1121.00033,1,1076448,1083436,+,6988
252,BUMA.1121.00018,1,3479104,3486111,+,7007
252,BUMA.1121.00080,1,2886666,2893701,+,7035
252,BUMA.1121.00027,1,1075814,1082870,+,7056
252,BUMA.1121.00053,1,2649084,2656104,+,7020
252,BUMA.1121.00059,1,2115629,2122655,+,7026
252,BUMA.1121.00043,1,2971943,2978929,+,6986
252,BUMA.1121.00056,1,1077020,1084054,-,7034
252,BUMA.1121.00112,1,4177949,4184965,-,7016
252,BUMA.1121.00091,1,1627378,1634394,-,7016
252,BUMA.1121.00047,1,58972,66015,-,7043
252,BUMA.1121.00067,1,1527247,1534263,-,7016
252,BUMA.1121.00110,1,1927575,1934699,-,7124
252,BUMA.1121.00073,1,2823789,2830797,+,7008
252,BUMA.1121.00072,1,2796408,2803434,+,7026
252,BUMA.1121.00077,1,1548512,1555638,+,7126
252,BUMA.1121.00082,1,2983092,2990118,+,7026
252,BUMA.1121.00062,1,1671702,1678727,-,7025
252,BUMA.1121.00007,1,1168557,1175529,-,6972
252,BUMA.1121.00025,1,3923724,3930739,-,7015
252,BUMA.1121.00021,1,3486476,3493474,+,6998
252,BUMA.1121.00103,1,1477701,1484655,-,6954
252,BUMA.1121.00096,1,385736,392752,-,7016
252,BUMA.1121.00079,1,2921012,2928038,+,7026
252,BUMA.1121.00039,1,3026648,3033641,+,6993
252,BUMA.1121.00083,1,2789242,2796267,-,7025
252,BUMA.1121.00084,1,3253220,3260251,+,7031
252,BUMA.1121.00049,1,2940201,2947235,-,7034
252,BUMA.1121.00089,1,2842791,2849826,+,7035
252,BUMA.1121.00014,1,4027249,4034201,-,6952
252,BUMA.1121.00090,1,963244,970243,+,6999
252,BUMA.1121.00071,1,2814239,2821247,+,7008
252,BUMA.1121.00078,1,3117820,3124830,-,7010
252,BUMA.1121.00102,1,2398759,2405760,-,7001
252,BUMA.1121.00075,1,2378770,2385794,+,7024
252,BUMA.1121.00012,1,1640173,1647168,+,6995
252,BUMA.1121.00076,1,2426481,2433506,-,7025
252,BUMA.1121.00106,1,2627722,2634739,+,7017
252,BUMA.1121.00001,1,1192699,1199700,-,7001
252,BUMA.1121.00107,1,2828237,2835326,+,7089
252,BUMA.1121.00104,1,2356653,2363678,-,7025
252,BUMA.1121.00099,1,3520873,3527930,-,7057
252,BUMA.1121.00098,1,1547896,1554895,+,6999
252,BUMA.1121.00111,1,3058379,3065405,+,7026
252,BUMA.1121.00109,1,3018289,3025296,-,7007
252,BUMA.1121.00097,1,1035911,1042945,-,7034
252,BUMA.1121.00094,1,2871784,2878819,+,7035
252,BUMA.1121.00095,1,2825354,2832498,-,7144
252,BUMA.1121.00005,1,1591049,1598038,+,6989
252,BUMA.1121.00101,1,3556513,3563637,-,7124
252,BUMA.1121.00065,1,2943031,2950030,+,6999
252,BUMA.1121.00100,1,2437577,2444593,-,7016
252,BUMA.1121.00105,1,2308372,2315388,-,7016
252,BUMA.1121.00029,1,2077120,2084105,-,6985
252,BUMA.1121.00066,1,2799256,2806282,+,7026
252,BUMA.1121.00031,1,216571,223515,+,6944
252,BUMA.1121.00108,1,3925114,3932104,+,6990
252,BUMA.1121.00023,1,1206758,1213756,+,6998
252,BUMA.1121.00035,1,4040500,4047495,+,6995
252,BUMA.1121.00041,1,60070,67136,+,7066
251,BUMA.1121.00057,1,3987734,3997933,+,10199
251,BUMA.1121.00058,1,1642779,1652944,-,10165
251,BUMA.1121.00045,1,1177831,1188028,-,10197
251,BUMA.1121.00051,1,2844166,2854445,+,10279
251,BUMA.1121.00068,1,1649191,1659477,+,10286
251,BUMA.1121.00061,1,2814859,2825079,+,10220
251,BUMA.1121.00060,1,3423049,3433246,-,10197
251,BUMA.1121.00064,1,2883754,2893890,+,10136
251,BUMA.1121.00016,1,989354,999489,+,10135
251,BUMA.1121.00003,1,1365740,1375957,+,10217
251,BUMA.1121.00055,1,2556375,2566429,+,10054
251,BUMA.1121.00011,1,2780014,2790155,-,10141
251,BUMA.1121.00037,1,1479799,1489926,+,10127
251,BUMA.1121.00009,1,2695165,2705348,-,10183
251,BUMA.1121.00069,1,2784201,2794391,+,10190
251,BUMA.1121.00088,1,3788271,3798424,+,10153
251,BUMA.1121.00092,1,895981,906200,-,10219
251,BUMA.1121.00074,1,980374,990568,-,10194
251,BUMA.1121.00070,1,2785972,2796196,+,10224
251,BUMA.1121.00093,1,3719907,3730126,+,10219
251,BUMA.1121.00063,1,2811678,2821915,+,10237
251,BUMA.1121.00033,1,1065806,1075975,+,10169
251,BUMA.1121.00018,1,3468441,3478631,+,10190
251,BUMA.1121.00080,1,2876014,2886193,+,10179
251,BUMA.1121.00027,1,1017044,1027261,+,10217
251,BUMA.1121.00053,1,2636797,2647016,+,10219
251,BUMA.1121.00059,1,2104978,2115156,+,10178
251,BUMA.1121.00043,1,2961232,2971470,+,10238
251,BUMA.1121.00056,1,1084527,1094693,-,10166
251,BUMA.1121.00112,1,4185439,4195663,-,10224
251,BUMA.1121.00091,1,1634867,1645039,-,10172
251,BUMA.1121.00047,1,66488,76727,-,10239
251,BUMA.1121.00067,1,1534736,1544958,-,10222
251,BUMA.1121.00110,1,1935172,1945396,-,10224
251,BUMA.1121.00073,1,2813094,2823316,+,10222
251,BUMA.1121.00072,1,2785690,2795935,+,10245
251,BUMA.1121.00077,1,1537822,1548039,+,10217
251,BUMA.1121.00082,1,2972357,2982619,+,10262
251,BUMA.1121.00062,1,1679200,1689361,-,10161
251,BUMA.1121.00007,1,1177593,1187645,-,10052
251,BUMA.1121.00025,1,3931212,3941417,-,10205
251,BUMA.1121.00021,1,3475830,3486003,+,10173
251,BUMA.1121.00103,1,1485128,1495171,-,10043
251,BUMA.1121.00096,1,393225,403452,-,10227
251,BUMA.1121.00079,1,2910362,2920539,+,10177
251,BUMA.1121.00039,1,3015997,3026175,+,10178
251,BUMA.1121.00083,1,2796740,2807002,-,10262
251,BUMA.1121.00084,1,3242534,3252747,+,10213
251,BUMA.1121.00049,1,2947708,2957921,-,10213
251,BUMA.1121.00089,1,2832152,2842318,+,10166
251,BUMA.1121.00014,1,4034674,4044870,-,10196
251,BUMA.1121.00090,1,952535,962771,+,10236
251,BUMA.1121.00071,1,2803645,2813766,+,10121
251,BUMA.1121.00078,1,3125303,3135578,-,10275
251,BUMA.1121.00102,1,2406233,2416410,-,10177
251,BUMA.1121.00075,1,2368060,2378297,+,10237
251,BUMA.1121.00012,1,1629539,1639700,+,10161
251,BUMA.1121.00076,1,2433979,2444230,-,10251
251,BUMA.1121.00106,1,2616982,2627249,+,10267
251,BUMA.1121.00001,1,1200173,1210326,-,10153
251,BUMA.1121.00107,1,2817571,2827764,+,10193
251,BUMA.1121.00104,1,2364151,2374334,-,10183
251,BUMA.1121.00099,1,3529995,3540212,-,10217
251,BUMA.1121.00098,1,1537256,1547423,+,10167
251,BUMA.1121.00111,1,3047766,3057906,+,10140
251,BUMA.1121.00109,1,3025768,3035801,-,10033
251,BUMA.1121.00097,1,1043418,1053668,-,10250
251,BUMA.1121.00094,1,2861145,2871311,+,10166
251,BUMA.1121.00095,1,2832971,2843106,-,10135
251,BUMA.1121.00005,1,1580331,1590576,+,10245
251,BUMA.1121.00101,1,3564110,3574197,-,10087
251,BUMA.1121.00065,1,2932409,2942558,+,10149
251,BUMA.1121.00100,1,2487399,2497658,-,10259
251,BUMA.1121.00105,1,2315861,2326064,-,10203
251,BUMA.1121.00029,1,2084578,2094773,-,10195
251,BUMA.1121.00066,1,2788560,2798783,+,10223
251,BUMA.1121.00031,1,205972,216098,+,10126
251,BUMA.1121.00108,1,3914505,3924641,+,10136
251,BUMA.1121.00023,1,1196072,1206285,+,10213
251,BUMA.1121.00035,1,4029846,4040027,+,10181
251,BUMA.1121.00041,1,49345,59597,+,10252
250,BUMA.1121.00057,1,3955267,3985495,+,30228
250,BUMA.1121.00058,1,1655003,1685390,-,30387
250,BUMA.1121.00045,1,1190090,1220491,-,30401
250,BUMA.1121.00051,1,2811667,2841903,+,30236
250,BUMA.1121.00068,1,1616756,1646975,+,30219
250,BUMA.1121.00061,1,2782406,2812634,+,30228
250,BUMA.1121.00060,1,3435308,3465709,-,30401
250,BUMA.1121.00064,1,2851318,2881540,+,30222
250,BUMA.1121.00016,1,956919,987145,+,30226
250,BUMA.1121.00003,1,1331643,1361858,+,30215
250,BUMA.1121.00055,1,2523929,2554180,+,30251
250,BUMA.1121.00011,1,2792254,2822655,-,30401
250,BUMA.1121.00037,1,1447390,1477618,+,30228
250,BUMA.1121.00009,1,2707430,2737829,-,30399
250,BUMA.1121.00069,1,2751752,2781980,+,30228
250,BUMA.1121.00088,1,3755818,3786046,+,30228
250,BUMA.1121.00092,1,908273,938666,-,30393
250,BUMA.1121.00074,1,992671,1023058,-,30387
250,BUMA.1121.00070,1,2753519,2783747,+,30228
250,BUMA.1121.00093,1,3687443,3717670,+,30227
250,BUMA.1121.00063,1,2779225,2809453,+,30228
250,BUMA.1121.00033,1,1033391,1063618,+,30227
250,BUMA.1121.00018,1,3436016,3466260,+,30244
250,BUMA.1121.00080,1,2843496,2873723,+,30227
250,BUMA.1121.00027,1,984600,1014826,+,30226
250,BUMA.1121.00053,1,2604322,2634565,+,30243
250,BUMA.1121.00059,1,2072519,2102748,+,30229
250,BUMA.1121.00043,1,2928823,2959051,+,30228
250,BUMA.1121.00056,1,1096764,1127157,-,30393
250,BUMA.1121.00112,1,4197729,4228131,-,30402
250,BUMA.1121.00091,1,1647091,1677467,-,30376
250,BUMA.1121.00047,1,78791,109184,-,30393
250,BUMA.1121.00067,1,1547026,1577413,-,30387
250,BUMA.1121.00110,1,1947424,1977823,-,30399
250,BUMA.1121.00073,1,2780641,2810869,+,30228
250,BUMA.1121.00072,1,2753252,2783480,+,30228
250,BUMA.1121.00077,1,1505396,1535630,+,30234
250,BUMA.1121.00082,1,2939904,2970132,+,30228
250,BUMA.1121.00062,1,1691436,1721823,-,30387
250,BUMA.1121.00007,1,1189692,1220100,-,30408
250,BUMA.1121.00025,1,3943434,3973843,-,30409
250,BUMA.1121.00021,1,3443234,3473456,+,30222
250,BUMA.1121.00103,1,1497223,1527638,-,30415
250,BUMA.1121.00096,1,405475,435892,-,30417
250,BUMA.1121.00079,1,2877894,2908120,+,30226
250,BUMA.1121.00039,1,2983574,3013802,+,30228
250,BUMA.1121.00083,1,2809063,2839456,-,30393
250,BUMA.1121.00084,1,3210039,3240267,+,30228
250,BUMA.1121.00049,1,2959982,2990354,-,30372
250,BUMA.1121.00089,1,2799689,2829917,+,30228
250,BUMA.1121.00014,1,4046887,4077281,-,30394
250,BUMA.1121.00090,1,920133,950361,+,30228
250,BUMA.1121.00071,1,2771198,2801426,+,30228
250,BUMA.1121.00078,1,3137672,3168065,-,30393
250,BUMA.1121.00102,1,2418434,2448827,-,30393
250,BUMA.1121.00075,1,2335550,2365814,+,30264
250,BUMA.1121.00012,1,1597116,1627344,+,30228
250,BUMA.1121.00076,1,2446319,2476750,-,30431
250,BUMA.1121.00106,1,2584540,2614768,+,30228
250,BUMA.1121.00001,1,1212378,1242771,-,30393
250,BUMA.1121.00107,1,2785117,2815341,+,30224
250,BUMA.1121.00104,1,2376409,2406811,-,30402
250,BUMA.1121.00099,1,3542273,3572708,-,30435
250,BUMA.1121.00098,1,1504809,1535038,+,30229
250,BUMA.1121.00111,1,3013753,3043988,+,30235
250,BUMA.1121.00109,1,3039342,3069731,-,30389
250,BUMA.1121.00097,1,1055799,1086187,-,30388
250,BUMA.1121.00094,1,2828688,2858916,+,30228
250,BUMA.1121.00095,1,2845348,2875709,-,30361
250,BUMA.1121.00005,1,1547894,1578122,+,30228
250,BUMA.1121.00101,1,3576235,3606658,-,30423
250,BUMA.1121.00065,1,2899969,2930193,+,30224
250,BUMA.1121.00100,1,2499726,2530155,-,30429
250,BUMA.1121.00105,1,2328118,2358511,-,30393
250,BUMA.1121.00029,1,2096825,2127218,-,30393
250,BUMA.1121.00066,1,2756116,2786344,+,30228
250,BUMA.1121.00031,1,173564,203791,+,30227
250,BUMA.1121.00108,1,3882088,3912296,+,30208
250,BUMA.1121.00023,1,1163599,1193842,+,30243
250,BUMA.1121.00035,1,3997409,4027637,+,30228
250,BUMA.1121.00041,1,16840,47064,+,30224
249,BUMA.1121.00057,1,3938392,3954113,+,15721
249,BUMA.1121.00058,1,1686544,1702169,-,15625
249,BUMA.1121.00045,1,1221645,1237255,-,15610
249,BUMA.1121.00051,1,2794784,2810512,+,15728
249,BUMA.1121.00068,1,1599865,1615601,+,15736
249,BUMA.1121.00061,1,2765531,2781252,+,15721
249,BUMA.1121.00060,1,3466863,3482473,-,15610
249,BUMA.1121.00064,1,2834419,2850164,+,15745
249,BUMA.1121.00016,1,940005,955765,+,15760
249,BUMA.1121.00003,1,1314757,1330489,+,15732
249,BUMA.1121.00055,1,2507042,2522775,+,15733
249,BUMA.1121.00011,1,2823809,2839422,-,15613
249,BUMA.1121.00037,1,1430494,1446236,+,15742
249,BUMA.1121.00009,1,2738983,2754593,-,15610
249,BUMA.1121.00069,1,2734886,2750598,+,15712
249,BUMA.1121.00088,1,3738918,3754663,+,15745
249,BUMA.1121.00092,1,939820,955433,-,15613
249,BUMA.1121.00074,1,1024213,1039838,-,15625
249,BUMA.1121.00070,1,2736651,2752365,+,15714
249,BUMA.1121.00093,1,3670556,3686289,+,15733
249,BUMA.1121.00063,1,2762376,2778071,+,15695
249,BUMA.1121.00033,1,1016495,1032237,+,15742
249,BUMA.1121.00018,1,3419120,3434862,+,15742
249,BUMA.1121.00080,1,2826613,2842341,+,15728
249,BUMA.1121.00027,1,967713,983446,+,15733
249,BUMA.1121.00053,1,2587451,2603167,+,15716
249,BUMA.1121.00059,1,2055625,2071365,+,15740
249,BUMA.1121.00043,1,2911909,2927669,+,15760
249,BUMA.1121.00056,1,1128312,1143920,-,15608
249,BUMA.1121.00112,1,569,16182,-,15613
249,BUMA.1121.00091,1,1678621,1694244,-,15623
249,BUMA.1121.00047,1,110339,125947,-,15608
249,BUMA.1121.00067,1,1578568,1594179,-,15611
249,BUMA.1121.00110,1,1978977,1994599,-,15622
249,BUMA.1121.00073,1,2763766,2779487,+,15721
249,BUMA.1121.00072,1,2736434,2752098,+,15664
249,BUMA.1121.00077,1,1488502,1504242,+,15740
249,BUMA.1121.00082,1,2923029,2938750,+,15721
249,BUMA.1121.00062,1,1722978,1738589,-,15611
249,BUMA.1121.00007,1,1221254,1236867,-,15613
249,BUMA.1121.00025,1,3974997,3990619,-,15622
249,BUMA.1121.00021,1,3426311,3442080,+,15769
249,BUMA.1121.00103,1,1528793,1544416,-,15623
249,BUMA.1121.00096,1,437046,452703,-,15657
249,BUMA.1121.00079,1,2861012,2876739,+,15727
249,BUMA.1121.00039,1,2966678,2982420,+,15742
249,BUMA.1121.00083,1,2840610,2856211,-,15601
249,BUMA.1121.00084,1,3193151,3208884,+,15733
249,BUMA.1121.00049,1,2991509,3007142,-,15633
249,BUMA.1121.00089,1,2782806,2798534,+,15728
249,BUMA.1121.00014,1,4078435,4094066,-,15631
249,BUMA.1121.00090,1,903237,918979,+,15742
249,BUMA.1121.00071,1,2754328,2770044,+,15716
249,BUMA.1121.00078,1,3169219,3184832,-,15613
249,BUMA.1121.00102,1,2449981,2465566,-,15585
249,BUMA.1121.00075,1,2318655,2334396,+,15741
249,BUMA.1121.00012,1,1580193,1595962,+,15769
249,BUMA.1121.00076,1,2477904,2493526,-,15622
249,BUMA.1121.00106,1,2567636,2583381,+,15745
249,BUMA.1121.00001,1,1243925,1259538,-,15613
249,BUMA.1121.00107,1,2768221,2783963,+,15742
249,BUMA.1121.00104,1,2407966,2423588,-,15622
249,BUMA.1121.00099,1,3573862,3589484,-,15622
249,BUMA.1121.00098,1,1487912,1503655,+,15743
249,BUMA.1121.00111,1,2996857,3012599,+,15742
249,BUMA.1121.00109,1,3070885,3086510,-,15625
249,BUMA.1121.00097,1,1087341,1102957,-,15616
249,BUMA.1121.00094,1,2811805,2827533,+,15728
249,BUMA.1121.00095,1,2876864,2892486,-,15622
249,BUMA.1121.00005,1,1531049,1546740,+,15691
249,BUMA.1121.00101,1,3607812,3623425,-,15613
249,BUMA.1121.00065,1,2883073,2898815,+,15742
249,BUMA.1121.00100,1,2532490,2548064,-,15574
249,BUMA.1121.00105,1,2359665,2375275,-,15610
249,BUMA.1121.00029,1,2128371,2143968,-,15597
249,BUMA.1121.00066,1,2739244,2754962,+,15718
249,BUMA.1121.00031,1,156659,172410,+,15751
249,BUMA.1121.00108,1,3865192,3880934,+,15742
249,BUMA.1121.00023,1,1146703,1162445,+,15742
249,BUMA.1121.00035,1,3980522,3996255,+,15733
249,BUMA.1121.00041,1,105,15686,+,15581
248,BUMA.1121.00057,1,3903354,3938141,+,34787
248,BUMA.1121.00058,1,1702540,1737205,-,34665
248,BUMA.1121.00045,1,1237626,1272441,-,34815
248,BUMA.1121.00051,1,2759725,2794533,+,34808
248,BUMA.1121.00068,1,1563509,1599614,+,36105
248,BUMA.1121.00061,1,2730580,2765280,+,34700
248,BUMA.1121.00060,1,3482844,3517694,-,34850
248,BUMA.1121.00064,1,2799408,2834168,+,34760
248,BUMA.1121.00016,1,904754,939754,+,35000
248,BUMA.1121.00003,1,1279644,1314506,+,34862
248,BUMA.1121.00055,1,2472077,2506791,+,34714
248,BUMA.1121.00011,1,2839793,2874444,-,34651
248,BUMA.1121.00037,1,1395216,1430243,+,35027
248,BUMA.1121.00009,1,2754964,2789743,-,34779
248,BUMA.1121.00069,1,2699936,2734635,+,34699
248,BUMA.1121.00088,1,3703536,3738667,+,35131
248,BUMA.1121.00092,1,955804,990617,-,34813
248,BUMA.1121.00074,1,1040209,1075000,-,34791
248,BUMA.1121.00070,1,2701674,2736400,+,34726
248,BUMA.1121.00093,1,3635528,3670305,+,34777
248,BUMA.1121.00063,1,2727373,2762125,+,34752
248,BUMA.1121.00033,1,980096,1014895,+,34799
248,BUMA.1121.00018,1,3383909,3418869,+,34960
248,BUMA.1121.00080,1,2791454,2826362,+,34908
248,BUMA.1121.00027,1,932537,967462,+,34925
248,BUMA.1121.00053,1,2552077,2587200,+,35123
248,BUMA.1121.00059,1,2020493,2055374,+,34881
248,BUMA.1121.00043,1,2876586,2911658,+,35072
248,BUMA.1121.00056,1,1144291,1179031,-,34740
248,BUMA.1121.00112,1,16553,51199,-,34646
248,BUMA.1121.00091,1,1694615,1729489,-,34874
248,BUMA.1121.00047,1,126318,161144,-,34826
248,BUMA.1121.00067,1,1594550,1629504,-,34954
248,BUMA.1121.00110,1,1994970,2029720,-,34750
248,BUMA.1121.00073,1,2728765,2763515,+,34750
248,BUMA.1121.00072,1,2701429,2736183,+,34754
248,BUMA.1121.00077,1,1453511,1488251,+,34740
248,BUMA.1121.00082,1,2888008,2922778,+,34770
248,BUMA.1121.00062,1,1738960,1773835,-,34875
248,BUMA.1121.00007,1,1237238,1272118,-,34880
248,BUMA.1121.00025,1,3990990,4025850,-,34860
248,BUMA.1121.00021,1,3391103,3426060,+,34957
248,BUMA.1121.00103,1,1586200,1620953,-,34753
248,BUMA.1121.00096,1,453074,487972,-,34898
248,BUMA.1121.00079,1,2825842,2860761,+,34919
248,BUMA.1121.00039,1,2931462,2966427,+,34965
248,BUMA.1121.00083,1,2856582,2891352,-,34770
248,BUMA.1121.00084,1,3158067,3192900,+,34833
248,BUMA.1121.00049,1,3007513,3042399,-,34886
248,BUMA.1121.00089,1,2747668,2782555,+,34887
248,BUMA.1121.00014,1,4094437,4129493,-,35056
248,BUMA.1121.00090,1,868149,902986,+,34837
248,BUMA.1121.00071,1,2719460,2754077,+,34617
248,BUMA.1121.00078,1,3185203,3220022,-,34819
248,BUMA.1121.00102,1,2465937,2501170,-,35233
248,BUMA.1121.00075,1,2283563,2318404,+,34841
248,BUMA.1121.00012,1,1544940,1579942,+,35002
248,BUMA.1121.00076,1,2493897,2528843,-,34946
248,BUMA.1121.00106,1,2532588,2567385,+,34797
248,BUMA.1121.00001,1,1259909,1294664,-,34755
248,BUMA.1121.00107,1,2733216,2767970,+,34754
248,BUMA.1121.00104,1,2423959,2458803,-,34844
248,BUMA.1121.00099,1,3589855,3624934,-,35079
248,BUMA.1121.00098,1,1452873,1487661,+,34788
248,BUMA.1121.00111,1,2961598,2996606,+,35008
248,BUMA.1121.00109,1,3086881,3121752,-,34871
248,BUMA.1121.00097,1,1103328,1137997,-,34669
248,BUMA.1121.00094,1,2776631,2811554,+,34923
248,BUMA.1121.00095,1,2892857,2927687,-,34830
248,BUMA.1121.00005,1,1495796,1530798,+,35002
248,BUMA.1121.00101,1,3623796,3658570,-,34774
248,BUMA.1121.00065,1,2848010,2882822,+,34812
248,BUMA.1121.00100,1,2548435,2583646,-,35211
248,BUMA.1121.00105,1,2375646,2411631,-,35985
248,BUMA.1121.00029,1,2144220,2178936,-,34716
248,BUMA.1121.00066,1,2704246,2738993,+,34747
248,BUMA.1121.00031,1,121490,156408,+,34918
248,BUMA.1121.00108,1,3830177,3864941,+,34764
248,BUMA.1121.00023,1,1111297,1146452,+,35155
248,BUMA.1121.00035,1,3945218,3980271,+,35053
248,BUMA.1121.00041,1,4100227,4134954,+,34727
247,BUMA.1121.00057,1,3893018,3902858,+,9840
247,BUMA.1121.00058,1,1737701,1747432,-,9731
247,BUMA.1121.00045,1,1272937,1282653,-,9716
247,BUMA.1121.00051,1,2749222,2759229,+,10007
247,BUMA.1121.00068,1,1551930,1561777,+,9847
247,BUMA.1121.00061,1,2720265,2730084,+,9819
247,BUMA.1121.00060,1,3518190,3527906,-,9716
247,BUMA.1121.00064,1,2789125,2798912,+,9787
247,BUMA.1121.00016,1,894340,904263,+,9923
247,BUMA.1121.00003,1,1269321,1279139,+,9818
247,BUMA.1121.00055,1,2461763,2471581,+,9818
247,BUMA.1121.00011,1,2874942,2884686,-,9744
247,BUMA.1121.00037,1,1383595,1393476,+,9881
247,BUMA.1121.00009,1,2791475,2801256,-,9781
247,BUMA.1121.00069,1,2689621,2699440,+,9819
247,BUMA.1121.00088,1,3693167,3703040,+,9873
247,BUMA.1121.00092,1,991113,1000865,-,9752
247,BUMA.1121.00074,1,1075496,1085297,-,9801
247,BUMA.1121.00070,1,2691359,2701178,+,9819
247,BUMA.1121.00093,1,3625199,3635032,+,9833
247,BUMA.1121.00063,1,2717058,2726877,+,9819
247,BUMA.1121.00033,1,969747,979600,+,9853
247,BUMA.1121.00018,1,3373592,3383418,+,9826
247,BUMA.1121.00080,1,2781027,2790958,+,9931
247,BUMA.1121.00027,1,922229,932041,+,9812
247,BUMA.1121.00053,1,2541692,2551581,+,9889
247,BUMA.1121.00059,1,2010157,2019997,+,9840
247,BUMA.1121.00043,1,2866237,2876090,+,9853
247,BUMA.1121.00056,1,1179527,1189328,-,9801
247,BUMA.1121.00112,1,51695,61447,-,9752
247,BUMA.1121.00091,1,1729985,1739800,-,9815
247,BUMA.1121.00047,1,161640,171552,-,9912
247,BUMA.1121.00067,1,1630000,1639829,-,9829
247,BUMA.1121.00110,1,2030216,2039933,-,9717
247,BUMA.1121.00073,1,2718450,2728269,+,9819
247,BUMA.1121.00072,1,2691114,2700933,+,9819
247,BUMA.1121.00077,1,1443217,1453015,+,9798
247,BUMA.1121.00082,1,2877693,2887512,+,9819
247,BUMA.1121.00062,1,1774331,1784055,-,9724
247,BUMA.1121.00007,1,1272614,1282475,-,9861
247,BUMA.1121.00025,1,4026341,4036079,-,9738
247,BUMA.1121.00021,1,3380757,3390603,+,9846
247,BUMA.1121.00103,1,1621449,1631192,-,9743
247,BUMA.1121.00096,1,488468,498217,-,9749
247,BUMA.1121.00079,1,2815430,2825346,+,9916
247,BUMA.1121.00039,1,2921120,2930966,+,9846
247,BUMA.1121.00083,1,2891848,2901586,-,9738
247,BUMA.1121.00084,1,3147619,3157571,+,9952
247,BUMA.1121.00049,1,3042895,3052669,-,9774
247,BUMA.1121.00089,1,2737269,2747172,+,9903
247,BUMA.1121.00014,1,4129994,4139737,-,9743
247,BUMA.1121.00090,1,857821,867653,+,9832
247,BUMA.1121.00071,1,2709145,2718956,+,9811
247,BUMA.1121.00078,1,3220518,3230253,-,9735
247,BUMA.1121.00102,1,2501666,2511494,-,9828
247,BUMA.1121.00075,1,2273122,2283067,+,9945
247,BUMA.1121.00012,1,1534584,1544444,+,9860
247,BUMA.1121.00076,1,2529339,2539280,-,9941
247,BUMA.1121.00106,1,2522249,2532092,+,9843
247,BUMA.1121.00001,1,1295160,1304911,-,9751
247,BUMA.1121.00107,1,2722867,2732720,+,9853
247,BUMA.1121.00104,1,2459299,2469089,-,9790
247,BUMA.1121.00099,1,3625430,3635195,-,9765
247,BUMA.1121.00098,1,1442510,1452377,+,9867
247,BUMA.1121.00111,1,2951249,2961102,+,9853
247,BUMA.1121.00109,1,3123484,3133243,-,9759
247,BUMA.1121.00097,1,1138493,1148251,-,9758
247,BUMA.1121.00094,1,2766232,2776135,+,9903
247,BUMA.1121.00095,1,2928183,2937881,-,9698
247,BUMA.1121.00005,1,1485384,1495300,+,9916
247,BUMA.1121.00101,1,3659066,3668805,-,9739
247,BUMA.1121.00065,1,2837653,2847514,+,9861
247,BUMA.1121.00100,1,2584145,2593903,-,9758
247,BUMA.1121.00105,1,2412127,2421872,-,9745
247,BUMA.1121.00029,1,2179432,2189204,-,9772
247,BUMA.1121.00066,1,2693931,2703750,+,9819
247,BUMA.1121.00031,1,111166,120990,+,9824
247,BUMA.1121.00108,1,3819854,3829681,+,9827
247,BUMA.1121.00023,1,1100968,1110806,+,9838
247,BUMA.1121.00035,1,3934841,3944722,+,9881
247,BUMA.1121.00041,1,4089885,4099731,+,9846
246,BUMA.1121.00057,1,3888465,3891923,+,3458
246,BUMA.1121.00058,1,1748608,1752066,-,3458
246,BUMA.1121.00045,1,1283852,1287310,-,3458
246,BUMA.1121.00051,1,2744658,2748116,+,3458
246,BUMA.1121.00068,1,1547366,1550824,+,3458
246,BUMA.1121.00061,1,2715712,2719170,+,3458
246,BUMA.1121.00060,1,3529105,3532563,-,3458
246,BUMA.1121.00064,1,2784491,2787949,+,3458
246,BUMA.1121.00016,1,889776,893234,+,3458
246,BUMA.1121.00003,1,1264751,1268209,+,3458
246,BUMA.1121.00055,1,2457210,2460668,+,3458
246,BUMA.1121.00011,1,2885885,2889343,-,3458
246,BUMA.1121.00037,1,1379031,1382489,+,3458
246,BUMA.1121.00009,1,2802443,2805901,-,3458
246,BUMA.1121.00011,2,1156036,1159497,-,3461
246,BUMA.1121.00009,2,1198558,1202019,-,3461
246,BUMA.1121.00039,2,1426789,1430255,+,3466
246,BUMA.1121.00029,2,1982579,1986045,+,3466
246,BUMA.1121.00021,2,3035091,3038557,-,3466
246,BUMA.1121.00069,1,2685068,2688526,+,3458
246,BUMA.1121.00107,2,1253453,1256914,+,3461
246,BUMA.1121.00023,2,2676942,2680408,-,3466
246,BUMA.1121.00067,2,1385839,1389305,+,3466
246,BUMA.1121.00088,1,3688603,3692061,+,3458
246,BUMA.1121.00035,2,2060268,2063734,+,3466
246,BUMA.1121.00005,2,1383373,1386839,+,3466
246,BUMA.1121.00092,1,1002041,1005499,-,3458
246,BUMA.1121.00100,2,568497,571964,-,3467
246,BUMA.1121.00016,2,1170383,1173849,+,3466
246,BUMA.1121.00099,2,2783744,2787211,-,3467
246,BUMA.1121.00074,1,1086473,1089931,-,3458
246,BUMA.1121.00094,2,2578101,2581566,-,3465
246,BUMA.1121.00093,2,394815,398281,+,3466
246,BUMA.1121.00070,1,2686806,2690264,+,3458
246,BUMA.1121.00097,2,2374760,2378227,-,3467
246,BUMA.1121.00093,1,3620646,3624104,+,3458
246,BUMA.1121.00063,1,2712505,2715963,+,3458
246,BUMA.1121.00109,2,2086849,2090310,+,3461
246,BUMA.1121.00018,2,1263936,1267402,+,3466
246,BUMA.1121.00110,2,2501013,2504480,-,3467
246,BUMA.1121.00033,1,965183,968641,+,3458
246,BUMA.1121.00079,2,2537606,2541073,-,3467
246,BUMA.1121.00075,2,299315,302782,+,3467
246,BUMA.1121.00066,2,2506847,2510313,-,3466
246,BUMA.1121.00089,2,2523913,2527380,-,3467
246,BUMA.1121.00057,2,2698759,2702225,+,3466
246,BUMA.1121.00018,1,3369039,3372497,+,3458
246,BUMA.1121.00080,1,2776463,2779921,+,3458
246,BUMA.1121.00027,1,917676,921134,+,3458
246,BUMA.1121.00090,2,276485,279951,-,3466
246,BUMA.1121.00027,2,456656,460122,-,3466
246,BUMA.1121.00062,2,2367303,2370769,+,3466
246,BUMA.1121.00053,1,2537139,2540597,+,3458
246,BUMA.1121.00091,2,1093354,1096821,+,3467
246,BUMA.1121.00059,1,2005604,2009062,+,3458
246,BUMA.1121.00043,1,2861673,2865131,+,3458
246,BUMA.1121.00098,2,2797515,2800976,-,3461
246,BUMA.1121.00092,2,2539682,2543148,-,3466
246,BUMA.1121.00031,2,1721961,1725421,-,3460
246,BUMA.1121.00096,2,2853103,2856564,-,3461
246,BUMA.1121.00073,2,2523222,2526688,-,3466
246,BUMA.1121.00103,2,1179155,1182622,-,3467
246,BUMA.1121.00056,1,1190515,1193973,-,3458
246,BUMA.1121.00112,1,62646,66104,-,3458
246,BUMA.1121.00084,2,1253554,1257015,-,3461
246,BUMA.1121.00014,2,2656607,2660073,-,3466
246,BUMA.1121.00091,1,1740987,1744445,-,3458
246,BUMA.1121.00047,1,172739,176197,-,3458
246,BUMA.1121.00067,1,1641016,1644474,-,3458
246,BUMA.1121.00111,2,1869178,1872638,-,3460
246,BUMA.1121.00007,2,2662335,2665802,-,3467
246,BUMA.1121.00110,1,2040992,2044450,-,3458
246,BUMA.1121.00072,2,2497688,2501154,-,3466
246,BUMA.1121.00071,2,2523101,2526567,-,3466
246,BUMA.1121.00077,2,1111475,1114942,+,3467
246,BUMA.1121.00003,2,781819,785280,-,3461
246,BUMA.1121.00104,2,2628309,2631770,-,3461
246,BUMA.1121.00074,2,1830614,1834080,+,3466
246,BUMA.1121.00060,2,2840877,2844338,+,3461
246,BUMA.1121.00073,1,2713897,2717355,+,3458
246,BUMA.1121.00072,1,2686561,2690019,+,3458
246,BUMA.1121.00088,2,2548566,2552027,-,3461
246,BUMA.1121.00053,2,2825587,2829053,-,3466
246,BUMA.1121.00025,2,1065531,1068997,-,3466
246,BUMA.1121.00077,1,1438781,1442239,+,3458
246,BUMA.1121.00070,2,2502561,2506027,-,3466
246,BUMA.1121.00049,2,1181287,1184748,-,3461
246,BUMA.1121.00078,2,595617,599083,+,3466
246,BUMA.1121.00082,1,2873140,2876598,+,3458
246,BUMA.1121.00069,2,2489119,2492585,-,3466
246,BUMA.1121.00102,2,2568780,2572247,-,3467
246,BUMA.1121.00062,1,1785231,1788689,-,3458
246,BUMA.1121.00112,2,1830381,1833847,+,3466
246,BUMA.1121.00007,1,1283651,1287109,-,3458
246,BUMA.1121.00041,2,269951,273417,-,3466
246,BUMA.1121.00068,2,1129227,1132688,-,3461
246,BUMA.1121.00076,2,294661,298128,-,3467
246,BUMA.1121.00033,2,92194,95660,-,3466
246,BUMA.1121.00025,1,4037255,4040713,-,3458
246,BUMA.1121.00021,1,3376193,3379651,+,3458
246,BUMA.1121.00101,2,872246,875706,+,3460
246,BUMA.1121.00103,1,1632379,1635837,-,3458
246,BUMA.1121.00105,2,3092811,3096272,+,3461
246,BUMA.1121.00061,2,2506328,2509794,-,3466
246,BUMA.1121.00096,1,499404,502862,-,3458
246,BUMA.1121.00063,2,2516287,2519753,-,3466
246,BUMA.1121.00059,2,1058245,1061711,+,3466
246,BUMA.1121.00058,2,3146391,3149852,-,3461
246,BUMA.1121.00043,2,3019407,3022867,+,3460
246,BUMA.1121.00055,2,135604,139065,+,3461
246,BUMA.1121.00065,2,2612279,2615746,-,3467
246,BUMA.1121.00064,2,2446178,2449645,-,3467
246,BUMA.1121.00047,2,351795,355262,-,3467
246,BUMA.1121.00037,2,2891298,2894764,-,3466
246,BUMA.1121.00079,1,2810866,2814324,+,3458
246,BUMA.1121.00106,2,1818791,1822252,-,3461
246,BUMA.1121.00051,2,2537190,2540657,-,3467
246,BUMA.1121.00045,2,2420767,2424228,-,3461
246,BUMA.1121.00039,1,2916567,2920025,+,3458
246,BUMA.1121.00056,2,1464318,1467785,+,3467
246,BUMA.1121.00083,1,2902762,2906220,-,3458
246,BUMA.1121.00084,1,3143066,3146524,+,3458
246,BUMA.1121.00049,1,3053856,3057314,-,3458
246,BUMA.1121.00095,2,1402563,1406024,-,3461
246,BUMA.1121.00089,1,2732705,2736163,+,3458
246,BUMA.1121.00014,1,4140924,4144382,-,3458
246,BUMA.1121.00090,1,853257,856715,+,3458
246,BUMA.1121.00071,1,2704592,2708050,+,3458
246,BUMA.1121.00078,1,3231440,3234898,-,3458
246,BUMA.1121.00102,1,2514011,2517469,-,3458
246,BUMA.1121.00075,1,2268569,2272027,+,3458
246,BUMA.1121.00012,1,1530020,1533478,+,3458
246,BUMA.1121.00076,1,2540456,2543914,-,3458
246,BUMA.1121.00106,1,2517685,2521143,+,3458
246,BUMA.1121.00001,1,1306097,1309555,-,3458
246,BUMA.1121.00082,2,2569589,2573055,-,3466
246,BUMA.1121.00107,1,2718303,2721761,+,3458
246,BUMA.1121.00104,1,2470276,2473734,-,3458
246,BUMA.1121.00099,1,3636382,3639840,-,3458
246,BUMA.1121.00001,2,2864093,2867559,+,3466
246,BUMA.1121.00098,1,1437946,1441404,+,3458
246,BUMA.1121.00108,2,2785220,2788681,-,3461
246,BUMA.1121.00111,1,2946685,2950143,+,3458
246,BUMA.1121.00109,1,3134431,3137889,-,3458
246,BUMA.1121.00083,2,1193505,1196971,-,3466
246,BUMA.1121.00097,1,1149450,1152908,-,3458
246,BUMA.1121.00080,2,2593641,2597108,-,3467
246,BUMA.1121.00094,1,2761668,2765126,+,3458
246,BUMA.1121.00012,2,2389922,2393388,+,3466
246,BUMA.1121.00095,1,2939057,2942515,-,3458
246,BUMA.1121.00005,1,1480858,1484290,+,3432
246,BUMA.1121.00101,1,3669992,3673450,-,3458
246,BUMA.1121.00065,1,2833100,2836558,+,3458
246,BUMA.1121.00100,1,2595090,2598548,-,3458
246,BUMA.1121.00105,1,2423059,2426517,-,3458
246,BUMA.1121.00029,1,2190391,2193849,-,3458
246,BUMA.1121.00066,1,2689378,2692836,+,3458
246,BUMA.1121.00031,1,106603,110061,+,3458
246,BUMA.1121.00108,1,3815290,3818748,+,3458
246,BUMA.1121.00023,1,1096404,1099862,+,3458
246,BUMA.1121.00035,1,3930277,3933735,+,3458
246,BUMA.1121.00041,1,4085321,4088779,+,3458
245,BUMA.1121.00057,1,3850042,3888463,+,38421
245,BUMA.1121.00058,1,1752067,1790451,-,38384
245,BUMA.1121.00045,1,1287311,1325721,-,38410
245,BUMA.1121.00051,1,2706194,2744656,+,38462
245,BUMA.1121.00068,1,1508968,1547364,+,38396
245,BUMA.1121.00061,1,2677327,2715710,+,38383
245,BUMA.1121.00060,1,3532564,3570982,-,38418
245,BUMA.1121.00064,1,2746092,2784489,+,38397
245,BUMA.1121.00016,1,851313,889774,+,38461
245,BUMA.1121.00003,1,1226304,1264749,+,38445
245,BUMA.1121.00055,1,2418787,2457208,+,38421
245,BUMA.1121.00011,1,2889344,2927739,-,38395
245,BUMA.1121.00037,1,1340576,1379029,+,38453
245,BUMA.1121.00009,1,2805902,2844227,-,38325
245,BUMA.1121.00069,1,2646683,2685066,+,38383
245,BUMA.1121.00088,1,3650203,3688601,+,38398
245,BUMA.1121.00092,1,1005500,1043920,-,38420
245,BUMA.1121.00074,1,1089932,1128366,-,38434
245,BUMA.1121.00070,1,2648446,2686804,+,38358
245,BUMA.1121.00093,1,3582225,3620644,+,38419
245,BUMA.1121.00063,1,2674121,2712503,+,38382
245,BUMA.1121.00033,1,926698,965181,+,38483
245,BUMA.1121.00018,1,3330549,3369037,+,38488
245,BUMA.1121.00080,1,2738015,2776461,+,38446
245,BUMA.1121.00027,1,879199,917674,+,38475
245,BUMA.1121.00053,1,2497401,2537137,+,39736
245,BUMA.1121.00059,1,1967198,2005602,+,38404
245,BUMA.1121.00043,1,2823174,2861671,+,38497
245,BUMA.1121.00056,1,1193974,1232468,-,38494
245,BUMA.1121.00112,1,66105,104508,-,38403
245,BUMA.1121.00091,1,1744446,1782865,-,38419
245,BUMA.1121.00047,1,176198,214630,-,38432
245,BUMA.1121.00067,1,1644475,1682887,-,38412
245,BUMA.1121.00110,1,2044451,2082928,-,38477
245,BUMA.1121.00073,1,2675530,2713895,+,38365
245,BUMA.1121.00072,1,2648175,2686559,+,38384
245,BUMA.1121.00077,1,1400303,1438779,+,38476
245,BUMA.1121.00082,1,2834753,2873138,+,38385
245,BUMA.1121.00062,1,1788690,1827111,-,38421
245,BUMA.1121.00007,1,1287110,1325573,-,38463
245,BUMA.1121.00025,1,4040714,4079203,-,38489
245,BUMA.1121.00021,1,3337715,3376191,+,38476
245,BUMA.1121.00103,1,1635838,1674247,-,38409
245,BUMA.1121.00096,1,502863,541370,-,38507
245,BUMA.1121.00079,1,2772475,2810864,+,38389
245,BUMA.1121.00039,1,2878061,2916565,+,38504
245,BUMA.1121.00083,1,2906221,2944608,-,38387
245,BUMA.1121.00084,1,3104675,3143064,+,38389
245,BUMA.1121.00049,1,3057315,3095799,-,38484
245,BUMA.1121.00089,1,2694224,2732703,+,38479
245,BUMA.1121.00014,1,4144383,4182889,-,38506
245,BUMA.1121.00090,1,814797,853255,+,38458
245,BUMA.1121.00071,1,2666211,2704590,+,38379
245,BUMA.1121.00078,1,3234899,3273309,-,38410
245,BUMA.1121.00102,1,2517470,2555902,-,38432
245,BUMA.1121.00075,1,2230100,2268567,+,38467
245,BUMA.1121.00012,1,1491572,1530018,+,38446
245,BUMA.1121.00076,1,2543915,2582355,-,38440
245,BUMA.1121.00106,1,2479224,2517683,+,38459
245,BUMA.1121.00001,1,1309556,1347956,-,38400
245,BUMA.1121.00107,1,2680011,2718301,+,38290
245,BUMA.1121.00104,1,2473735,2512205,-,38470
245,BUMA.1121.00099,1,3639841,3678186,-,38345
245,BUMA.1121.00098,1,1399686,1437944,+,38258
245,BUMA.1121.00111,1,2908242,2946683,+,38441
245,BUMA.1121.00109,1,3137890,3176272,-,38382
245,BUMA.1121.00097,1,1152909,1191280,-,38371
245,BUMA.1121.00094,1,2723198,2761666,+,38468
245,BUMA.1121.00095,1,2942516,2981062,-,38546
245,BUMA.1121.00005,1,1442398,1480856,+,38458
245,BUMA.1121.00101,1,3673451,3711859,-,38408
245,BUMA.1121.00065,1,2794686,2833098,+,38412
245,BUMA.1121.00100,1,2598549,2636875,-,38326
245,BUMA.1121.00105,1,2426518,2464906,-,38388
245,BUMA.1121.00029,1,2193850,2232281,-,38431
245,BUMA.1121.00066,1,2650991,2689376,+,38385
245,BUMA.1121.00031,1,68112,106601,+,38489
245,BUMA.1121.00108,1,3776835,3815288,+,38453
245,BUMA.1121.00023,1,1057899,1096402,+,38503
245,BUMA.1121.00035,1,3891818,3930275,+,38457
245,BUMA.1121.00041,1,4046821,4085319,+,38498
244,BUMA.1121.00057,1,3839865,3849633,+,9768
244,BUMA.1121.00058,1,1790859,1800627,-,9768
244,BUMA.1121.00045,1,1326129,1335897,-,9768
244,BUMA.1121.00051,1,2694660,2704428,+,9768
244,BUMA.1121.00068,1,1498782,1508559,+,9777
244,BUMA.1121.00061,1,2667150,2676918,+,9768
244,BUMA.1121.00060,1,3571390,3581158,-,9768
244,BUMA.1121.00064,1,2735915,2745683,+,9768
244,BUMA.1121.00016,1,841138,850904,+,9766
244,BUMA.1121.00003,1,1216116,1225891,+,9775
244,BUMA.1121.00055,1,2408588,2418369,+,9781
244,BUMA.1121.00011,1,2928156,2937915,-,9759
244,BUMA.1121.00037,1,1330399,1340167,+,9768
244,BUMA.1121.00009,1,2844635,2854403,-,9768
244,BUMA.1121.00069,1,2636506,2646265,+,9759
244,BUMA.1121.00088,1,3640026,3649794,+,9768
244,BUMA.1121.00092,1,1044328,1054096,-,9768
244,BUMA.1121.00074,1,1128774,1138542,-,9768
244,BUMA.1121.00070,1,2638263,2648031,+,9768
244,BUMA.1121.00093,1,3572048,3581816,+,9768
244,BUMA.1121.00063,1,2663944,2673703,+,9759
244,BUMA.1121.00033,1,916523,926289,+,9766
244,BUMA.1121.00018,1,3320372,3330140,+,9768
244,BUMA.1121.00080,1,2726481,2736249,+,9768
244,BUMA.1121.00027,1,869022,878790,+,9768
244,BUMA.1121.00053,1,2487224,2496992,+,9768
244,BUMA.1121.00059,1,1957010,1966789,+,9779
244,BUMA.1121.00043,1,2812999,2822765,+,9766
244,BUMA.1121.00056,1,1234233,1244001,-,9768
244,BUMA.1121.00112,1,104916,114685,-,9769
244,BUMA.1121.00091,1,1783273,1793052,-,9779
244,BUMA.1121.00047,1,216395,226163,-,9768
244,BUMA.1121.00067,1,1683295,1693063,-,9768
244,BUMA.1121.00110,1,2083336,2093105,-,9769
244,BUMA.1121.00073,1,2665347,2675115,+,9768
244,BUMA.1121.00072,1,2637998,2647766,+,9768
244,BUMA.1121.00077,1,1390125,1399894,+,9769
244,BUMA.1121.00082,1,2824576,2834344,+,9768
244,BUMA.1121.00062,1,1827519,1837287,-,9768
244,BUMA.1121.00007,1,1325990,1335749,-,9759
244,BUMA.1121.00025,1,4079611,4089379,-,9768
244,BUMA.1121.00021,1,3327538,3337306,+,9768
244,BUMA.1121.00103,1,1674655,1684431,-,9776
244,BUMA.1121.00096,1,541787,551546,-,9759
244,BUMA.1121.00079,1,2760941,2770709,+,9768
244,BUMA.1121.00039,1,2867886,2877652,+,9766
244,BUMA.1121.00083,1,2945016,2954784,-,9768
244,BUMA.1121.00084,1,3094498,3104257,+,9759
244,BUMA.1121.00049,1,3096216,3105975,-,9759
244,BUMA.1121.00089,1,2682690,2692458,+,9768
244,BUMA.1121.00014,1,4183297,4193065,-,9768
244,BUMA.1121.00090,1,804620,814388,+,9768
244,BUMA.1121.00071,1,2656034,2665793,+,9759
244,BUMA.1121.00078,1,3273717,3283518,-,9801
244,BUMA.1121.00102,1,2556310,2566089,-,9779
244,BUMA.1121.00075,1,2219924,2229691,+,9767
244,BUMA.1121.00012,1,1481395,1491163,+,9768
244,BUMA.1121.00076,1,2582763,2592531,-,9768
244,BUMA.1121.00106,1,2469047,2478806,+,9759
244,BUMA.1121.00001,1,1348363,1358131,-,9768
244,BUMA.1121.00107,1,2669835,2679593,+,9758
244,BUMA.1121.00104,1,2512622,2522403,-,9781
244,BUMA.1121.00099,1,3678594,3688362,-,9768
244,BUMA.1121.00098,1,1389509,1399268,+,9759
244,BUMA.1121.00111,1,2898065,2907833,+,9768
244,BUMA.1121.00109,1,3176680,3186449,-,9769
244,BUMA.1121.00097,1,1191697,1201479,-,9782
244,BUMA.1121.00094,1,2711663,2721432,+,9769
244,BUMA.1121.00095,1,2981479,2991238,-,9759
244,BUMA.1121.00005,1,1432210,1441989,+,9779
244,BUMA.1121.00101,1,3712276,3722046,-,9770
244,BUMA.1121.00065,1,2784509,2794268,+,9759
244,BUMA.1121.00100,1,2637291,2647047,-,9756
244,BUMA.1121.00105,1,2465314,2475082,-,9768
244,BUMA.1121.00029,1,2232689,2242457,-,9768
244,BUMA.1121.00066,1,2640814,2650573,+,9759
244,BUMA.1121.00031,1,57935,67703,+,9768
244,BUMA.1121.00108,1,3766647,3776426,+,9779
244,BUMA.1121.00023,1,1047722,1057490,+,9768
244,BUMA.1121.00035,1,3881641,3891409,+,9768
244,BUMA.1121.00041,1,4036633,4046412,+,9779
243,BUMA.1121.00057,1,3830544,3833798,+,3254
243,BUMA.1121.00058,1,1806010,1809263,-,3253
243,BUMA.1121.00045,1,1341325,1344578,-,3253
243,BUMA.1121.00051,1,2686027,2689279,+,3252
243,BUMA.1121.00068,1,1490157,1493409,+,3252
243,BUMA.1121.00061,1,2659370,2662624,+,3254
243,BUMA.1121.00060,1,3586586,3589839,-,3253
243,BUMA.1121.00064,1,2726023,2729276,+,3253
243,BUMA.1121.00016,1,830942,834194,+,3252
243,BUMA.1121.00003,1,1207440,1210698,+,3258
243,BUMA.1121.00055,1,2396689,2399936,+,3247
243,BUMA.1121.00011,1,2943343,2946590,-,3247
243,BUMA.1121.00037,1,1319706,1322959,+,3253
243,BUMA.1121.00009,1,2859762,2863015,-,3253
243,BUMA.1121.00069,1,2628815,2632068,+,3253
243,BUMA.1121.00088,1,3630705,3633959,+,3254
243,BUMA.1121.00092,1,1059454,1062707,-,3253
243,BUMA.1121.00074,1,1145182,1148435,-,3253
243,BUMA.1121.00070,1,2630478,2633731,+,3253
243,BUMA.1121.00093,1,3563438,3566691,+,3253
243,BUMA.1121.00063,1,2656250,2659504,+,3254
243,BUMA.1121.00033,1,905832,909085,+,3253
243,BUMA.1121.00018,1,3310176,3313429,+,3253
243,BUMA.1121.00080,1,2717848,2721100,+,3252
243,BUMA.1121.00027,1,859702,862956,+,3254
243,BUMA.1121.00053,1,2477903,2481157,+,3254
243,BUMA.1121.00059,1,1948376,1951628,+,3252
243,BUMA.1121.00043,1,2789888,2793136,+,3248
243,BUMA.1121.00056,1,1250641,1253888,-,3247
243,BUMA.1121.00112,1,120105,123358,-,3253
243,BUMA.1121.00091,1,1797735,1800983,-,3248
243,BUMA.1121.00047,1,232803,236050,-,3247
243,BUMA.1121.00067,1,1699703,1702956,-,3253
243,BUMA.1121.00110,1,2100718,2103965,-,3247
243,BUMA.1121.00073,1,2657563,2660816,+,3253
243,BUMA.1121.00072,1,2631253,2634502,+,3249
243,BUMA.1121.00077,1,1379267,1382514,+,3247
243,BUMA.1121.00082,1,2815255,2818509,+,3254
243,BUMA.1121.00062,1,1842669,1845922,-,3253
243,BUMA.1121.00007,1,1341131,1344384,-,3253
243,BUMA.1121.00025,1,4096323,4099576,-,3253
243,BUMA.1121.00021,1,3316846,3320098,+,3252
243,BUMA.1121.00103,1,1690559,1693812,-,3253
243,BUMA.1121.00096,1,557567,560826,-,3259
243,BUMA.1121.00079,1,2752309,2755560,+,3251
243,BUMA.1121.00039,1,2855858,2859111,+,3253
243,BUMA.1121.00083,1,2960852,2964106,-,3254
243,BUMA.1121.00084,1,3085177,3088431,+,3254
243,BUMA.1121.00049,1,3112043,3115296,-,3253
243,BUMA.1121.00089,1,2672804,2676051,+,3247
243,BUMA.1121.00014,1,4200506,4203759,-,3253
243,BUMA.1121.00090,1,793927,797180,+,3253
243,BUMA.1121.00071,1,2648250,2651503,+,3253
243,BUMA.1121.00078,1,3288901,3292159,-,3258
243,BUMA.1121.00102,1,2571472,2574730,-,3258
243,BUMA.1121.00075,1,2211291,2214542,+,3251
243,BUMA.1121.00012,1,1449583,1452829,+,3246
243,BUMA.1121.00076,1,2597914,2601166,-,3252
243,BUMA.1121.00106,1,2459726,2462980,+,3254
243,BUMA.1121.00001,1,1366865,1370118,-,3253
243,BUMA.1121.00107,1,2659636,2662883,+,3247
243,BUMA.1121.00104,1,2528471,2531725,-,3254
243,BUMA.1121.00099,1,3693722,3696981,-,3259
243,BUMA.1121.00098,1,1380947,1384206,+,3259
243,BUMA.1121.00111,1,2887372,2890625,+,3253
243,BUMA.1121.00109,1,3192345,3195592,-,3247
243,BUMA.1121.00097,1,1208502,1211755,-,3253
243,BUMA.1121.00094,1,2701777,2705024,+,3247
243,BUMA.1121.00095,1,2996535,2999800,-,3265
243,BUMA.1121.00005,1,1423135,1426388,+,3253
243,BUMA.1121.00101,1,3727345,3730592,-,3247
243,BUMA.1121.00065,1,2775881,2779127,+,3246
243,BUMA.1121.00100,1,2652783,2656042,-,3259
243,BUMA.1121.00105,1,2480465,2483718,-,3253
243,BUMA.1121.00029,1,2251191,2254444,-,3253
243,BUMA.1121.00066,1,2633037,2636290,+,3253
243,BUMA.1121.00031,1,47242,50495,+,3253
243,BUMA.1121.00108,1,3757243,3760520,+,3277
243,BUMA.1121.00023,1,1035739,1038992,+,3253
243,BUMA.1121.00035,1,3869655,3872908,+,3253
243,BUMA.1121.00041,1,4004600,4007852,+,3252
242,BUMA.1121.00057,1,3814660,3830459,+,15799
242,BUMA.1121.00058,1,1809327,1825137,-,15810
242,BUMA.1121.00045,1,1344615,1360449,-,15834
242,BUMA.1121.00051,1,2670062,2685849,+,15787
242,BUMA.1121.00068,1,1474296,1490102,+,15806
242,BUMA.1121.00061,1,2643489,2659279,+,15790
242,BUMA.1121.00060,1,3589876,3605710,-,15834
242,BUMA.1121.00064,1,2709964,2725752,+,15788
242,BUMA.1121.00016,1,815119,830896,+,15777
242,BUMA.1121.00003,1,1191555,1207394,+,15839
242,BUMA.1121.00055,1,2380765,2396580,+,15815
242,BUMA.1121.00011,1,2946645,2962490,-,15845
242,BUMA.1121.00037,1,1303828,1319606,+,15778
242,BUMA.1121.00009,1,2863160,2878993,-,15833
242,BUMA.1121.00069,1,2612936,2628721,+,15785
242,BUMA.1121.00088,1,3614864,3630647,+,15783
242,BUMA.1121.00092,1,1062762,1078561,-,15799
242,BUMA.1121.00074,1,1148589,1164439,-,15850
242,BUMA.1121.00070,1,2614597,2630387,+,15790
242,BUMA.1121.00093,1,3547585,3563383,+,15798
242,BUMA.1121.00063,1,2640394,2656186,+,15792
242,BUMA.1121.00033,1,889848,905624,+,15776
242,BUMA.1121.00018,1,3294117,3309887,+,15770
242,BUMA.1121.00080,1,2701870,2717658,+,15788
242,BUMA.1121.00027,1,843784,859581,+,15797
242,BUMA.1121.00053,1,2461937,2477722,+,15785
242,BUMA.1121.00059,1,1932531,1948330,+,15799
242,BUMA.1121.00043,1,2773869,2789653,+,15784
242,BUMA.1121.00056,1,1254006,1269767,-,15761
242,BUMA.1121.00112,1,123395,139212,-,15817
242,BUMA.1121.00091,1,1801020,1816834,-,15814
242,BUMA.1121.00047,1,236186,252025,-,15839
242,BUMA.1121.00067,1,1703110,1718923,-,15813
242,BUMA.1121.00110,1,2104038,2119889,-,15851
242,BUMA.1121.00073,1,2641682,2657472,+,15790
242,BUMA.1121.00072,1,2615400,2631159,+,15759
242,BUMA.1121.00077,1,1363346,1379149,+,15803
242,BUMA.1121.00082,1,2799362,2815161,+,15799
242,BUMA.1121.00062,1,1845998,1861753,-,15755
242,BUMA.1121.00007,1,1344451,1360246,-,15795
242,BUMA.1121.00025,1,4099802,4115654,-,15852
242,BUMA.1121.00021,1,3300914,3316692,+,15778
242,BUMA.1121.00103,1,1693849,1709701,-,15852
242,BUMA.1121.00096,1,560872,576689,-,15817
242,BUMA.1121.00079,1,2736314,2752101,+,15787
242,BUMA.1121.00039,1,2839879,2855650,+,15771
242,BUMA.1121.00083,1,2964200,2979999,-,15799
242,BUMA.1121.00084,1,3069313,3085110,+,15797
242,BUMA.1121.00049,1,3115378,3131145,-,15767
242,BUMA.1121.00089,1,2656838,2672632,+,15794
242,BUMA.1121.00014,1,4203913,4219728,-,15815
242,BUMA.1121.00090,1,778013,793791,+,15778
242,BUMA.1121.00071,1,2632385,2648187,+,15802
242,BUMA.1121.00078,1,3292205,3307984,-,15779
242,BUMA.1121.00102,1,2574830,2590738,-,15908
242,BUMA.1121.00075,1,2195422,2211224,+,15802
242,BUMA.1121.00012,1,1433651,1449429,+,15778
242,BUMA.1121.00076,1,2601233,2616994,-,15761
242,BUMA.1121.00106,1,2443776,2459581,+,15805
242,BUMA.1121.00001,1,1371476,1387303,-,15827
242,BUMA.1121.00107,1,2643733,2659491,+,15758
242,BUMA.1121.00104,1,2531861,2547684,-,15823
242,BUMA.1121.00099,1,3697027,3712854,-,15827
242,BUMA.1121.00098,1,1365061,1380883,+,15822
242,BUMA.1121.00111,1,2871549,2887326,+,15777
242,BUMA.1121.00109,1,3195656,3211471,-,15815
242,BUMA.1121.00097,1,1211828,1227687,-,15859
242,BUMA.1121.00094,1,2685811,2701605,+,15794
242,BUMA.1121.00095,1,2999972,3015809,-,15837
242,BUMA.1121.00005,1,1407257,1422999,+,15742
242,BUMA.1121.00101,1,3730638,3746468,-,15830
242,BUMA.1121.00065,1,2759977,2775790,+,15813
242,BUMA.1121.00100,1,2656196,2672074,-,15878
242,BUMA.1121.00105,1,2483794,2499584,-,15790
242,BUMA.1121.00029,1,2254508,2270326,-,15818
242,BUMA.1121.00066,1,2617175,2632971,+,15796
242,BUMA.1121.00031,1,31356,47133,+,15777
242,BUMA.1121.00108,1,3741304,3757089,+,15785
242,BUMA.1121.00023,1,1019815,1035594,+,15779
242,BUMA.1121.00035,1,3853763,3869564,+,15801
242,BUMA.1121.00041,1,3988646,4004410,+,15764
241,BUMA.1121.00057,1,3810898,3814658,+,3760
241,BUMA.1121.00058,1,1825138,1828898,-,3760
241,BUMA.1121.00045,1,1360450,1364209,-,3759
241,BUMA.1121.00051,1,2666301,2670060,+,3759
241,BUMA.1121.00068,1,1470535,1474294,+,3759
241,BUMA.1121.00061,1,2639728,2643487,+,3759
241,BUMA.1121.00060,1,3605711,3609470,-,3759
241,BUMA.1121.00064,1,2706202,2709962,+,3760
241,BUMA.1121.00016,1,811359,815117,+,3758
241,BUMA.1121.00003,1,1187793,1191553,+,3760
241,BUMA.1121.00055,1,2377003,2380763,+,3760
241,BUMA.1121.00011,1,2962491,2966250,-,3759
241,BUMA.1121.00037,1,1300067,1303826,+,3759
241,BUMA.1121.00009,1,2878994,2882754,-,3760
241,BUMA.1121.00069,1,2609174,2612934,+,3760
241,BUMA.1121.00088,1,3611102,3614862,+,3760
241,BUMA.1121.00092,1,1078562,1082322,-,3760
241,BUMA.1121.00074,1,1164440,1168200,-,3760
241,BUMA.1121.00070,1,2610836,2614595,+,3759
241,BUMA.1121.00093,1,3543823,3547583,+,3760
241,BUMA.1121.00063,1,2636633,2640392,+,3759
241,BUMA.1121.00033,1,886087,889846,+,3759
241,BUMA.1121.00018,1,3290356,3294115,+,3759
241,BUMA.1121.00080,1,2698109,2701868,+,3759
241,BUMA.1121.00027,1,840022,843782,+,3760
241,BUMA.1121.00053,1,2458176,2461935,+,3759
241,BUMA.1121.00059,1,1928769,1932529,+,3760
241,BUMA.1121.00043,1,2770108,2773867,+,3759
241,BUMA.1121.00056,1,1269768,1273527,-,3759
241,BUMA.1121.00112,1,139213,142967,-,3754
241,BUMA.1121.00091,1,1816835,1820594,-,3759
241,BUMA.1121.00047,1,252026,255785,-,3759
241,BUMA.1121.00067,1,1718924,1722684,-,3760
241,BUMA.1121.00110,1,2119890,2123649,-,3759
241,BUMA.1121.00073,1,2637921,2641680,+,3759
241,BUMA.1121.00072,1,2611638,2615398,+,3760
241,BUMA.1121.00077,1,1359585,1363344,+,3759
241,BUMA.1121.00082,1,2795600,2799360,+,3760
241,BUMA.1121.00062,1,1861754,1865513,-,3759
241,BUMA.1121.00007,1,1360247,1364007,-,3760
241,BUMA.1121.00025,1,4115655,4119430,-,3775
241,BUMA.1121.00021,1,3297153,3300912,+,3759
241,BUMA.1121.00103,1,1709702,1713463,-,3761
241,BUMA.1121.00096,1,576690,580449,-,3759
241,BUMA.1121.00079,1,2732553,2736312,+,3759
241,BUMA.1121.00039,1,2836118,2839877,+,3759
241,BUMA.1121.00083,1,2980000,2983760,-,3760
241,BUMA.1121.00084,1,3065552,3069311,+,3759
241,BUMA.1121.00049,1,3131146,3134906,-,3760
241,BUMA.1121.00089,1,2653077,2656836,+,3759
241,BUMA.1121.00014,1,4219729,4223488,-,3759
241,BUMA.1121.00090,1,774252,778011,+,3759
241,BUMA.1121.00071,1,2628623,2632383,+,3760
241,BUMA.1121.00078,1,3307985,3311745,-,3760
241,BUMA.1121.00102,1,2590739,2594499,-,3760
241,BUMA.1121.00075,1,2191660,2195420,+,3760
241,BUMA.1121.00012,1,1429890,1433649,+,3759
241,BUMA.1121.00076,1,2618616,2622391,-,3775
241,BUMA.1121.00106,1,2440014,2443774,+,3760
241,BUMA.1121.00001,1,1387304,1391063,-,3759
241,BUMA.1121.00107,1,2639956,2643731,+,3775
241,BUMA.1121.00104,1,2547685,2551445,-,3760
241,BUMA.1121.00099,1,3712855,3716615,-,3760
241,BUMA.1121.00098,1,1361299,1365059,+,3760
241,BUMA.1121.00111,1,2867788,2871547,+,3759
241,BUMA.1121.00109,1,3211472,3215232,-,3760
241,BUMA.1121.00097,1,1227688,1231448,-,3760
241,BUMA.1121.00094,1,2682050,2685809,+,3759
241,BUMA.1121.00095,1,3015810,3019570,-,3760
241,BUMA.1121.00005,1,1403496,1407255,+,3759
241,BUMA.1121.00101,1,3746469,3750229,-,3760
241,BUMA.1121.00065,1,2756215,2759975,+,3760
241,BUMA.1121.00100,1,2672075,2675835,-,3760
241,BUMA.1121.00105,1,2499585,2503344,-,3759
241,BUMA.1121.00029,1,2270327,2274086,-,3759
241,BUMA.1121.00066,1,2613414,2617173,+,3759
241,BUMA.1121.00031,1,27595,31354,+,3759
241,BUMA.1121.00108,1,3737543,3741302,+,3759
241,BUMA.1121.00023,1,1016054,1019813,+,3759
241,BUMA.1121.00035,1,3850002,3853761,+,3759
241,BUMA.1121.00041,1,3984884,3988644,+,3760
240,BUMA.1121.00057,1,3806304,3809460,+,3156
240,BUMA.1121.00058,1,1830311,1833467,-,3156
240,BUMA.1121.00045,1,1365646,1368802,-,3156
240,BUMA.1121.00051,1,2661709,2664865,+,3156
240,BUMA.1121.00068,1,1465942,1469098,+,3156
240,BUMA.1121.00061,1,2635134,2638290,+,3156
240,BUMA.1121.00060,1,3610907,3614063,-,3156
240,BUMA.1121.00064,1,2701609,2704765,+,3156
240,BUMA.1121.00016,1,806766,809922,+,3156
240,BUMA.1121.00003,1,1183200,1186356,+,3156
240,BUMA.1121.00055,1,2372410,2375566,+,3156
240,BUMA.1121.00011,1,2967687,2970843,-,3156
240,BUMA.1121.00037,1,1295474,1298630,+,3156
240,BUMA.1121.00009,1,2884191,2887347,-,3156
240,BUMA.1121.00069,1,2604580,2607736,+,3156
240,BUMA.1121.00088,1,3606497,3609665,+,3168
240,BUMA.1121.00092,1,1083759,1086915,-,3156
240,BUMA.1121.00074,1,1169637,1172793,-,3156
240,BUMA.1121.00070,1,2606242,2609398,+,3156
240,BUMA.1121.00093,1,3539230,3542386,+,3156
240,BUMA.1121.00063,1,2632039,2635195,+,3156
240,BUMA.1121.00033,1,881495,884651,+,3156
240,BUMA.1121.00018,1,3285763,3288919,+,3156
240,BUMA.1121.00080,1,2693516,2696672,+,3156
240,BUMA.1121.00027,1,835429,838584,+,3155
240,BUMA.1121.00053,1,2453583,2456739,+,3156
240,BUMA.1121.00059,1,1924176,1927332,+,3156
240,BUMA.1121.00043,1,2765515,2768671,+,3156
240,BUMA.1121.00056,1,1274964,1278120,-,3156
240,BUMA.1121.00112,1,144404,147560,-,3156
240,BUMA.1121.00091,1,1822031,1825187,-,3156
240,BUMA.1121.00047,1,257222,260378,-,3156
240,BUMA.1121.00067,1,1724122,1727278,-,3156
240,BUMA.1121.00110,1,2125086,2128242,-,3156
240,BUMA.1121.00073,1,2633327,2636483,+,3156
240,BUMA.1121.00072,1,2607044,2610200,+,3156
240,BUMA.1121.00077,1,1354992,1358148,+,3156
240,BUMA.1121.00082,1,2791006,2794162,+,3156
240,BUMA.1121.00062,1,1866950,1870106,-,3156
240,BUMA.1121.00007,1,1365444,1368600,-,3156
240,BUMA.1121.00025,1,4162279,4165435,-,3156
240,BUMA.1121.00021,1,3292560,3295716,+,3156
240,BUMA.1121.00103,1,1714900,1718056,-,3156
240,BUMA.1121.00096,1,581886,585042,-,3156
240,BUMA.1121.00079,1,2727960,2731116,+,3156
240,BUMA.1121.00039,1,2831525,2834681,+,3156
240,BUMA.1121.00083,1,2985198,2988354,-,3156
240,BUMA.1121.00084,1,3060947,3064115,+,3168
240,BUMA.1121.00049,1,3136344,3139500,-,3156
240,BUMA.1121.00089,1,2648484,2651640,+,3156
240,BUMA.1121.00014,1,22,3193,-,3171
240,BUMA.1121.00090,1,769659,772815,+,3156
240,BUMA.1121.00071,1,2624029,2627185,+,3156
240,BUMA.1121.00078,1,3313182,3316338,-,3156
240,BUMA.1121.00102,1,2595937,2599093,-,3156
240,BUMA.1121.00075,1,2187071,2190225,+,3154
240,BUMA.1121.00012,1,1425297,1428453,+,3156
240,BUMA.1121.00076,1,2623828,2626984,-,3156
240,BUMA.1121.00106,1,2435420,2438576,+,3156
240,BUMA.1121.00001,1,1392500,1395656,-,3156
240,BUMA.1121.00107,1,2618971,2622127,+,3156
240,BUMA.1121.00104,1,2552882,2556038,-,3156
240,BUMA.1121.00099,1,3718052,3721208,-,3156
240,BUMA.1121.00098,1,1356706,1359862,+,3156
240,BUMA.1121.00111,1,2863195,2866351,+,3156
240,BUMA.1121.00109,1,3216645,3219801,-,3156
240,BUMA.1121.00097,1,1232885,1236047,-,3162
240,BUMA.1121.00094,1,2677456,2680613,+,3157
240,BUMA.1121.00095,1,3021008,3024164,-,3156
240,BUMA.1121.00005,1,1398908,1402059,+,3151
240,BUMA.1121.00101,1,3751666,3754822,-,3156
240,BUMA.1121.00065,1,2751622,2754778,+,3156
240,BUMA.1121.00100,1,2677272,2680428,-,3156
240,BUMA.1121.00105,1,2504781,2507937,-,3156
240,BUMA.1121.00029,1,2275523,2278679,-,3156
240,BUMA.1121.00066,1,2608820,2611976,+,3156
240,BUMA.1121.00031,1,23002,26158,+,3156
240,BUMA.1121.00108,1,3732950,3736106,+,3156
240,BUMA.1121.00023,1,1011461,1014617,+,3156
240,BUMA.1121.00035,1,3845409,3848565,+,3156
240,BUMA.1121.00041,1,3980291,3983447,+,3156
239,BUMA.1121.00057,1,3797941,3802596,+,4655
239,BUMA.1121.00058,1,1837175,1841831,-,4656
239,BUMA.1121.00045,1,1372510,1377166,-,4656
239,BUMA.1121.00051,1,2653346,2658001,+,4655
239,BUMA.1121.00068,1,1457580,1462234,+,4654
239,BUMA.1121.00061,1,2626771,2631426,+,4655
239,BUMA.1121.00060,1,3617771,3622427,-,4656
239,BUMA.1121.00064,1,2693246,2697901,+,4655
239,BUMA.1121.00016,1,798403,803058,+,4655
239,BUMA.1121.00003,1,1174837,1179492,+,4655
239,BUMA.1121.00055,1,2364047,2368702,+,4655
239,BUMA.1121.00011,1,2974551,2979207,-,4656
239,BUMA.1121.00037,1,1287111,1291766,+,4655
239,BUMA.1121.00009,1,2891055,2895711,-,4656
239,BUMA.1121.00069,1,2596217,2600872,+,4655
239,BUMA.1121.00088,1,3598134,3602789,+,4655
239,BUMA.1121.00092,1,1090623,1095278,-,4655
239,BUMA.1121.00074,1,1176501,1181157,-,4656
239,BUMA.1121.00070,1,2597879,2602534,+,4655
239,BUMA.1121.00093,1,3530868,3535522,+,4654
239,BUMA.1121.00063,1,2623676,2628331,+,4655
239,BUMA.1121.00033,1,873132,877787,+,4655
239,BUMA.1121.00018,1,3277400,3282055,+,4655
239,BUMA.1121.00080,1,2685153,2689808,+,4655
239,BUMA.1121.00027,1,827066,831721,+,4655
239,BUMA.1121.00053,1,2445220,2449875,+,4655
239,BUMA.1121.00059,1,1915813,1920468,+,4655
239,BUMA.1121.00043,1,2757152,2761807,+,4655
239,BUMA.1121.00056,1,1281828,1286484,-,4656
239,BUMA.1121.00112,1,151268,155924,-,4656
239,BUMA.1121.00091,1,1828895,1833551,-,4656
239,BUMA.1121.00047,1,264086,268742,-,4656
239,BUMA.1121.00067,1,1730986,1735642,-,4656
239,BUMA.1121.00110,1,2131950,2136610,-,4660
239,BUMA.1121.00073,1,2624964,2629619,+,4655
239,BUMA.1121.00072,1,2598681,2603336,+,4655
239,BUMA.1121.00077,1,1346625,1351284,+,4659
239,BUMA.1121.00082,1,2782643,2787298,+,4655
239,BUMA.1121.00062,1,1873814,1878469,-,4655
239,BUMA.1121.00007,1,1372308,1376968,-,4660
239,BUMA.1121.00025,1,4169143,4173799,-,4656
239,BUMA.1121.00021,1,3284197,3288852,+,4655
239,BUMA.1121.00103,1,1721764,1726419,-,4655
239,BUMA.1121.00096,1,588750,593406,-,4656
239,BUMA.1121.00079,1,2719597,2724252,+,4655
239,BUMA.1121.00039,1,2823162,2827817,+,4655
239,BUMA.1121.00083,1,2992062,2996718,-,4656
239,BUMA.1121.00084,1,3052584,3057239,+,4655
239,BUMA.1121.00049,1,3143208,3147863,-,4655
239,BUMA.1121.00089,1,2640121,2644776,+,4655
239,BUMA.1121.00014,1,6901,11557,-,4656
239,BUMA.1121.00090,1,761296,765951,+,4655
239,BUMA.1121.00071,1,2615666,2620321,+,4655
239,BUMA.1121.00078,1,3320046,3324702,-,4656
239,BUMA.1121.00102,1,2602801,2607457,-,4656
239,BUMA.1121.00075,1,2178708,2183363,+,4655
239,BUMA.1121.00012,1,1416934,1421589,+,4655
239,BUMA.1121.00076,1,2630692,2635348,-,4656
239,BUMA.1121.00106,1,2427057,2431712,+,4655
239,BUMA.1121.00001,1,1399364,1404020,-,4656
239,BUMA.1121.00107,1,2610608,2615263,+,4655
239,BUMA.1121.00104,1,2557943,2562614,-,4671
239,BUMA.1121.00099,1,3724916,3729572,-,4656
239,BUMA.1121.00098,1,1348343,1352998,+,4655
239,BUMA.1121.00111,1,2854833,2859487,+,4654
239,BUMA.1121.00109,1,3223509,3228169,-,4660
239,BUMA.1121.00097,1,1239755,1244411,-,4656
239,BUMA.1121.00094,1,2669093,2673748,+,4655
239,BUMA.1121.00095,1,3027872,3032528,-,4656
239,BUMA.1121.00005,1,1390545,1395200,+,4655
239,BUMA.1121.00101,1,3758530,3763186,-,4656
239,BUMA.1121.00065,1,2743259,2747914,+,4655
239,BUMA.1121.00100,1,2684136,2688792,-,4656
239,BUMA.1121.00105,1,2511645,2516301,-,4656
239,BUMA.1121.00029,1,2282387,2287043,-,4656
239,BUMA.1121.00066,1,2600457,2605112,+,4655
239,BUMA.1121.00031,1,14639,19294,+,4655
239,BUMA.1121.00108,1,3724587,3729242,+,4655
239,BUMA.1121.00023,1,1003098,1007753,+,4655
239,BUMA.1121.00035,1,3837046,3841701,+,4655
239,BUMA.1121.00041,1,3971928,3976583,+,4655
238,BUMA.1121.00057,1,3783267,3797786,+,14519
238,BUMA.1121.00058,1,1841875,1856381,-,14506
238,BUMA.1121.00045,1,1377251,1391680,-,14429
238,BUMA.1121.00051,1,2638642,2653212,+,14570
238,BUMA.1121.00068,1,1442975,1457467,+,14492
238,BUMA.1121.00061,1,2612118,2626630,+,14512
238,BUMA.1121.00060,1,3622505,3636934,-,14429
238,BUMA.1121.00064,1,2678554,2693154,+,14600
238,BUMA.1121.00016,1,783779,798332,+,14553
238,BUMA.1121.00003,1,1160237,1174717,+,14480
238,BUMA.1121.00055,1,2349178,2363941,+,14763
238,BUMA.1121.00011,1,2979362,2993846,-,14484
238,BUMA.1121.00037,1,1272390,1286984,+,14594
238,BUMA.1121.00009,1,2895803,2910391,-,14588
238,BUMA.1121.00069,1,2581539,2596076,+,14537
238,BUMA.1121.00088,1,3583535,3598063,+,14528
238,BUMA.1121.00092,1,1095370,1109911,-,14541
238,BUMA.1121.00074,1,1181221,1195837,-,14616
238,BUMA.1121.00070,1,2583226,2597738,+,14512
238,BUMA.1121.00093,1,3516241,3530783,+,14542
238,BUMA.1121.00063,1,2609014,2623535,+,14521
238,BUMA.1121.00033,1,858538,873082,+,14544
238,BUMA.1121.00018,1,3262704,3277294,+,14590
238,BUMA.1121.00080,1,2670507,2685054,+,14547
238,BUMA.1121.00027,1,812422,826939,+,14517
238,BUMA.1121.00053,1,2430531,2445128,+,14597
238,BUMA.1121.00059,1,1901175,1915735,+,14560
238,BUMA.1121.00043,1,2742446,2757018,+,14572
238,BUMA.1121.00056,1,1286562,1301088,-,14526
238,BUMA.1121.00112,1,155995,170506,-,14511
238,BUMA.1121.00091,1,1833622,1848189,-,14567
238,BUMA.1121.00047,1,268834,283397,-,14563
238,BUMA.1121.00067,1,1735741,1750225,-,14484
238,BUMA.1121.00110,1,2136723,2151091,-,14368
238,BUMA.1121.00073,1,2610305,2624823,+,14518
238,BUMA.1121.00072,1,2584003,2598547,+,14544
238,BUMA.1121.00077,1,1332142,1346512,+,14370
238,BUMA.1121.00082,1,2767965,2782502,+,14537
238,BUMA.1121.00062,1,1878547,1893068,-,14521
238,BUMA.1121.00007,1,1377067,1391585,-,14518
238,BUMA.1121.00025,1,4173898,4188487,-,14589
238,BUMA.1121.00021,1,3269443,3284050,+,14607
238,BUMA.1121.00103,1,1726458,1740945,-,14487
238,BUMA.1121.00096,1,593445,607996,-,14551
238,BUMA.1121.00079,1,2704921,2719449,+,14528
238,BUMA.1121.00039,1,2808444,2823098,+,14654
238,BUMA.1121.00083,1,2996859,3011395,-,14536
238,BUMA.1121.00084,1,3037999,3052513,+,14514
238,BUMA.1121.00049,1,3147913,3162437,-,14524
238,BUMA.1121.00089,1,2625511,2640043,+,14532
238,BUMA.1121.00014,1,11684,26253,-,14569
238,BUMA.1121.00090,1,746564,761169,+,14605
238,BUMA.1121.00071,1,2600988,2615525,+,14537
238,BUMA.1121.00078,1,3324788,3339276,-,14488
238,BUMA.1121.00102,1,2607549,2622227,-,14678
238,BUMA.1121.00075,1,2163921,2178602,+,14681
238,BUMA.1121.00012,1,1402304,1416870,+,14566
238,BUMA.1121.00076,1,2635447,2650119,-,14672
238,BUMA.1121.00106,1,2412409,2426993,+,14584
238,BUMA.1121.00001,1,1404119,1418652,-,14533
238,BUMA.1121.00107,1,2595927,2610481,+,14554
238,BUMA.1121.00104,1,2562734,2577283,-,14549
238,BUMA.1121.00099,1,3729657,3744161,-,14504
238,BUMA.1121.00098,1,1333707,1348230,+,14523
238,BUMA.1121.00111,1,2840195,2854748,+,14553
238,BUMA.1121.00109,1,3228296,3242802,-,14506
238,BUMA.1121.00097,1,1244480,1259094,-,14614
238,BUMA.1121.00094,1,2654483,2669015,+,14532
238,BUMA.1121.00095,1,3032567,3046956,-,14389
238,BUMA.1121.00005,1,1375910,1390481,+,14571
238,BUMA.1121.00101,1,3763271,3777860,-,14589
238,BUMA.1121.00065,1,2728663,2743174,+,14511
238,BUMA.1121.00100,1,2688891,2703444,-,14553
238,BUMA.1121.00105,1,2516386,2530930,-,14544
238,BUMA.1121.00029,1,2287156,2301719,-,14563
238,BUMA.1121.00066,1,2585779,2600323,+,14544
238,BUMA.1121.00031,1,25,14589,+,14564
238,BUMA.1121.00108,1,3710040,3724495,+,14455
238,BUMA.1121.00023,1,988455,1003013,+,14558
238,BUMA.1121.00035,1,3822444,3836968,+,14524
238,BUMA.1121.00041,1,3955799,3970283,+,14484
237,BUMA.1121.00057,1,3730518,3777686,+,47168
237,BUMA.1121.00058,1,1860333,1907485,-,47152
237,BUMA.1121.00045,1,1395687,1442873,-,47186
237,BUMA.1121.00051,1,2585897,2633082,+,47185
237,BUMA.1121.00068,1,1390253,1437409,+,47156
237,BUMA.1121.00061,1,2559450,2606563,+,47113
237,BUMA.1121.00060,1,3640941,3688127,-,47186
237,BUMA.1121.00064,1,2627428,2674610,+,47182
237,BUMA.1121.00016,1,731098,778242,+,47144
237,BUMA.1121.00003,1,1107539,1154698,+,47159
237,BUMA.1121.00055,1,2298023,2345234,+,47211
237,BUMA.1121.00011,1,2997783,3045085,-,47302
237,BUMA.1121.00037,1,1219686,1266853,+,47167
237,BUMA.1121.00009,1,2914336,2961473,-,47137
237,BUMA.1121.00069,1,2528867,2575984,+,47117
237,BUMA.1121.00088,1,3530857,3577996,+,47139
237,BUMA.1121.00092,1,1115458,1162580,-,47122
237,BUMA.1121.00074,1,1199782,1246961,-,47179
237,BUMA.1121.00070,1,2530516,2577687,+,47171
237,BUMA.1121.00093,1,3463573,3510695,+,47122
237,BUMA.1121.00063,1,2556391,2603503,+,47112
237,BUMA.1121.00033,1,805826,852986,+,47160
237,BUMA.1121.00018,1,3208411,3255571,+,47160
237,BUMA.1121.00080,1,2616162,2663345,+,47183
237,BUMA.1121.00027,1,759678,806841,+,47163
237,BUMA.1121.00053,1,2377804,2424993,+,47189
237,BUMA.1121.00059,1,1850103,1897231,+,47128
237,BUMA.1121.00043,1,2691350,2738496,+,47146
237,BUMA.1121.00056,1,1306642,1353871,-,47229
237,BUMA.1121.00112,1,176110,223302,-,47192
237,BUMA.1121.00091,1,1853736,1900922,-,47186
237,BUMA.1121.00047,1,288958,336170,-,47212
237,BUMA.1121.00067,1,1754170,1801344,-,47174
237,BUMA.1121.00110,1,2155035,2202202,-,47167
237,BUMA.1121.00073,1,2557622,2604752,+,47130
237,BUMA.1121.00072,1,2531333,2578469,+,47136
237,BUMA.1121.00077,1,1281033,1328199,+,47166
237,BUMA.1121.00082,1,2715213,2762384,+,47171
237,BUMA.1121.00062,1,1898615,1945785,-,47170
237,BUMA.1121.00007,1,1397138,1444262,-,47124
237,BUMA.1121.00025,1,4111,51271,-,47160
237,BUMA.1121.00021,1,3216720,3263898,+,47178
237,BUMA.1121.00103,1,1744889,1792080,-,47191
237,BUMA.1121.00096,1,611941,659124,-,47183
237,BUMA.1121.00079,1,2652222,2699382,+,47160
237,BUMA.1121.00039,1,2754167,2801313,+,47146
237,BUMA.1121.00083,1,3016977,3064148,-,47171
237,BUMA.1121.00084,1,2985257,3032453,+,47196
237,BUMA.1121.00049,1,3166382,3213513,-,47131
237,BUMA.1121.00089,1,2572729,2619958,+,47229
237,BUMA.1121.00014,1,31807,78996,-,47189
237,BUMA.1121.00090,1,693852,741026,+,47174
237,BUMA.1121.00071,1,2548411,2595518,+,47107
237,BUMA.1121.00078,1,3346403,3393583,-,47180
237,BUMA.1121.00102,1,2627765,2674936,-,47171
237,BUMA.1121.00075,1,2112800,2159921,+,47121
237,BUMA.1121.00012,1,1349936,1398325,+,48389
237,BUMA.1121.00076,1,2654127,2701268,-,47141
237,BUMA.1121.00106,1,2361335,2408458,+,47123
237,BUMA.1121.00001,1,1425786,1472958,-,47172
237,BUMA.1121.00107,1,2543182,2590361,+,47179
237,BUMA.1121.00104,1,2581228,2628390,-,47162
237,BUMA.1121.00099,1,3751327,3798469,-,47142
237,BUMA.1121.00098,1,1279345,1326549,+,47204
237,BUMA.1121.00111,1,2787513,2834658,+,47145
237,BUMA.1121.00109,1,3248341,3295597,-,47256
237,BUMA.1121.00097,1,1264704,1311955,-,47251
237,BUMA.1121.00094,1,2601683,2648931,+,47248
237,BUMA.1121.00095,1,3052521,3099686,-,47165
237,BUMA.1121.00005,1,1321949,1369060,+,47111
237,BUMA.1121.00101,1,3783482,3830641,-,47159
237,BUMA.1121.00065,1,2677531,2724692,+,47161
237,BUMA.1121.00100,1,2707389,2754501,-,47112
237,BUMA.1121.00105,1,2536477,2583601,-,47124
237,BUMA.1121.00029,1,2308854,2356022,-,47168
237,BUMA.1121.00066,1,2533131,2580233,+,47102
237,BUMA.1121.00031,1,4024959,4072148,+,47189
237,BUMA.1121.00108,1,3658984,3706041,+,47057
237,BUMA.1121.00023,1,937336,984483,+,47147
237,BUMA.1121.00035,1,3768148,3815310,+,47162
237,BUMA.1121.00041,1,3903087,3950262,+,47175
236,BUMA.1121.00057,1,3715492,3730516,+,15024
236,BUMA.1121.00058,1,1907486,1922513,-,15027
236,BUMA.1121.00045,1,1442874,1457883,-,15009
236,BUMA.1121.00051,1,2569539,2585895,+,16356
236,BUMA.1121.00068,1,1329409,1344462,+,15053
236,BUMA.1121.00061,1,2544438,2559448,+,15010
236,BUMA.1121.00060,1,3688128,3703137,-,15009
236,BUMA.1121.00064,1,2612398,2627426,+,15028
236,BUMA.1121.00016,1,704351,719380,+,15029
236,BUMA.1121.00003,1,1092534,1107537,+,15003
236,BUMA.1121.00055,1,2239106,2254131,+,15025
236,BUMA.1121.00011,1,3045086,3060096,-,15010
236,BUMA.1121.00037,1,1204649,1219684,+,15035
236,BUMA.1121.00009,1,2963879,2978901,-,15022
236,BUMA.1121.00069,1,2513855,2528865,+,15010
236,BUMA.1121.00088,1,3515816,3530855,+,15039
236,BUMA.1121.00092,1,1205959,1220998,-,15039
236,BUMA.1121.00074,1,1246962,1261981,-,15019
236,BUMA.1121.00070,1,2515504,2530514,+,15010
236,BUMA.1121.00093,1,3405154,3420194,+,15040
236,BUMA.1121.00063,1,2541379,2556389,+,15010
236,BUMA.1121.00033,1,779049,794090,+,15041
236,BUMA.1121.00018,1,3193397,3208409,+,15012
236,BUMA.1121.00080,1,2599798,2616160,+,16362
236,BUMA.1121.00027,1,744652,759676,+,15024
236,BUMA.1121.00053,1,2362773,2377802,+,15029
236,BUMA.1121.00059,1,1788687,1803721,+,15034
236,BUMA.1121.00043,1,2664605,2679631,+,15026
236,BUMA.1121.00056,1,1353872,1370234,-,16362
236,BUMA.1121.00112,1,270761,285804,-,15043
236,BUMA.1121.00091,1,1900923,1915948,-,15025
236,BUMA.1121.00047,1,336171,352533,-,16362
236,BUMA.1121.00067,1,1801345,1816357,-,15012
236,BUMA.1121.00110,1,2202203,2217207,-,15004
236,BUMA.1121.00073,1,2542610,2557620,+,15010
236,BUMA.1121.00072,1,2516324,2531331,+,15007
236,BUMA.1121.00077,1,1266027,1281031,+,15004
236,BUMA.1121.00082,1,2700201,2715211,+,15010
236,BUMA.1121.00062,1,1990193,2005228,-,15035
236,BUMA.1121.00007,1,1488930,1503970,-,15040
236,BUMA.1121.00025,1,51272,66284,-,15012
236,BUMA.1121.00021,1,3201717,3216718,+,15001
236,BUMA.1121.00103,1,1835880,1850899,-,15019
236,BUMA.1121.00096,1,659125,674129,-,15004
236,BUMA.1121.00079,1,2595493,2611835,+,16342
236,BUMA.1121.00039,1,2739141,2754165,+,15024
236,BUMA.1121.00083,1,3064149,3079159,-,15010
236,BUMA.1121.00084,1,2970220,2985255,+,15035
236,BUMA.1121.00049,1,3259967,3275023,-,15056
236,BUMA.1121.00089,1,2556365,2572727,+,16362
236,BUMA.1121.00014,1,78997,94037,-,15040
236,BUMA.1121.00090,1,678826,693850,+,15024
236,BUMA.1121.00071,1,2533400,2548409,+,15009
236,BUMA.1121.00078,1,3442961,3458645,-,15684
236,BUMA.1121.00102,1,2674937,2689976,-,15039
236,BUMA.1121.00075,1,2049914,2064928,+,15014
236,BUMA.1121.00012,1,1321143,1336192,+,15049
236,BUMA.1121.00076,1,2749140,2764153,-,15013
236,BUMA.1121.00106,1,2346312,2361333,+,15021
236,BUMA.1121.00001,1,1472959,1487971,-,15012
236,BUMA.1121.00107,1,2482811,2497863,+,15052
236,BUMA.1121.00104,1,2628391,2643432,-,15041
236,BUMA.1121.00099,1,3844275,3859291,-,15016
236,BUMA.1121.00098,1,1214893,1229927,+,15034
236,BUMA.1121.00111,1,2758732,2773770,+,15038
236,BUMA.1121.00109,1,3295598,3310604,-,15006
236,BUMA.1121.00097,1,1327084,1342112,-,15028
236,BUMA.1121.00094,1,2586661,2601681,+,15020
236,BUMA.1121.00095,1,3099687,3114724,-,15037
236,BUMA.1121.00005,1,1306936,1321947,+,15011
236,BUMA.1121.00101,1,3830642,3845677,-,15035
236,BUMA.1121.00065,1,2662483,2677529,+,15046
236,BUMA.1121.00100,1,2754502,2769518,-,15016
236,BUMA.1121.00105,1,2633785,2648808,-,15023
236,BUMA.1121.00029,1,2356023,2371036,-,15013
236,BUMA.1121.00066,1,2518112,2533129,+,15017
236,BUMA.1121.00031,1,4009933,4024957,+,15024
236,BUMA.1121.00108,1,3595953,3610985,+,15032
236,BUMA.1121.00023,1,922324,937334,+,15010
236,BUMA.1121.00035,1,3753133,3768146,+,15013
236,BUMA.1121.00041,1,3888079,3903085,+,15006
235,BUMA.1121.00057,1,3677916,3715491,+,37575
235,BUMA.1121.00058,1,1977625,2015130,-,37505
235,BUMA.1121.00045,1,1457885,1495417,-,37532
235,BUMA.1121.00051,1,2531898,2569538,+,37640
235,BUMA.1121.00068,1,1291946,1329408,+,37462
235,BUMA.1121.00061,1,2506899,2544437,+,37538
235,BUMA.1121.00060,1,3703139,3740671,-,37532
235,BUMA.1121.00064,1,2574893,2612397,+,37504
235,BUMA.1121.00016,1,666747,704350,+,37603
235,BUMA.1121.00003,1,1055011,1092533,+,37522
235,BUMA.1121.00055,1,2201528,2239105,+,37577
235,BUMA.1121.00011,1,3060098,3097741,-,37643
235,BUMA.1121.00037,1,1167182,1204648,+,37466
235,BUMA.1121.00009,1,2978903,3016551,-,37648
235,BUMA.1121.00069,1,2476280,2513854,+,37574
235,BUMA.1121.00088,1,3478291,3515815,+,37524
235,BUMA.1121.00092,1,1221000,1258621,-,37621
235,BUMA.1121.00074,1,1261983,1299502,-,37519
235,BUMA.1121.00070,1,2477928,2515503,+,37575
235,BUMA.1121.00093,1,3367646,3405153,+,37507
235,BUMA.1121.00063,1,2503803,2541378,+,37575
235,BUMA.1121.00033,1,741441,779048,+,37607
235,BUMA.1121.00018,1,3155840,3193396,+,37556
235,BUMA.1121.00080,1,2562156,2599797,+,37641
235,BUMA.1121.00027,1,707077,744651,+,37574
235,BUMA.1121.00053,1,2275483,2313143,+,37660
235,BUMA.1121.00059,1,1751091,1788686,+,37595
235,BUMA.1121.00043,1,2626868,2664604,+,37736
235,BUMA.1121.00056,1,1370236,1407887,-,37651
235,BUMA.1121.00112,1,387448,425001,-,37553
235,BUMA.1121.00091,1,1915950,1953438,-,37488
235,BUMA.1121.00047,1,352535,390202,-,37667
235,BUMA.1121.00067,1,1816359,1853881,-,37522
235,BUMA.1121.00110,1,2217209,2254820,-,37611
235,BUMA.1121.00073,1,2505034,2542609,+,37575
235,BUMA.1121.00072,1,2478750,2516323,+,37573
235,BUMA.1121.00077,1,1228414,1266026,+,37612
235,BUMA.1121.00082,1,2662625,2700200,+,37575
235,BUMA.1121.00062,1,2005230,2042731,-,37501
235,BUMA.1121.00007,1,1503972,1541490,-,37518
235,BUMA.1121.00025,1,66286,103841,-,37555
235,BUMA.1121.00021,1,3164260,3201716,+,37456
235,BUMA.1121.00103,1,1850901,1888533,-,37632
235,BUMA.1121.00096,1,674131,711741,-,37610
235,BUMA.1121.00079,1,2557842,2595492,+,37650
235,BUMA.1121.00039,1,2701498,2739140,+,37642
235,BUMA.1121.00083,1,3079161,3116735,-,37574
235,BUMA.1121.00084,1,2932697,2970219,+,37522
235,BUMA.1121.00049,1,3275025,3312546,-,37521
235,BUMA.1121.00089,1,2518712,2556364,+,37652
235,BUMA.1121.00014,1,206586,244186,-,37600
235,BUMA.1121.00090,1,641217,678825,+,37608
235,BUMA.1121.00071,1,2495830,2533399,+,37569
235,BUMA.1121.00078,1,3458647,3496215,-,37568
235,BUMA.1121.00102,1,2740947,2778544,-,37597
235,BUMA.1121.00075,1,2012406,2049913,+,37507
235,BUMA.1121.00012,1,1283566,1321142,+,37576
235,BUMA.1121.00076,1,2764155,2801665,-,37510
235,BUMA.1121.00106,1,2308773,2346311,+,37538
235,BUMA.1121.00001,1,1487973,1525445,-,37472
235,BUMA.1121.00107,1,2435454,2473146,+,37692
235,BUMA.1121.00104,1,2643434,2680960,-,37526
235,BUMA.1121.00099,1,3859293,3896742,-,37449
235,BUMA.1121.00098,1,1177301,1214892,+,37591
235,BUMA.1121.00111,1,2721184,2758731,+,37547
235,BUMA.1121.00109,1,3310606,3348171,-,37565
235,BUMA.1121.00097,1,1342114,1379616,-,37502
235,BUMA.1121.00094,1,2549025,2586660,+,37635
235,BUMA.1121.00095,1,3114726,3152345,-,37619
235,BUMA.1121.00005,1,1269441,1306935,+,37494
235,BUMA.1121.00101,1,3845679,3883387,-,37708
235,BUMA.1121.00065,1,2624994,2662482,+,37488
235,BUMA.1121.00100,1,2769520,2807187,-,37667
235,BUMA.1121.00105,1,2648810,2686434,-,37624
235,BUMA.1121.00029,1,2371038,2408521,-,37483
235,BUMA.1121.00066,1,2480538,2518111,+,37573
235,BUMA.1121.00031,1,3972321,4009932,+,37611
235,BUMA.1121.00108,1,3558337,3595952,+,37615
235,BUMA.1121.00023,1,884652,922323,+,37671
235,BUMA.1121.00035,1,3715621,3753132,+,37511
235,BUMA.1121.00041,1,3850462,3888078,+,37616
234,BUMA.1121.00057,1,3672271,3676651,+,4380
234,BUMA.1121.00058,1,2016396,2020788,-,4392
234,BUMA.1121.00045,1,1496683,1501052,-,4369
234,BUMA.1121.00051,1,2526277,2530633,+,4356
234,BUMA.1121.00068,1,1286282,1290681,+,4399
234,BUMA.1121.00061,1,2501290,2505634,+,4344
234,BUMA.1121.00060,1,3741937,3746306,-,4369
234,BUMA.1121.00064,1,2569259,2573628,+,4369
234,BUMA.1121.00016,1,661102,665482,+,4380
234,BUMA.1121.00003,1,1049360,1053746,+,4386
234,BUMA.1121.00055,1,2195877,2200263,+,4386
234,BUMA.1121.00011,1,3099007,3103364,-,4357
234,BUMA.1121.00037,1,1161549,1165917,+,4368
234,BUMA.1121.00009,1,3017807,3022220,-,4413
234,BUMA.1121.00069,1,2470671,2475015,+,4344
234,BUMA.1121.00088,1,3472658,3477026,+,4368
234,BUMA.1121.00092,1,1259887,1264261,-,4374
234,BUMA.1121.00074,1,1300768,1305130,-,4362
234,BUMA.1121.00070,1,2472319,2476663,+,4344
234,BUMA.1121.00093,1,3362007,3366381,+,4374
234,BUMA.1121.00063,1,2498194,2502538,+,4344
234,BUMA.1121.00033,1,735789,740176,+,4387
234,BUMA.1121.00018,1,3150195,3154575,+,4380
234,BUMA.1121.00080,1,2556501,2560891,+,4390
234,BUMA.1121.00027,1,701427,705812,+,4385
234,BUMA.1121.00053,1,2269856,2274218,+,4362
234,BUMA.1121.00059,1,1745440,1749826,+,4386
234,BUMA.1121.00043,1,2621233,2625603,+,4370
234,BUMA.1121.00056,1,1409153,1413515,-,4362
234,BUMA.1121.00112,1,426267,430637,-,4370
234,BUMA.1121.00091,1,1954704,1959084,-,4380
234,BUMA.1121.00047,1,391468,395812,-,4344
234,BUMA.1121.00067,1,1855147,1859521,-,4374
234,BUMA.1121.00110,1,2256086,2260471,-,4385
234,BUMA.1121.00073,1,2499425,2503769,+,4344
234,BUMA.1121.00072,1,2473141,2477485,+,4344
234,BUMA.1121.00077,1,1222763,1227148,+,4385
234,BUMA.1121.00082,1,2657016,2661360,+,4344
234,BUMA.1121.00062,1,2043997,2048371,-,4374
234,BUMA.1121.00007,1,1542756,1547106,-,4350
234,BUMA.1121.00025,1,105107,109487,-,4380
234,BUMA.1121.00021,1,3158651,3162995,+,4344
234,BUMA.1121.00103,1,1889799,1894165,-,4366
234,BUMA.1121.00096,1,713007,717375,-,4368
234,BUMA.1121.00079,1,2552175,2556577,+,4402
234,BUMA.1121.00039,1,2695817,2700233,+,4416
234,BUMA.1121.00083,1,3118001,3122345,-,4344
234,BUMA.1121.00084,1,2927070,2931432,+,4362
234,BUMA.1121.00049,1,3313812,3318174,-,4362
234,BUMA.1121.00089,1,2513085,2517447,+,4362
234,BUMA.1121.00014,1,245452,249820,-,4368
234,BUMA.1121.00090,1,635578,639952,+,4374
234,BUMA.1121.00071,1,2490221,2494565,+,4344
234,BUMA.1121.00078,1,3497479,3501847,-,4368
234,BUMA.1121.00102,1,2779810,2784196,-,4386
234,BUMA.1121.00075,1,2006773,2011141,+,4368
234,BUMA.1121.00012,1,1277933,1282301,+,4368
234,BUMA.1121.00076,1,2802931,2807299,-,4368
234,BUMA.1121.00106,1,2303134,2307508,+,4374
234,BUMA.1121.00001,1,1526711,1531099,-,4388
234,BUMA.1121.00107,1,2429802,2434189,+,4387
234,BUMA.1121.00104,1,2682226,2686594,-,4368
234,BUMA.1121.00099,1,3898008,3902407,-,4399
234,BUMA.1121.00098,1,1171680,1176036,+,4356
234,BUMA.1121.00111,1,2715545,2719919,+,4374
234,BUMA.1121.00109,1,3349437,3353847,-,4410
234,BUMA.1121.00097,1,1380882,1385250,-,4368
234,BUMA.1121.00097,1,1748479,1752709,+,4230
234,BUMA.1121.00094,1,2543380,2547760,+,4380
234,BUMA.1121.00095,1,3153610,3157993,-,4383
234,BUMA.1121.00005,1,1263803,1268176,+,4373
234,BUMA.1121.00101,1,3884654,3889022,-,4368
234,BUMA.1121.00065,1,2619360,2623729,+,4369
234,BUMA.1121.00100,1,2808443,2812854,-,4411
234,BUMA.1121.00105,1,2687700,2692051,-,4351
234,BUMA.1121.00029,1,2409787,2414168,-,4381
234,BUMA.1121.00066,1,2474929,2479273,+,4344
234,BUMA.1121.00031,1,3966688,3971056,+,4368
234,BUMA.1121.00108,1,3552677,3557072,+,4395
234,BUMA.1121.00023,1,879037,883387,+,4350
234,BUMA.1121.00035,1,3709975,3714356,+,4381
234,BUMA.1121.00041,1,3844803,3849197,+,4394
233,BUMA.1121.00057,1,3663168,3672269,+,9101
233,BUMA.1121.00058,1,2020789,2029917,-,9128
233,BUMA.1121.00045,1,1501053,1510143,-,9090
233,BUMA.1121.00051,1,2517173,2526275,+,9102
233,BUMA.1121.00068,1,1277191,1286280,+,9089
233,BUMA.1121.00061,1,2492233,2501288,+,9055
233,BUMA.1121.00060,1,3746307,3755397,-,9090
233,BUMA.1121.00064,1,2560156,2569257,+,9101
233,BUMA.1121.00016,1,651999,661100,+,9101
233,BUMA.1121.00003,1,1040258,1049358,+,9100
233,BUMA.1121.00055,1,2186789,2195875,+,9086
233,BUMA.1121.00011,1,3103365,3112434,-,9069
233,BUMA.1121.00037,1,1152504,1161547,+,9043
233,BUMA.1121.00009,1,3022221,3031307,-,9086
233,BUMA.1121.00069,1,2461614,2470669,+,9055
233,BUMA.1121.00088,1,3463562,3472656,+,9094
233,BUMA.1121.00092,1,1264262,1273364,-,9102
233,BUMA.1121.00074,1,1305131,1314233,-,9102
233,BUMA.1121.00070,1,2463262,2472317,+,9055
233,BUMA.1121.00093,1,3352904,3362005,+,9101
233,BUMA.1121.00063,1,2489137,2498192,+,9055
233,BUMA.1121.00033,1,726686,735787,+,9101
233,BUMA.1121.00018,1,3141149,3150193,+,9044
233,BUMA.1121.00080,1,2547397,2556499,+,9102
233,BUMA.1121.00027,1,692373,701425,+,9052
233,BUMA.1121.00053,1,2260796,2269854,+,9058
233,BUMA.1121.00059,1,1736319,1745438,+,9119
233,BUMA.1121.00043,1,2612188,2621231,+,9043
233,BUMA.1121.00056,1,1413516,1422636,-,9120
233,BUMA.1121.00112,1,430638,439681,-,9043
233,BUMA.1121.00091,1,1959085,1968187,-,9102
233,BUMA.1121.00047,1,395813,404931,-,9118
233,BUMA.1121.00067,1,1859522,1868619,-,9097
233,BUMA.1121.00110,1,2260472,2269574,-,9102
233,BUMA.1121.00073,1,2490368,2499423,+,9055
233,BUMA.1121.00072,1,2464120,2473139,+,9019
233,BUMA.1121.00077,1,1213660,1222761,+,9101
233,BUMA.1121.00082,1,2647959,2657014,+,9055
233,BUMA.1121.00062,1,2048372,2057475,-,9103
233,BUMA.1121.00007,1,1547107,1556186,-,9079
233,BUMA.1121.00025,1,109488,118532,-,9044
233,BUMA.1121.00021,1,3149606,3158649,+,9043
233,BUMA.1121.00103,1,1894166,1903248,-,9082
233,BUMA.1121.00096,1,717376,726478,-,9102
233,BUMA.1121.00079,1,2543073,2552173,+,9100
233,BUMA.1121.00039,1,2686775,2695815,+,9040
233,BUMA.1121.00083,1,3122346,3131402,-,9056
233,BUMA.1121.00084,1,2917957,2927068,+,9111
233,BUMA.1121.00049,1,3318175,3327292,-,9117
233,BUMA.1121.00089,1,2503964,2513083,+,9119
233,BUMA.1121.00014,1,249821,258865,-,9044
233,BUMA.1121.00090,1,626532,635576,+,9044
233,BUMA.1121.00071,1,2481166,2490219,+,9053
233,BUMA.1121.00078,1,3501848,3510947,-,9099
233,BUMA.1121.00102,1,2784197,2793308,-,9111
233,BUMA.1121.00075,1,1997638,2006771,+,9133
233,BUMA.1121.00012,1,1268830,1277931,+,9101
233,BUMA.1121.00076,1,2807300,2816434,-,9134
233,BUMA.1121.00106,1,2294016,2303132,+,9116
233,BUMA.1121.00001,1,1531100,1540144,-,9044
233,BUMA.1121.00107,1,2420699,2429800,+,9101
233,BUMA.1121.00104,1,2686595,2695698,-,9103
233,BUMA.1121.00099,1,3902408,3911508,-,9100
233,BUMA.1121.00098,1,1162613,1171678,+,9065
233,BUMA.1121.00111,1,2706500,2715543,+,9043
233,BUMA.1121.00109,1,3353848,3362951,-,9103
233,BUMA.1121.00097,1,1385251,1394341,-,9090
233,BUMA.1121.00094,1,2534259,2543378,+,9119
233,BUMA.1121.00095,1,3157994,3167094,-,9100
233,BUMA.1121.00005,1,1254763,1263801,+,9038
233,BUMA.1121.00101,1,3889023,3898009,-,8986
233,BUMA.1121.00065,1,2610256,2619358,+,9102
233,BUMA.1121.00100,1,2812855,2821956,-,9101
233,BUMA.1121.00105,1,2692052,2701153,-,9101
233,BUMA.1121.00029,1,2414169,2423213,-,9044
233,BUMA.1121.00066,1,2465872,2474927,+,9055
233,BUMA.1121.00031,1,3957643,3966686,+,9043
233,BUMA.1121.00108,1,3543593,3552675,+,9082
233,BUMA.1121.00023,1,869934,879035,+,9101
233,BUMA.1121.00035,1,3700930,3709973,+,9043
233,BUMA.1121.00041,1,3835706,3844801,+,9095
232,BUMA.1121.00057,1,3607675,3662590,+,54915
232,BUMA.1121.00058,1,2030494,2085528,-,55034
232,BUMA.1121.00045,1,1510719,1565626,-,54907
232,BUMA.1121.00051,1,2461429,2516596,+,55167
232,BUMA.1121.00068,1,1221684,1276614,+,54930
232,BUMA.1121.00061,1,2436782,2491655,+,54873
232,BUMA.1121.00060,1,3755973,3810885,-,54912
232,BUMA.1121.00064,1,2504489,2559579,+,55090
232,BUMA.1121.00016,1,596431,651422,+,54991
232,BUMA.1121.00003,1,984766,1039681,+,54915
232,BUMA.1121.00055,1,2131459,2186211,+,54752
232,BUMA.1121.00011,1,3113010,3167906,-,54896
232,BUMA.1121.00037,1,1096982,1151927,+,54945
232,BUMA.1121.00009,1,3031883,3086853,-,54970
232,BUMA.1121.00069,1,2406141,2461036,+,54895
232,BUMA.1121.00088,1,3407964,3462984,+,55020
232,BUMA.1121.00092,1,1273940,1329138,-,55198
232,BUMA.1121.00074,1,1314809,1369927,-,55118
232,BUMA.1121.00070,1,2407778,2462684,+,54906
232,BUMA.1121.00093,1,3297144,3352327,+,55183
232,BUMA.1121.00063,1,2433700,2488559,+,54859
232,BUMA.1121.00033,1,671245,726109,+,54864
232,BUMA.1121.00018,1,3085631,3140572,+,54941
232,BUMA.1121.00080,1,2491638,2546820,+,55182
232,BUMA.1121.00027,1,636883,691795,+,54912
232,BUMA.1121.00053,1,2205218,2260219,+,55001
232,BUMA.1121.00059,1,1680752,1735742,+,54990
232,BUMA.1121.00043,1,2556707,2611611,+,54904
232,BUMA.1121.00056,1,1423212,1478199,-,54987
232,BUMA.1121.00112,1,440257,495328,-,55071
232,BUMA.1121.00091,1,1968764,2023642,-,54878
232,BUMA.1121.00047,1,405507,460556,-,55049
232,BUMA.1121.00067,1,1869195,1924327,-,55132
232,BUMA.1121.00110,1,2270150,2325065,-,54915
232,BUMA.1121.00073,1,2434886,2489790,+,54904
232,BUMA.1121.00072,1,2408657,2463542,+,54885
232,BUMA.1121.00077,1,1158169,1213083,+,54914
232,BUMA.1121.00082,1,2592475,2647381,+,54906
232,BUMA.1121.00062,1,2058051,2113167,-,55116
232,BUMA.1121.00007,1,1556762,1611744,-,54982
232,BUMA.1121.00025,1,119108,174071,-,54963
232,BUMA.1121.00021,1,3094145,3149029,+,54884
232,BUMA.1121.00103,1,1903824,1958763,-,54939
232,BUMA.1121.00096,1,727054,782051,-,54997
232,BUMA.1121.00079,1,2487442,2542496,+,55054
232,BUMA.1121.00039,1,2631181,2686198,+,55017
232,BUMA.1121.00083,1,3131979,3186886,-,54907
232,BUMA.1121.00084,1,2862300,2917379,+,55079
232,BUMA.1121.00049,1,3327868,3382782,-,54914
232,BUMA.1121.00089,1,2448422,2503387,+,54965
232,BUMA.1121.00014,1,259441,314402,-,54961
232,BUMA.1121.00090,1,571013,625955,+,54942
232,BUMA.1121.00071,1,2425725,2480588,+,54863
232,BUMA.1121.00078,1,3511523,3566724,-,55201
232,BUMA.1121.00102,1,2793884,2849506,-,55622
232,BUMA.1121.00075,1,1942220,1997060,+,54840
232,BUMA.1121.00012,1,1213386,1268253,+,54867
232,BUMA.1121.00076,1,2817011,2871833,-,54822
232,BUMA.1121.00106,1,2238483,2293439,+,54956
232,BUMA.1121.00001,1,1540720,1595686,-,54966
232,BUMA.1121.00107,1,2365307,2420122,+,54815
232,BUMA.1121.00104,1,2696274,2751181,-,54907
232,BUMA.1121.00099,1,3912084,3967029,-,54945
232,BUMA.1121.00098,1,1106980,1162036,+,55056
232,BUMA.1121.00111,1,2650966,2705923,+,54957
232,BUMA.1121.00109,1,3363527,3418467,-,54940
232,BUMA.1121.00097,1,1394917,1449866,-,54949
232,BUMA.1121.00094,1,2478729,2533682,+,54953
232,BUMA.1121.00095,1,3167670,3222577,-,54907
232,BUMA.1121.00005,1,1199403,1254186,+,54783
232,BUMA.1121.00101,1,3900223,3955130,-,54907
232,BUMA.1121.00065,1,2554971,2609679,+,54708
232,BUMA.1121.00100,1,2822532,2877476,-,54944
232,BUMA.1121.00105,1,2701729,2756683,-,54954
232,BUMA.1121.00029,1,2423789,2478802,-,55013
232,BUMA.1121.00066,1,2410389,2465294,+,54905
232,BUMA.1121.00031,1,3902082,3957066,+,54984
232,BUMA.1121.00108,1,3487991,3543016,+,55025
232,BUMA.1121.00023,1,814456,869357,+,54901
232,BUMA.1121.00035,1,3645420,3700353,+,54933
232,BUMA.1121.00041,1,3780138,3835128,+,54990
231,BUMA.1121.00057,1,3581888,3607581,+,25693
231,BUMA.1121.00058,1,2085622,2111295,-,25673
231,BUMA.1121.00045,1,1565720,1591371,-,25651
231,BUMA.1121.00051,1,2435721,2461335,+,25614
231,BUMA.1121.00068,1,1195899,1221590,+,25691
231,BUMA.1121.00061,1,2411027,2436688,+,25661
231,BUMA.1121.00060,1,3810979,3836630,-,25651
231,BUMA.1121.00064,1,2478707,2504395,+,25688
231,BUMA.1121.00016,1,570655,596337,+,25682
231,BUMA.1121.00003,1,959037,984455,+,25418
231,BUMA.1121.00055,1,2105745,2131365,+,25620
231,BUMA.1121.00011,1,3168000,3193585,-,25585
231,BUMA.1121.00037,1,1071328,1096888,+,25560
231,BUMA.1121.00009,1,3086947,3112574,-,25627
231,BUMA.1121.00069,1,2380383,2406047,+,25664
231,BUMA.1121.00088,1,3382190,3407870,+,25680
231,BUMA.1121.00092,1,1329232,1354813,-,25581
231,BUMA.1121.00074,1,1370021,1395660,-,25639
231,BUMA.1121.00070,1,2382034,2407684,+,25650
231,BUMA.1121.00093,1,3271468,3297050,+,25582
231,BUMA.1121.00063,1,2407929,2433606,+,25677
231,BUMA.1121.00033,1,645553,671151,+,25598
231,BUMA.1121.00018,1,3059874,3085537,+,25663
231,BUMA.1121.00080,1,2465960,2491544,+,25584
231,BUMA.1121.00027,1,611084,636789,+,25705
231,BUMA.1121.00053,1,2179487,2205124,+,25637
231,BUMA.1121.00059,1,1655001,1680658,+,25657
231,BUMA.1121.00043,1,2530950,2556613,+,25663
231,BUMA.1121.00056,1,1478293,1503906,-,25613
231,BUMA.1121.00112,1,495422,521087,-,25665
231,BUMA.1121.00091,1,2023736,2049416,-,25680
231,BUMA.1121.00047,1,460650,486281,-,25631
231,BUMA.1121.00067,1,1924421,1950099,-,25678
231,BUMA.1121.00110,1,2325159,2350814,-,25655
231,BUMA.1121.00073,1,2409130,2434792,+,25662
231,BUMA.1121.00072,1,2382886,2408563,+,25677
231,BUMA.1121.00077,1,1132420,1158075,+,25655
231,BUMA.1121.00082,1,2566704,2592381,+,25677
231,BUMA.1121.00062,1,2113261,2138937,-,25676
231,BUMA.1121.00007,1,1611838,1637431,-,25593
231,BUMA.1121.00025,1,174165,199833,-,25668
231,BUMA.1121.00021,1,3068411,3094051,+,25640
231,BUMA.1121.00103,1,1959074,1984554,-,25480
231,BUMA.1121.00096,1,782145,807806,-,25661
231,BUMA.1121.00079,1,2461748,2487348,+,25600
231,BUMA.1121.00039,1,2605456,2631087,+,25631
231,BUMA.1121.00083,1,3186980,3212656,-,25676
231,BUMA.1121.00084,1,2836515,2862206,+,25691
231,BUMA.1121.00049,1,3382876,3408593,-,25717
231,BUMA.1121.00089,1,2422714,2448328,+,25614
231,BUMA.1121.00014,1,314496,340107,-,25611
231,BUMA.1121.00090,1,545327,570919,+,25592
231,BUMA.1121.00071,1,2399954,2425631,+,25677
231,BUMA.1121.00078,1,3566818,3592416,-,25598
231,BUMA.1121.00102,1,2849600,2875236,-,25636
231,BUMA.1121.00075,1,1916460,1942126,+,25666
231,BUMA.1121.00012,1,1187630,1213292,+,25662
231,BUMA.1121.00076,1,2871927,2897592,-,25665
231,BUMA.1121.00106,1,2212737,2238389,+,25652
231,BUMA.1121.00001,1,1595780,1621478,-,25698
231,BUMA.1121.00107,1,2339576,2365213,+,25637
231,BUMA.1121.00104,1,2751275,2776965,-,25690
231,BUMA.1121.00099,1,3967123,3992757,-,25634
231,BUMA.1121.00098,1,1081240,1106886,+,25646
231,BUMA.1121.00111,1,2625249,2650872,+,25623
231,BUMA.1121.00109,1,3418561,3444268,-,25707
231,BUMA.1121.00097,1,1449960,1475588,-,25628
231,BUMA.1121.00094,1,2453008,2478635,+,25627
231,BUMA.1121.00095,1,3222671,3248373,-,25702
231,BUMA.1121.00005,1,1173585,1199309,+,25724
231,BUMA.1121.00101,1,345,25748,-,25403
231,BUMA.1121.00065,1,2529215,2554877,+,25662
231,BUMA.1121.00100,1,2877570,2903180,-,25610
231,BUMA.1121.00105,1,2756777,2782462,-,25685
231,BUMA.1121.00029,1,2478896,2504612,-,25716
231,BUMA.1121.00066,1,2384619,2410295,+,25676
231,BUMA.1121.00031,1,3876384,3901988,+,25604
231,BUMA.1121.00108,1,3462291,3487897,+,25606
231,BUMA.1121.00023,1,788800,814362,+,25562
231,BUMA.1121.00035,1,3619627,3645326,+,25699
231,BUMA.1121.00041,1,3754406,3780044,+,25638
230,BUMA.1121.00057,1,3577008,3581887,+,4879
230,BUMA.1121.00058,1,2111297,2116183,-,4886
230,BUMA.1121.00045,1,1591373,1596274,-,4901
230,BUMA.1121.00051,1,2430856,2435720,+,4864
230,BUMA.1121.00068,1,1191060,1195898,+,4838
230,BUMA.1121.00061,1,2406137,2411026,+,4889
230,BUMA.1121.00060,1,3836632,3841533,-,4901
230,BUMA.1121.00064,1,2473820,2478706,+,4886
230,BUMA.1121.00016,1,565756,570654,+,4898
230,BUMA.1121.00003,1,954134,959036,+,4902
230,BUMA.1121.00055,1,2100878,2105743,+,4865
230,BUMA.1121.00011,1,3193587,3198481,-,4894
230,BUMA.1121.00037,1,1066407,1071327,+,4920
230,BUMA.1121.00009,1,3112576,3117441,-,4865
230,BUMA.1121.00069,1,2375488,2380382,+,4894
230,BUMA.1121.00088,1,3377303,3382189,+,4886
230,BUMA.1121.00092,1,1354815,1359694,-,4879
230,BUMA.1121.00074,1,1395662,1400548,-,4886
230,BUMA.1121.00070,1,2377145,2382033,+,4888
230,BUMA.1121.00093,1,3266588,3271467,+,4879
230,BUMA.1121.00063,1,2403038,2407928,+,4890
230,BUMA.1121.00033,1,639077,643954,+,4877
230,BUMA.1121.00018,1,3055001,3059873,+,4872
230,BUMA.1121.00080,1,2461095,2465959,+,4864
230,BUMA.1121.00027,1,606204,611083,+,4879
230,BUMA.1121.00053,1,2174621,2179486,+,4865
230,BUMA.1121.00059,1,1650114,1655000,+,4886
230,BUMA.1121.00043,1,2526066,2530949,+,4883
230,BUMA.1121.00056,1,1503908,1508794,-,4886
230,BUMA.1121.00112,1,521089,525975,-,4886
230,BUMA.1121.00091,1,2049418,2054327,-,4909
230,BUMA.1121.00047,1,486283,491147,-,4864
230,BUMA.1121.00067,1,1950101,1954987,-,4886
230,BUMA.1121.00110,1,2350816,2355724,-,4908
230,BUMA.1121.00073,1,2404240,2409129,+,4889
230,BUMA.1121.00072,1,2377996,2382885,+,4889
230,BUMA.1121.00077,1,1127511,1132419,+,4908
230,BUMA.1121.00082,1,2561809,2566703,+,4894
230,BUMA.1121.00062,1,2138939,2143803,-,4864
230,BUMA.1121.00007,1,1637433,1642313,-,4880
230,BUMA.1121.00025,1,199835,204707,-,4872
230,BUMA.1121.00021,1,3063523,3068410,+,4887
230,BUMA.1121.00103,1,1984556,1989466,-,4910
230,BUMA.1121.00096,1,807808,812686,-,4878
230,BUMA.1121.00079,1,2456883,2461747,+,4864
230,BUMA.1121.00039,1,2598991,2603857,+,4866
230,BUMA.1121.00083,1,3212658,3217552,-,4894
230,BUMA.1121.00084,1,2831628,2836514,+,4886
230,BUMA.1121.00049,1,3408595,3413481,-,4886
230,BUMA.1121.00089,1,2417827,2422713,+,4886
230,BUMA.1121.00014,1,340109,344989,-,4880
230,BUMA.1121.00090,1,540417,545326,+,4909
230,BUMA.1121.00071,1,2395064,2399953,+,4889
230,BUMA.1121.00078,1,3592418,3597283,-,4865
230,BUMA.1121.00102,1,2875238,2880103,-,4865
230,BUMA.1121.00075,1,1911579,1916459,+,4880
230,BUMA.1121.00012,1,1182709,1187629,+,4920
230,BUMA.1121.00076,1,2897594,2902474,-,4880
230,BUMA.1121.00106,1,2207850,2212736,+,4886
230,BUMA.1121.00001,1,1621480,1626359,-,4879
230,BUMA.1121.00107,1,2334688,2339575,+,4887
230,BUMA.1121.00104,1,2776967,2781853,-,4886
230,BUMA.1121.00099,1,3992759,3997653,-,4894
230,BUMA.1121.00098,1,1076352,1081239,+,4887
230,BUMA.1121.00111,1,2620361,2625248,+,4887
230,BUMA.1121.00109,1,3444270,3449150,-,4880
230,BUMA.1121.00097,1,1475590,1480470,-,4880
230,BUMA.1121.00094,1,2448143,2453007,+,4864
230,BUMA.1121.00095,1,3248375,3253255,-,4880
230,BUMA.1121.00005,1,1168712,1173584,+,4872
230,BUMA.1121.00101,1,25750,30637,-,4887
230,BUMA.1121.00065,1,2524349,2529214,+,4865
230,BUMA.1121.00100,1,2903182,2908083,-,4901
230,BUMA.1121.00105,1,2782464,2787328,-,4864
230,BUMA.1121.00029,1,2504614,2509486,-,4872
230,BUMA.1121.00066,1,2379730,2384618,+,4888
230,BUMA.1121.00031,1,3871504,3876383,+,4879
230,BUMA.1121.00108,1,3457410,3462290,+,4880
230,BUMA.1121.00023,1,783920,788799,+,4879
230,BUMA.1121.00035,1,3614747,3619626,+,4879
230,BUMA.1121.00041,1,3749498,3754405,+,4907
229,BUMA.1121.00057,1,3570610,3575558,+,4948
229,BUMA.1121.00058,1,2117927,2122877,-,4950
229,BUMA.1121.00045,1,1598018,1602968,-,4950
229,BUMA.1121.00051,1,2424163,2429111,+,4948
229,BUMA.1121.00068,1,1184367,1189315,+,4948
229,BUMA.1121.00061,1,2399738,2404686,+,4948
229,BUMA.1121.00060,1,3843277,3848227,-,4950
229,BUMA.1121.00064,1,2467420,2472369,+,4949
229,BUMA.1121.00016,1,559062,564011,+,4949
229,BUMA.1121.00003,1,948921,953866,+,4945
229,BUMA.1121.00055,1,2094185,2099133,+,4948
229,BUMA.1121.00011,1,3200225,3205165,-,4940
229,BUMA.1121.00037,1,1059708,1064657,+,4949
229,BUMA.1121.00009,1,3119185,3124135,-,4950
229,BUMA.1121.00069,1,2369089,2374037,+,4948
229,BUMA.1121.00088,1,3370610,3375558,+,4948
229,BUMA.1121.00092,1,1361438,1366387,-,4949
229,BUMA.1121.00074,1,1401998,1406948,-,4950
229,BUMA.1121.00070,1,2370746,2375694,+,4948
229,BUMA.1121.00093,1,3259895,3264843,+,4948
229,BUMA.1121.00063,1,2396640,2401588,+,4948
229,BUMA.1121.00033,1,632384,637333,+,4949
229,BUMA.1121.00018,1,3048307,3053256,+,4949
229,BUMA.1121.00080,1,2454401,2459350,+,4949
229,BUMA.1121.00027,1,599806,604754,+,4948
229,BUMA.1121.00053,1,2167928,2172877,+,4949
229,BUMA.1121.00059,1,1643421,1648369,+,4948
229,BUMA.1121.00043,1,2519372,2524321,+,4949
229,BUMA.1121.00056,1,1510538,1515487,-,4949
229,BUMA.1121.00112,1,527719,532668,-,4949
229,BUMA.1121.00091,1,2056071,2060950,-,4879
229,BUMA.1121.00047,1,492891,497841,-,4950
229,BUMA.1121.00067,1,1956731,1961681,-,4950
229,BUMA.1121.00110,1,2357468,2362420,-,4952
229,BUMA.1121.00073,1,2397842,2402790,+,4948
229,BUMA.1121.00072,1,2371598,2376546,+,4948
229,BUMA.1121.00077,1,1120816,1125766,+,4950
229,BUMA.1121.00082,1,2555410,2560358,+,4948
229,BUMA.1121.00062,1,2145547,2150497,-,4950
229,BUMA.1121.00007,1,1644057,1649015,-,4958
229,BUMA.1121.00025,1,206451,211401,-,4950
229,BUMA.1121.00021,1,3056830,3061779,+,4949
229,BUMA.1121.00103,1,1991210,1996159,-,4949
229,BUMA.1121.00096,1,814430,819380,-,4950
229,BUMA.1121.00079,1,2450191,2455139,+,4948
229,BUMA.1121.00039,1,2592298,2597247,+,4949
229,BUMA.1121.00083,1,3219002,3223951,-,4949
229,BUMA.1121.00084,1,2824935,2829883,+,4948
229,BUMA.1121.00049,1,3415225,3420174,-,4949
229,BUMA.1121.00089,1,2411134,2416082,+,4948
229,BUMA.1121.00014,1,346738,351688,-,4950
229,BUMA.1121.00090,1,533724,538673,+,4949
229,BUMA.1121.00071,1,2388666,2393614,+,4948
229,BUMA.1121.00078,1,3599027,3603974,-,4947
229,BUMA.1121.00102,1,2881735,2886685,-,4950
229,BUMA.1121.00075,1,1904886,1909834,+,4948
229,BUMA.1121.00012,1,1176015,1180964,+,4949
229,BUMA.1121.00076,1,2904218,2909167,-,4949
229,BUMA.1121.00106,1,2201157,2206105,+,4948
229,BUMA.1121.00001,1,1628103,1633053,-,4950
229,BUMA.1121.00107,1,2327994,2332943,+,4949
229,BUMA.1121.00104,1,2783597,2788546,-,4949
229,BUMA.1121.00099,1,3999397,4004347,-,4950
229,BUMA.1121.00098,1,1069659,1074607,+,4948
229,BUMA.1121.00111,1,2613667,2618616,+,4949
229,BUMA.1121.00109,1,3450894,3455838,-,4944
229,BUMA.1121.00097,1,1482214,1487164,-,4950
229,BUMA.1121.00094,1,2441449,2446398,+,4949
229,BUMA.1121.00095,1,3254999,3259949,-,4950
229,BUMA.1121.00005,1,1162021,1166970,+,4949
229,BUMA.1121.00101,1,32381,37331,-,4950
229,BUMA.1121.00065,1,2517656,2522604,+,4948
229,BUMA.1121.00100,1,2909827,2914777,-,4950
229,BUMA.1121.00105,1,2789072,2794022,-,4950
229,BUMA.1121.00029,1,2511230,2516180,-,4950
229,BUMA.1121.00066,1,2373331,2378279,+,4948
229,BUMA.1121.00031,1,3864805,3869754,+,4949
229,BUMA.1121.00108,1,3450716,3455665,+,4949
229,BUMA.1121.00023,1,777226,782175,+,4949
229,BUMA.1121.00035,1,3608053,3613002,+,4949
229,BUMA.1121.00041,1,3742804,3747753,+,4949
228,BUMA.1121.00057,1,3558722,3569556,+,10834
228,BUMA.1121.00058,1,2129235,2140069,-,10834
228,BUMA.1121.00045,1,1613780,1624605,-,10825
228,BUMA.1121.00051,1,2402526,2413351,+,10825
228,BUMA.1121.00068,1,1172451,1183312,+,10861
228,BUMA.1121.00061,1,2387841,2398684,+,10843
228,BUMA.1121.00060,1,3859039,3869864,-,10825
228,BUMA.1121.00064,1,2445792,2456617,+,10825
228,BUMA.1121.00016,1,541926,552704,+,10778
228,BUMA.1121.00003,1,937073,947857,+,10784
228,BUMA.1121.00055,1,2082331,2093129,+,10798
228,BUMA.1121.00011,1,3215977,3226801,-,10824
228,BUMA.1121.00037,1,1042175,1052971,+,10796
228,BUMA.1121.00009,1,3125189,3135993,-,10804
228,BUMA.1121.00069,1,2357200,2368035,+,10835
228,BUMA.1121.00088,1,3348946,3359798,+,10852
228,BUMA.1121.00092,1,1372745,1383588,-,10843
228,BUMA.1121.00074,1,1417754,1428576,-,10822
228,BUMA.1121.00070,1,2358849,2369692,+,10843
228,BUMA.1121.00093,1,3242694,3253537,+,10843
228,BUMA.1121.00063,1,2384752,2395586,+,10834
228,BUMA.1121.00033,1,614305,625098,+,10793
228,BUMA.1121.00018,1,3029458,3040235,+,10777
228,BUMA.1121.00080,1,2432755,2443589,+,10834
228,BUMA.1121.00027,1,587919,598752,+,10833
228,BUMA.1121.00053,1,2140843,2151686,+,10843
228,BUMA.1121.00059,1,1621758,1632610,+,10852
228,BUMA.1121.00043,1,2498209,2510320,+,12111
228,BUMA.1121.00056,1,1526299,1537124,-,10825
228,BUMA.1121.00112,1,543480,554305,-,10825
228,BUMA.1121.00091,1,2074352,2085186,-,10834
228,BUMA.1121.00047,1,508653,519478,-,10825
228,BUMA.1121.00067,1,1972487,1983309,-,10822
228,BUMA.1121.00110,1,2368779,2379611,-,10832
228,BUMA.1121.00073,1,2385945,2396788,+,10843
228,BUMA.1121.00072,1,2359706,2370544,+,10838
228,BUMA.1121.00077,1,1103625,1114457,+,10832
228,BUMA.1121.00082,1,2543513,2554356,+,10843
228,BUMA.1121.00062,1,2151553,2162387,-,10834
228,BUMA.1121.00007,1,1659828,1670644,-,10816
228,BUMA.1121.00025,1,219473,230251,-,10778
228,BUMA.1121.00021,1,3039295,3050093,+,10798
228,BUMA.1121.00103,1,1997215,2008021,-,10806
228,BUMA.1121.00096,1,820436,831279,-,10843
228,BUMA.1121.00079,1,2428555,2439380,+,10825
228,BUMA.1121.00039,1,2536649,2547445,+,10796
228,BUMA.1121.00083,1,3225005,3235848,-,10843
228,BUMA.1121.00084,1,2803271,2814123,+,10852
228,BUMA.1121.00049,1,3433293,3444136,-,10843
228,BUMA.1121.00089,1,2389497,2400322,+,10825
228,BUMA.1121.00014,1,369136,379932,-,10796
228,BUMA.1121.00090,1,516570,527366,+,10796
228,BUMA.1121.00071,1,2376772,2387612,+,10840
228,BUMA.1121.00078,1,3610332,3621137,-,10805
228,BUMA.1121.00102,1,2893043,2903898,-,10855
228,BUMA.1121.00075,1,1883241,1894083,+,10842
228,BUMA.1121.00012,1,1154322,1165100,+,10778
228,BUMA.1121.00076,1,2919970,2930813,-,10843
228,BUMA.1121.00106,1,2178317,2189142,+,10825
228,BUMA.1121.00001,1,1640742,1651538,-,10796
228,BUMA.1121.00107,1,2306365,2317182,+,10817
228,BUMA.1121.00104,1,2799357,2810191,-,10834
228,BUMA.1121.00099,1,4005402,4016190,-,10788
228,BUMA.1121.00098,1,1057743,1068604,+,10861
228,BUMA.1121.00111,1,2592083,2602880,+,10797
228,BUMA.1121.00109,1,3456894,3467718,-,10824
228,BUMA.1121.00097,1,1488219,1499051,-,10832
228,BUMA.1121.00094,1,2419812,2430637,+,10825
228,BUMA.1121.00095,1,3266306,3277120,-,10814
228,BUMA.1121.00005,1,1144865,1155663,+,10798
228,BUMA.1121.00101,1,43689,54511,-,10822
228,BUMA.1121.00065,1,2505767,2516601,+,10834
228,BUMA.1121.00100,1,2915833,2926669,-,10836
228,BUMA.1121.00105,1,2795078,2805921,-,10843
228,BUMA.1121.00029,1,2522537,2533333,-,10796
228,BUMA.1121.00066,1,2361437,2372277,+,10840
228,BUMA.1121.00031,1,3837336,3848132,+,10796
228,BUMA.1121.00108,1,3438845,3449661,+,10816
228,BUMA.1121.00023,1,748964,759760,+,10796
228,BUMA.1121.00035,1,3555172,3565968,+,10796
228,BUMA.1121.00041,1,3725639,3736446,+,10807
227,BUMA.1121.00057,1,3538344,3543029,+,4685
227,BUMA.1121.00058,1,2155752,2160435,-,4683
227,BUMA.1121.00045,1,1641762,1646454,-,4692
227,BUMA.1121.00051,1,2382169,2386858,+,4689
227,BUMA.1121.00068,1,1152009,1156722,+,4713
227,BUMA.1121.00061,1,2367462,2372145,+,4683
227,BUMA.1121.00060,1,3887015,3891707,-,4692
227,BUMA.1121.00064,1,2425401,2430099,+,4698
227,BUMA.1121.00016,1,521471,526170,+,4699
227,BUMA.1121.00003,1,916686,921385,+,4699
227,BUMA.1121.00055,1,2059047,2063740,+,4693
227,BUMA.1121.00011,1,3244035,3248735,-,4700
227,BUMA.1121.00037,1,1021737,1026437,+,4700
227,BUMA.1121.00009,1,3151695,3156388,-,4693
227,BUMA.1121.00069,1,2336830,2341515,+,4685
227,BUMA.1121.00088,1,3328577,3333266,+,4689
227,BUMA.1121.00092,1,1399290,1403983,-,4693
227,BUMA.1121.00074,1,1444261,1448962,-,4701
227,BUMA.1121.00070,1,2338466,2343151,+,4685
227,BUMA.1121.00093,1,3222299,3226991,+,4692
227,BUMA.1121.00063,1,2364387,2369071,+,4684
227,BUMA.1121.00033,1,593795,598495,+,4700
227,BUMA.1121.00018,1,3008998,3013697,+,4699
227,BUMA.1121.00080,1,2412390,2417079,+,4689
227,BUMA.1121.00027,1,567553,572238,+,4685
227,BUMA.1121.00053,1,2120438,2125136,+,4698
227,BUMA.1121.00059,1,1601382,1606083,+,4701
227,BUMA.1121.00043,1,2477822,2482481,+,4659
227,BUMA.1121.00056,1,1552798,1557488,-,4690
227,BUMA.1121.00112,1,569996,574695,-,4699
227,BUMA.1121.00091,1,2100885,2105584,-,4699
227,BUMA.1121.00047,1,535152,539842,-,4690
227,BUMA.1121.00067,1,1999030,2003731,-,4701
227,BUMA.1121.00110,1,2395242,2399942,-,4700
227,BUMA.1121.00073,1,2365562,2370247,+,4685
227,BUMA.1121.00072,1,2339323,2344008,+,4685
227,BUMA.1121.00077,1,1083297,1087996,+,4699
227,BUMA.1121.00082,1,2523129,2527814,+,4685
227,BUMA.1121.00062,1,2179669,2184352,-,4683
227,BUMA.1121.00007,1,1686365,1691059,-,4694
227,BUMA.1121.00025,1,246007,250707,-,4700
227,BUMA.1121.00021,1,3018857,3023557,+,4700
227,BUMA.1121.00103,1,2023698,2028390,-,4692
227,BUMA.1121.00096,1,846940,851642,-,4702
227,BUMA.1121.00079,1,2408180,2412869,+,4689
227,BUMA.1121.00039,1,2516211,2520911,+,4700
227,BUMA.1121.00083,1,3251546,3256232,-,4686
227,BUMA.1121.00084,1,2782905,2787594,+,4689
227,BUMA.1121.00049,1,3461153,3465852,-,4699
227,BUMA.1121.00089,1,2369133,2373822,+,4689
227,BUMA.1121.00014,1,395686,400388,-,4702
227,BUMA.1121.00090,1,496144,500843,+,4699
227,BUMA.1121.00071,1,2356401,2361086,+,4685
227,BUMA.1121.00078,1,3638392,3643092,-,4700
227,BUMA.1121.00102,1,2919612,2924314,-,4702
227,BUMA.1121.00075,1,1861297,1866010,+,4713
227,BUMA.1121.00012,1,1133882,1138581,+,4699
227,BUMA.1121.00076,1,2948052,2952766,-,4714
227,BUMA.1121.00106,1,2157908,2162606,+,4698
227,BUMA.1121.00001,1,1667308,1672008,-,4700
227,BUMA.1121.00107,1,2286003,2290703,+,4700
227,BUMA.1121.00104,1,2827182,2831882,-,4700
227,BUMA.1121.00099,1,4031891,4036592,-,4701
227,BUMA.1121.00098,1,1037323,1042022,+,4699
227,BUMA.1121.00111,1,2571661,2576360,+,4699
227,BUMA.1121.00109,1,3483385,3488077,-,4692
227,BUMA.1121.00097,1,1514758,1519457,-,4699
227,BUMA.1121.00094,1,2399448,2404137,+,4689
227,BUMA.1121.00095,1,3292785,3297486,-,4701
227,BUMA.1121.00005,1,1124540,1129222,+,4682
227,BUMA.1121.00101,1,70241,74934,-,4693
227,BUMA.1121.00065,1,2485355,2490055,+,4700
227,BUMA.1121.00100,1,2942413,2947080,-,4667
227,BUMA.1121.00105,1,2821681,2826373,-,4692
227,BUMA.1121.00029,1,2549066,2553766,-,4700
227,BUMA.1121.00066,1,2341060,2345744,+,4684
227,BUMA.1121.00031,1,3816856,3821557,+,4701
227,BUMA.1121.00108,1,3418522,3423221,+,4699
227,BUMA.1121.00023,1,728506,733207,+,4701
227,BUMA.1121.00035,1,3534736,3539435,+,4699
227,BUMA.1121.00041,1,3703844,3708534,+,4690
226,BUMA.1121.00057,1,3524669,3538140,+,13471
226,BUMA.1121.00058,1,2160650,2174060,-,13410
226,BUMA.1121.00045,1,1646613,1660013,-,13400
226,BUMA.1121.00051,1,2368556,2382000,+,13444
226,BUMA.1121.00068,1,1138388,1151854,+,13466
226,BUMA.1121.00061,1,2353851,2367315,+,13464
226,BUMA.1121.00060,1,3891866,3905265,-,13399
226,BUMA.1121.00064,1,2411884,2425295,+,13411
226,BUMA.1121.00016,1,507985,521437,+,13452
226,BUMA.1121.00003,1,903190,916622,+,13432
226,BUMA.1121.00055,1,2045396,2058906,+,13510
226,BUMA.1121.00011,1,3248884,3262288,-,13404
226,BUMA.1121.00037,1,1008232,1021673,+,13441
226,BUMA.1121.00009,1,3156432,3169825,-,13393
226,BUMA.1121.00069,1,2323197,2336689,+,13492
226,BUMA.1121.00088,1,3315013,3328457,+,13444
226,BUMA.1121.00092,1,1404118,1417521,-,13403
226,BUMA.1121.00074,1,1449139,1462524,-,13385
226,BUMA.1121.00070,1,2324833,2338276,+,13443
226,BUMA.1121.00093,1,3208761,3222207,+,13446
226,BUMA.1121.00063,1,2350760,2364231,+,13471
226,BUMA.1121.00033,1,580215,593703,+,13488
226,BUMA.1121.00018,1,2995375,3008850,+,13475
226,BUMA.1121.00080,1,2398797,2412249,+,13452
226,BUMA.1121.00027,1,553879,567384,+,13505
226,BUMA.1121.00053,1,2106776,2120268,+,13492
226,BUMA.1121.00059,1,1587924,1601338,+,13414
226,BUMA.1121.00043,1,2462494,2476139,+,13645
226,BUMA.1121.00056,1,1557616,1571018,-,13402
226,BUMA.1121.00112,1,574847,588249,-,13402
226,BUMA.1121.00091,1,2105771,2119182,-,13411
226,BUMA.1121.00047,1,539998,553400,-,13402
226,BUMA.1121.00067,1,2003922,2017304,-,13382
226,BUMA.1121.00110,1,2400073,2413478,-,13405
226,BUMA.1121.00073,1,2351929,2365372,+,13443
226,BUMA.1121.00072,1,2325697,2339175,+,13478
226,BUMA.1121.00077,1,1069754,1083263,+,13509
226,BUMA.1121.00082,1,2509496,2522960,+,13464
226,BUMA.1121.00062,1,2184574,2197983,-,13409
226,BUMA.1121.00007,1,1691286,1704696,-,13410
226,BUMA.1121.00025,1,250912,264317,-,13405
226,BUMA.1121.00021,1,3004026,3018823,+,14797
226,BUMA.1121.00103,1,2028556,2041958,-,13402
226,BUMA.1121.00096,1,851819,865232,-,13413
226,BUMA.1121.00079,1,2394603,2408060,+,13457
226,BUMA.1121.00039,1,2502470,2515946,+,13476
226,BUMA.1121.00083,1,3256451,3269865,-,13414
226,BUMA.1121.00084,1,2769187,2782631,+,13444
226,BUMA.1121.00049,1,3465911,3479321,-,13410
226,BUMA.1121.00089,1,2355568,2369013,+,13445
226,BUMA.1121.00014,1,400582,414001,-,13419
226,BUMA.1121.00090,1,482562,496045,+,13483
226,BUMA.1121.00071,1,2342807,2356245,+,13438
226,BUMA.1121.00078,1,3643251,3656656,-,13405
226,BUMA.1121.00102,1,2924508,2937901,-,13393
226,BUMA.1121.00075,1,1847611,1861093,+,13482
226,BUMA.1121.00012,1,1120223,1133699,+,13476
226,BUMA.1121.00076,1,2953065,2966459,-,13394
226,BUMA.1121.00106,1,2144412,2157836,+,13424
226,BUMA.1121.00001,1,1672241,1685645,-,13404
226,BUMA.1121.00107,1,2272512,2285967,+,13455
226,BUMA.1121.00104,1,2832062,2845459,-,13397
226,BUMA.1121.00099,1,4036867,4050277,-,13410
226,BUMA.1121.00098,1,1023865,1037289,+,13424
226,BUMA.1121.00111,1,2558079,2571562,+,13483
226,BUMA.1121.00109,1,3488233,3501641,-,13408
226,BUMA.1121.00097,1,1519761,1533158,-,13397
226,BUMA.1121.00094,1,2385883,2399328,+,13445
226,BUMA.1121.00095,1,3297750,3311156,-,13406
226,BUMA.1121.00005,1,1111019,1124416,+,13397
226,BUMA.1121.00101,1,75084,88494,-,13410
226,BUMA.1121.00065,1,2471814,2485263,+,13449
226,BUMA.1121.00100,1,2947123,2960527,-,13404
226,BUMA.1121.00105,1,2826536,2839950,-,13414
226,BUMA.1121.00029,1,2553921,2567358,-,13437
226,BUMA.1121.00066,1,2327437,2340870,+,13433
226,BUMA.1121.00031,1,3803272,3816757,+,13485
226,BUMA.1121.00108,1,3404990,3418444,+,13454
226,BUMA.1121.00023,1,714908,728358,+,13450
226,BUMA.1121.00035,1,3521224,3534672,+,13448
226,BUMA.1121.00041,1,3690241,3703689,+,13448
225,BUMA.1121.00057,1,3514365,3523301,+,8936
225,BUMA.1121.00055,1,2035091,2044027,+,8936
225,BUMA.1121.00112,1,1643089,1652025,+,8936
225,BUMA.1121.00084,1,1717605,1726532,-,8927
224,BUMA.1121.00057,1,3498684,3501725,+,3041
224,BUMA.1121.00055,1,2019485,2022513,+,3028
224,BUMA.1121.00112,1,1627308,1630632,+,3324
223,BUMA.1121.00057,1,3492720,3497834,+,5114
223,BUMA.1121.00055,1,2013107,2018478,+,5371
223,BUMA.1121.00112,1,1621466,1626497,+,5031
223,BUMA.1121.00084,1,1742905,1748244,-,5339
222,BUMA.1121.00057,1,3485874,3491135,+,5261
222,BUMA.1121.00055,1,2006261,2011522,+,5261
222,BUMA.1121.00112,1,1614504,1619702,+,5198
222,BUMA.1121.00084,1,1749891,1755301,-,5410
221,BUMA.1121.00057,1,3479323,3483053,+,3730
221,BUMA.1121.00055,1,1999710,2003440,+,3730
221,BUMA.1121.00112,1,1607106,1610834,+,3728
221,BUMA.1121.00084,1,1758092,1761784,-,3692
220,BUMA.1121.00057,1,3455172,3472826,+,17654
220,BUMA.1121.00058,1,2179487,2197135,-,17648
220,BUMA.1121.00045,1,1665451,1683104,-,17653
220,BUMA.1121.00051,1,2345483,2363126,+,17643
220,BUMA.1121.00068,1,1115327,1132956,+,17629
220,BUMA.1121.00061,1,1488985,1506639,-,17654
220,BUMA.1121.00060,1,3910703,3928356,-,17653
220,BUMA.1121.00064,1,2388807,2406458,+,17651
220,BUMA.1121.00016,1,483539,501178,+,17639
220,BUMA.1121.00003,1,880153,897758,+,17605
220,BUMA.1121.00055,1,1974355,1992000,+,17645
220,BUMA.1121.00011,1,3267712,3285365,-,17653
220,BUMA.1121.00037,1,985164,1002806,+,17642
220,BUMA.1121.00009,1,3175267,3192896,-,17629
220,BUMA.1121.00069,1,1441782,1459433,-,17651
220,BUMA.1121.00088,1,3290620,3308258,+,17638
220,BUMA.1121.00092,1,1424157,1441673,-,17516
220,BUMA.1121.00074,1,1467949,1485600,-,17651
220,BUMA.1121.00070,1,1459978,1477628,-,17650
220,BUMA.1121.00093,1,3184609,3202125,+,17516
220,BUMA.1121.00063,1,1486072,1503726,-,17654
220,BUMA.1121.00033,1,498738,516376,+,17638
220,BUMA.1121.00018,1,2971579,2989218,+,17639
220,BUMA.1121.00080,1,2375723,2393367,+,17644
220,BUMA.1121.00027,1,530805,548457,+,17652
220,BUMA.1121.00053,1,2083709,2101346,+,17637
220,BUMA.1121.00059,1,1564841,1582482,+,17641
220,BUMA.1121.00043,1,2439426,2457067,+,17641
220,BUMA.1121.00056,1,1576447,1594091,-,17644
220,BUMA.1121.00112,1,593694,611324,-,17630
220,BUMA.1121.00091,1,2124624,2142269,-,17645
220,BUMA.1121.00047,1,597945,615589,-,17644
220,BUMA.1121.00067,1,2022729,2040378,-,17649
220,BUMA.1121.00110,1,2418897,2436548,-,17651
220,BUMA.1121.00073,1,1487229,1504883,-,17654
220,BUMA.1121.00072,1,1461527,1479180,-,17653
220,BUMA.1121.00077,1,1046686,1064334,+,17648
220,BUMA.1121.00082,1,1619708,1637362,-,17654
220,BUMA.1121.00062,1,2203407,2221056,-,17649
220,BUMA.1121.00007,1,1710127,1727776,-,17649
220,BUMA.1121.00025,1,270473,288112,-,17639
220,BUMA.1121.00021,1,2980959,2998599,+,17640
220,BUMA.1121.00103,1,2047397,2065034,-,17637
220,BUMA.1121.00096,1,870671,888310,-,17639
220,BUMA.1121.00079,1,2371531,2389166,+,17635
220,BUMA.1121.00039,1,2479405,2497044,+,17639
220,BUMA.1121.00083,1,3275286,3292940,-,17654
220,BUMA.1121.00084,1,2746109,2763745,+,17636
220,BUMA.1121.00049,1,3484752,3502404,-,17652
220,BUMA.1121.00089,1,2332494,2350138,+,17644
220,BUMA.1121.00014,1,419427,437074,-,17647
220,BUMA.1121.00090,1,459496,477135,+,17639
220,BUMA.1121.00071,1,1479074,1496648,-,17574
220,BUMA.1121.00078,1,3662086,3679740,-,17654
220,BUMA.1121.00102,1,2943343,2960980,-,17637
220,BUMA.1121.00075,1,1824765,1842403,+,17638
220,BUMA.1121.00012,1,1097157,1114796,+,17639
220,BUMA.1121.00076,1,2971666,2989305,-,17639
220,BUMA.1121.00106,1,2120133,2137774,+,17641
220,BUMA.1121.00001,1,1691071,1708710,-,17639
220,BUMA.1121.00107,1,2249452,2267088,+,17636
220,BUMA.1121.00104,1,2852096,2869737,-,17641
220,BUMA.1121.00099,1,4055702,4073333,-,17631
220,BUMA.1121.00098,1,1000796,1018434,+,17638
220,BUMA.1121.00111,1,2535012,2552651,+,17639
220,BUMA.1121.00109,1,3507060,3524660,-,17600
220,BUMA.1121.00097,1,1538596,1556246,-,17650
220,BUMA.1121.00094,1,2362813,2380457,+,17644
220,BUMA.1121.00095,1,3316408,3334050,-,17642
220,BUMA.1121.00005,1,1087928,1105576,+,17648
220,BUMA.1121.00101,1,93932,111587,-,17655
220,BUMA.1121.00065,1,2448728,2466371,+,17643
220,BUMA.1121.00100,1,2965959,2983509,-,17550
220,BUMA.1121.00105,1,2845145,2862797,-,17652
220,BUMA.1121.00029,1,2572784,2590418,-,17634
220,BUMA.1121.00066,1,1463144,1480718,-,17574
220,BUMA.1121.00031,1,3780199,3797845,+,17646
220,BUMA.1121.00108,1,3381918,3399560,+,17642
220,BUMA.1121.00023,1,690507,708146,+,17639
220,BUMA.1121.00035,1,3498158,3515797,+,17639
220,BUMA.1121.00041,1,3667185,3684811,+,17626
219,BUMA.1121.00057,1,3449846,3453302,+,3456
219,BUMA.1121.00058,1,2198991,2202462,-,3471
219,BUMA.1121.00045,1,1684974,1688414,-,3440
219,BUMA.1121.00051,1,2340049,2343612,+,3563
219,BUMA.1121.00068,1,1109965,1113457,+,3492
219,BUMA.1121.00061,1,1508497,1511960,-,3463
219,BUMA.1121.00060,1,3930226,3933682,-,3456
219,BUMA.1121.00064,1,2382022,2385482,+,3460
219,BUMA.1121.00016,1,478223,481670,+,3447
219,BUMA.1121.00003,1,874804,878285,+,3481
219,BUMA.1121.00055,1,1968796,1972500,+,3704
219,BUMA.1121.00011,1,3287237,3290650,-,3413
219,BUMA.1121.00037,1,979829,983302,+,3473
219,BUMA.1121.00009,1,3194767,3198326,-,3559
219,BUMA.1121.00069,1,1461295,1464755,-,3460
219,BUMA.1121.00088,1,3285288,3288752,+,3464
219,BUMA.1121.00092,1,1443542,1446945,-,3403
219,BUMA.1121.00074,1,1487474,1490981,-,3507
219,BUMA.1121.00070,1,1479490,1482953,-,3463
219,BUMA.1121.00093,1,3179337,3182741,+,3404
219,BUMA.1121.00063,1,1505583,1509046,-,3463
219,BUMA.1121.00033,1,493367,496872,+,3505
219,BUMA.1121.00018,1,2966251,2969717,+,3466
219,BUMA.1121.00080,1,2370281,2373852,+,3571
219,BUMA.1121.00027,1,525480,528936,+,3456
219,BUMA.1121.00053,1,2078284,2081851,+,3567
219,BUMA.1121.00059,1,1557971,1561519,+,3548
219,BUMA.1121.00043,1,2434071,2437558,+,3487
219,BUMA.1121.00056,1,1595963,1599517,-,3554
219,BUMA.1121.00112,1,613194,616615,-,3421
219,BUMA.1121.00091,1,2144135,2147568,-,3433
219,BUMA.1121.00047,1,617461,620959,-,3498
219,BUMA.1121.00067,1,2042250,2045664,-,3414
219,BUMA.1121.00110,1,2439855,2443300,-,3445
219,BUMA.1121.00073,1,1506742,1510205,-,3463
219,BUMA.1121.00072,1,1481048,1484496,-,3448
219,BUMA.1121.00077,1,1039932,1043378,+,3446
219,BUMA.1121.00082,1,1639233,1642696,-,3463
219,BUMA.1121.00062,1,2222925,2226436,-,3511
219,BUMA.1121.00007,1,1729614,1733048,-,3434
219,BUMA.1121.00025,1,289975,293442,-,3467
219,BUMA.1121.00021,1,2975618,2979097,+,3479
219,BUMA.1121.00103,1,2066918,2070536,-,3618
219,BUMA.1121.00096,1,890179,893612,-,3433
219,BUMA.1121.00079,1,2366114,2369661,+,3547
219,BUMA.1121.00039,1,2474111,2477542,+,3431
219,BUMA.1121.00083,1,3294811,3298274,-,3463
219,BUMA.1121.00084,1,2740783,2744239,+,3456
219,BUMA.1121.00049,1,3505729,3509268,-,3539
219,BUMA.1121.00089,1,2327052,2330623,+,3571
219,BUMA.1121.00014,1,438937,442424,-,3487
219,BUMA.1121.00090,1,454202,457634,+,3432
219,BUMA.1121.00071,1,1498507,1501969,-,3462
219,BUMA.1121.00078,1,3681599,3685085,-,3486
219,BUMA.1121.00102,1,2962836,2966331,-,3495
219,BUMA.1121.00075,1,1819417,1822897,+,3480
219,BUMA.1121.00012,1,1091855,1095294,+,3439
219,BUMA.1121.00076,1,2991174,2994653,-,3479
219,BUMA.1121.00106,1,2113279,2116811,+,3532
219,BUMA.1121.00001,1,1710573,1714019,-,3446
219,BUMA.1121.00107,1,2244154,2247595,+,3441
219,BUMA.1121.00104,1,2873060,2876575,-,3515
219,BUMA.1121.00099,1,4075200,4078649,-,3449
219,BUMA.1121.00098,1,995430,998927,+,3497
219,BUMA.1121.00111,1,2529646,2533150,+,3504
219,BUMA.1121.00109,1,3527968,3531395,-,3427
219,BUMA.1121.00097,1,1558119,1561583,-,3464
219,BUMA.1121.00094,1,2357373,2360942,+,3569
219,BUMA.1121.00095,1,3335920,3339443,-,3523
219,BUMA.1121.00005,1,1082647,1086060,+,3413
219,BUMA.1121.00101,1,113452,116905,-,3453
219,BUMA.1121.00065,1,2443405,2446860,+,3455
219,BUMA.1121.00100,1,2985368,2988917,-,3549
219,BUMA.1121.00105,1,2866120,2869627,-,3507
219,BUMA.1121.00029,1,2592281,2595822,-,3541
219,BUMA.1121.00066,1,1482576,1486038,-,3462
219,BUMA.1121.00031,1,3774848,3778337,+,3489
219,BUMA.1121.00108,1,3376598,3380047,+,3449
219,BUMA.1121.00023,1,685174,688645,+,3471
219,BUMA.1121.00035,1,3492842,3496296,+,3454
219,BUMA.1121.00041,1,3661930,3665327,+,3397
218,BUMA.1121.00057,1,3439562,3449845,+,10283
218,BUMA.1121.00058,1,2202464,2212740,-,10276
218,BUMA.1121.00045,1,1688416,1698730,-,10314
218,BUMA.1121.00051,1,2329508,2340048,+,10540
218,BUMA.1121.00068,1,1099627,1109964,+,10337
218,BUMA.1121.00061,1,1511962,1522332,-,10370
218,BUMA.1121.00060,1,3935291,3945575,-,10284
218,BUMA.1121.00064,1,2371745,2382021,+,10276
218,BUMA.1121.00016,1,467882,478222,+,10340
218,BUMA.1121.00003,1,864359,874803,+,10444
218,BUMA.1121.00055,1,1958494,1968795,+,10301
218,BUMA.1121.00011,1,3290652,3300928,-,10276
218,BUMA.1121.00037,1,969489,979828,+,10339
218,BUMA.1121.00009,1,3198328,3208636,-,10308
218,BUMA.1121.00069,1,1464757,1475143,-,10386
218,BUMA.1121.00088,1,3274973,3285287,+,10314
218,BUMA.1121.00092,1,1446947,1457181,-,10234
218,BUMA.1121.00074,1,1490983,1501250,-,10267
218,BUMA.1121.00070,1,1482955,1493244,-,10289
218,BUMA.1121.00093,1,3169101,3179336,+,10235
218,BUMA.1121.00063,1,1509048,1519434,-,10386
218,BUMA.1121.00033,1,483035,493366,+,10331
218,BUMA.1121.00018,1,2955671,2966250,+,10579
218,BUMA.1121.00080,1,2359685,2370280,+,10595
218,BUMA.1121.00027,1,515044,525479,+,10435
218,BUMA.1121.00053,1,2067977,2078283,+,10306
218,BUMA.1121.00059,1,1547719,1557970,+,10251
218,BUMA.1121.00043,1,2423763,2434070,+,10307
218,BUMA.1121.00056,1,1599519,1609866,-,10347
218,BUMA.1121.00112,1,616617,626821,-,10204
218,BUMA.1121.00091,1,2147570,2157973,-,10403
218,BUMA.1121.00047,1,620961,631468,-,10507
218,BUMA.1121.00067,1,2045666,2055940,-,10274
218,BUMA.1121.00110,1,2443302,2453560,-,10258
218,BUMA.1121.00073,1,1510207,1520496,-,10289
218,BUMA.1121.00072,1,1484498,1494884,-,10386
218,BUMA.1121.00077,1,1029672,1039931,+,10259
218,BUMA.1121.00082,1,1642698,1653084,-,10386
218,BUMA.1121.00062,1,2226438,2236680,-,10242
218,BUMA.1121.00007,1,1733050,1743350,-,10300
218,BUMA.1121.00025,1,293444,304014,-,10570
218,BUMA.1121.00021,1,2965382,2975617,+,10235
218,BUMA.1121.00103,1,2070538,2080788,-,10250
218,BUMA.1121.00096,1,893614,903992,-,10378
218,BUMA.1121.00079,1,2355629,2366113,+,10484
218,BUMA.1121.00039,1,2463707,2474110,+,10403
218,BUMA.1121.00083,1,3298276,3308662,-,10386
218,BUMA.1121.00084,1,2730395,2740782,+,10387
218,BUMA.1121.00049,1,3509270,3519545,-,10275
218,BUMA.1121.00089,1,2316703,2327051,+,10348
218,BUMA.1121.00014,1,442426,452884,-,10458
218,BUMA.1121.00090,1,443789,454201,+,10412
218,BUMA.1121.00071,1,1501971,1512357,-,10386
218,BUMA.1121.00078,1,3685087,3695446,-,10359
218,BUMA.1121.00102,1,2966333,2976657,-,10324
218,BUMA.1121.00075,1,1809100,1819416,+,10316
218,BUMA.1121.00012,1,1081523,1091854,+,10331
218,BUMA.1121.00076,1,2994655,3004971,-,10316
218,BUMA.1121.00106,1,2103002,2113278,+,10276
218,BUMA.1121.00001,1,1714021,1724375,-,10354
218,BUMA.1121.00107,1,2233933,2244153,+,10220
218,BUMA.1121.00104,1,2876577,2886892,-,10315
218,BUMA.1121.00099,1,4078651,4088909,-,10258
218,BUMA.1121.00098,1,985217,995429,+,10212
218,BUMA.1121.00111,1,2519308,2529645,+,10337
218,BUMA.1121.00109,1,3531397,3541656,-,10259
218,BUMA.1121.00097,1,1561585,1571810,-,10225
218,BUMA.1121.00094,1,2347024,2357372,+,10348
218,BUMA.1121.00095,1,3339445,3349672,-,10227
218,BUMA.1121.00005,1,1072387,1082646,+,10259
218,BUMA.1121.00101,1,116907,127206,-,10299
218,BUMA.1121.00065,1,2433031,2443404,+,10373
218,BUMA.1121.00100,1,2988919,2999266,-,10347
218,BUMA.1121.00105,1,2869629,2879975,-,10346
218,BUMA.1121.00029,1,2595824,2606186,-,10362
218,BUMA.1121.00066,1,1486040,1496426,-,10386
218,BUMA.1121.00031,1,3764276,3774847,+,10571
218,BUMA.1121.00108,1,3366385,3376597,+,10212
218,BUMA.1121.00023,1,674858,685173,+,10315
218,BUMA.1121.00035,1,3482470,3492841,+,10371
218,BUMA.1121.00041,1,3651558,3661929,+,10371
217,BUMA.1121.00057,1,3399976,3439561,+,39585
217,BUMA.1121.00058,1,2212742,2252208,-,39466
217,BUMA.1121.00045,1,1698732,1738209,-,39477
217,BUMA.1121.00051,1,2289864,2329507,+,39643
217,BUMA.1121.00068,1,1060148,1099626,+,39478
217,BUMA.1121.00061,1,1522334,1561727,-,39393
217,BUMA.1121.00060,1,3945577,3985054,-,39477
217,BUMA.1121.00064,1,2332232,2371744,+,39512
217,BUMA.1121.00016,1,428325,467881,+,39556
217,BUMA.1121.00003,1,824840,864358,+,39518
217,BUMA.1121.00055,1,1918977,1958493,+,39516
217,BUMA.1121.00011,1,3300930,3340573,-,39643
217,BUMA.1121.00037,1,930043,969488,+,39445
217,BUMA.1121.00009,1,3208638,3248135,-,39497
217,BUMA.1121.00069,1,1475145,1514593,-,39448
217,BUMA.1121.00088,1,3235673,3274972,+,39299
217,BUMA.1121.00092,1,1457183,1496718,-,39535
217,BUMA.1121.00074,1,1501252,1540652,-,39400
217,BUMA.1121.00070,1,1493246,1532664,-,39418
217,BUMA.1121.00093,1,3129565,3169100,+,39535
217,BUMA.1121.00063,1,1519436,1558883,-,39447
217,BUMA.1121.00033,1,443559,483034,+,39475
217,BUMA.1121.00018,1,2916171,2955670,+,39499
217,BUMA.1121.00080,1,2320134,2359684,+,39550
217,BUMA.1121.00027,1,475499,515043,+,39544
217,BUMA.1121.00053,1,2028523,2067976,+,39453
217,BUMA.1121.00059,1,1508265,1547718,+,39453
217,BUMA.1121.00043,1,2384078,2423762,+,39684
217,BUMA.1121.00056,1,1609868,1649521,-,39653
217,BUMA.1121.00112,1,626823,666425,-,39602
217,BUMA.1121.00091,1,2157975,2197551,-,39576
217,BUMA.1121.00047,1,631470,671077,-,39607
217,BUMA.1121.00067,1,2055942,2095495,-,39553
217,BUMA.1121.00110,1,2453562,2493135,-,39573
217,BUMA.1121.00073,1,1520498,1559940,-,39442
217,BUMA.1121.00072,1,1494886,1534336,-,39450
217,BUMA.1121.00077,1,990098,1029671,+,39573
217,BUMA.1121.00082,1,1653086,1692537,-,39451
217,BUMA.1121.00062,1,2236682,2276157,-,39475
217,BUMA.1121.00007,1,1743352,1782924,-,39572
217,BUMA.1121.00025,1,304016,343531,-,39515
217,BUMA.1121.00021,1,2925789,2965381,+,39592
217,BUMA.1121.00103,1,2080790,2120265,-,39475
217,BUMA.1121.00096,1,903994,943601,-,39607
217,BUMA.1121.00079,1,2316023,2355628,+,39605
217,BUMA.1121.00039,1,2424205,2463706,+,39501
217,BUMA.1121.00083,1,3308664,3348115,-,39451
217,BUMA.1121.00084,1,2690892,2730394,+,39502
217,BUMA.1121.00049,1,3519547,3559021,-,39474
217,BUMA.1121.00089,1,2277033,2316702,+,39669
217,BUMA.1121.00014,1,452886,492314,-,39428
217,BUMA.1121.00090,1,404310,443788,+,39478
217,BUMA.1121.00071,1,1512359,1551810,-,39451
217,BUMA.1121.00078,1,3695448,3734943,-,39495
217,BUMA.1121.00102,1,2976659,3016022,-,39363
217,BUMA.1121.00075,1,1769634,1809099,+,39465
217,BUMA.1121.00012,1,1042054,1081522,+,39468
217,BUMA.1121.00076,1,3004973,3044441,-,39468
217,BUMA.1121.00106,1,2063501,2103001,+,39500
217,BUMA.1121.00001,1,1724377,1763934,-,39557
217,BUMA.1121.00107,1,2194395,2233932,+,39537
217,BUMA.1121.00104,1,2886894,2926556,-,39662
217,BUMA.1121.00099,1,1,39572,-,39571
217,BUMA.1121.00098,1,945752,985216,+,39464
217,BUMA.1121.00111,1,2479812,2519307,+,39495
217,BUMA.1121.00109,1,3541658,3581221,-,39563
217,BUMA.1121.00097,1,1571812,1611374,-,39562
217,BUMA.1121.00094,1,2307507,2347023,+,39516
217,BUMA.1121.00095,1,3349674,3389269,-,39595
217,BUMA.1121.00005,1,1032882,1072386,+,39504
217,BUMA.1121.00101,1,127208,166725,-,39517
217,BUMA.1121.00065,1,2393520,2433030,+,39510
217,BUMA.1121.00100,1,2999268,3038828,-,39560
217,BUMA.1121.00105,1,2879977,2919467,-,39490
217,BUMA.1121.00029,1,2606188,2645719,-,39531
217,BUMA.1121.00066,1,1496428,1535879,-,39451
217,BUMA.1121.00031,1,3724693,3764275,+,39582
217,BUMA.1121.00108,1,3326830,3366384,+,39554
217,BUMA.1121.00023,1,635405,674857,+,39452
217,BUMA.1121.00035,1,3442951,3482469,+,39518
217,BUMA.1121.00041,1,3612033,3651557,+,39524
216,BUMA.1121.00057,1,3369186,3399443,+,30257
216,BUMA.1121.00058,1,2252740,2283097,-,30357
216,BUMA.1121.00045,1,1738741,1769008,-,30267
216,BUMA.1121.00051,1,2258986,2289331,+,30345
216,BUMA.1121.00068,1,1027939,1058249,+,30310
216,BUMA.1121.00061,1,1562259,1592621,-,30362
216,BUMA.1121.00060,1,3985586,4015853,-,30267
216,BUMA.1121.00064,1,2301350,2331699,+,30349
216,BUMA.1121.00016,1,397575,427792,+,30217
216,BUMA.1121.00003,1,793944,824307,+,30363
216,BUMA.1121.00055,1,1888134,1918444,+,30310
216,BUMA.1121.00011,1,3341105,3371364,-,30259
216,BUMA.1121.00037,1,899260,929510,+,30250
216,BUMA.1121.00009,1,3248667,3278909,-,30242
216,BUMA.1121.00069,1,1515125,1545487,-,30362
216,BUMA.1121.00088,1,3204812,3235140,+,30328
216,BUMA.1121.00092,1,1497239,1527489,-,30250
216,BUMA.1121.00074,1,1541184,1571549,-,30365
216,BUMA.1121.00070,1,1533196,1563549,-,30353
216,BUMA.1121.00093,1,3098793,3129044,+,30251
216,BUMA.1121.00063,1,1559415,1589777,-,30362
216,BUMA.1121.00033,1,412789,443026,+,30237
216,BUMA.1121.00018,1,2885344,2915638,+,30294
216,BUMA.1121.00080,1,2289255,2319601,+,30346
216,BUMA.1121.00027,1,444698,474966,+,30268
216,BUMA.1121.00053,1,1997621,2027990,+,30369
216,BUMA.1121.00059,1,1477392,1507732,+,30340
216,BUMA.1121.00043,1,2353306,2383545,+,30239
216,BUMA.1121.00056,1,1650053,1680395,-,30342
216,BUMA.1121.00112,1,666957,697186,-,30229
216,BUMA.1121.00091,1,2198083,2228326,-,30243
216,BUMA.1121.00047,1,671609,701950,-,30341
216,BUMA.1121.00067,1,2096027,2126377,-,30350
216,BUMA.1121.00110,1,2493667,2523889,-,30222
216,BUMA.1121.00073,1,1560472,1590854,-,30382
216,BUMA.1121.00072,1,1534868,1565185,-,30317
216,BUMA.1121.00077,1,959345,989565,+,30220
216,BUMA.1121.00082,1,1693069,1723462,-,30393
216,BUMA.1121.00062,1,2276689,2306929,-,30240
216,BUMA.1121.00007,1,1783456,1813754,-,30298
216,BUMA.1121.00025,1,344063,374329,-,30266
216,BUMA.1121.00021,1,2894995,2925256,+,30261
216,BUMA.1121.00103,1,2120797,2151084,-,30287
216,BUMA.1121.00096,1,944133,974359,-,30226
216,BUMA.1121.00079,1,2285149,2315490,+,30341
216,BUMA.1121.00039,1,2393425,2423672,+,30247
216,BUMA.1121.00083,1,3348647,3379040,-,30393
216,BUMA.1121.00084,1,2660015,2690359,+,30344
216,BUMA.1121.00049,1,3559553,3589910,-,30357
216,BUMA.1121.00089,1,2246159,2276500,+,30341
216,BUMA.1121.00014,1,492846,523090,-,30244
216,BUMA.1121.00090,1,373532,403777,+,30245
216,BUMA.1121.00071,1,1552342,1582693,-,30351
216,BUMA.1121.00078,1,3735475,3765750,-,30275
216,BUMA.1121.00102,1,3016554,3046849,-,30295
216,BUMA.1121.00075,1,1738834,1769102,+,30268
216,BUMA.1121.00012,1,1011285,1041521,+,30236
216,BUMA.1121.00076,1,3044973,3075243,-,30270
216,BUMA.1121.00106,1,2032612,2062968,+,30356
216,BUMA.1121.00001,1,1764466,1794711,-,30245
216,BUMA.1121.00107,1,2163650,2193862,+,30212
216,BUMA.1121.00104,1,2927088,2958755,-,31667
216,BUMA.1121.00099,1,40104,70315,-,30211
216,BUMA.1121.00098,1,914981,945219,+,30238
216,BUMA.1121.00111,1,2449029,2479279,+,30250
216,BUMA.1121.00109,1,3581753,3612061,-,30308
216,BUMA.1121.00097,1,1611906,1642126,-,30220
216,BUMA.1121.00094,1,2276633,2306974,+,30341
216,BUMA.1121.00095,1,3389801,3420078,-,30277
216,BUMA.1121.00005,1,1002105,1032349,+,30244
216,BUMA.1121.00101,1,167257,197532,-,30275
216,BUMA.1121.00065,1,2362768,2392987,+,30219
216,BUMA.1121.00100,1,3039360,3069538,-,30178
216,BUMA.1121.00105,1,2919999,2950247,-,30248
216,BUMA.1121.00029,1,2646251,2676506,-,30255
216,BUMA.1121.00066,1,1536411,1566773,-,30362
216,BUMA.1121.00031,1,3693910,3724160,+,30250
216,BUMA.1121.00108,1,3296065,3326297,+,30232
216,BUMA.1121.00023,1,604626,634872,+,30246
216,BUMA.1121.00035,1,3412164,3442418,+,30254
216,BUMA.1121.00041,1,3581229,3611500,+,30271
215,BUMA.1121.00057,1,3365896,3369140,+,3244
215,BUMA.1121.00058,1,2283143,2286384,-,3241
215,BUMA.1121.00045,1,1769032,1772293,-,3261
215,BUMA.1121.00051,1,2255710,2258940,+,3230
215,BUMA.1121.00068,1,1024647,1027893,+,3246
215,BUMA.1121.00061,1,1592645,1595898,-,3253
215,BUMA.1121.00060,1,4015877,4019138,-,3261
215,BUMA.1121.00064,1,2298063,2301304,+,3241
215,BUMA.1121.00016,1,394290,397529,+,3239
215,BUMA.1121.00003,1,790660,793898,+,3238
215,BUMA.1121.00055,1,1884840,1888088,+,3248
215,BUMA.1121.00011,1,3371388,3374655,-,3267
215,BUMA.1121.00037,1,895975,899214,+,3239
215,BUMA.1121.00009,1,3278933,3282185,-,3252
215,BUMA.1121.00069,1,1545511,1548767,-,3256
215,BUMA.1121.00088,1,3201536,3204766,+,3230
215,BUMA.1121.00092,1,1529113,1532381,-,3268
215,BUMA.1121.00074,1,1571595,1574836,-,3241
215,BUMA.1121.00070,1,1563573,1566829,-,3256
215,BUMA.1121.00093,1,3093902,3097148,+,3246
215,BUMA.1121.00063,1,1589801,1593057,-,3256
215,BUMA.1121.00033,1,409504,412743,+,3239
215,BUMA.1121.00018,1,2882059,2885298,+,3239
215,BUMA.1121.00080,1,2285979,2289209,+,3230
215,BUMA.1121.00027,1,441425,444652,+,3227
215,BUMA.1121.00053,1,1994355,1997575,+,3220
215,BUMA.1121.00059,1,1474112,1477346,+,3234
215,BUMA.1121.00043,1,2350021,2353260,+,3239
215,BUMA.1121.00056,1,1680419,1683671,-,3252
215,BUMA.1121.00112,1,697210,700464,-,3254
215,BUMA.1121.00091,1,2228350,2231602,-,3252
215,BUMA.1121.00047,1,701974,705230,-,3256
215,BUMA.1121.00067,1,2126423,2129664,-,3241
215,BUMA.1121.00110,1,2523913,2527189,-,3276
215,BUMA.1121.00073,1,1590878,1594134,-,3256
215,BUMA.1121.00072,1,1565209,1568465,-,3256
215,BUMA.1121.00077,1,956045,959299,+,3254
215,BUMA.1121.00082,1,1723486,1726742,-,3256
215,BUMA.1121.00062,1,2306975,2310216,-,3241
215,BUMA.1121.00007,1,1813778,1817038,-,3260
215,BUMA.1121.00025,1,374353,377614,-,3261
215,BUMA.1121.00021,1,2891709,2894948,+,3239
215,BUMA.1121.00103,1,2151130,2154364,-,3234
215,BUMA.1121.00096,1,974384,977646,-,3262
215,BUMA.1121.00079,1,2281858,2285104,+,3246
215,BUMA.1121.00039,1,2390140,2393379,+,3239
215,BUMA.1121.00083,1,3379064,3382320,-,3256
215,BUMA.1121.00084,1,2656728,2659969,+,3241
215,BUMA.1121.00049,1,3589934,3593186,-,3252
215,BUMA.1121.00089,1,2242883,2246113,+,3230
215,BUMA.1121.00014,1,523114,526375,-,3261
215,BUMA.1121.00090,1,370247,373486,+,3239
215,BUMA.1121.00071,1,1582717,1585973,-,3256
215,BUMA.1121.00078,1,3765774,3769034,-,3260
215,BUMA.1121.00102,1,3046873,3050125,-,3252
215,BUMA.1121.00075,1,1735563,1738788,+,3225
215,BUMA.1121.00012,1,1008000,1011239,+,3239
215,BUMA.1121.00076,1,3075289,3078514,-,3225
215,BUMA.1121.00106,1,2029320,2032566,+,3246
215,BUMA.1121.00001,1,1794735,1798004,-,3269
215,BUMA.1121.00107,1,2160338,2163604,+,3266
215,BUMA.1121.00104,1,2958801,2962042,-,3241
215,BUMA.1121.00099,1,70339,73604,-,3265
215,BUMA.1121.00098,1,911697,914936,+,3239
215,BUMA.1121.00111,1,2445744,2448983,+,3239
215,BUMA.1121.00109,1,3612085,3615353,-,3268
215,BUMA.1121.00097,1,1642150,1645413,-,3263
215,BUMA.1121.00094,1,2273357,2276587,+,3230
215,BUMA.1121.00095,1,3420102,3423362,-,3260
215,BUMA.1121.00005,1,998833,1002059,+,3226
215,BUMA.1121.00101,1,197578,200810,-,3232
215,BUMA.1121.00065,1,2359475,2362722,+,3247
215,BUMA.1121.00100,1,3069584,3072824,-,3240
215,BUMA.1121.00105,1,2950271,2953523,-,3252
215,BUMA.1121.00029,1,2676530,2679799,-,3269
215,BUMA.1121.00066,1,1566797,1570053,-,3256
215,BUMA.1121.00031,1,3690625,3693864,+,3239
215,BUMA.1121.00108,1,3292790,3296019,+,3229
215,BUMA.1121.00023,1,601341,604580,+,3239
215,BUMA.1121.00035,1,3408871,3412118,+,3247
215,BUMA.1121.00041,1,3577953,3581183,+,3230
214,BUMA.1121.00057,1,3325282,3365527,+,40245
214,BUMA.1121.00058,1,2286753,2328359,-,41606
214,BUMA.1121.00045,1,1772662,1812959,-,40297
214,BUMA.1121.00051,1,2215075,2255341,+,40266
214,BUMA.1121.00068,1,984010,1024278,+,40268
214,BUMA.1121.00061,1,1596267,1636519,-,40252
214,BUMA.1121.00060,1,1,40257,-,40256
214,BUMA.1121.00064,1,2257430,2297694,+,40264
214,BUMA.1121.00016,1,353660,393921,+,40261
214,BUMA.1121.00003,1,749993,790291,+,40298
214,BUMA.1121.00055,1,1842897,1884471,+,41574
214,BUMA.1121.00011,1,3375030,3415329,-,40299
214,BUMA.1121.00037,1,855350,895606,+,40256
214,BUMA.1121.00009,1,3282554,3322845,-,40291
214,BUMA.1121.00069,1,1549136,1589388,-,40252
214,BUMA.1121.00088,1,3159594,3201167,+,41573
214,BUMA.1121.00092,1,1532750,1574336,-,41586
214,BUMA.1121.00074,1,1575205,1615468,-,40263
214,BUMA.1121.00070,1,1567198,1607450,-,40252
214,BUMA.1121.00093,1,3051946,3093533,+,41587
214,BUMA.1121.00063,1,1593426,1633677,-,40251
214,BUMA.1121.00033,1,368881,409135,+,40254
214,BUMA.1121.00018,1,2841423,2881690,+,40267
214,BUMA.1121.00080,1,2245344,2285610,+,40266
214,BUMA.1121.00027,1,400797,441056,+,40259
214,BUMA.1121.00053,1,1953723,1993986,+,40263
214,BUMA.1121.00059,1,1432156,1473743,+,41587
214,BUMA.1121.00043,1,2308083,2349652,+,41569
214,BUMA.1121.00056,1,1684040,1724322,-,40282
214,BUMA.1121.00112,1,700839,741138,-,40299
214,BUMA.1121.00091,1,2231971,2272225,-,40254
214,BUMA.1121.00047,1,705599,745880,-,40281
214,BUMA.1121.00067,1,2130033,2171614,-,41581
214,BUMA.1121.00110,1,2527558,2567823,-,40265
214,BUMA.1121.00073,1,1594503,1634755,-,40252
214,BUMA.1121.00072,1,1568834,1609047,-,40213
214,BUMA.1121.00077,1,915411,955676,+,40265
214,BUMA.1121.00082,1,1727111,1767364,-,40253
214,BUMA.1121.00062,1,2310585,2352186,-,41601
214,BUMA.1121.00007,1,1817407,1857699,-,40292
214,BUMA.1121.00025,1,377983,418248,-,40265
214,BUMA.1121.00021,1,2851085,2891340,+,40255
214,BUMA.1121.00103,1,2154733,2195004,-,40271
214,BUMA.1121.00096,1,978015,1018289,-,40274
214,BUMA.1121.00079,1,2241223,2281489,+,40266
214,BUMA.1121.00039,1,2349515,2389771,+,40256
214,BUMA.1121.00083,1,3382689,3422942,-,40253
214,BUMA.1121.00084,1,2614785,2656359,+,41574
214,BUMA.1121.00049,1,3593555,3633839,-,40284
214,BUMA.1121.00089,1,2202232,2242514,+,40282
214,BUMA.1121.00014,1,526744,566999,-,40255
214,BUMA.1121.00090,1,329622,369878,+,40256
214,BUMA.1121.00071,1,1586342,1626586,-,40244
214,BUMA.1121.00078,1,3769403,3809677,-,40274
214,BUMA.1121.00102,1,3050494,3090757,-,40263
214,BUMA.1121.00075,1,1694926,1735194,+,40268
214,BUMA.1121.00012,1,967373,1007631,+,40258
214,BUMA.1121.00076,1,3078883,3119154,-,40271
214,BUMA.1121.00106,1,1988663,2028951,+,40288
214,BUMA.1121.00001,1,1798373,1838628,-,40255
214,BUMA.1121.00107,1,2119718,2159969,+,40251
214,BUMA.1121.00104,1,2962411,3002708,-,40297
214,BUMA.1121.00099,1,73973,114178,-,40205
214,BUMA.1121.00098,1,869726,911328,+,41602
214,BUMA.1121.00111,1,2403792,2445375,+,41583
214,BUMA.1121.00109,1,3615722,3656023,-,40301
214,BUMA.1121.00097,1,1645782,1687382,-,41600
214,BUMA.1121.00094,1,2232707,2272988,+,40281
214,BUMA.1121.00095,1,3423731,3464035,-,40304
214,BUMA.1121.00005,1,958222,998464,+,40242
214,BUMA.1121.00101,1,201179,241455,-,40276
214,BUMA.1121.00065,1,2318806,2359106,+,40300
214,BUMA.1121.00100,1,3073193,3114759,-,41566
214,BUMA.1121.00105,1,2953892,2994199,-,40307
214,BUMA.1121.00029,1,2680168,2720424,-,40256
214,BUMA.1121.00066,1,1570422,1610675,-,40253
214,BUMA.1121.00031,1,3650001,3690256,+,40255
214,BUMA.1121.00108,1,3252133,3292421,+,40288
214,BUMA.1121.00023,1,560716,600972,+,40256
214,BUMA.1121.00035,1,3368246,3408502,+,40256
214,BUMA.1121.00041,1,3537330,3577584,+,40254
213,BUMA.1121.00057,1,3303290,3325140,+,21850
213,BUMA.1121.00058,1,2328502,2350382,-,21880
213,BUMA.1121.00045,1,1813104,1834950,-,21846
213,BUMA.1121.00051,1,2193086,2214933,+,21847
213,BUMA.1121.00068,1,961962,983866,+,21904
213,BUMA.1121.00061,1,1636662,1658491,-,21829
213,BUMA.1121.00060,1,40402,62248,-,21846
213,BUMA.1121.00064,1,2234150,2255975,+,21825
213,BUMA.1121.00016,1,331700,353518,+,21818
213,BUMA.1121.00003,1,728027,749854,+,21827
213,BUMA.1121.00055,1,1820904,1842756,+,21852
213,BUMA.1121.00011,1,3415472,3437349,-,21877
213,BUMA.1121.00037,1,831756,853615,+,21859
213,BUMA.1121.00009,1,3322988,3344832,-,21844
213,BUMA.1121.00069,1,1589531,1611351,-,21820
213,BUMA.1121.00088,1,3137570,3159452,+,21882
213,BUMA.1121.00092,1,1574478,1596306,-,21828
213,BUMA.1121.00074,1,1616924,1638827,-,21903
213,BUMA.1121.00070,1,1607593,1629429,-,21836
213,BUMA.1121.00093,1,3029977,3051805,+,21828
213,BUMA.1121.00063,1,1633820,1655648,-,21828
213,BUMA.1121.00033,1,345315,367146,+,21831
213,BUMA.1121.00018,1,2817742,2839686,+,21944
213,BUMA.1121.00080,1,2223291,2245202,+,21911
213,BUMA.1121.00027,1,378792,400655,+,21863
213,BUMA.1121.00053,1,1931752,1953582,+,21830
213,BUMA.1121.00059,1,1410164,1432014,+,21850
213,BUMA.1121.00043,1,2284429,2306348,+,21919
213,BUMA.1121.00056,1,1724465,1746324,-,21859
213,BUMA.1121.00112,1,741281,763117,-,21836
213,BUMA.1121.00091,1,2272368,2294215,-,21847
213,BUMA.1121.00047,1,746023,767935,-,21912
213,BUMA.1121.00067,1,2173070,2194934,-,21864
213,BUMA.1121.00110,1,2567967,2589748,-,21781
213,BUMA.1121.00073,1,1634898,1656695,-,21797
213,BUMA.1121.00072,1,1609190,1631055,-,21865
213,BUMA.1121.00077,1,893488,915268,+,21780
213,BUMA.1121.00082,1,1767507,1789372,-,21865
213,BUMA.1121.00062,1,2352329,2374176,-,21847
213,BUMA.1121.00007,1,1857842,1879676,-,21834
213,BUMA.1121.00025,1,419987,441944,-,21957
213,BUMA.1121.00021,1,2827406,2849349,+,21943
213,BUMA.1121.00103,1,2196747,2218564,-,21817
213,BUMA.1121.00096,1,1018432,1040311,-,21879
213,BUMA.1121.00079,1,2219198,2241081,+,21883
213,BUMA.1121.00039,1,2325866,2347780,+,21914
213,BUMA.1121.00083,1,3423085,3444950,-,21865
213,BUMA.1121.00084,1,2592758,2614645,+,21887
213,BUMA.1121.00049,1,3633979,3655865,-,21886
213,BUMA.1121.00089,1,2180231,2202090,+,21859
213,BUMA.1121.00014,1,568739,590558,-,21819
213,BUMA.1121.00090,1,305910,327871,+,21961
213,BUMA.1121.00071,1,1626729,1648593,-,21864
213,BUMA.1121.00078,1,3809818,3831684,-,21866
213,BUMA.1121.00102,1,3090899,3112872,-,21973
213,BUMA.1121.00075,1,1671522,1693347,+,21825
213,BUMA.1121.00012,1,945352,967230,+,21878
213,BUMA.1121.00076,1,3120734,3142560,-,21826
213,BUMA.1121.00106,1,1965391,1987208,+,21817
213,BUMA.1121.00001,1,1840364,1862246,-,21882
213,BUMA.1121.00107,1,2097594,2119575,+,21981
213,BUMA.1121.00104,1,3005758,3027674,-,21916
213,BUMA.1121.00099,1,114320,136188,-,21868
213,BUMA.1121.00098,1,847679,869584,+,21905
213,BUMA.1121.00111,1,2381805,2403648,+,21843
213,BUMA.1121.00109,1,3656163,3678086,-,21923
213,BUMA.1121.00097,1,1687526,1709398,-,21872
213,BUMA.1121.00094,1,2210706,2232565,+,21859
213,BUMA.1121.00095,1,3464178,3486065,-,21887
213,BUMA.1121.00005,1,936265,958081,+,21816
213,BUMA.1121.00101,1,241598,263498,-,21900
213,BUMA.1121.00065,1,2295506,2317348,+,21842
213,BUMA.1121.00100,1,3114901,3136806,-,21905
213,BUMA.1121.00105,1,2994342,3016252,-,21910
213,BUMA.1121.00029,1,2722160,2744003,-,21843
213,BUMA.1121.00066,1,1610818,1632676,-,21858
213,BUMA.1121.00031,1,3626450,3648263,+,21813
213,BUMA.1121.00108,1,3228590,3250398,+,21808
213,BUMA.1121.00023,1,537129,558981,+,21852
213,BUMA.1121.00035,1,3344648,3366511,+,21863
213,BUMA.1121.00041,1,3515297,3537189,+,21892
212,BUMA.1121.00057,1,3296317,3301731,+,5414
212,BUMA.1121.00058,1,2351952,2357365,-,5413
212,BUMA.1121.00045,1,1836516,1841929,-,5413
212,BUMA.1121.00051,1,2186021,2191448,+,5427
212,BUMA.1121.00068,1,954905,960334,+,5429
212,BUMA.1121.00061,1,1660105,1665519,-,5414
212,BUMA.1121.00060,1,63835,69248,-,5413
212,BUMA.1121.00064,1,2227081,2232508,+,5427
212,BUMA.1121.00016,1,324744,330171,+,5427
212,BUMA.1121.00003,1,721048,726479,+,5431
212,BUMA.1121.00055,1,1813927,1819359,+,5432
212,BUMA.1121.00011,1,3438846,3444273,-,5427
212,BUMA.1121.00037,1,824661,830088,+,5427
212,BUMA.1121.00009,1,3346527,3351956,-,5429
212,BUMA.1121.00069,1,1612988,1618382,-,5394
212,BUMA.1121.00088,1,3130585,3136013,+,5428
212,BUMA.1121.00092,1,1597849,1603280,-,5431
212,BUMA.1121.00074,1,1640521,1645952,-,5431
212,BUMA.1121.00070,1,1631015,1636425,-,5410
212,BUMA.1121.00093,1,3023004,3028431,+,5427
212,BUMA.1121.00063,1,1657139,1662537,-,5398
212,BUMA.1121.00033,1,338398,343807,+,5409
212,BUMA.1121.00018,1,2810595,2816022,+,5427
212,BUMA.1121.00080,1,2216152,2221579,+,5427
212,BUMA.1121.00027,1,371796,377223,+,5427
212,BUMA.1121.00053,1,1924750,1930178,+,5428
212,BUMA.1121.00059,1,1403124,1408556,+,5432
212,BUMA.1121.00043,1,2277247,2282674,+,5427
212,BUMA.1121.00056,1,1748015,1753428,-,5413
212,BUMA.1121.00112,1,764675,770089,-,5414
212,BUMA.1121.00091,1,2295740,2301151,-,5411
212,BUMA.1121.00047,1,769624,775055,-,5431
212,BUMA.1121.00067,1,2196469,2201900,-,5431
212,BUMA.1121.00110,1,2591285,2596694,-,5409
212,BUMA.1121.00073,1,1658367,1663783,-,5416
212,BUMA.1121.00072,1,1632561,1637974,-,5413
212,BUMA.1121.00077,1,886451,891864,+,5413
212,BUMA.1121.00082,1,1791064,1796478,-,5414
212,BUMA.1121.00062,1,2375838,2381252,-,5414
212,BUMA.1121.00007,1,1881331,1886744,-,5413
212,BUMA.1121.00025,1,443668,449100,-,5432
212,BUMA.1121.00021,1,2820445,2825877,+,5432
212,BUMA.1121.00103,1,2220061,2225486,-,5425
212,BUMA.1121.00096,1,1041769,1047200,-,5431
212,BUMA.1121.00079,1,2212158,2217585,+,5427
212,BUMA.1121.00039,1,2318927,2324354,+,5427
212,BUMA.1121.00083,1,3446642,3452056,-,5414
212,BUMA.1121.00084,1,2585763,2591192,+,5429
212,BUMA.1121.00049,1,3657536,3662949,-,5413
212,BUMA.1121.00089,1,2173139,2178548,+,5409
212,BUMA.1121.00014,1,592125,597556,-,5431
212,BUMA.1121.00090,1,299010,304441,+,5431
212,BUMA.1121.00071,1,1650238,1655650,-,5412
212,BUMA.1121.00078,1,3833363,3838794,-,5431
212,BUMA.1121.00102,1,3114519,3119951,-,5432
212,BUMA.1121.00075,1,1664485,1669886,+,5401
212,BUMA.1121.00012,1,938417,943844,+,5427
212,BUMA.1121.00076,1,3144189,3149594,-,5405
212,BUMA.1121.00106,1,1958313,1963722,+,5409
212,BUMA.1121.00001,1,1863764,1869195,-,5431
212,BUMA.1121.00107,1,2090602,2096033,+,5431
212,BUMA.1121.00104,1,3029381,3034812,-,5431
212,BUMA.1121.00099,1,137748,143179,-,5431
212,BUMA.1121.00098,1,840713,846122,+,5409
212,BUMA.1121.00111,1,2374835,2380266,+,5431
212,BUMA.1121.00109,1,3679667,3685098,-,5431
212,BUMA.1121.00097,1,1711138,1716552,-,5414
212,BUMA.1121.00094,1,2203568,2208994,+,5426
212,BUMA.1121.00095,1,3487635,3493039,-,5404
212,BUMA.1121.00005,1,929374,934777,+,5403
212,BUMA.1121.00101,1,265058,270472,-,5414
212,BUMA.1121.00065,1,2288420,2293830,+,5410
212,BUMA.1121.00100,1,3139803,3145234,-,5431
212,BUMA.1121.00105,1,3017852,3023283,-,5431
212,BUMA.1121.00029,1,2745528,2750959,-,5431
212,BUMA.1121.00066,1,1634328,1639722,-,5394
212,BUMA.1121.00031,1,3619487,3624918,+,5431
212,BUMA.1121.00108,1,3221684,3227115,+,5431
212,BUMA.1121.00023,1,529862,535289,+,5427
212,BUMA.1121.00035,1,3336322,3341753,+,5431
212,BUMA.1121.00041,1,3508269,3513701,+,5432
211,BUMA.1121.00057,1,3288275,3295477,+,7202
211,BUMA.1121.00058,1,2358205,2365407,-,7202
211,BUMA.1121.00045,1,1842769,1849971,-,7202
211,BUMA.1121.00051,1,2177986,2185181,+,7195
211,BUMA.1121.00068,1,946870,954065,+,7195
211,BUMA.1121.00061,1,1666359,1673558,-,7199
211,BUMA.1121.00060,1,70088,77290,-,7202
211,BUMA.1121.00064,1,2219047,2226241,+,7194
211,BUMA.1121.00016,1,316717,323904,+,7187
211,BUMA.1121.00003,1,697046,704207,+,7161
211,BUMA.1121.00055,1,1805899,1813087,+,7188
211,BUMA.1121.00011,1,3445113,3452284,-,7171
211,BUMA.1121.00037,1,816620,823821,+,7201
211,BUMA.1121.00009,1,3352796,3359968,-,7172
211,BUMA.1121.00069,1,1619222,1626423,-,7201
211,BUMA.1121.00088,1,3122542,3129745,+,7203
211,BUMA.1121.00092,1,1604120,1611321,-,7201
211,BUMA.1121.00074,1,1646792,1653987,-,7195
211,BUMA.1121.00070,1,1637265,1644464,-,7199
211,BUMA.1121.00093,1,3014963,3022164,+,7201
211,BUMA.1121.00063,1,1663377,1670578,-,7201
211,BUMA.1121.00033,1,330365,337558,+,7193
211,BUMA.1121.00018,1,2802560,2809755,+,7195
211,BUMA.1121.00080,1,2208117,2215312,+,7195
211,BUMA.1121.00027,1,363762,370956,+,7194
211,BUMA.1121.00053,1,1916715,1923910,+,7195
211,BUMA.1121.00059,1,1395082,1402284,+,7202
211,BUMA.1121.00043,1,2269213,2276407,+,7194
211,BUMA.1121.00056,1,1754268,1761464,-,7196
211,BUMA.1121.00112,1,770929,778108,-,7179
211,BUMA.1121.00091,1,2301991,2309178,-,7187
211,BUMA.1121.00047,1,775895,783090,-,7195
211,BUMA.1121.00067,1,2202740,2209931,-,7191
211,BUMA.1121.00110,1,2597534,2604736,-,7202
211,BUMA.1121.00073,1,1664623,1671825,-,7202
211,BUMA.1121.00072,1,1638814,1646015,-,7201
211,BUMA.1121.00077,1,878409,885611,+,7202
211,BUMA.1121.00082,1,1797318,1804520,-,7202
211,BUMA.1121.00062,1,2382092,2389294,-,7202
211,BUMA.1121.00007,1,1887584,1894755,-,7171
211,BUMA.1121.00025,1,449940,457135,-,7195
211,BUMA.1121.00021,1,2812410,2819605,+,7195
211,BUMA.1121.00103,1,2226326,2233513,-,7187
211,BUMA.1121.00096,1,1048040,1055242,-,7202
211,BUMA.1121.00079,1,2204131,2211318,+,7187
211,BUMA.1121.00039,1,2310893,2318087,+,7194
211,BUMA.1121.00083,1,3452896,3460098,-,7202
211,BUMA.1121.00084,1,2577714,2584923,+,7209
211,BUMA.1121.00049,1,3677568,3684762,-,7194
211,BUMA.1121.00089,1,2165103,2172299,+,7196
211,BUMA.1121.00014,1,598396,605591,-,7195
211,BUMA.1121.00090,1,290975,298170,+,7195
211,BUMA.1121.00071,1,1656490,1663692,-,7202
211,BUMA.1121.00078,1,3839634,3846829,-,7195
211,BUMA.1121.00102,1,3120791,3127986,-,7195
211,BUMA.1121.00075,1,1656452,1663645,+,7193
211,BUMA.1121.00012,1,930383,937577,+,7194
211,BUMA.1121.00076,1,3150434,3157629,-,7195
211,BUMA.1121.00106,1,1950278,1957473,+,7195
211,BUMA.1121.00001,1,1870035,1877222,-,7187
211,BUMA.1121.00107,1,2082589,2089762,+,7173
211,BUMA.1121.00104,1,3035652,3042848,-,7196
211,BUMA.1121.00099,1,144019,151226,-,7207
211,BUMA.1121.00098,1,814323,821509,+,7186
211,BUMA.1121.00111,1,2366800,2373995,+,7195
211,BUMA.1121.00109,1,3685938,3693126,-,7188
211,BUMA.1121.00097,1,1717392,1724570,-,7178
211,BUMA.1121.00094,1,2195532,2202728,+,7196
211,BUMA.1121.00095,1,3493879,3501057,-,7178
211,BUMA.1121.00005,1,921332,928534,+,7202
211,BUMA.1121.00101,1,271312,278508,-,7196
211,BUMA.1121.00065,1,2280390,2287580,+,7190
211,BUMA.1121.00100,1,3146074,3153278,-,7204
211,BUMA.1121.00105,1,3024123,3031332,-,7209
211,BUMA.1121.00029,1,2751799,2758986,-,7187
211,BUMA.1121.00066,1,1640562,1647763,-,7201
211,BUMA.1121.00031,1,3611452,3618647,+,7195
211,BUMA.1121.00108,1,3213649,3220844,+,7195
211,BUMA.1121.00023,1,521827,529022,+,7195
211,BUMA.1121.00035,1,3328295,3335482,+,7187
211,BUMA.1121.00041,1,3500234,3507429,+,7195
210,BUMA.1121.00057,1,3278936,3284442,+,5506
210,BUMA.1121.00058,1,2369239,2374740,-,5501
210,BUMA.1121.00045,1,1853803,1859307,-,5504
210,BUMA.1121.00051,1,2168641,2174153,+,5512
210,BUMA.1121.00068,1,937546,943037,+,5491
210,BUMA.1121.00061,1,1677390,1682897,-,5507
210,BUMA.1121.00060,1,81122,86626,-,5504
210,BUMA.1121.00064,1,2209708,2215214,+,5506
210,BUMA.1121.00016,1,307367,312884,+,5517
210,BUMA.1121.00003,1,687708,693213,+,5505
210,BUMA.1121.00055,1,1796560,1802066,+,5506
210,BUMA.1121.00011,1,3456116,3461628,-,5512
210,BUMA.1121.00037,1,807281,812787,+,5506
210,BUMA.1121.00009,1,3363800,3369306,-,5506
210,BUMA.1121.00069,1,1630255,1635760,-,5505
210,BUMA.1121.00088,1,3113206,3118709,+,5503
210,BUMA.1121.00092,1,1615153,1620660,-,5507
210,BUMA.1121.00074,1,1657819,1663326,-,5507
210,BUMA.1121.00070,1,1648296,1653803,-,5507
210,BUMA.1121.00093,1,3005624,3011130,+,5506
210,BUMA.1121.00063,1,1674410,1679917,-,5507
210,BUMA.1121.00033,1,321028,326533,+,5505
210,BUMA.1121.00018,1,2793221,2798727,+,5506
210,BUMA.1121.00080,1,2198772,2204284,+,5512
210,BUMA.1121.00027,1,354424,359929,+,5505
210,BUMA.1121.00053,1,1907390,1912882,+,5492
210,BUMA.1121.00059,1,1385746,1391249,+,5503
210,BUMA.1121.00043,1,2259874,2265380,+,5506
210,BUMA.1121.00056,1,1765296,1770809,-,5513
210,BUMA.1121.00112,1,781940,787447,-,5507
210,BUMA.1121.00091,1,2313010,2318517,-,5507
210,BUMA.1121.00047,1,786922,792435,-,5513
210,BUMA.1121.00067,1,2213763,2219267,-,5504
210,BUMA.1121.00110,1,2608568,2614072,-,5504
210,BUMA.1121.00073,1,1675657,1681164,-,5507
210,BUMA.1121.00072,1,1649847,1655346,-,5499
210,BUMA.1121.00077,1,869073,874576,+,5503
210,BUMA.1121.00082,1,1808352,1813859,-,5507
210,BUMA.1121.00062,1,2393126,2398633,-,5507
210,BUMA.1121.00007,1,1898587,1904094,-,5507
210,BUMA.1121.00025,1,460967,466474,-,5507
210,BUMA.1121.00021,1,2803071,2808577,+,5506
210,BUMA.1121.00103,1,2237345,2242852,-,5507
210,BUMA.1121.00096,1,1059074,1064578,-,5504
210,BUMA.1121.00079,1,2194786,2200298,+,5512
210,BUMA.1121.00039,1,2301554,2307060,+,5506
210,BUMA.1121.00083,1,3463930,3469437,-,5507
210,BUMA.1121.00084,1,2568375,2573881,+,5506
210,BUMA.1121.00049,1,3688594,3694101,-,5507
210,BUMA.1121.00089,1,2155758,2161270,+,5512
210,BUMA.1121.00014,1,609423,614930,-,5507
210,BUMA.1121.00090,1,281636,287142,+,5506
210,BUMA.1121.00071,1,1667524,1673028,-,5504
210,BUMA.1121.00078,1,3850661,3856154,-,5493
210,BUMA.1121.00102,1,3131818,3137322,-,5504
210,BUMA.1121.00075,1,1647113,1652619,+,5506
210,BUMA.1121.00012,1,921044,926550,+,5506
210,BUMA.1121.00076,1,3161461,3166968,-,5507
210,BUMA.1121.00106,1,1940939,1946445,+,5506
210,BUMA.1121.00001,1,1881053,1886560,-,5507
210,BUMA.1121.00107,1,2073250,2078756,+,5506
210,BUMA.1121.00104,1,3046680,3052187,-,5507
210,BUMA.1121.00099,1,155058,160567,-,5509
210,BUMA.1121.00098,1,804986,810490,+,5504
210,BUMA.1121.00111,1,2357461,2362967,+,5506
210,BUMA.1121.00109,1,3696958,3702462,-,5504
210,BUMA.1121.00097,1,1728402,1733905,-,5503
210,BUMA.1121.00094,1,2186186,2191699,+,5513
210,BUMA.1121.00095,1,3504889,3510396,-,5507
210,BUMA.1121.00005,1,911999,917499,+,5500
210,BUMA.1121.00101,1,282340,287836,-,5496
210,BUMA.1121.00065,1,2271051,2276557,+,5506
210,BUMA.1121.00100,1,3157110,3162607,-,5497
210,BUMA.1121.00105,1,3035164,3040668,-,5504
210,BUMA.1121.00029,1,2762818,2768325,-,5507
210,BUMA.1121.00066,1,1651595,1657100,-,5505
210,BUMA.1121.00031,1,3602113,3607619,+,5506
210,BUMA.1121.00108,1,3204307,3209816,+,5509
210,BUMA.1121.00023,1,512488,517994,+,5506
210,BUMA.1121.00035,1,3318956,3324462,+,5506
210,BUMA.1121.00041,1,3490898,3496401,+,5503
209,BUMA.1121.00057,1,3253819,3276392,+,22573
209,BUMA.1121.00058,1,2377282,2399701,-,22419
209,BUMA.1121.00045,1,1861853,1884257,-,22404
209,BUMA.1121.00051,1,2143587,2166076,+,22489
209,BUMA.1121.00068,1,912540,934989,+,22449
209,BUMA.1121.00061,1,1685441,1708034,-,22593
209,BUMA.1121.00060,1,89172,111576,-,22404
209,BUMA.1121.00064,1,2184699,2207166,+,22467
209,BUMA.1121.00016,1,282344,304823,+,22479
209,BUMA.1121.00003,1,657704,680128,+,22424
209,BUMA.1121.00055,1,1771519,1794016,+,22497
209,BUMA.1121.00011,1,3469212,3491547,-,22335
209,BUMA.1121.00037,1,782172,804737,+,22565
209,BUMA.1121.00009,1,3376890,3399283,-,22393
209,BUMA.1121.00069,1,1638304,1660905,-,22601
209,BUMA.1121.00088,1,3088145,3110662,+,22517
209,BUMA.1121.00092,1,1623204,1645639,-,22435
209,BUMA.1121.00074,1,1665868,1688302,-,22434
209,BUMA.1121.00070,1,1656347,1678943,-,22596
209,BUMA.1121.00093,1,2980645,3003080,+,22435
209,BUMA.1121.00063,1,1682461,1705062,-,22601
209,BUMA.1121.00033,1,296058,318484,+,22426
209,BUMA.1121.00018,1,2768080,2790665,+,22585
209,BUMA.1121.00080,1,2173729,2196207,+,22478
209,BUMA.1121.00027,1,329311,351880,+,22569
209,BUMA.1121.00053,1,1882287,1904836,+,22549
209,BUMA.1121.00059,1,1360782,1383204,+,22422
209,BUMA.1121.00043,1,2234863,2257330,+,22467
209,BUMA.1121.00056,1,1773375,1795854,-,22479
209,BUMA.1121.00112,1,790015,812450,-,22435
209,BUMA.1121.00091,1,2321061,2343615,-,22554
209,BUMA.1121.00047,1,795001,817513,-,22512
209,BUMA.1121.00067,1,2221811,2244295,-,22484
209,BUMA.1121.00110,1,2616618,2639024,-,22406
209,BUMA.1121.00073,1,1683708,1706308,-,22600
209,BUMA.1121.00072,1,1657890,1680491,-,22601
209,BUMA.1121.00077,1,844123,866527,+,22404
209,BUMA.1121.00082,1,1816403,1839004,-,22601
209,BUMA.1121.00062,1,2401175,2423653,-,22478
209,BUMA.1121.00007,1,1906639,1929094,-,22455
209,BUMA.1121.00025,1,469030,491605,-,22575
209,BUMA.1121.00021,1,2777896,2800527,+,22631
209,BUMA.1121.00103,1,2245396,2267891,-,22495
209,BUMA.1121.00096,1,1067137,1089612,-,22475
209,BUMA.1121.00079,1,2169765,2192221,+,22456
209,BUMA.1121.00039,1,2276434,2299010,+,22576
209,BUMA.1121.00083,1,3471981,3494571,-,22590
209,BUMA.1121.00084,1,2543297,2565821,+,22524
209,BUMA.1121.00049,1,3696645,3719072,-,22427
209,BUMA.1121.00089,1,2130713,2153192,+,22479
209,BUMA.1121.00014,1,617474,640073,-,22599
209,BUMA.1121.00090,1,256567,279092,+,22525
209,BUMA.1121.00071,1,1675572,1697988,-,22416
209,BUMA.1121.00078,1,3858696,3881305,-,22609
209,BUMA.1121.00102,1,3139866,3162443,-,22577
209,BUMA.1121.00075,1,1622168,1644569,+,22401
209,BUMA.1121.00012,1,896007,918500,+,22493
209,BUMA.1121.00076,1,3169512,3191914,-,22402
209,BUMA.1121.00106,1,1915977,1938406,+,22429
209,BUMA.1121.00001,1,1889104,1911625,-,22521
209,BUMA.1121.00107,1,2048146,2070698,+,22552
209,BUMA.1121.00104,1,3054729,3077158,-,22429
209,BUMA.1121.00099,1,168158,190550,-,22392
209,BUMA.1121.00098,1,773741,796170,+,22429
209,BUMA.1121.00111,1,2332464,2354917,+,22453
209,BUMA.1121.00109,1,3704994,3727562,-,22568
209,BUMA.1121.00097,1,1766694,1789083,-,22389
209,BUMA.1121.00094,1,2161140,2183620,+,22480
209,BUMA.1121.00095,1,3512940,3535414,-,22474
209,BUMA.1121.00005,1,886957,909460,+,22503
209,BUMA.1121.00101,1,290381,312788,-,22407
209,BUMA.1121.00065,1,2246037,2268509,+,22472
209,BUMA.1121.00100,1,3165151,3187608,-,22457
209,BUMA.1121.00105,1,3043210,3065697,-,22487
209,BUMA.1121.00029,1,2770869,2793422,-,22553
209,BUMA.1121.00066,1,1659644,1682058,-,22414
209,BUMA.1121.00031,1,3577025,3599569,+,22544
209,BUMA.1121.00108,1,3179289,3201763,+,22474
209,BUMA.1121.00023,1,487407,509944,+,22537
209,BUMA.1121.00035,1,3293890,3316412,+,22522
209,BUMA.1121.00041,1,3465750,3488354,+,22604
208,BUMA.1121.00057,1,3222110,3246994,+,24884
208,BUMA.1121.00058,1,2408411,2433148,-,24737
208,BUMA.1121.00045,1,1890916,1915621,-,24705
208,BUMA.1121.00051,1,2112093,2136855,+,24762
208,BUMA.1121.00068,1,880936,905843,+,24907
208,BUMA.1121.00061,1,1714689,1739434,-,24745
208,BUMA.1121.00060,1,118235,142940,-,24705
208,BUMA.1121.00064,1,2153328,2178052,+,24724
208,BUMA.1121.00016,1,250953,275698,+,24745
208,BUMA.1121.00003,1,621298,646097,+,24799
208,BUMA.1121.00055,1,1738004,1762769,+,24765
208,BUMA.1121.00011,1,3500252,3525026,-,24774
208,BUMA.1121.00037,1,750753,775517,+,24764
208,BUMA.1121.00009,1,3408003,3432779,-,24776
208,BUMA.1121.00069,1,1667560,1692309,-,24749
208,BUMA.1121.00088,1,3056842,3081514,+,24672
208,BUMA.1121.00092,1,1654343,1679065,-,24722
208,BUMA.1121.00074,1,1694930,1719601,-,24671
208,BUMA.1121.00070,1,1685607,1710364,-,24757
208,BUMA.1121.00093,1,2947219,2971940,+,24721
208,BUMA.1121.00063,1,1711718,1736469,-,24751
208,BUMA.1121.00033,1,264621,289367,+,24746
208,BUMA.1121.00018,1,2736595,2761429,+,24834
208,BUMA.1121.00080,1,2142082,2166970,+,24888
208,BUMA.1121.00027,1,297629,322301,+,24672
208,BUMA.1121.00053,1,1849452,1874198,+,24746
208,BUMA.1121.00059,1,1327256,1352062,+,24806
208,BUMA.1121.00043,1,2203372,2228070,+,24698
208,BUMA.1121.00056,1,1802606,1827364,-,24758
208,BUMA.1121.00112,1,819102,843894,-,24792
208,BUMA.1121.00091,1,2350414,2375165,-,24751
208,BUMA.1121.00047,1,824258,848998,-,24740
208,BUMA.1121.00067,1,2250998,2275736,-,24738
208,BUMA.1121.00110,1,2645654,2670397,-,24743
208,BUMA.1121.00073,1,1712971,1737730,-,24759
208,BUMA.1121.00072,1,1687096,1711844,-,24748
208,BUMA.1121.00077,1,812752,837492,+,24740
208,BUMA.1121.00082,1,1845856,1870619,-,24763
208,BUMA.1121.00062,1,2432367,2457105,-,24738
208,BUMA.1121.00007,1,1937799,1962540,-,24741
208,BUMA.1121.00025,1,498255,523076,-,24821
208,BUMA.1121.00021,1,2746758,2771189,+,24431
208,BUMA.1121.00103,1,2273956,2298725,-,24769
208,BUMA.1121.00096,1,1096235,1120875,-,24640
208,BUMA.1121.00079,1,2138313,2163041,+,24728
208,BUMA.1121.00039,1,2245066,2269782,+,24716
208,BUMA.1121.00083,1,3501430,3526193,-,24763
208,BUMA.1121.00084,1,2512031,2536654,+,24623
208,BUMA.1121.00049,1,3727827,3752659,-,24832
208,BUMA.1121.00089,1,2099203,2123960,+,24757
208,BUMA.1121.00014,1,646820,671688,-,24868
208,BUMA.1121.00090,1,225074,249902,+,24828
208,BUMA.1121.00071,1,1704606,1729358,-,24752
208,BUMA.1121.00078,1,3887950,3912644,-,24694
208,BUMA.1121.00102,1,3170525,3195280,-,24755
208,BUMA.1121.00075,1,1590610,1615507,+,24897
208,BUMA.1121.00012,1,864606,889280,+,24674
208,BUMA.1121.00076,1,3198568,3223477,-,24909
208,BUMA.1121.00106,1,1882369,1907232,+,24863
208,BUMA.1121.00001,1,1918340,1943196,-,24856
208,BUMA.1121.00107,1,2016714,2041509,+,24795
208,BUMA.1121.00104,1,3085881,3110502,-,24621
208,BUMA.1121.00099,1,197217,221894,-,24677
208,BUMA.1121.00098,1,742307,767092,+,24785
208,BUMA.1121.00111,1,2301017,2325792,+,24775
208,BUMA.1121.00109,1,3736274,3760922,-,24648
208,BUMA.1121.00097,1,1797004,1821684,-,24680
208,BUMA.1121.00094,1,2129630,2154379,+,24749
208,BUMA.1121.00095,1,3542053,3566693,-,24640
208,BUMA.1121.00005,1,853523,878269,+,24746
208,BUMA.1121.00101,1,321477,346269,-,24792
208,BUMA.1121.00065,1,2214679,2239412,+,24733
208,BUMA.1121.00100,1,3194253,3219053,-,24800
208,BUMA.1121.00105,1,3074413,3099276,-,24863
208,BUMA.1121.00029,1,2800158,2824958,-,24800
208,BUMA.1121.00066,1,1688684,1713436,-,24752
208,BUMA.1121.00031,1,3545427,3570319,+,24892
208,BUMA.1121.00108,1,3145840,3170575,+,24735
208,BUMA.1121.00023,1,455994,480749,+,24755
208,BUMA.1121.00035,1,3262423,3287223,+,24800
208,BUMA.1121.00041,1,3434897,3459589,+,24692
207,BUMA.1121.00057,1,3210213,3220716,+,10503
207,BUMA.1121.00058,1,2434542,2445053,-,10511
207,BUMA.1121.00045,1,1917027,1927520,-,10493
207,BUMA.1121.00051,1,2100186,2110702,+,10516
207,BUMA.1121.00068,1,869053,879559,+,10506
207,BUMA.1121.00061,1,1740821,1751323,-,10502
207,BUMA.1121.00060,1,144346,154839,-,10493
207,BUMA.1121.00064,1,2141417,2151946,+,10529
207,BUMA.1121.00016,1,239079,249568,+,10489
207,BUMA.1121.00003,1,609366,619910,+,10544
207,BUMA.1121.00055,1,1726098,1736604,+,10506
207,BUMA.1121.00011,1,3526438,3536941,-,10503
207,BUMA.1121.00037,1,738878,749368,+,10490
207,BUMA.1121.00009,1,3434161,3444658,-,10497
207,BUMA.1121.00069,1,1693702,1704204,-,10502
207,BUMA.1121.00088,1,3044917,3055436,+,10519
207,BUMA.1121.00092,1,1680465,1690979,-,10514
207,BUMA.1121.00074,1,1720995,1731529,-,10534
207,BUMA.1121.00070,1,1711758,1722260,-,10502
207,BUMA.1121.00093,1,2935305,2945819,+,10514
207,BUMA.1121.00063,1,1737863,1748366,-,10503
207,BUMA.1121.00033,1,252729,263227,+,10498
207,BUMA.1121.00018,1,2724705,2735210,+,10505
207,BUMA.1121.00080,1,2130170,2140691,+,10521
207,BUMA.1121.00027,1,285732,296235,+,10503
207,BUMA.1121.00053,1,1837550,1848070,+,10520
207,BUMA.1121.00059,1,1315347,1325859,+,10512
207,BUMA.1121.00043,1,2191483,2201987,+,10504
207,BUMA.1121.00056,1,1828755,1839272,-,10517
207,BUMA.1121.00112,1,845279,855790,-,10511
207,BUMA.1121.00091,1,2376550,2387055,-,10505
207,BUMA.1121.00047,1,850389,860905,-,10516
207,BUMA.1121.00067,1,2277130,2287654,-,10524
207,BUMA.1121.00110,1,2671797,2682320,-,10523
207,BUMA.1121.00073,1,1739119,1749622,-,10503
207,BUMA.1121.00072,1,1713237,1723739,-,10502
207,BUMA.1121.00077,1,800831,811352,+,10521
207,BUMA.1121.00082,1,1872013,1882516,-,10503
207,BUMA.1121.00062,1,2458499,2469023,-,10524
207,BUMA.1121.00007,1,1963919,1974419,-,10500
207,BUMA.1121.00025,1,524461,534966,-,10505
207,BUMA.1121.00021,1,2734874,2745373,+,10499
207,BUMA.1121.00103,1,2300101,2310614,-,10513
207,BUMA.1121.00096,1,1122257,1132712,-,10455
207,BUMA.1121.00079,1,2126407,2136922,+,10515
207,BUMA.1121.00039,1,2233177,2243681,+,10504
207,BUMA.1121.00083,1,3527587,3538090,-,10503
207,BUMA.1121.00084,1,2500125,2510649,+,10524
207,BUMA.1121.00049,1,3754029,3764548,-,10519
207,BUMA.1121.00089,1,2087295,2097812,+,10517
207,BUMA.1121.00014,1,673073,683603,-,10530
207,BUMA.1121.00090,1,213185,223689,+,10504
207,BUMA.1121.00071,1,1730751,1741241,-,10490
207,BUMA.1121.00078,1,3914050,3924547,-,10497
207,BUMA.1121.00102,1,3196674,3207208,-,10534
207,BUMA.1121.00075,1,1578745,1589234,+,10489
207,BUMA.1121.00012,1,852707,863221,+,10514
207,BUMA.1121.00076,1,3224853,3235337,-,10484
207,BUMA.1121.00106,1,1870464,1880981,+,10517
207,BUMA.1121.00001,1,1944581,1955085,-,10504
207,BUMA.1121.00107,1,2004815,2015329,+,10514
207,BUMA.1121.00104,1,3111878,3122388,-,10510
207,BUMA.1121.00099,1,223285,233793,-,10508
207,BUMA.1121.00098,1,730418,740925,+,10507
207,BUMA.1121.00111,1,2289142,2299638,+,10496
207,BUMA.1121.00109,1,3762292,3772827,-,10535
207,BUMA.1121.00097,1,1823069,1833587,-,10518
207,BUMA.1121.00094,1,2117722,2128239,+,10517
207,BUMA.1121.00095,1,3568087,3578554,-,10467
207,BUMA.1121.00005,1,841622,852138,+,10516
207,BUMA.1121.00101,1,347654,358068,-,10414
207,BUMA.1121.00065,1,2202787,2213279,+,10492
207,BUMA.1121.00100,1,3220441,3230964,-,10523
207,BUMA.1121.00105,1,3100676,3111195,-,10519
207,BUMA.1121.00029,1,2826343,2836842,-,10499
207,BUMA.1121.00066,1,1714823,1725325,-,10502
207,BUMA.1121.00031,1,3533547,3544042,+,10495
207,BUMA.1121.00108,1,3133934,3144464,+,10530
207,BUMA.1121.00023,1,444127,454618,+,10491
207,BUMA.1121.00035,1,3250534,3261038,+,10504
207,BUMA.1121.00041,1,3422992,3433497,+,10505
206,BUMA.1121.00057,1,3201638,3207202,+,5564
206,BUMA.1121.00058,1,2448065,2453612,-,5547
206,BUMA.1121.00045,1,1930528,1936101,-,5573
206,BUMA.1121.00051,1,2091600,2097175,+,5575
206,BUMA.1121.00068,1,860486,866043,+,5557
206,BUMA.1121.00061,1,1754334,1759881,-,5547
206,BUMA.1121.00060,1,157847,163420,-,5573
206,BUMA.1121.00064,1,2132843,2138407,+,5564
206,BUMA.1121.00016,1,230510,236061,+,5551
206,BUMA.1121.00003,1,600778,606336,+,5558
206,BUMA.1121.00055,1,1717522,1723086,+,5564
206,BUMA.1121.00011,1,3539953,3545517,-,5564
206,BUMA.1121.00037,1,730309,735856,+,5547
206,BUMA.1121.00009,1,3447674,3453238,-,5564
206,BUMA.1121.00069,1,1707215,1712779,-,5564
206,BUMA.1121.00088,1,3035157,3040721,+,5564
206,BUMA.1121.00092,1,1693989,1699553,-,5564
206,BUMA.1121.00074,1,1734539,1740103,-,5564
206,BUMA.1121.00070,1,1725271,1730818,-,5547
206,BUMA.1121.00093,1,2926731,2932295,+,5564
206,BUMA.1121.00063,1,1751377,1756924,-,5547
206,BUMA.1121.00033,1,244156,249707,+,5551
206,BUMA.1121.00018,1,2716132,2721683,+,5551
206,BUMA.1121.00080,1,2121583,2127159,+,5576
206,BUMA.1121.00027,1,277158,282721,+,5563
206,BUMA.1121.00053,1,1828975,1834539,+,5564
206,BUMA.1121.00059,1,1306773,1312337,+,5564
206,BUMA.1121.00043,1,2182908,2188459,+,5551
206,BUMA.1121.00056,1,1842284,1847860,-,5576
206,BUMA.1121.00112,1,858801,864365,-,5564
206,BUMA.1121.00091,1,2390066,2395635,-,5569
206,BUMA.1121.00047,1,863916,869492,-,5576
206,BUMA.1121.00067,1,2290664,2296228,-,5564
206,BUMA.1121.00110,1,2685350,2690921,-,5571
206,BUMA.1121.00073,1,1752633,1758180,-,5547
206,BUMA.1121.00072,1,1726750,1732314,-,5564
206,BUMA.1121.00077,1,792230,797801,+,5571
206,BUMA.1121.00082,1,1885527,1891091,-,5564
206,BUMA.1121.00062,1,2472035,2477599,-,5564
206,BUMA.1121.00007,1,1977430,1982989,-,5559
206,BUMA.1121.00025,1,537988,543555,-,5567
206,BUMA.1121.00021,1,2726305,2731852,+,5547
206,BUMA.1121.00103,1,2313626,2319182,-,5556
206,BUMA.1121.00096,1,1135769,1141296,-,5527
206,BUMA.1121.00079,1,2117822,2123397,+,5575
206,BUMA.1121.00039,1,2224595,2230155,+,5560
206,BUMA.1121.00083,1,3541101,3546665,-,5564
206,BUMA.1121.00084,1,2491550,2497114,+,5564
206,BUMA.1121.00049,1,3767558,3773125,-,5567
206,BUMA.1121.00089,1,2078707,2084283,+,5576
206,BUMA.1121.00014,1,686625,692191,-,5566
206,BUMA.1121.00090,1,204599,210163,+,5564
206,BUMA.1121.00071,1,1744252,1749816,-,5564
206,BUMA.1121.00078,1,3927558,3933131,-,5573
206,BUMA.1121.00102,1,3210219,3215783,-,5564
206,BUMA.1121.00012,1,844134,849690,+,5556
206,BUMA.1121.00106,1,1861889,1867453,+,5564
206,BUMA.1121.00001,1,1958101,1963674,-,5573
206,BUMA.1121.00107,1,1996229,2001805,+,5576
206,BUMA.1121.00104,1,3125398,3130962,-,5564
206,BUMA.1121.00099,1,236804,242351,-,5547
206,BUMA.1121.00098,1,721840,727409,+,5569
206,BUMA.1121.00111,1,2280570,2286120,+,5550
206,BUMA.1121.00109,1,3775858,3781422,-,5564
206,BUMA.1121.00097,1,1836598,1842157,-,5559
206,BUMA.1121.00094,1,2109134,2114710,+,5576
206,BUMA.1121.00095,1,3581536,3587112,-,5576
206,BUMA.1121.00005,1,833058,838611,+,5553
206,BUMA.1121.00101,1,361080,366595,-,5515
206,BUMA.1121.00065,1,2194213,2199777,+,5564
206,BUMA.1121.00100,1,3233994,3239566,-,5572
206,BUMA.1121.00105,1,3114206,3119770,-,5564
206,BUMA.1121.00029,1,2839857,2845430,-,5573
206,BUMA.1121.00066,1,1728336,1733883,-,5547
206,BUMA.1121.00031,1,3524974,3530525,+,5551
206,BUMA.1121.00108,1,3125371,3130924,+,5553
206,BUMA.1121.00023,1,435543,441110,+,5567
206,BUMA.1121.00035,1,3241961,3247518,+,5557
206,BUMA.1121.00041,1,3414433,3419981,+,5548
205,BUMA.1121.00057,1,3192104,3200164,+,8060
205,BUMA.1121.00058,1,2454672,2462898,-,8226
205,BUMA.1121.00045,1,1937396,1945624,-,8228
205,BUMA.1121.00051,1,2081932,2090127,+,8195
205,BUMA.1121.00068,1,851209,859247,+,8038
205,BUMA.1121.00061,1,1761103,1769328,-,8225
205,BUMA.1121.00060,1,164715,172943,-,8228
205,BUMA.1121.00064,1,2123348,2131554,+,8206
205,BUMA.1121.00016,1,220819,228869,+,8050
205,BUMA.1121.00003,1,591751,599789,+,8038
205,BUMA.1121.00055,1,1708130,1716174,+,8044
205,BUMA.1121.00011,1,3546812,3554978,-,8166
205,BUMA.1121.00037,1,720849,728899,+,8050
205,BUMA.1121.00009,1,3454542,3462713,-,8171
205,BUMA.1121.00069,1,1713984,1722207,-,8223
205,BUMA.1121.00088,1,3025634,3033868,+,8234
205,BUMA.1121.00092,1,1700848,1709064,-,8216
205,BUMA.1121.00074,1,1741398,1749598,-,8200
205,BUMA.1121.00070,1,1732040,1740265,-,8225
205,BUMA.1121.00093,1,2917220,2925442,+,8222
205,BUMA.1121.00063,1,1758146,1766371,-,8225
205,BUMA.1121.00033,1,234465,242515,+,8050
205,BUMA.1121.00018,1,2706450,2714491,+,8041
205,BUMA.1121.00080,1,2112083,2120294,+,8211
205,BUMA.1121.00027,1,267640,275684,+,8044
205,BUMA.1121.00053,1,1819426,1827434,+,8008
205,BUMA.1121.00059,1,1297278,1305484,+,8206
205,BUMA.1121.00043,1,2173453,2181519,+,8066
205,BUMA.1121.00056,1,1848903,1857108,-,8205
205,BUMA.1121.00112,1,865401,873619,-,8218
205,BUMA.1121.00091,1,2396420,2404638,-,8218
205,BUMA.1121.00047,1,870949,879160,-,8211
205,BUMA.1121.00067,1,2297523,2305723,-,8200
205,BUMA.1121.00110,1,2692090,2700330,-,8240
205,BUMA.1121.00073,1,1759402,1767627,-,8225
205,BUMA.1121.00072,1,1733519,1741744,-,8225
205,BUMA.1121.00077,1,782695,790756,+,8061
205,BUMA.1121.00082,1,1892302,1900521,-,8219
205,BUMA.1121.00062,1,2478516,2486716,-,8200
205,BUMA.1121.00007,1,1983974,1992178,-,8204
205,BUMA.1121.00025,1,545012,553221,-,8209
205,BUMA.1121.00021,1,2716677,2724744,+,8067
205,BUMA.1121.00103,1,2319990,2328195,-,8205
205,BUMA.1121.00096,1,1141955,1150179,-,8224
205,BUMA.1121.00079,1,2108143,2116349,+,8206
205,BUMA.1121.00039,1,2214904,2222954,+,8050
205,BUMA.1121.00083,1,3547876,3556095,-,8219
205,BUMA.1121.00084,1,2482304,2490328,+,8024
205,BUMA.1121.00049,1,3774372,3782578,-,8206
205,BUMA.1121.00089,1,2069039,2077234,+,8195
205,BUMA.1121.00014,1,693480,701705,-,8225
205,BUMA.1121.00090,1,195176,203226,+,8050
205,BUMA.1121.00071,1,1750822,1758995,-,8173
205,BUMA.1121.00078,1,3933664,3941893,-,8229
205,BUMA.1121.00102,1,3217240,3225416,-,8176
205,BUMA.1121.00012,1,834927,842993,+,8066
205,BUMA.1121.00106,1,1852394,1860600,+,8206
205,BUMA.1121.00001,1,1965047,1973265,-,8218
205,BUMA.1121.00107,1,1986976,1995192,+,8216
205,BUMA.1121.00104,1,3132257,3140457,-,8200
205,BUMA.1121.00099,1,243663,251879,-,8216
205,BUMA.1121.00098,1,712488,720492,+,8004
205,BUMA.1121.00111,1,2271399,2279415,+,8016
205,BUMA.1121.00109,1,3782585,3790773,-,8188
205,BUMA.1121.00097,1,1843268,1851423,-,8155
205,BUMA.1121.00094,1,2100440,2108644,+,8204
205,BUMA.1121.00095,1,3588275,3596450,-,8175
205,BUMA.1121.00005,1,823647,831694,+,8047
205,BUMA.1121.00101,1,367890,376091,-,8201
205,BUMA.1121.00065,1,2185343,2193554,+,8211
205,BUMA.1121.00100,1,3240981,3249204,-,8223
205,BUMA.1121.00105,1,3121107,3129335,-,8228
205,BUMA.1121.00029,1,2846803,2855021,-,8218
205,BUMA.1121.00066,1,1735105,1743330,-,8225
205,BUMA.1121.00031,1,3515445,3523484,+,8039
205,BUMA.1121.00108,1,3116345,3124385,+,8040
205,BUMA.1121.00023,1,426540,434590,+,8050
205,BUMA.1121.00035,1,3232354,3240404,+,8050
205,BUMA.1121.00041,1,3405043,3413069,+,8026
204,BUMA.1121.00057,1,3173230,3186699,+,13469
204,BUMA.1121.00045,1,1951305,1964784,-,13479
204,BUMA.1121.00068,1,832063,845548,+,13485
204,BUMA.1121.00061,1,1774547,1788031,-,13484
204,BUMA.1121.00060,1,178624,192103,-,13479
204,BUMA.1121.00064,1,2104640,2118125,+,13485
204,BUMA.1121.00055,1,1689234,1702713,+,13479
204,BUMA.1121.00011,1,3560636,3574117,-,13481
204,BUMA.1121.00009,1,3468396,3481877,-,13481
204,BUMA.1121.00069,1,1727428,1740913,-,13485
204,BUMA.1121.00088,1,3006473,3019958,+,13485
204,BUMA.1121.00092,1,1714472,1727953,-,13481
204,BUMA.1121.00074,1,1754821,1768306,-,13485
204,BUMA.1121.00070,1,1745484,1758969,-,13485
204,BUMA.1121.00093,1,2898331,2911812,+,13481
204,BUMA.1121.00063,1,1771590,1785075,-,13485
204,BUMA.1121.00027,1,248931,262415,+,13484
204,BUMA.1121.00053,1,1800530,1814011,+,13481
204,BUMA.1121.00059,1,1278120,1291605,+,13485
204,BUMA.1121.00112,1,878850,892329,-,13479
204,BUMA.1121.00091,1,2409864,2422545,-,12681
204,BUMA.1121.00067,1,2310946,2324431,-,13485
204,BUMA.1121.00110,1,2706006,2719487,-,13481
204,BUMA.1121.00073,1,1772846,1786331,-,13485
204,BUMA.1121.00072,1,1746963,1760448,-,13485
204,BUMA.1121.00077,1,763538,777019,+,13481
204,BUMA.1121.00082,1,1905740,1919225,-,13485
204,BUMA.1121.00007,1,1997420,2010901,-,13481
204,BUMA.1121.00103,1,2335132,2348588,-,13456
204,BUMA.1121.00096,1,1155405,1168886,-,13481
204,BUMA.1121.00083,1,3561314,3574799,-,13485
204,BUMA.1121.00084,1,2463139,2476622,+,13483
204,BUMA.1121.00049,1,3788247,3801720,-,13473
204,BUMA.1121.00090,1,176276,189755,+,13479
204,BUMA.1121.00071,1,1764214,1777698,-,13484
204,BUMA.1121.00078,1,3947571,3961052,-,13481
204,BUMA.1121.00102,1,3230831,3244316,-,13485
204,BUMA.1121.00106,1,1833256,1846725,+,13469
204,BUMA.1121.00107,1,1967829,1981313,+,13484
204,BUMA.1121.00104,1,3146126,3159595,-,13469
204,BUMA.1121.00099,1,257111,270591,-,13480
204,BUMA.1121.00098,1,693347,706826,+,13479
204,BUMA.1121.00109,1,3809541,3823004,-,13463
204,BUMA.1121.00097,1,1856650,1870134,-,13484
204,BUMA.1121.00095,1,3602130,3615607,-,13477
204,BUMA.1121.00101,1,381774,395255,-,13481
204,BUMA.1121.00065,1,2166895,2180378,+,13483
204,BUMA.1121.00100,1,3255789,3268730,-,12941
204,BUMA.1121.00105,1,3134558,3148042,-,13484
204,BUMA.1121.00066,1,1748549,1762034,-,13485
204,BUMA.1121.00108,1,3097907,3111388,+,13481
204,BUMA.1121.00041,1,3386316,3399801,+,13485
203,BUMA.1121.00057,1,3167026,3171608,+,4582
203,BUMA.1121.00058,1,2469540,2474121,-,4581
203,BUMA.1121.00045,1,1966406,1970986,-,4580
203,BUMA.1121.00051,1,2071684,2076264,+,4580
203,BUMA.1121.00068,1,825860,830439,+,4579
203,BUMA.1121.00061,1,1790893,1795474,-,4581
203,BUMA.1121.00060,1,193725,198305,-,4580
203,BUMA.1121.00064,1,2098438,2103019,+,4581
203,BUMA.1121.00016,1,210464,215059,+,4595
203,BUMA.1121.00055,1,1683031,1687612,+,4581
203,BUMA.1121.00011,1,3575738,3580333,-,4595
203,BUMA.1121.00037,1,710493,715090,+,4597
203,BUMA.1121.00009,1,3483498,3488078,-,4580
203,BUMA.1121.00069,1,1743775,1748356,-,4581
203,BUMA.1121.00088,1,3000271,3004852,+,4581
203,BUMA.1121.00092,1,1729575,1734156,-,4581
203,BUMA.1121.00074,1,1769927,1774508,-,4581
203,BUMA.1121.00070,1,1761831,1766411,-,4580
203,BUMA.1121.00093,1,2892128,2896709,+,4581
203,BUMA.1121.00063,1,1787937,1792518,-,4581
203,BUMA.1121.00033,1,224125,228720,+,4595
203,BUMA.1121.00018,1,2694785,2699367,+,4582
203,BUMA.1121.00080,1,2101835,2106415,+,4580
203,BUMA.1121.00027,1,242732,247311,+,4579
203,BUMA.1121.00053,1,1794328,1798909,+,4581
203,BUMA.1121.00059,1,1271918,1276498,+,4580
203,BUMA.1121.00043,1,2161741,2166322,+,4581
203,BUMA.1121.00056,1,1862776,1867356,-,4580
203,BUMA.1121.00112,1,893951,898531,-,4580
203,BUMA.1121.00091,1,2425407,2429990,-,4583
203,BUMA.1121.00047,1,884828,889408,-,4580
203,BUMA.1121.00067,1,2326052,2330633,-,4581
203,BUMA.1121.00110,1,2721108,2725689,-,4581
203,BUMA.1121.00073,1,1789193,1793773,-,4580
203,BUMA.1121.00072,1,1763307,1767887,-,4580
203,BUMA.1121.00077,1,757338,761917,+,4579
203,BUMA.1121.00082,1,1922087,1926668,-,4581
203,BUMA.1121.00062,1,2493353,2497933,-,4580
203,BUMA.1121.00007,1,2012522,2017103,-,4581
203,BUMA.1121.00025,1,560305,564887,-,4582
203,BUMA.1121.00021,1,2706335,2710917,+,4582
203,BUMA.1121.00103,1,2350210,2354790,-,4580
203,BUMA.1121.00096,1,1170507,1175088,-,4581
203,BUMA.1121.00079,1,2097895,2102475,+,4580
203,BUMA.1121.00039,1,2204549,2209144,+,4595
203,BUMA.1121.00083,1,3577661,3582242,-,4581
203,BUMA.1121.00084,1,2456937,2461517,+,4580
203,BUMA.1121.00049,1,3803341,3807922,-,4581
203,BUMA.1121.00089,1,2058791,2063371,+,4580
203,BUMA.1121.00014,1,707452,712033,-,4581
203,BUMA.1121.00090,1,168833,173414,+,4581
203,BUMA.1121.00071,1,1780559,1785140,-,4581
203,BUMA.1121.00078,1,3963914,3968495,-,4581
203,BUMA.1121.00102,1,3247177,3251758,-,4581
203,BUMA.1121.00075,1,1568777,1573358,+,4581
203,BUMA.1121.00012,1,824572,829168,+,4596
203,BUMA.1121.00076,1,3240724,3245305,-,4581
203,BUMA.1121.00106,1,1827055,1831635,+,4580
203,BUMA.1121.00001,1,1979012,1983608,-,4596
203,BUMA.1121.00107,1,1961626,1966207,+,4581
203,BUMA.1121.00104,1,3161216,3165797,-,4581
203,BUMA.1121.00099,1,272213,276793,-,4580
203,BUMA.1121.00098,1,687144,691725,+,4581
203,BUMA.1121.00111,1,2261058,2265640,+,4582
203,BUMA.1121.00109,1,3824625,3829206,-,4581
203,BUMA.1121.00097,1,1871758,1876353,-,4595
203,BUMA.1121.00094,1,2090192,2094772,+,4580
203,BUMA.1121.00095,1,3617228,3621810,-,4582
203,BUMA.1121.00005,1,812416,816998,+,4582
203,BUMA.1121.00101,1,396875,401456,-,4581
203,BUMA.1121.00065,1,2160692,2165273,+,4581
203,BUMA.1121.00105,1,3149664,3154245,-,4581
203,BUMA.1121.00029,1,2860768,2865363,-,4595
203,BUMA.1121.00066,1,1764896,1769477,-,4581
203,BUMA.1121.00031,1,3505102,3509698,+,4596
203,BUMA.1121.00108,1,3091706,3096286,+,4580
203,BUMA.1121.00023,1,416184,420780,+,4596
203,BUMA.1121.00035,1,3222011,3226607,+,4596
203,BUMA.1121.00041,1,3377512,3382092,+,4580
202,BUMA.1121.00057,1,3146352,3164413,+,18061
202,BUMA.1121.00058,1,2476733,2494794,-,18061
202,BUMA.1121.00045,1,1973599,1991660,-,18061
202,BUMA.1121.00051,1,2051012,2069071,+,18059
202,BUMA.1121.00068,1,805187,823247,+,18060
202,BUMA.1121.00061,1,1798086,1816145,-,18059
202,BUMA.1121.00060,1,200918,218979,-,18061
202,BUMA.1121.00064,1,2077765,2095826,+,18061
202,BUMA.1121.00016,1,189792,207851,+,18059
202,BUMA.1121.00055,1,1662358,1680419,+,18061
202,BUMA.1121.00011,1,3581992,3600051,-,18059
202,BUMA.1121.00037,1,689821,707881,+,18060
202,BUMA.1121.00009,1,3489737,3507798,-,18061
202,BUMA.1121.00069,1,1750968,1769027,-,18059
202,BUMA.1121.00088,1,2979598,2997659,+,18061
202,BUMA.1121.00092,1,1736768,1754829,-,18061
202,BUMA.1121.00074,1,1777120,1795181,-,18061
202,BUMA.1121.00070,1,1769024,1787083,-,18059
202,BUMA.1121.00093,1,2871455,2889516,+,18061
202,BUMA.1121.00063,1,1795065,1813124,-,18059
202,BUMA.1121.00033,1,203454,221513,+,18059
202,BUMA.1121.00018,1,2674114,2692173,+,18059
202,BUMA.1121.00080,1,2082116,2100176,+,18060
202,BUMA.1121.00027,1,222062,240119,+,18057
202,BUMA.1121.00053,1,1774611,1792670,+,18059
202,BUMA.1121.00059,1,1251244,1269305,+,18061
202,BUMA.1121.00043,1,2141068,2159128,+,18060
202,BUMA.1121.00056,1,1869969,1888029,-,18060
202,BUMA.1121.00112,1,901144,919205,-,18061
202,BUMA.1121.00091,1,2432602,2450664,-,18062
202,BUMA.1121.00047,1,892021,910081,-,18060
202,BUMA.1121.00067,1,2333245,2351305,-,18060
202,BUMA.1121.00110,1,2728301,2746360,-,18059
202,BUMA.1121.00073,1,1796386,1814445,-,18059
202,BUMA.1121.00072,1,1770500,1788559,-,18059
202,BUMA.1121.00077,1,736667,754725,+,18058
202,BUMA.1121.00082,1,1929280,1947339,-,18059
202,BUMA.1121.00062,1,2500546,2518606,-,18060
202,BUMA.1121.00007,1,2019715,2037776,-,18061
202,BUMA.1121.00025,1,567499,585558,-,18059
202,BUMA.1121.00021,1,2682402,2701815,+,19413
202,BUMA.1121.00103,1,2357403,2375464,-,18061
202,BUMA.1121.00096,1,1177700,1195759,-,18059
202,BUMA.1121.00079,1,2077222,2095282,+,18060
202,BUMA.1121.00039,1,2183876,2201936,+,18060
202,BUMA.1121.00083,1,3584854,3602913,-,18059
202,BUMA.1121.00084,1,2437217,2455278,+,18061
202,BUMA.1121.00049,1,3810534,3828595,-,18061
202,BUMA.1121.00089,1,2038118,2056178,+,18060
202,BUMA.1121.00014,1,714645,732705,-,18060
202,BUMA.1121.00090,1,148161,166221,+,18060
202,BUMA.1121.00071,1,1787752,1805811,-,18059
202,BUMA.1121.00078,1,3971107,3989166,-,18059
202,BUMA.1121.00102,1,3254370,3272429,-,18059
202,BUMA.1121.00075,1,1548104,1566165,+,18061
202,BUMA.1121.00012,1,803899,821959,+,18060
202,BUMA.1121.00076,1,3247917,3265978,-,18061
202,BUMA.1121.00106,1,1806381,1824442,+,18061
202,BUMA.1121.00001,1,1986220,2004278,-,18058
202,BUMA.1121.00107,1,1940953,1959014,+,18061
202,BUMA.1121.00104,1,3168409,3186470,-,18061
202,BUMA.1121.00099,1,279406,297483,-,18077
202,BUMA.1121.00098,1,666473,684532,+,18059
202,BUMA.1121.00111,1,2240386,2258446,+,18060
202,BUMA.1121.00109,1,3831818,3849879,-,18061
202,BUMA.1121.00097,1,1878012,1896071,-,18059
202,BUMA.1121.00094,1,2069519,2087579,+,18060
202,BUMA.1121.00095,1,3624422,3642481,-,18059
202,BUMA.1121.00005,1,791744,809803,+,18059
202,BUMA.1121.00101,1,404068,422129,-,18061
202,BUMA.1121.00065,1,2140022,2158080,+,18058
202,BUMA.1121.00105,1,3156857,3174918,-,18061
202,BUMA.1121.00029,1,2867975,2886034,-,18059
202,BUMA.1121.00066,1,1772089,1790148,-,18059
202,BUMA.1121.00031,1,3484428,3502489,+,18061
202,BUMA.1121.00108,1,3071988,3090047,+,18059
202,BUMA.1121.00023,1,395511,413571,+,18060
202,BUMA.1121.00035,1,3201340,3219399,+,18059
202,BUMA.1121.00041,1,3356841,3374900,+,18059
201,BUMA.1121.00057,1,3136848,3139954,+,3106
201,BUMA.1121.00058,1,2501195,2504289,-,3094
201,BUMA.1121.00045,1,1998062,2001156,-,3094
201,BUMA.1121.00051,1,2040162,2043256,+,3094
201,BUMA.1121.00068,1,795689,798783,+,3094
201,BUMA.1121.00061,1,1822544,1825650,-,3106
201,BUMA.1121.00060,1,225381,228475,-,3094
201,BUMA.1121.00064,1,2068268,2071362,+,3094
201,BUMA.1121.00055,1,1652865,1655959,+,3094
201,BUMA.1121.00011,1,3606271,3609365,-,3094
201,BUMA.1121.00009,1,3514200,3517294,-,3094
201,BUMA.1121.00069,1,1775426,1778530,-,3104
201,BUMA.1121.00088,1,2970087,2973199,+,3112
201,BUMA.1121.00092,1,1761227,1764345,-,3118
201,BUMA.1121.00074,1,1801579,1804673,-,3094
201,BUMA.1121.00070,1,1793482,1796587,-,3105
201,BUMA.1121.00093,1,2861938,2865056,+,3118
201,BUMA.1121.00063,1,1819523,1822628,-,3105
201,BUMA.1121.00080,1,2072622,2075716,+,3094
201,BUMA.1121.00027,1,212557,215663,+,3106
201,BUMA.1121.00053,1,1765117,1768211,+,3094
201,BUMA.1121.00059,1,1241733,1244845,+,3112
201,BUMA.1121.00056,1,1894416,1897510,-,3094
201,BUMA.1121.00112,1,925620,928720,-,3100
201,BUMA.1121.00091,1,2484923,2488041,-,3118
201,BUMA.1121.00047,1,916480,919574,-,3094
201,BUMA.1121.00067,1,2357704,2360798,-,3094
201,BUMA.1121.00110,1,2752764,2755853,-,3089
201,BUMA.1121.00073,1,1820844,1823950,-,3106
201,BUMA.1121.00072,1,1794958,1798064,-,3106
201,BUMA.1121.00077,1,727172,730261,+,3089
201,BUMA.1121.00082,1,1953738,1956844,-,3106
201,BUMA.1121.00062,1,2525006,2528100,-,3094
201,BUMA.1121.00096,1,1202164,1205258,-,3094
201,BUMA.1121.00079,1,2067728,2070822,+,3094
201,BUMA.1121.00083,1,3609312,3612418,-,3106
201,BUMA.1121.00084,1,2427719,2430813,+,3094
201,BUMA.1121.00049,1,3834993,3838087,-,3094
201,BUMA.1121.00089,1,2028636,2031730,+,3094
201,BUMA.1121.00090,1,138672,141766,+,3094
201,BUMA.1121.00071,1,1812210,1815314,-,3104
201,BUMA.1121.00078,1,3995560,3998670,-,3110
201,BUMA.1121.00102,1,3278827,3281921,-,3094
201,BUMA.1121.00075,1,1537371,1540465,+,3094
201,BUMA.1121.00076,1,3272376,3275470,-,3094
201,BUMA.1121.00106,1,1796870,1799982,+,3112
201,BUMA.1121.00107,1,1931461,1934555,+,3094
201,BUMA.1121.00104,1,3192872,3195984,-,3112
201,BUMA.1121.00099,1,303706,306800,-,3094
201,BUMA.1121.00098,1,656978,660072,+,3094
201,BUMA.1121.00109,1,3857734,3860828,-,3094
201,BUMA.1121.00097,1,1903330,1906424,-,3094
201,BUMA.1121.00094,1,2060025,2063119,+,3094
201,BUMA.1121.00095,1,3648879,3651995,-,3116
201,BUMA.1121.00005,1,780724,783818,+,3094
201,BUMA.1121.00101,1,428530,431624,-,3094
201,BUMA.1121.00065,1,2130529,2133623,+,3094
201,BUMA.1121.00105,1,3181145,3184239,-,3094
201,BUMA.1121.00066,1,1796547,1799652,-,3105
201,BUMA.1121.00108,1,3062657,3065763,+,3106
200,BUMA.1121.00057,1,3131861,3136847,+,4986
200,BUMA.1121.00058,1,2504291,2509275,-,4984
200,BUMA.1121.00045,1,2001158,2006143,-,4985
200,BUMA.1121.00051,1,2035175,2040161,+,4986
200,BUMA.1121.00068,1,790702,795688,+,4986
200,BUMA.1121.00061,1,1825652,1830637,-,4985
200,BUMA.1121.00060,1,228477,233462,-,4985
200,BUMA.1121.00064,1,2063281,2068267,+,4986
200,BUMA.1121.00055,1,1647878,1652864,+,4986
200,BUMA.1121.00011,1,3609367,3614352,-,4985
200,BUMA.1121.00009,1,3517296,3522281,-,4985
200,BUMA.1121.00069,1,1778532,1783517,-,4985
200,BUMA.1121.00088,1,2965100,2970086,+,4986
200,BUMA.1121.00092,1,1764347,1769332,-,4985
200,BUMA.1121.00074,1,1804675,1809660,-,4985
200,BUMA.1121.00070,1,1796589,1801574,-,4985
200,BUMA.1121.00093,1,2856951,2861937,+,4986
200,BUMA.1121.00063,1,1822630,1827615,-,4985
200,BUMA.1121.00080,1,2067635,2072621,+,4986
200,BUMA.1121.00027,1,207570,212556,+,4986
200,BUMA.1121.00053,1,1760130,1765116,+,4986
200,BUMA.1121.00059,1,1236746,1241732,+,4986
200,BUMA.1121.00056,1,1897512,1902497,-,4985
200,BUMA.1121.00112,1,928722,933707,-,4985
200,BUMA.1121.00091,1,2488043,2493028,-,4985
200,BUMA.1121.00047,1,919576,924561,-,4985
200,BUMA.1121.00067,1,2360800,2365785,-,4985
200,BUMA.1121.00110,1,2755855,2760840,-,4985
200,BUMA.1121.00073,1,1823952,1828937,-,4985
200,BUMA.1121.00072,1,1798066,1803051,-,4985
200,BUMA.1121.00077,1,722185,727171,+,4986
200,BUMA.1121.00082,1,1956846,1961831,-,4985
200,BUMA.1121.00062,1,2528102,2533087,-,4985
200,BUMA.1121.00096,1,1205260,1210245,-,4985
200,BUMA.1121.00079,1,2062741,2067727,+,4986
200,BUMA.1121.00083,1,3612420,3617405,-,4985
200,BUMA.1121.00084,1,2422732,2427718,+,4986
200,BUMA.1121.00049,1,3838089,3843074,-,4985
200,BUMA.1121.00089,1,2023649,2028635,+,4986
200,BUMA.1121.00090,1,133685,138671,+,4986
200,BUMA.1121.00071,1,1815316,1820301,-,4985
200,BUMA.1121.00078,1,3998686,4003671,+,4985
200,BUMA.1121.00102,1,3281923,3286908,-,4985
200,BUMA.1121.00075,1,1532384,1537370,+,4986
200,BUMA.1121.00076,1,3275472,3280457,-,4985
200,BUMA.1121.00106,1,1791883,1796869,+,4986
200,BUMA.1121.00107,1,1926474,1931460,+,4986
200,BUMA.1121.00104,1,3195986,3200971,-,4985
200,BUMA.1121.00099,1,306802,311787,-,4985
200,BUMA.1121.00098,1,651991,656977,+,4986
200,BUMA.1121.00109,1,3860830,3865815,-,4985
200,BUMA.1121.00097,1,1906426,1911411,-,4985
200,BUMA.1121.00094,1,2055038,2060024,+,4986
200,BUMA.1121.00095,1,3651997,3656982,-,4985
200,BUMA.1121.00005,1,775737,780723,+,4986
200,BUMA.1121.00101,1,431626,436611,-,4985
200,BUMA.1121.00065,1,2125542,2130528,+,4986
200,BUMA.1121.00105,1,3184241,3189226,-,4985
200,BUMA.1121.00066,1,1799654,1804639,-,4985
200,BUMA.1121.00108,1,3057670,3062656,+,4986
199,BUMA.1121.00057,1,3122694,3128006,+,5312
199,BUMA.1121.00058,1,2513095,2518402,-,5307
199,BUMA.1121.00045,1,2009963,2015275,-,5312
199,BUMA.1121.00051,1,2026051,2031355,+,5304
199,BUMA.1121.00068,1,781571,786882,+,5311
199,BUMA.1121.00061,1,1834457,1839769,-,5312
199,BUMA.1121.00060,1,237282,242584,-,5302
199,BUMA.1121.00064,1,2054119,2059426,+,5307
199,BUMA.1121.00016,1,178224,183529,+,5305
199,BUMA.1121.00055,1,1638746,1644058,+,5312
199,BUMA.1121.00011,1,3618172,3623485,-,5313
199,BUMA.1121.00037,1,678254,683559,+,5305
199,BUMA.1121.00009,1,3526101,3531413,-,5312
199,BUMA.1121.00069,1,1787337,1792649,-,5312
199,BUMA.1121.00088,1,2955974,2961280,+,5306
199,BUMA.1121.00092,1,1773152,1778457,-,5305
199,BUMA.1121.00074,1,1813515,1818822,-,5307
199,BUMA.1121.00070,1,1805394,1810706,-,5312
199,BUMA.1121.00093,1,2847827,2853131,+,5304
199,BUMA.1121.00063,1,1831435,1836747,-,5312
199,BUMA.1121.00033,1,191885,197190,+,5305
199,BUMA.1121.00018,1,2663571,2668876,+,5305
199,BUMA.1121.00080,1,2058511,2063815,+,5304
199,BUMA.1121.00027,1,198409,203715,+,5306
199,BUMA.1121.00053,1,1750998,1756310,+,5312
199,BUMA.1121.00059,1,1227620,1232926,+,5306
199,BUMA.1121.00043,1,2129501,2134806,+,5305
199,BUMA.1121.00056,1,1906317,1911622,-,5305
199,BUMA.1121.00112,1,937527,942840,-,5313
199,BUMA.1121.00091,1,2496847,2502155,-,5308
199,BUMA.1121.00047,1,928381,933686,-,5305
199,BUMA.1121.00067,1,2369640,2374948,-,5308
199,BUMA.1121.00110,1,2764660,2769972,-,5312
199,BUMA.1121.00073,1,1832757,1838069,-,5312
199,BUMA.1121.00072,1,1806871,1812183,-,5312
199,BUMA.1121.00077,1,713054,718365,+,5311
199,BUMA.1121.00082,1,1965651,1970963,-,5312
199,BUMA.1121.00062,1,2536907,2542212,-,5305
199,BUMA.1121.00007,1,2041648,2046963,-,5315
199,BUMA.1121.00025,1,590795,596101,-,5306
199,BUMA.1121.00021,1,2670834,2676139,+,5305
199,BUMA.1121.00103,1,2385397,2390706,-,5309
199,BUMA.1121.00096,1,1214065,1219377,-,5312
199,BUMA.1121.00079,1,2053618,2058922,+,5304
199,BUMA.1121.00039,1,2170974,2176279,+,5305
199,BUMA.1121.00083,1,3621225,3626537,-,5312
199,BUMA.1121.00084,1,2413608,2418912,+,5304
199,BUMA.1121.00049,1,3846893,3852198,-,5305
199,BUMA.1121.00089,1,2014525,2019829,+,5304
199,BUMA.1121.00014,1,740301,745607,-,5306
199,BUMA.1121.00090,1,124558,129865,+,5307
199,BUMA.1121.00071,1,1824121,1829433,-,5312
199,BUMA.1121.00078,1,4007461,4012774,-,5313
199,BUMA.1121.00102,1,3290728,3296036,-,5308
199,BUMA.1121.00075,1,1523258,1528564,+,5306
199,BUMA.1121.00012,1,792330,797635,+,5305
199,BUMA.1121.00076,1,3284277,3289584,-,5307
199,BUMA.1121.00106,1,1782757,1788063,+,5306
199,BUMA.1121.00001,1,2010540,2015846,-,5306
199,BUMA.1121.00107,1,1917342,1922654,+,5312
199,BUMA.1121.00104,1,3204826,3210132,-,5306
199,BUMA.1121.00099,1,315607,320919,-,5312
199,BUMA.1121.00098,1,642865,648171,+,5306
199,BUMA.1121.00111,1,2228816,2234121,+,5305
199,BUMA.1121.00109,1,3869635,3874947,-,5312
199,BUMA.1121.00097,1,1915231,1920539,-,5308
199,BUMA.1121.00094,1,2045914,2051218,+,5304
199,BUMA.1121.00095,1,3660802,3666117,-,5315
199,BUMA.1121.00005,1,766612,771917,+,5305
199,BUMA.1121.00101,1,440431,445744,-,5313
199,BUMA.1121.00065,1,2116410,2121722,+,5312
199,BUMA.1121.00100,1,3305698,3311001,-,5303
199,BUMA.1121.00105,1,3193046,3198351,-,5305
199,BUMA.1121.00029,1,2892297,2897602,-,5305
199,BUMA.1121.00066,1,1808459,1813771,-,5312
199,BUMA.1121.00031,1,3471527,3476832,+,5305
199,BUMA.1121.00108,1,3048539,3053850,+,5311
199,BUMA.1121.00023,1,382712,388019,+,5307
199,BUMA.1121.00035,1,3189771,3195076,+,5305
199,BUMA.1121.00041,1,3342264,3347527,+,5263
198,BUMA.1121.00057,1,3117402,3120658,+,3256
198,BUMA.1121.00058,1,2520437,2523694,-,3257
198,BUMA.1121.00045,1,2017310,2020567,-,3257
198,BUMA.1121.00060,1,244619,247876,-,3257
198,BUMA.1121.00055,1,1633454,1636710,+,3256
198,BUMA.1121.00011,1,3625520,3628777,-,3257
198,BUMA.1121.00009,1,3533448,3536705,-,3257
198,BUMA.1121.00069,1,1794684,1797941,-,3257
198,BUMA.1121.00088,1,2950682,2953938,+,3256
198,BUMA.1121.00092,1,1780492,1783749,-,3257
198,BUMA.1121.00093,1,2842535,2845791,+,3256
198,BUMA.1121.00112,1,944875,948132,-,3257
198,BUMA.1121.00091,1,2505477,2510069,-,4592
198,BUMA.1121.00082,1,1972998,1976255,-,3257
198,BUMA.1121.00083,1,3628572,3631829,-,3257
198,BUMA.1121.00084,1,2408316,2411572,+,3256
198,BUMA.1121.00090,1,119266,122522,+,3256
198,BUMA.1121.00005,1,761320,764576,+,3256
198,BUMA.1121.00101,1,447779,451036,-,3257
198,BUMA.1121.00108,1,3043247,3046503,+,3256
197,BUMA.1121.00057,1,3100769,3106193,+,5424
197,BUMA.1121.00058,1,2534902,2540327,-,5425
197,BUMA.1121.00045,1,2031324,2036749,-,5425
197,BUMA.1121.00060,1,258633,264058,-,5425
197,BUMA.1121.00055,1,1616821,1622245,+,5424
197,BUMA.1121.00011,1,3639966,3645381,-,5415
197,BUMA.1121.00009,1,3547687,3553112,-,5425
197,BUMA.1121.00069,1,1806450,1811875,-,5425
197,BUMA.1121.00088,1,2934049,2939473,+,5424
197,BUMA.1121.00092,1,1794957,1800382,-,5425
197,BUMA.1121.00093,1,2825902,2831326,+,5424
197,BUMA.1121.00112,1,959340,964765,-,5425
197,BUMA.1121.00091,1,2521278,2526703,-,5425
197,BUMA.1121.00082,1,1987463,1992888,-,5425
197,BUMA.1121.00083,1,3643037,3648462,-,5425
197,BUMA.1121.00084,1,2391683,2397107,+,5424
197,BUMA.1121.00090,1,102676,108100,+,5424
197,BUMA.1121.00005,1,744918,750342,+,5424
197,BUMA.1121.00101,1,462246,467671,-,5425
197,BUMA.1121.00108,1,3026613,3032036,+,5423
196,BUMA.1121.00057,1,3061767,3099673,+,37906
196,BUMA.1121.00058,1,2541423,2579340,-,37917
196,BUMA.1121.00045,1,2037845,2075751,-,37906
196,BUMA.1121.00051,1,1987166,2025066,+,37900
196,BUMA.1121.00068,1,742840,780707,+,37867
196,BUMA.1121.00061,1,1840458,1878363,-,37905
196,BUMA.1121.00060,1,265154,303060,-,37906
196,BUMA.1121.00064,1,2001640,2039546,+,37906
196,BUMA.1121.00016,1,139879,177780,+,37901
196,BUMA.1121.00003,1,548631,586472,+,37841
196,BUMA.1121.00055,1,1563888,1601782,+,37894
196,BUMA.1121.00011,1,3646359,3684280,-,37921
196,BUMA.1121.00037,1,639893,677805,+,37912
196,BUMA.1121.00009,1,3553750,3591608,-,37858
196,BUMA.1121.00069,1,1812971,1850876,-,37905
196,BUMA.1121.00088,1,2895055,2932953,+,37898
196,BUMA.1121.00092,1,1801478,1839389,-,37911
196,BUMA.1121.00074,1,1820799,1858698,-,37899
196,BUMA.1121.00070,1,1811627,1849390,-,37763
196,BUMA.1121.00093,1,2786894,2824806,+,37912
196,BUMA.1121.00063,1,1837567,1875471,-,37904
196,BUMA.1121.00033,1,153520,191436,+,37916
196,BUMA.1121.00018,1,2625230,2663128,+,37898
196,BUMA.1121.00080,1,2005680,2043585,+,37905
196,BUMA.1121.00027,1,159733,197644,+,37911
196,BUMA.1121.00053,1,1712250,1750134,+,37884
196,BUMA.1121.00059,1,1188961,1226855,+,37894
196,BUMA.1121.00043,1,2091145,2129051,+,37906
196,BUMA.1121.00056,1,1912607,1950512,-,37905
196,BUMA.1121.00112,1,979998,1017866,-,37868
196,BUMA.1121.00091,1,2527799,2565698,-,37899
196,BUMA.1121.00047,1,934671,972576,-,37905
196,BUMA.1121.00067,1,2375713,2413606,-,37893
196,BUMA.1121.00110,1,2784684,2822596,-,37912
196,BUMA.1121.00073,1,1838621,1876406,-,37785
196,BUMA.1121.00072,1,1812975,1850880,-,37905
196,BUMA.1121.00077,1,660424,698342,+,37918
196,BUMA.1121.00082,1,1993984,2031889,-,37905
196,BUMA.1121.00062,1,2543197,2581108,-,37911
196,BUMA.1121.00007,1,2047860,2085708,-,37848
196,BUMA.1121.00025,1,596544,634441,-,37897
196,BUMA.1121.00021,1,2632479,2670385,+,37906
196,BUMA.1121.00103,1,2391691,2429587,-,37896
196,BUMA.1121.00096,1,1256529,1294444,-,37915
196,BUMA.1121.00079,1,2000952,2038857,+,37905
196,BUMA.1121.00039,1,2132631,2170525,+,37894
196,BUMA.1121.00083,1,3649558,3687463,-,37905
196,BUMA.1121.00084,1,2352675,2390587,+,37912
196,BUMA.1121.00049,1,3853062,3890959,-,37897
196,BUMA.1121.00089,1,1975634,2013540,+,37906
196,BUMA.1121.00014,1,746056,783967,-,37911
196,BUMA.1121.00090,1,63668,101580,+,37912
196,BUMA.1121.00071,1,1830107,1868003,-,37896
196,BUMA.1121.00078,1,4013638,4051536,-,37898
196,BUMA.1121.00102,1,3296900,3334786,-,37886
196,BUMA.1121.00075,1,1484604,1522495,+,37891
196,BUMA.1121.00012,1,753970,791881,+,37911
196,BUMA.1121.00076,1,3290347,3328238,-,37891
196,BUMA.1121.00106,1,1744094,1781992,+,37898
196,BUMA.1121.00001,1,2016290,2054196,-,37906
196,BUMA.1121.00107,1,1878622,1916478,+,37856
196,BUMA.1121.00104,1,3210897,3248794,-,37897
196,BUMA.1121.00099,1,321682,359570,-,37888
196,BUMA.1121.00098,1,569286,607177,+,37891
196,BUMA.1121.00111,1,2190456,2228367,+,37911
196,BUMA.1121.00109,1,3875710,3913586,-,37876
196,BUMA.1121.00097,1,1921302,1959176,-,37874
196,BUMA.1121.00094,1,2007023,2044929,+,37906
196,BUMA.1121.00095,1,3666782,3704639,-,37857
196,BUMA.1121.00005,1,705941,743822,+,37881
196,BUMA.1121.00101,1,468309,506213,-,37904
196,BUMA.1121.00065,1,2077519,2115425,+,37906
196,BUMA.1121.00100,1,3313078,3350941,-,37863
196,BUMA.1121.00105,1,3199125,3237027,-,37902
196,BUMA.1121.00029,1,2898046,2935973,-,37927
196,BUMA.1121.00066,1,1814403,1852304,-,37901
196,BUMA.1121.00031,1,3433166,3471078,+,37912
196,BUMA.1121.00108,1,2952738,2990612,+,37874
196,BUMA.1121.00023,1,344353,382265,+,37912
196,BUMA.1121.00035,1,3151421,3189327,+,37906
196,BUMA.1121.00041,1,3303507,3341400,+,37893
195,BUMA.1121.00057,1,3056463,3061766,+,5303
195,BUMA.1121.00058,1,2579342,2584604,-,5262
195,BUMA.1121.00045,1,2075753,2081021,-,5268
195,BUMA.1121.00051,1,1981919,1987165,+,5246
195,BUMA.1121.00068,1,737526,742839,+,5313
195,BUMA.1121.00061,1,1878365,1883615,-,5250
195,BUMA.1121.00060,1,303062,308330,-,5268
195,BUMA.1121.00064,1,1996377,2001639,+,5262
195,BUMA.1121.00016,1,134618,139878,+,5260
195,BUMA.1121.00003,1,543338,548630,+,5292
195,BUMA.1121.00055,1,1558626,1563887,+,5261
195,BUMA.1121.00011,1,3684282,3689508,-,5226
195,BUMA.1121.00037,1,634630,639892,+,5262
195,BUMA.1121.00009,1,3591610,3596903,-,5293
195,BUMA.1121.00069,1,1850878,1856128,-,5250
195,BUMA.1121.00088,1,2889751,2895054,+,5303
195,BUMA.1121.00092,1,1839391,1844681,-,5290
195,BUMA.1121.00074,1,1858700,1863950,-,5250
195,BUMA.1121.00070,1,1849392,1854644,-,5252
195,BUMA.1121.00093,1,2781603,2786893,+,5290
195,BUMA.1121.00063,1,1875473,1880724,-,5251
195,BUMA.1121.00033,1,148216,153519,+,5303
195,BUMA.1121.00018,1,2619967,2625229,+,5262
195,BUMA.1121.00080,1,2000433,2005679,+,5246
195,BUMA.1121.00027,1,154432,159732,+,5300
195,BUMA.1121.00053,1,1706955,1712249,+,5294
195,BUMA.1121.00059,1,1183680,1188960,+,5280
195,BUMA.1121.00043,1,2085888,2091144,+,5256
195,BUMA.1121.00056,1,1950514,1955779,-,5265
195,BUMA.1121.00112,1,1017868,1023172,-,5304
195,BUMA.1121.00091,1,2565700,2570950,-,5250
195,BUMA.1121.00047,1,972578,977824,-,5246
195,BUMA.1121.00067,1,2413608,2418858,-,5250
195,BUMA.1121.00110,1,2822598,2827835,-,5237
195,BUMA.1121.00073,1,1876408,1881658,-,5250
195,BUMA.1121.00072,1,1850882,1856140,-,5258
195,BUMA.1121.00077,1,655186,660423,+,5237
195,BUMA.1121.00082,1,2031891,2037152,-,5261
195,BUMA.1121.00062,1,2581110,2586403,-,5293
195,BUMA.1121.00007,1,2085710,2090959,-,5249
195,BUMA.1121.00025,1,634443,639705,-,5262
195,BUMA.1121.00021,1,2627228,2632478,+,5250
195,BUMA.1121.00103,1,2429589,2434876,-,5287
195,BUMA.1121.00096,1,1294446,1299733,-,5287
195,BUMA.1121.00079,1,1995701,2000951,+,5250
195,BUMA.1121.00039,1,2127332,2132630,+,5298
195,BUMA.1121.00083,1,3687465,3692726,-,5261
195,BUMA.1121.00084,1,2347418,2352674,+,5256
195,BUMA.1121.00049,1,3890961,3896226,-,5265
195,BUMA.1121.00089,1,1970368,1975633,+,5265
195,BUMA.1121.00014,1,783969,789277,-,5308
195,BUMA.1121.00090,1,58411,63667,+,5256
195,BUMA.1121.00071,1,1868005,1873257,-,5252
195,BUMA.1121.00078,1,4051538,4056772,-,5234
195,BUMA.1121.00102,1,3334788,3340081,-,5293
195,BUMA.1121.00075,1,1479347,1484603,+,5256
195,BUMA.1121.00012,1,748714,753969,+,5255
195,BUMA.1121.00076,1,3328240,3333496,-,5256
195,BUMA.1121.00106,1,1738828,1744093,+,5265
195,BUMA.1121.00001,1,2054198,2059491,-,5293
195,BUMA.1121.00107,1,1873373,1878621,+,5248
195,BUMA.1121.00104,1,3248796,3254061,-,5265
195,BUMA.1121.00099,1,359572,364880,-,5308
195,BUMA.1121.00098,1,564013,569285,+,5272
195,BUMA.1121.00111,1,2185150,2190455,+,5305
195,BUMA.1121.00109,1,3913588,3918807,-,5219
195,BUMA.1121.00097,1,1959178,1964467,-,5289
195,BUMA.1121.00094,1,2001776,2007022,+,5246
195,BUMA.1121.00095,1,3704641,3709939,-,5298
195,BUMA.1121.00005,1,700644,705940,+,5296
195,BUMA.1121.00101,1,506215,511480,-,5265
195,BUMA.1121.00065,1,2072261,2077518,+,5257
195,BUMA.1121.00100,1,3350943,3356233,-,5290
195,BUMA.1121.00105,1,3237029,3242288,-,5259
195,BUMA.1121.00029,1,2937290,2942544,-,5254
195,BUMA.1121.00066,1,1852306,1857567,-,5261
195,BUMA.1121.00031,1,3427858,3433165,+,5307
195,BUMA.1121.00108,1,2947456,2952737,+,5281
195,BUMA.1121.00023,1,339105,344352,+,5247
195,BUMA.1121.00035,1,3146127,3151420,+,5293
195,BUMA.1121.00041,1,3298214,3303506,+,5292
194,BUMA.1121.00057,1,3022081,3053906,+,31825
194,BUMA.1121.00058,1,2587158,2618877,-,31719
194,BUMA.1121.00045,1,2083582,2115232,-,31650
194,BUMA.1121.00051,1,1947874,1979355,+,31481
194,BUMA.1121.00068,1,703120,734962,+,31842
194,BUMA.1121.00061,1,1886172,1917985,-,31813
194,BUMA.1121.00060,1,310891,342557,-,31666
194,BUMA.1121.00064,1,1962046,1993820,+,31774
194,BUMA.1121.00016,1,100193,132061,+,31868
194,BUMA.1121.00003,1,509043,540795,+,31752
194,BUMA.1121.00055,1,1524175,1556072,+,31897
194,BUMA.1121.00011,1,3692064,3723720,-,31656
194,BUMA.1121.00037,1,600450,632073,+,31623
194,BUMA.1121.00009,1,3599460,3631180,-,31720
194,BUMA.1121.00069,1,1858685,1890044,-,31359
194,BUMA.1121.00088,1,2855872,2887194,+,31322
194,BUMA.1121.00092,1,1847235,1879073,-,31838
194,BUMA.1121.00074,1,1866507,1897816,-,31309
194,BUMA.1121.00070,1,1857201,1889014,-,31813
194,BUMA.1121.00093,1,2747232,2779050,+,31818
194,BUMA.1121.00063,1,1883281,1915088,-,31807
194,BUMA.1121.00033,1,113965,145659,+,31694
194,BUMA.1121.00018,1,2585690,2617410,+,31720
194,BUMA.1121.00080,1,1966457,1997869,+,31412
194,BUMA.1121.00027,1,120074,151875,+,31801
194,BUMA.1121.00053,1,1673129,1704391,+,31262
194,BUMA.1121.00059,1,1149429,1181123,+,31694
194,BUMA.1121.00043,1,2051592,2083374,+,31782
194,BUMA.1121.00056,1,1958336,1989769,-,31433
194,BUMA.1121.00112,1,1025733,1057537,-,31804
194,BUMA.1121.00091,1,2573511,2605333,-,31822
194,BUMA.1121.00047,1,980388,1011905,-,31517
194,BUMA.1121.00067,1,2421415,2452782,-,31367
194,BUMA.1121.00110,1,2827951,2859190,-,31239
194,BUMA.1121.00073,1,1884215,1916029,-,31814
194,BUMA.1121.00072,1,1858697,1890504,-,31807
194,BUMA.1121.00077,1,623786,655070,+,31284
194,BUMA.1121.00082,1,2039709,2071523,-,31814
194,BUMA.1121.00062,1,2588957,2620744,-,31787
194,BUMA.1121.00007,1,2093516,2125312,-,31796
194,BUMA.1121.00025,1,642262,674069,-,31807
194,BUMA.1121.00021,1,2592943,2624671,+,31728
194,BUMA.1121.00103,1,2437433,2469128,-,31695
194,BUMA.1121.00096,1,1302297,1333976,-,31679
194,BUMA.1121.00079,1,1961637,1993144,+,31507
194,BUMA.1121.00039,1,2093037,2124775,+,31738
194,BUMA.1121.00083,1,3695283,3727097,-,31814
194,BUMA.1121.00084,1,2313567,2344854,+,31287
194,BUMA.1121.00049,1,3898783,3930042,-,31259
194,BUMA.1121.00089,1,1936369,1967811,+,31442
194,BUMA.1121.00014,1,791199,823029,-,31830
194,BUMA.1121.00090,1,24125,55854,+,31729
194,BUMA.1121.00071,1,1875814,1907622,-,31808
194,BUMA.1121.00078,1,4059339,4091174,-,31835
194,BUMA.1121.00102,1,3342627,3374692,-,32065
194,BUMA.1121.00075,1,1445019,1476793,+,31774
194,BUMA.1121.00012,1,714424,746157,+,31733
194,BUMA.1121.00076,1,3336053,3367900,-,31847
194,BUMA.1121.00106,1,1704918,1736271,+,31353
194,BUMA.1121.00001,1,2062048,2093899,-,31851
194,BUMA.1121.00107,1,1839466,1870830,+,31364
194,BUMA.1121.00104,1,3256618,3287940,-,31322
194,BUMA.1121.00099,1,367437,399164,-,31727
194,BUMA.1121.00098,1,529673,561453,+,31780
194,BUMA.1121.00111,1,2150864,2182593,+,31729
194,BUMA.1121.00109,1,3921371,3953053,-,31682
194,BUMA.1121.00097,1,1967034,1998665,-,31631
194,BUMA.1121.00094,1,1967769,1999212,+,31443
194,BUMA.1121.00095,1,3712493,3744221,-,31728
194,BUMA.1121.00005,1,666249,698087,+,31838
194,BUMA.1121.00101,1,514034,545745,-,31711
194,BUMA.1121.00065,1,2038320,2069700,+,31380
194,BUMA.1121.00100,1,3358790,3390580,-,31790
194,BUMA.1121.00105,1,3244852,3276562,-,31710
194,BUMA.1121.00029,1,2945101,2976913,-,31812
194,BUMA.1121.00066,1,1860124,1891934,-,31810
194,BUMA.1121.00031,1,3394121,3425936,+,31815
194,BUMA.1121.00108,1,2913217,2944902,+,31685
194,BUMA.1121.00023,1,304836,336562,+,31726
194,BUMA.1121.00035,1,3111789,3143570,+,31781
194,BUMA.1121.00041,1,3263849,3295660,+,31811
193,BUMA.1121.00057,1,3012500,3020181,+,7681
193,BUMA.1121.00058,1,2620778,2628439,-,7661
193,BUMA.1121.00045,1,2117133,2124791,-,7658
193,BUMA.1121.00051,1,1938315,1945973,+,7658
193,BUMA.1121.00068,1,693554,701219,+,7665
193,BUMA.1121.00061,1,1919886,1927567,-,7681
193,BUMA.1121.00060,1,344458,352116,-,7658
193,BUMA.1121.00064,1,1952485,1960145,+,7660
193,BUMA.1121.00016,1,90612,98292,+,7680
193,BUMA.1121.00003,1,499461,507142,+,7681
193,BUMA.1121.00055,1,1514594,1522274,+,7680
193,BUMA.1121.00011,1,3725621,3733282,-,7661
193,BUMA.1121.00037,1,590868,598549,+,7681
193,BUMA.1121.00009,1,3633081,3640763,-,7682
193,BUMA.1121.00069,1,1891945,1899626,-,7681
193,BUMA.1121.00088,1,2846285,2853971,+,7686
193,BUMA.1121.00092,1,1880974,1888656,-,7682
193,BUMA.1121.00074,1,1899717,1907378,-,7661
193,BUMA.1121.00070,1,1890915,1898596,-,7681
193,BUMA.1121.00093,1,2737650,2745331,+,7681
193,BUMA.1121.00063,1,1916989,1924670,-,7681
193,BUMA.1121.00033,1,104407,112064,+,7657
193,BUMA.1121.00018,1,2576108,2583789,+,7681
193,BUMA.1121.00080,1,1956897,1964556,+,7659
193,BUMA.1121.00027,1,110495,118175,+,7680
193,BUMA.1121.00053,1,1663547,1671228,+,7681
193,BUMA.1121.00059,1,1139847,1147528,+,7681
193,BUMA.1121.00043,1,2042010,2049691,+,7681
193,BUMA.1121.00056,1,1991670,1999331,-,7661
193,BUMA.1121.00112,1,1059438,1067117,-,7679
193,BUMA.1121.00091,1,2607234,2614915,-,7681
193,BUMA.1121.00047,1,1013806,1021466,-,7660
193,BUMA.1121.00067,1,2454683,2462344,-,7661
193,BUMA.1121.00110,1,2861091,2868773,-,7682
193,BUMA.1121.00073,1,1917930,1925611,-,7681
193,BUMA.1121.00072,1,1892405,1900086,-,7681
193,BUMA.1121.00077,1,614204,621885,+,7681
193,BUMA.1121.00082,1,2073424,2081105,-,7681
193,BUMA.1121.00062,1,2622645,2630306,-,7661
193,BUMA.1121.00007,1,2127213,2134895,-,7682
193,BUMA.1121.00025,1,675970,683652,-,7682
193,BUMA.1121.00021,1,2583361,2591042,+,7681
193,BUMA.1121.00103,1,2471029,2478712,-,7683
193,BUMA.1121.00096,1,1335877,1343559,-,7682
193,BUMA.1121.00079,1,1952080,1959737,+,7657
193,BUMA.1121.00039,1,2083478,2091136,+,7658
193,BUMA.1121.00083,1,3728998,3736679,-,7681
193,BUMA.1121.00084,1,2303985,2311666,+,7681
193,BUMA.1121.00049,1,3931943,3939580,-,7637
193,BUMA.1121.00089,1,1926808,1934468,+,7660
193,BUMA.1121.00014,1,824930,832612,-,7682
193,BUMA.1121.00090,1,14543,22224,+,7681
193,BUMA.1121.00071,1,1909523,1917204,-,7681
193,BUMA.1121.00078,1,4093075,4100769,-,7694
193,BUMA.1121.00102,1,3376593,3384274,-,7681
193,BUMA.1121.00075,1,1435428,1443119,+,7691
193,BUMA.1121.00012,1,704842,712523,+,7681
193,BUMA.1121.00076,1,3369801,3377496,-,7695
193,BUMA.1121.00106,1,1695336,1703017,+,7681
193,BUMA.1121.00001,1,2095800,2103482,-,7682
193,BUMA.1121.00107,1,1829888,1837565,+,7677
193,BUMA.1121.00104,1,3289841,3297502,-,7661
193,BUMA.1121.00099,1,401065,408743,-,7678
193,BUMA.1121.00098,1,520091,527772,+,7681
193,BUMA.1121.00111,1,2141282,2148963,+,7681
193,BUMA.1121.00109,1,3954954,3962642,-,7688
193,BUMA.1121.00097,1,2000566,2008244,-,7678
193,BUMA.1121.00094,1,1958209,1965868,+,7659
193,BUMA.1121.00095,1,3746122,3753819,-,7697
193,BUMA.1121.00005,1,656701,664359,+,7658
193,BUMA.1121.00101,1,547646,555338,-,7692
193,BUMA.1121.00065,1,2028759,2036419,+,7660
193,BUMA.1121.00100,1,3392481,3400161,-,7680
193,BUMA.1121.00105,1,3278463,3286143,-,7680
193,BUMA.1121.00029,1,2978814,2986496,-,7682
193,BUMA.1121.00066,1,1893835,1901516,-,7681
193,BUMA.1121.00031,1,3384552,3392220,+,7668
193,BUMA.1121.00108,1,2903620,2911316,+,7696
193,BUMA.1121.00023,1,295254,302935,+,7681
193,BUMA.1121.00035,1,3102207,3109888,+,7681
193,BUMA.1121.00041,1,3254269,3261948,+,7679
192,BUMA.1121.00057,1,3008812,3012418,+,3606
192,BUMA.1121.00058,1,2628509,2632092,-,3583
192,BUMA.1121.00045,1,2124873,2128496,-,3623
192,BUMA.1121.00051,1,1934627,1938233,+,3606
192,BUMA.1121.00068,1,689860,693460,+,3600
192,BUMA.1121.00061,1,1927649,1931269,-,3620
192,BUMA.1121.00060,1,352198,355821,-,3623
192,BUMA.1121.00064,1,1948819,1952391,+,3572
192,BUMA.1121.00016,1,86901,90494,+,3593
192,BUMA.1121.00003,1,495734,499379,+,3645
192,BUMA.1121.00055,1,1510873,1514500,+,3627
192,BUMA.1121.00011,1,3733364,3736993,-,3629
192,BUMA.1121.00037,1,587162,590762,+,3600
192,BUMA.1121.00009,1,3640845,3644462,-,3617
192,BUMA.1121.00069,1,1899739,1903338,-,3599
192,BUMA.1121.00088,1,2832135,2835719,+,3584
192,BUMA.1121.00092,1,1888726,1892337,-,3611
192,BUMA.1121.00074,1,1907460,1911043,-,3583
192,BUMA.1121.00070,1,1898678,1902324,-,3646
192,BUMA.1121.00093,1,2733968,2737568,+,3600
192,BUMA.1121.00063,1,1924798,1928384,-,3586
192,BUMA.1121.00033,1,100707,104301,+,3594
192,BUMA.1121.00018,1,2572371,2575978,+,3607
192,BUMA.1121.00080,1,1953209,1956815,+,3606
192,BUMA.1121.00027,1,106778,110377,+,3599
192,BUMA.1121.00053,1,1649154,1652754,+,3600
192,BUMA.1121.00059,1,1136165,1139765,+,3600
192,BUMA.1121.00043,1,2038304,2041904,+,3600
192,BUMA.1121.00056,1,1999413,2002996,-,3583
192,BUMA.1121.00112,1,1077899,1081522,-,3623
192,BUMA.1121.00091,1,2615078,2618689,-,3611
192,BUMA.1121.00047,1,1021548,1025153,-,3605
192,BUMA.1121.00067,1,2462426,2466009,-,3583
192,BUMA.1121.00110,1,2868855,2872466,-,3611
192,BUMA.1121.00073,1,1925693,1929335,-,3642
192,BUMA.1121.00072,1,1900214,1903805,-,3591
192,BUMA.1121.00077,1,610510,614110,+,3600
192,BUMA.1121.00082,1,2081235,2084846,-,3611
192,BUMA.1121.00062,1,2630376,2633987,-,3611
192,BUMA.1121.00007,1,2134977,2138624,-,3647
192,BUMA.1121.00025,1,683770,687388,-,3618
192,BUMA.1121.00021,1,2579649,2583255,+,3606
192,BUMA.1121.00103,1,2478794,2482405,-,3611
192,BUMA.1121.00096,1,1343641,1347271,-,3630
192,BUMA.1121.00079,1,1948392,1951998,+,3606
192,BUMA.1121.00039,1,2068965,2072571,+,3606
192,BUMA.1121.00083,1,3736809,3740420,-,3611
192,BUMA.1121.00084,1,2289851,2293457,+,3606
192,BUMA.1121.00049,1,3950373,3954014,-,3641
192,BUMA.1121.00089,1,1923142,1926714,+,3572
192,BUMA.1121.00014,1,832718,836329,-,3611
192,BUMA.1121.00090,1,15,3636,+,3621
192,BUMA.1121.00071,1,1917329,1920928,-,3599
192,BUMA.1121.00078,1,4100851,4104444,-,3593
192,BUMA.1121.00102,1,3395079,3398590,-,3511
192,BUMA.1121.00075,1,1421294,1424900,+,3606
192,BUMA.1121.00012,1,701130,704724,+,3594
192,BUMA.1121.00076,1,3388012,3391629,-,3617
192,BUMA.1121.00106,1,1691670,1695242,+,3572
192,BUMA.1121.00001,1,2103576,2107193,-,3617
192,BUMA.1121.00107,1,1826188,1829794,+,3606
192,BUMA.1121.00104,1,3297584,3301195,-,3611
192,BUMA.1121.00099,1,408825,412445,-,3620
192,BUMA.1121.00098,1,516346,519997,+,3651
192,BUMA.1121.00111,1,2126769,2130375,+,3606
192,BUMA.1121.00109,1,3962748,3966377,-,3629
192,BUMA.1121.00097,1,2008314,2011938,-,3624
192,BUMA.1121.00094,1,1954521,1958127,+,3606
192,BUMA.1121.00095,1,3753901,3757518,-,3617
192,BUMA.1121.00005,1,642481,646123,+,3642
192,BUMA.1121.00101,1,555423,559040,-,3617
192,BUMA.1121.00065,1,2025093,2028665,+,3572
192,BUMA.1121.00100,1,3400243,3403869,-,3626
192,BUMA.1121.00105,1,3296659,3300276,-,3617
192,BUMA.1121.00029,1,2986590,2990207,-,3617
192,BUMA.1121.00066,1,1901598,1905232,-,3634
192,BUMA.1121.00031,1,3380834,3384434,+,3600
192,BUMA.1121.00108,1,2899893,2903526,+,3633
192,BUMA.1121.00023,1,291554,295160,+,3606
192,BUMA.1121.00035,1,3098495,3102101,+,3606
192,BUMA.1121.00041,1,3239870,3243476,+,3606
191,BUMA.1121.00057,1,2982117,3005639,+,23522
191,BUMA.1121.00058,1,2635265,2658783,-,23518
191,BUMA.1121.00045,1,2131669,2155199,-,23530
191,BUMA.1121.00051,1,1907974,1931454,+,23480
191,BUMA.1121.00068,1,663113,686687,+,23574
191,BUMA.1121.00061,1,1934442,1957956,-,23514
191,BUMA.1121.00060,1,358994,382524,-,23530
191,BUMA.1121.00064,1,1922114,1945646,+,23532
191,BUMA.1121.00016,1,60132,83728,+,23596
191,BUMA.1121.00003,1,469101,492561,+,23460
191,BUMA.1121.00055,1,1484123,1507700,+,23577
191,BUMA.1121.00011,1,3740166,3763696,-,23530
191,BUMA.1121.00037,1,560383,583989,+,23606
191,BUMA.1121.00009,1,3647635,3671144,-,23509
191,BUMA.1121.00069,1,1906511,1930012,-,23501
191,BUMA.1121.00088,1,2805458,2828962,+,23504
191,BUMA.1121.00092,1,1895510,1918980,-,23470
191,BUMA.1121.00074,1,1914216,1937716,-,23500
191,BUMA.1121.00070,1,1905497,1929008,-,23511
191,BUMA.1121.00093,1,2707326,2730795,+,23469
191,BUMA.1121.00063,1,1931557,1955050,-,23493
191,BUMA.1121.00033,1,73975,97534,+,23559
191,BUMA.1121.00018,1,2545609,2569198,+,23589
191,BUMA.1121.00080,1,1926556,1950036,+,23480
191,BUMA.1121.00027,1,80065,103605,+,23540
191,BUMA.1121.00053,1,1622392,1645981,+,23589
191,BUMA.1121.00059,1,1109484,1132992,+,23508
191,BUMA.1121.00043,1,2011570,2035131,+,23561
191,BUMA.1121.00056,1,2006169,2029641,-,23472
191,BUMA.1121.00112,1,1084695,1108258,-,23563
191,BUMA.1121.00091,1,2621862,2645389,-,23527
191,BUMA.1121.00047,1,1028326,1051808,-,23482
191,BUMA.1121.00067,1,2469182,2492697,-,23515
191,BUMA.1121.00110,1,2875639,2899128,-,23489
191,BUMA.1121.00073,1,1932508,1956020,-,23512
191,BUMA.1121.00072,1,1906978,1930479,-,23501
191,BUMA.1121.00077,1,583854,607337,+,23483
191,BUMA.1121.00082,1,2088019,2111533,-,23514
191,BUMA.1121.00062,1,2637160,2660702,-,23542
191,BUMA.1121.00007,1,2141797,2165315,-,23518
191,BUMA.1121.00025,1,690561,714160,-,23599
191,BUMA.1121.00021,1,2552926,2576476,+,23550
191,BUMA.1121.00103,1,2485578,2509114,-,23536
191,BUMA.1121.00096,1,1350444,1373952,-,23508
191,BUMA.1121.00079,1,1921753,1945219,+,23466
191,BUMA.1121.00039,1,2042231,2065792,+,23561
191,BUMA.1121.00083,1,3743593,3767107,-,23514
191,BUMA.1121.00084,1,2263174,2286678,+,23504
191,BUMA.1121.00049,1,3957187,3980715,-,23528
191,BUMA.1121.00089,1,1896500,1919969,+,23469
191,BUMA.1121.00014,1,839502,863055,-,23553
191,BUMA.1121.00090,1,4094942,4118509,+,23567
191,BUMA.1121.00071,1,1924101,1947603,-,23502
191,BUMA.1121.00078,1,4107617,4131125,-,23508
191,BUMA.1121.00102,1,3401763,3425316,-,23553
191,BUMA.1121.00075,1,1394626,1418121,+,23495
191,BUMA.1121.00012,1,674417,697957,+,23540
191,BUMA.1121.00076,1,3394802,3418301,-,23499
191,BUMA.1121.00106,1,1664943,1688497,+,23554
191,BUMA.1121.00001,1,2110366,2133910,-,23544
191,BUMA.1121.00107,1,1799520,1823015,+,23495
191,BUMA.1121.00104,1,3304368,3327880,-,23512
191,BUMA.1121.00099,1,415618,439166,-,23548
191,BUMA.1121.00098,1,489581,513173,+,23592
191,BUMA.1121.00111,1,2100026,2123596,+,23570
191,BUMA.1121.00109,1,146,23670,-,23524
191,BUMA.1121.00097,1,2015111,2038635,-,23524
191,BUMA.1121.00094,1,1927867,1951348,+,23481
191,BUMA.1121.00095,1,3760690,3784191,-,23501
191,BUMA.1121.00005,1,615747,639309,+,23562
191,BUMA.1121.00101,1,562213,585720,-,23507
191,BUMA.1121.00065,1,1998388,2021920,+,23532
191,BUMA.1121.00100,1,3407042,3430566,-,23524
191,BUMA.1121.00105,1,3303449,3326972,-,23523
191,BUMA.1121.00029,1,2993380,3016914,-,23534
191,BUMA.1121.00066,1,1908405,1931906,-,23501
191,BUMA.1121.00031,1,3354047,3377661,+,23614
191,BUMA.1121.00108,1,2873160,2896733,+,23573
191,BUMA.1121.00023,1,264812,288381,+,23569
191,BUMA.1121.00035,1,3071743,3095322,+,23579
191,BUMA.1121.00041,1,3213193,3236697,+,23504
190,BUMA.1121.00057,1,2968584,2980492,+,11908
190,BUMA.1121.00058,1,2660398,2672243,-,11845
190,BUMA.1121.00045,1,2156808,2168695,-,11887
190,BUMA.1121.00051,1,1894495,1906340,+,11845
190,BUMA.1121.00068,1,649592,661504,+,11912
190,BUMA.1121.00061,1,1959580,1971447,-,11867
190,BUMA.1121.00060,1,384133,396020,-,11887
190,BUMA.1121.00064,1,1908605,1920489,+,11884
190,BUMA.1121.00016,1,46735,58516,+,11781
190,BUMA.1121.00003,1,455572,467476,+,11904
190,BUMA.1121.00055,1,1470629,1482498,+,11869
190,BUMA.1121.00011,1,3765320,3777186,-,11866
190,BUMA.1121.00037,1,546858,558758,+,11900
190,BUMA.1121.00009,1,3672759,3684617,-,11858
190,BUMA.1121.00069,1,1931636,1943503,-,11867
190,BUMA.1121.00088,1,2791971,2803842,+,11871
190,BUMA.1121.00092,1,1920595,1932476,-,11881
190,BUMA.1121.00074,1,1939331,1951219,-,11888
190,BUMA.1121.00070,1,1930632,1942498,-,11866
190,BUMA.1121.00093,1,2693820,2705710,+,11890
190,BUMA.1121.00063,1,1956674,1968530,-,11856
190,BUMA.1121.00033,1,60443,72350,+,11907
190,BUMA.1121.00018,1,2532319,2543993,+,11674
190,BUMA.1121.00080,1,1913088,1924931,+,11843
190,BUMA.1121.00027,1,66533,78425,+,11892
190,BUMA.1121.00053,1,1608888,1620767,+,11879
190,BUMA.1121.00059,1,1095984,1107868,+,11884
190,BUMA.1121.00043,1,1998079,2009945,+,11866
190,BUMA.1121.00056,1,2031265,2043110,-,11845
190,BUMA.1121.00112,1,1109873,1121743,-,11870
190,BUMA.1121.00091,1,2647013,2658853,-,11840
190,BUMA.1121.00047,1,1053432,1065277,-,11845
190,BUMA.1121.00067,1,2494339,2506186,-,11847
190,BUMA.1121.00110,1,2900761,2912564,-,11803
190,BUMA.1121.00073,1,1957644,1969511,-,11867
190,BUMA.1121.00072,1,1932103,1943970,-,11867
190,BUMA.1121.00077,1,570413,582220,+,11807
190,BUMA.1121.00082,1,2113157,2125024,-,11867
190,BUMA.1121.00062,1,2662326,2674182,-,11856
190,BUMA.1121.00007,1,2166941,2178840,-,11899
190,BUMA.1121.00025,1,715775,727449,-,11674
190,BUMA.1121.00021,1,2539343,2551292,+,11949
190,BUMA.1121.00103,1,2510729,2522597,-,11868
190,BUMA.1121.00096,1,1375576,1387365,-,11789
190,BUMA.1121.00079,1,1908285,1920128,+,11843
190,BUMA.1121.00039,1,2028713,2040606,+,11893
190,BUMA.1121.00083,1,3768731,3780598,-,11867
190,BUMA.1121.00084,1,2249678,2261558,+,11880
190,BUMA.1121.00049,1,3982339,3994191,-,11852
190,BUMA.1121.00089,1,1883030,1894875,+,11845
190,BUMA.1121.00014,1,864679,876536,-,11857
190,BUMA.1121.00090,1,4081413,4093317,+,11904
190,BUMA.1121.00071,1,1949227,1961086,-,11859
190,BUMA.1121.00078,1,4132749,4144614,-,11865
190,BUMA.1121.00102,1,3426940,3438839,-,11899
190,BUMA.1121.00075,1,1381110,1393001,+,11891
190,BUMA.1121.00012,1,660920,672792,+,11872
190,BUMA.1121.00076,1,3419925,3431818,-,11893
190,BUMA.1121.00106,1,1651439,1663327,+,11888
190,BUMA.1121.00001,1,2135534,2147410,-,11876
190,BUMA.1121.00107,1,1785999,1797895,+,11896
190,BUMA.1121.00104,1,3329495,3341344,-,11849
190,BUMA.1121.00099,1,440790,452674,-,11884
190,BUMA.1121.00098,1,476122,487972,+,11850
190,BUMA.1121.00111,1,2086536,2098417,+,11881
190,BUMA.1121.00109,1,25294,37111,-,11817
190,BUMA.1121.00097,1,2040250,2052120,-,11870
190,BUMA.1121.00094,1,1914397,1926242,+,11845
190,BUMA.1121.00095,1,3785815,3797745,-,11930
190,BUMA.1121.00005,1,602240,614122,+,11882
190,BUMA.1121.00101,1,587335,599228,-,11893
190,BUMA.1121.00065,1,1984893,1996754,+,11861
190,BUMA.1121.00100,1,3432178,3444049,-,11871
190,BUMA.1121.00105,1,3328596,3340517,-,11921
190,BUMA.1121.00029,1,3018538,3030393,-,11855
190,BUMA.1121.00066,1,1933530,1945397,-,11867
190,BUMA.1121.00031,1,3340550,3352422,+,11872
190,BUMA.1121.00108,1,2859657,2871542,+,11885
190,BUMA.1121.00023,1,251311,263178,+,11867
190,BUMA.1121.00035,1,3058263,3070118,+,11855
190,BUMA.1121.00041,1,3199720,3211568,+,11848
189,BUMA.1121.00057,1,2947068,2968108,+,21040
189,BUMA.1121.00058,1,2672699,2693840,-,21141
189,BUMA.1121.00045,1,2169151,2190194,-,21043
189,BUMA.1121.00051,1,1872916,1894040,+,21124
189,BUMA.1121.00068,1,628066,649115,+,21049
189,BUMA.1121.00061,1,1971909,1992970,-,21061
189,BUMA.1121.00060,1,396476,417512,-,21036
189,BUMA.1121.00064,1,1887095,1908129,+,21034
189,BUMA.1121.00016,1,25272,46260,+,20988
189,BUMA.1121.00003,1,434054,455095,+,21041
189,BUMA.1121.00055,1,1449064,1470174,+,21110
189,BUMA.1121.00011,1,3777663,3798679,-,21016
189,BUMA.1121.00037,1,525234,546383,+,21149
189,BUMA.1121.00009,1,3685094,3706189,-,21095
189,BUMA.1121.00069,1,1943965,1964994,-,21029
189,BUMA.1121.00088,1,2770454,2791513,+,21059
189,BUMA.1121.00092,1,1932935,1954021,-,21086
189,BUMA.1121.00074,1,1951686,1972775,-,21089
189,BUMA.1121.00070,1,1942974,1964016,-,21042
189,BUMA.1121.00093,1,2672275,2693362,+,21087
189,BUMA.1121.00063,1,1968992,1990039,-,21047
189,BUMA.1121.00033,1,28268,49333,+,21065
189,BUMA.1121.00018,1,2510805,2531844,+,21039
189,BUMA.1121.00080,1,1891504,1912633,+,21129
189,BUMA.1121.00027,1,44999,66057,+,21058
189,BUMA.1121.00053,1,1587261,1608413,+,21152
189,BUMA.1121.00059,1,1074396,1095528,+,21132
189,BUMA.1121.00043,1,1976558,1997604,+,21046
189,BUMA.1121.00056,1,2043566,2064735,-,21169
189,BUMA.1121.00112,1,1122220,1143227,-,21007
189,BUMA.1121.00091,1,2659310,2680334,-,21024
189,BUMA.1121.00047,1,1065733,1086845,-,21112
189,BUMA.1121.00067,1,2506642,2527680,-,21038
189,BUMA.1121.00110,1,2913033,2934040,-,21007
189,BUMA.1121.00073,1,1969987,1991037,-,21050
189,BUMA.1121.00072,1,1944432,1965465,-,21033
189,BUMA.1121.00077,1,548937,569944,+,21007
189,BUMA.1121.00082,1,2125500,2146552,-,21052
189,BUMA.1121.00062,1,2674638,2695855,-,21217
189,BUMA.1121.00007,1,2179317,2200549,-,21232
189,BUMA.1121.00025,1,727924,748963,-,21039
189,BUMA.1121.00021,1,2517768,2538868,+,21100
189,BUMA.1121.00103,1,2523074,2544059,-,20985
189,BUMA.1121.00096,1,1387842,1408935,-,21093
189,BUMA.1121.00079,1,1886777,1907830,+,21053
189,BUMA.1121.00039,1,2007070,2028238,+,21168
189,BUMA.1121.00083,1,3781074,3802126,-,21052
189,BUMA.1121.00084,1,2228136,2249202,+,21066
189,BUMA.1121.00049,1,3994668,4015716,-,21048
189,BUMA.1121.00089,1,1861400,1882575,+,21175
189,BUMA.1121.00014,1,877011,898086,-,21075
189,BUMA.1121.00090,1,4059839,4080938,+,21099
189,BUMA.1121.00071,1,1961562,1982587,-,21025
189,BUMA.1121.00078,1,4145091,4166122,-,21031
189,BUMA.1121.00102,1,3439315,3460394,-,21079
189,BUMA.1121.00075,1,1359522,1380652,+,21130
189,BUMA.1121.00012,1,639270,660445,+,21175
189,BUMA.1121.00076,1,3432277,3453372,-,21095
189,BUMA.1121.00106,1,1629851,1650981,+,21130
189,BUMA.1121.00001,1,2147885,2168951,-,21066
189,BUMA.1121.00107,1,1764498,1785522,+,21024
189,BUMA.1121.00104,1,3341811,3362942,-,21131
189,BUMA.1121.00099,1,453151,474229,-,21078
189,BUMA.1121.00098,1,454524,475645,+,21121
189,BUMA.1121.00111,1,2064975,2086061,+,21086
189,BUMA.1121.00109,1,37588,58679,-,21091
189,BUMA.1121.00097,1,2052597,2073608,-,21011
189,BUMA.1121.00094,1,1892811,1913942,+,21131
189,BUMA.1121.00095,1,3798202,3819277,-,21075
189,BUMA.1121.00005,1,580711,601773,+,21062
189,BUMA.1121.00101,1,599684,620790,-,21106
189,BUMA.1121.00065,1,1963387,1984426,+,21039
189,BUMA.1121.00100,1,3444512,3465553,-,21041
189,BUMA.1121.00105,1,3340984,3362046,-,21062
189,BUMA.1121.00029,1,3030868,3051842,-,20974
189,BUMA.1121.00066,1,1945859,1966919,-,21060
189,BUMA.1121.00031,1,3318996,3340075,+,21079
189,BUMA.1121.00108,1,2838128,2859180,+,21052
189,BUMA.1121.00023,1,229768,250836,+,21068
189,BUMA.1121.00035,1,3036748,3057788,+,21040
189,BUMA.1121.00041,1,3178263,3199243,+,20980
188,BUMA.1121.00057,1,2940692,2945308,+,4616
188,BUMA.1121.00058,1,2695600,2700217,-,4617
188,BUMA.1121.00045,1,2191954,2196571,-,4617
188,BUMA.1121.00051,1,1866540,1871156,+,4616
188,BUMA.1121.00068,1,621694,626306,+,4612
188,BUMA.1121.00061,1,1994730,1999347,-,4617
188,BUMA.1121.00060,1,419272,423851,-,4579
188,BUMA.1121.00064,1,1880719,1885335,+,4616
188,BUMA.1121.00016,1,18896,23512,+,4616
188,BUMA.1121.00003,1,427678,432294,+,4616
188,BUMA.1121.00055,1,1442688,1447304,+,4616
188,BUMA.1121.00011,1,3800448,3805065,-,4617
188,BUMA.1121.00037,1,518858,523474,+,4616
188,BUMA.1121.00009,1,3707949,3712566,-,4617
188,BUMA.1121.00069,1,1966754,1971371,-,4617
188,BUMA.1121.00088,1,2764078,2768694,+,4616
188,BUMA.1121.00092,1,1955781,1960398,-,4617
188,BUMA.1121.00074,1,1974535,1979152,-,4617
188,BUMA.1121.00070,1,1965776,1970393,-,4617
188,BUMA.1121.00093,1,2665901,2670517,+,4616
188,BUMA.1121.00063,1,1991799,1996416,-,4617
188,BUMA.1121.00033,1,21892,26508,+,4616
188,BUMA.1121.00018,1,2504429,2509045,+,4616
188,BUMA.1121.00080,1,1885128,1889744,+,4616
188,BUMA.1121.00027,1,38623,43239,+,4616
188,BUMA.1121.00053,1,1580885,1585501,+,4616
188,BUMA.1121.00059,1,1068020,1072636,+,4616
188,BUMA.1121.00043,1,1970182,1974798,+,4616
188,BUMA.1121.00056,1,2066493,2071110,-,4617
188,BUMA.1121.00112,1,1144987,1149604,-,4617
188,BUMA.1121.00091,1,2682094,2686711,-,4617
188,BUMA.1121.00047,1,1088605,1093222,-,4617
188,BUMA.1121.00067,1,2529440,2534057,-,4617
188,BUMA.1121.00110,1,2935800,2940417,-,4617
188,BUMA.1121.00073,1,1992797,1997414,-,4617
188,BUMA.1121.00072,1,1967225,1971842,-,4617
188,BUMA.1121.00077,1,542561,547177,+,4616
188,BUMA.1121.00082,1,2148312,2152929,-,4617
188,BUMA.1121.00062,1,2697615,2702232,-,4617
188,BUMA.1121.00007,1,2202309,2206926,-,4617
188,BUMA.1121.00025,1,750723,755340,-,4617
188,BUMA.1121.00021,1,2511392,2516008,+,4616
188,BUMA.1121.00103,1,2545818,2550435,-,4617
188,BUMA.1121.00096,1,1410695,1415312,-,4617
188,BUMA.1121.00079,1,1880401,1885017,+,4616
188,BUMA.1121.00039,1,2000694,2005310,+,4616
188,BUMA.1121.00083,1,3803886,3808503,-,4617
188,BUMA.1121.00084,1,2221760,2226376,+,4616
188,BUMA.1121.00049,1,4017476,4022093,-,4617
188,BUMA.1121.00089,1,1855024,1859640,+,4616
188,BUMA.1121.00014,1,899846,904464,-,4618
188,BUMA.1121.00090,1,4053463,4058079,+,4616
188,BUMA.1121.00071,1,1984347,1988964,-,4617
188,BUMA.1121.00078,1,1493,6110,-,4617
188,BUMA.1121.00102,1,3462154,3466771,-,4617
188,BUMA.1121.00075,1,1353146,1357762,+,4616
188,BUMA.1121.00012,1,632894,637510,+,4616
188,BUMA.1121.00076,1,3455132,3459749,-,4617
188,BUMA.1121.00106,1,1623475,1628091,+,4616
188,BUMA.1121.00001,1,2170711,2175328,-,4617
188,BUMA.1121.00107,1,1758122,1762738,+,4616
188,BUMA.1121.00104,1,3364702,3369301,-,4599
188,BUMA.1121.00099,1,475989,480606,-,4617
188,BUMA.1121.00098,1,448148,452764,+,4616
188,BUMA.1121.00111,1,2058599,2063215,+,4616
188,BUMA.1121.00109,1,60439,65056,-,4617
188,BUMA.1121.00097,1,2075365,2079982,-,4617
188,BUMA.1121.00094,1,1886435,1891051,+,4616
188,BUMA.1121.00095,1,3821019,3825651,-,4632
188,BUMA.1121.00005,1,574335,578951,+,4616
188,BUMA.1121.00101,1,622550,627167,-,4617
188,BUMA.1121.00065,1,1957011,1961627,+,4616
188,BUMA.1121.00100,1,3467313,3471930,-,4617
188,BUMA.1121.00105,1,3363806,3368423,-,4617
188,BUMA.1121.00029,1,3053602,3058219,-,4617
188,BUMA.1121.00066,1,1968679,1973296,-,4617
188,BUMA.1121.00031,1,3312620,3317236,+,4616
188,BUMA.1121.00108,1,2831752,2836368,+,4616
188,BUMA.1121.00023,1,223392,228008,+,4616
188,BUMA.1121.00035,1,3030372,3034988,+,4616
188,BUMA.1121.00041,1,3171887,3176503,+,4616
187,BUMA.1121.00057,1,2930565,2939086,+,8521
187,BUMA.1121.00058,1,2701831,2710341,-,8510
187,BUMA.1121.00045,1,2198175,2206657,-,8482
187,BUMA.1121.00051,1,1856424,1864938,+,8514
187,BUMA.1121.00068,1,611545,620070,+,8525
187,BUMA.1121.00061,1,2000953,2009472,-,8519
187,BUMA.1121.00060,1,423919,432401,-,8482
187,BUMA.1121.00064,1,1870608,1879124,+,8516
187,BUMA.1121.00016,1,8812,17301,+,8489
187,BUMA.1121.00003,1,417622,426069,+,8447
187,BUMA.1121.00055,1,1432561,1441082,+,8521
187,BUMA.1121.00011,1,3806679,3815186,-,8507
187,BUMA.1121.00037,1,508723,517252,+,8529
187,BUMA.1121.00009,1,3714169,3722735,-,8566
187,BUMA.1121.00069,1,1972977,1981497,-,8520
187,BUMA.1121.00088,1,2753928,2762475,+,8547
187,BUMA.1121.00092,1,1962015,1970535,-,8520
187,BUMA.1121.00074,1,1980755,1989346,-,8591
187,BUMA.1121.00070,1,1971999,1980519,-,8520
187,BUMA.1121.00093,1,2655761,2664282,+,8521
187,BUMA.1121.00063,1,1998022,2006542,-,8520
187,BUMA.1121.00033,1,11790,20286,+,8496
187,BUMA.1121.00018,1,2494303,2502823,+,8520
187,BUMA.1121.00080,1,1875013,1883525,+,8512
187,BUMA.1121.00027,1,28496,37017,+,8521
187,BUMA.1121.00053,1,1570731,1579279,+,8548
187,BUMA.1121.00059,1,1057907,1066417,+,8510
187,BUMA.1121.00043,1,1960006,1968576,+,8570
187,BUMA.1121.00056,1,2072713,2081256,-,8543
187,BUMA.1121.00112,1,1151196,1159697,-,8501
187,BUMA.1121.00091,1,2688303,2696858,-,8555
187,BUMA.1121.00047,1,1094825,1103320,-,8495
187,BUMA.1121.00067,1,2535660,2544188,-,8528
187,BUMA.1121.00110,1,2942009,2950512,-,8503
187,BUMA.1121.00073,1,1999020,2007540,-,8520
187,BUMA.1121.00072,1,1973448,1981968,-,8520
187,BUMA.1121.00077,1,532465,540969,+,8504
187,BUMA.1121.00082,1,2154535,2163055,-,8520
187,BUMA.1121.00062,1,2703835,2712380,-,8545
187,BUMA.1121.00007,1,2208529,2217043,-,8514
187,BUMA.1121.00025,1,756946,765465,-,8519
187,BUMA.1121.00021,1,2501265,2509786,+,8521
187,BUMA.1121.00103,1,2552052,2560563,-,8511
187,BUMA.1121.00096,1,1416918,1425429,-,8511
187,BUMA.1121.00079,1,1870198,1878798,+,8600
187,BUMA.1121.00039,1,1990559,1999088,+,8529
187,BUMA.1121.00083,1,3810109,3818629,-,8520
187,BUMA.1121.00084,1,2211596,2220157,+,8561
187,BUMA.1121.00049,1,4023696,4032242,-,8546
187,BUMA.1121.00089,1,1844874,1853421,+,8547
187,BUMA.1121.00014,1,906070,914610,-,8540
187,BUMA.1121.00090,1,4043301,4051857,+,8556
187,BUMA.1121.00071,1,1990570,1999090,-,8520
187,BUMA.1121.00078,1,7716,16229,-,8513
187,BUMA.1121.00102,1,3468385,3476910,-,8525
187,BUMA.1121.00075,1,1343014,1351532,+,8518
187,BUMA.1121.00012,1,622808,631318,+,8510
187,BUMA.1121.00076,1,3461363,3469881,-,8518
187,BUMA.1121.00106,1,1613316,1621872,+,8556
187,BUMA.1121.00001,1,2176934,2185462,-,8528
187,BUMA.1121.00107,1,1748034,1756519,+,8485
187,BUMA.1121.00104,1,3370893,3379411,-,8518
187,BUMA.1121.00099,1,482212,490739,-,8527
187,BUMA.1121.00098,1,438024,446540,+,8516
187,BUMA.1121.00111,1,2048488,2056993,+,8505
187,BUMA.1121.00109,1,66684,75196,-,8512
187,BUMA.1121.00097,1,2081585,2090129,-,8544
187,BUMA.1121.00094,1,1876290,1884832,+,8542
187,BUMA.1121.00095,1,3827257,3835746,-,8489
187,BUMA.1121.00005,1,564181,572743,+,8562
187,BUMA.1121.00101,1,628759,637380,-,8621
187,BUMA.1121.00065,1,1946898,1955397,+,8499
187,BUMA.1121.00100,1,3473537,3481949,-,8412
187,BUMA.1121.00105,1,3370026,3378539,-,8513
187,BUMA.1121.00029,1,3059825,3068362,-,8537
187,BUMA.1121.00066,1,1974902,1983422,-,8520
187,BUMA.1121.00031,1,3302455,3311014,+,8559
187,BUMA.1121.00108,1,2821625,2830146,+,8521
187,BUMA.1121.00023,1,213275,221786,+,8511
187,BUMA.1121.00035,1,3020228,3028766,+,8538
187,BUMA.1121.00041,1,3161738,3170281,+,8543
186,BUMA.1121.00057,1,2921731,2929184,+,7453
186,BUMA.1121.00058,1,2711713,2719193,-,7480
186,BUMA.1121.00045,1,2208029,2215472,-,7443
186,BUMA.1121.00051,1,1847439,1855062,+,7623
186,BUMA.1121.00068,1,602723,610164,+,7441
186,BUMA.1121.00061,1,2010853,2018378,-,7525
186,BUMA.1121.00060,1,433773,441216,-,7443
186,BUMA.1121.00064,1,1861800,1869227,+,7427
186,BUMA.1121.00016,1,1,7437,+,7436
186,BUMA.1121.00003,1,408841,416241,+,7400
186,BUMA.1121.00055,1,1423758,1431180,+,7422
186,BUMA.1121.00011,1,3816567,3824026,-,7459
186,BUMA.1121.00037,1,499845,507339,+,7494
186,BUMA.1121.00009,1,3724116,3731566,-,7450
186,BUMA.1121.00069,1,1982878,1990404,-,7526
186,BUMA.1121.00088,1,2745162,2752553,+,7391
186,BUMA.1121.00092,1,1971916,1979411,-,7495
186,BUMA.1121.00074,1,1990721,1998231,-,7510
186,BUMA.1121.00070,1,1981900,1989423,-,7523
186,BUMA.1121.00093,1,2646886,2654380,+,7494
186,BUMA.1121.00063,1,2007917,2015442,-,7525
186,BUMA.1121.00033,1,2973,10407,+,7434
186,BUMA.1121.00018,1,2485440,2492919,+,7479
186,BUMA.1121.00080,1,1866172,1873650,+,7478
186,BUMA.1121.00027,1,19618,27116,+,7498
186,BUMA.1121.00053,1,1561835,1569350,+,7515
186,BUMA.1121.00059,1,1049054,1056526,+,7472
186,BUMA.1121.00043,1,1951002,1958622,+,7620
186,BUMA.1121.00056,1,2082635,2090066,-,7431
186,BUMA.1121.00112,1,1161069,1168509,-,7440
186,BUMA.1121.00091,1,2698233,2705730,-,7497
186,BUMA.1121.00047,1,1104701,1112230,-,7529
186,BUMA.1121.00067,1,2545552,2552998,-,7446
186,BUMA.1121.00110,1,2951893,2959385,-,7492
186,BUMA.1121.00073,1,2008921,2016444,-,7523
186,BUMA.1121.00072,1,1983349,1990826,-,7477
186,BUMA.1121.00077,1,523530,531084,+,7554
186,BUMA.1121.00082,1,2164436,2171962,-,7526
186,BUMA.1121.00062,1,2713761,2721243,-,7482
186,BUMA.1121.00007,1,2218399,2225894,-,7495
186,BUMA.1121.00025,1,766849,774302,-,7453
186,BUMA.1121.00021,1,2492489,2499881,+,7392
186,BUMA.1121.00103,1,2561944,2569453,-,7509
186,BUMA.1121.00096,1,1426801,1434198,-,7397
186,BUMA.1121.00079,1,1861266,1868836,+,7570
186,BUMA.1121.00039,1,1981672,1989175,+,7503
186,BUMA.1121.00083,1,3820010,3827536,-,7526
186,BUMA.1121.00084,1,2202719,2210221,+,7502
186,BUMA.1121.00049,1,584,7967,-,7383
186,BUMA.1121.00089,1,1836063,1843493,+,7430
186,BUMA.1121.00014,1,915994,923378,-,7384
186,BUMA.1121.00090,1,4034442,4041918,+,7476
186,BUMA.1121.00071,1,2000471,2007997,-,7526
186,BUMA.1121.00078,1,17606,24947,-,7341
186,BUMA.1121.00102,1,3478291,3485934,-,7643
186,BUMA.1121.00075,1,1334194,1341633,+,7439
186,BUMA.1121.00012,1,612593,621424,+,8831
186,BUMA.1121.00076,1,3471262,3478711,-,7449
186,BUMA.1121.00106,1,1604536,1611936,+,7400
186,BUMA.1121.00001,1,2186846,2194293,-,7447
186,BUMA.1121.00107,1,1739199,1746656,+,7457
186,BUMA.1121.00104,1,3380777,3388217,-,7440
186,BUMA.1121.00099,1,492120,499575,-,7455
186,BUMA.1121.00098,1,429246,436643,+,7397
186,BUMA.1121.00111,1,2038499,2047104,+,8605
186,BUMA.1121.00109,1,76577,84015,-,7438
186,BUMA.1121.00097,1,2091510,2099047,-,7537
186,BUMA.1121.00094,1,1867471,1874918,+,7447
186,BUMA.1121.00095,1,3837124,3844547,-,7423
186,BUMA.1121.00005,1,554012,562805,+,8793
186,BUMA.1121.00101,1,638765,646281,-,7516
186,BUMA.1121.00065,1,1938159,1945517,+,7358
186,BUMA.1121.00100,1,3483330,3490782,-,7452
186,BUMA.1121.00105,1,3379911,3387348,-,7437
186,BUMA.1121.00029,1,3069746,3077211,-,7465
186,BUMA.1121.00066,1,1984803,1992166,-,7363
186,BUMA.1121.00031,1,3293574,3301071,+,7497
186,BUMA.1121.00108,1,2812859,2820244,+,7385
186,BUMA.1121.00023,1,204388,211891,+,7503
186,BUMA.1121.00035,1,3011416,3018844,+,7428
186,BUMA.1121.00041,1,3152847,3160357,+,7510
185,BUMA.1121.00057,1,2902051,2918785,+,16734
185,BUMA.1121.00058,1,2722149,2738816,-,16667
185,BUMA.1121.00045,1,2218413,2235067,-,16654
185,BUMA.1121.00051,1,1827854,1844488,+,16634
185,BUMA.1121.00068,1,583149,599782,+,16633
185,BUMA.1121.00061,1,2021324,2038002,-,16678
185,BUMA.1121.00060,1,444157,460811,-,16654
185,BUMA.1121.00064,1,1842220,1858859,+,16639
185,BUMA.1121.00016,1,4036787,4053466,+,16679
185,BUMA.1121.00003,1,389249,405900,+,16651
185,BUMA.1121.00055,1,1404127,1420797,+,16670
185,BUMA.1121.00011,1,3826967,3843681,-,16714
185,BUMA.1121.00037,1,480252,496904,+,16652
185,BUMA.1121.00009,1,3734507,3751144,-,16637
185,BUMA.1121.00069,1,1993350,2010028,-,16678
185,BUMA.1121.00088,1,2725582,2742221,+,16639
185,BUMA.1121.00092,1,1982372,1999039,-,16667
185,BUMA.1121.00074,1,2001172,2017852,-,16680
185,BUMA.1121.00070,1,1992369,2009047,-,16678
185,BUMA.1121.00093,1,2627258,2643925,+,16667
185,BUMA.1121.00063,1,2018388,2035066,-,16678
185,BUMA.1121.00033,1,4174772,4191431,+,16659
185,BUMA.1121.00018,1,2465836,2482500,+,16664
185,BUMA.1121.00080,1,1846586,1863221,+,16635
185,BUMA.1121.00027,1,1,16672,+,16671
185,BUMA.1121.00053,1,1542226,1558894,+,16668
185,BUMA.1121.00059,1,1029426,1046093,+,16667
185,BUMA.1121.00043,1,1931379,1948057,+,16678
185,BUMA.1121.00056,1,2092964,2109600,-,16636
185,BUMA.1121.00112,1,1171460,1188114,-,16654
185,BUMA.1121.00091,1,2708630,2725366,-,16736
185,BUMA.1121.00047,1,1115128,1131778,-,16650
185,BUMA.1121.00067,1,2555939,2572616,-,16677
185,BUMA.1121.00110,1,2962336,2978990,-,16654
185,BUMA.1121.00073,1,2019390,2036068,-,16678
185,BUMA.1121.00072,1,1993772,2010450,-,16678
185,BUMA.1121.00077,1,503925,520579,+,16654
185,BUMA.1121.00082,1,2174908,2191586,-,16678
185,BUMA.1121.00062,1,2724184,2740838,-,16654
185,BUMA.1121.00007,1,2228835,2245495,-,16660
185,BUMA.1121.00025,1,777242,793906,-,16664
185,BUMA.1121.00021,1,2472852,2489544,+,16692
185,BUMA.1121.00103,1,2572394,2589048,-,16654
185,BUMA.1121.00096,1,1437139,1453807,-,16668
185,BUMA.1121.00079,1,1841685,1858316,+,16631
185,BUMA.1121.00039,1,1962077,1978727,+,16650
185,BUMA.1121.00083,1,3830482,3847160,-,16678
185,BUMA.1121.00084,1,2183139,2199778,+,16639
185,BUMA.1121.00049,1,10908,27645,-,16737
185,BUMA.1121.00089,1,1816529,1833165,+,16636
185,BUMA.1121.00014,1,926323,942987,-,16664
185,BUMA.1121.00090,1,4014823,4031501,+,16678
185,BUMA.1121.00071,1,2010938,2027616,-,16678
185,BUMA.1121.00078,1,27845,44525,-,16680
185,BUMA.1121.00102,1,3488875,3505553,-,16678
185,BUMA.1121.00075,1,1314621,1331253,+,16632
185,BUMA.1121.00012,1,592984,609648,+,16664
185,BUMA.1121.00076,1,3481652,3498288,-,16636
185,BUMA.1121.00106,1,1584957,1601595,+,16638
185,BUMA.1121.00001,1,2197238,2213905,-,16667
185,BUMA.1121.00107,1,1719563,1736259,+,16696
185,BUMA.1121.00104,1,3391158,3407810,-,16652
185,BUMA.1121.00099,1,502466,519117,-,16651
185,BUMA.1121.00098,1,409641,426305,+,16664
185,BUMA.1121.00111,1,2018894,2035544,+,16650
185,BUMA.1121.00109,1,86961,103606,-,16645
185,BUMA.1121.00097,1,2101988,2118593,-,16605
185,BUMA.1121.00094,1,1847884,1864520,+,16636
185,BUMA.1121.00095,1,3847493,3864130,-,16637
185,BUMA.1121.00005,1,534429,551066,+,16637
185,BUMA.1121.00101,1,649222,665876,-,16654
185,BUMA.1121.00065,1,1918604,1935259,+,16655
185,BUMA.1121.00100,1,3493723,3510374,-,16651
185,BUMA.1121.00105,1,3390299,3407008,-,16709
185,BUMA.1121.00029,1,3080156,3096822,-,16666
185,BUMA.1121.00066,1,1995112,2011790,-,16678
185,BUMA.1121.00031,1,3273966,3290629,+,16663
185,BUMA.1121.00108,1,2793241,2809918,+,16677
185,BUMA.1121.00023,1,184790,201468,+,16678
185,BUMA.1121.00035,1,2991804,3008471,+,16667
185,BUMA.1121.00041,1,3133169,3149906,+,16737
184,BUMA.1121.00057,1,2885610,2902049,+,16439
184,BUMA.1121.00058,1,2738817,2755264,-,16447
184,BUMA.1121.00045,1,2235068,2251407,-,16339
184,BUMA.1121.00051,1,1811418,1827852,+,16434
184,BUMA.1121.00068,1,566721,583147,+,16426
184,BUMA.1121.00061,1,2038003,2054409,-,16406
184,BUMA.1121.00060,1,460812,477151,-,16339
184,BUMA.1121.00064,1,1825773,1842218,+,16445
184,BUMA.1121.00016,1,4020447,4036785,+,16338
184,BUMA.1121.00003,1,372784,389247,+,16463
184,BUMA.1121.00055,1,1387705,1404125,+,16420
184,BUMA.1121.00011,1,3843682,3860109,-,16427
184,BUMA.1121.00037,1,463818,480250,+,16432
184,BUMA.1121.00009,1,3751145,3767591,-,16446
184,BUMA.1121.00069,1,2010029,2026464,-,16435
184,BUMA.1121.00088,1,2709112,2725580,+,16468
184,BUMA.1121.00092,1,1999040,2015462,-,16422
184,BUMA.1121.00074,1,2017853,2034299,-,16446
184,BUMA.1121.00070,1,2009048,2025470,-,16422
184,BUMA.1121.00093,1,2610835,2627256,+,16421
184,BUMA.1121.00063,1,2035067,2051476,-,16409
184,BUMA.1121.00033,1,4158356,4174770,+,16414
184,BUMA.1121.00018,1,2449413,2465834,+,16421
184,BUMA.1121.00080,1,1830151,1846584,+,16433
184,BUMA.1121.00027,1,3995570,4012023,+,16453
184,BUMA.1121.00053,1,1525861,1542224,+,16363
184,BUMA.1121.00059,1,1012992,1029424,+,16432
184,BUMA.1121.00043,1,1914942,1931377,+,16435
184,BUMA.1121.00056,1,2109601,2126035,-,16434
184,BUMA.1121.00112,1,1188115,1204542,-,16427
184,BUMA.1121.00091,1,2725367,2741815,-,16448
184,BUMA.1121.00047,1,1131779,1148213,-,16434
184,BUMA.1121.00067,1,2572617,2589040,-,16423
184,BUMA.1121.00110,1,2978991,2995442,-,16451
184,BUMA.1121.00073,1,2036069,2052485,-,16416
184,BUMA.1121.00072,1,2010451,2026890,-,16439
184,BUMA.1121.00077,1,487475,503923,+,16448
184,BUMA.1121.00082,1,2191587,2208027,-,16440
184,BUMA.1121.00062,1,2740839,2757269,-,16430
184,BUMA.1121.00007,1,2245496,2261951,-,16455
184,BUMA.1121.00025,1,793907,810330,-,16423
184,BUMA.1121.00021,1,2456417,2472850,+,16433
184,BUMA.1121.00103,1,2589049,2605493,-,16444
184,BUMA.1121.00096,1,1453808,1470242,-,16434
184,BUMA.1121.00079,1,1825253,1841683,+,16430
184,BUMA.1121.00039,1,1945666,1962075,+,16409
184,BUMA.1121.00083,1,3847161,3863601,-,16440
184,BUMA.1121.00084,1,2166679,2183137,+,16458
184,BUMA.1121.00049,1,27646,44105,-,16459
184,BUMA.1121.00089,1,1800094,1816527,+,16433
184,BUMA.1121.00014,1,942988,959409,-,16421
184,BUMA.1121.00090,1,3998412,4014821,+,16409
184,BUMA.1121.00071,1,2027617,2044057,-,16440
184,BUMA.1121.00078,1,44526,60971,-,16445
184,BUMA.1121.00102,1,3505554,3521988,-,16434
184,BUMA.1121.00075,1,1298176,1314619,+,16443
184,BUMA.1121.00012,1,576553,592982,+,16429
184,BUMA.1121.00076,1,3498289,3514733,-,16444
184,BUMA.1121.00106,1,1568497,1584955,+,16458
184,BUMA.1121.00001,1,2213906,2230316,-,16410
184,BUMA.1121.00107,1,1703124,1719561,+,16437
184,BUMA.1121.00104,1,3407811,3424267,-,16456
184,BUMA.1121.00099,1,519118,535506,-,16388
184,BUMA.1121.00098,1,393194,409639,+,16445
184,BUMA.1121.00111,1,2002484,2018892,+,16408
184,BUMA.1121.00109,1,103607,120045,-,16438
184,BUMA.1121.00097,1,2118594,2135022,-,16428
184,BUMA.1121.00094,1,1831449,1847882,+,16433
184,BUMA.1121.00095,1,3864131,3880574,-,16443
184,BUMA.1121.00005,1,517984,534427,+,16443
184,BUMA.1121.00101,1,665877,682297,-,16420
184,BUMA.1121.00065,1,1902182,1918602,+,16420
184,BUMA.1121.00100,1,3510375,3526836,-,16461
184,BUMA.1121.00105,1,3407009,3423430,-,16421
184,BUMA.1121.00029,1,3096823,3113161,-,16338
184,BUMA.1121.00066,1,2011791,2028224,-,16433
184,BUMA.1121.00031,1,3257544,3273964,+,16420
184,BUMA.1121.00108,1,2776798,2793239,+,16441
184,BUMA.1121.00023,1,168380,184788,+,16408
184,BUMA.1121.00035,1,2975393,2991802,+,16409
184,BUMA.1121.00041,1,3116718,3133167,+,16449
183,BUMA.1121.00057,1,2871515,2885608,+,14093
183,BUMA.1121.00058,1,2755265,2769382,-,14117
183,BUMA.1121.00045,1,2251408,2265503,-,14095
183,BUMA.1121.00051,1,1797312,1811416,+,14104
183,BUMA.1121.00068,1,552578,566719,+,14141
183,BUMA.1121.00061,1,2054410,2068505,-,14095
183,BUMA.1121.00060,1,477152,491247,-,14095
183,BUMA.1121.00064,1,1811666,1825771,+,14105
183,BUMA.1121.00016,1,4006345,4020445,+,14100
183,BUMA.1121.00003,1,358704,372782,+,14078
183,BUMA.1121.00055,1,1373608,1387703,+,14095
183,BUMA.1121.00011,1,3860110,3874194,-,14084
183,BUMA.1121.00037,1,449719,463816,+,14097
183,BUMA.1121.00009,1,3767592,3781672,-,14080
183,BUMA.1121.00069,1,2026465,2040558,-,14093
183,BUMA.1121.00088,1,2695029,2709110,+,14081
183,BUMA.1121.00092,1,2015463,2029567,-,14104
183,BUMA.1121.00074,1,2034300,2048405,-,14105
183,BUMA.1121.00070,1,2025471,2039567,-,14096
183,BUMA.1121.00093,1,2596729,2610833,+,14104
183,BUMA.1121.00063,1,2051477,2065573,-,14096
183,BUMA.1121.00033,1,4144249,4158354,+,14105
183,BUMA.1121.00018,1,2435322,2449411,+,14089
183,BUMA.1121.00080,1,1816043,1830149,+,14106
183,BUMA.1121.00027,1,3981457,3995568,+,14111
183,BUMA.1121.00053,1,1511719,1525859,+,14140
183,BUMA.1121.00059,1,998886,1012990,+,14104
183,BUMA.1121.00043,1,1900843,1914940,+,14097
183,BUMA.1121.00056,1,2126036,2140143,-,14107
183,BUMA.1121.00112,1,1204543,1218626,-,14083
183,BUMA.1121.00091,1,2741816,2755932,-,14116
183,BUMA.1121.00047,1,1148214,1162321,-,14107
183,BUMA.1121.00067,1,2589041,2603147,-,14106
183,BUMA.1121.00110,1,2995443,3009570,-,14127
183,BUMA.1121.00073,1,2052486,2066583,-,14097
183,BUMA.1121.00072,1,2026891,2040991,-,14100
183,BUMA.1121.00077,1,473348,487473,+,14125
183,BUMA.1121.00082,1,2208028,2222130,-,14102
183,BUMA.1121.00062,1,2757270,2771343,-,14073
183,BUMA.1121.00007,1,2261952,2276060,-,14108
183,BUMA.1121.00025,1,810331,824419,-,14088
183,BUMA.1121.00021,1,2442317,2456415,+,14098
183,BUMA.1121.00103,1,2607069,2621214,-,14145
183,BUMA.1121.00096,1,1470243,1484360,-,14117
183,BUMA.1121.00079,1,1811155,1825251,+,14096
183,BUMA.1121.00039,1,1931567,1945664,+,14097
183,BUMA.1121.00083,1,3863602,3877704,-,14102
183,BUMA.1121.00084,1,2152558,2166677,+,14119
183,BUMA.1121.00049,1,44106,58206,-,14100
183,BUMA.1121.00089,1,1785985,1800092,+,14107
183,BUMA.1121.00014,1,959410,973507,-,14097
183,BUMA.1121.00090,1,3984326,3998410,+,14084
183,BUMA.1121.00071,1,2044058,2058160,-,14102
183,BUMA.1121.00078,1,60972,75065,-,14093
183,BUMA.1121.00102,1,3521989,3536095,-,14106
183,BUMA.1121.00075,1,1284057,1298174,+,14117
183,BUMA.1121.00012,1,562467,576551,+,14084
183,BUMA.1121.00076,1,3514734,3528851,-,14117
183,BUMA.1121.00106,1,1554378,1568495,+,14117
183,BUMA.1121.00001,1,2230317,2244414,-,14097
183,BUMA.1121.00107,1,1689015,1703122,+,14107
183,BUMA.1121.00104,1,3425845,3439947,-,14102
183,BUMA.1121.00099,1,535507,549630,-,14123
183,BUMA.1121.00098,1,379101,393192,+,14091
183,BUMA.1121.00111,1,1988387,2002482,+,14095
183,BUMA.1121.00109,1,120046,134129,-,14083
183,BUMA.1121.00097,1,2135023,2149138,-,14115
183,BUMA.1121.00094,1,1817340,1831447,+,14107
183,BUMA.1121.00095,1,3880575,3894689,-,14114
183,BUMA.1121.00005,1,503876,517982,+,14106
183,BUMA.1121.00101,1,682298,696371,-,14073
183,BUMA.1121.00065,1,1888088,1902180,+,14092
183,BUMA.1121.00100,1,3526837,3540885,-,14048
183,BUMA.1121.00105,1,3423431,3437535,-,14104
183,BUMA.1121.00029,1,3113162,3127259,-,14097
183,BUMA.1121.00066,1,2028225,2042320,-,14095
183,BUMA.1121.00031,1,3243446,3257542,+,14096
183,BUMA.1121.00108,1,2762688,2776796,+,14108
183,BUMA.1121.00023,1,152691,166804,+,14113
183,BUMA.1121.00035,1,2961294,2975391,+,14097
183,BUMA.1121.00041,1,3102636,3116716,+,14080
182,BUMA.1121.00057,1,2863242,2871394,+,8152
182,BUMA.1121.00058,1,2769503,2777412,-,7909
182,BUMA.1121.00045,1,2265624,2273533,-,7909
182,BUMA.1121.00051,1,1789039,1797191,+,8152
182,BUMA.1121.00068,1,544304,552457,+,8153
182,BUMA.1121.00061,1,2068626,2076535,-,7909
182,BUMA.1121.00060,1,491368,499277,-,7909
182,BUMA.1121.00064,1,1803394,1811545,+,8151
182,BUMA.1121.00016,1,3998072,4006224,+,8152
182,BUMA.1121.00003,1,350433,358584,+,8151
182,BUMA.1121.00055,1,1365335,1373487,+,8152
182,BUMA.1121.00011,1,3874315,3882224,-,7909
182,BUMA.1121.00037,1,441446,449598,+,8152
182,BUMA.1121.00009,1,3781793,3789663,-,7870
182,BUMA.1121.00069,1,2040679,2048568,-,7889
182,BUMA.1121.00088,1,2686756,2694908,+,8152
182,BUMA.1121.00092,1,2029688,2037597,-,7909
182,BUMA.1121.00074,1,2048526,2056435,-,7909
182,BUMA.1121.00070,1,2039688,2047597,-,7909
182,BUMA.1121.00093,1,2588456,2596608,+,8152
182,BUMA.1121.00063,1,2065694,2073603,-,7909
182,BUMA.1121.00033,1,4135976,4144128,+,8152
182,BUMA.1121.00018,1,2427049,2435201,+,8152
182,BUMA.1121.00080,1,1807770,1815922,+,8152
182,BUMA.1121.00027,1,3973184,3981336,+,8152
182,BUMA.1121.00053,1,1503446,1511598,+,8152
182,BUMA.1121.00059,1,990614,998765,+,8151
182,BUMA.1121.00043,1,1892570,1900722,+,8152
182,BUMA.1121.00056,1,2140264,2148173,-,7909
182,BUMA.1121.00112,1,1218747,1226656,-,7909
182,BUMA.1121.00091,1,2756053,2763962,-,7909
182,BUMA.1121.00047,1,1162442,1170351,-,7909
182,BUMA.1121.00067,1,2603268,2611177,-,7909
182,BUMA.1121.00110,1,3009691,3017601,-,7910
182,BUMA.1121.00073,1,2066704,2074613,-,7909
182,BUMA.1121.00072,1,2041112,2049021,-,7909
182,BUMA.1121.00077,1,465075,473227,+,8152
182,BUMA.1121.00082,1,2222251,2230160,-,7909
182,BUMA.1121.00062,1,2772963,2780871,-,7908
182,BUMA.1121.00007,1,2276181,2284090,-,7909
182,BUMA.1121.00025,1,824540,832450,-,7910
182,BUMA.1121.00021,1,2434044,2442196,+,8152
182,BUMA.1121.00103,1,2621301,2629210,-,7909
182,BUMA.1121.00096,1,1484481,1492390,-,7909
182,BUMA.1121.00079,1,1802882,1811034,+,8152
182,BUMA.1121.00039,1,1923294,1931446,+,8152
182,BUMA.1121.00083,1,3877825,3885734,-,7909
182,BUMA.1121.00084,1,2144285,2152437,+,8152
182,BUMA.1121.00049,1,58327,66236,-,7909
182,BUMA.1121.00089,1,1777712,1785864,+,8152
182,BUMA.1121.00014,1,973628,981537,-,7909
182,BUMA.1121.00090,1,3976053,3984205,+,8152
182,BUMA.1121.00071,1,2058281,2066190,-,7909
182,BUMA.1121.00078,1,75186,83094,-,7908
182,BUMA.1121.00102,1,3536216,3544125,-,7909
182,BUMA.1121.00075,1,1275785,1283936,+,8151
182,BUMA.1121.00012,1,554194,562346,+,8152
182,BUMA.1121.00076,1,3528972,3536881,-,7909
182,BUMA.1121.00106,1,1546105,1554257,+,8152
182,BUMA.1121.00001,1,2244535,2252444,-,7909
182,BUMA.1121.00107,1,1680742,1688894,+,8152
182,BUMA.1121.00104,1,3440068,3447977,-,7909
182,BUMA.1121.00099,1,549751,557650,-,7899
182,BUMA.1121.00098,1,370915,378980,+,8065
182,BUMA.1121.00111,1,1980114,1988266,+,8152
182,BUMA.1121.00109,1,134249,142147,-,7898
182,BUMA.1121.00097,1,2149259,2157168,-,7909
182,BUMA.1121.00094,1,1809066,1817219,+,8153
182,BUMA.1121.00095,1,3894810,3902719,-,7909
182,BUMA.1121.00005,1,495603,503755,+,8152
182,BUMA.1121.00101,1,696492,704400,-,7908
182,BUMA.1121.00065,1,1879816,1887967,+,8151
182,BUMA.1121.00100,1,3541006,3548915,-,7909
182,BUMA.1121.00105,1,3437656,3445565,-,7909
182,BUMA.1121.00029,1,3127380,3135289,-,7909
182,BUMA.1121.00066,1,2042441,2050350,-,7909
182,BUMA.1121.00031,1,3235173,3243325,+,8152
182,BUMA.1121.00108,1,2754416,2762567,+,8151
182,BUMA.1121.00023,1,144418,152570,+,8152
182,BUMA.1121.00035,1,2953021,2961173,+,8152
182,BUMA.1121.00041,1,3094363,3102515,+,8152
181,BUMA.1121.00057,1,2859201,2863179,+,3978
181,BUMA.1121.00058,1,2777719,2781667,-,3948
181,BUMA.1121.00045,1,2273840,2277818,-,3978
181,BUMA.1121.00051,1,1785065,1788976,+,3911
181,BUMA.1121.00068,1,540263,544241,+,3978
181,BUMA.1121.00061,1,2076842,2080830,-,3988
181,BUMA.1121.00060,1,499584,503562,-,3978
181,BUMA.1121.00064,1,1799420,1803331,+,3911
181,BUMA.1121.00016,1,3978649,3982627,+,3978
181,BUMA.1121.00003,1,346392,350370,+,3978
181,BUMA.1121.00055,1,1361304,1365272,+,3968
181,BUMA.1121.00011,1,3882531,3886509,-,3978
181,BUMA.1121.00037,1,437405,441383,+,3978
181,BUMA.1121.00009,1,3789970,3793948,-,3978
181,BUMA.1121.00069,1,2048875,2052863,-,3988
181,BUMA.1121.00088,1,2682782,2686693,+,3911
181,BUMA.1121.00092,1,2037904,2041881,-,3977
181,BUMA.1121.00074,1,2056742,2060710,-,3968
181,BUMA.1121.00070,1,2047904,2051892,-,3988
181,BUMA.1121.00093,1,2584416,2588393,+,3977
181,BUMA.1121.00063,1,2073910,2077898,-,3988
181,BUMA.1121.00033,1,4084534,4088503,+,3969
181,BUMA.1121.00018,1,2423008,2426986,+,3978
181,BUMA.1121.00080,1,1803796,1807707,+,3911
181,BUMA.1121.00027,1,3969133,3973121,+,3988
181,BUMA.1121.00053,1,1499416,1503383,+,3967
181,BUMA.1121.00059,1,986641,990551,+,3910
181,BUMA.1121.00043,1,1888529,1892507,+,3978
181,BUMA.1121.00056,1,2148480,2152458,-,3978
181,BUMA.1121.00112,1,1226963,1230931,-,3968
181,BUMA.1121.00091,1,2764269,2768248,-,3979
181,BUMA.1121.00047,1,1170658,1174635,-,3977
181,BUMA.1121.00067,1,2611484,2615451,-,3967
181,BUMA.1121.00110,1,3017908,3021906,-,3998
181,BUMA.1121.00073,1,2074920,2078908,-,3988
181,BUMA.1121.00072,1,2049328,2053316,-,3988
181,BUMA.1121.00077,1,461014,465012,+,3998
181,BUMA.1121.00082,1,2230467,2234455,-,3988
181,BUMA.1121.00062,1,2781178,2785165,-,3987
181,BUMA.1121.00007,1,2284397,2288344,-,3947
181,BUMA.1121.00025,1,832757,836735,-,3978
181,BUMA.1121.00021,1,2430003,2433981,+,3978
181,BUMA.1121.00103,1,2629517,2633513,-,3996
181,BUMA.1121.00096,1,1492697,1496675,-,3978
181,BUMA.1121.00079,1,1798908,1802819,+,3911
181,BUMA.1121.00039,1,1919253,1923231,+,3978
181,BUMA.1121.00083,1,3886041,3890029,-,3988
181,BUMA.1121.00084,1,2140311,2144222,+,3911
181,BUMA.1121.00049,1,66543,70522,-,3979
181,BUMA.1121.00089,1,1773738,1777649,+,3911
181,BUMA.1121.00014,1,981844,985822,-,3978
181,BUMA.1121.00090,1,3972012,3975990,+,3978
181,BUMA.1121.00071,1,2066497,2070485,-,3988
181,BUMA.1121.00078,1,163374,167372,-,3998
181,BUMA.1121.00102,1,3633147,3637115,-,3968
181,BUMA.1121.00075,1,1271744,1275722,+,3978
181,BUMA.1121.00012,1,502752,506720,+,3968
181,BUMA.1121.00076,1,3537187,3541165,-,3978
181,BUMA.1121.00106,1,1542063,1546042,+,3979
181,BUMA.1121.00001,1,2252751,2256729,-,3978
181,BUMA.1121.00107,1,1676767,1680679,+,3912
181,BUMA.1121.00104,1,3448284,3452263,-,3979
181,BUMA.1121.00099,1,557957,561935,-,3978
181,BUMA.1121.00098,1,366894,370852,+,3958
181,BUMA.1121.00111,1,1976115,1980051,+,3936
181,BUMA.1121.00109,1,142454,146452,-,3998
181,BUMA.1121.00097,1,2157475,2161452,-,3977
181,BUMA.1121.00094,1,1805092,1809003,+,3911
181,BUMA.1121.00095,1,3903026,3907004,-,3978
181,BUMA.1121.00005,1,491561,495540,+,3979
181,BUMA.1121.00101,1,704707,708664,-,3957
181,BUMA.1121.00065,1,1875775,1879753,+,3978
181,BUMA.1121.00100,1,3549221,3553198,-,3977
181,BUMA.1121.00105,1,3445872,3449849,-,3977
181,BUMA.1121.00029,1,3135596,3139574,-,3978
181,BUMA.1121.00066,1,2050657,2054645,-,3988
181,BUMA.1121.00031,1,3231132,3235110,+,3978
181,BUMA.1121.00108,1,2750442,2754353,+,3911
181,BUMA.1121.00023,1,140367,144355,+,3988
181,BUMA.1121.00035,1,2948980,2952958,+,3978
181,BUMA.1121.00041,1,3090388,3094300,+,3912
180,BUMA.1121.00057,1,2850318,2859151,+,8833
180,BUMA.1121.00058,1,2783182,2791980,-,8798
180,BUMA.1121.00045,1,2277868,2286594,-,8726
180,BUMA.1121.00051,1,1776188,1784948,+,8760
180,BUMA.1121.00068,1,531306,540213,+,8907
180,BUMA.1121.00061,1,2080880,2089663,-,8783
180,BUMA.1121.00060,1,503612,512345,-,8733
180,BUMA.1121.00064,1,1790506,1799313,+,8807
180,BUMA.1121.00016,1,3969813,3978599,+,8786
180,BUMA.1121.00003,1,337606,346342,+,8736
180,BUMA.1121.00055,1,1352324,1361254,+,8930
180,BUMA.1121.00011,1,3886559,3895323,-,8764
180,BUMA.1121.00037,1,428478,437355,+,8877
180,BUMA.1121.00009,1,3793998,3802847,-,8849
180,BUMA.1121.00069,1,2052913,2061690,-,8777
180,BUMA.1121.00088,1,2673813,2682675,+,8862
180,BUMA.1121.00092,1,2041931,2050742,-,8811
180,BUMA.1121.00074,1,2060760,2069580,-,8820
180,BUMA.1121.00070,1,2051942,2060697,-,8755
180,BUMA.1121.00093,1,2575576,2584366,+,8790
180,BUMA.1121.00063,1,2077948,2086699,-,8751
180,BUMA.1121.00033,1,4075620,4084484,+,8864
180,BUMA.1121.00018,1,2414249,2422958,+,8709
180,BUMA.1121.00080,1,1794876,1803679,+,8803
180,BUMA.1121.00027,1,3960277,3969083,+,8806
180,BUMA.1121.00053,1,1490570,1499366,+,8796
180,BUMA.1121.00059,1,977730,986534,+,8804
180,BUMA.1121.00043,1,1879702,1888479,+,8777
180,BUMA.1121.00056,1,2152508,2161256,-,8748
180,BUMA.1121.00112,1,1230981,1239793,-,8812
180,BUMA.1121.00091,1,2768298,2777150,-,8852
180,BUMA.1121.00047,1,1174685,1183531,-,8846
180,BUMA.1121.00067,1,2616966,2625815,-,8849
180,BUMA.1121.00110,1,3021956,3030616,-,8660
180,BUMA.1121.00073,1,2078958,2087713,-,8755
180,BUMA.1121.00072,1,2053366,2062141,-,8775
180,BUMA.1121.00077,1,452206,460964,+,8758
180,BUMA.1121.00082,1,2234505,2243288,-,8783
180,BUMA.1121.00062,1,2785215,2793987,-,8772
180,BUMA.1121.00007,1,2288394,2297082,-,8688
180,BUMA.1121.00025,1,836785,845509,-,8724
180,BUMA.1121.00021,1,2421154,2429953,+,8799
180,BUMA.1121.00103,1,2633563,2642391,-,8828
180,BUMA.1121.00096,1,1496725,1505459,-,8734
180,BUMA.1121.00079,1,1790050,1798791,+,8741
180,BUMA.1121.00039,1,1910403,1919203,+,8800
180,BUMA.1121.00083,1,3890079,3898862,-,8783
180,BUMA.1121.00084,1,2129921,2138738,+,8817
180,BUMA.1121.00049,1,70572,79368,-,8796
180,BUMA.1121.00089,1,1764768,1773621,+,8853
180,BUMA.1121.00014,1,985872,994818,-,8946
180,BUMA.1121.00090,1,3963190,3971962,+,8772
180,BUMA.1121.00071,1,2070535,2079285,-,8750
180,BUMA.1121.00078,1,167422,176260,-,8838
180,BUMA.1121.00102,1,3637165,3645926,-,8761
180,BUMA.1121.00075,1,1262921,1271694,+,8773
180,BUMA.1121.00012,1,493915,502702,+,8787
180,BUMA.1121.00076,1,3541215,3549997,-,8782
180,BUMA.1121.00106,1,1533182,1542013,+,8831
180,BUMA.1121.00001,1,2256779,2265640,-,8861
180,BUMA.1121.00107,1,1667928,1676650,+,8722
180,BUMA.1121.00104,1,3452313,3461151,-,8838
180,BUMA.1121.00099,1,561985,570702,-,8717
180,BUMA.1121.00098,1,357956,366844,+,8888
180,BUMA.1121.00111,1,1967267,1976071,+,8804
180,BUMA.1121.00109,1,146502,155305,-,8803
180,BUMA.1121.00097,1,2161502,2170243,-,8741
180,BUMA.1121.00094,1,1796122,1804975,+,8853
180,BUMA.1121.00095,1,3907054,3915796,-,8742
180,BUMA.1121.00005,1,482632,491511,+,8879
180,BUMA.1121.00101,1,708714,717524,-,8810
180,BUMA.1121.00065,1,1867017,1875725,+,8708
180,BUMA.1121.00100,1,3553248,3562171,-,8923
180,BUMA.1121.00105,1,3449899,3458557,-,8658
180,BUMA.1121.00029,1,3139624,3148625,-,9001
180,BUMA.1121.00066,1,2054695,2063478,-,8783
180,BUMA.1121.00031,1,3222228,3231082,+,8854
180,BUMA.1121.00108,1,2741607,2750325,+,8718
180,BUMA.1121.00023,1,131384,140317,+,8933
180,BUMA.1121.00035,1,2940119,2948930,+,8811
180,BUMA.1121.00041,1,3081464,3090271,+,8807
179,BUMA.1121.00057,1,2818820,2849748,+,30928
179,BUMA.1121.00058,1,2792549,2823433,-,30884
179,BUMA.1121.00045,1,2287163,2318031,-,30868
179,BUMA.1121.00051,1,1744717,1775618,+,30901
179,BUMA.1121.00068,1,499866,530736,+,30870
179,BUMA.1121.00061,1,2090232,2121146,-,30914
179,BUMA.1121.00060,1,512914,543782,-,30868
179,BUMA.1121.00064,1,1759024,1789936,+,30912
179,BUMA.1121.00016,1,3938349,3969243,+,30894
179,BUMA.1121.00003,1,306068,337036,+,30968
179,BUMA.1121.00055,1,1320830,1351754,+,30924
179,BUMA.1121.00011,1,3895892,3926709,-,30817
179,BUMA.1121.00037,1,397032,427908,+,30876
179,BUMA.1121.00009,1,3803416,3834321,-,30905
179,BUMA.1121.00069,1,2062259,2093170,-,30911
179,BUMA.1121.00088,1,2642325,2673243,+,30918
179,BUMA.1121.00092,1,2051311,2082195,-,30884
179,BUMA.1121.00074,1,2070149,2101062,-,30913
179,BUMA.1121.00070,1,2061266,2092166,-,30900
179,BUMA.1121.00093,1,2544124,2575006,+,30882
179,BUMA.1121.00063,1,2087268,2118164,-,30896
179,BUMA.1121.00033,1,4044163,4075050,+,30887
179,BUMA.1121.00018,1,2382811,2413679,+,30868
179,BUMA.1121.00080,1,1763403,1794306,+,30903
179,BUMA.1121.00027,1,3928846,3959707,+,30861
179,BUMA.1121.00053,1,1459099,1490000,+,30901
179,BUMA.1121.00059,1,946226,977160,+,30934
179,BUMA.1121.00043,1,1846882,1879132,+,32250
179,BUMA.1121.00056,1,2161825,2192729,-,30904
179,BUMA.1121.00112,1,1240362,1271213,-,30851
179,BUMA.1121.00091,1,2777719,2808656,-,30937
179,BUMA.1121.00047,1,1184100,1215004,-,30904
179,BUMA.1121.00067,1,2626384,2657288,-,30904
179,BUMA.1121.00110,1,3031185,3062025,-,30840
179,BUMA.1121.00073,1,2088282,2119211,-,30929
179,BUMA.1121.00072,1,2062710,2093613,-,30903
179,BUMA.1121.00077,1,420798,451636,+,30838
179,BUMA.1121.00082,1,2243857,2274786,-,30929
179,BUMA.1121.00062,1,2794556,2825458,-,30902
179,BUMA.1121.00007,1,2297651,2328541,-,30890
179,BUMA.1121.00025,1,846078,876947,-,30869
179,BUMA.1121.00021,1,2389684,2420584,+,30900
179,BUMA.1121.00103,1,2642960,2673771,-,30811
179,BUMA.1121.00096,1,1506028,1536955,-,30927
179,BUMA.1121.00079,1,1758572,1789480,+,30908
179,BUMA.1121.00039,1,1878896,1909833,+,30937
179,BUMA.1121.00083,1,3899431,3930360,-,30929
179,BUMA.1121.00084,1,2098433,2129351,+,30918
179,BUMA.1121.00049,1,79937,110838,-,30901
179,BUMA.1121.00089,1,1733295,1764198,+,30903
179,BUMA.1121.00014,1,995387,1026313,-,30926
179,BUMA.1121.00090,1,3931668,3962620,+,30952
179,BUMA.1121.00071,1,2079854,2110776,-,30922
179,BUMA.1121.00078,1,176829,207714,-,30885
179,BUMA.1121.00102,1,3646495,3677188,-,30693
179,BUMA.1121.00075,1,1231490,1262351,+,30861
179,BUMA.1121.00012,1,462450,493345,+,30895
179,BUMA.1121.00076,1,3550566,3581430,-,30864
179,BUMA.1121.00106,1,1501687,1532612,+,30925
179,BUMA.1121.00001,1,2266209,2297138,-,30929
179,BUMA.1121.00107,1,1636474,1667358,+,30884
179,BUMA.1121.00104,1,3461720,3492646,-,30926
179,BUMA.1121.00099,1,571271,602194,-,30923
179,BUMA.1121.00098,1,326490,357386,+,30896
179,BUMA.1121.00111,1,1935736,1966697,+,30961
179,BUMA.1121.00109,1,155874,186763,-,30889
179,BUMA.1121.00097,1,2170812,2201697,-,30885
179,BUMA.1121.00094,1,1764649,1795552,+,30903
179,BUMA.1121.00095,1,3916365,3947268,-,30903
179,BUMA.1121.00005,1,451218,482062,+,30844
179,BUMA.1121.00101,1,718093,748828,-,30735
179,BUMA.1121.00065,1,1835537,1866447,+,30910
179,BUMA.1121.00100,1,3562740,3593640,-,30900
179,BUMA.1121.00105,1,3459126,3490039,-,30913
179,BUMA.1121.00029,1,3149194,3180124,-,30930
179,BUMA.1121.00066,1,2064047,2094958,-,30911
179,BUMA.1121.00031,1,3190732,3221658,+,30926
179,BUMA.1121.00108,1,2710111,2741037,+,30926
179,BUMA.1121.00023,1,99883,130814,+,30931
179,BUMA.1121.00035,1,2908666,2939549,+,30883
179,BUMA.1121.00041,1,3049970,3080894,+,30924
178,BUMA.1121.00057,1,2809968,2815078,+,5110
178,BUMA.1121.00058,1,2825584,2830694,-,5110
178,BUMA.1121.00045,1,2320182,2325292,-,5110
178,BUMA.1121.00051,1,1737456,1742559,+,5103
178,BUMA.1121.00068,1,491015,496125,+,5110
178,BUMA.1121.00061,1,2124888,2129998,-,5110
178,BUMA.1121.00060,1,545933,551043,-,5110
178,BUMA.1121.00064,1,1751763,1756873,+,5110
178,BUMA.1121.00016,1,3931088,3936198,+,5110
178,BUMA.1121.00003,1,297216,302326,+,5110
178,BUMA.1121.00055,1,1313569,1318679,+,5110
178,BUMA.1121.00011,1,3928860,3933964,-,5104
178,BUMA.1121.00037,1,388178,393288,+,5110
178,BUMA.1121.00009,1,3836475,3841585,-,5110
178,BUMA.1121.00069,1,2096912,2102022,-,5110
178,BUMA.1121.00088,1,2633473,2638583,+,5110
178,BUMA.1121.00092,1,2084352,2089456,-,5104
178,BUMA.1121.00074,1,2103213,2108323,-,5110
178,BUMA.1121.00070,1,2095908,2101018,-,5110
178,BUMA.1121.00093,1,2536863,2541966,+,5103
178,BUMA.1121.00063,1,2121906,2127016,-,5110
178,BUMA.1121.00033,1,4036902,4042012,+,5110
178,BUMA.1121.00018,1,2375550,2380660,+,5110
178,BUMA.1121.00080,1,1756142,1761245,+,5103
178,BUMA.1121.00027,1,3919994,3925104,+,5110
178,BUMA.1121.00053,1,1451838,1456941,+,5103
178,BUMA.1121.00059,1,937374,942477,+,5103
178,BUMA.1121.00043,1,1839631,1844731,+,5100
178,BUMA.1121.00056,1,2194886,2199990,-,5104
178,BUMA.1121.00112,1,1273364,1278468,-,5104
178,BUMA.1121.00091,1,2810806,2815916,-,5110
178,BUMA.1121.00047,1,1217161,1222265,-,5104
178,BUMA.1121.00067,1,2659439,2664549,-,5110
178,BUMA.1121.00110,1,3064176,3069286,-,5110
178,BUMA.1121.00073,1,2122953,2128063,-,5110
178,BUMA.1121.00072,1,2097355,2102465,-,5110
178,BUMA.1121.00077,1,413539,418649,+,5110
178,BUMA.1121.00082,1,2278528,2283638,-,5110
178,BUMA.1121.00062,1,2829200,2834310,-,5110
178,BUMA.1121.00007,1,2330691,2335801,-,5110
178,BUMA.1121.00025,1,879098,884208,-,5110
178,BUMA.1121.00021,1,2382423,2387533,+,5110
178,BUMA.1121.00103,1,2679106,2684216,-,5110
178,BUMA.1121.00096,1,1539106,1544216,-,5110
178,BUMA.1121.00079,1,1751311,1756414,+,5103
178,BUMA.1121.00039,1,1870322,1875398,+,5076
178,BUMA.1121.00083,1,3934102,3939212,-,5110
178,BUMA.1121.00084,1,2091172,2096282,+,5110
178,BUMA.1121.00049,1,112989,118099,-,5110
178,BUMA.1121.00089,1,1726034,1731137,+,5103
178,BUMA.1121.00014,1,1030055,1035165,-,5110
178,BUMA.1121.00090,1,3924407,3929517,+,5110
178,BUMA.1121.00071,1,2114518,2119628,-,5110
178,BUMA.1121.00078,1,211454,216564,-,5110
178,BUMA.1121.00102,1,3680936,3686040,-,5104
178,BUMA.1121.00075,1,1224229,1229339,+,5110
178,BUMA.1121.00012,1,455190,460300,+,5110
178,BUMA.1121.00076,1,3583581,3588691,-,5110
178,BUMA.1121.00106,1,1492833,1497943,+,5110
178,BUMA.1121.00001,1,2299289,2304399,-,5110
178,BUMA.1121.00107,1,1629213,1634323,+,5110
178,BUMA.1121.00104,1,3494797,3499907,-,5110
178,BUMA.1121.00099,1,604351,609449,-,5098
178,BUMA.1121.00098,1,317638,322748,+,5110
178,BUMA.1121.00111,1,1928476,1933585,+,5109
178,BUMA.1121.00109,1,188920,194024,-,5104
178,BUMA.1121.00097,1,2203847,2208957,-,5110
178,BUMA.1121.00094,1,1757388,1762491,+,5103
178,BUMA.1121.00095,1,3949433,3954543,-,5110
178,BUMA.1121.00005,1,442366,447469,+,5103
178,BUMA.1121.00101,1,750979,756095,-,5116
178,BUMA.1121.00065,1,1828276,1833386,+,5110
178,BUMA.1121.00100,1,3595791,3600901,-,5110
178,BUMA.1121.00105,1,3493787,3498891,-,5104
178,BUMA.1121.00029,1,3182275,3187385,-,5110
178,BUMA.1121.00066,1,2098700,2103810,-,5110
178,BUMA.1121.00031,1,3181880,3186990,+,5110
178,BUMA.1121.00108,1,2702850,2707960,+,5110
178,BUMA.1121.00023,1,92622,97732,+,5110
178,BUMA.1121.00035,1,2901405,2906515,+,5110
178,BUMA.1121.00041,1,3042709,3047819,+,5110
177,BUMA.1121.00057,1,2794537,2809102,+,14565
177,BUMA.1121.00058,1,2831559,2846087,-,14528
177,BUMA.1121.00045,1,2326156,2340722,-,14566
177,BUMA.1121.00051,1,1722026,1736591,+,14565
177,BUMA.1121.00068,1,475584,490150,+,14566
177,BUMA.1121.00061,1,2130862,2145408,-,14546
177,BUMA.1121.00060,1,551907,566473,-,14566
177,BUMA.1121.00064,1,1736320,1750897,+,14577
177,BUMA.1121.00016,1,3915677,3930223,+,14546
177,BUMA.1121.00003,1,281776,296349,+,14573
177,BUMA.1121.00055,1,1298137,1312703,+,14566
177,BUMA.1121.00011,1,3934829,3949395,-,14566
177,BUMA.1121.00037,1,372760,387313,+,14553
177,BUMA.1121.00009,1,3842449,3857015,-,14566
177,BUMA.1121.00069,1,2102887,2117434,-,14547
177,BUMA.1121.00088,1,2618042,2632608,+,14566
177,BUMA.1121.00092,1,2090321,2104887,-,14566
177,BUMA.1121.00074,1,2109188,2123766,-,14578
177,BUMA.1121.00070,1,2101883,2116437,-,14554
177,BUMA.1121.00093,1,2521432,2535997,+,14565
177,BUMA.1121.00063,1,2127881,2142429,-,14548
177,BUMA.1121.00033,1,4021486,4036037,+,14551
177,BUMA.1121.00018,1,2360117,2374685,+,14568
177,BUMA.1121.00080,1,1740713,1755277,+,14564
177,BUMA.1121.00027,1,3904564,3919128,+,14564
177,BUMA.1121.00053,1,1436448,1450972,+,14524
177,BUMA.1121.00059,1,921933,936508,+,14575
177,BUMA.1121.00043,1,1824203,1838756,+,14553
177,BUMA.1121.00056,1,2200854,2215421,-,14567
177,BUMA.1121.00112,1,1279329,1293896,-,14567
177,BUMA.1121.00091,1,2816780,2831307,-,14527
177,BUMA.1121.00047,1,1223129,1237696,-,14567
177,BUMA.1121.00067,1,2665414,2679991,-,14577
177,BUMA.1121.00110,1,3070151,3084731,-,14580
177,BUMA.1121.00073,1,2128928,2143482,-,14554
177,BUMA.1121.00072,1,2103330,2117895,-,14565
177,BUMA.1121.00077,1,398094,412673,+,14579
177,BUMA.1121.00082,1,2284503,2299069,-,14566
177,BUMA.1121.00062,1,2835175,2849744,-,14569
177,BUMA.1121.00007,1,2336665,2351230,-,14565
177,BUMA.1121.00025,1,885072,899641,-,14569
177,BUMA.1121.00021,1,2367004,2381558,+,14554
177,BUMA.1121.00103,1,2685080,2699635,-,14555
177,BUMA.1121.00096,1,1545080,1559646,-,14566
177,BUMA.1121.00079,1,1735880,1750446,+,14566
177,BUMA.1121.00039,1,1854904,1869457,+,14553
177,BUMA.1121.00083,1,3940077,3954643,-,14566
177,BUMA.1121.00084,1,2075739,2090307,+,14568
177,BUMA.1121.00049,1,118964,133531,-,14567
177,BUMA.1121.00089,1,1710603,1725169,+,14566
177,BUMA.1121.00014,1,1036029,1050583,-,14554
177,BUMA.1121.00090,1,3908989,3923542,+,14553
177,BUMA.1121.00071,1,2120492,2135038,-,14546
177,BUMA.1121.00078,1,217429,231954,-,14525
177,BUMA.1121.00102,1,3686905,3701430,-,14525
177,BUMA.1121.00075,1,1207473,1223363,+,15890
177,BUMA.1121.00012,1,439772,454325,+,14553
177,BUMA.1121.00076,1,3589556,3605447,-,15891
177,BUMA.1121.00106,1,1477402,1491968,+,14566
177,BUMA.1121.00001,1,2305263,2319817,-,14554
177,BUMA.1121.00107,1,1613782,1628347,+,14565
177,BUMA.1121.00104,1,3500772,3515341,-,14569
177,BUMA.1121.00099,1,610310,624876,-,14566
177,BUMA.1121.00098,1,302243,316773,+,14530
177,BUMA.1121.00111,1,1913066,1927611,+,14545
177,BUMA.1121.00109,1,194889,209467,-,14578
177,BUMA.1121.00097,1,2209821,2224387,-,14566
177,BUMA.1121.00094,1,1741957,1756523,+,14566
177,BUMA.1121.00095,1,3955407,3969980,-,14573
177,BUMA.1121.00005,1,426976,441501,+,14525
177,BUMA.1121.00101,1,756960,771528,-,14568
177,BUMA.1121.00065,1,1812846,1827411,+,14565
177,BUMA.1121.00100,1,3601765,3616301,-,14536
177,BUMA.1121.00105,1,3501353,3515920,-,14567
177,BUMA.1121.00029,1,3188249,3202802,-,14553
177,BUMA.1121.00066,1,2104675,2119221,-,14546
177,BUMA.1121.00031,1,3166462,3181015,+,14553
177,BUMA.1121.00108,1,2687411,2701985,+,14574
177,BUMA.1121.00023,1,77204,91757,+,14553
177,BUMA.1121.00035,1,2885987,2900540,+,14553
177,BUMA.1121.00041,1,3027319,3041843,+,14524
176,BUMA.1121.00057,1,2789173,2792791,+,3618
176,BUMA.1121.00058,1,2846521,2850134,-,3613
176,BUMA.1121.00045,1,2341155,2344755,-,3600
176,BUMA.1121.00051,1,1717993,1721593,+,3600
176,BUMA.1121.00068,1,471549,475150,+,3601
176,BUMA.1121.00061,1,2147044,2150658,-,3614
176,BUMA.1121.00060,1,566906,570506,-,3600
176,BUMA.1121.00064,1,1732285,1735887,+,3602
176,BUMA.1121.00016,1,3911642,3915243,+,3601
176,BUMA.1121.00003,1,276124,279751,+,3627
176,BUMA.1121.00055,1,1294089,1297702,+,3613
176,BUMA.1121.00011,1,3949830,3953444,-,3614
176,BUMA.1121.00037,1,368733,372326,+,3593
176,BUMA.1121.00009,1,3857450,3861052,-,3602
176,BUMA.1121.00069,1,2119167,2122785,-,3618
176,BUMA.1121.00088,1,2613995,2617607,+,3612
176,BUMA.1121.00092,1,2105322,2108935,-,3613
176,BUMA.1121.00074,1,2124199,2127799,-,3600
176,BUMA.1121.00070,1,2118183,2121797,-,3614
176,BUMA.1121.00093,1,2517384,2520997,+,3613
176,BUMA.1121.00063,1,2144032,2147649,-,3617
176,BUMA.1121.00033,1,4017461,4021052,+,3591
176,BUMA.1121.00018,1,2354769,2358370,+,3601
176,BUMA.1121.00080,1,1736680,1740280,+,3600
176,BUMA.1121.00027,1,3899182,3902818,+,3636
176,BUMA.1121.00053,1,1432409,1436015,+,3606
176,BUMA.1121.00059,1,917904,921498,+,3594
176,BUMA.1121.00043,1,1817262,1820862,+,3600
176,BUMA.1121.00056,1,2215854,2219454,-,3600
176,BUMA.1121.00112,1,1294331,1297938,-,3607
176,BUMA.1121.00091,1,2831740,2835352,-,3612
176,BUMA.1121.00047,1,1238129,1241729,-,3600
176,BUMA.1121.00067,1,2680424,2684024,-,3600
176,BUMA.1121.00110,1,3085166,3088767,-,3601
176,BUMA.1121.00073,1,2145228,2148843,-,3615
176,BUMA.1121.00072,1,2119642,2123260,-,3618
176,BUMA.1121.00077,1,394059,397660,+,3601
176,BUMA.1121.00082,1,2300815,2304433,-,3618
176,BUMA.1121.00062,1,2851771,2855359,-,3588
176,BUMA.1121.00007,1,2351661,2355275,-,3614
176,BUMA.1121.00025,1,901388,904989,-,3601
176,BUMA.1121.00021,1,2362969,2366570,+,3601
176,BUMA.1121.00103,1,2700065,2703664,-,3599
176,BUMA.1121.00096,1,1560081,1563683,-,3602
176,BUMA.1121.00079,1,1731847,1735447,+,3600
176,BUMA.1121.00039,1,1850869,1854470,+,3601
176,BUMA.1121.00083,1,3956389,3960007,-,3618
176,BUMA.1121.00084,1,2071692,2075304,+,3612
176,BUMA.1121.00049,1,135279,138890,-,3611
176,BUMA.1121.00089,1,1706570,1710170,+,3600
176,BUMA.1121.00014,1,1051017,1054617,-,3600
176,BUMA.1121.00090,1,3903641,3907242,+,3601
176,BUMA.1121.00071,1,2136784,2140402,-,3618
176,BUMA.1121.00078,1,232387,235981,-,3594
176,BUMA.1121.00102,1,3703176,3706782,-,3606
176,BUMA.1121.00075,1,1203432,1207038,+,3606
176,BUMA.1121.00012,1,435743,439338,+,3595
176,BUMA.1121.00076,1,3605882,3609488,-,3606
176,BUMA.1121.00106,1,1471762,1475373,+,3611
176,BUMA.1121.00001,1,2320251,2323851,-,3600
176,BUMA.1121.00107,1,1609746,1613347,+,3601
176,BUMA.1121.00104,1,3515776,3519376,-,3600
176,BUMA.1121.00099,1,625309,628918,-,3609
176,BUMA.1121.00098,1,298210,301810,+,3600
176,BUMA.1121.00111,1,1906112,1909706,+,3594
176,BUMA.1121.00109,1,209901,213495,-,3594
176,BUMA.1121.00097,1,2224821,2228434,-,3613
176,BUMA.1121.00094,1,1737924,1741524,+,3600
176,BUMA.1121.00095,1,3970415,3974006,-,3591
176,BUMA.1121.00005,1,422949,426543,+,3594
176,BUMA.1121.00101,1,773558,777165,-,3607
176,BUMA.1121.00065,1,1808808,1812413,+,3605
176,BUMA.1121.00100,1,3616735,3620333,-,3598
176,BUMA.1121.00105,1,3517949,3521537,-,3588
176,BUMA.1121.00029,1,3203236,3206837,-,3601
176,BUMA.1121.00066,1,2120967,2124585,-,3618
176,BUMA.1121.00031,1,3162427,3166028,+,3601
176,BUMA.1121.00108,1,2683371,2686976,+,3605
176,BUMA.1121.00023,1,73170,76770,+,3600
176,BUMA.1121.00035,1,2881952,2885553,+,3601
176,BUMA.1121.00041,1,3023286,3026886,+,3600
175,BUMA.1121.00057,1,2766235,2787478,+,21243
175,BUMA.1121.00058,1,2851832,2873095,-,21263
175,BUMA.1121.00045,1,2346452,2367656,-,21204
175,BUMA.1121.00051,1,1695062,1716295,+,21233
175,BUMA.1121.00068,1,448577,469855,+,21278
175,BUMA.1121.00061,1,2152366,2173568,-,21202
175,BUMA.1121.00060,1,572205,593409,-,21204
175,BUMA.1121.00064,1,1709354,1730591,+,21237
175,BUMA.1121.00016,1,3887371,3909948,+,22577
175,BUMA.1121.00003,1,252197,274423,+,22226
175,BUMA.1121.00055,1,1271169,1292395,+,21226
175,BUMA.1121.00011,1,3955137,3976383,-,21246
175,BUMA.1121.00037,1,336083,357378,+,21295
175,BUMA.1121.00009,1,3862746,3884912,-,22166
175,BUMA.1121.00069,1,2124480,2145703,-,21223
175,BUMA.1121.00088,1,2591033,2612297,+,21264
175,BUMA.1121.00092,1,2110629,2131892,-,21263
175,BUMA.1121.00074,1,2129493,2150729,-,21236
175,BUMA.1121.00070,1,2123492,2144717,-,21225
175,BUMA.1121.00093,1,2494426,2515690,+,21264
175,BUMA.1121.00063,1,2149344,2170498,-,21154
175,BUMA.1121.00033,1,3987981,4009202,+,21221
175,BUMA.1121.00018,1,2331825,2353075,+,21250
175,BUMA.1121.00080,1,1713714,1734982,+,21268
175,BUMA.1121.00027,1,3876254,3897484,+,21230
175,BUMA.1121.00053,1,1409454,1430711,+,21257
175,BUMA.1121.00059,1,894911,916210,+,21299
175,BUMA.1121.00043,1,1794317,1815568,+,21251
175,BUMA.1121.00056,1,2221152,2242377,-,21225
175,BUMA.1121.00112,1,1299632,1320899,-,21267
175,BUMA.1121.00091,1,2837047,2858352,-,21305
175,BUMA.1121.00047,1,1243427,1264687,-,21260
175,BUMA.1121.00067,1,2685718,2706961,-,21243
175,BUMA.1121.00110,1,3090461,3111758,-,21297
175,BUMA.1121.00073,1,2150538,2171740,-,21202
175,BUMA.1121.00072,1,2124955,2146099,-,21144
175,BUMA.1121.00077,1,371066,392365,+,21299
175,BUMA.1121.00082,1,2306128,2327353,-,21225
175,BUMA.1121.00062,1,2857053,2878323,-,21270
175,BUMA.1121.00007,1,2356969,2378196,-,21227
175,BUMA.1121.00025,1,906683,927932,-,21249
175,BUMA.1121.00021,1,2340032,2361275,+,21243
175,BUMA.1121.00103,1,2705370,2726640,-,21270
175,BUMA.1121.00096,1,1565377,1589295,-,23918
175,BUMA.1121.00079,1,1708909,1730149,+,21240
175,BUMA.1121.00039,1,1827878,1849175,+,21297
175,BUMA.1121.00083,1,3961702,3982928,-,21226
175,BUMA.1121.00084,1,2048743,2069994,+,21251
175,BUMA.1121.00049,1,140584,161870,-,21286
175,BUMA.1121.00089,1,1683646,1704872,+,21226
175,BUMA.1121.00014,1,1056311,1077581,-,21270
175,BUMA.1121.00090,1,3880704,3901947,+,21243
175,BUMA.1121.00071,1,2142097,2163268,-,21171
175,BUMA.1121.00078,1,237676,258930,-,21254
175,BUMA.1121.00102,1,3708480,3729752,-,21272
175,BUMA.1121.00075,1,1180423,1201738,+,21315
175,BUMA.1121.00012,1,411438,432714,+,21276
175,BUMA.1121.00076,1,3611182,3632496,-,21314
175,BUMA.1121.00106,1,1447482,1468711,+,21229
175,BUMA.1121.00001,1,2326838,2348101,-,21263
175,BUMA.1121.00107,1,1586759,1608052,+,21293
175,BUMA.1121.00104,1,3521073,3542310,-,21237
175,BUMA.1121.00099,1,630612,651876,-,21264
175,BUMA.1121.00098,1,275230,296516,+,21286
175,BUMA.1121.00111,1,1880017,1901277,+,21260
175,BUMA.1121.00109,1,215189,236475,-,21286
175,BUMA.1121.00097,1,2230128,2251460,-,21332
175,BUMA.1121.00094,1,1714976,1736226,+,21250
175,BUMA.1121.00095,1,3975700,3997043,-,21343
175,BUMA.1121.00005,1,400033,421255,+,21222
175,BUMA.1121.00101,1,778859,800104,-,21245
175,BUMA.1121.00065,1,1785853,1807110,+,21257
175,BUMA.1121.00100,1,3622027,3643229,-,21202
175,BUMA.1121.00105,1,3523231,3544487,-,21256
175,BUMA.1121.00029,1,3209824,3231066,-,21242
175,BUMA.1121.00066,1,2126280,2147505,-,21225
175,BUMA.1121.00031,1,3139455,3160733,+,21278
175,BUMA.1121.00108,1,2660412,2681677,+,21265
175,BUMA.1121.00023,1,50129,71476,+,21347
175,BUMA.1121.00035,1,2857673,2878965,+,21292
175,BUMA.1121.00041,1,2999014,3020240,+,21226
174,BUMA.1121.00057,1,2757785,2765718,+,7933
174,BUMA.1121.00058,1,2873613,2881524,-,7911
174,BUMA.1121.00045,1,2368174,2376083,-,7909
174,BUMA.1121.00051,1,1686613,1694545,+,7932
174,BUMA.1121.00068,1,440152,448060,+,7908
174,BUMA.1121.00061,1,2174086,2182017,-,7931
174,BUMA.1121.00060,1,593927,601836,-,7909
174,BUMA.1121.00064,1,1700926,1708837,+,7911
174,BUMA.1121.00016,1,3878943,3886854,+,7911
174,BUMA.1121.00003,1,243768,251680,+,7912
174,BUMA.1121.00055,1,1262720,1270652,+,7932
174,BUMA.1121.00011,1,3976901,3984814,-,7913
174,BUMA.1121.00037,1,327653,335566,+,7913
174,BUMA.1121.00009,1,3885430,3893341,-,7911
174,BUMA.1121.00069,1,2146221,2154153,-,7932
174,BUMA.1121.00088,1,2582584,2590516,+,7932
174,BUMA.1121.00092,1,2132410,2140341,-,7931
174,BUMA.1121.00074,1,2151247,2159158,-,7911
174,BUMA.1121.00070,1,2145235,2153167,-,7932
174,BUMA.1121.00093,1,2485978,2493909,+,7931
174,BUMA.1121.00063,1,2171016,2178947,-,7931
174,BUMA.1121.00033,1,3979555,3987464,+,7909
174,BUMA.1121.00018,1,2323396,2331308,+,7912
174,BUMA.1121.00080,1,1705265,1713197,+,7932
174,BUMA.1121.00027,1,3867826,3875737,+,7911
174,BUMA.1121.00053,1,1401004,1408937,+,7933
174,BUMA.1121.00059,1,886481,894394,+,7913
174,BUMA.1121.00043,1,1785889,1793800,+,7911
174,BUMA.1121.00056,1,2242895,2250827,-,7932
174,BUMA.1121.00112,1,1321417,1329327,-,7910
174,BUMA.1121.00091,1,2858870,2866803,-,7933
174,BUMA.1121.00047,1,1265205,1273137,-,7932
174,BUMA.1121.00067,1,2707479,2715411,-,7932
174,BUMA.1121.00110,1,3112276,3120187,-,7911
174,BUMA.1121.00073,1,2172258,2180190,-,7932
174,BUMA.1121.00072,1,2146617,2154549,-,7932
174,BUMA.1121.00077,1,362639,370549,+,7910
174,BUMA.1121.00082,1,2327871,2335803,-,7932
174,BUMA.1121.00062,1,2878841,2886774,-,7933
174,BUMA.1121.00007,1,2378714,2386626,-,7912
174,BUMA.1121.00025,1,928450,936362,-,7912
174,BUMA.1121.00021,1,2331602,2339515,+,7913
174,BUMA.1121.00103,1,2727158,2735069,-,7911
174,BUMA.1121.00096,1,1589813,1597713,-,7900
174,BUMA.1121.00079,1,1700460,1708392,+,7932
174,BUMA.1121.00039,1,1818137,1827361,+,9224
174,BUMA.1121.00083,1,3983446,3991378,-,7932
174,BUMA.1121.00084,1,2040762,2048226,+,7464
174,BUMA.1121.00049,1,162388,170320,-,7932
174,BUMA.1121.00089,1,1675197,1683129,+,7932
174,BUMA.1121.00014,1,1078099,1086010,-,7911
174,BUMA.1121.00090,1,3872274,3880187,+,7913
174,BUMA.1121.00071,1,2163786,2171718,-,7932
174,BUMA.1121.00078,1,259448,267358,-,7910
174,BUMA.1121.00102,1,3730270,3738202,-,7932
174,BUMA.1121.00075,1,1171974,1179906,+,7932
174,BUMA.1121.00012,1,401697,410921,+,9224
174,BUMA.1121.00076,1,3633014,3640946,-,7932
174,BUMA.1121.00106,1,1439033,1446965,+,7932
174,BUMA.1121.00001,1,2348619,2356531,-,7912
174,BUMA.1121.00107,1,1578340,1586242,+,7902
174,BUMA.1121.00104,1,3542828,3550760,-,7932
174,BUMA.1121.00099,1,652394,660306,-,7912
174,BUMA.1121.00098,1,266806,274713,+,7907
174,BUMA.1121.00111,1,1871591,1879500,+,7909
174,BUMA.1121.00109,1,236993,244905,-,7912
174,BUMA.1121.00097,1,2251978,2259889,-,7911
174,BUMA.1121.00094,1,1706528,1714459,+,7931
174,BUMA.1121.00095,1,456,8369,-,7913
174,BUMA.1121.00005,1,391605,399516,+,7911
174,BUMA.1121.00101,1,800622,808532,-,7910
174,BUMA.1121.00065,1,1777424,1785336,+,7912
174,BUMA.1121.00100,1,3643747,3651660,-,7913
174,BUMA.1121.00105,1,3545005,3552937,-,7932
174,BUMA.1121.00029,1,3231584,3239497,-,7913
174,BUMA.1121.00066,1,2148023,2155955,-,7932
174,BUMA.1121.00031,1,3131028,3138938,+,7910
174,BUMA.1121.00108,1,2651985,2659895,+,7910
174,BUMA.1121.00023,1,41702,49612,+,7910
174,BUMA.1121.00035,1,2849243,2857156,+,7913
174,BUMA.1121.00041,1,2990565,2998497,+,7932
173,BUMA.1121.00057,1,2751685,2757714,+,6029
173,BUMA.1121.00058,1,2881595,2887605,-,6010
173,BUMA.1121.00045,1,2376154,2382192,-,6038
173,BUMA.1121.00051,1,1679033,1685080,+,6047
173,BUMA.1121.00068,1,432611,438611,+,6000
173,BUMA.1121.00061,1,2182088,2188113,-,6025
173,BUMA.1121.00060,1,601907,607945,-,6038
173,BUMA.1121.00064,1,1693238,1699258,+,6020
173,BUMA.1121.00016,1,3872881,3878883,+,6002
173,BUMA.1121.00003,1,237623,243632,+,6009
173,BUMA.1121.00055,1,1255134,1261179,+,6045
173,BUMA.1121.00011,1,3984919,3990920,-,6001
173,BUMA.1121.00037,1,321591,327593,+,6002
173,BUMA.1121.00009,1,3893412,3899422,-,6010
173,BUMA.1121.00069,1,2154224,2160248,-,6024
173,BUMA.1121.00088,1,2576457,2582513,+,6056
173,BUMA.1121.00092,1,2140446,2146519,-,6073
173,BUMA.1121.00074,1,2160826,2166845,-,6019
173,BUMA.1121.00070,1,2153238,2159262,-,6024
173,BUMA.1121.00093,1,2479799,2485873,+,6074
173,BUMA.1121.00063,1,2179018,2185064,-,6046
173,BUMA.1121.00033,1,3971897,3977899,+,6002
173,BUMA.1121.00018,1,2315724,2321741,+,6017
173,BUMA.1121.00080,1,1697694,1703732,+,6038
173,BUMA.1121.00027,1,3861708,3867755,+,6047
173,BUMA.1121.00053,1,1394942,1400944,+,6002
173,BUMA.1121.00059,1,878757,884813,+,6056
173,BUMA.1121.00043,1,1779827,1785829,+,6002
173,BUMA.1121.00056,1,2252360,2258442,-,6082
173,BUMA.1121.00112,1,1331001,1337028,-,6027
173,BUMA.1121.00091,1,2866874,2872939,-,6065
173,BUMA.1121.00047,1,1274670,1280770,-,6100
173,BUMA.1121.00067,1,2716944,2722999,-,6055
173,BUMA.1121.00110,1,3121727,3127738,-,6011
173,BUMA.1121.00073,1,2180261,2186287,-,6026
173,BUMA.1121.00072,1,2154620,2160666,-,6046
173,BUMA.1121.00077,1,355086,361097,+,6011
173,BUMA.1121.00082,1,2335874,2341920,-,6046
173,BUMA.1121.00062,1,2888306,2894352,-,6046
173,BUMA.1121.00007,1,2386686,2392741,-,6055
173,BUMA.1121.00025,1,938017,944034,-,6017
173,BUMA.1121.00021,1,2325540,2331542,+,6002
173,BUMA.1121.00103,1,2735129,2741122,-,5993
173,BUMA.1121.00096,1,1597818,1603828,-,6010
173,BUMA.1121.00079,1,1692880,1698927,+,6047
173,BUMA.1121.00039,1,1812075,1818077,+,6002
173,BUMA.1121.00083,1,3991449,3997495,-,6046
173,BUMA.1121.00084,1,2034680,2040691,+,6011
173,BUMA.1121.00049,1,174305,180351,-,6046
173,BUMA.1121.00089,1,1667581,1673664,+,6083
173,BUMA.1121.00014,1,1086070,1092080,-,6010
173,BUMA.1121.00090,1,3866212,3872214,+,6002
173,BUMA.1121.00071,1,2171789,2177814,-,6025
173,BUMA.1121.00078,1,267429,273430,-,6001
173,BUMA.1121.00102,1,3738273,3744328,-,6055
173,BUMA.1121.00075,1,1164412,1170442,+,6030
173,BUMA.1121.00012,1,395635,401637,+,6002
173,BUMA.1121.00076,1,3642478,3648507,-,6029
173,BUMA.1121.00106,1,1431273,1437365,+,6092
173,BUMA.1121.00001,1,2356591,2362592,-,6001
173,BUMA.1121.00107,1,1572277,1578250,+,5973
173,BUMA.1121.00104,1,3552428,3558501,-,6073
173,BUMA.1121.00099,1,660377,666440,-,6063
173,BUMA.1121.00098,1,260626,266681,+,6055
173,BUMA.1121.00111,1,1865529,1871531,+,6002
173,BUMA.1121.00109,1,246445,252498,-,6053
173,BUMA.1121.00097,1,2261429,2267448,-,6019
173,BUMA.1121.00094,1,1698966,1704995,+,6029
173,BUMA.1121.00095,1,8429,14457,-,6028
173,BUMA.1121.00005,1,385515,391545,+,6030
173,BUMA.1121.00101,1,808592,814620,-,6028
173,BUMA.1121.00065,1,1769827,1775892,+,6065
173,BUMA.1121.00100,1,3653192,3659207,-,6015
173,BUMA.1121.00105,1,3553008,3559081,-,6073
173,BUMA.1121.00029,1,3239557,3245558,-,6001
173,BUMA.1121.00066,1,2156026,2162051,-,6025
173,BUMA.1121.00031,1,3124930,3130968,+,6038
173,BUMA.1121.00108,1,2644283,2650310,+,6027
173,BUMA.1121.00023,1,35640,41642,+,6002
173,BUMA.1121.00035,1,2843181,2849183,+,6002
173,BUMA.1121.00041,1,2982895,2988899,+,6004
172,BUMA.1121.00057,1,2715813,2751684,+,35871
172,BUMA.1121.00058,1,2887607,2923202,-,35595
172,BUMA.1121.00045,1,2382194,2417829,-,35635
172,BUMA.1121.00051,1,1643351,1679032,+,35681
172,BUMA.1121.00068,1,396937,432610,+,35673
172,BUMA.1121.00061,1,2188115,2223952,-,35837
172,BUMA.1121.00060,1,607947,643582,-,35635
172,BUMA.1121.00064,1,1657552,1693237,+,35685
172,BUMA.1121.00016,1,3837140,3872880,+,35740
172,BUMA.1121.00003,1,201930,237622,+,35692
172,BUMA.1121.00055,1,1219405,1255133,+,35728
172,BUMA.1121.00011,1,3990922,4026500,-,35578
172,BUMA.1121.00037,1,285957,321590,+,35633
172,BUMA.1121.00009,1,3899424,3935117,-,35693
172,BUMA.1121.00069,1,2160250,2195955,-,35705
172,BUMA.1121.00088,1,2540700,2576456,+,35756
172,BUMA.1121.00092,1,2146521,2182205,-,35684
172,BUMA.1121.00074,1,2166847,2202576,-,35729
172,BUMA.1121.00070,1,2159264,2194952,-,35688
172,BUMA.1121.00093,1,2444114,2479798,+,35684
172,BUMA.1121.00063,1,2185066,2220898,-,35832
172,BUMA.1121.00033,1,3936249,3971896,+,35647
172,BUMA.1121.00018,1,2232438,2268034,+,35596
172,BUMA.1121.00080,1,1662048,1697693,+,35645
172,BUMA.1121.00027,1,3825864,3861707,+,35843
172,BUMA.1121.00053,1,1359130,1394941,+,35811
172,BUMA.1121.00059,1,842934,878756,+,35822
172,BUMA.1121.00043,1,1744190,1779826,+,35636
172,BUMA.1121.00056,1,2258444,2294060,-,35616
172,BUMA.1121.00112,1,1337030,1372622,-,35592
172,BUMA.1121.00091,1,2872941,2908760,-,35819
172,BUMA.1121.00047,1,1280772,1316365,-,35593
172,BUMA.1121.00067,1,2723001,2758678,-,35677
172,BUMA.1121.00110,1,3127740,3163352,-,35612
172,BUMA.1121.00073,1,2186289,2221977,-,35688
172,BUMA.1121.00072,1,2160668,2196405,-,35737
172,BUMA.1121.00077,1,319475,355085,+,35610
172,BUMA.1121.00082,1,2341922,2377759,-,35837
172,BUMA.1121.00062,1,2894354,2930028,-,35674
172,BUMA.1121.00007,1,2392743,2428303,-,35560
172,BUMA.1121.00025,1,991726,1027340,-,35614
172,BUMA.1121.00021,1,2289748,2325539,+,35791
172,BUMA.1121.00103,1,2741124,2776873,-,35749
172,BUMA.1121.00096,1,1603830,1639462,-,35632
172,BUMA.1121.00079,1,1657263,1692879,+,35616
172,BUMA.1121.00039,1,1776373,1812074,+,35701
172,BUMA.1121.00083,1,3997497,4033334,-,35837
172,BUMA.1121.00084,1,1999008,2034679,+,35671
172,BUMA.1121.00049,1,180353,216066,-,35713
172,BUMA.1121.00089,1,1631964,1667580,+,35616
172,BUMA.1121.00014,1,1092082,1127755,-,35673
172,BUMA.1121.00090,1,3830503,3866211,+,35708
172,BUMA.1121.00071,1,2177816,2213536,-,35720
172,BUMA.1121.00078,1,273432,309150,-,35718
172,BUMA.1121.00102,1,3744330,3780293,-,35963
172,BUMA.1121.00075,1,1128715,1164411,+,35696
172,BUMA.1121.00012,1,359998,395634,+,35636
172,BUMA.1121.00076,1,3648509,3684201,-,35692
172,BUMA.1121.00106,1,1395568,1431272,+,35704
172,BUMA.1121.00001,1,2362594,2398177,-,35583
172,BUMA.1121.00107,1,1536674,1572276,+,35602
172,BUMA.1121.00104,1,3558503,3594183,-,35680
172,BUMA.1121.00099,1,666442,702077,-,35635
172,BUMA.1121.00098,1,225037,260625,+,35588
172,BUMA.1121.00111,1,1829866,1865528,+,35662
172,BUMA.1121.00109,1,252500,288249,-,35749
172,BUMA.1121.00097,1,2267450,2303139,-,35689
172,BUMA.1121.00094,1,1663308,1698965,+,35657
172,BUMA.1121.00095,1,14459,50071,-,35612
172,BUMA.1121.00005,1,349741,385514,+,35773
172,BUMA.1121.00101,1,814622,850248,-,35626
172,BUMA.1121.00065,1,1733944,1769826,+,35882
172,BUMA.1121.00100,1,3659209,3694867,-,35658
172,BUMA.1121.00105,1,3559083,3594704,-,35621
172,BUMA.1121.00029,1,3245560,3281139,-,35579
172,BUMA.1121.00066,1,2162053,2197889,-,35836
172,BUMA.1121.00031,1,3089249,3124929,+,35680
172,BUMA.1121.00108,1,2608618,2644282,+,35664
172,BUMA.1121.00023,1,1,35639,+,35638
172,BUMA.1121.00035,1,2807602,2843180,+,35578
172,BUMA.1121.00041,1,2947087,2982894,+,35807
171,BUMA.1121.00057,1,2693570,2715510,+,21940
171,BUMA.1121.00058,1,2923504,2945445,-,21941
171,BUMA.1121.00045,1,2418131,2440105,-,21974
171,BUMA.1121.00051,1,1621040,1643048,+,22008
171,BUMA.1121.00068,1,374391,396634,+,22243
171,BUMA.1121.00061,1,2224254,2246171,-,21917
171,BUMA.1121.00060,1,643884,665849,-,21965
171,BUMA.1121.00064,1,1635345,1657249,+,21904
171,BUMA.1121.00016,1,3814939,3836837,+,21898
171,BUMA.1121.00003,1,179787,201627,+,21840
171,BUMA.1121.00055,1,1197205,1219102,+,21897
171,BUMA.1121.00011,1,4026802,4048723,-,21921
171,BUMA.1121.00037,1,263822,285654,+,21832
171,BUMA.1121.00009,1,3935419,3957369,-,21950
171,BUMA.1121.00069,1,2196257,2218070,-,21813
171,BUMA.1121.00088,1,2518515,2540397,+,21882
171,BUMA.1121.00092,1,2182507,2204766,-,22259
171,BUMA.1121.00074,1,2202878,2224808,-,21930
171,BUMA.1121.00070,1,2195254,2217104,-,21850
171,BUMA.1121.00093,1,2421553,2443811,+,22258
171,BUMA.1121.00063,1,2221200,2243094,-,21894
171,BUMA.1121.00033,1,3914147,3935946,+,21799
171,BUMA.1121.00018,1,2210119,2232135,+,22016
171,BUMA.1121.00080,1,1639827,1661745,+,21918
171,BUMA.1121.00027,1,3803682,3825561,+,21879
171,BUMA.1121.00053,1,1336955,1358827,+,21872
171,BUMA.1121.00059,1,820666,842631,+,21965
171,BUMA.1121.00043,1,1721827,1743887,+,22060
171,BUMA.1121.00056,1,2294362,2316166,-,21804
171,BUMA.1121.00112,1,1372924,1394775,-,21851
171,BUMA.1121.00091,1,2909062,2931029,-,21967
171,BUMA.1121.00047,1,1316667,1338762,-,22095
171,BUMA.1121.00067,1,2758980,2781081,-,22101
171,BUMA.1121.00110,1,3163654,3185568,-,21914
171,BUMA.1121.00073,1,2222279,2244197,-,21918
171,BUMA.1121.00072,1,2196707,2218631,-,21924
171,BUMA.1121.00077,1,297250,319172,+,21922
171,BUMA.1121.00082,1,2378061,2399986,-,21925
171,BUMA.1121.00062,1,2930330,2952222,-,21892
171,BUMA.1121.00007,1,2428605,2450485,-,21880
171,BUMA.1121.00025,1,1027642,1049669,-,22027
171,BUMA.1121.00021,1,2267561,2289445,+,21884
171,BUMA.1121.00103,1,2777175,2799181,-,22006
171,BUMA.1121.00096,1,1639764,1661625,-,21861
171,BUMA.1121.00079,1,1635093,1656960,+,21867
171,BUMA.1121.00039,1,1754184,1776070,+,21886
171,BUMA.1121.00083,1,4033636,4055561,-,21925
171,BUMA.1121.00084,1,1976885,1998705,+,21820
171,BUMA.1121.00049,1,216368,238268,-,21900
171,BUMA.1121.00089,1,1609858,1631661,+,21803
171,BUMA.1121.00014,1,1128057,1150017,-,21960
171,BUMA.1121.00090,1,3808299,3830200,+,21901
171,BUMA.1121.00071,1,2213838,2235733,-,21895
171,BUMA.1121.00078,1,309452,331409,-,21957
171,BUMA.1121.00102,1,3780595,3802713,-,22118
171,BUMA.1121.00075,1,1106632,1128412,+,21780
171,BUMA.1121.00012,1,337655,359695,+,22040
171,BUMA.1121.00076,1,3684503,3706361,-,21858
171,BUMA.1121.00106,1,1373391,1395265,+,21874
171,BUMA.1121.00001,1,2398479,2420353,-,21874
171,BUMA.1121.00107,1,1514452,1536371,+,21919
171,BUMA.1121.00104,1,3594485,3616351,-,21866
171,BUMA.1121.00099,1,702379,724232,-,21853
171,BUMA.1121.00098,1,202923,224734,+,21811
171,BUMA.1121.00111,1,1807665,1829563,+,21898
171,BUMA.1121.00109,1,288551,310579,-,22028
171,BUMA.1121.00097,1,2303441,2325314,-,21873
171,BUMA.1121.00094,1,1641202,1663005,+,21803
171,BUMA.1121.00095,1,50373,72207,-,21834
171,BUMA.1121.00005,1,327504,349438,+,21934
171,BUMA.1121.00101,1,850550,872407,-,21857
171,BUMA.1121.00065,1,1711802,1733641,+,21839
171,BUMA.1121.00100,1,3695169,3717029,-,21860
171,BUMA.1121.00105,1,3595006,3616833,-,21827
171,BUMA.1121.00029,1,3281441,3303351,-,21910
171,BUMA.1121.00066,1,2198191,2220057,-,21866
171,BUMA.1121.00031,1,3067081,3088946,+,21865
171,BUMA.1121.00108,1,2585912,2608315,+,22403
171,BUMA.1121.00023,1,4076807,4098857,+,22050
171,BUMA.1121.00035,1,2785462,2807299,+,21837
171,BUMA.1121.00041,1,2924934,2946784,+,21850
170,BUMA.1121.00057,1,2683174,2690924,+,7750
170,BUMA.1121.00058,1,2948059,2955808,-,7749
170,BUMA.1121.00045,1,2442708,2450493,-,7785
170,BUMA.1121.00051,1,1610693,1618437,+,7744
170,BUMA.1121.00068,1,364080,371831,+,7751
170,BUMA.1121.00061,1,2248774,2256504,-,7730
170,BUMA.1121.00060,1,668452,676237,-,7785
170,BUMA.1121.00064,1,1624982,1632706,+,7724
170,BUMA.1121.00016,1,3804601,3812311,+,7710
170,BUMA.1121.00003,1,169433,177184,+,7751
170,BUMA.1121.00055,1,1186823,1194556,+,7733
170,BUMA.1121.00011,1,4051326,4059074,-,7748
170,BUMA.1121.00037,1,253474,261194,+,7720
170,BUMA.1121.00009,1,3959983,3967734,-,7751
170,BUMA.1121.00069,1,2220673,2228418,-,7745
170,BUMA.1121.00088,1,2508172,2515887,+,7715
170,BUMA.1121.00092,1,2207391,2215149,-,7758
170,BUMA.1121.00074,1,2227422,2235206,-,7784
170,BUMA.1121.00070,1,2219707,2227450,-,7743
170,BUMA.1121.00093,1,2411170,2418903,+,7733
170,BUMA.1121.00063,1,2245697,2253427,-,7730
170,BUMA.1121.00033,1,3903800,3911519,+,7719
170,BUMA.1121.00018,1,2199771,2207491,+,7720
170,BUMA.1121.00080,1,1629441,1637167,+,7726
170,BUMA.1121.00027,1,3793331,3801054,+,7723
170,BUMA.1121.00053,1,1326589,1334327,+,7738
170,BUMA.1121.00059,1,810237,817961,+,7724
170,BUMA.1121.00043,1,1711462,1719199,+,7737
170,BUMA.1121.00056,1,2318769,2326513,-,7744
170,BUMA.1121.00112,1,1397378,1405140,-,7762
170,BUMA.1121.00091,1,2933643,2941358,-,7715
170,BUMA.1121.00047,1,1341365,1349109,-,7744
170,BUMA.1121.00067,1,2783695,2791485,-,7790
170,BUMA.1121.00110,1,3189766,3197537,-,7771
170,BUMA.1121.00073,1,2246800,2254549,-,7749
170,BUMA.1121.00072,1,2221234,2228983,-,7749
170,BUMA.1121.00077,1,285283,293054,+,7771
170,BUMA.1121.00082,1,2402589,2410338,-,7749
170,BUMA.1121.00062,1,2954836,2962628,-,7792
170,BUMA.1121.00007,1,2453088,2460895,-,7807
170,BUMA.1121.00025,1,1052272,1060017,-,7745
170,BUMA.1121.00021,1,2257231,2264958,+,7727
170,BUMA.1121.00103,1,2801774,2809523,-,7749
170,BUMA.1121.00096,1,1664235,1671981,-,7746
170,BUMA.1121.00079,1,1624749,1632493,+,7744
170,BUMA.1121.00039,1,1743836,1751556,+,7720
170,BUMA.1121.00083,1,4058164,4065913,-,7749
170,BUMA.1121.00084,1,1966497,1974243,+,7746
170,BUMA.1121.00049,1,240871,248625,-,7754
170,BUMA.1121.00089,1,1599511,1607255,+,7744
170,BUMA.1121.00014,1,1152620,1160382,-,7762
170,BUMA.1121.00090,1,3797951,3805671,+,7720
170,BUMA.1121.00071,1,2238336,2246068,-,7732
170,BUMA.1121.00078,1,334018,341744,-,7726
170,BUMA.1121.00102,1,3805316,3813186,-,7870
170,BUMA.1121.00075,1,1096302,1103975,+,7673
170,BUMA.1121.00012,1,327304,335027,+,7723
170,BUMA.1121.00076,1,3708975,3716694,-,7719
170,BUMA.1121.00106,1,1363034,1370763,+,7729
170,BUMA.1121.00001,1,2422956,2430705,-,7749
170,BUMA.1121.00107,1,1504123,1511850,+,7727
170,BUMA.1121.00104,1,3618954,3626708,-,7754
170,BUMA.1121.00099,1,726835,734602,-,7767
170,BUMA.1121.00098,1,192585,200321,+,7736
170,BUMA.1121.00111,1,1797317,1805037,+,7720
170,BUMA.1121.00109,1,313193,320196,-,7003
170,BUMA.1121.00097,1,2327924,2335686,-,7762
170,BUMA.1121.00094,1,1630856,1638599,+,7743
170,BUMA.1121.00095,1,76414,84179,-,7765
170,BUMA.1121.00005,1,317165,324876,+,7711
170,BUMA.1121.00101,1,875010,882813,-,7803
170,BUMA.1121.00065,1,1701442,1709167,+,7725
170,BUMA.1121.00100,1,3719631,3727417,-,7786
170,BUMA.1121.00105,1,3619436,3627202,-,7766
170,BUMA.1121.00029,1,3305954,3313702,-,7748
170,BUMA.1121.00066,1,2222660,2230394,-,7734
170,BUMA.1121.00031,1,3056716,3064453,+,7737
170,BUMA.1121.00108,1,2575565,2583309,+,7744
170,BUMA.1121.00023,1,4066434,4074179,+,7745
170,BUMA.1121.00035,1,2775110,2782834,+,7724
170,BUMA.1121.00041,1,2914611,2922331,+,7720
169,BUMA.1121.00057,1,2676450,2681130,+,4680
169,BUMA.1121.00058,1,2957851,2962523,-,4672
169,BUMA.1121.00045,1,2450950,2455640,-,4690
169,BUMA.1121.00051,1,1605562,1610242,+,4680
169,BUMA.1121.00068,1,358944,363624,+,4680
169,BUMA.1121.00061,1,2256955,2261636,-,4681
169,BUMA.1121.00060,1,676693,681383,-,4690
169,BUMA.1121.00064,1,1619850,1624530,+,4680
169,BUMA.1121.00016,1,3799477,3804145,+,4668
169,BUMA.1121.00003,1,164306,168986,+,4680
169,BUMA.1121.00055,1,1181710,1186376,+,4666
169,BUMA.1121.00011,1,4059520,4064205,-,4685
169,BUMA.1121.00037,1,248404,253018,+,4614
169,BUMA.1121.00009,1,3968186,3972867,-,4681
169,BUMA.1121.00069,1,2228873,2233554,-,4681
169,BUMA.1121.00088,1,2503040,2507720,+,4680
169,BUMA.1121.00092,1,2215600,2220281,-,4681
169,BUMA.1121.00074,1,2235657,2240338,-,4681
169,BUMA.1121.00070,1,2227901,2232581,-,4680
169,BUMA.1121.00093,1,2406038,2410718,+,4680
169,BUMA.1121.00063,1,2253878,2258559,-,4681
169,BUMA.1121.00033,1,3898677,3903345,+,4668
169,BUMA.1121.00018,1,2194644,2199315,+,4671
169,BUMA.1121.00080,1,1624309,1628989,+,4680
169,BUMA.1121.00027,1,3788200,3792880,+,4680
169,BUMA.1121.00053,1,1320010,1324685,+,4675
169,BUMA.1121.00059,1,805110,809785,+,4675
169,BUMA.1121.00043,1,1706338,1711006,+,4668
169,BUMA.1121.00056,1,2326964,2331645,-,4681
169,BUMA.1121.00112,1,1405590,1410256,-,4666
169,BUMA.1121.00091,1,2943395,2948058,-,4663
169,BUMA.1121.00047,1,1349560,1354241,-,4681
169,BUMA.1121.00067,1,2791936,2796617,-,4681
169,BUMA.1121.00110,1,3197988,3202668,-,4680
169,BUMA.1121.00073,1,2255000,2259681,-,4681
169,BUMA.1121.00072,1,2229434,2234115,-,4681
169,BUMA.1121.00077,1,280152,284831,+,4679
169,BUMA.1121.00082,1,2410789,2415470,-,4681
169,BUMA.1121.00062,1,2963083,2967755,-,4672
169,BUMA.1121.00007,1,2461346,2466011,-,4665
169,BUMA.1121.00025,1,1060472,1065144,-,4672
169,BUMA.1121.00021,1,2252104,2256775,+,4671
169,BUMA.1121.00103,1,2809969,2814641,-,4672
169,BUMA.1121.00096,1,1672432,1677113,-,4681
169,BUMA.1121.00079,1,1619619,1624299,+,4680
169,BUMA.1121.00039,1,1738712,1743380,+,4668
169,BUMA.1121.00083,1,4066364,4071045,-,4681
169,BUMA.1121.00084,1,1961366,1966041,+,4675
169,BUMA.1121.00049,1,249080,253770,-,4690
169,BUMA.1121.00089,1,1594379,1599059,+,4680
169,BUMA.1121.00014,1,1160837,1165510,-,4673
169,BUMA.1121.00090,1,3792824,3797495,+,4671
169,BUMA.1121.00071,1,2246519,2251200,-,4681
169,BUMA.1121.00078,1,342195,346876,-,4681
169,BUMA.1121.00102,1,3813641,3818313,-,4672
169,BUMA.1121.00075,1,1091166,1095846,+,4680
169,BUMA.1121.00012,1,322185,326853,+,4668
169,BUMA.1121.00076,1,3717151,3721832,-,4681
169,BUMA.1121.00106,1,1357889,1362578,+,4689
169,BUMA.1121.00001,1,2431161,2435833,-,4672
169,BUMA.1121.00107,1,1499001,1503672,+,4671
169,BUMA.1121.00104,1,3627163,3631859,-,4696
169,BUMA.1121.00099,1,735053,739728,-,4675
169,BUMA.1121.00098,1,187569,192134,+,4565
169,BUMA.1121.00111,1,1792193,1796861,+,4668
169,BUMA.1121.00109,1,320647,325328,-,4681
169,BUMA.1121.00097,1,2336137,2340588,-,4451
169,BUMA.1121.00094,1,1625724,1630404,+,4680
169,BUMA.1121.00095,1,84630,89311,-,4681
169,BUMA.1121.00005,1,312043,316714,+,4671
169,BUMA.1121.00101,1,883263,887944,-,4681
169,BUMA.1121.00065,1,1696310,1700990,+,4680
169,BUMA.1121.00100,1,3727868,3732549,-,4681
169,BUMA.1121.00105,1,3627657,3632333,-,4676
169,BUMA.1121.00029,1,3314158,3318826,-,4668
169,BUMA.1121.00066,1,2230845,2235526,-,4681
169,BUMA.1121.00031,1,3051590,3056261,+,4671
169,BUMA.1121.00108,1,2570433,2575113,+,4680
169,BUMA.1121.00023,1,4061307,4065978,+,4671
169,BUMA.1121.00035,1,2769982,2774653,+,4671
169,BUMA.1121.00041,1,2909483,2914154,+,4671
168,BUMA.1121.00057,1,2663139,2672780,+,9641
168,BUMA.1121.00058,1,2966192,2975836,-,9644
168,BUMA.1121.00045,1,2459300,2468917,-,9617
168,BUMA.1121.00051,1,1592251,1601892,+,9641
168,BUMA.1121.00068,1,344446,354100,+,9654
168,BUMA.1121.00061,1,2265297,2274913,-,9616
168,BUMA.1121.00060,1,685043,694660,-,9617
168,BUMA.1121.00064,1,1606539,1616189,+,9650
168,BUMA.1121.00016,1,3786151,3795795,+,9644
168,BUMA.1121.00003,1,149805,159455,+,9650
168,BUMA.1121.00055,1,1168393,1178034,+,9641
168,BUMA.1121.00011,1,159,9811,-,9652
168,BUMA.1121.00037,1,235093,244734,+,9641
168,BUMA.1121.00009,1,166,9811,-,9645
168,BUMA.1121.00069,1,2237223,2246864,-,9641
168,BUMA.1121.00088,1,2489726,2499370,+,9644
168,BUMA.1121.00092,1,2223950,2233591,-,9641
168,BUMA.1121.00074,1,2244007,2253651,-,9644
168,BUMA.1121.00070,1,2236250,2245891,-,9641
168,BUMA.1121.00093,1,2392727,2402368,+,9641
168,BUMA.1121.00063,1,2262212,2271828,-,9616
168,BUMA.1121.00033,1,3885366,3895007,+,9641
168,BUMA.1121.00018,1,2181360,2190983,+,9623
168,BUMA.1121.00080,1,1610996,1620640,+,9644
168,BUMA.1121.00027,1,3774889,3784530,+,9641
168,BUMA.1121.00053,1,1306718,1316361,+,9643
168,BUMA.1121.00059,1,791796,801440,+,9644
168,BUMA.1121.00043,1,1693033,1702677,+,9644
168,BUMA.1121.00056,1,2335314,2344955,-,9641
168,BUMA.1121.00112,1,1413934,1423560,-,9626
168,BUMA.1121.00091,1,2951718,2961362,-,9644
168,BUMA.1121.00047,1,1357910,1367551,-,9641
168,BUMA.1121.00067,1,2800286,2809930,-,9644
168,BUMA.1121.00110,1,3206328,3215969,-,9641
168,BUMA.1121.00073,1,2263350,2272991,-,9641
168,BUMA.1121.00072,1,2237784,2247403,-,9619
168,BUMA.1121.00077,1,266850,276491,+,9641
168,BUMA.1121.00082,1,2419139,2428780,-,9641
168,BUMA.1121.00062,1,2971424,2981065,-,9641
168,BUMA.1121.00007,1,2469671,2479297,-,9626
168,BUMA.1121.00025,1,1068804,1078427,-,9623
168,BUMA.1121.00021,1,2238793,2248434,+,9641
168,BUMA.1121.00103,1,2818301,2827916,-,9615
168,BUMA.1121.00096,1,1680774,1690408,-,9634
168,BUMA.1121.00079,1,1606311,1615949,+,9638
168,BUMA.1121.00039,1,1725401,1735042,+,9641
168,BUMA.1121.00083,1,159,9808,-,9649
168,BUMA.1121.00084,1,1948055,1957696,+,9641
168,BUMA.1121.00049,1,257439,267080,-,9641
168,BUMA.1121.00089,1,1581068,1590709,+,9641
168,BUMA.1121.00014,1,1169179,1178820,-,9641
168,BUMA.1121.00090,1,3779513,3789154,+,9641
168,BUMA.1121.00071,1,2254869,2264485,-,9616
168,BUMA.1121.00078,1,350545,360186,-,9641
168,BUMA.1121.00102,1,3821952,3831595,-,9643
168,BUMA.1121.00075,1,1077856,1087497,+,9641
168,BUMA.1121.00012,1,308880,318524,+,9644
168,BUMA.1121.00076,1,3725501,3735142,-,9641
168,BUMA.1121.00106,1,1344578,1354219,+,9641
168,BUMA.1121.00001,1,2439501,2449143,-,9642
168,BUMA.1121.00107,1,1485714,1495340,+,9626
168,BUMA.1121.00104,1,3635528,3645171,-,9643
168,BUMA.1121.00099,1,743388,753032,-,9644
168,BUMA.1121.00098,1,174276,183902,+,9626
168,BUMA.1121.00111,1,1778879,1788525,+,9646
168,BUMA.1121.00109,1,328988,338632,-,9644
168,BUMA.1121.00097,1,2344486,2354138,-,9652
168,BUMA.1121.00094,1,1612413,1622054,+,9641
168,BUMA.1121.00095,1,92977,102602,-,9625
168,BUMA.1121.00005,1,298733,308373,+,9640
168,BUMA.1121.00101,1,891604,901248,-,9644
168,BUMA.1121.00065,1,1682987,1692640,+,9653
168,BUMA.1121.00100,1,3736215,3745859,-,9644
168,BUMA.1121.00105,1,3636002,3645643,-,9641
168,BUMA.1121.00029,1,3322494,3332136,-,9642
168,BUMA.1121.00066,1,2239195,2248811,-,9616
168,BUMA.1121.00031,1,3038279,3047920,+,9641
168,BUMA.1121.00108,1,2557129,2566773,+,9644
168,BUMA.1121.00023,1,4048008,4057637,+,9629
168,BUMA.1121.00035,1,2756671,2766314,+,9643
168,BUMA.1121.00041,1,2896180,2905822,+,9642
167,BUMA.1121.00057,1,2648445,2652455,+,4010
167,BUMA.1121.00058,1,2995786,2999796,-,4010
167,BUMA.1121.00045,1,2487314,2491323,-,4009
167,BUMA.1121.00051,1,1577570,1581579,+,4009
167,BUMA.1121.00068,1,320267,324276,+,4009
167,BUMA.1121.00061,1,2283827,2287837,-,4010
167,BUMA.1121.00060,1,713057,717066,-,4009
167,BUMA.1121.00064,1,1591846,1595855,+,4009
167,BUMA.1121.00016,1,3767995,3772005,+,4010
167,BUMA.1121.00003,1,133804,137809,+,4005
167,BUMA.1121.00055,1,1153699,1157709,+,4010
167,BUMA.1121.00011,1,21481,25490,-,4009
167,BUMA.1121.00009,1,23636,27645,-,4009
167,BUMA.1121.00069,1,2253170,2257179,-,4009
167,BUMA.1121.00088,1,2466148,2470158,+,4010
167,BUMA.1121.00092,1,2254154,2258164,-,4010
167,BUMA.1121.00074,1,2264335,2268345,-,4010
167,BUMA.1121.00070,1,2254804,2258814,-,4010
167,BUMA.1121.00093,1,2368154,2372164,+,4010
167,BUMA.1121.00063,1,2280736,2284745,-,4009
167,BUMA.1121.00033,1,3864450,3869841,+,5391
167,BUMA.1121.00018,1,2161891,2165901,+,4010
167,BUMA.1121.00080,1,1596315,1600324,+,4009
167,BUMA.1121.00027,1,3760200,3764209,+,4009
167,BUMA.1121.00053,1,1292028,1296037,+,4009
167,BUMA.1121.00059,1,777111,781121,+,4010
167,BUMA.1121.00043,1,1674869,1678879,+,4010
167,BUMA.1121.00056,1,2355627,2359636,-,4009
167,BUMA.1121.00112,1,1441956,1445965,-,4009
167,BUMA.1121.00091,1,2981926,2985937,-,4011
167,BUMA.1121.00047,1,1378223,1382232,-,4009
167,BUMA.1121.00067,1,2820614,2824624,-,4010
167,BUMA.1121.00110,1,3227637,3231645,-,4008
167,BUMA.1121.00073,1,2281900,2285910,-,4010
167,BUMA.1121.00072,1,2256339,2260348,-,4009
167,BUMA.1121.00077,1,251174,255182,+,4008
167,BUMA.1121.00082,1,2439464,2443474,-,4010
167,BUMA.1121.00062,1,2995892,2999902,-,4010
167,BUMA.1121.00007,1,2493133,2497143,-,4010
167,BUMA.1121.00025,1,1093886,1097896,-,4010
167,BUMA.1121.00021,1,2220637,2224647,+,4010
167,BUMA.1121.00103,1,2841752,2845761,-,4009
167,BUMA.1121.00096,1,1706170,1710178,-,4008
167,BUMA.1121.00079,1,1591632,1595641,+,4009
167,BUMA.1121.00039,1,1707235,1711245,+,4010
167,BUMA.1121.00083,1,20492,24502,-,4010
167,BUMA.1121.00084,1,1922168,1926178,+,4010
167,BUMA.1121.00049,1,288856,292866,-,4010
167,BUMA.1121.00089,1,1566387,1570396,+,4009
167,BUMA.1121.00014,1,1192967,1196977,-,4010
167,BUMA.1121.00090,1,3761358,3765368,+,4010
167,BUMA.1121.00071,1,2273399,2277409,-,4010
167,BUMA.1121.00078,1,380145,384154,-,4009
167,BUMA.1121.00102,1,3843265,3847291,-,4026
167,BUMA.1121.00075,1,1062179,1066189,+,4010
167,BUMA.1121.00012,1,290715,294725,+,4010
167,BUMA.1121.00076,1,3746809,3750819,-,4010
167,BUMA.1121.00106,1,1318648,1322658,+,4010
167,BUMA.1121.00001,1,2468519,2472529,-,4010
167,BUMA.1121.00107,1,1470049,1474057,+,4008
167,BUMA.1121.00104,1,3667048,3671058,-,4010
167,BUMA.1121.00099,1,774832,778841,-,4009
167,BUMA.1121.00098,1,148456,152465,+,4009
167,BUMA.1121.00111,1,1760714,1764723,+,4009
167,BUMA.1121.00109,1,355902,359910,-,4008
167,BUMA.1121.00097,1,2374706,2378716,-,4010
167,BUMA.1121.00094,1,1597731,1601740,+,4009
167,BUMA.1121.00095,1,114272,118282,-,4010
167,BUMA.1121.00005,1,284038,288048,+,4010
167,BUMA.1121.00101,1,921812,925821,-,4009
167,BUMA.1121.00065,1,1668296,1672303,+,4007
167,BUMA.1121.00100,1,3761283,3765292,-,4009
167,BUMA.1121.00105,1,3666199,3670209,-,4010
167,BUMA.1121.00029,1,3349713,3353723,-,4010
167,BUMA.1121.00066,1,2257726,2261736,-,4010
167,BUMA.1121.00031,1,3020122,3024132,+,4010
167,BUMA.1121.00108,1,2541462,2545472,+,4010
167,BUMA.1121.00023,1,4029841,4033851,+,4010
167,BUMA.1121.00035,1,2736377,2740387,+,4010
167,BUMA.1121.00041,1,2872214,2876222,+,4008
166,BUMA.1121.00057,1,2591184,2641790,+,50606
166,BUMA.1121.00058,1,3006452,3057091,-,50639
166,BUMA.1121.00045,1,2497979,2548544,-,50565
166,BUMA.1121.00051,1,1520246,1570915,+,50669
166,BUMA.1121.00068,1,262959,313612,+,50653
166,BUMA.1121.00061,1,2294493,2345055,-,50562
166,BUMA.1121.00060,1,723722,774287,-,50565
166,BUMA.1121.00064,1,1534608,1585191,+,50583
166,BUMA.1121.00016,1,3709997,3760618,+,50621
166,BUMA.1121.00003,1,77283,127149,+,49866
166,BUMA.1121.00055,1,1096444,1147044,+,50600
166,BUMA.1121.00011,1,32146,82792,-,50646
166,BUMA.1121.00037,1,167897,218533,+,50636
166,BUMA.1121.00009,1,35023,85644,-,50621
166,BUMA.1121.00069,1,2263835,2314399,-,50564
166,BUMA.1121.00088,1,2408206,2458770,+,50564
166,BUMA.1121.00092,1,2264820,2315366,-,50546
166,BUMA.1121.00074,1,2275001,2325572,-,50571
166,BUMA.1121.00070,1,2265470,2316035,-,50565
166,BUMA.1121.00093,1,2310930,2361499,+,50569
166,BUMA.1121.00063,1,2291401,2341964,-,50563
166,BUMA.1121.00033,1,3807186,3857795,+,50609
166,BUMA.1121.00018,1,2104002,2154515,+,50513
166,BUMA.1121.00080,1,1539021,1589660,+,50639
166,BUMA.1121.00027,1,3702994,3753545,+,50551
166,BUMA.1121.00053,1,1234772,1285372,+,50600
166,BUMA.1121.00059,1,719094,769733,+,50639
166,BUMA.1121.00043,1,1616955,1667492,+,50537
166,BUMA.1121.00056,1,2366292,2416919,-,50627
166,BUMA.1121.00112,1,1452645,1502477,-,49832
166,BUMA.1121.00091,1,2992593,3043217,-,50624
166,BUMA.1121.00047,1,1388888,1439475,-,50587
166,BUMA.1121.00067,1,2831280,2881862,-,50582
166,BUMA.1121.00110,1,3239029,3290887,-,51858
166,BUMA.1121.00073,1,2292566,2343131,-,50565
166,BUMA.1121.00072,1,2267004,2317568,-,50564
166,BUMA.1121.00077,1,191942,243792,+,51850
166,BUMA.1121.00082,1,2450130,2500698,-,50568
166,BUMA.1121.00062,1,3006554,3057077,-,50523
166,BUMA.1121.00007,1,2503799,2554562,-,50763
166,BUMA.1121.00025,1,1105273,1155763,-,50490
166,BUMA.1121.00021,1,2163392,2213976,+,50584
166,BUMA.1121.00103,1,2853139,2903786,-,50647
166,BUMA.1121.00096,1,1716834,1767369,-,50535
166,BUMA.1121.00079,1,1534317,1584977,+,50660
166,BUMA.1121.00039,1,1649254,1699857,+,50603
166,BUMA.1121.00083,1,31158,81726,-,50568
166,BUMA.1121.00084,1,1864204,1914790,+,50586
166,BUMA.1121.00049,1,300245,350847,-,50602
166,BUMA.1121.00089,1,1509082,1559732,+,50650
166,BUMA.1121.00014,1,1203634,1254213,-,50579
166,BUMA.1121.00090,1,3703414,3753974,+,50560
166,BUMA.1121.00071,1,2284065,2334632,-,50567
166,BUMA.1121.00078,1,390816,441415,-,50599
166,BUMA.1121.00102,1,3855283,3905922,-,50639
166,BUMA.1121.00075,1,1004856,1055524,+,50668
166,BUMA.1121.00012,1,232753,283337,+,50584
166,BUMA.1121.00076,1,3757475,3808132,-,50657
166,BUMA.1121.00106,1,1261396,1311992,+,50596
166,BUMA.1121.00001,1,2479907,2530474,-,50567
166,BUMA.1121.00107,1,1412742,1463394,+,50652
166,BUMA.1121.00104,1,3678437,3728974,-,50537
166,BUMA.1121.00099,1,786221,836114,-,49893
166,BUMA.1121.00098,1,90461,141066,+,50605
166,BUMA.1121.00111,1,1702745,1753336,+,50591
166,BUMA.1121.00109,1,366566,417183,-,50617
166,BUMA.1121.00097,1,2385372,2435215,-,49843
166,BUMA.1121.00094,1,1540407,1591076,+,50669
166,BUMA.1121.00095,1,124938,175531,-,50593
166,BUMA.1121.00005,1,226732,277383,+,50651
166,BUMA.1121.00101,1,933199,983779,-,50580
166,BUMA.1121.00065,1,1609777,1661641,+,51864
166,BUMA.1121.00100,1,3771948,3822489,-,50541
166,BUMA.1121.00105,1,3676865,3727446,-,50581
166,BUMA.1121.00029,1,3361102,3411672,-,50570
166,BUMA.1121.00066,1,2268392,2318918,-,50526
166,BUMA.1121.00031,1,2962861,3013466,+,50605
166,BUMA.1121.00108,1,2483532,2534078,+,50546
166,BUMA.1121.00023,1,3971935,4022463,+,50528
166,BUMA.1121.00035,1,2678406,2728999,+,50593
166,BUMA.1121.00041,1,2814884,2865559,+,50675
165,BUMA.1121.00057,1,2586162,2591087,+,4925
165,BUMA.1121.00058,1,3057139,3062122,-,4983
165,BUMA.1121.00045,1,2548592,2553539,-,4947
165,BUMA.1121.00051,1,1515251,1520198,+,4947
165,BUMA.1121.00068,1,257964,262911,+,4947
165,BUMA.1121.00061,1,2345103,2350050,-,4947
165,BUMA.1121.00060,1,774335,779282,-,4947
165,BUMA.1121.00064,1,1529586,1534511,+,4925
165,BUMA.1121.00016,1,3704960,3709882,+,4922
165,BUMA.1121.00003,1,72252,77199,+,4947
165,BUMA.1121.00055,1,1091449,1096396,+,4947
165,BUMA.1121.00011,1,82881,87900,-,5019
165,BUMA.1121.00037,1,162848,167773,+,4925
165,BUMA.1121.00009,1,85692,90623,-,4931
165,BUMA.1121.00069,1,2314447,2319394,-,4947
165,BUMA.1121.00088,1,2403211,2408158,+,4947
165,BUMA.1121.00092,1,2315437,2320411,-,4974
165,BUMA.1121.00074,1,2325643,2330653,-,5010
165,BUMA.1121.00070,1,2316083,2321030,-,4947
165,BUMA.1121.00093,1,2305908,2310833,+,4925
165,BUMA.1121.00063,1,2342012,2346959,-,4947
165,BUMA.1121.00033,1,3802164,3807089,+,4925
165,BUMA.1121.00018,1,2098980,2103905,+,4925
165,BUMA.1121.00080,1,1533990,1538915,+,4925
165,BUMA.1121.00027,1,3697999,3702946,+,4947
165,BUMA.1121.00053,1,1229795,1234724,+,4929
165,BUMA.1121.00059,1,714072,718997,+,4925
165,BUMA.1121.00043,1,1611945,1616907,+,4962
165,BUMA.1121.00056,1,2416990,2421937,-,4947
165,BUMA.1121.00112,1,1502525,1507497,-,4972
165,BUMA.1121.00091,1,3043265,3048212,-,4947
165,BUMA.1121.00047,1,1439523,1444506,-,4983
165,BUMA.1121.00067,1,2881933,2886934,-,5001
165,BUMA.1121.00110,1,3290953,3295945,-,4992
165,BUMA.1121.00073,1,2343179,2348126,-,4947
165,BUMA.1121.00072,1,2317616,2322563,-,4947
165,BUMA.1121.00077,1,186884,191876,+,4992
165,BUMA.1121.00082,1,2500746,2505693,-,4947
165,BUMA.1121.00062,1,3057148,3062122,-,4974
165,BUMA.1121.00007,1,2554610,2559546,-,4936
165,BUMA.1121.00025,1,1155834,1160808,-,4974
165,BUMA.1121.00021,1,2158334,2163259,+,4925
165,BUMA.1121.00103,1,2903834,2908772,-,4938
165,BUMA.1121.00096,1,1767417,1772364,-,4947
165,BUMA.1121.00079,1,1529322,1534269,+,4947
165,BUMA.1121.00039,1,1644250,1649206,+,4956
165,BUMA.1121.00083,1,81774,86721,-,4947
165,BUMA.1121.00084,1,1859209,1864156,+,4947
165,BUMA.1121.00049,1,350918,355910,-,4992
165,BUMA.1121.00089,1,1504087,1509034,+,4947
165,BUMA.1121.00014,1,1254284,1259303,-,5019
165,BUMA.1121.00090,1,3698383,3703308,+,4925
165,BUMA.1121.00071,1,2334680,2339627,-,4947
165,BUMA.1121.00078,1,441463,446437,-,4974
165,BUMA.1121.00102,1,3905970,3910944,-,4974
165,BUMA.1121.00075,1,999862,1004808,+,4946
165,BUMA.1121.00012,1,227713,232638,+,4925
165,BUMA.1121.00076,1,3808203,3813150,-,4947
165,BUMA.1121.00106,1,1256356,1261281,+,4925
165,BUMA.1121.00001,1,2530545,2535528,-,4983
165,BUMA.1121.00107,1,1407694,1412640,+,4946
165,BUMA.1121.00104,1,3729045,3734064,-,5019
165,BUMA.1121.00099,1,836162,841163,-,5001
165,BUMA.1121.00098,1,85458,90413,+,4955
165,BUMA.1121.00109,1,417258,422223,-,4965
165,BUMA.1121.00097,1,2435272,2440219,-,4947
165,BUMA.1121.00094,1,1535412,1540359,+,4947
165,BUMA.1121.00095,1,175579,180517,-,4938
165,BUMA.1121.00005,1,221728,226684,+,4956
165,BUMA.1121.00101,1,983827,988765,-,4938
165,BUMA.1121.00065,1,1604755,1609680,+,4925
165,BUMA.1121.00100,1,3822582,3827477,-,4895
165,BUMA.1121.00105,1,3727517,3732464,-,4947
165,BUMA.1121.00029,1,3411743,3416726,-,4983
165,BUMA.1121.00066,1,2318966,2323913,-,4947
165,BUMA.1121.00031,1,2957803,2962728,+,4925
165,BUMA.1121.00108,1,2478519,2483448,+,4929
165,BUMA.1121.00023,1,3966904,3971829,+,4925
165,BUMA.1121.00035,1,2673375,2678300,+,4925
165,BUMA.1121.00041,1,2809862,2814800,+,4938
164,BUMA.1121.00057,1,2573024,2582489,+,9465
164,BUMA.1121.00058,1,3065795,3075201,-,9406
164,BUMA.1121.00045,1,2557212,2566665,-,9453
164,BUMA.1121.00051,1,1492506,1501912,+,9406
164,BUMA.1121.00068,1,234140,243585,+,9445
164,BUMA.1121.00061,1,1474274,1483738,+,9464
164,BUMA.1121.00060,1,782955,792408,-,9453
164,BUMA.1121.00064,1,1498204,1507683,+,9479
164,BUMA.1121.00016,1,3651425,3660882,+,9457
164,BUMA.1121.00003,1,45855,55303,+,9448
164,BUMA.1121.00055,1,1078347,1087776,+,9429
164,BUMA.1121.00011,1,91575,101020,-,9445
164,BUMA.1121.00037,1,115712,125162,+,9450
164,BUMA.1121.00009,1,94274,103680,-,9406
164,BUMA.1121.00069,1,1427448,1436912,+,9464
164,BUMA.1121.00088,1,2388865,2398329,+,9464
164,BUMA.1121.00092,1,2324084,2333490,-,9406
164,BUMA.1121.00074,1,2352556,2362035,-,9479
164,BUMA.1121.00070,1,1445264,1454727,+,9463
164,BUMA.1121.00093,1,2292829,2302235,+,9406
164,BUMA.1121.00063,1,1471361,1480825,+,9464
164,BUMA.1121.00033,1,3753741,3763205,+,9464
164,BUMA.1121.00018,1,2085863,2095307,+,9444
164,BUMA.1121.00080,1,1519699,1529105,+,9406
164,BUMA.1121.00027,1,3684854,3694324,+,9470
164,BUMA.1121.00053,1,1216651,1226122,+,9471
164,BUMA.1121.00059,1,700997,710399,+,9402
164,BUMA.1121.00043,1,1547707,1557151,+,9444
164,BUMA.1121.00056,1,2426822,2436228,-,9406
164,BUMA.1121.00112,1,1511166,1520622,-,9456
164,BUMA.1121.00091,1,3051885,3061354,-,9469
164,BUMA.1121.00047,1,1448157,1457610,-,9453
164,BUMA.1121.00067,1,2910178,2919650,-,9472
164,BUMA.1121.00110,1,3299617,3309022,-,9405
164,BUMA.1121.00073,1,1472515,1481978,+,9463
164,BUMA.1121.00072,1,1446775,1456239,+,9464
164,BUMA.1121.00077,1,173810,183212,+,9402
164,BUMA.1121.00082,1,1604953,1614417,+,9464
164,BUMA.1121.00062,1,3075261,3084707,-,9446
164,BUMA.1121.00007,1,2563215,2572672,-,9457
164,BUMA.1121.00025,1,1164481,1173926,-,9445
164,BUMA.1121.00021,1,2145206,2154664,+,9458
164,BUMA.1121.00103,1,2912444,2921890,-,9446
164,BUMA.1121.00096,1,1776036,1785456,-,9420
164,BUMA.1121.00079,1,1514991,1524437,+,9446
164,BUMA.1121.00039,1,1631136,1640578,+,9442
164,BUMA.1121.00083,1,90394,99858,-,9464
164,BUMA.1121.00084,1,1826183,1835655,+,9472
164,BUMA.1121.00049,1,371844,381271,-,9427
164,BUMA.1121.00089,1,1489796,1499202,+,9406
164,BUMA.1121.00014,1,1281763,1291220,-,9457
164,BUMA.1121.00090,1,3673281,3682731,+,9450
164,BUMA.1121.00071,1,1464350,1473788,+,9438
164,BUMA.1121.00078,1,459574,469011,-,9437
164,BUMA.1121.00102,1,3914614,3924064,-,9450
164,BUMA.1121.00075,1,986763,996207,+,9444
164,BUMA.1121.00012,1,185994,195445,+,9451
164,BUMA.1121.00076,1,3816805,3826249,-,9444
164,BUMA.1121.00106,1,1243263,1252683,+,9420
164,BUMA.1121.00001,1,2554778,2564228,-,9450
164,BUMA.1121.00107,1,1394587,1404022,+,9435
164,BUMA.1121.00104,1,3737737,3747157,-,9420
164,BUMA.1121.00099,1,892625,902065,-,9440
164,BUMA.1121.00098,1,16423,25815,+,9392
164,BUMA.1121.00111,1,1643223,1652687,+,9464
164,BUMA.1121.00109,1,425895,435334,-,9439
164,BUMA.1121.00097,1,2453341,2462754,-,9413
164,BUMA.1121.00094,1,1521122,1530528,+,9406
164,BUMA.1121.00095,1,184189,193628,-,9439
164,BUMA.1121.00005,1,171728,181193,+,9465
164,BUMA.1121.00101,1,992435,1001867,-,9432
164,BUMA.1121.00065,1,1591655,1601085,+,9430
164,BUMA.1121.00100,1,3831146,3840586,-,9440
164,BUMA.1121.00105,1,3736137,3745562,-,9425
164,BUMA.1121.00029,1,3428826,3438277,-,9451
164,BUMA.1121.00066,1,1448394,1457858,+,9464
164,BUMA.1121.00031,1,2925895,2935345,+,9450
164,BUMA.1121.00108,1,2465460,2474867,+,9407
164,BUMA.1121.00023,1,3934995,3944445,+,9450
164,BUMA.1121.00035,1,2646217,2655667,+,9450
164,BUMA.1121.00041,1,2796758,2806189,+,9431
163,BUMA.1121.00057,1,2556566,2570674,+,14108
163,BUMA.1121.00058,1,3077550,3091677,-,14127
163,BUMA.1121.00045,1,2569016,2583113,-,14097
163,BUMA.1121.00051,1,1476047,1490156,+,14109
163,BUMA.1121.00068,1,217676,231789,+,14113
163,BUMA.1121.00061,1,1457816,1471924,+,14108
163,BUMA.1121.00060,1,794759,808856,-,14097
163,BUMA.1121.00064,1,1481760,1495853,+,14093
163,BUMA.1121.00016,1,3634962,3649074,+,14112
163,BUMA.1121.00003,1,29408,43503,+,14095
163,BUMA.1121.00055,1,1061901,1075996,+,14095
163,BUMA.1121.00011,1,103371,117452,-,14081
163,BUMA.1121.00037,1,99249,113361,+,14112
163,BUMA.1121.00009,1,106030,120142,-,14112
163,BUMA.1121.00069,1,1410991,1425099,+,14108
163,BUMA.1121.00088,1,2372406,2386516,+,14110
163,BUMA.1121.00092,1,2390707,2404819,-,14112
163,BUMA.1121.00074,1,2364386,2378479,-,14093
163,BUMA.1121.00070,1,1428806,1442914,+,14108
163,BUMA.1121.00093,1,2221500,2235612,+,14112
163,BUMA.1121.00063,1,1454903,1469011,+,14108
163,BUMA.1121.00033,1,3737264,3751390,+,14126
163,BUMA.1121.00018,1,2069401,2083492,+,14091
163,BUMA.1121.00080,1,1503239,1517349,+,14110
163,BUMA.1121.00027,1,3668413,3682504,+,14091
163,BUMA.1121.00053,1,1200190,1214300,+,14110
163,BUMA.1121.00059,1,684537,698645,+,14108
163,BUMA.1121.00043,1,1531230,1545357,+,14127
163,BUMA.1121.00056,1,2438579,2452688,-,14109
163,BUMA.1121.00112,1,1522958,1537085,-,14127
163,BUMA.1121.00091,1,3063705,3077815,-,14110
163,BUMA.1121.00047,1,1459960,1474076,-,14116
163,BUMA.1121.00067,1,2922001,2936094,-,14093
163,BUMA.1121.00110,1,3311373,3325480,-,14107
163,BUMA.1121.00073,1,1456057,1470165,+,14108
163,BUMA.1121.00072,1,1430335,1444425,+,14090
163,BUMA.1121.00077,1,157352,171459,+,14107
163,BUMA.1121.00082,1,1588495,1602603,+,14108
163,BUMA.1121.00062,1,3087056,3101166,-,14110
163,BUMA.1121.00007,1,2630248,2644338,-,14090
163,BUMA.1121.00025,1,1176297,1190388,-,14091
163,BUMA.1121.00021,1,2128743,2142855,+,14112
163,BUMA.1121.00103,1,2924239,2938318,-,14079
163,BUMA.1121.00096,1,1787806,1801916,-,14110
163,BUMA.1121.00079,1,1498532,1512640,+,14108
163,BUMA.1121.00039,1,1613341,1627450,+,14109
163,BUMA.1121.00083,1,102208,116316,-,14108
163,BUMA.1121.00084,1,1701782,1715890,+,14108
163,BUMA.1121.00049,1,384834,398942,-,14108
163,BUMA.1121.00089,1,1473337,1487445,+,14108
163,BUMA.1121.00014,1,1293571,1307681,-,14110
163,BUMA.1121.00090,1,3630365,3644477,+,14112
163,BUMA.1121.00071,1,1447892,1462000,+,14108
163,BUMA.1121.00078,1,471361,485484,-,14123
163,BUMA.1121.00102,1,3926415,3940538,-,14123
163,BUMA.1121.00075,1,970298,984412,+,14114
163,BUMA.1121.00012,1,169546,183643,+,14097
163,BUMA.1121.00076,1,3828600,3842714,-,14114
163,BUMA.1121.00106,1,1226804,1240912,+,14108
163,BUMA.1121.00001,1,2566579,2580688,-,14109
163,BUMA.1121.00107,1,1378107,1392237,+,14130
163,BUMA.1121.00104,1,3749508,3763616,-,14108
163,BUMA.1121.00099,1,904416,918546,-,14130
163,BUMA.1121.00098,1,1,14072,+,14071
163,BUMA.1121.00111,1,1626760,1640872,+,14112
163,BUMA.1121.00109,1,437685,451782,-,14097
163,BUMA.1121.00097,1,2523996,2538104,-,14108
163,BUMA.1121.00094,1,1504662,1518772,+,14110
163,BUMA.1121.00095,1,195978,210072,-,14094
163,BUMA.1121.00005,1,155264,169376,+,14112
163,BUMA.1121.00101,1,1004218,1018346,-,14128
163,BUMA.1121.00065,1,1575177,1589304,+,14127
163,BUMA.1121.00100,1,3842938,3857048,-,14110
163,BUMA.1121.00105,1,3747912,3762022,-,14110
163,BUMA.1121.00029,1,3440628,3454737,-,14109
163,BUMA.1121.00066,1,1431936,1446044,+,14108
163,BUMA.1121.00031,1,2909432,2923544,+,14112
163,BUMA.1121.00108,1,2449036,2463110,+,14074
163,BUMA.1121.00023,1,3889726,3903823,+,14097
163,BUMA.1121.00035,1,2629757,2643866,+,14109
163,BUMA.1121.00041,1,2780270,2794408,+,14138
162,BUMA.1121.00057,1,2528029,2556564,+,28535
162,BUMA.1121.00058,1,3091678,3120109,-,28431
162,BUMA.1121.00045,1,2583114,2611761,-,28647
162,BUMA.1121.00051,1,1447353,1476045,+,28692
162,BUMA.1121.00068,1,189130,217674,+,28544
162,BUMA.1121.00061,1,1429387,1457814,+,28427
162,BUMA.1121.00060,1,808857,837510,-,28653
162,BUMA.1121.00064,1,1453155,1481758,+,28603
162,BUMA.1121.00016,1,3606320,3634960,+,28640
162,BUMA.1121.00003,1,994,29406,+,28412
162,BUMA.1121.00055,1,1033162,1061899,+,28737
162,BUMA.1121.00011,1,117453,145973,-,28520
162,BUMA.1121.00037,1,70469,99247,+,28778
162,BUMA.1121.00009,1,120143,148691,-,28548
162,BUMA.1121.00069,1,1382493,1410989,+,28496
162,BUMA.1121.00088,1,2343700,2372404,+,28704
162,BUMA.1121.00092,1,2404820,2433566,-,28746
162,BUMA.1121.00074,1,2378480,2407066,-,28586
162,BUMA.1121.00070,1,1400328,1428804,+,28476
162,BUMA.1121.00093,1,2192752,2221498,+,28746
162,BUMA.1121.00063,1,1426430,1454901,+,28471
162,BUMA.1121.00033,1,3708789,3737262,+,28473
162,BUMA.1121.00018,1,2040771,2069399,+,28628
162,BUMA.1121.00080,1,1474613,1503237,+,28624
162,BUMA.1121.00027,1,3639905,3668411,+,28506
162,BUMA.1121.00053,1,1171847,1200188,+,28341
162,BUMA.1121.00059,1,655512,684535,+,29023
162,BUMA.1121.00043,1,1502384,1531228,+,28844
162,BUMA.1121.00056,1,2452689,2481331,-,28642
162,BUMA.1121.00112,1,1537086,1565751,-,28665
162,BUMA.1121.00091,1,3077816,3106507,-,28691
162,BUMA.1121.00047,1,1474077,1502991,-,28914
162,BUMA.1121.00067,1,2936095,2964758,-,28663
162,BUMA.1121.00110,1,3325481,3354025,-,28544
162,BUMA.1121.00073,1,1427559,1456055,+,28496
162,BUMA.1121.00072,1,1401995,1430333,+,28338
162,BUMA.1121.00077,1,128743,157350,+,28607
162,BUMA.1121.00082,1,1559997,1588493,+,28496
162,BUMA.1121.00062,1,3101167,3129729,-,28562
162,BUMA.1121.00007,1,2644339,2673062,-,28723
162,BUMA.1121.00025,1,1190389,1218971,-,28582
162,BUMA.1121.00021,1,2099832,2128741,+,28909
162,BUMA.1121.00103,1,2938319,2966930,-,28611
162,BUMA.1121.00096,1,1801917,1830509,-,28592
162,BUMA.1121.00079,1,1469912,1498530,+,28618
162,BUMA.1121.00039,1,1584461,1613339,+,28878
162,BUMA.1121.00083,1,116317,144813,-,28496
162,BUMA.1121.00084,1,1672950,1701780,+,28830
162,BUMA.1121.00049,1,398943,427403,-,28460
162,BUMA.1121.00089,1,1444567,1473335,+,28768
162,BUMA.1121.00014,1,1307682,1336208,-,28526
162,BUMA.1121.00090,1,3601610,3630363,+,28753
162,BUMA.1121.00071,1,1419421,1447890,+,28469
162,BUMA.1121.00078,1,485485,514199,-,28714
162,BUMA.1121.00102,1,3940539,3969120,-,28581
162,BUMA.1121.00075,1,941629,970296,+,28667
162,BUMA.1121.00012,1,141082,169544,+,28462
162,BUMA.1121.00076,1,3842715,3871365,-,28650
162,BUMA.1121.00106,1,1198156,1226802,+,28646
162,BUMA.1121.00001,1,2580689,2609329,-,28640
162,BUMA.1121.00107,1,1349690,1378105,+,28415
162,BUMA.1121.00104,1,3763617,3792388,-,28771
162,BUMA.1121.00099,1,918547,946998,-,28451
162,BUMA.1121.00098,1,4211960,4240579,+,28619
162,BUMA.1121.00111,1,1597715,1626758,+,29043
162,BUMA.1121.00109,1,451783,480524,-,28741
162,BUMA.1121.00097,1,2538105,2566607,-,28502
162,BUMA.1121.00094,1,1475913,1504660,+,28747
162,BUMA.1121.00095,1,210073,238439,-,28366
162,BUMA.1121.00005,1,126730,155262,+,28532
162,BUMA.1121.00101,1,1018347,1046733,-,28386
162,BUMA.1121.00065,1,1546242,1575175,+,28933
162,BUMA.1121.00100,1,3857049,3885567,-,28518
162,BUMA.1121.00105,1,3762023,3790661,-,28638
162,BUMA.1121.00029,1,3454738,3483431,-,28693
162,BUMA.1121.00066,1,1403482,1431934,+,28452
162,BUMA.1121.00031,1,2880800,2909430,+,28630
162,BUMA.1121.00108,1,2420528,2449034,+,28506
162,BUMA.1121.00023,1,3861163,3889724,+,28561
162,BUMA.1121.00035,1,2601083,2629755,+,28672
162,BUMA.1121.00041,1,2751403,2780268,+,28865
161,BUMA.1121.00057,1,2517681,2526731,+,9050
161,BUMA.1121.00058,1,3121408,3130533,-,9125
161,BUMA.1121.00045,1,2613060,2622168,-,9108
161,BUMA.1121.00051,1,1437013,1446055,+,9042
161,BUMA.1121.00068,1,178708,187836,+,9128
161,BUMA.1121.00061,1,1418971,1428089,+,9118
161,BUMA.1121.00060,1,838809,847908,-,9099
161,BUMA.1121.00064,1,1442760,1451857,+,9097
161,BUMA.1121.00016,1,3595963,3605022,+,9059
161,BUMA.1121.00003,1,3906031,3915152,+,9121
161,BUMA.1121.00055,1,1022760,1031864,+,9104
161,BUMA.1121.00011,1,147272,156448,-,9176
161,BUMA.1121.00037,1,60068,69171,+,9103
161,BUMA.1121.00009,1,149990,159164,-,9174
161,BUMA.1121.00069,1,1372112,1381195,+,9083
161,BUMA.1121.00088,1,2333298,2342402,+,9104
161,BUMA.1121.00092,1,2434865,2443978,-,9113
161,BUMA.1121.00074,1,2408365,2417479,-,9114
161,BUMA.1121.00070,1,1389912,1399030,+,9118
161,BUMA.1121.00093,1,2182341,2191454,+,9113
161,BUMA.1121.00063,1,1416014,1425132,+,9118
161,BUMA.1121.00033,1,3698352,3707491,+,9139
161,BUMA.1121.00018,1,2030381,2039473,+,9092
161,BUMA.1121.00080,1,1464119,1473315,+,9196
161,BUMA.1121.00027,1,3629534,3638607,+,9073
161,BUMA.1121.00053,1,1161502,1170549,+,9047
161,BUMA.1121.00059,1,645114,654214,+,9100
161,BUMA.1121.00043,1,1492026,1501086,+,9060
161,BUMA.1121.00056,1,2482631,2491698,-,9067
161,BUMA.1121.00112,1,1567050,1576189,-,9139
161,BUMA.1121.00091,1,3107806,3116927,-,9121
161,BUMA.1121.00047,1,1504290,1513351,-,9061
161,BUMA.1121.00067,1,2966057,2975162,-,9105
161,BUMA.1121.00110,1,3355324,3364480,-,9156
161,BUMA.1121.00073,1,1417143,1426261,+,9118
161,BUMA.1121.00072,1,1391579,1400697,+,9118
161,BUMA.1121.00077,1,118291,127447,+,9156
161,BUMA.1121.00082,1,1549581,1558699,+,9118
161,BUMA.1121.00062,1,3131028,3140179,-,9151
161,BUMA.1121.00007,1,2674361,2683621,-,9260
161,BUMA.1121.00025,1,1220270,1229392,-,9122
161,BUMA.1121.00021,1,2089343,2098534,+,9191
161,BUMA.1121.00103,1,2968229,2977288,-,9059
161,BUMA.1121.00096,1,1831808,1840930,-,9122
161,BUMA.1121.00079,1,1459469,1468614,+,9145
161,BUMA.1121.00039,1,1574042,1583163,+,9121
161,BUMA.1121.00083,1,146112,155231,-,9119
161,BUMA.1121.00084,1,1662620,1671652,+,9032
161,BUMA.1121.00049,1,428703,437809,-,9106
161,BUMA.1121.00089,1,1434202,1443269,+,9067
161,BUMA.1121.00014,1,1337507,1346577,-,9070
161,BUMA.1121.00090,1,3591226,3600312,+,9086
161,BUMA.1121.00071,1,1409005,1418123,+,9118
161,BUMA.1121.00078,1,515494,524687,-,9193
161,BUMA.1121.00102,1,3970419,3979515,-,9096
161,BUMA.1121.00075,1,931203,940381,+,9178
161,BUMA.1121.00012,1,130617,139784,+,9167
161,BUMA.1121.00076,1,3872615,3881786,-,9171
161,BUMA.1121.00106,1,1187703,1196858,+,9155
161,BUMA.1121.00001,1,2610628,2619711,-,9083
161,BUMA.1121.00107,1,1339245,1348396,+,9151
161,BUMA.1121.00104,1,3793687,3802817,-,9130
161,BUMA.1121.00099,1,948297,957377,-,9080
161,BUMA.1121.00098,1,4201593,4210662,+,9069
161,BUMA.1121.00111,1,1587316,1596417,+,9101
161,BUMA.1121.00109,1,481823,490906,-,9083
161,BUMA.1121.00097,1,2567905,2576989,-,9084
161,BUMA.1121.00094,1,1465560,1474615,+,9055
161,BUMA.1121.00095,1,239739,248872,-,9133
161,BUMA.1121.00005,1,116298,125432,+,9134
161,BUMA.1121.00101,1,1048033,1057123,-,9090
161,BUMA.1121.00065,1,1535850,1544944,+,9094
161,BUMA.1121.00100,1,3886866,3896089,-,9223
161,BUMA.1121.00105,1,3791960,3801063,-,9103
161,BUMA.1121.00029,1,3484730,3493816,-,9086
161,BUMA.1121.00066,1,1393066,1402184,+,9118
161,BUMA.1121.00031,1,2870381,2879502,+,9121
161,BUMA.1121.00108,1,2410117,2419230,+,9113
161,BUMA.1121.00023,1,3850764,3859865,+,9101
161,BUMA.1121.00035,1,2590699,2599785,+,9086
161,BUMA.1121.00041,1,2741029,2750105,+,9076
160,BUMA.1121.00057,1,2494012,2517617,+,23605
160,BUMA.1121.00058,1,3130597,3154245,-,23648
160,BUMA.1121.00045,1,2622232,2645813,-,23581
160,BUMA.1121.00051,1,1413290,1436949,+,23659
160,BUMA.1121.00068,1,155009,178644,+,23635
160,BUMA.1121.00061,1,1395432,1418907,+,23475
160,BUMA.1121.00060,1,847972,871554,-,23582
160,BUMA.1121.00064,1,1419171,1442696,+,23525
160,BUMA.1121.00016,1,3572321,3595899,+,23578
160,BUMA.1121.00003,1,3882256,3905967,+,23711
160,BUMA.1121.00055,1,999162,1022696,+,23534
160,BUMA.1121.00011,1,156512,180139,-,23627
160,BUMA.1121.00037,1,36357,60004,+,23647
160,BUMA.1121.00009,1,159228,182832,-,23604
160,BUMA.1121.00069,1,1348596,1372048,+,23452
160,BUMA.1121.00088,1,2309596,2333234,+,23638
160,BUMA.1121.00092,1,2444042,2467716,-,23674
160,BUMA.1121.00074,1,2417543,2441141,-,23598
160,BUMA.1121.00070,1,1366411,1389848,+,23437
160,BUMA.1121.00093,1,2158620,2182277,+,23657
160,BUMA.1121.00063,1,1392508,1415950,+,23442
160,BUMA.1121.00033,1,3674727,3698288,+,23561
160,BUMA.1121.00018,1,2006688,2030317,+,23629
160,BUMA.1121.00080,1,1440493,1464055,+,23562
160,BUMA.1121.00027,1,3605996,3629470,+,23474
160,BUMA.1121.00053,1,1137873,1161438,+,23565
160,BUMA.1121.00059,1,621382,645050,+,23668
160,BUMA.1121.00043,1,1468357,1491962,+,23605
160,BUMA.1121.00056,1,2491762,2515420,-,23658
160,BUMA.1121.00112,1,1576253,1599806,-,23553
160,BUMA.1121.00091,1,3116991,3140692,-,23701
160,BUMA.1121.00047,1,1513415,1537093,-,23678
160,BUMA.1121.00067,1,2975226,2998850,-,23624
160,BUMA.1121.00110,1,3364544,3388138,-,23594
160,BUMA.1121.00073,1,1393640,1417079,+,23439
160,BUMA.1121.00072,1,1368036,1391515,+,23479
160,BUMA.1121.00077,1,94633,118227,+,23594
160,BUMA.1121.00082,1,1526031,1549517,+,23486
160,BUMA.1121.00062,1,3140243,3163869,-,23626
160,BUMA.1121.00007,1,2683685,2707324,-,23639
160,BUMA.1121.00025,1,1229456,1253078,-,23622
160,BUMA.1121.00021,1,2065640,2089279,+,23639
160,BUMA.1121.00103,1,2977352,3000880,-,23528
160,BUMA.1121.00096,1,1840994,1864627,-,23633
160,BUMA.1121.00079,1,1435711,1459405,+,23694
160,BUMA.1121.00039,1,1550342,1573978,+,23636
160,BUMA.1121.00083,1,155295,178780,-,23485
160,BUMA.1121.00084,1,1638952,1662556,+,23604
160,BUMA.1121.00049,1,437873,461523,-,23650
160,BUMA.1121.00089,1,1410479,1434138,+,23659
160,BUMA.1121.00014,1,1346641,1370206,-,23565
160,BUMA.1121.00090,1,3567499,3591162,+,23663
160,BUMA.1121.00071,1,1385462,1408941,+,23479
160,BUMA.1121.00078,1,524751,548318,-,23567
160,BUMA.1121.00102,1,3979579,4003100,-,23521
160,BUMA.1121.00075,1,907486,931139,+,23653
160,BUMA.1121.00012,1,106929,130553,+,23624
160,BUMA.1121.00076,1,3881850,3905470,-,23620
160,BUMA.1121.00106,1,1164038,1187639,+,23601
160,BUMA.1121.00001,1,2619775,2643244,-,23469
160,BUMA.1121.00107,1,1315618,1339181,+,23563
160,BUMA.1121.00104,1,3802881,3826534,-,23653
160,BUMA.1121.00099,1,957441,981135,-,23694
160,BUMA.1121.00098,1,4177059,4200667,+,23608
160,BUMA.1121.00111,1,1563681,1587252,+,23571
160,BUMA.1121.00109,1,490970,514645,-,23675
160,BUMA.1121.00097,1,2577053,2600604,-,23551
160,BUMA.1121.00094,1,1441837,1465496,+,23659
160,BUMA.1121.00095,1,248936,272547,-,23611
160,BUMA.1121.00005,1,92686,116234,+,23548
160,BUMA.1121.00101,1,1057187,1080654,-,23467
160,BUMA.1121.00065,1,1512311,1535786,+,23475
160,BUMA.1121.00100,1,3896091,3919867,-,23776
160,BUMA.1121.00105,1,3801127,3824641,-,23514
160,BUMA.1121.00029,1,3493880,3517336,-,23456
160,BUMA.1121.00066,1,1369557,1393002,+,23445
160,BUMA.1121.00031,1,2846730,2870317,+,23587
160,BUMA.1121.00108,1,2386529,2410053,+,23524
160,BUMA.1121.00023,1,3827010,3850700,+,23690
160,BUMA.1121.00035,1,2567168,2590635,+,23467
160,BUMA.1121.00041,1,2717380,2740965,+,23585
159,BUMA.1121.00057,1,2488553,2492129,+,3576
159,BUMA.1121.00058,1,3156130,3159689,-,3559
159,BUMA.1121.00045,1,2647698,2651275,-,3577
159,BUMA.1121.00051,1,1407837,1411393,+,3556
159,BUMA.1121.00068,1,149555,153148,+,3593
159,BUMA.1121.00061,1,1390029,1393535,+,3506
159,BUMA.1121.00060,1,873439,877016,-,3577
159,BUMA.1121.00064,1,1413738,1417274,+,3536
159,BUMA.1121.00016,1,3566908,3570436,+,3528
159,BUMA.1121.00003,1,3876729,3880359,+,3630
159,BUMA.1121.00055,1,993708,997279,+,3571
159,BUMA.1121.00011,1,182036,185662,-,3626
159,BUMA.1121.00037,1,30918,34472,+,3554
159,BUMA.1121.00009,1,184705,188204,-,3499
159,BUMA.1121.00069,1,1343193,1346699,+,3506
159,BUMA.1121.00088,1,2304105,2307713,+,3608
159,BUMA.1121.00092,1,2469599,2473172,-,3573
159,BUMA.1121.00074,1,2443024,2446573,-,3549
159,BUMA.1121.00070,1,1361008,1364514,+,3506
159,BUMA.1121.00093,1,2153164,2156737,+,3573
159,BUMA.1121.00063,1,1387105,1390611,+,3506
159,BUMA.1121.00033,1,3669272,3672842,+,3570
159,BUMA.1121.00018,1,2001224,2004803,+,3579
159,BUMA.1121.00080,1,1435012,1438596,+,3584
159,BUMA.1121.00027,1,3600498,3604099,+,3601
159,BUMA.1121.00053,1,1132397,1135978,+,3581
159,BUMA.1121.00059,1,615960,619485,+,3525
159,BUMA.1121.00043,1,1462918,1466472,+,3554
159,BUMA.1121.00056,1,2517315,2520858,-,3543
159,BUMA.1121.00112,1,1601691,1605310,-,3619
159,BUMA.1121.00091,1,3142589,3146179,-,3590
159,BUMA.1121.00047,1,1538988,1542523,-,3535
159,BUMA.1121.00067,1,3000733,3004309,-,3576
159,BUMA.1121.00110,1,3390021,3393579,-,3558
159,BUMA.1121.00073,1,1388237,1391743,+,3506
159,BUMA.1121.00072,1,1362634,1366139,+,3505
159,BUMA.1121.00077,1,89192,92750,+,3558
159,BUMA.1121.00082,1,1520628,1524134,+,3506
159,BUMA.1121.00062,1,3165752,3169297,-,3545
159,BUMA.1121.00007,1,2709177,2712711,-,3534
159,BUMA.1121.00025,1,1254963,1258542,-,3579
159,BUMA.1121.00021,1,2060176,2063755,+,3579
159,BUMA.1121.00103,1,3002741,3006364,-,3623
159,BUMA.1121.00096,1,1866486,1870013,-,3527
159,BUMA.1121.00079,1,1430238,1433815,+,3577
159,BUMA.1121.00039,1,1544902,1548457,+,3555
159,BUMA.1121.00083,1,180677,184183,-,3506
159,BUMA.1121.00084,1,1633525,1637055,+,3530
159,BUMA.1121.00049,1,463420,466957,-,3537
159,BUMA.1121.00089,1,1405042,1408584,+,3542
159,BUMA.1121.00014,1,1372091,1375631,-,3540
159,BUMA.1121.00090,1,3562052,3565614,+,3562
159,BUMA.1121.00071,1,1380059,1383565,+,3506
159,BUMA.1121.00078,1,550201,553708,-,3507
159,BUMA.1121.00102,1,4004983,4008613,-,3630
159,BUMA.1121.00075,1,902053,905601,+,3548
159,BUMA.1121.00012,1,101514,105044,+,3530
159,BUMA.1121.00076,1,3907355,3910903,-,3548
159,BUMA.1121.00106,1,1158608,1162155,+,3547
159,BUMA.1121.00001,1,2645129,2648699,-,3570
159,BUMA.1121.00107,1,1310156,1313733,+,3577
159,BUMA.1121.00104,1,3828429,3831960,-,3531
159,BUMA.1121.00099,1,983008,986651,-,3643
159,BUMA.1121.00098,1,4171570,4175176,+,3606
159,BUMA.1121.00111,1,1558233,1561796,+,3563
159,BUMA.1121.00109,1,516554,520122,-,3568
159,BUMA.1121.00097,1,2602489,2606093,-,3604
159,BUMA.1121.00094,1,1436400,1439942,+,3542
159,BUMA.1121.00095,1,274444,277986,-,3542
159,BUMA.1121.00005,1,87255,90789,+,3534
159,BUMA.1121.00101,1,1082527,1086107,-,3580
159,BUMA.1121.00065,1,1506858,1510428,+,3570
159,BUMA.1121.00100,1,3921750,3925362,-,3612
159,BUMA.1121.00105,1,3826538,3830130,-,3592
159,BUMA.1121.00029,1,3519221,3522800,-,3579
159,BUMA.1121.00066,1,1364156,1367660,+,3504
159,BUMA.1121.00031,1,2841305,2844845,+,3540
159,BUMA.1121.00108,1,2381083,2384644,+,3561
159,BUMA.1121.00023,1,3821578,3825125,+,3547
159,BUMA.1121.00035,1,2561719,2565283,+,3564
159,BUMA.1121.00041,1,2711960,2715495,+,3535
158,BUMA.1121.00057,1,2480700,2488552,+,7852
158,BUMA.1121.00058,1,3159691,3167562,-,7871
158,BUMA.1121.00045,1,2651277,2659144,-,7867
158,BUMA.1121.00051,1,1389679,1397519,+,7840
158,BUMA.1121.00068,1,141629,149554,+,7925
158,BUMA.1121.00061,1,1382226,1390028,+,7802
158,BUMA.1121.00060,1,877018,884885,-,7867
158,BUMA.1121.00064,1,1405859,1413737,+,7878
158,BUMA.1121.00016,1,3559064,3566907,+,7843
158,BUMA.1121.00003,1,3868929,3876728,+,7799
158,BUMA.1121.00055,1,985882,993707,+,7825
158,BUMA.1121.00011,1,185664,193639,-,7975
158,BUMA.1121.00037,1,23077,30917,+,7840
158,BUMA.1121.00009,1,188206,196120,-,7914
158,BUMA.1121.00069,1,1335387,1343192,+,7805
158,BUMA.1121.00088,1,2296248,2304104,+,7856
158,BUMA.1121.00092,1,2473174,2480964,-,7790
158,BUMA.1121.00074,1,2446575,2454448,-,7873
158,BUMA.1121.00070,1,1353198,1361007,+,7809
158,BUMA.1121.00093,1,2145373,2153163,+,7790
158,BUMA.1121.00063,1,1379299,1387104,+,7805
158,BUMA.1121.00109,2,891782,899596,-,7814
158,BUMA.1121.00033,1,3661437,3669271,+,7834
158,BUMA.1121.00018,1,1993369,2001223,+,7854
158,BUMA.1121.00080,1,1416875,1424694,+,7819
158,BUMA.1121.00027,1,3592652,3600497,+,7845
158,BUMA.1121.00053,1,1124485,1132396,+,7911
158,BUMA.1121.00059,1,608092,615959,+,7867
158,BUMA.1121.00043,1,1455073,1462917,+,7844
158,BUMA.1121.00056,1,2531187,2539021,-,7834
158,BUMA.1121.00112,1,1652429,1660340,-,7911
158,BUMA.1121.00091,1,3146181,3154024,-,7843
158,BUMA.1121.00047,1,1552852,1560706,-,7854
158,BUMA.1121.00067,1,3015836,3023726,-,7890
158,BUMA.1121.00110,1,3393581,3401511,-,7930
158,BUMA.1121.00073,1,1380427,1388236,+,7809
158,BUMA.1121.00072,1,1354851,1362633,+,7782
158,BUMA.1121.00077,1,81261,89191,+,7930
158,BUMA.1121.00082,1,1512812,1520627,+,7815
158,BUMA.1121.00062,1,3169299,3177168,-,7869
158,BUMA.1121.00007,1,2712713,2720605,-,7892
158,BUMA.1121.00025,1,1258544,1266391,-,7847
158,BUMA.1121.00021,1,2039494,2047374,+,7880
158,BUMA.1121.00103,1,3006366,3014179,-,7813
158,BUMA.1121.00096,1,1870015,1877887,-,7872
158,BUMA.1121.00079,1,1412096,1419921,+,7825
158,BUMA.1121.00039,1,1535755,1544901,+,9146
158,BUMA.1121.00083,1,184185,192000,-,7815
158,BUMA.1121.00084,1,1625661,1633524,+,7863
158,BUMA.1121.00049,1,477283,485125,-,7842
158,BUMA.1121.00089,1,1386879,1394713,+,7834
158,BUMA.1121.00014,1,1375633,1383484,-,7851
158,BUMA.1121.00090,1,3554225,3562051,+,7826
158,BUMA.1121.00071,1,1372262,1380058,+,7796
158,BUMA.1121.00078,1,553710,561537,-,7827
158,BUMA.1121.00102,1,4008615,4016449,-,7834
158,BUMA.1121.00075,1,894202,902052,+,7850
158,BUMA.1121.00012,1,26178,34018,+,7840
158,BUMA.1121.00076,1,3910905,3918756,-,7851
158,BUMA.1121.00106,1,1140426,1148282,+,7856
158,BUMA.1121.00001,1,2648701,2656584,-,7883
158,BUMA.1121.00107,1,1302312,1310155,+,7843
158,BUMA.1121.00104,1,3842286,3850162,-,7876
158,BUMA.1121.00099,1,986653,994540,-,7887
158,BUMA.1121.00098,1,4163658,4171569,+,7911
158,BUMA.1121.00111,1,1550376,1558232,+,7856
158,BUMA.1121.00097,1,2606095,2613982,-,7887
158,BUMA.1121.00094,1,1418246,1426073,+,7827
158,BUMA.1121.00095,1,277988,285899,-,7911
158,BUMA.1121.00005,1,79454,87254,+,7800
158,BUMA.1121.00101,1,1086109,1093970,-,7861
158,BUMA.1121.00065,1,1498956,1506857,+,7901
158,BUMA.1121.00100,1,3925364,3933224,-,7860
158,BUMA.1121.00105,1,3830132,3837972,-,7840
158,BUMA.1121.00029,1,3522802,3530657,-,7855
158,BUMA.1121.00066,1,1356350,1364155,+,7805
158,BUMA.1121.00031,1,2833474,2841304,+,7830
158,BUMA.1121.00108,1,2373191,2381082,+,7891
158,BUMA.1121.00023,1,3813710,3821577,+,7867
158,BUMA.1121.00035,1,2553855,2561718,+,7863
158,BUMA.1121.00041,1,2704107,2711959,+,7852
157,BUMA.1121.00057,1,2472250,2478651,+,6401
157,BUMA.1121.00058,1,3169840,3175911,-,6071
157,BUMA.1121.00045,1,2661121,2667405,-,6284
157,BUMA.1121.00051,1,1381367,1387699,+,6332
157,BUMA.1121.00068,1,132966,139607,+,6641
157,BUMA.1121.00061,1,1373857,1380214,+,6357
157,BUMA.1121.00060,1,886862,893146,-,6284
157,BUMA.1121.00064,1,1397568,1403888,+,6320
157,BUMA.1121.00016,1,3550658,3557000,+,6342
157,BUMA.1121.00003,1,3862272,3868607,+,6335
157,BUMA.1121.00055,1,977542,983893,+,6351
157,BUMA.1121.00011,1,195938,201919,-,5981
157,BUMA.1121.00037,1,14688,21025,+,6337
157,BUMA.1121.00009,1,198401,204438,-,6037
157,BUMA.1121.00069,1,1327012,1333371,+,6359
157,BUMA.1121.00088,1,2287759,2294253,+,6494
157,BUMA.1121.00092,1,2482968,2489346,-,6378
157,BUMA.1121.00074,1,2456744,2462789,-,6045
157,BUMA.1121.00070,1,1344826,1351182,+,6356
157,BUMA.1121.00093,1,2136991,2143369,+,6378
157,BUMA.1121.00063,1,1370930,1377284,+,6354
157,BUMA.1121.00109,2,901579,907890,-,6311
157,BUMA.1121.00033,1,3653088,3659427,+,6339
157,BUMA.1121.00018,1,1984989,1991329,+,6340
157,BUMA.1121.00080,1,1408556,1414895,+,6339
157,BUMA.1121.00027,1,3584219,3590627,+,6408
157,BUMA.1121.00053,1,1116178,1122502,+,6324
157,BUMA.1121.00059,1,599898,606335,+,6437
157,BUMA.1121.00043,1,1446717,1453051,+,6334
157,BUMA.1121.00056,1,2541299,2547337,-,6038
157,BUMA.1121.00112,1,1662602,1668665,-,6063
157,BUMA.1121.00091,1,3156296,3162419,-,6123
157,BUMA.1121.00047,1,1562987,1569015,-,6028
157,BUMA.1121.00067,1,3026025,3032084,-,6059
157,BUMA.1121.00110,1,3403503,3409827,-,6324
157,BUMA.1121.00073,1,1372038,1378411,+,6373
157,BUMA.1121.00072,1,1346472,1352836,+,6364
157,BUMA.1121.00077,1,72946,79270,+,6324
157,BUMA.1121.00082,1,1504423,1510796,+,6373
157,BUMA.1121.00062,1,3179157,3185600,-,6443
157,BUMA.1121.00007,1,2722892,2728927,-,6035
157,BUMA.1121.00025,1,1268714,1274765,-,6051
157,BUMA.1121.00021,1,2031155,2037487,+,6332
157,BUMA.1121.00103,1,3016115,3022411,-,6296
157,BUMA.1121.00096,1,1880282,1886378,-,6096
157,BUMA.1121.00079,1,1403767,1410098,+,6331
157,BUMA.1121.00039,1,1527343,1533739,+,6396
157,BUMA.1121.00083,1,194016,200389,-,6373
157,BUMA.1121.00084,1,1617281,1623672,+,6391
157,BUMA.1121.00049,1,487409,493412,-,6003
157,BUMA.1121.00089,1,1378563,1384890,+,6327
157,BUMA.1121.00014,1,1385800,1391867,-,6067
157,BUMA.1121.00090,1,3545813,3552143,+,6330
157,BUMA.1121.00071,1,1363902,1370246,+,6344
157,BUMA.1121.00078,1,563818,569897,-,6079
157,BUMA.1121.00102,1,4018438,4024825,-,6387
157,BUMA.1121.00075,1,885814,892216,+,6402
157,BUMA.1121.00012,1,17835,24162,+,6327
157,BUMA.1121.00076,1,3920742,3927130,-,6388
157,BUMA.1121.00106,1,1132027,1138431,+,6404
157,BUMA.1121.00001,1,2658919,2665008,-,6089
157,BUMA.1121.00107,1,1294019,1300329,+,6310
157,BUMA.1121.00104,1,3852452,3858511,-,6059
157,BUMA.1121.00099,1,996815,1002920,-,6105
157,BUMA.1121.00098,1,4155370,4161678,+,6308
157,BUMA.1121.00111,1,1542049,1548372,+,6323
157,BUMA.1121.00097,1,2616251,2622452,-,6201
157,BUMA.1121.00094,1,1409911,1416245,+,6334
157,BUMA.1121.00095,1,288180,294145,-,5965
157,BUMA.1121.00005,1,71222,77468,+,6246
157,BUMA.1121.00101,1,1096248,1102305,-,6057
157,BUMA.1121.00065,1,1490655,1496979,+,6324
157,BUMA.1121.00100,1,3935240,3941568,-,6328
157,BUMA.1121.00105,1,3839988,3846363,-,6375
157,BUMA.1121.00029,1,3532986,3539048,-,6062
157,BUMA.1121.00066,1,1347986,1354334,+,6348
157,BUMA.1121.00031,1,2825096,2831440,+,6344
157,BUMA.1121.00108,1,2364760,2371193,+,6433
157,BUMA.1121.00023,1,3805370,3811688,+,6318
157,BUMA.1121.00035,1,2545460,2551809,+,6349
157,BUMA.1121.00041,1,2695845,2702127,+,6282
156,BUMA.1121.00057,1,2466025,2472171,+,6146
156,BUMA.1121.00058,1,3175990,3182105,-,6115
156,BUMA.1121.00045,1,2667484,2673614,-,6130
156,BUMA.1121.00051,1,1375268,1381287,+,6019
156,BUMA.1121.00068,1,126789,132886,+,6097
156,BUMA.1121.00061,1,1367621,1373778,+,6157
156,BUMA.1121.00060,1,893225,899355,-,6130
156,BUMA.1121.00064,1,1391394,1397488,+,6094
156,BUMA.1121.00016,1,3544247,3550579,+,6332
156,BUMA.1121.00003,1,3855886,3862188,+,6302
156,BUMA.1121.00055,1,971382,977462,+,6080
156,BUMA.1121.00011,1,201999,208118,-,6119
156,BUMA.1121.00037,1,8476,14609,+,6133
156,BUMA.1121.00009,1,204517,210649,-,6132
156,BUMA.1121.00069,1,1320776,1326933,+,6157
156,BUMA.1121.00088,1,2281564,2287680,+,6116
156,BUMA.1121.00092,1,2489426,2495553,-,6127
156,BUMA.1121.00074,1,2462869,2468962,-,6093
156,BUMA.1121.00070,1,1338590,1344747,+,6157
156,BUMA.1121.00093,1,2130783,2136911,+,6128
156,BUMA.1121.00063,1,1364695,1370851,+,6156
156,BUMA.1121.00109,2,907970,914106,-,6136
156,BUMA.1121.00033,1,3646866,3653009,+,6143
156,BUMA.1121.00018,1,1978767,1984910,+,6143
156,BUMA.1121.00080,1,1402457,1408476,+,6019
156,BUMA.1121.00027,1,3577983,3584140,+,6157
156,BUMA.1121.00053,1,1109968,1116099,+,6131
156,BUMA.1121.00059,1,593693,599819,+,6126
156,BUMA.1121.00043,1,1440317,1446638,+,6321
156,BUMA.1121.00056,1,2547417,2553435,-,6018
156,BUMA.1121.00112,1,1668744,1674948,-,6204
156,BUMA.1121.00091,1,3162499,3168578,-,6079
156,BUMA.1121.00047,1,1569095,1575113,-,6018
156,BUMA.1121.00067,1,3032164,3038257,-,6093
156,BUMA.1121.00110,1,3409906,3416042,-,6136
156,BUMA.1121.00073,1,1365802,1371959,+,6157
156,BUMA.1121.00072,1,1340237,1346393,+,6156
156,BUMA.1121.00077,1,66730,72867,+,6137
156,BUMA.1121.00082,1,1498187,1504344,+,6157
156,BUMA.1121.00062,1,3185679,3191804,-,6125
156,BUMA.1121.00007,1,2729007,2735124,-,6117
156,BUMA.1121.00025,1,1274855,1280986,-,6131
156,BUMA.1121.00021,1,2024923,2031076,+,6153
156,BUMA.1121.00103,1,3022495,3028710,-,6215
156,BUMA.1121.00096,1,1886462,1892784,-,6322
156,BUMA.1121.00079,1,1397561,1403687,+,6126
156,BUMA.1121.00039,1,1520937,1527264,+,6327
156,BUMA.1121.00083,1,200468,206624,-,6156
156,BUMA.1121.00084,1,1611086,1617202,+,6116
156,BUMA.1121.00049,1,493492,499596,-,6104
156,BUMA.1121.00089,1,1372464,1378483,+,6019
156,BUMA.1121.00014,1,1391946,1398078,-,6132
156,BUMA.1121.00090,1,3539591,3545734,+,6143
156,BUMA.1121.00071,1,1357670,1363823,+,6153
156,BUMA.1121.00078,1,569977,576098,-,6121
156,BUMA.1121.00102,1,4024904,4031132,-,6228
156,BUMA.1121.00075,1,879618,885734,+,6116
156,BUMA.1121.00012,1,11624,17756,+,6132
156,BUMA.1121.00076,1,3927210,3933317,-,6107
156,BUMA.1121.00106,1,1125842,1131947,+,6105
156,BUMA.1121.00001,1,2665098,2671229,-,6131
156,BUMA.1121.00107,1,1287507,1293940,+,6433
156,BUMA.1121.00104,1,3858591,3864618,-,6027
156,BUMA.1121.00099,1,1002999,1009420,-,6421
156,BUMA.1121.00098,1,4149137,4155268,+,6131
156,BUMA.1121.00111,1,1535837,1541970,+,6133
156,BUMA.1121.00097,1,2622532,2628736,-,6204
156,BUMA.1121.00094,1,1403812,1409831,+,6019
156,BUMA.1121.00095,1,294225,300352,-,6127
156,BUMA.1121.00005,1,65005,71142,+,6137
156,BUMA.1121.00101,1,1102385,1108588,-,6203
156,BUMA.1121.00065,1,1484547,1490575,+,6028
156,BUMA.1121.00100,1,3941652,3947750,-,6098
156,BUMA.1121.00105,1,3846442,3852578,-,6136
156,BUMA.1121.00029,1,3540452,3546584,-,6132
156,BUMA.1121.00066,1,1341750,1347907,+,6157
156,BUMA.1121.00031,1,2818884,2825017,+,6133
156,BUMA.1121.00108,1,2358558,2364680,+,6122
156,BUMA.1121.00023,1,3799147,3805291,+,6144
156,BUMA.1121.00035,1,2539238,2545381,+,6143
156,BUMA.1121.00041,1,2689644,2695765,+,6121
155,BUMA.1121.00057,1,2449144,2454309,+,5165
155,BUMA.1121.00058,1,3193759,3198933,-,5174
155,BUMA.1121.00045,1,2685279,2690433,-,5154
155,BUMA.1121.00051,1,1358361,1363516,+,5155
155,BUMA.1121.00068,1,109848,115033,+,5185
155,BUMA.1121.00061,1,1350761,1355916,+,5155
155,BUMA.1121.00060,1,911013,916167,-,5154
155,BUMA.1121.00064,1,1374551,1379706,+,5155
155,BUMA.1121.00016,1,3527338,3532503,+,5165
155,BUMA.1121.00003,1,3839057,3844202,+,5145
155,BUMA.1121.00055,1,954509,959674,+,5165
155,BUMA.1121.00011,1,219931,225085,-,5154
155,BUMA.1121.00037,1,4019095,4024260,+,5165
155,BUMA.1121.00009,1,222474,227628,-,5154
155,BUMA.1121.00069,1,1303916,1309071,+,5155
155,BUMA.1121.00088,1,2264652,2269817,+,5165
155,BUMA.1121.00092,1,2507352,2512516,-,5164
155,BUMA.1121.00074,1,2480707,2485861,-,5154
155,BUMA.1121.00070,1,1321730,1326885,+,5155
155,BUMA.1121.00093,1,2113897,2119062,+,5165
155,BUMA.1121.00063,1,1347834,1352990,+,5156
155,BUMA.1121.00109,2,925803,930957,-,5154
155,BUMA.1121.00033,1,3590866,3596031,+,5165
155,BUMA.1121.00018,1,1961966,1967141,+,5175
155,BUMA.1121.00080,1,1385515,1390670,+,5155
155,BUMA.1121.00027,1,3560956,3566121,+,5165
155,BUMA.1121.00053,1,1092995,1098140,+,5145
155,BUMA.1121.00059,1,576850,581997,+,5147
155,BUMA.1121.00043,1,1423302,1428457,+,5155
155,BUMA.1121.00056,1,2565202,2570366,-,5164
155,BUMA.1121.00112,1,1686634,1691788,-,5154
155,BUMA.1121.00091,1,3180224,3185368,-,5144
155,BUMA.1121.00047,1,1586987,1592141,-,5154
155,BUMA.1121.00067,1,3050013,3055167,-,5154
155,BUMA.1121.00110,1,3427755,3432919,-,5164
155,BUMA.1121.00073,1,1348942,1354097,+,5155
155,BUMA.1121.00072,1,1323412,1328567,+,5155
155,BUMA.1121.00077,1,49864,55029,+,5165
155,BUMA.1121.00082,1,1481327,1486482,+,5155
155,BUMA.1121.00062,1,3203582,3208746,-,5164
155,BUMA.1121.00007,1,2746875,2752068,-,5193
155,BUMA.1121.00025,1,1292732,1297906,-,5174
155,BUMA.1121.00021,1,2008007,2013172,+,5165
155,BUMA.1121.00103,1,3040532,3045706,-,5174
155,BUMA.1121.00096,1,1904445,1909598,-,5153
155,BUMA.1121.00079,1,1380671,1385825,+,5154
155,BUMA.1121.00039,1,1503782,1508947,+,5165
155,BUMA.1121.00083,1,218351,223505,-,5154
155,BUMA.1121.00084,1,1594159,1599324,+,5165
155,BUMA.1121.00049,1,511271,516435,-,5164
155,BUMA.1121.00089,1,1355533,1360698,+,5165
155,BUMA.1121.00014,1,1409969,1415133,-,5164
155,BUMA.1121.00090,1,3522685,3527840,+,5155
155,BUMA.1121.00071,1,1340810,1345965,+,5155
155,BUMA.1121.00078,1,587883,593037,-,5154
155,BUMA.1121.00102,1,4043342,4048506,-,5164
155,BUMA.1121.00075,1,862785,867950,+,5165
155,BUMA.1121.00012,1,4189885,4195050,+,5165
155,BUMA.1121.00076,1,11691,16855,-,5164
155,BUMA.1121.00106,1,1108864,1114029,+,5165
155,BUMA.1121.00001,1,2683052,2688206,-,5154
155,BUMA.1121.00107,1,1270618,1275771,+,5153
155,BUMA.1121.00104,1,3876320,3881474,-,5154
155,BUMA.1121.00099,1,1021299,1026453,-,5154
155,BUMA.1121.00098,1,4132009,4137164,+,5155
155,BUMA.1121.00111,1,1518978,1524143,+,5165
155,BUMA.1121.00097,1,2640357,2645521,-,5164
155,BUMA.1121.00094,1,1386905,1392070,+,5165
155,BUMA.1121.00095,1,312103,317255,-,5152
155,BUMA.1121.00005,1,48026,53191,+,5165
155,BUMA.1121.00101,1,1120298,1125440,-,5142
155,BUMA.1121.00065,1,1467659,1472824,+,5165
155,BUMA.1121.00100,1,3959515,3964669,-,5154
155,BUMA.1121.00105,1,3864344,3869508,-,5164
155,BUMA.1121.00029,1,3558361,3563515,-,5154
155,BUMA.1121.00066,1,1324890,1330045,+,5155
155,BUMA.1121.00031,1,2801921,2807086,+,5165
155,BUMA.1121.00108,1,2341727,2346892,+,5165
155,BUMA.1121.00023,1,3782274,3787439,+,5165
155,BUMA.1121.00035,1,2522297,2527452,+,5155
155,BUMA.1121.00041,1,2672783,2677938,+,5155
154,BUMA.1121.00057,1,2405590,2442033,+,36443
154,BUMA.1121.00058,1,3206041,3242435,-,36394
154,BUMA.1121.00045,1,2697530,2733865,-,36335
154,BUMA.1121.00051,1,1314819,1351253,+,36434
154,BUMA.1121.00068,1,66351,102710,+,36359
154,BUMA.1121.00061,1,1307253,1343650,+,36397
154,BUMA.1121.00060,1,923264,959599,-,36335
154,BUMA.1121.00064,1,1331050,1367443,+,36393
154,BUMA.1121.00016,1,3483827,3520215,+,36388
154,BUMA.1121.00003,1,3795544,3831951,+,36407
154,BUMA.1121.00055,1,911000,947399,+,36399
154,BUMA.1121.00011,1,232205,268563,-,36358
154,BUMA.1121.00037,1,3975528,4011960,+,36432
154,BUMA.1121.00009,1,234736,271134,-,36398
154,BUMA.1121.00069,1,1260406,1296806,+,36400
154,BUMA.1121.00088,1,2221110,2257541,+,36431
154,BUMA.1121.00092,1,2519609,2555988,-,36379
154,BUMA.1121.00074,1,2492958,2529359,-,36401
154,BUMA.1121.00070,1,1278220,1314619,+,36399
154,BUMA.1121.00093,1,2070427,2106805,+,36378
154,BUMA.1121.00063,1,1304326,1340725,+,36399
154,BUMA.1121.00109,2,938066,974403,-,36337
154,BUMA.1121.00033,1,3547325,3583718,+,36393
154,BUMA.1121.00018,1,1918480,1954840,+,36360
154,BUMA.1121.00080,1,1341956,1378418,+,36462
154,BUMA.1121.00027,1,3517452,3553846,+,36394
154,BUMA.1121.00053,1,1049517,1085884,+,36367
154,BUMA.1121.00059,1,533324,569742,+,36418
154,BUMA.1121.00043,1,1379763,1416180,+,36417
154,BUMA.1121.00056,1,2577474,2613903,-,36429
154,BUMA.1121.00112,1,1698907,1735321,-,36414
154,BUMA.1121.00091,1,3192476,3228873,-,36397
154,BUMA.1121.00047,1,1599240,1635655,-,36415
154,BUMA.1121.00067,1,3062266,3098648,-,36382
154,BUMA.1121.00110,1,3440019,3476374,-,36355
154,BUMA.1121.00073,1,1305431,1341831,+,36400
154,BUMA.1121.00072,1,1279918,1316302,+,36384
154,BUMA.1121.00077,1,6409,42765,+,36356
154,BUMA.1121.00082,1,1437785,1474216,+,36431
154,BUMA.1121.00062,1,3215854,3252362,-,36508
154,BUMA.1121.00007,1,2759165,2795541,-,36376
154,BUMA.1121.00025,1,1305033,1341394,-,36361
154,BUMA.1121.00021,1,1964503,2000885,+,36382
154,BUMA.1121.00103,1,3052821,3089155,-,36334
154,BUMA.1121.00096,1,1916733,1953107,-,36374
154,BUMA.1121.00079,1,1337109,1373565,+,36456
154,BUMA.1121.00039,1,1460320,1496679,+,36359
154,BUMA.1121.00083,1,230617,267048,-,36431
154,BUMA.1121.00084,1,1550692,1587048,+,36356
154,BUMA.1121.00049,1,523532,559905,-,36373
154,BUMA.1121.00089,1,1311997,1348426,+,36429
154,BUMA.1121.00014,1,1422230,1458625,-,36395
154,BUMA.1121.00090,1,3479117,3515550,+,36433
154,BUMA.1121.00071,1,1297301,1333699,+,36398
154,BUMA.1121.00078,1,600131,636495,-,36364
154,BUMA.1121.00102,1,4055603,4092011,-,36408
154,BUMA.1121.00075,1,819165,855679,+,36514
154,BUMA.1121.00012,1,4146342,4182737,+,36395
154,BUMA.1121.00076,1,23963,60480,-,36517
154,BUMA.1121.00106,1,1065227,1101754,+,36527
154,BUMA.1121.00001,1,2695369,2731734,-,36365
154,BUMA.1121.00107,1,1227148,1263494,+,36346
154,BUMA.1121.00104,1,3888511,3924896,-,36385
154,BUMA.1121.00099,1,1033596,1069998,-,36402
154,BUMA.1121.00098,1,4088509,4124890,+,36381
154,BUMA.1121.00111,1,1475442,1511866,+,36424
154,BUMA.1121.00097,1,2652641,2688985,-,36344
154,BUMA.1121.00094,1,1343333,1379798,+,36465
154,BUMA.1121.00095,1,324363,360770,-,36407
154,BUMA.1121.00005,1,4570,40936,+,36366
154,BUMA.1121.00101,1,1132585,1168956,-,36371
154,BUMA.1121.00065,1,1424171,1460568,+,36397
154,BUMA.1121.00100,1,3971791,4008171,-,36380
154,BUMA.1121.00105,1,3876616,3913086,-,36470
154,BUMA.1121.00029,1,3570652,3607045,-,36393
154,BUMA.1121.00066,1,1281380,1317779,+,36399
154,BUMA.1121.00031,1,2758403,2794825,+,36422
154,BUMA.1121.00108,1,2298226,2334578,+,36352
154,BUMA.1121.00023,1,3738788,3775165,+,36377
154,BUMA.1121.00035,1,2478711,2515161,+,36450
154,BUMA.1121.00041,1,2629319,2665694,+,36375
153,BUMA.1121.00057,1,2392056,2399160,+,7104
153,BUMA.1121.00058,1,3248901,3256005,-,7104
153,BUMA.1121.00045,1,2740292,2747396,-,7104
153,BUMA.1121.00051,1,1301248,1308351,+,7103
153,BUMA.1121.00068,1,51467,59884,+,8417
153,BUMA.1121.00061,1,1293714,1300818,+,7104
153,BUMA.1121.00060,1,966026,973130,-,7104
153,BUMA.1121.00064,1,1317468,1324572,+,7104
153,BUMA.1121.00016,1,3470306,3477410,+,7104
153,BUMA.1121.00003,1,3781927,3789036,+,7109
153,BUMA.1121.00055,1,897431,904535,+,7104
153,BUMA.1121.00011,1,274980,282085,-,7105
153,BUMA.1121.00037,1,3961994,3969098,+,7104
153,BUMA.1121.00009,1,277558,284662,-,7104
153,BUMA.1121.00069,1,1246866,1253970,+,7104
153,BUMA.1121.00088,1,2207528,2214632,+,7104
153,BUMA.1121.00092,1,2562455,2569559,-,7104
153,BUMA.1121.00074,1,2535837,2542941,-,7104
153,BUMA.1121.00070,1,1264682,1271786,+,7104
153,BUMA.1121.00093,1,2056855,2063959,+,7104
153,BUMA.1121.00063,1,1290787,1297891,+,7104
153,BUMA.1121.00033,1,3533798,3540902,+,7104
153,BUMA.1121.00018,1,1904946,1912050,+,7104
153,BUMA.1121.00080,1,1328423,1335527,+,7104
153,BUMA.1121.00027,1,3503920,3511023,+,7103
153,BUMA.1121.00053,1,1034777,1041881,+,7104
153,BUMA.1121.00059,1,519790,526894,+,7104
153,BUMA.1121.00043,1,1366238,1373342,+,7104
153,BUMA.1121.00056,1,2620331,2627435,-,7104
153,BUMA.1121.00112,1,1741753,1748857,-,7104
153,BUMA.1121.00091,1,3235301,3242405,-,7104
153,BUMA.1121.00047,1,1642083,1649187,-,7104
153,BUMA.1121.00067,1,3105083,3112187,-,7104
153,BUMA.1121.00110,1,3482840,3489944,-,7104
153,BUMA.1121.00073,1,1291892,1298996,+,7104
153,BUMA.1121.00072,1,1266378,1273482,+,7104
153,BUMA.1121.00077,1,4002383,4009467,+,7084
153,BUMA.1121.00082,1,1424245,1431349,+,7104
153,BUMA.1121.00062,1,3258792,3265896,-,7104
153,BUMA.1121.00007,1,2803189,2810293,-,7104
153,BUMA.1121.00025,1,1347823,1354927,-,7104
153,BUMA.1121.00021,1,1947876,1954980,+,7104
153,BUMA.1121.00103,1,3095579,3102683,-,7104
153,BUMA.1121.00096,1,1960854,1967958,-,7104
153,BUMA.1121.00079,1,1323576,1330680,+,7104
153,BUMA.1121.00039,1,1446194,1453298,+,7104
153,BUMA.1121.00083,1,273483,280587,-,7104
153,BUMA.1121.00084,1,1537157,1544261,+,7104
153,BUMA.1121.00049,1,566370,573474,-,7104
153,BUMA.1121.00089,1,1298464,1305568,+,7104
153,BUMA.1121.00014,1,1466286,1473390,-,7104
153,BUMA.1121.00090,1,3465587,3472691,+,7104
153,BUMA.1121.00071,1,1283762,1290866,+,7104
153,BUMA.1121.00078,1,642909,650011,-,7102
153,BUMA.1121.00102,1,4098484,4105588,-,7104
153,BUMA.1121.00075,1,805599,812703,+,7104
153,BUMA.1121.00012,1,4132812,4139916,+,7104
153,BUMA.1121.00076,1,66948,74052,-,7104
153,BUMA.1121.00106,1,1051664,1058765,+,7101
153,BUMA.1121.00001,1,2738160,2745264,-,7104
153,BUMA.1121.00107,1,1213583,1220691,+,7108
153,BUMA.1121.00104,1,5818,12922,-,7104
153,BUMA.1121.00099,1,1076472,1084889,-,8417
153,BUMA.1121.00098,1,4073739,4080843,+,7104
153,BUMA.1121.00111,1,1461911,1469015,+,7104
153,BUMA.1121.00109,1,567023,574070,-,7047
153,BUMA.1121.00097,1,2695444,2702548,-,7104
153,BUMA.1121.00094,1,1329801,1336904,+,7103
153,BUMA.1121.00095,1,367189,374293,-,7104
153,BUMA.1121.00005,1,2276791,2283895,-,7104
153,BUMA.1121.00101,1,1175382,1182429,-,7047
153,BUMA.1121.00065,1,1410631,1417735,+,7104
153,BUMA.1121.00100,1,4014645,4021765,-,7120
153,BUMA.1121.00105,1,3919555,3926659,-,7104
153,BUMA.1121.00029,1,3613473,3620577,-,7104
153,BUMA.1121.00066,1,1267845,1274949,+,7104
153,BUMA.1121.00031,1,2743637,2750741,+,7104
153,BUMA.1121.00108,1,2284693,2291797,+,7104
153,BUMA.1121.00023,1,3724022,3731126,+,7104
153,BUMA.1121.00035,1,2465177,2472281,+,7104
153,BUMA.1121.00041,1,2614547,2621651,+,7104
152,BUMA.1121.00057,1,2340646,2392055,+,51409
152,BUMA.1121.00058,1,3256007,3307414,-,51407
152,BUMA.1121.00045,1,2747398,2798806,-,51408
152,BUMA.1121.00051,1,1249828,1301247,+,51419
152,BUMA.1121.00068,1,34,51466,+,51432
152,BUMA.1121.00061,1,1242304,1293713,+,51409
152,BUMA.1121.00060,1,973132,1024540,-,51408
152,BUMA.1121.00064,1,1266057,1317467,+,51410
152,BUMA.1121.00016,1,3418882,3470305,+,51423
152,BUMA.1121.00003,1,3730482,3781926,+,51444
152,BUMA.1121.00055,1,845988,897430,+,51442
152,BUMA.1121.00011,1,282087,333512,-,51425
152,BUMA.1121.00037,1,3910569,3961993,+,51424
152,BUMA.1121.00009,1,284664,336074,-,51410
152,BUMA.1121.00069,1,1195457,1246865,+,51408
152,BUMA.1121.00088,1,2156145,2207527,+,51382
152,BUMA.1121.00092,1,2569561,2620969,-,51408
152,BUMA.1121.00074,1,2542943,2594352,-,51409
152,BUMA.1121.00070,1,1213272,1264681,+,51409
152,BUMA.1121.00093,1,2005445,2056854,+,51409
152,BUMA.1121.00063,1,1239377,1290786,+,51409
152,BUMA.1121.00033,1,3482367,3533797,+,51430
152,BUMA.1121.00018,1,1853521,1904945,+,51424
152,BUMA.1121.00080,1,1277001,1328422,+,51421
152,BUMA.1121.00027,1,3452511,3503919,+,51408
152,BUMA.1121.00053,1,983354,1034776,+,51422
152,BUMA.1121.00059,1,468381,519789,+,51408
152,BUMA.1121.00043,1,1314817,1366237,+,51420
152,BUMA.1121.00056,1,2627437,2678862,-,51425
152,BUMA.1121.00112,1,1748859,1800277,-,51418
152,BUMA.1121.00091,1,3242407,3293815,-,51408
152,BUMA.1121.00047,1,1649189,1700614,-,51425
152,BUMA.1121.00067,1,3112189,3163609,-,51420
152,BUMA.1121.00110,1,3489946,3541389,-,51443
152,BUMA.1121.00073,1,1240482,1291891,+,51409
152,BUMA.1121.00072,1,1215073,1266377,+,51304
152,BUMA.1121.00077,1,3950937,4002382,+,51445
152,BUMA.1121.00082,1,1372835,1424244,+,51409
152,BUMA.1121.00062,1,3265898,3317305,-,51407
152,BUMA.1121.00007,1,2810295,2861705,-,51410
152,BUMA.1121.00025,1,1354929,1406352,-,51423
152,BUMA.1121.00021,1,1896450,1947875,+,51425
152,BUMA.1121.00103,1,3102685,3154111,-,51426
152,BUMA.1121.00096,1,1967960,2019350,-,51390
152,BUMA.1121.00079,1,1272157,1323575,+,51418
152,BUMA.1121.00039,1,1394842,1446193,+,51351
152,BUMA.1121.00083,1,280589,331997,-,51408
152,BUMA.1121.00084,1,1485747,1537156,+,51409
152,BUMA.1121.00049,1,573476,624884,-,51408
152,BUMA.1121.00089,1,1247037,1298463,+,51426
152,BUMA.1121.00014,1,1473392,1524810,-,51418
152,BUMA.1121.00090,1,3414158,3465586,+,51428
152,BUMA.1121.00071,1,1232352,1283761,+,51409
152,BUMA.1121.00078,1,650013,701434,-,51421
152,BUMA.1121.00102,1,4105590,4157013,-,51423
152,BUMA.1121.00075,1,754175,805598,+,51423
152,BUMA.1121.00012,1,4081419,4132811,+,51392
152,BUMA.1121.00076,1,74054,125476,-,51422
152,BUMA.1121.00106,1,1000281,1051663,+,51382
152,BUMA.1121.00001,1,2745266,2796693,-,51427
152,BUMA.1121.00107,1,1162179,1213582,+,51403
152,BUMA.1121.00104,1,12924,64336,-,51412
152,BUMA.1121.00099,1,1084891,1136301,-,51410
152,BUMA.1121.00098,1,4022312,4073738,+,51426
152,BUMA.1121.00111,1,1410488,1461910,+,51422
152,BUMA.1121.00109,1,574072,625498,-,51426
152,BUMA.1121.00097,1,2702550,2753976,-,51426
152,BUMA.1121.00094,1,1278374,1329800,+,51426
152,BUMA.1121.00095,1,374295,425716,-,51421
152,BUMA.1121.00005,1,2283897,2335305,-,51408
152,BUMA.1121.00101,1,1182431,1233851,-,51420
152,BUMA.1121.00065,1,1359270,1410630,+,51360
152,BUMA.1121.00100,1,1,51383,-,51382
152,BUMA.1121.00105,1,3926661,3978076,-,51415
152,BUMA.1121.00029,1,3620579,3672007,-,51428
152,BUMA.1121.00066,1,1216435,1267844,+,51409
152,BUMA.1121.00031,1,2692217,2743636,+,51419
152,BUMA.1121.00108,1,2233339,2284692,+,51353
152,BUMA.1121.00023,1,3672597,3724021,+,51424
152,BUMA.1121.00035,1,2413747,2465176,+,51429
152,BUMA.1121.00041,1,2563092,2614546,+,51454
151,BUMA.1121.00057,1,2335039,2340645,+,5606
151,BUMA.1121.00058,1,3307416,3312981,-,5565
151,BUMA.1121.00045,1,2798808,2804419,-,5611
151,BUMA.1121.00051,1,1244200,1249827,+,5627
151,BUMA.1121.00068,1,4106652,4112209,+,5557
151,BUMA.1121.00061,1,1236697,1242303,+,5606
151,BUMA.1121.00060,1,1024542,1030153,-,5611
151,BUMA.1121.00064,1,1260422,1266056,+,5634
151,BUMA.1121.00016,1,3413282,3418881,+,5599
151,BUMA.1121.00003,1,3724857,3730481,+,5624
151,BUMA.1121.00055,1,840378,845987,+,5609
151,BUMA.1121.00011,1,333514,339107,-,5593
151,BUMA.1121.00037,1,3904988,3910568,+,5580
151,BUMA.1121.00009,1,336076,341707,-,5631
151,BUMA.1121.00069,1,1189850,1195456,+,5606
151,BUMA.1121.00088,1,2150546,2156144,+,5598
151,BUMA.1121.00092,1,2620971,2626556,-,5585
151,BUMA.1121.00074,1,2594354,2599995,-,5641
151,BUMA.1121.00070,1,1207665,1213271,+,5606
151,BUMA.1121.00093,1,1999859,2005444,+,5585
151,BUMA.1121.00063,1,1233785,1239376,+,5591
151,BUMA.1121.00033,1,3476789,3482366,+,5577
151,BUMA.1121.00018,1,1847928,1853520,+,5592
151,BUMA.1121.00080,1,1271409,1277000,+,5591
151,BUMA.1121.00027,1,3446940,3452510,+,5570
151,BUMA.1121.00053,1,977780,983353,+,5573
151,BUMA.1121.00059,1,462760,468380,+,5620
151,BUMA.1121.00043,1,1309232,1314816,+,5584
151,BUMA.1121.00056,1,2678864,2684461,-,5597
151,BUMA.1121.00112,1,1800279,1805849,-,5570
151,BUMA.1121.00091,1,3293817,3299395,-,5578
151,BUMA.1121.00047,1,1700616,1706227,-,5611
151,BUMA.1121.00067,1,3163611,3169182,-,5571
151,BUMA.1121.00110,1,3541391,3546930,-,5539
151,BUMA.1121.00073,1,1234875,1240481,+,5606
151,BUMA.1121.00072,1,1209466,1215072,+,5606
151,BUMA.1121.00077,1,3945397,3950936,+,5539
151,BUMA.1121.00082,1,1367228,1372834,+,5606
151,BUMA.1121.00062,1,3317307,3322899,-,5592
151,BUMA.1121.00007,1,2861707,2867272,-,5565
151,BUMA.1121.00025,1,1406354,1411946,-,5592
151,BUMA.1121.00021,1,1890850,1896449,+,5599
151,BUMA.1121.00103,1,3154113,3159736,-,5623
151,BUMA.1121.00096,1,2019352,2024949,-,5597
151,BUMA.1121.00079,1,1266529,1272156,+,5627
151,BUMA.1121.00039,1,1389261,1394841,+,5580
151,BUMA.1121.00083,1,331999,337605,-,5606
151,BUMA.1121.00084,1,1480134,1485746,+,5612
151,BUMA.1121.00049,1,624886,630499,-,5613
151,BUMA.1121.00089,1,1241438,1247036,+,5598
151,BUMA.1121.00014,1,1524812,1530404,-,5592
151,BUMA.1121.00090,1,3408580,3414157,+,5577
151,BUMA.1121.00071,1,1226760,1232351,+,5591
151,BUMA.1121.00078,1,701436,707047,-,5611
151,BUMA.1121.00102,1,4157015,4162623,-,5608
151,BUMA.1121.00075,1,748569,754174,+,5605
151,BUMA.1121.00012,1,4075827,4081418,+,5591
151,BUMA.1121.00076,1,125478,131091,-,5613
151,BUMA.1121.00106,1,994674,1000280,+,5606
151,BUMA.1121.00001,1,2796695,2802287,-,5592
151,BUMA.1121.00107,1,1156573,1162178,+,5605
151,BUMA.1121.00104,1,64338,69902,-,5564
151,BUMA.1121.00099,1,1136303,1141831,-,5528
151,BUMA.1121.00098,1,4016700,4022311,+,5611
151,BUMA.1121.00111,1,1404902,1410487,+,5585
151,BUMA.1121.00109,1,625500,631072,-,5572
151,BUMA.1121.00097,1,2753978,2759583,-,5605
151,BUMA.1121.00094,1,1272762,1278373,+,5611
151,BUMA.1121.00095,1,425718,431323,-,5605
151,BUMA.1121.00005,1,2335307,2340953,-,5646
151,BUMA.1121.00101,1,1233853,1239509,-,5656
151,BUMA.1121.00065,1,1353692,1359269,+,5577
151,BUMA.1121.00100,1,51385,57003,-,5618
151,BUMA.1121.00105,1,3978078,3983698,-,5620
151,BUMA.1121.00029,1,3672009,3677601,-,5592
151,BUMA.1121.00066,1,1210843,1216434,+,5591
151,BUMA.1121.00031,1,2686624,2692216,+,5592
151,BUMA.1121.00108,1,2227752,2233338,+,5586
151,BUMA.1121.00023,1,3666988,3672596,+,5608
151,BUMA.1121.00035,1,2408154,2413746,+,5592
151,BUMA.1121.00041,1,2557454,2563091,+,5637
150,BUMA.1121.00057,1,2331439,2334716,+,3277
150,BUMA.1121.00058,1,3313304,3316580,-,3276
150,BUMA.1121.00045,1,2804727,2808003,-,3276
150,BUMA.1121.00051,1,1240592,1243868,+,3276
150,BUMA.1121.00068,1,4103045,4106320,+,3275
150,BUMA.1121.00061,1,1233099,1236376,+,3277
150,BUMA.1121.00060,1,1030461,1033737,-,3276
150,BUMA.1121.00064,1,1256822,1260099,+,3277
150,BUMA.1121.00016,1,3409655,3412932,+,3277
150,BUMA.1121.00003,1,3721257,3724534,+,3277
150,BUMA.1121.00055,1,836778,840055,+,3277
150,BUMA.1121.00011,1,339448,342723,-,3275
150,BUMA.1121.00037,1,3901406,3904683,+,3277
150,BUMA.1121.00009,1,342037,345313,-,3276
150,BUMA.1121.00069,1,1186258,1189535,+,3277
150,BUMA.1121.00088,1,2146941,2150217,+,3276
150,BUMA.1121.00092,1,2626879,2630155,-,3276
150,BUMA.1121.00074,1,2600318,2603594,-,3276
150,BUMA.1121.00070,1,1204071,1207348,+,3277
150,BUMA.1121.00093,1,1996259,1999536,+,3277
150,BUMA.1121.00063,1,1230170,1233447,+,3277
150,BUMA.1121.00033,1,3473208,3476484,+,3276
150,BUMA.1121.00018,1,1844328,1847605,+,3277
150,BUMA.1121.00080,1,1267801,1271077,+,3276
150,BUMA.1121.00027,1,3443343,3446620,+,3277
150,BUMA.1121.00053,1,974183,977460,+,3277
150,BUMA.1121.00059,1,459160,462437,+,3277
150,BUMA.1121.00043,1,1305632,1308909,+,3277
150,BUMA.1121.00056,1,2684782,2688058,-,3276
150,BUMA.1121.00112,1,1806190,1809466,-,3276
150,BUMA.1121.00091,1,3299718,3302994,-,3276
150,BUMA.1121.00047,1,1706548,1709824,-,3276
150,BUMA.1121.00067,1,3169505,3172781,-,3276
150,BUMA.1121.00110,1,3547235,3550511,-,3276
150,BUMA.1121.00073,1,1231275,1234552,+,3277
150,BUMA.1121.00072,1,1205866,1209143,+,3277
150,BUMA.1121.00077,1,3941815,3945092,+,3277
150,BUMA.1121.00082,1,1363628,1366905,+,3277
150,BUMA.1121.00062,1,3323222,3326498,-,3276
150,BUMA.1121.00007,1,2867622,2870898,-,3276
150,BUMA.1121.00025,1,1412269,1415545,-,3276
150,BUMA.1121.00021,1,1887250,1890527,+,3277
150,BUMA.1121.00103,1,3160050,3163322,-,3272
150,BUMA.1121.00096,1,2025270,2028545,-,3275
150,BUMA.1121.00079,1,1262906,1266197,+,3291
150,BUMA.1121.00039,1,1385652,1388929,+,3277
150,BUMA.1121.00083,1,337928,341204,-,3276
150,BUMA.1121.00084,1,1476529,1479805,+,3276
150,BUMA.1121.00049,1,630822,634098,-,3276
150,BUMA.1121.00089,1,1237841,1241118,+,3277
150,BUMA.1121.00014,1,1530709,1533985,-,3276
150,BUMA.1121.00090,1,3404980,3408257,+,3277
150,BUMA.1121.00071,1,1223145,1226422,+,3277
150,BUMA.1121.00078,1,707379,710655,-,3276
150,BUMA.1121.00102,1,4162928,4166204,-,3276
150,BUMA.1121.00075,1,744960,748237,+,3277
150,BUMA.1121.00012,1,4072227,4075504,+,3277
150,BUMA.1121.00076,1,131423,134699,-,3276
150,BUMA.1121.00106,1,991074,994351,+,3277
150,BUMA.1121.00001,1,2802592,2805868,-,3276
150,BUMA.1121.00107,1,1152988,1156265,+,3277
150,BUMA.1121.00104,1,70234,73510,-,3276
150,BUMA.1121.00099,1,1142206,1145482,-,3276
150,BUMA.1121.00098,1,4013109,4016401,+,3292
150,BUMA.1121.00111,1,1401302,1404579,+,3277
150,BUMA.1121.00109,1,631395,634671,-,3276
150,BUMA.1121.00097,1,2761273,2764520,-,3247
150,BUMA.1121.00094,1,1269165,1272442,+,3277
150,BUMA.1121.00095,1,431646,434922,-,3276
150,BUMA.1121.00005,1,2341274,2344525,-,3251
150,BUMA.1121.00101,1,1239823,1243099,-,3276
150,BUMA.1121.00065,1,1350092,1353369,+,3277
150,BUMA.1121.00100,1,57308,60572,-,3264
150,BUMA.1121.00105,1,3984030,3987306,-,3276
150,BUMA.1121.00029,1,3677906,3681182,-,3276
150,BUMA.1121.00066,1,1207228,1210505,+,3277
150,BUMA.1121.00031,1,2683042,2686319,+,3277
150,BUMA.1121.00108,1,2224092,2227369,+,3277
150,BUMA.1121.00023,1,3663406,3666683,+,3277
150,BUMA.1121.00035,1,2404572,2407849,+,3277
150,BUMA.1121.00041,1,2553872,2557149,+,3277
149,BUMA.1121.00057,1,2326403,2331438,+,5035
149,BUMA.1121.00058,1,3316582,3321609,-,5027
149,BUMA.1121.00045,1,2808005,2813011,-,5006
149,BUMA.1121.00051,1,1235564,1240591,+,5027
149,BUMA.1121.00068,1,4097999,4103044,+,5045
149,BUMA.1121.00061,1,1228081,1233098,+,5017
149,BUMA.1121.00060,1,1033739,1038745,-,5006
149,BUMA.1121.00064,1,1251794,1256821,+,5027
149,BUMA.1121.00016,1,3404645,3409654,+,5009
149,BUMA.1121.00003,1,3716220,3721256,+,5036
149,BUMA.1121.00055,1,831741,836777,+,5036
149,BUMA.1121.00011,1,342725,347761,-,5036
149,BUMA.1121.00037,1,3896369,3901405,+,5036
149,BUMA.1121.00009,1,345315,350351,-,5036
149,BUMA.1121.00069,1,1181240,1186257,+,5017
149,BUMA.1121.00088,1,2141913,2146940,+,5027
149,BUMA.1121.00092,1,2630157,2635193,-,5036
149,BUMA.1121.00074,1,2603596,2608623,-,5027
149,BUMA.1121.00070,1,1199053,1204070,+,5017
149,BUMA.1121.00093,1,1991222,1996258,+,5036
149,BUMA.1121.00063,1,1225152,1230169,+,5017
149,BUMA.1121.00033,1,3468171,3473207,+,5036
149,BUMA.1121.00018,1,1839291,1844327,+,5036
149,BUMA.1121.00080,1,1262773,1267800,+,5027
149,BUMA.1121.00027,1,3438315,3443342,+,5027
149,BUMA.1121.00053,1,969155,974182,+,5027
149,BUMA.1121.00059,1,454123,459159,+,5036
149,BUMA.1121.00043,1,1300595,1305631,+,5036
149,BUMA.1121.00056,1,2688060,2693087,-,5027
149,BUMA.1121.00112,1,1809468,1814504,-,5036
149,BUMA.1121.00091,1,3302996,3308032,-,5036
149,BUMA.1121.00047,1,1709826,1714853,-,5027
149,BUMA.1121.00067,1,3172783,3177810,-,5027
149,BUMA.1121.00110,1,3550513,3555530,-,5017
149,BUMA.1121.00073,1,1226257,1231274,+,5017
149,BUMA.1121.00072,1,1200848,1205865,+,5017
149,BUMA.1121.00077,1,3936797,3941814,+,5017
149,BUMA.1121.00082,1,1358610,1363627,+,5017
149,BUMA.1121.00062,1,3326500,3331536,-,5036
149,BUMA.1121.00007,1,2870900,2875926,-,5026
149,BUMA.1121.00025,1,1415547,1420583,-,5036
149,BUMA.1121.00021,1,1882222,1887249,+,5027
149,BUMA.1121.00103,1,3163324,3168351,-,5027
149,BUMA.1121.00096,1,2028547,2033592,-,5045
149,BUMA.1121.00079,1,1257878,1262905,+,5027
149,BUMA.1121.00039,1,1380615,1385651,+,5036
149,BUMA.1121.00083,1,341206,346223,-,5017
149,BUMA.1121.00084,1,1471501,1476528,+,5027
149,BUMA.1121.00049,1,634100,639145,-,5045
149,BUMA.1121.00089,1,1232813,1237840,+,5027
149,BUMA.1121.00014,1,1533987,1539023,-,5036
149,BUMA.1121.00090,1,3399943,3404979,+,5036
149,BUMA.1121.00071,1,1218127,1223144,+,5017
149,BUMA.1121.00078,1,710657,715684,-,5027
149,BUMA.1121.00102,1,4166206,4171242,-,5036
149,BUMA.1121.00075,1,739942,744959,+,5017
149,BUMA.1121.00012,1,4067190,4072226,+,5036
149,BUMA.1121.00076,1,134701,139718,-,5017
149,BUMA.1121.00106,1,986037,991073,+,5036
149,BUMA.1121.00001,1,2805870,2810888,-,5018
149,BUMA.1121.00107,1,1147906,1152987,+,5081
149,BUMA.1121.00104,1,73512,78529,-,5017
149,BUMA.1121.00099,1,1145484,1150511,-,5027
149,BUMA.1121.00098,1,3978087,3983089,+,5002
149,BUMA.1121.00111,1,1396265,1401301,+,5036
149,BUMA.1121.00109,1,634673,639718,-,5045
149,BUMA.1121.00097,1,2764522,2769558,-,5036
149,BUMA.1121.00094,1,1264137,1269164,+,5027
149,BUMA.1121.00095,1,434924,439951,-,5027
149,BUMA.1121.00005,1,2344527,2349572,-,5045
149,BUMA.1121.00101,1,1243101,1248128,-,5027
149,BUMA.1121.00065,1,1345064,1350091,+,5027
149,BUMA.1121.00100,1,60574,65619,-,5045
149,BUMA.1121.00105,1,3987308,3992344,-,5036
149,BUMA.1121.00029,1,3681184,3686202,-,5018
149,BUMA.1121.00066,1,1202210,1207227,+,5017
149,BUMA.1121.00031,1,2677996,2683041,+,5045
149,BUMA.1121.00108,1,2219065,2224091,+,5026
149,BUMA.1121.00023,1,3658391,3663405,+,5014
149,BUMA.1121.00035,1,2399553,2404571,+,5018
149,BUMA.1121.00041,1,2548817,2553871,+,5054
148,BUMA.1121.00057,1,2312409,2326289,+,13880
148,BUMA.1121.00058,1,3321741,3335666,-,13925
148,BUMA.1121.00045,1,2813117,2826988,-,13871
148,BUMA.1121.00051,1,1221454,1235437,+,13983
148,BUMA.1121.00068,1,4084073,4097885,+,13812
148,BUMA.1121.00061,1,1214066,1227945,+,13879
148,BUMA.1121.00060,1,1038851,1052610,-,13759
148,BUMA.1121.00064,1,1237911,1251673,+,13762
148,BUMA.1121.00016,1,3390706,3404531,+,13825
148,BUMA.1121.00003,1,3702247,3716099,+,13852
148,BUMA.1121.00055,1,816427,830165,+,13738
148,BUMA.1121.00011,1,347868,361736,-,13868
148,BUMA.1121.00037,1,3882532,3896255,+,13723
148,BUMA.1121.00009,1,350458,364162,-,13704
148,BUMA.1121.00069,1,1167323,1181142,+,13819
148,BUMA.1121.00088,1,2127854,2141792,+,13938
148,BUMA.1121.00092,1,2635307,2649262,-,13955
148,BUMA.1121.00074,1,2608744,2622546,-,13802
148,BUMA.1121.00070,1,1185062,1198922,+,13860
148,BUMA.1121.00093,1,1977159,1991108,+,13949
148,BUMA.1121.00063,1,1211227,1225071,+,13844
148,BUMA.1121.00033,1,3454389,3468057,+,13668
148,BUMA.1121.00018,1,1825234,1839177,+,13943
148,BUMA.1121.00080,1,1248613,1262645,+,14032
148,BUMA.1121.00027,1,3424357,3438194,+,13837
148,BUMA.1121.00053,1,955224,969034,+,13810
148,BUMA.1121.00059,1,440263,454009,+,13746
148,BUMA.1121.00043,1,1286622,1300481,+,13859
148,BUMA.1121.00056,1,2693215,2707112,-,13897
148,BUMA.1121.00112,1,1814632,1828555,-,13923
148,BUMA.1121.00091,1,3308181,3322030,-,13849
148,BUMA.1121.00047,1,1714981,1729055,-,14074
148,BUMA.1121.00067,1,3179385,3193283,-,13898
148,BUMA.1121.00110,1,3555666,3569500,-,13834
148,BUMA.1121.00073,1,1212260,1226133,+,13873
148,BUMA.1121.00072,1,1186923,1200714,+,13791
148,BUMA.1121.00077,1,3922816,3936658,+,13842
148,BUMA.1121.00082,1,1344594,1358474,+,13880
148,BUMA.1121.00062,1,3331657,3345561,-,13904
148,BUMA.1121.00007,1,2876047,2890017,-,13970
148,BUMA.1121.00025,1,1420697,1434608,-,13911
148,BUMA.1121.00021,1,1868324,1882108,+,13784
148,BUMA.1121.00103,1,3168488,3182161,-,13673
148,BUMA.1121.00096,1,2033699,2047628,-,13929
148,BUMA.1121.00079,1,1243689,1257751,+,14062
148,BUMA.1121.00039,1,1366657,1380501,+,13844
148,BUMA.1121.00083,1,346359,360231,-,13872
148,BUMA.1121.00084,1,1457399,1471380,+,13981
148,BUMA.1121.00049,1,639266,653045,-,13779
148,BUMA.1121.00089,1,1218654,1232685,+,14031
148,BUMA.1121.00014,1,1539137,1552863,-,13726
148,BUMA.1121.00090,1,3385939,3399829,+,13890
148,BUMA.1121.00071,1,1204178,1218041,+,13863
148,BUMA.1121.00078,1,715820,729757,-,13937
148,BUMA.1121.00102,1,4171364,4185325,-,13961
148,BUMA.1121.00075,1,726073,739822,+,13749
148,BUMA.1121.00012,1,4053273,4067076,+,13803
148,BUMA.1121.00076,1,139839,153581,-,13742
148,BUMA.1121.00106,1,972019,985916,+,13897
148,BUMA.1121.00001,1,2811002,2824729,-,13727
148,BUMA.1121.00107,1,1133929,1147799,+,13870
148,BUMA.1121.00104,1,78650,92420,-,13770
148,BUMA.1121.00099,1,1150618,1164607,-,13989
148,BUMA.1121.00098,1,3964132,3977959,+,13827
148,BUMA.1121.00111,1,1382299,1396137,+,13838
148,BUMA.1121.00109,1,639818,653936,-,14118
148,BUMA.1121.00097,1,2769679,2783624,-,13945
148,BUMA.1121.00094,1,1249986,1264009,+,14023
148,BUMA.1121.00095,1,440087,453784,-,13697
148,BUMA.1121.00005,1,2349672,2363482,-,13810
148,BUMA.1121.00101,1,1248242,1262109,-,13867
148,BUMA.1121.00065,1,1331195,1344916,+,13721
148,BUMA.1121.00100,1,65775,79618,-,13843
148,BUMA.1121.00105,1,3992465,4006385,-,13920
148,BUMA.1121.00029,1,3686316,3700131,-,13815
148,BUMA.1121.00066,1,1188255,1202106,+,13851
148,BUMA.1121.00031,1,2664133,2677882,+,13749
148,BUMA.1121.00108,1,2205253,2218944,+,13691
148,BUMA.1121.00023,1,3644443,3658287,+,13844
148,BUMA.1121.00035,1,2385712,2399439,+,13727
148,BUMA.1121.00041,1,2534934,2548710,+,13776
147,BUMA.1121.00057,1,2305459,2312408,+,6949
147,BUMA.1121.00058,1,3335668,3342617,-,6949
147,BUMA.1121.00045,1,2826990,2833939,-,6949
147,BUMA.1121.00051,1,1214504,1221453,+,6949
147,BUMA.1121.00068,1,4077123,4084072,+,6949
147,BUMA.1121.00061,1,1207092,1214065,+,6973
147,BUMA.1121.00060,1,1052612,1059561,-,6949
147,BUMA.1121.00064,1,1230961,1237910,+,6949
147,BUMA.1121.00016,1,3383756,3390705,+,6949
147,BUMA.1121.00003,1,3695297,3702246,+,6949
147,BUMA.1121.00055,1,809477,816426,+,6949
147,BUMA.1121.00011,1,361738,368683,-,6945
147,BUMA.1121.00037,1,3875582,3882531,+,6949
147,BUMA.1121.00009,1,364164,371113,-,6949
147,BUMA.1121.00069,1,1160348,1167322,+,6974
147,BUMA.1121.00088,1,2120904,2127853,+,6949
147,BUMA.1121.00092,1,2649264,2656213,-,6949
147,BUMA.1121.00074,1,2622548,2629497,-,6949
147,BUMA.1121.00070,1,1178088,1185061,+,6973
147,BUMA.1121.00093,1,1970209,1977158,+,6949
147,BUMA.1121.00063,1,1204253,1211226,+,6973
147,BUMA.1121.00033,1,3447439,3454388,+,6949
147,BUMA.1121.00018,1,1818284,1825233,+,6949
147,BUMA.1121.00080,1,1241663,1248612,+,6949
147,BUMA.1121.00027,1,3417407,3424356,+,6949
147,BUMA.1121.00053,1,948274,955223,+,6949
147,BUMA.1121.00059,1,433313,440262,+,6949
147,BUMA.1121.00043,1,1279672,1286621,+,6949
147,BUMA.1121.00056,1,2707114,2714063,-,6949
147,BUMA.1121.00112,1,1828557,1835518,-,6961
147,BUMA.1121.00091,1,3322032,3328981,-,6949
147,BUMA.1121.00047,1,1729057,1736006,-,6949
147,BUMA.1121.00067,1,3193285,3200234,-,6949
147,BUMA.1121.00110,1,3569502,3576451,-,6949
147,BUMA.1121.00073,1,1205283,1212259,+,6976
147,BUMA.1121.00072,1,1179948,1186922,+,6974
147,BUMA.1121.00077,1,3915868,3922815,+,6947
147,BUMA.1121.00082,1,1337651,1344593,+,6942
147,BUMA.1121.00062,1,3345563,3352512,-,6949
147,BUMA.1121.00007,1,2890019,2896968,-,6949
147,BUMA.1121.00025,1,1434610,1441559,-,6949
147,BUMA.1121.00021,1,1861374,1868323,+,6949
147,BUMA.1121.00103,1,3182163,3189112,-,6949
147,BUMA.1121.00096,1,2047630,2054572,-,6942
147,BUMA.1121.00079,1,1236739,1243688,+,6949
147,BUMA.1121.00039,1,1359707,1366656,+,6949
147,BUMA.1121.00083,1,360233,367175,-,6942
147,BUMA.1121.00084,1,1450449,1457398,+,6949
147,BUMA.1121.00049,1,653047,659996,-,6949
147,BUMA.1121.00089,1,1211704,1218653,+,6949
147,BUMA.1121.00014,1,1552865,1559814,-,6949
147,BUMA.1121.00090,1,3378989,3385938,+,6949
147,BUMA.1121.00071,1,1197204,1204177,+,6973
147,BUMA.1121.00078,1,729759,736708,-,6949
147,BUMA.1121.00102,1,1,6913,-,6912
147,BUMA.1121.00075,1,719124,726072,+,6948
147,BUMA.1121.00012,1,4046327,4053272,+,6945
147,BUMA.1121.00076,1,153583,160532,-,6949
147,BUMA.1121.00106,1,965069,972018,+,6949
147,BUMA.1121.00001,1,2824731,2831680,-,6949
147,BUMA.1121.00107,1,1126979,1133928,+,6949
147,BUMA.1121.00104,1,92422,99371,-,6949
147,BUMA.1121.00099,1,1164609,1171558,-,6949
147,BUMA.1121.00098,1,3957186,3964131,+,6945
147,BUMA.1121.00111,1,1375349,1382298,+,6949
147,BUMA.1121.00109,1,653938,660887,-,6949
147,BUMA.1121.00097,1,2783626,2790575,-,6949
147,BUMA.1121.00094,1,1243036,1249985,+,6949
147,BUMA.1121.00095,1,453786,460735,-,6949
147,BUMA.1121.00005,1,2363484,2370433,-,6949
147,BUMA.1121.00101,1,1262111,1269060,-,6949
147,BUMA.1121.00065,1,1324245,1331194,+,6949
147,BUMA.1121.00100,1,79620,86569,-,6949
147,BUMA.1121.00105,1,4006387,4013336,-,6949
147,BUMA.1121.00029,1,3700133,3707082,-,6949
147,BUMA.1121.00066,1,1181281,1188254,+,6973
147,BUMA.1121.00031,1,2657183,2664132,+,6949
147,BUMA.1121.00108,1,2198303,2205252,+,6949
147,BUMA.1121.00023,1,3637493,3644442,+,6949
147,BUMA.1121.00035,1,2378769,2385711,+,6942
147,BUMA.1121.00041,1,2527984,2534933,+,6949
146,BUMA.1121.00057,1,2301069,2305457,+,4388
146,BUMA.1121.00058,1,3342618,3347007,-,4389
146,BUMA.1121.00045,1,2833940,2838329,-,4389
146,BUMA.1121.00051,1,1210114,1214502,+,4388
146,BUMA.1121.00068,1,4072733,4077121,+,4388
146,BUMA.1121.00061,1,1202702,1207090,+,4388
146,BUMA.1121.00060,1,1059562,1063951,-,4389
146,BUMA.1121.00064,1,1226571,1230959,+,4388
146,BUMA.1121.00016,1,3379366,3383754,+,4388
146,BUMA.1121.00003,1,3690907,3695295,+,4388
146,BUMA.1121.00055,1,787876,792280,+,4404
146,BUMA.1121.00011,1,384760,389163,-,4403
146,BUMA.1121.00037,1,3871192,3875580,+,4388
146,BUMA.1121.00009,1,371114,375496,-,4382
146,BUMA.1121.00069,1,1155958,1160346,+,4388
146,BUMA.1121.00088,1,2116514,2120902,+,4388
146,BUMA.1121.00092,1,2656214,2660603,-,4389
146,BUMA.1121.00074,1,2629498,2633887,-,4389
146,BUMA.1121.00070,1,1173698,1178086,+,4388
146,BUMA.1121.00093,1,1965819,1970207,+,4388
146,BUMA.1121.00063,1,1199877,1204251,+,4374
146,BUMA.1121.00033,1,3443049,3447437,+,4388
146,BUMA.1121.00018,1,1813894,1818282,+,4388
146,BUMA.1121.00080,1,1237273,1241661,+,4388
146,BUMA.1121.00027,1,3413017,3417405,+,4388
146,BUMA.1121.00053,1,943884,948272,+,4388
146,BUMA.1121.00059,1,428923,433311,+,4388
146,BUMA.1121.00043,1,1275260,1279670,+,4410
146,BUMA.1121.00056,1,2714064,2718453,-,4389
146,BUMA.1121.00112,1,1835519,1839902,-,4383
146,BUMA.1121.00091,1,3328982,3333371,-,4389
146,BUMA.1121.00047,1,1736007,1740396,-,4389
146,BUMA.1121.00067,1,3200235,3204624,-,4389
146,BUMA.1121.00110,1,3576452,3580841,-,4389
146,BUMA.1121.00073,1,1200893,1205281,+,4388
146,BUMA.1121.00072,1,1175558,1179946,+,4388
146,BUMA.1121.00077,1,3911478,3915866,+,4388
146,BUMA.1121.00082,1,1318047,1322451,+,4404
146,BUMA.1121.00062,1,3352513,3356902,-,4389
146,BUMA.1121.00007,1,2896969,2901337,-,4368
146,BUMA.1121.00025,1,1441560,1445949,-,4389
146,BUMA.1121.00021,1,1856942,1861372,+,4430
146,BUMA.1121.00103,1,3205187,3209569,-,4382
146,BUMA.1121.00096,1,2063180,2067584,-,4404
146,BUMA.1121.00079,1,1232349,1236737,+,4388
146,BUMA.1121.00039,1,1355317,1359705,+,4388
146,BUMA.1121.00083,1,382375,386779,-,4404
146,BUMA.1121.00084,1,1446059,1450447,+,4388
146,BUMA.1121.00049,1,659997,664386,-,4389
146,BUMA.1121.00089,1,1207314,1211702,+,4388
146,BUMA.1121.00014,1,1559815,1564204,-,4389
146,BUMA.1121.00090,1,3374578,3378987,+,4409
146,BUMA.1121.00071,1,1192814,1197202,+,4388
146,BUMA.1121.00078,1,736709,741098,-,4389
146,BUMA.1121.00102,1,6914,11303,-,4389
146,BUMA.1121.00075,1,714735,719122,+,4387
146,BUMA.1121.00012,1,4030232,4034637,+,4405
146,BUMA.1121.00076,1,160533,164922,-,4389
146,BUMA.1121.00106,1,960679,965067,+,4388
146,BUMA.1121.00001,1,2831681,2836070,-,4389
146,BUMA.1121.00107,1,1122589,1126977,+,4388
146,BUMA.1121.00104,1,99372,103761,-,4389
146,BUMA.1121.00099,1,1171559,1175948,-,4389
146,BUMA.1121.00098,1,3936414,3940818,+,4404
146,BUMA.1121.00111,1,1370938,1375347,+,4409
146,BUMA.1121.00109,1,660888,665277,-,4389
146,BUMA.1121.00097,1,2790576,2794921,-,4345
146,BUMA.1121.00094,1,1238646,1243034,+,4388
146,BUMA.1121.00095,1,460736,465060,-,4324
146,BUMA.1121.00005,1,2370434,2374807,-,4373
146,BUMA.1121.00101,1,1269061,1273450,-,4389
146,BUMA.1121.00065,1,1319855,1324243,+,4388
146,BUMA.1121.00100,1,86570,90959,-,4389
146,BUMA.1121.00105,1,4013337,4017692,-,4355
146,BUMA.1121.00029,1,3707083,3711472,-,4389
146,BUMA.1121.00066,1,1176891,1181279,+,4388
146,BUMA.1121.00031,1,2652793,2657181,+,4388
146,BUMA.1121.00108,1,2193913,2198301,+,4388
146,BUMA.1121.00023,1,3633081,3637491,+,4410
146,BUMA.1121.00035,1,2363616,2368020,+,4404
146,BUMA.1121.00041,1,2505021,2509404,+,4383
145,BUMA.1121.00057,1,2292028,2301067,+,9039
145,BUMA.1121.00058,1,3347008,3356006,-,8998
145,BUMA.1121.00045,1,2838330,2847393,-,9063
145,BUMA.1121.00051,1,1201067,1210112,+,9045
145,BUMA.1121.00068,1,4063770,4072731,+,8961
145,BUMA.1121.00061,1,1193679,1202700,+,9021
145,BUMA.1121.00060,1,1063952,1073015,-,9063
145,BUMA.1121.00064,1,1217543,1226569,+,9026
145,BUMA.1121.00016,1,3370373,3379364,+,8991
145,BUMA.1121.00003,1,3681862,3690905,+,9043
145,BUMA.1121.00055,1,778853,787874,+,9021
145,BUMA.1121.00011,1,389164,398188,-,9024
145,BUMA.1121.00037,1,3862158,3871190,+,9032
145,BUMA.1121.00009,1,375497,384481,-,8984
145,BUMA.1121.00069,1,1146949,1155956,+,9007
145,BUMA.1121.00088,1,2107495,2116512,+,9017
145,BUMA.1121.00092,1,2660604,2669580,-,8976
145,BUMA.1121.00074,1,2633888,2642942,-,9054
145,BUMA.1121.00070,1,1164675,1173696,+,9021
145,BUMA.1121.00093,1,1956849,1965817,+,8968
145,BUMA.1121.00063,1,1190853,1199875,+,9022
145,BUMA.1121.00033,1,3434041,3443047,+,9006
145,BUMA.1121.00018,1,1804890,1813892,+,9002
145,BUMA.1121.00080,1,1228205,1237271,+,9066
145,BUMA.1121.00027,1,3403990,3413015,+,9025
145,BUMA.1121.00053,1,934878,943882,+,9004
145,BUMA.1121.00059,1,419900,428921,+,9021
145,BUMA.1121.00043,1,1266275,1275258,+,8983
145,BUMA.1121.00056,1,2718454,2727458,-,9004
145,BUMA.1121.00112,1,1839903,1848895,-,8992
145,BUMA.1121.00091,1,3333372,3342405,-,9033
145,BUMA.1121.00047,1,1740397,1749437,-,9040
145,BUMA.1121.00067,1,3204625,3213678,-,9053
145,BUMA.1121.00110,1,3580842,3590034,-,9192
145,BUMA.1121.00073,1,1191863,1200891,+,9028
145,BUMA.1121.00072,1,1166528,1175556,+,9028
145,BUMA.1121.00077,1,3902285,3911476,+,9191
145,BUMA.1121.00082,1,1309017,1318045,+,9028
145,BUMA.1121.00062,1,3356903,3365925,-,9022
145,BUMA.1121.00007,1,2901338,2910378,-,9040
145,BUMA.1121.00025,1,1445950,1454953,-,9003
145,BUMA.1121.00021,1,1847914,1856940,+,9026
145,BUMA.1121.00103,1,3209570,3218570,-,9000
145,BUMA.1121.00096,1,2067585,2076639,-,9054
145,BUMA.1121.00079,1,1223357,1232347,+,8990
145,BUMA.1121.00039,1,1346273,1355315,+,9042
145,BUMA.1121.00083,1,386780,395809,-,9029
145,BUMA.1121.00084,1,1437058,1446057,+,8999
145,BUMA.1121.00049,1,664387,673409,-,9022
145,BUMA.1121.00089,1,1198309,1207312,+,9003
145,BUMA.1121.00014,1,1564205,1573198,-,8993
145,BUMA.1121.00090,1,3365570,3374576,+,9006
145,BUMA.1121.00071,1,1183791,1192812,+,9021
145,BUMA.1121.00078,1,741099,750196,-,9097
145,BUMA.1121.00102,1,11304,20262,-,8958
145,BUMA.1121.00075,1,705704,714733,+,9029
145,BUMA.1121.00012,1,4021195,4030230,+,9035
145,BUMA.1121.00076,1,164923,173953,-,9030
145,BUMA.1121.00106,1,951646,960677,+,9031
145,BUMA.1121.00001,1,2836071,2845069,-,8998
145,BUMA.1121.00107,1,1113573,1122587,+,9014
145,BUMA.1121.00104,1,103762,112736,-,8974
145,BUMA.1121.00099,1,1175949,1184965,-,9016
145,BUMA.1121.00098,1,3927410,3936412,+,9002
145,BUMA.1121.00111,1,1361921,1370936,+,9015
145,BUMA.1121.00109,1,665278,674295,-,9017
145,BUMA.1121.00097,1,2794922,2803991,-,9069
145,BUMA.1121.00094,1,1229641,1238644,+,9003
145,BUMA.1121.00095,1,465061,474091,-,9030
145,BUMA.1121.00005,1,2374808,2383775,-,8967
145,BUMA.1121.00101,1,1273451,1282528,-,9077
145,BUMA.1121.00065,1,1310858,1319853,+,8995
145,BUMA.1121.00100,1,90960,100089,-,9129
145,BUMA.1121.00105,1,20,9075,-,9055
145,BUMA.1121.00029,1,3711473,3720482,-,9009
145,BUMA.1121.00066,1,1167876,1176889,+,9013
145,BUMA.1121.00031,1,2643808,2652791,+,8983
145,BUMA.1121.00108,1,2184826,2193911,+,9085
145,BUMA.1121.00023,1,3624073,3633079,+,9006
145,BUMA.1121.00035,1,2354581,2363614,+,9033
145,BUMA.1121.00041,1,2496154,2505019,+,8865
144,BUMA.1121.00057,1,2274090,2282017,+,7927
144,BUMA.1121.00058,1,3366018,3373992,-,7974
144,BUMA.1121.00045,1,2857405,2865331,-,7926
144,BUMA.1121.00051,1,1183117,1191054,+,7937
144,BUMA.1121.00068,1,4045822,4053757,+,7935
144,BUMA.1121.00061,1,1175733,1183668,+,7935
144,BUMA.1121.00060,1,1083036,1090962,-,7926
144,BUMA.1121.00064,1,1199568,1207530,+,7962
144,BUMA.1121.00016,1,3352414,3360361,+,7947
144,BUMA.1121.00003,1,3663939,3671843,+,7904
144,BUMA.1121.00055,1,760873,768842,+,7969
144,BUMA.1121.00011,1,408200,416135,-,7935
144,BUMA.1121.00037,1,3844189,3852145,+,7956
144,BUMA.1121.00009,1,394499,402409,-,7910
144,BUMA.1121.00069,1,1129026,1136938,+,7912
144,BUMA.1121.00088,1,2089538,2097482,+,7944
144,BUMA.1121.00092,1,2679592,2687555,-,7963
144,BUMA.1121.00074,1,2652954,2660917,-,7963
144,BUMA.1121.00070,1,1146729,1154664,+,7935
144,BUMA.1121.00093,1,1938874,1946836,+,7962
144,BUMA.1121.00063,1,1172907,1180842,+,7935
144,BUMA.1121.00033,1,3416074,3424028,+,7954
144,BUMA.1121.00018,1,1786931,1794877,+,7946
144,BUMA.1121.00080,1,1210272,1218192,+,7920
144,BUMA.1121.00027,1,3386053,3393979,+,7926
144,BUMA.1121.00053,1,916920,924866,+,7946
144,BUMA.1121.00059,1,401965,409887,+,7922
144,BUMA.1121.00043,1,1248315,1256262,+,7947
144,BUMA.1121.00056,1,2737470,2745435,-,7965
144,BUMA.1121.00112,1,1858906,1866814,-,7908
144,BUMA.1121.00091,1,3352417,3360302,-,7885
144,BUMA.1121.00047,1,1759449,1767393,-,7944
144,BUMA.1121.00067,1,3223690,3231628,-,7938
144,BUMA.1121.00110,1,3600045,3607975,-,7930
144,BUMA.1121.00073,1,1173917,1181852,+,7935
144,BUMA.1121.00072,1,1148582,1156517,+,7935
144,BUMA.1121.00077,1,3884343,3892273,+,7930
144,BUMA.1121.00082,1,1291071,1299006,+,7935
144,BUMA.1121.00062,1,3375936,3383889,-,7953
144,BUMA.1121.00007,1,2920390,2928304,-,7914
144,BUMA.1121.00025,1,1464965,1472912,-,7947
144,BUMA.1121.00021,1,1829954,1837900,+,7946
144,BUMA.1121.00103,1,3228581,3236535,-,7954
144,BUMA.1121.00096,1,2086651,2094562,-,7911
144,BUMA.1121.00079,1,1205425,1213344,+,7919
144,BUMA.1121.00039,1,1328313,1336260,+,7947
144,BUMA.1121.00083,1,405819,413755,-,7936
144,BUMA.1121.00084,1,1419077,1427045,+,7968
144,BUMA.1121.00049,1,683420,691342,-,7922
144,BUMA.1121.00089,1,1180332,1188296,+,7964
144,BUMA.1121.00014,1,1583210,1591149,-,7939
144,BUMA.1121.00090,1,3347619,3355557,+,7938
144,BUMA.1121.00071,1,1165845,1173780,+,7935
144,BUMA.1121.00078,1,760208,768158,-,7950
144,BUMA.1121.00102,1,30274,38212,-,7938
144,BUMA.1121.00075,1,687746,695692,+,7946
144,BUMA.1121.00012,1,4003260,4011182,+,7922
144,BUMA.1121.00076,1,183964,191911,-,7947
144,BUMA.1121.00106,1,933663,941633,+,7970
144,BUMA.1121.00001,1,2855080,2863027,-,7947
144,BUMA.1121.00107,1,1095612,1103561,+,7949
144,BUMA.1121.00104,1,122748,130719,-,7971
144,BUMA.1121.00099,1,1194983,1202913,-,7930
144,BUMA.1121.00098,1,3909468,3917397,+,7929
144,BUMA.1121.00111,1,1343963,1351908,+,7945
144,BUMA.1121.00109,1,684312,692270,-,7958
144,BUMA.1121.00097,1,2814002,2821984,-,7982
144,BUMA.1121.00094,1,1211674,1219628,+,7954
144,BUMA.1121.00095,1,484090,491956,-,7866
144,BUMA.1121.00005,1,2393786,2401715,-,7929
144,BUMA.1121.00101,1,1292540,1300464,-,7924
144,BUMA.1121.00065,1,1292884,1300845,+,7961
144,BUMA.1121.00100,1,108809,116819,-,8010
144,BUMA.1121.00105,1,19087,27034,-,7947
144,BUMA.1121.00029,1,3730493,3738448,-,7955
144,BUMA.1121.00066,1,1149930,1157865,+,7935
144,BUMA.1121.00031,1,2625857,2633795,+,7938
144,BUMA.1121.00108,1,2166858,2174802,+,7944
144,BUMA.1121.00023,1,3606114,3614076,+,7962
144,BUMA.1121.00035,1,2336623,2344569,+,7946
144,BUMA.1121.00041,1,2478204,2486141,+,7937
143,BUMA.1121.00057,1,2257844,2273131,+,15287
143,BUMA.1121.00058,1,3374881,3389922,-,15041
143,BUMA.1121.00045,1,2866220,2881537,-,15317
143,BUMA.1121.00051,1,1166971,1182229,+,15258
143,BUMA.1121.00068,1,4029707,4044948,+,15241
143,BUMA.1121.00061,1,1159734,1174821,+,15087
143,BUMA.1121.00060,1,1091851,1107168,-,15317
143,BUMA.1121.00064,1,1183442,1198669,+,15227
143,BUMA.1121.00016,1,3336258,3351535,+,15277
143,BUMA.1121.00003,1,3647817,3663050,+,15233
143,BUMA.1121.00055,1,744748,759984,+,15236
143,BUMA.1121.00011,1,418251,433487,-,15236
143,BUMA.1121.00037,1,3826720,3843310,+,16590
143,BUMA.1121.00009,1,403262,418407,-,15145
143,BUMA.1121.00069,1,1113168,1128101,+,14933
143,BUMA.1121.00088,1,2073358,2088649,+,15291
143,BUMA.1121.00092,1,2688434,2703489,-,15055
143,BUMA.1121.00074,1,2661816,2677064,-,15248
143,BUMA.1121.00070,1,1130820,1145837,+,15017
143,BUMA.1121.00093,1,1922939,1937995,+,15056
143,BUMA.1121.00063,1,1157033,1171968,+,14935
143,BUMA.1121.00033,1,3399906,3415185,+,15279
143,BUMA.1121.00018,1,1770802,1786042,+,15240
143,BUMA.1121.00080,1,1194144,1209383,+,15239
143,BUMA.1121.00027,1,3369802,3385094,+,15292
143,BUMA.1121.00053,1,900709,916031,+,15322
143,BUMA.1121.00059,1,385876,401076,+,15200
143,BUMA.1121.00043,1,1232407,1247436,+,15029
143,BUMA.1121.00056,1,2746334,2761621,-,15287
143,BUMA.1121.00112,1,1867696,1882985,-,15289
143,BUMA.1121.00091,1,3361181,3376540,-,15359
143,BUMA.1121.00047,1,1768282,1784877,-,16595
143,BUMA.1121.00067,1,3232517,3247851,-,15334
143,BUMA.1121.00110,1,3608867,3624233,-,15366
143,BUMA.1121.00073,1,1157800,1173004,+,15204
143,BUMA.1121.00072,1,1132774,1147699,+,14925
143,BUMA.1121.00077,1,3868084,3883451,+,15367
143,BUMA.1121.00082,1,1274835,1290132,+,15297
143,BUMA.1121.00062,1,3384778,3400058,-,15280
143,BUMA.1121.00007,1,2929183,2944482,-,15299
143,BUMA.1121.00025,1,1473801,1489040,-,15239
143,BUMA.1121.00021,1,1813809,1829055,+,15246
143,BUMA.1121.00103,1,3237369,3252708,-,15339
143,BUMA.1121.00096,1,2095454,2110695,-,15241
143,BUMA.1121.00079,1,1189301,1204536,+,15235
143,BUMA.1121.00039,1,1310842,1327434,+,16592
143,BUMA.1121.00083,1,414694,429984,-,15290
143,BUMA.1121.00084,1,1402917,1418198,+,15281
143,BUMA.1121.00049,1,692221,707569,-,15348
143,BUMA.1121.00089,1,1164146,1179433,+,15287
143,BUMA.1121.00014,1,1592048,1607293,-,15245
143,BUMA.1121.00090,1,3331490,3346720,+,15230
143,BUMA.1121.00071,1,1149854,1164944,+,15090
143,BUMA.1121.00078,1,769037,784340,-,15303
143,BUMA.1121.00102,1,39081,54391,-,15310
143,BUMA.1121.00075,1,671783,686837,+,15054
143,BUMA.1121.00012,1,3987145,4002371,+,15226
143,BUMA.1121.00076,1,192820,207885,-,15065
143,BUMA.1121.00106,1,917465,932774,+,15309
143,BUMA.1121.00001,1,2863916,2879073,-,15157
143,BUMA.1121.00107,1,1079501,1094720,+,15219
143,BUMA.1121.00104,1,131608,146925,-,15317
143,BUMA.1121.00099,1,1203792,1219035,-,15243
143,BUMA.1121.00098,1,3893358,3908589,+,15231
143,BUMA.1121.00111,1,1327845,1343075,+,15230
143,BUMA.1121.00109,1,693162,708472,-,15310
143,BUMA.1121.00097,1,2822866,2838103,-,15237
143,BUMA.1121.00094,1,1195494,1210775,+,15281
143,BUMA.1121.00095,1,492803,508038,-,15235
143,BUMA.1121.00005,1,2402620,2417623,-,15003
143,BUMA.1121.00101,1,1301356,1316500,-,15144
143,BUMA.1121.00065,1,1276891,1291995,+,15104
143,BUMA.1121.00100,1,117711,133002,-,15291
143,BUMA.1121.00105,1,27943,43211,-,15268
143,BUMA.1121.00029,1,3739337,3754559,-,15222
143,BUMA.1121.00066,1,1134125,1149010,+,14885
143,BUMA.1121.00031,1,2609712,2624958,+,15246
143,BUMA.1121.00108,1,2149396,2165969,+,16573
143,BUMA.1121.00023,1,3590019,3605245,+,15226
143,BUMA.1121.00035,1,2320502,2335734,+,15232
143,BUMA.1121.00041,1,2462027,2477325,+,15298
142,BUMA.1121.00057,1,2208129,2256288,+,48159
142,BUMA.1121.00058,1,3391472,3438383,-,46911
142,BUMA.1121.00045,1,2883092,2929724,-,46632
142,BUMA.1121.00051,1,1118650,1165415,+,46765
142,BUMA.1121.00068,1,3981200,4028152,+,46952
142,BUMA.1121.00061,1,1111408,1158178,+,46770
142,BUMA.1121.00060,1,1108723,1155331,-,46608
142,BUMA.1121.00064,1,1135080,1181886,+,46806
142,BUMA.1121.00016,1,3286715,3334702,+,47987
142,BUMA.1121.00003,1,3599487,3646261,+,46774
142,BUMA.1121.00055,1,696410,743192,+,46782
142,BUMA.1121.00011,1,435043,483074,-,48031
142,BUMA.1121.00037,1,3778448,3825164,+,46716
142,BUMA.1121.00009,1,419963,466554,-,46591
142,BUMA.1121.00069,1,1064912,1111612,+,46700
142,BUMA.1121.00088,1,2025228,2071802,+,46574
142,BUMA.1121.00092,1,2705045,2751730,-,46685
142,BUMA.1121.00074,1,2678620,2725396,-,46776
142,BUMA.1121.00070,1,1082507,1129264,+,46757
142,BUMA.1121.00093,1,1874698,1921383,+,46685
142,BUMA.1121.00063,1,1108677,1155477,+,46800
142,BUMA.1121.00033,1,3351580,3398350,+,46770
142,BUMA.1121.00018,1,1722695,1769246,+,46551
142,BUMA.1121.00080,1,1145744,1192588,+,46844
142,BUMA.1121.00027,1,3321326,3368246,+,46920
142,BUMA.1121.00053,1,852311,899153,+,46842
142,BUMA.1121.00059,1,337614,384320,+,46706
142,BUMA.1121.00043,1,1184242,1230851,+,46609
142,BUMA.1121.00056,1,2763177,2809881,-,46704
142,BUMA.1121.00112,1,1884541,1931309,-,46768
142,BUMA.1121.00091,1,3378096,3426323,-,48227
142,BUMA.1121.00047,1,1786433,1833235,-,46802
142,BUMA.1121.00067,1,3249395,3296136,-,46741
142,BUMA.1121.00110,1,3625781,3672609,-,46828
142,BUMA.1121.00073,1,1109442,1156244,+,46802
142,BUMA.1121.00072,1,1084437,1131218,+,46781
142,BUMA.1121.00077,1,3819690,3866534,+,46844
142,BUMA.1121.00082,1,1226477,1273279,+,46802
142,BUMA.1121.00062,1,3401614,3448531,-,46917
142,BUMA.1121.00007,1,2946038,2992698,-,46660
142,BUMA.1121.00025,1,1490596,1537156,-,46560
142,BUMA.1121.00021,1,1765656,1812253,+,46597
142,BUMA.1121.00103,1,3254264,3300949,-,46685
142,BUMA.1121.00096,1,2112251,2159013,-,46762
142,BUMA.1121.00079,1,1140834,1187745,+,46911
142,BUMA.1121.00039,1,1262666,1309286,+,46620
142,BUMA.1121.00083,1,431540,478342,-,46802
142,BUMA.1121.00084,1,1354692,1401361,+,46669
142,BUMA.1121.00049,1,709124,757153,-,48029
142,BUMA.1121.00089,1,1115887,1162590,+,46703
142,BUMA.1121.00014,1,1608849,1655710,-,46861
142,BUMA.1121.00090,1,3283415,3329934,+,46519
142,BUMA.1121.00071,1,1101627,1148298,+,46671
142,BUMA.1121.00078,1,785892,832582,-,46690
142,BUMA.1121.00102,1,55947,102894,-,46947
142,BUMA.1121.00075,1,623545,670227,+,46682
142,BUMA.1121.00012,1,3938904,3985589,+,46685
142,BUMA.1121.00076,1,209441,256150,-,46709
142,BUMA.1121.00106,1,869098,915909,+,46811
142,BUMA.1121.00001,1,2880629,2927198,-,46569
142,BUMA.1121.00107,1,1031360,1077945,+,46585
142,BUMA.1121.00104,1,148481,195224,-,46743
142,BUMA.1121.00099,1,1220591,1267271,-,46680
142,BUMA.1121.00098,1,3844976,3891813,+,46837
142,BUMA.1121.00111,1,1278382,1326289,+,47907
142,BUMA.1121.00109,1,710028,757108,-,47080
142,BUMA.1121.00097,1,2839659,2886296,-,46637
142,BUMA.1121.00094,1,1147226,1193939,+,46713
142,BUMA.1121.00095,1,509594,557757,-,48163
142,BUMA.1121.00005,1,2419176,2467288,-,48112
142,BUMA.1121.00101,1,1318056,1364823,-,46767
142,BUMA.1121.00065,1,1228568,1275335,+,46767
142,BUMA.1121.00100,1,134558,181202,-,46644
142,BUMA.1121.00105,1,44767,91469,-,46702
142,BUMA.1121.00029,1,3756115,3802715,-,46600
142,BUMA.1121.00066,1,1085887,1132569,+,46682
142,BUMA.1121.00031,1,2561535,2608156,+,46621
142,BUMA.1121.00108,1,2099954,2147840,+,47886
142,BUMA.1121.00023,1,3541945,3588463,+,46518
142,BUMA.1121.00035,1,2272351,2318946,+,46595
142,BUMA.1121.00041,1,2413733,2460471,+,46738
141,BUMA.1121.00057,1,2199145,2204672,+,5527
141,BUMA.1121.00058,1,3504352,3509883,-,5531
141,BUMA.1121.00045,1,2965164,2970697,-,5533
141,BUMA.1121.00051,1,1096247,1101779,+,5532
141,BUMA.1121.00068,1,3958708,3964224,+,5516
141,BUMA.1121.00061,1,1102612,1108144,+,5532
141,BUMA.1121.00060,1,1190771,1196304,-,5533
141,BUMA.1121.00064,1,1126080,1131607,+,5527
141,BUMA.1121.00016,1,3220765,3226298,+,5533
141,BUMA.1121.00003,1,3577055,3582586,+,5531
141,BUMA.1121.00055,1,687389,692921,+,5532
141,BUMA.1121.00011,1,499987,505520,-,5533
141,BUMA.1121.00037,1,3741082,3746621,+,5539
141,BUMA.1121.00009,1,470019,475554,-,5535
141,BUMA.1121.00069,1,1056117,1061649,+,5532
141,BUMA.1121.00088,1,1966643,1972172,+,5529
141,BUMA.1121.00092,1,2768645,2774160,-,5515
141,BUMA.1121.00074,1,2777342,2782870,-,5528
141,BUMA.1121.00070,1,1073594,1079126,+,5532
141,BUMA.1121.00093,1,1852269,1857783,+,5514
141,BUMA.1121.00063,1,1099880,1105412,+,5532
141,BUMA.1121.00033,1,3340140,3345673,+,5533
141,BUMA.1121.00018,1,1648924,1654455,+,5531
141,BUMA.1121.00080,1,1123341,1128873,+,5532
141,BUMA.1121.00027,1,3312344,3317871,+,5527
141,BUMA.1121.00053,1,824915,830446,+,5531
141,BUMA.1121.00059,1,328604,334133,+,5529
141,BUMA.1121.00043,1,1080422,1085953,+,5531
141,BUMA.1121.00056,1,2826752,2832285,-,5533
141,BUMA.1121.00112,1,1968184,1973714,-,5530
141,BUMA.1121.00091,1,3450828,3456359,-,5531
141,BUMA.1121.00047,1,1898646,1904177,-,5531
141,BUMA.1121.00067,1,3299601,3305129,-,5528
141,BUMA.1121.00110,1,3694447,3699977,-,5530
141,BUMA.1121.00073,1,1100527,1106059,+,5532
141,BUMA.1121.00072,1,1075639,1081171,+,5532
141,BUMA.1121.00077,1,3792324,3797853,+,5529
141,BUMA.1121.00082,1,1217480,1223012,+,5532
141,BUMA.1121.00062,1,3465416,3470944,-,5528
141,BUMA.1121.00007,1,3026096,3031612,-,5516
141,BUMA.1121.00025,1,1605396,1610928,-,5532
141,BUMA.1121.00021,1,1727747,1733280,+,5533
141,BUMA.1121.00103,1,3322820,3328352,-,5532
141,BUMA.1121.00079,1,1118431,1123963,+,5532
141,BUMA.1121.00039,1,1216739,1222264,+,5525
141,BUMA.1121.00083,1,481807,487340,-,5533
141,BUMA.1121.00084,1,1313260,1318789,+,5529
141,BUMA.1121.00049,1,760634,766165,-,5531
141,BUMA.1121.00089,1,1093484,1099016,+,5532
141,BUMA.1121.00014,1,1733451,1738983,-,5532
141,BUMA.1121.00090,1,3195248,3200779,+,5531
141,BUMA.1121.00071,1,1092714,1098246,+,5532
141,BUMA.1121.00078,1,867384,872915,-,5531
141,BUMA.1121.00102,1,126151,131666,-,5515
141,BUMA.1121.00075,1,597721,603236,+,5515
141,BUMA.1121.00012,1,3877939,3883470,+,5531
141,BUMA.1121.00076,1,276467,281984,-,5517
141,BUMA.1121.00106,1,860064,865593,+,5529
141,BUMA.1121.00001,1,2986502,2992036,-,5534
141,BUMA.1121.00107,1,990293,995824,+,5531
141,BUMA.1121.00104,1,198673,204204,-,5531
141,BUMA.1121.00099,1,1284210,1289742,-,5532
141,BUMA.1121.00098,1,3820779,3826308,+,5529
141,BUMA.1121.00111,1,1234357,1239888,+,5531
141,BUMA.1121.00109,1,760581,766111,-,5530
141,BUMA.1121.00097,1,2904476,2910010,-,5534
141,BUMA.1121.00094,1,1077113,1082645,+,5532
141,BUMA.1121.00095,1,579615,585118,-,5503
141,BUMA.1121.00005,1,2490400,2495931,-,5531
141,BUMA.1121.00101,1,1368328,1373858,-,5530
141,BUMA.1121.00065,1,1160430,1165961,+,5531
141,BUMA.1121.00100,1,184635,190167,-,5532
141,BUMA.1121.00105,1,108353,113885,-,5532
141,BUMA.1121.00029,1,3834869,3840403,-,5534
141,BUMA.1121.00066,1,1076973,1082505,+,5532
141,BUMA.1121.00031,1,2479598,2485129,+,5531
141,BUMA.1121.00108,1,2090963,2096492,+,5529
141,BUMA.1121.00023,1,3456269,3461807,+,5538
141,BUMA.1121.00035,1,2203430,2208963,+,5533
141,BUMA.1121.00041,1,2360066,2365596,+,5530
140,BUMA.1121.00057,1,2193546,2198806,+,5260
140,BUMA.1121.00058,1,3510174,3515422,-,5248
140,BUMA.1121.00045,1,2970992,2976241,-,5249
140,BUMA.1121.00051,1,1089358,1094608,+,5250
140,BUMA.1121.00068,1,3953183,3958435,+,5252
140,BUMA.1121.00061,1,1096997,1102253,+,5256
140,BUMA.1121.00060,1,1196599,1201848,-,5249
140,BUMA.1121.00064,1,1120573,1125817,+,5244
140,BUMA.1121.00016,1,3215155,3220396,+,5241
140,BUMA.1121.00003,1,3571384,3576644,+,5260
140,BUMA.1121.00055,1,681863,687107,+,5244
140,BUMA.1121.00011,1,505825,511061,-,5236
140,BUMA.1121.00037,1,3735465,3740713,+,5248
140,BUMA.1121.00009,1,475845,481083,-,5238
140,BUMA.1121.00069,1,1050510,1055768,+,5258
140,BUMA.1121.00088,1,1961127,1966370,+,5243
140,BUMA.1121.00092,1,2774433,2779682,-,5249
140,BUMA.1121.00074,1,2783133,2788382,-,5249
140,BUMA.1121.00070,1,1067968,1073225,+,5257
140,BUMA.1121.00093,1,1846746,1851996,+,5250
140,BUMA.1121.00063,1,1094275,1099532,+,5257
140,BUMA.1121.00033,1,3334589,3339849,+,5260
140,BUMA.1121.00018,1,1643352,1648613,+,5261
140,BUMA.1121.00080,1,1117828,1123078,+,5250
140,BUMA.1121.00027,1,3306746,3311996,+,5250
140,BUMA.1121.00053,1,819334,824595,+,5261
140,BUMA.1121.00059,1,323081,328331,+,5250
140,BUMA.1121.00043,1,1074870,1080122,+,5252
140,BUMA.1121.00056,1,2833924,2839172,-,5248
140,BUMA.1121.00112,1,1973996,1979232,-,5236
140,BUMA.1121.00091,1,3456651,3461900,-,5249
140,BUMA.1121.00047,1,1905816,1911064,-,5248
140,BUMA.1121.00067,1,3305392,3310641,-,5249
140,BUMA.1121.00110,1,3700240,3705489,-,5249
140,BUMA.1121.00073,1,1094901,1100158,+,5257
140,BUMA.1121.00072,1,1070013,1075270,+,5257
140,BUMA.1121.00077,1,3786808,3792061,+,5253
140,BUMA.1121.00082,1,1211850,1217110,+,5260
140,BUMA.1121.00062,1,3471207,3476456,-,5249
140,BUMA.1121.00007,1,3031924,3037166,-,5242
140,BUMA.1121.00025,1,1611239,1616499,-,5260
140,BUMA.1121.00021,1,1722156,1727406,+,5250
140,BUMA.1121.00103,1,3328616,3333865,-,5249
140,BUMA.1121.00079,1,1111542,1116792,+,5250
140,BUMA.1121.00039,1,1211081,1216331,+,5250
140,BUMA.1121.00083,1,487710,492969,-,5259
140,BUMA.1121.00084,1,1307744,1312987,+,5243
140,BUMA.1121.00049,1,766428,771677,-,5249
140,BUMA.1121.00089,1,1086596,1091845,+,5249
140,BUMA.1121.00014,1,1739371,1744614,-,5243
140,BUMA.1121.00090,1,3189593,3194843,+,5250
140,BUMA.1121.00071,1,1087100,1092357,+,5257
140,BUMA.1121.00078,1,873197,878445,-,5248
140,BUMA.1121.00102,1,131961,137210,-,5249
140,BUMA.1121.00075,1,592149,597399,+,5250
140,BUMA.1121.00012,1,3872378,3877639,+,5261
140,BUMA.1121.00076,1,282296,287545,-,5249
140,BUMA.1121.00106,1,854551,859801,+,5250
140,BUMA.1121.00001,1,2995428,3000664,-,5236
140,BUMA.1121.00107,1,984711,989972,+,5261
140,BUMA.1121.00104,1,204467,209715,-,5248
140,BUMA.1121.00099,1,1290014,1295263,-,5249
140,BUMA.1121.00098,1,3815247,3820507,+,5260
140,BUMA.1121.00111,1,1228640,1233889,+,5249
140,BUMA.1121.00109,1,766402,771637,-,5235
140,BUMA.1121.00097,1,2910291,2915551,-,5260
140,BUMA.1121.00094,1,1070225,1075474,+,5249
140,BUMA.1121.00095,1,585409,590657,-,5248
140,BUMA.1121.00005,1,2496242,2501502,-,5260
140,BUMA.1121.00101,1,1374122,1379370,-,5248
140,BUMA.1121.00065,1,1154868,1160129,+,5261
140,BUMA.1121.00100,1,190431,195674,-,5243
140,BUMA.1121.00105,1,114220,119463,-,5243
140,BUMA.1121.00029,1,3840684,3845938,-,5254
140,BUMA.1121.00066,1,1071347,1076604,+,5257
140,BUMA.1121.00031,1,2473960,2479210,+,5250
140,BUMA.1121.00108,1,2085421,2090669,+,5248
140,BUMA.1121.00023,1,3450578,3455828,+,5250
140,BUMA.1121.00035,1,2197895,2203149,+,5254
140,BUMA.1121.00041,1,2354553,2359803,+,5250
139,BUMA.1121.00057,1,2184047,2193545,+,9498
139,BUMA.1121.00058,1,3515424,3524922,-,9498
139,BUMA.1121.00045,1,2976243,2985721,-,9478
139,BUMA.1121.00051,1,1079892,1089357,+,9465
139,BUMA.1121.00068,1,3943687,3953182,+,9495
139,BUMA.1121.00061,1,1087501,1096996,+,9495
139,BUMA.1121.00060,1,1201850,1211328,-,9478
139,BUMA.1121.00064,1,1111108,1120572,+,9464
139,BUMA.1121.00016,1,3205657,3215154,+,9497
139,BUMA.1121.00003,1,3561887,3571383,+,9496
139,BUMA.1121.00055,1,672366,681862,+,9496
139,BUMA.1121.00011,1,511063,520558,-,9495
139,BUMA.1121.00037,1,3725964,3735464,+,9500
139,BUMA.1121.00009,1,481097,490589,-,9492
139,BUMA.1121.00069,1,1041013,1050509,+,9496
139,BUMA.1121.00088,1,1951631,1961126,+,9495
139,BUMA.1121.00092,1,2779684,2789149,-,9465
139,BUMA.1121.00074,1,2788384,2797883,-,9499
139,BUMA.1121.00070,1,1058471,1067967,+,9496
139,BUMA.1121.00093,1,1837279,1846745,+,9466
139,BUMA.1121.00063,1,1084778,1094274,+,9496
139,BUMA.1121.00033,1,3325092,3334588,+,9496
139,BUMA.1121.00018,1,1633854,1643351,+,9497
139,BUMA.1121.00080,1,1108330,1117827,+,9497
139,BUMA.1121.00027,1,3297282,3306745,+,9463
139,BUMA.1121.00053,1,809838,819333,+,9495
139,BUMA.1121.00059,1,313628,323080,+,9452
139,BUMA.1121.00043,1,1065372,1074869,+,9497
139,BUMA.1121.00056,1,2839174,2848671,-,9497
139,BUMA.1121.00112,1,1979234,1988691,-,9457
139,BUMA.1121.00091,1,3461902,3471423,-,9521
139,BUMA.1121.00047,1,1911066,1920563,-,9497
139,BUMA.1121.00067,1,3310643,3320142,-,9499
139,BUMA.1121.00110,1,3705491,3714985,-,9494
139,BUMA.1121.00073,1,1085404,1094900,+,9496
139,BUMA.1121.00072,1,1060516,1070012,+,9496
139,BUMA.1121.00077,1,3777312,3786807,+,9495
139,BUMA.1121.00082,1,1202353,1211849,+,9496
139,BUMA.1121.00062,1,3476458,3485923,-,9465
139,BUMA.1121.00007,1,3037168,3046671,-,9503
139,BUMA.1121.00025,1,1616501,1625997,-,9496
139,BUMA.1121.00021,1,1712655,1722155,+,9500
139,BUMA.1121.00103,1,3333867,3343362,-,9495
139,BUMA.1121.00096,1,2189052,2198540,-,9488
139,BUMA.1121.00079,1,1102076,1111541,+,9465
139,BUMA.1121.00039,1,1201580,1211080,+,9500
139,BUMA.1121.00083,1,492971,502466,-,9495
139,BUMA.1121.00084,1,1298243,1307743,+,9500
139,BUMA.1121.00049,1,771679,781142,-,9463
139,BUMA.1121.00089,1,1077097,1086595,+,9498
139,BUMA.1121.00014,1,1744616,1754115,-,9499
139,BUMA.1121.00090,1,3180092,3189592,+,9500
139,BUMA.1121.00071,1,1077603,1087099,+,9496
139,BUMA.1121.00078,1,878447,887938,-,9491
139,BUMA.1121.00102,1,137212,146707,-,9495
139,BUMA.1121.00075,1,582649,592148,+,9499
139,BUMA.1121.00012,1,3862880,3872377,+,9497
139,BUMA.1121.00076,1,287547,297045,-,9498
139,BUMA.1121.00106,1,845084,854550,+,9466
139,BUMA.1121.00001,1,3014457,3023947,-,9490
139,BUMA.1121.00107,1,975215,984710,+,9495
139,BUMA.1121.00104,1,209717,219180,-,9463
139,BUMA.1121.00099,1,1295265,1304761,-,9496
139,BUMA.1121.00098,1,3805751,3815246,+,9495
139,BUMA.1121.00111,1,1219139,1228639,+,9500
139,BUMA.1121.00109,1,805071,814559,-,9488
139,BUMA.1121.00097,1,2915553,2925047,-,9494
139,BUMA.1121.00094,1,1060758,1070224,+,9466
139,BUMA.1121.00095,1,590659,600162,-,9503
139,BUMA.1121.00005,1,2501504,2510998,-,9494
139,BUMA.1121.00101,1,1379372,1388894,-,9522
139,BUMA.1121.00065,1,1145372,1154867,+,9495
139,BUMA.1121.00100,1,231814,241270,-,9456
139,BUMA.1121.00105,1,119465,128928,-,9463
139,BUMA.1121.00029,1,3868056,3877545,-,9489
139,BUMA.1121.00066,1,1061850,1071346,+,9496
139,BUMA.1121.00031,1,2464459,2473959,+,9500
139,BUMA.1121.00108,1,2075941,2085420,+,9479
139,BUMA.1121.00023,1,3441077,3450577,+,9500
139,BUMA.1121.00035,1,2147285,2156776,+,9491
139,BUMA.1121.00041,1,2345056,2354552,+,9496
138,BUMA.1121.00057,1,2162219,2182197,+,19978
138,BUMA.1121.00058,1,3526773,3546648,-,19875
138,BUMA.1121.00045,1,2987572,3007515,-,19943
138,BUMA.1121.00051,1,1058147,1078042,+,19895
138,BUMA.1121.00068,1,3921989,3941837,+,19848
138,BUMA.1121.00061,1,1064600,1085651,+,21051
138,BUMA.1121.00060,1,1213179,1233104,-,19925
138,BUMA.1121.00064,1,1089274,1109258,+,19984
138,BUMA.1121.00016,1,3183895,3203807,+,19912
138,BUMA.1121.00003,1,3540215,3560037,+,19822
138,BUMA.1121.00055,1,650583,670516,+,19933
138,BUMA.1121.00011,1,522409,542306,-,19897
138,BUMA.1121.00037,1,3704156,3724114,+,19958
138,BUMA.1121.00009,1,492440,512334,-,19894
138,BUMA.1121.00069,1,1018054,1039163,+,21109
138,BUMA.1121.00088,1,1929913,1949781,+,19868
138,BUMA.1121.00092,1,2791000,2810966,-,19966
138,BUMA.1121.00074,1,2799734,2819628,-,19894
138,BUMA.1121.00070,1,1035963,1056621,+,20658
138,BUMA.1121.00093,1,1815463,1835429,+,19966
138,BUMA.1121.00063,1,1061877,1082928,+,21051
138,BUMA.1121.00033,1,3303437,3323242,+,19805
138,BUMA.1121.00018,1,1612034,1632004,+,19970
138,BUMA.1121.00080,1,1086605,1106480,+,19875
138,BUMA.1121.00027,1,3275466,3295432,+,19966
138,BUMA.1121.00053,1,788124,807988,+,19864
138,BUMA.1121.00059,1,291876,311778,+,19902
138,BUMA.1121.00043,1,1043718,1063522,+,19804
138,BUMA.1121.00056,1,2850522,2870400,-,19878
138,BUMA.1121.00112,1,1990542,2010421,-,19879
138,BUMA.1121.00091,1,3473274,3493276,-,20002
138,BUMA.1121.00047,1,1922414,1942319,-,19905
138,BUMA.1121.00067,1,3321993,3341998,-,20005
138,BUMA.1121.00110,1,3716836,3736730,-,19894
138,BUMA.1121.00073,1,1062850,1083554,+,20704
138,BUMA.1121.00072,1,1037557,1058666,+,21109
138,BUMA.1121.00077,1,3755533,3775462,+,19929
138,BUMA.1121.00082,1,1179394,1200503,+,21109
138,BUMA.1121.00062,1,3487774,3507745,-,19971
138,BUMA.1121.00007,1,3048522,3068413,-,19891
138,BUMA.1121.00025,1,1627848,1647827,-,19979
138,BUMA.1121.00021,1,1690827,1710805,+,19978
138,BUMA.1121.00103,1,3345213,3365171,-,19958
138,BUMA.1121.00096,1,2200391,2220261,-,19870
138,BUMA.1121.00079,1,1080172,1100226,+,20054
138,BUMA.1121.00039,1,1179855,1199730,+,19875
138,BUMA.1121.00083,1,504317,525426,-,21109
138,BUMA.1121.00084,1,1276509,1296393,+,19884
138,BUMA.1121.00049,1,782993,802953,-,19960
138,BUMA.1121.00089,1,1055261,1075247,+,19986
138,BUMA.1121.00014,1,1755966,1775821,-,19855
138,BUMA.1121.00090,1,3158356,3178242,+,19886
138,BUMA.1121.00071,1,1054645,1075753,+,21108
138,BUMA.1121.00078,1,889789,909711,-,19922
138,BUMA.1121.00102,1,148558,168621,-,20063
138,BUMA.1121.00075,1,560833,580799,+,19966
138,BUMA.1121.00012,1,3841220,3861030,+,19810
138,BUMA.1121.00076,1,298896,318873,-,19977
138,BUMA.1121.00106,1,823375,843234,+,19859
138,BUMA.1121.00001,1,3025798,3045756,-,19958
138,BUMA.1121.00107,1,953451,973365,+,19914
138,BUMA.1121.00104,1,221031,241025,-,19994
138,BUMA.1121.00099,1,1306612,1326622,-,20010
138,BUMA.1121.00098,1,3783858,3803901,+,20043
138,BUMA.1121.00111,1,1197439,1217289,+,19850
138,BUMA.1121.00109,1,816410,836313,-,19903
138,BUMA.1121.00097,1,2926898,2946777,-,19879
138,BUMA.1121.00094,1,1038922,1058908,+,19986
138,BUMA.1121.00095,1,602013,621983,-,19970
138,BUMA.1121.00005,1,2512849,2532793,-,19944
138,BUMA.1121.00101,1,1390745,1410636,-,19891
138,BUMA.1121.00065,1,1123549,1143522,+,19973
138,BUMA.1121.00100,1,243121,262981,-,19860
138,BUMA.1121.00105,1,130779,150718,-,19939
138,BUMA.1121.00029,1,3879396,3899283,-,19887
138,BUMA.1121.00066,1,1038893,1060000,+,21107
138,BUMA.1121.00031,1,2442796,2462609,+,19813
138,BUMA.1121.00108,1,2054215,2074091,+,19876
138,BUMA.1121.00023,1,3419390,3439227,+,19837
138,BUMA.1121.00035,1,2125575,2145435,+,19860
138,BUMA.1121.00041,1,2323176,2343206,+,20030
137,BUMA.1121.00057,1,2103149,2162111,+,58962
137,BUMA.1121.00058,1,3546735,3605729,-,58994
137,BUMA.1121.00045,1,3007635,3066740,-,59105
137,BUMA.1121.00051,1,999011,1058046,+,59035
137,BUMA.1121.00068,1,3862853,3921869,+,59016
137,BUMA.1121.00061,1,1005464,1064450,+,58986
137,BUMA.1121.00060,1,1233224,1292329,-,59105
137,BUMA.1121.00064,1,1030161,1089145,+,58984
137,BUMA.1121.00016,1,3124673,3183745,+,59072
137,BUMA.1121.00003,1,3480997,3540135,+,59138
137,BUMA.1121.00055,1,591477,650501,+,59024
137,BUMA.1121.00011,1,542442,604182,-,61740
137,BUMA.1121.00037,1,3645011,3704020,+,59009
137,BUMA.1121.00009,1,512435,571549,-,59114
137,BUMA.1121.00069,1,958927,1017904,+,58977
137,BUMA.1121.00088,1,1870789,1929798,+,59009
137,BUMA.1121.00092,1,2811081,2870157,-,59076
137,BUMA.1121.00074,1,2819729,2878739,-,59010
137,BUMA.1121.00070,1,976830,1035813,+,58983
137,BUMA.1121.00093,1,1756272,1815348,+,59076
137,BUMA.1121.00063,1,1002774,1061732,+,58958
137,BUMA.1121.00033,1,3244317,3303322,+,59005
137,BUMA.1121.00018,1,1552949,1611919,+,58970
137,BUMA.1121.00080,1,1027439,1086490,+,59051
137,BUMA.1121.00027,1,3216352,3275351,+,58999
137,BUMA.1121.00053,1,729061,788044,+,58983
137,BUMA.1121.00059,1,232680,291712,+,59032
137,BUMA.1121.00043,1,984474,1043596,+,59122
137,BUMA.1121.00056,1,2870501,2929481,-,58980
137,BUMA.1121.00112,1,2010599,2069571,-,58972
137,BUMA.1121.00091,1,3493349,3552216,-,58867
137,BUMA.1121.00047,1,1942420,2001376,-,58956
137,BUMA.1121.00067,1,3342099,3401079,-,58980
137,BUMA.1121.00110,1,3736857,3795856,-,58999
137,BUMA.1121.00073,1,1003714,1062700,+,58986
137,BUMA.1121.00072,1,978598,1037430,+,58832
137,BUMA.1121.00077,1,3696415,3755406,+,58991
137,BUMA.1121.00082,1,1120240,1179244,+,59004
137,BUMA.1121.00062,1,3507895,3568149,-,60254
137,BUMA.1121.00007,1,3068556,3127609,-,59053
137,BUMA.1121.00025,1,1647942,1706919,-,58977
137,BUMA.1121.00021,1,1631721,1690684,+,58963
137,BUMA.1121.00103,1,3366869,3425714,-,58845
137,BUMA.1121.00096,1,2220335,2279386,-,59051
137,BUMA.1121.00079,1,1021095,1080057,+,58962
137,BUMA.1121.00039,1,1120663,1179677,+,59014
137,BUMA.1121.00083,1,525576,584580,-,59004
137,BUMA.1121.00084,1,1217331,1276394,+,59063
137,BUMA.1121.00049,1,803061,862021,-,58960
137,BUMA.1121.00089,1,996179,1055160,+,58981
137,BUMA.1121.00014,1,1775971,1835011,-,59040
137,BUMA.1121.00090,1,3099303,3158255,+,58952
137,BUMA.1121.00071,1,995547,1054495,+,58948
137,BUMA.1121.00078,1,909826,968926,-,59100
137,BUMA.1121.00102,1,168736,227902,-,59166
137,BUMA.1121.00075,1,501677,560683,+,59006
137,BUMA.1121.00012,1,3782035,3841056,+,59021
137,BUMA.1121.00076,1,319023,378048,-,59025
137,BUMA.1121.00106,1,764136,823232,+,59096
137,BUMA.1121.00001,1,3045892,3104886,-,58994
137,BUMA.1121.00107,1,894213,953289,+,59076
137,BUMA.1121.00104,1,241147,300130,-,58983
137,BUMA.1121.00099,1,1326737,1385867,-,59130
137,BUMA.1121.00098,1,3724610,3783687,+,59077
137,BUMA.1121.00111,1,1138306,1197317,+,59011
137,BUMA.1121.00109,1,836477,896868,-,60391
137,BUMA.1121.00097,1,2946871,3006113,-,59242
137,BUMA.1121.00094,1,979838,1038821,+,58983
137,BUMA.1121.00095,1,622112,681182,-,59070
137,BUMA.1121.00005,1,2532901,2591825,-,58924
137,BUMA.1121.00101,1,1410765,1469818,-,59053
137,BUMA.1121.00065,1,1064440,1123469,+,59029
137,BUMA.1121.00100,1,263068,322078,-,59010
137,BUMA.1121.00105,1,150805,209876,-,59071
137,BUMA.1121.00029,1,3899412,3958385,-,58973
137,BUMA.1121.00066,1,979787,1038750,+,58963
137,BUMA.1121.00031,1,2383668,2442660,+,58992
137,BUMA.1121.00108,1,1995007,2054030,+,59023
137,BUMA.1121.00023,1,3360221,3419254,+,59033
137,BUMA.1121.00035,1,2066494,2125439,+,58945
137,BUMA.1121.00041,1,2264035,2323054,+,59019
136,BUMA.1121.00057,1,2095212,2099938,+,4726
136,BUMA.1121.00058,1,3608940,3613666,-,4726
136,BUMA.1121.00045,1,3069951,3074678,-,4727
136,BUMA.1121.00051,1,991074,995799,+,4725
136,BUMA.1121.00068,1,3854915,3859641,+,4726
136,BUMA.1121.00061,1,997527,1002253,+,4726
136,BUMA.1121.00060,1,1295540,1300267,-,4727
136,BUMA.1121.00064,1,1022224,1026949,+,4725
136,BUMA.1121.00016,1,3116735,3121461,+,4726
136,BUMA.1121.00003,1,3473059,3477785,+,4726
136,BUMA.1121.00055,1,583539,588265,+,4726
136,BUMA.1121.00011,1,607402,612129,-,4727
136,BUMA.1121.00037,1,3636604,3641799,+,5195
136,BUMA.1121.00009,1,574760,579487,-,4727
136,BUMA.1121.00069,1,950990,955716,+,4726
136,BUMA.1121.00088,1,1862852,1867577,+,4725
136,BUMA.1121.00092,1,2873368,2878095,-,4727
136,BUMA.1121.00074,1,2881950,2886676,-,4726
136,BUMA.1121.00070,1,968893,973619,+,4726
136,BUMA.1121.00093,1,1748334,1753060,+,4726
136,BUMA.1121.00063,1,994837,999563,+,4726
136,BUMA.1121.00033,1,3236379,3241105,+,4726
136,BUMA.1121.00018,1,1545011,1549737,+,4726
136,BUMA.1121.00080,1,1019502,1024227,+,4725
136,BUMA.1121.00027,1,3208415,3213141,+,4726
136,BUMA.1121.00053,1,721123,725849,+,4726
136,BUMA.1121.00059,1,224743,229468,+,4725
136,BUMA.1121.00043,1,976536,981262,+,4726
136,BUMA.1121.00056,1,2932692,2937419,-,4727
136,BUMA.1121.00112,1,2072791,2077518,-,4727
136,BUMA.1121.00091,1,3555436,3560163,-,4727
136,BUMA.1121.00047,1,2004587,2009301,-,4714
136,BUMA.1121.00067,1,3404290,3409017,-,4727
136,BUMA.1121.00110,1,3799067,3803793,-,4726
136,BUMA.1121.00073,1,995777,1000503,+,4726
136,BUMA.1121.00072,1,970661,975387,+,4726
136,BUMA.1121.00077,1,3688478,3693203,+,4725
136,BUMA.1121.00082,1,1112303,1117029,+,4726
136,BUMA.1121.00062,1,3571360,3576086,-,4726
136,BUMA.1121.00007,1,3130820,3135547,-,4727
136,BUMA.1121.00025,1,1710130,1714857,-,4727
136,BUMA.1121.00021,1,1623783,1628509,+,4726
136,BUMA.1121.00103,1,3430560,3435287,-,4727
136,BUMA.1121.00096,1,2282606,2287333,-,4727
136,BUMA.1121.00079,1,1013158,1017883,+,4725
136,BUMA.1121.00039,1,1112725,1117451,+,4726
136,BUMA.1121.00083,1,587790,592517,-,4727
136,BUMA.1121.00084,1,1209394,1214119,+,4725
136,BUMA.1121.00049,1,865232,869958,-,4726
136,BUMA.1121.00089,1,988241,992967,+,4726
136,BUMA.1121.00014,1,1838222,1842949,-,4727
136,BUMA.1121.00090,1,3091365,3096091,+,4726
136,BUMA.1121.00071,1,987610,992336,+,4726
136,BUMA.1121.00078,1,972136,976826,-,4690
136,BUMA.1121.00102,1,231113,235840,-,4727
136,BUMA.1121.00075,1,493740,498465,+,4725
136,BUMA.1121.00012,1,3774097,3778823,+,4726
136,BUMA.1121.00076,1,381259,385985,-,4726
136,BUMA.1121.00106,1,756199,760924,+,4725
136,BUMA.1121.00001,1,3108097,3112824,-,4727
136,BUMA.1121.00107,1,885799,891001,+,5202
136,BUMA.1121.00104,1,303341,308067,-,4726
136,BUMA.1121.00099,1,1389078,1393804,-,4726
136,BUMA.1121.00098,1,3716672,3721398,+,4726
136,BUMA.1121.00111,1,1130368,1135094,+,4726
136,BUMA.1121.00109,1,900088,904815,-,4727
136,BUMA.1121.00097,1,3009324,3014051,-,4727
136,BUMA.1121.00094,1,971903,976628,+,4725
136,BUMA.1121.00095,1,684384,689111,-,4727
136,BUMA.1121.00005,1,2595045,2599772,-,4727
136,BUMA.1121.00101,1,1473029,1477756,-,4727
136,BUMA.1121.00065,1,1056502,1061228,+,4726
136,BUMA.1121.00100,1,325289,330015,-,4726
136,BUMA.1121.00105,1,213087,217813,-,4726
136,BUMA.1121.00029,1,3961596,3966323,-,4727
136,BUMA.1121.00066,1,971850,976576,+,4726
136,BUMA.1121.00031,1,2375730,2380456,+,4726
136,BUMA.1121.00108,1,1987069,1991795,+,4726
136,BUMA.1121.00023,1,3352283,3357009,+,4726
136,BUMA.1121.00035,1,2058556,2063282,+,4726
136,BUMA.1121.00041,1,2256079,2260805,+,4726
135,BUMA.1121.00057,1,2089230,2092793,+,3563
135,BUMA.1121.00027,1,3202435,3205996,+,3561
135,BUMA.1121.00082,1,1106321,1109884,+,3563
135,BUMA.1121.00083,1,594935,598499,-,3564
135,BUMA.1121.00097,1,3016469,3020033,-,3564
135,BUMA.1121.00101,1,1480174,1483738,-,3564
134,BUMA.1121.00057,1,2073789,2082476,+,8687
134,BUMA.1121.00009,1,590230,598910,-,8680
134,BUMA.1121.00092,1,2881077,2889765,-,8688
134,BUMA.1121.00093,1,1736664,1745351,+,8687
134,BUMA.1121.00027,1,3173483,3182168,+,8685
134,BUMA.1121.00072,1,960473,969160,+,8687
134,BUMA.1121.00082,1,1090880,1099567,+,8687
134,BUMA.1121.00083,1,605252,613940,-,8688
134,BUMA.1121.00097,1,3026782,3035470,-,8688
134,BUMA.1121.00101,1,1490487,1499175,-,8688
134,BUMA.1121.00065,1,1033236,1041923,+,8687
133,BUMA.1121.00057,1,2055309,2073784,+,18475
133,BUMA.1121.00058,1,3628763,3647295,-,18532
133,BUMA.1121.00045,1,3086847,3105334,-,18487
133,BUMA.1121.00051,1,972515,991071,+,18556
133,BUMA.1121.00068,1,3836335,3854912,+,18577
133,BUMA.1121.00061,1,978069,996528,+,18459
133,BUMA.1121.00060,1,1312436,1330923,-,18487
133,BUMA.1121.00064,1,1003721,1022221,+,18500
133,BUMA.1121.00016,1,3080738,3099211,+,18473
133,BUMA.1121.00003,1,3454533,3473056,+,18523
133,BUMA.1121.00055,1,545052,563543,+,18491
133,BUMA.1121.00011,1,612132,630628,-,18496
133,BUMA.1121.00037,1,3598643,3617117,+,18474
133,BUMA.1121.00009,1,598915,617414,-,18499
133,BUMA.1121.00069,1,931007,949440,+,18433
133,BUMA.1121.00088,1,1844374,1862849,+,18475
133,BUMA.1121.00092,1,2889770,2908278,-,18508
133,BUMA.1121.00074,1,2886679,2905179,-,18500
133,BUMA.1121.00070,1,949278,967735,+,18457
133,BUMA.1121.00093,1,1718150,1736659,+,18509
133,BUMA.1121.00063,1,975246,993709,+,18463
133,BUMA.1121.00033,1,3205701,3224222,+,18521
133,BUMA.1121.00018,1,1513916,1532378,+,18462
133,BUMA.1121.00080,1,1000943,1019499,+,18556
133,BUMA.1121.00027,1,3154980,3173478,+,18498
133,BUMA.1121.00053,1,683359,701877,+,18518
133,BUMA.1121.00059,1,206245,224740,+,18495
133,BUMA.1121.00043,1,942684,961158,+,18474
133,BUMA.1121.00056,1,2937422,2955978,-,18556
133,BUMA.1121.00112,1,2090808,2109325,-,18517
133,BUMA.1121.00091,1,3560166,3578654,-,18488
133,BUMA.1121.00047,1,2009304,2027852,-,18548
133,BUMA.1121.00067,1,3409020,3427531,-,18511
133,BUMA.1121.00110,1,3816463,3834994,-,18531
133,BUMA.1121.00073,1,976140,994598,+,18458
133,BUMA.1121.00072,1,942013,960468,+,18455
133,BUMA.1121.00077,1,3657280,3675809,+,18529
133,BUMA.1121.00082,1,1072400,1090875,+,18475
133,BUMA.1121.00062,1,3576089,3594578,-,18489
133,BUMA.1121.00007,1,3148952,3167580,-,18628
133,BUMA.1121.00025,1,1727490,1745951,-,18461
133,BUMA.1121.00021,1,1584347,1602821,+,18474
133,BUMA.1121.00103,1,3435290,3453809,-,18519
133,BUMA.1121.00096,1,2287336,2305833,-,18497
133,BUMA.1121.00079,1,994608,1013155,+,18547
133,BUMA.1121.00039,1,1079899,1098397,+,18498
133,BUMA.1121.00083,1,613945,632419,-,18474
133,BUMA.1121.00084,1,1190916,1209391,+,18475
133,BUMA.1121.00049,1,869961,888434,-,18473
133,BUMA.1121.00089,1,969682,988238,+,18556
133,BUMA.1121.00014,1,1849028,1867501,-,18473
133,BUMA.1121.00090,1,3059948,3078422,+,18474
133,BUMA.1121.00071,1,968195,986643,+,18448
133,BUMA.1121.00078,1,1021724,1040239,-,18515
133,BUMA.1121.00102,1,248502,266950,-,18448
133,BUMA.1121.00075,1,475242,493737,+,18495
133,BUMA.1121.00012,1,3743821,3762340,+,18519
133,BUMA.1121.00076,1,385988,404482,-,18494
133,BUMA.1121.00106,1,737718,756196,+,18478
133,BUMA.1121.00001,1,3125564,3144052,-,18488
133,BUMA.1121.00107,1,811871,830385,+,18514
133,BUMA.1121.00104,1,308070,326543,-,18473
133,BUMA.1121.00099,1,1393807,1412292,-,18485
133,BUMA.1121.00098,1,3685452,3704012,+,18560
133,BUMA.1121.00111,1,1096341,1114815,+,18474
133,BUMA.1121.00109,1,904818,923317,-,18499
133,BUMA.1121.00097,1,3035475,3054025,-,18550
133,BUMA.1121.00094,1,953395,971900,+,18505
133,BUMA.1121.00095,1,689114,707572,-,18458
133,BUMA.1121.00005,1,2599775,2618245,-,18470
133,BUMA.1121.00101,1,1499180,1517624,-,18444
133,BUMA.1121.00065,1,1014687,1033231,+,18544
133,BUMA.1121.00100,1,330018,348508,-,18490
133,BUMA.1121.00105,1,217816,236282,-,18466
133,BUMA.1121.00029,1,3979063,3997551,-,18488
133,BUMA.1121.00066,1,952296,970750,+,18454
133,BUMA.1121.00031,1,2351178,2369652,+,18474
133,BUMA.1121.00108,1,1955100,1973659,+,18559
133,BUMA.1121.00023,1,3319585,3338065,+,18480
133,BUMA.1121.00035,1,2034036,2052525,+,18489
133,BUMA.1121.00041,1,2237581,2256076,+,18495
132,BUMA.1121.00057,1,2024640,2055308,+,30668
132,BUMA.1121.00058,1,3647297,3677938,-,30641
132,BUMA.1121.00045,1,3105336,3136044,-,30708
132,BUMA.1121.00051,1,940488,971157,+,30669
132,BUMA.1121.00068,1,3805631,3836334,+,30703
132,BUMA.1121.00061,1,947379,978068,+,30689
132,BUMA.1121.00060,1,1330925,1361633,-,30708
132,BUMA.1121.00064,1,972183,1002851,+,30668
132,BUMA.1121.00016,1,3050060,3080737,+,30677
132,BUMA.1121.00003,1,3423853,3454532,+,30679
132,BUMA.1121.00055,1,514364,545051,+,30687
132,BUMA.1121.00011,1,630630,661304,-,30674
132,BUMA.1121.00037,1,3567965,3598642,+,30677
132,BUMA.1121.00009,1,617416,648105,-,30689
132,BUMA.1121.00069,1,900318,931006,+,30688
132,BUMA.1121.00088,1,1813736,1844373,+,30637
132,BUMA.1121.00092,1,2908280,2938959,-,30679
132,BUMA.1121.00074,1,2906049,2936717,-,30668
132,BUMA.1121.00070,1,918588,949277,+,30689
132,BUMA.1121.00093,1,1687470,1718149,+,30679
132,BUMA.1121.00063,1,944556,975245,+,30689
132,BUMA.1121.00033,1,3175025,3205700,+,30675
132,BUMA.1121.00018,1,1483239,1513915,+,30676
132,BUMA.1121.00080,1,968909,999585,+,30676
132,BUMA.1121.00027,1,3124316,3154979,+,30663
132,BUMA.1121.00053,1,652682,683358,+,30676
132,BUMA.1121.00059,1,175565,206244,+,30679
132,BUMA.1121.00043,1,912014,942683,+,30669
132,BUMA.1121.00056,1,2957335,2988007,-,30672
132,BUMA.1121.00112,1,2109327,2140034,-,30707
132,BUMA.1121.00091,1,3578656,3609335,-,30679
132,BUMA.1121.00047,1,2027854,2058530,-,30676
132,BUMA.1121.00067,1,3428401,3459064,-,30663
132,BUMA.1121.00110,1,3834996,3865683,-,30687
132,BUMA.1121.00073,1,945450,976139,+,30689
132,BUMA.1121.00072,1,911323,942012,+,30689
132,BUMA.1121.00077,1,3626590,3657279,+,30689
132,BUMA.1121.00082,1,1041710,1072399,+,30689
132,BUMA.1121.00062,1,3594580,3625259,-,30679
132,BUMA.1121.00007,1,3167582,3198281,-,30699
132,BUMA.1121.00025,1,1745953,1776630,-,30677
132,BUMA.1121.00021,1,1553675,1584346,+,30671
132,BUMA.1121.00103,1,3453811,3484477,-,30666
132,BUMA.1121.00096,1,2305835,2336524,-,30689
132,BUMA.1121.00079,1,962578,993250,+,30672
132,BUMA.1121.00039,1,1049222,1079898,+,30676
132,BUMA.1121.00083,1,632421,663110,-,30689
132,BUMA.1121.00084,1,1160256,1190915,+,30659
132,BUMA.1121.00049,1,888436,919141,-,30705
132,BUMA.1121.00089,1,937653,968324,+,30671
132,BUMA.1121.00014,1,1867503,1898179,-,30676
132,BUMA.1121.00090,1,3029277,3059947,+,30670
132,BUMA.1121.00071,1,937522,968194,+,30672
132,BUMA.1121.00078,1,1040241,1070917,-,30676
132,BUMA.1121.00102,1,266952,297620,-,30668
132,BUMA.1121.00075,1,444590,475241,+,30651
132,BUMA.1121.00012,1,3710174,3740877,+,30703
132,BUMA.1121.00076,1,404484,435135,-,30651
132,BUMA.1121.00106,1,707080,737717,+,30637
132,BUMA.1121.00001,1,3144054,3174745,-,30691
132,BUMA.1121.00107,1,781170,811870,+,30700
132,BUMA.1121.00104,1,326545,357197,-,30652
132,BUMA.1121.00099,1,1412294,1442998,-,30704
132,BUMA.1121.00098,1,3654737,3685451,+,30714
132,BUMA.1121.00111,1,1065648,1096340,+,30692
132,BUMA.1121.00109,1,923319,954018,-,30699
132,BUMA.1121.00097,1,3054027,3084712,-,30685
132,BUMA.1121.00094,1,921366,952037,+,30671
132,BUMA.1121.00095,1,707574,738253,-,30679
132,BUMA.1121.00005,1,2619834,2650472,-,30638
132,BUMA.1121.00101,1,1517626,1548310,-,30684
132,BUMA.1121.00065,1,984009,1014686,+,30677
132,BUMA.1121.00100,1,349841,380520,-,30679
132,BUMA.1121.00105,1,236284,266961,-,30677
132,BUMA.1121.00029,1,3997553,4028242,-,30689
132,BUMA.1121.00066,1,921606,952295,+,30689
132,BUMA.1121.00031,1,2320507,2351177,+,30670
132,BUMA.1121.00108,1,1924421,1955099,+,30678
132,BUMA.1121.00023,1,3288895,3319584,+,30689
132,BUMA.1121.00035,1,2003343,2034035,+,30692
132,BUMA.1121.00041,1,2206890,2237580,+,30690
131,BUMA.1121.00057,1,2017306,2022670,+,5364
131,BUMA.1121.00058,1,3679908,3685376,-,5468
131,BUMA.1121.00045,1,3138014,3143700,-,5686
131,BUMA.1121.00051,1,932914,938518,+,5604
131,BUMA.1121.00068,1,3798146,3803661,+,5515
131,BUMA.1121.00061,1,940346,945409,+,5063
131,BUMA.1121.00060,1,1363603,1369289,-,5686
131,BUMA.1121.00064,1,964731,970213,+,5482
131,BUMA.1121.00016,1,3043143,3048090,+,4947
131,BUMA.1121.00003,1,3416180,3421883,+,5703
131,BUMA.1121.00055,1,506916,512394,+,5478
131,BUMA.1121.00011,1,663274,668845,-,5571
131,BUMA.1121.00037,1,3560238,3565995,+,5757
131,BUMA.1121.00009,1,650075,655510,-,5435
131,BUMA.1121.00069,1,893196,898348,+,5152
131,BUMA.1121.00088,1,1806086,1811766,+,5680
131,BUMA.1121.00092,1,2940929,2946440,-,5511
131,BUMA.1121.00074,1,2938687,2944169,-,5482
131,BUMA.1121.00070,1,911519,916618,+,5099
131,BUMA.1121.00093,1,1679989,1685500,+,5511
131,BUMA.1121.00063,1,937223,942586,+,5363
131,BUMA.1121.00033,1,3168085,3173055,+,4970
131,BUMA.1121.00018,1,1475607,1481269,+,5662
131,BUMA.1121.00080,1,961345,966939,+,5594
131,BUMA.1121.00027,1,3116983,3122346,+,5363
131,BUMA.1121.00053,1,645544,650712,+,5168
131,BUMA.1121.00059,1,168082,173595,+,5513
131,BUMA.1121.00043,1,905068,910044,+,4976
131,BUMA.1121.00056,1,2989977,2995566,-,5589
131,BUMA.1121.00112,1,2142004,2147188,-,5184
131,BUMA.1121.00091,1,3611305,3616817,-,5512
131,BUMA.1121.00047,1,2060500,2066104,-,5604
131,BUMA.1121.00067,1,3461034,3466488,-,5454
131,BUMA.1121.00110,1,3867653,3873258,-,5605
131,BUMA.1121.00073,1,938292,943480,+,5188
131,BUMA.1121.00072,1,904113,909353,+,5240
131,BUMA.1121.00077,1,3619015,3624620,+,5605
131,BUMA.1121.00082,1,1034377,1039740,+,5363
131,BUMA.1121.00062,1,3627229,3632720,-,5491
131,BUMA.1121.00007,1,3200251,3205841,-,5590
131,BUMA.1121.00025,1,1778600,1784262,-,5662
131,BUMA.1121.00021,1,1546741,1551705,+,4964
131,BUMA.1121.00103,1,3486447,3491940,-,5493
131,BUMA.1121.00096,1,2338494,2344058,-,5564
131,BUMA.1121.00079,1,955006,960608,+,5602
131,BUMA.1121.00039,1,1041660,1047252,+,5592
131,BUMA.1121.00083,1,665080,670443,-,5363
131,BUMA.1121.00084,1,1152594,1158286,+,5692
131,BUMA.1121.00049,1,921111,926740,-,5629
131,BUMA.1121.00089,1,930094,935683,+,5589
131,BUMA.1121.00014,1,1900149,1905757,-,5608
131,BUMA.1121.00090,1,3022325,3027307,+,4982
131,BUMA.1121.00071,1,930189,935552,+,5363
131,BUMA.1121.00078,1,1072887,1078303,-,5416
131,BUMA.1121.00102,1,299590,305052,-,5462
131,BUMA.1121.00075,1,437000,442620,+,5620
131,BUMA.1121.00012,1,3702724,3708204,+,5480
131,BUMA.1121.00076,1,437105,442725,-,5620
131,BUMA.1121.00106,1,699483,705110,+,5627
131,BUMA.1121.00001,1,3176715,3182347,-,5632
131,BUMA.1121.00107,1,773540,779200,+,5660
131,BUMA.1121.00104,1,359167,364787,-,5620
131,BUMA.1121.00099,1,1444968,1450548,-,5580
131,BUMA.1121.00098,1,3647230,3652767,+,5537
131,BUMA.1121.00111,1,1058686,1063678,+,4992
131,BUMA.1121.00109,1,955988,961320,-,5332
131,BUMA.1121.00097,1,3086682,3092267,-,5585
131,BUMA.1121.00094,1,914013,919396,+,5383
131,BUMA.1121.00095,1,740223,745740,-,5517
131,BUMA.1121.00005,1,2652442,2657776,-,5334
131,BUMA.1121.00101,1,1550280,1555816,-,5536
131,BUMA.1121.00065,1,976504,982039,+,5535
131,BUMA.1121.00100,1,382490,387912,-,5422
131,BUMA.1121.00105,1,270561,276202,-,5641
131,BUMA.1121.00029,1,4030212,4035845,-,5633
131,BUMA.1121.00066,1,914281,919636,+,5355
131,BUMA.1121.00031,1,2312929,2318537,+,5608
131,BUMA.1121.00108,1,1916913,1922451,+,5538
131,BUMA.1121.00023,1,3281228,3286925,+,5697
131,BUMA.1121.00035,1,1995726,2001373,+,5647
131,BUMA.1121.00041,1,2199353,2204920,+,5567
130,BUMA.1121.00057,1,1998223,2015770,+,17547
130,BUMA.1121.00058,1,3686902,3704333,-,17431
130,BUMA.1121.00045,1,3145253,3162772,-,17519
130,BUMA.1121.00051,1,913932,931379,+,17447
130,BUMA.1121.00068,1,3779060,3796610,+,17550
130,BUMA.1121.00061,1,921424,938810,+,17386
130,BUMA.1121.00060,1,1370842,1388385,-,17543
130,BUMA.1121.00064,1,945698,963186,+,17488
130,BUMA.1121.00016,1,3023944,3041607,+,17663
130,BUMA.1121.00003,1,3397015,3414644,+,17629
130,BUMA.1121.00055,1,487842,505371,+,17529
130,BUMA.1121.00011,1,670380,687883,-,17503
130,BUMA.1121.00037,1,3541228,3558702,+,17474
130,BUMA.1121.00009,1,657054,674641,-,17587
130,BUMA.1121.00069,1,874293,891660,+,17367
130,BUMA.1121.00088,1,1787033,1804559,+,17526
130,BUMA.1121.00092,1,2947975,2965519,-,17544
130,BUMA.1121.00074,1,2945713,2963186,-,17473
130,BUMA.1121.00070,1,892546,909983,+,17437
130,BUMA.1121.00093,1,1660910,1678453,+,17543
130,BUMA.1121.00063,1,918299,935687,+,17388
130,BUMA.1121.00033,1,3148940,3166549,+,17609
130,BUMA.1121.00018,1,1456589,1474071,+,17482
130,BUMA.1121.00080,1,942411,959809,+,17398
130,BUMA.1121.00027,1,3097948,3115447,+,17499
130,BUMA.1121.00053,1,626469,644008,+,17539
130,BUMA.1121.00059,1,149034,166546,+,17512
130,BUMA.1121.00043,1,885840,903532,+,17692
130,BUMA.1121.00056,1,2997101,3014536,-,17435
130,BUMA.1121.00112,1,2148732,2166187,-,17455
130,BUMA.1121.00091,1,3618361,3635754,-,17393
130,BUMA.1121.00047,1,2067639,2085094,-,17455
130,BUMA.1121.00067,1,3468023,3485485,-,17462
130,BUMA.1121.00110,1,3874793,3892350,-,17557
130,BUMA.1121.00073,1,919298,936756,+,17458
130,BUMA.1121.00072,1,885249,902577,+,17328
130,BUMA.1121.00077,1,3599923,3617479,+,17556
130,BUMA.1121.00082,1,1015371,1032841,+,17470
130,BUMA.1121.00062,1,3634255,3651676,-,17421
130,BUMA.1121.00007,1,3207367,3224973,-,17606
130,BUMA.1121.00025,1,1785797,1803271,-,17474
130,BUMA.1121.00021,1,1527729,1545205,+,17476
130,BUMA.1121.00103,1,3493484,3510888,-,17404
130,BUMA.1121.00096,1,2345594,2363124,-,17530
130,BUMA.1121.00079,1,936006,953470,+,17464
130,BUMA.1121.00039,1,1022479,1040124,+,17645
130,BUMA.1121.00083,1,671978,689448,-,17470
130,BUMA.1121.00084,1,1134411,1151941,+,17530
130,BUMA.1121.00049,1,928275,945782,-,17507
130,BUMA.1121.00089,1,911115,928558,+,17443
130,BUMA.1121.00014,1,1907328,1924867,-,17539
130,BUMA.1121.00090,1,3003177,3020789,+,17612
130,BUMA.1121.00071,1,911258,928653,+,17395
130,BUMA.1121.00078,1,1079838,1097233,-,17395
130,BUMA.1121.00102,1,306587,324042,-,17455
130,BUMA.1121.00075,1,418031,435464,+,17433
130,BUMA.1121.00012,1,3683491,3701188,+,17697
130,BUMA.1121.00076,1,444260,461703,-,17443
130,BUMA.1121.00106,1,680409,697947,+,17538
130,BUMA.1121.00001,1,3183891,3201586,-,17695
130,BUMA.1121.00107,1,754517,772004,+,17487
130,BUMA.1121.00104,1,366322,383877,-,17555
130,BUMA.1121.00099,1,1452083,1469689,-,17606
130,BUMA.1121.00098,1,3628178,3645694,+,17516
130,BUMA.1121.00111,1,1039494,1057150,+,17656
130,BUMA.1121.00109,1,962855,980530,-,17675
130,BUMA.1121.00097,1,3093820,3111262,-,17442
130,BUMA.1121.00094,1,895030,912477,+,17447
130,BUMA.1121.00095,1,747284,764857,-,17573
130,BUMA.1121.00005,1,2659320,2676757,-,17437
130,BUMA.1121.00101,1,1557351,1574792,-,17441
130,BUMA.1121.00065,1,957506,974968,+,17462
130,BUMA.1121.00100,1,389447,407023,-,17576
130,BUMA.1121.00105,1,277737,295296,-,17559
130,BUMA.1121.00029,1,4037380,4055046,-,17666
130,BUMA.1121.00066,1,895342,912745,+,17403
130,BUMA.1121.00031,1,2293742,2311384,+,17642
130,BUMA.1121.00108,1,1897891,1915386,+,17495
130,BUMA.1121.00023,1,3262085,3279692,+,17607
130,BUMA.1121.00035,1,1976696,1994181,+,17485
130,BUMA.1121.00041,1,2180333,2197817,+,17484
129,BUMA.1121.00057,1,1990699,1998222,+,7523
129,BUMA.1121.00058,1,3705914,3713413,-,7499
129,BUMA.1121.00045,1,3162774,3170265,-,7491
129,BUMA.1121.00051,1,906400,913931,+,7531
129,BUMA.1121.00068,1,3771570,3779059,+,7489
129,BUMA.1121.00061,1,913895,921423,+,7528
129,BUMA.1121.00060,1,1388387,1395878,-,7491
129,BUMA.1121.00064,1,938189,945697,+,7508
129,BUMA.1121.00016,1,3016431,3023943,+,7512
129,BUMA.1121.00003,1,3389512,3397014,+,7502
129,BUMA.1121.00055,1,480327,487841,+,7514
129,BUMA.1121.00011,1,687885,695395,-,7510
129,BUMA.1121.00037,1,3533715,3541227,+,7512
129,BUMA.1121.00009,1,674643,682147,-,7504
129,BUMA.1121.00069,1,866761,874292,+,7531
129,BUMA.1121.00088,1,1779507,1787032,+,7525
129,BUMA.1121.00092,1,2967100,2974636,-,7536
129,BUMA.1121.00074,1,2963188,2970697,-,7509
129,BUMA.1121.00070,1,885014,892545,+,7531
129,BUMA.1121.00093,1,1651793,1659328,+,7535
129,BUMA.1121.00063,1,910769,918298,+,7529
129,BUMA.1121.00033,1,3141419,3148939,+,7520
129,BUMA.1121.00018,1,1449076,1456588,+,7512
129,BUMA.1121.00080,1,934879,942410,+,7531
129,BUMA.1121.00027,1,3090410,3097947,+,7537
129,BUMA.1121.00053,1,617380,624889,+,7509
129,BUMA.1121.00059,1,141523,149033,+,7510
129,BUMA.1121.00043,1,878339,885839,+,7500
129,BUMA.1121.00056,1,3014538,3022048,-,7510
129,BUMA.1121.00112,1,2166189,2173699,-,7510
129,BUMA.1121.00091,1,3635756,3643266,-,7510
129,BUMA.1121.00047,1,2085096,2092627,-,7531
129,BUMA.1121.00067,1,3485487,3493012,-,7525
129,BUMA.1121.00110,1,3893929,3901430,-,7501
129,BUMA.1121.00073,1,911766,919297,+,7531
129,BUMA.1121.00072,1,877721,885248,+,7527
129,BUMA.1121.00077,1,3590845,3598344,+,7499
129,BUMA.1121.00082,1,1007839,1015370,+,7531
129,BUMA.1121.00062,1,3651678,3659188,-,7510
129,BUMA.1121.00007,1,3224975,3232485,-,7510
129,BUMA.1121.00025,1,1803273,1810787,-,7514
129,BUMA.1121.00021,1,1520224,1527728,+,7504
129,BUMA.1121.00103,1,3510890,3518398,-,7508
129,BUMA.1121.00096,1,2363126,2370616,-,7490
129,BUMA.1121.00079,1,928480,936005,+,7525
129,BUMA.1121.00039,1,1014974,1022478,+,7504
129,BUMA.1121.00083,1,689450,696981,-,7531
129,BUMA.1121.00084,1,1126879,1134410,+,7531
129,BUMA.1121.00049,1,945784,953376,-,7592
129,BUMA.1121.00089,1,903604,911114,+,7510
129,BUMA.1121.00014,1,1924869,1932386,-,7517
129,BUMA.1121.00090,1,2995660,3003176,+,7516
129,BUMA.1121.00071,1,903726,911257,+,7531
129,BUMA.1121.00078,1,1097235,1104739,-,7504
129,BUMA.1121.00102,1,325624,333131,-,7507
129,BUMA.1121.00075,1,410512,418030,+,7518
129,BUMA.1121.00012,1,3675974,3683490,+,7516
129,BUMA.1121.00076,1,461705,469223,-,7518
129,BUMA.1121.00106,1,672898,680408,+,7510
129,BUMA.1121.00001,1,3201588,3209088,-,7500
129,BUMA.1121.00107,1,747008,754516,+,7508
129,BUMA.1121.00104,1,383879,391389,-,7510
129,BUMA.1121.00099,1,1469691,1477202,-,7511
129,BUMA.1121.00098,1,3620673,3628177,+,7504
129,BUMA.1121.00111,1,1031988,1039493,+,7505
129,BUMA.1121.00109,1,980532,988014,-,7482
129,BUMA.1121.00097,1,3111264,3118768,-,7504
129,BUMA.1121.00094,1,887515,895029,+,7514
129,BUMA.1121.00095,1,766436,773939,-,7503
129,BUMA.1121.00005,1,2676759,2684261,-,7502
129,BUMA.1121.00101,1,1574794,1582296,-,7502
129,BUMA.1121.00065,1,950003,957505,+,7502
129,BUMA.1121.00100,1,407025,414518,-,7493
129,BUMA.1121.00105,1,295298,302808,-,7510
129,BUMA.1121.00029,1,4055048,4062495,-,7447
129,BUMA.1121.00066,1,887812,895341,+,7529
129,BUMA.1121.00031,1,2286225,2293741,+,7516
129,BUMA.1121.00108,1,1890379,1897890,+,7511
129,BUMA.1121.00023,1,3254568,3262084,+,7516
129,BUMA.1121.00035,1,1969195,1976695,+,7500
129,BUMA.1121.00041,1,2172822,2180332,+,7510
128,BUMA.1121.00057,1,1967981,1990697,+,22716
128,BUMA.1121.00058,1,3713414,3736111,-,22697
128,BUMA.1121.00045,1,3170266,3192972,-,22706
128,BUMA.1121.00051,1,883784,906398,+,22614
128,BUMA.1121.00068,1,3748857,3771568,+,22711
128,BUMA.1121.00061,1,891164,913893,+,22729
128,BUMA.1121.00060,1,1395879,1418585,-,22706
128,BUMA.1121.00064,1,915467,938187,+,22720
128,BUMA.1121.00016,1,2993769,3016429,+,22660
128,BUMA.1121.00003,1,3366792,3389510,+,22718
128,BUMA.1121.00055,1,457615,480325,+,22710
128,BUMA.1121.00011,1,695396,718110,-,22714
128,BUMA.1121.00037,1,3511004,3533713,+,22709
128,BUMA.1121.00009,1,682148,704885,-,22737
128,BUMA.1121.00069,1,844031,866759,+,22728
128,BUMA.1121.00088,1,1756773,1779505,+,22732
128,BUMA.1121.00092,1,2974637,2997338,-,22701
128,BUMA.1121.00074,1,2970698,2993426,-,22728
128,BUMA.1121.00070,1,862283,885012,+,22729
128,BUMA.1121.00093,1,1629090,1651791,+,22701
128,BUMA.1121.00063,1,888042,910767,+,22725
128,BUMA.1121.00033,1,3118734,3141417,+,22683
128,BUMA.1121.00018,1,1426365,1449074,+,22709
128,BUMA.1121.00080,1,912263,934877,+,22614
128,BUMA.1121.00027,1,3067664,3090408,+,22744
128,BUMA.1121.00053,1,594647,617378,+,22731
128,BUMA.1121.00059,1,118793,141521,+,22728
128,BUMA.1121.00043,1,855615,878337,+,22722
128,BUMA.1121.00056,1,3022049,3044777,-,22728
128,BUMA.1121.00112,1,2173700,2196448,-,22748
128,BUMA.1121.00091,1,3643267,3665974,-,22707
128,BUMA.1121.00047,1,2092628,2115242,-,22614
128,BUMA.1121.00067,1,3493013,3515722,-,22709
128,BUMA.1121.00110,1,3901431,3924115,-,22684
128,BUMA.1121.00073,1,889035,911764,+,22729
128,BUMA.1121.00072,1,854990,877719,+,22729
128,BUMA.1121.00077,1,3568160,3590843,+,22683
128,BUMA.1121.00082,1,985108,1007837,+,22729
128,BUMA.1121.00062,1,3659189,3681903,-,22714
128,BUMA.1121.00007,1,3232486,3255207,-,22721
128,BUMA.1121.00025,1,1810788,1833498,-,22710
128,BUMA.1121.00021,1,1497526,1520222,+,22696
128,BUMA.1121.00103,1,3518399,3541117,-,22718
128,BUMA.1121.00096,1,2370617,2393314,-,22697
128,BUMA.1121.00079,1,905723,928478,+,22755
128,BUMA.1121.00039,1,992236,1014972,+,22736
128,BUMA.1121.00083,1,696982,719711,-,22729
128,BUMA.1121.00084,1,1104145,1126877,+,22732
128,BUMA.1121.00049,1,953377,976087,-,22710
128,BUMA.1121.00089,1,880874,903602,+,22728
128,BUMA.1121.00014,1,1932387,1955106,-,22719
128,BUMA.1121.00090,1,2972949,2995658,+,22709
128,BUMA.1121.00071,1,880995,903724,+,22729
128,BUMA.1121.00078,1,1104740,1127424,-,22684
128,BUMA.1121.00102,1,333132,355874,-,22742
128,BUMA.1121.00075,1,387774,410510,+,22736
128,BUMA.1121.00012,1,3653276,3675972,+,22696
128,BUMA.1121.00076,1,469224,491961,-,22737
128,BUMA.1121.00106,1,650159,672896,+,22737
128,BUMA.1121.00001,1,3209089,3231820,-,22731
128,BUMA.1121.00107,1,724268,747006,+,22738
128,BUMA.1121.00104,1,391390,414118,-,22728
128,BUMA.1121.00099,1,1477203,1499910,-,22707
128,BUMA.1121.00098,1,3597962,3620671,+,22709
128,BUMA.1121.00111,1,1009277,1031986,+,22709
128,BUMA.1121.00109,1,988015,1010715,-,22700
128,BUMA.1121.00097,1,3118769,3141492,-,22723
128,BUMA.1121.00094,1,864899,887513,+,22614
128,BUMA.1121.00095,1,773940,796648,-,22708
128,BUMA.1121.00005,1,2684262,2706981,-,22719
128,BUMA.1121.00101,1,1582297,1605003,-,22706
128,BUMA.1121.00065,1,927280,950001,+,22721
128,BUMA.1121.00100,1,414519,437239,-,22720
128,BUMA.1121.00105,1,302809,325568,-,22759
128,BUMA.1121.00029,1,30,22768,-,22738
128,BUMA.1121.00066,1,865081,887810,+,22729
128,BUMA.1121.00031,1,2263505,2286223,+,22718
128,BUMA.1121.00108,1,1867586,1890377,+,22791
128,BUMA.1121.00023,1,3231857,3254566,+,22709
128,BUMA.1121.00035,1,1946470,1969193,+,22723
128,BUMA.1121.00041,1,2150109,2172820,+,22711
59,BUMA.1121.00057,1,936454,948702,+,12248
59,BUMA.1121.00058,1,655111,667350,-,12239
59,BUMA.1121.00045,1,222426,234666,-,12240
59,BUMA.1121.00051,1,3868295,3880529,+,12234
59,BUMA.1121.00068,1,2680228,2692457,+,12229
59,BUMA.1121.00061,1,3748015,3760261,+,12246
59,BUMA.1121.00060,1,2467682,2479922,-,12240
59,BUMA.1121.00064,1,3848447,3860688,+,12241
59,BUMA.1121.00016,1,1949326,1961554,+,12228
59,BUMA.1121.00003,1,2366304,2378545,+,12241
59,BUMA.1121.00055,1,3514300,3526537,+,12237
59,BUMA.1121.00011,1,1758022,1770269,-,12247
59,BUMA.1121.00037,1,2501309,2513548,+,12239
59,BUMA.1121.00009,1,1721521,1733754,-,12233
59,BUMA.1121.00069,1,3738893,3751141,+,12248
59,BUMA.1121.00088,1,689500,701735,+,12235
59,BUMA.1121.00092,1,3938413,3950645,+,12232
59,BUMA.1121.00074,1,232702,244943,-,12241
59,BUMA.1121.00070,1,3723684,3735932,+,12248
59,BUMA.1121.00093,1,675830,688062,-,12232
59,BUMA.1121.00063,1,3737875,3750123,+,12248
59,BUMA.1121.00033,1,2100684,2112923,+,12239
59,BUMA.1121.00018,1,364620,376853,+,12233
59,BUMA.1121.00080,1,3894563,3906797,+,12234
59,BUMA.1121.00027,1,2035379,2047626,+,12247
59,BUMA.1121.00053,1,3609182,3621425,+,12243
59,BUMA.1121.00059,1,3093424,3105666,+,12242
59,BUMA.1121.00043,1,3963858,3976098,+,12240
59,BUMA.1121.00056,1,47435,59669,-,12234
59,BUMA.1121.00112,1,3231291,3243524,-,12233
59,BUMA.1121.00091,1,636840,649073,-,12233
59,BUMA.1121.00047,1,3087267,3099501,-,12234
59,BUMA.1121.00067,1,568917,581163,-,12246
59,BUMA.1121.00110,1,948527,960762,-,12235
59,BUMA.1121.00073,1,3750801,3763049,+,12248
59,BUMA.1121.00072,1,3735910,3748153,+,12243
59,BUMA.1121.00077,1,2522554,2534788,+,12234
59,BUMA.1121.00082,1,3951409,3963657,+,12248
59,BUMA.1121.00062,1,696699,708931,-,12232
59,BUMA.1121.00007,1,191720,203953,-,12233
59,BUMA.1121.00025,1,2883027,2895260,-,12233
59,BUMA.1121.00021,1,480126,492366,+,12240
59,BUMA.1121.00103,1,471460,483692,-,12232
59,BUMA.1121.00096,1,3395091,3407325,-,12234
59,BUMA.1121.00079,1,3947811,3960044,+,12233
59,BUMA.1121.00039,1,3999799,4012039,+,12240
59,BUMA.1121.00083,1,1815714,1827962,-,12248
59,BUMA.1121.00084,1,105862,118108,+,12246
59,BUMA.1121.00049,1,1963364,1975590,-,12226
59,BUMA.1121.00089,1,3869834,3882068,+,12234
59,BUMA.1121.00014,1,3019354,3031586,-,12232
59,BUMA.1121.00090,1,1945769,1958009,+,12240
59,BUMA.1121.00071,1,3743960,3756205,+,12245
59,BUMA.1121.00078,1,2155683,2167907,-,12224
59,BUMA.1121.00102,1,1408649,1420880,-,12231
59,BUMA.1121.00075,1,3323003,3335237,+,12234
59,BUMA.1121.00012,1,2583024,2595264,+,12240
59,BUMA.1121.00076,1,1477002,1489236,-,12234
59,BUMA.1121.00106,1,3608874,3621113,+,12239
59,BUMA.1121.00001,1,197634,209874,-,12240
59,BUMA.1121.00107,1,3811879,3824107,+,12228
59,BUMA.1121.00104,1,1394816,1407055,-,12239
59,BUMA.1121.00099,1,2582990,2595223,-,12233
59,BUMA.1121.00098,1,2544239,2556466,+,12227
59,BUMA.1121.00111,1,8927,21167,+,12240
59,BUMA.1121.00109,1,2050702,2062948,-,12246
59,BUMA.1121.00097,1,95149,107381,-,12232
59,BUMA.1121.00094,1,3883151,3895385,+,12234
59,BUMA.1121.00095,1,1794514,1806750,-,12236
59,BUMA.1121.00005,1,3714376,3726617,-,12241
59,BUMA.1121.00101,1,2599787,2612019,-,12232
59,BUMA.1121.00065,1,3893206,3905446,+,12240
59,BUMA.1121.00100,1,1445523,1457764,-,12241
59,BUMA.1121.00105,1,1364478,1376719,-,12241
59,BUMA.1121.00029,1,1074137,1086382,-,12245
59,BUMA.1121.00066,1,3736245,3748493,+,12248
59,BUMA.1121.00031,1,1218852,1231083,+,12231
59,BUMA.1121.00108,1,832262,844494,+,12232
59,BUMA.1121.00023,1,2202638,2214878,+,12240
59,BUMA.1121.00035,1,883816,896056,+,12240
59,BUMA.1121.00041,1,1101614,1113855,+,12241
58,BUMA.1121.00057,1,919033,927564,+,8531
58,BUMA.1121.00058,1,676231,684763,-,8532
58,BUMA.1121.00045,1,243557,252087,-,8530
58,BUMA.1121.00051,1,3850881,3859414,+,8533
58,BUMA.1121.00068,1,2662813,2671344,+,8531
58,BUMA.1121.00061,1,3730594,3739125,+,8531
58,BUMA.1121.00060,1,2488813,2497343,-,8530
58,BUMA.1121.00064,1,3831026,3839559,+,8533
58,BUMA.1121.00016,1,1931914,1940445,+,8531
58,BUMA.1121.00003,1,2348892,2357423,+,8531
58,BUMA.1121.00055,1,3496879,3505412,+,8533
58,BUMA.1121.00011,1,1779157,1787695,-,8538
58,BUMA.1121.00037,1,2485998,2494529,+,8531
58,BUMA.1121.00009,1,1742644,1751174,-,8530
58,BUMA.1121.00069,1,3721690,3730221,+,8531
58,BUMA.1121.00088,1,672081,680612,+,8531
58,BUMA.1121.00092,1,3920991,3929522,+,8531
58,BUMA.1121.00074,1,253831,262363,-,8532
58,BUMA.1121.00070,1,3706481,3715012,+,8531
58,BUMA.1121.00093,1,696953,705483,-,8530
58,BUMA.1121.00063,1,3727334,3735865,+,8531
58,BUMA.1121.00033,1,2083272,2091803,+,8531
58,BUMA.1121.00018,1,347208,355739,+,8531
58,BUMA.1121.00080,1,3877149,3885682,+,8533
58,BUMA.1121.00027,1,2017959,2026489,+,8530
58,BUMA.1121.00053,1,3591757,3600288,+,8531
58,BUMA.1121.00059,1,3078113,3086644,+,8531
58,BUMA.1121.00043,1,3946446,3954977,+,8531
58,BUMA.1121.00056,1,68550,77082,-,8532
58,BUMA.1121.00112,1,3252417,3260947,-,8530
58,BUMA.1121.00091,1,657968,666498,-,8530
58,BUMA.1121.00047,1,3108382,3116914,-,8532
58,BUMA.1121.00067,1,590053,598583,-,8530
58,BUMA.1121.00110,1,969655,978187,-,8532
58,BUMA.1121.00073,1,3733598,3742129,+,8531
58,BUMA.1121.00072,1,3718706,3727237,+,8531
58,BUMA.1121.00077,1,2505129,2513661,+,8532
58,BUMA.1121.00082,1,3933988,3942519,+,8531
58,BUMA.1121.00062,1,717822,726354,-,8532
58,BUMA.1121.00007,1,212841,221371,-,8530
58,BUMA.1121.00025,1,2904141,2912671,-,8530
58,BUMA.1121.00021,1,462714,471245,+,8531
58,BUMA.1121.00103,1,492583,501113,-,8530
58,BUMA.1121.00096,1,3414105,3422643,-,8538
58,BUMA.1121.00079,1,3930397,3938930,+,8533
58,BUMA.1121.00039,1,3982387,3990918,+,8531
58,BUMA.1121.00083,1,1836852,1845382,-,8530
58,BUMA.1121.00084,1,88440,96971,+,8531
58,BUMA.1121.00049,1,1984478,1993010,-,8532
58,BUMA.1121.00089,1,3852420,3860953,+,8533
58,BUMA.1121.00014,1,3038366,3046896,-,8530
58,BUMA.1121.00090,1,1928357,1936888,+,8531
58,BUMA.1121.00071,1,3733419,3741950,+,8531
58,BUMA.1121.00078,1,2176795,2185327,-,8532
58,BUMA.1121.00102,1,1429767,1438297,-,8530
58,BUMA.1121.00075,1,3305583,3314112,+,8529
58,BUMA.1121.00012,1,2565612,2574143,+,8531
58,BUMA.1121.00076,1,1498127,1506657,-,8530
58,BUMA.1121.00106,1,3591452,3599983,+,8531
58,BUMA.1121.00001,1,218755,227285,-,8530
58,BUMA.1121.00107,1,3794459,3802991,+,8532
58,BUMA.1121.00104,1,1415946,1424476,-,8530
58,BUMA.1121.00099,1,2602003,2610532,-,8529
58,BUMA.1121.00098,1,2526814,2535346,+,8532
58,BUMA.1121.00111,1,4024113,4032598,+,8485
58,BUMA.1121.00109,1,2071829,2080360,-,8531
58,BUMA.1121.00097,1,114161,122691,-,8530
58,BUMA.1121.00094,1,3865739,3874270,+,8531
58,BUMA.1121.00095,1,1815631,1824168,-,8537
58,BUMA.1121.00005,1,3735508,3744038,-,8530
58,BUMA.1121.00101,1,2618799,2627331,-,8532
58,BUMA.1121.00065,1,3875787,3884318,+,8531
58,BUMA.1121.00100,1,1466655,1475187,-,8532
58,BUMA.1121.00105,1,1385607,1394137,-,8530
58,BUMA.1121.00029,1,1095263,1103793,-,8530
58,BUMA.1121.00066,1,3719042,3727573,+,8531
58,BUMA.1121.00031,1,1203541,1212072,+,8531
58,BUMA.1121.00108,1,814836,823368,+,8532
58,BUMA.1121.00023,1,2185226,2193757,+,8531
58,BUMA.1121.00035,1,866404,874935,+,8531
58,BUMA.1121.00041,1,1084179,1092710,+,8531
57,BUMA.1121.00057,1,885363,918910,+,33547
57,BUMA.1121.00058,1,684886,718441,-,33555
57,BUMA.1121.00045,1,252210,285757,-,33547
57,BUMA.1121.00051,1,3815774,3849299,+,33525
57,BUMA.1121.00068,1,2629159,2662690,+,33531
57,BUMA.1121.00061,1,3697025,3730471,+,33446
57,BUMA.1121.00060,1,2497466,2531013,-,33547
57,BUMA.1121.00064,1,3797370,3830903,+,33533
57,BUMA.1121.00016,1,1898268,1931791,+,33523
57,BUMA.1121.00003,1,2315248,2348769,+,33521
57,BUMA.1121.00055,1,3461764,3495298,+,33534
57,BUMA.1121.00011,1,1787818,1821201,-,33383
57,BUMA.1121.00037,1,2452350,2485875,+,33525
57,BUMA.1121.00009,1,1751297,1784869,-,33572
57,BUMA.1121.00069,1,3688121,3721567,+,33446
57,BUMA.1121.00088,1,638411,671958,+,33547
57,BUMA.1121.00092,1,3887323,3920868,+,33545
57,BUMA.1121.00074,1,262486,296020,-,33534
57,BUMA.1121.00070,1,3672877,3706358,+,33481
57,BUMA.1121.00093,1,705606,739152,-,33546
57,BUMA.1121.00063,1,3693765,3727211,+,33446
57,BUMA.1121.00033,1,2049632,2083149,+,33517
57,BUMA.1121.00018,1,313568,347085,+,33517
57,BUMA.1121.00080,1,3843494,3877026,+,33532
57,BUMA.1121.00027,1,1984294,2017836,+,33542
57,BUMA.1121.00053,1,3558061,3591634,+,33573
57,BUMA.1121.00059,1,3044584,3077990,+,33406
57,BUMA.1121.00043,1,3912814,3946323,+,33509
57,BUMA.1121.00056,1,77205,110739,-,33534
57,BUMA.1121.00112,1,3261070,3294606,-,33536
57,BUMA.1121.00091,1,666621,700094,-,33473
57,BUMA.1121.00047,1,3117037,3150571,-,33534
57,BUMA.1121.00067,1,598706,632240,-,33534
57,BUMA.1121.00110,1,978310,1011831,-,33521
57,BUMA.1121.00073,1,3699994,3733475,+,33481
57,BUMA.1121.00072,1,3685102,3718583,+,33481
57,BUMA.1121.00077,1,2471488,2505006,+,33518
57,BUMA.1121.00082,1,3900384,3933865,+,33481
57,BUMA.1121.00062,1,727936,761474,-,33538
57,BUMA.1121.00007,1,221494,255020,-,33526
57,BUMA.1121.00025,1,2912794,2946313,-,33519
57,BUMA.1121.00021,1,429076,462591,+,33515
57,BUMA.1121.00103,1,501236,534761,-,33525
57,BUMA.1121.00096,1,3422766,3456314,-,33548
57,BUMA.1121.00079,1,3896749,3930274,+,33525
57,BUMA.1121.00039,1,3948740,3982264,+,33524
57,BUMA.1121.00083,1,1845505,1878987,-,33482
57,BUMA.1121.00084,1,54784,88317,+,33533
57,BUMA.1121.00049,1,1993133,2026667,-,33534
57,BUMA.1121.00089,1,3818764,3852297,+,33533
57,BUMA.1121.00014,1,3047019,3080535,-,33516
57,BUMA.1121.00090,1,1894719,1928234,+,33515
57,BUMA.1121.00071,1,3699851,3733296,+,33445
57,BUMA.1121.00078,1,2185450,2218995,-,33545
57,BUMA.1121.00102,1,1438420,1471888,-,33468
57,BUMA.1121.00075,1,3271959,3305460,+,33501
57,BUMA.1121.00012,1,2531971,2565489,+,33518
57,BUMA.1121.00076,1,1506780,1540282,-,33502
57,BUMA.1121.00106,1,3557784,3591329,+,33545
57,BUMA.1121.00001,1,227408,260939,-,33531
57,BUMA.1121.00107,1,3760786,3794336,+,33550
57,BUMA.1121.00104,1,1424599,1458145,-,33546
57,BUMA.1121.00099,1,2610655,2644170,-,33515
57,BUMA.1121.00098,1,2493173,2526691,+,33518
57,BUMA.1121.00111,1,3990467,4023990,+,33523
57,BUMA.1121.00109,1,2080483,2113973,-,33490
57,BUMA.1121.00097,1,122814,156359,-,33545
57,BUMA.1121.00094,1,3832072,3865616,+,33544
57,BUMA.1121.00095,1,1824291,1857821,-,33530
57,BUMA.1121.00005,1,3744161,3777679,-,33518
57,BUMA.1121.00101,1,2627454,2660996,-,33542
57,BUMA.1121.00065,1,3842124,3875664,+,33540
57,BUMA.1121.00100,1,1476769,1510324,-,33555
57,BUMA.1121.00105,1,1394260,1427808,-,33548
57,BUMA.1121.00029,1,1103916,1137440,-,33524
57,BUMA.1121.00066,1,3685438,3718919,+,33481
57,BUMA.1121.00031,1,1169909,1203418,+,33509
57,BUMA.1121.00108,1,781232,814713,+,33481
57,BUMA.1121.00023,1,2151579,2185103,+,33524
57,BUMA.1121.00035,1,832757,866281,+,33524
57,BUMA.1121.00041,1,1050515,1084056,+,33541
56,BUMA.1121.00057,1,877093,881700,+,4607
56,BUMA.1121.00058,1,722103,726712,-,4609
56,BUMA.1121.00045,1,289421,294030,-,4609
56,BUMA.1121.00051,1,3807504,3812111,+,4607
56,BUMA.1121.00068,1,2620886,2625494,+,4608
56,BUMA.1121.00061,1,3688755,3693362,+,4607
56,BUMA.1121.00060,1,2534677,2539286,-,4609
56,BUMA.1121.00064,1,3789100,3793707,+,4607
56,BUMA.1121.00016,1,1889999,1894606,+,4607
56,BUMA.1121.00003,1,2306978,2311585,+,4607
56,BUMA.1121.00055,1,3453494,3458101,+,4607
56,BUMA.1121.00011,1,1824865,1829473,-,4608
56,BUMA.1121.00037,1,2444080,2448687,+,4607
56,BUMA.1121.00009,1,1788533,1793141,-,4608
56,BUMA.1121.00069,1,3679851,3684458,+,4607
56,BUMA.1121.00088,1,630141,634748,+,4607
56,BUMA.1121.00092,1,3879053,3883660,+,4607
56,BUMA.1121.00074,1,299682,304290,-,4608
56,BUMA.1121.00070,1,3664607,3669214,+,4607
56,BUMA.1121.00093,1,742814,747422,-,4608
56,BUMA.1121.00063,1,3685495,3690102,+,4607
56,BUMA.1121.00033,1,2041362,2045969,+,4607
56,BUMA.1121.00018,1,305296,309903,+,4607
56,BUMA.1121.00080,1,3835223,3839831,+,4608
56,BUMA.1121.00027,1,1976024,1980631,+,4607
56,BUMA.1121.00053,1,3549790,3554397,+,4607
56,BUMA.1121.00059,1,3036312,3040919,+,4607
56,BUMA.1121.00043,1,3904544,3909151,+,4607
56,BUMA.1121.00056,1,114401,119009,-,4608
56,BUMA.1121.00112,1,3298268,3302876,-,4608
56,BUMA.1121.00091,1,703756,708364,-,4608
56,BUMA.1121.00047,1,3154233,3158841,-,4608
56,BUMA.1121.00067,1,635902,640511,-,4609
56,BUMA.1121.00110,1,1015493,1020102,-,4609
56,BUMA.1121.00073,1,3691724,3696331,+,4607
56,BUMA.1121.00072,1,3676832,3681439,+,4607
56,BUMA.1121.00077,1,2463221,2467825,+,4604
56,BUMA.1121.00082,1,3892114,3896721,+,4607
56,BUMA.1121.00062,1,765136,769744,-,4608
56,BUMA.1121.00007,1,258696,263304,-,4608
56,BUMA.1121.00025,1,2949977,2954585,-,4608
56,BUMA.1121.00021,1,420806,425413,+,4607
56,BUMA.1121.00103,1,538424,543032,-,4608
56,BUMA.1121.00096,1,3459976,3464585,-,4609
56,BUMA.1121.00079,1,3888478,3893085,+,4607
56,BUMA.1121.00039,1,3940470,3945077,+,4607
56,BUMA.1121.00083,1,1882649,1887257,-,4608
56,BUMA.1121.00084,1,46512,51119,+,4607
56,BUMA.1121.00049,1,2031526,2036150,-,4624
56,BUMA.1121.00089,1,3810494,3815101,+,4607
56,BUMA.1121.00014,1,3084197,3088805,-,4608
56,BUMA.1121.00090,1,1886449,1891056,+,4607
56,BUMA.1121.00071,1,3691581,3696188,+,4607
56,BUMA.1121.00078,1,2222657,2227265,-,4608
56,BUMA.1121.00102,1,1475551,1480159,-,4608
56,BUMA.1121.00075,1,3263688,3268295,+,4607
56,BUMA.1121.00012,1,2523702,2528309,+,4607
56,BUMA.1121.00076,1,1543945,1548553,-,4608
56,BUMA.1121.00106,1,3549511,3554119,+,4608
56,BUMA.1121.00001,1,264601,269209,-,4608
56,BUMA.1121.00107,1,3752516,3757123,+,4607
56,BUMA.1121.00104,1,1461809,1466417,-,4608
56,BUMA.1121.00099,1,2647833,2652441,-,4608
56,BUMA.1121.00098,1,2484902,2489509,+,4607
56,BUMA.1121.00111,1,3982195,3986802,+,4607
56,BUMA.1121.00109,1,2117637,2122246,-,4609
56,BUMA.1121.00097,1,160022,164630,-,4608
56,BUMA.1121.00094,1,3823802,3828409,+,4607
56,BUMA.1121.00095,1,1861484,1866092,-,4608
56,BUMA.1121.00005,1,3781341,3785949,-,4608
56,BUMA.1121.00101,1,2664659,2669271,-,4612
56,BUMA.1121.00065,1,3833853,3838460,+,4607
56,BUMA.1121.00100,1,1513986,1518595,-,4609
56,BUMA.1121.00105,1,1431470,1436078,-,4608
56,BUMA.1121.00029,1,1141102,1145710,-,4608
56,BUMA.1121.00066,1,3677168,3681775,+,4607
56,BUMA.1121.00031,1,1161639,1166246,+,4607
56,BUMA.1121.00108,1,772962,777569,+,4607
56,BUMA.1121.00023,1,2143309,2147916,+,4607
56,BUMA.1121.00035,1,824487,829094,+,4607
56,BUMA.1121.00041,1,1042258,1046850,+,4592
55,BUMA.1121.00057,1,873169,876601,+,3432
55,BUMA.1121.00058,1,728813,732228,-,3415
55,BUMA.1121.00045,1,294522,297954,-,3432
55,BUMA.1121.00051,1,3803580,3807012,+,3432
55,BUMA.1121.00068,1,2616954,2620394,+,3440
55,BUMA.1121.00061,1,3684786,3688263,+,3477
55,BUMA.1121.00060,1,2539778,2543210,-,3432
55,BUMA.1121.00064,1,3785176,3788608,+,3432
55,BUMA.1121.00016,1,1886078,1889507,+,3429
55,BUMA.1121.00003,1,2303054,2306486,+,3432
55,BUMA.1121.00055,1,3449570,3453002,+,3432
55,BUMA.1121.00011,1,1829965,1833397,-,3432
55,BUMA.1121.00037,1,2440159,2443588,+,3429
55,BUMA.1121.00009,1,1793633,1797062,-,3429
55,BUMA.1121.00069,1,3675927,3679359,+,3432
55,BUMA.1121.00088,1,626217,629649,+,3432
55,BUMA.1121.00092,1,3875129,3878561,+,3432
55,BUMA.1121.00074,1,304782,308214,-,3432
55,BUMA.1121.00070,1,3660683,3664115,+,3432
55,BUMA.1121.00093,1,747914,751346,-,3432
55,BUMA.1121.00063,1,3681344,3685003,+,3659
55,BUMA.1121.00033,1,2037441,2040870,+,3429
55,BUMA.1121.00018,1,301387,304804,+,3417
55,BUMA.1121.00080,1,3831299,3834731,+,3432
55,BUMA.1121.00027,1,1972100,1975532,+,3432
55,BUMA.1121.00053,1,3545866,3549298,+,3432
55,BUMA.1121.00059,1,3032388,3035820,+,3432
55,BUMA.1121.00043,1,3900623,3904052,+,3429
55,BUMA.1121.00056,1,119501,122933,-,3432
55,BUMA.1121.00112,1,3303368,3306800,-,3432
55,BUMA.1121.00091,1,708856,712288,-,3432
55,BUMA.1121.00047,1,3159333,3162765,-,3432
55,BUMA.1121.00067,1,641003,644435,-,3432
55,BUMA.1121.00110,1,1020594,1024026,-,3432
55,BUMA.1121.00073,1,3687800,3691232,+,3432
55,BUMA.1121.00072,1,3672908,3676340,+,3432
55,BUMA.1121.00077,1,2459297,2462729,+,3432
55,BUMA.1121.00082,1,3888190,3891622,+,3432
55,BUMA.1121.00062,1,770236,773668,-,3432
55,BUMA.1121.00007,1,263796,267225,-,3429
55,BUMA.1121.00025,1,2955077,2958494,-,3417
55,BUMA.1121.00021,1,416885,420314,+,3429
55,BUMA.1121.00103,1,543524,546956,-,3432
55,BUMA.1121.00096,1,3465077,3468509,-,3432
55,BUMA.1121.00079,1,3884554,3887986,+,3432
55,BUMA.1121.00039,1,3936549,3939978,+,3429
55,BUMA.1121.00083,1,1887749,1891181,-,3432
55,BUMA.1121.00084,1,42588,46020,+,3432
55,BUMA.1121.00049,1,2038254,2041669,-,3415
55,BUMA.1121.00089,1,3806570,3810002,+,3432
55,BUMA.1121.00014,1,3089297,3092726,-,3429
55,BUMA.1121.00090,1,1882528,1885957,+,3429
55,BUMA.1121.00071,1,3687358,3691089,+,3731
55,BUMA.1121.00078,1,2227757,2231189,-,3432
55,BUMA.1121.00102,1,1480651,1484083,-,3432
55,BUMA.1121.00075,1,3259764,3263196,+,3432
55,BUMA.1121.00012,1,2519781,2523210,+,3429
55,BUMA.1121.00076,1,1549045,1552477,-,3432
55,BUMA.1121.00106,1,3545587,3549019,+,3432
55,BUMA.1121.00001,1,269701,273124,-,3423
55,BUMA.1121.00107,1,3748592,3752024,+,3432
55,BUMA.1121.00104,1,1466909,1470341,-,3432
55,BUMA.1121.00099,1,2652933,2656365,-,3432
55,BUMA.1121.00098,1,2480978,2484410,+,3432
55,BUMA.1121.00111,1,3978274,3981703,+,3429
55,BUMA.1121.00109,1,2122738,2126178,-,3440
55,BUMA.1121.00097,1,165122,168554,-,3432
55,BUMA.1121.00094,1,3819878,3823310,+,3432
55,BUMA.1121.00095,1,1866584,1870012,-,3428
55,BUMA.1121.00005,1,3786441,3789873,-,3432
55,BUMA.1121.00101,1,2669763,2673203,-,3440
55,BUMA.1121.00065,1,3829929,3833361,+,3432
55,BUMA.1121.00100,1,1519087,1522519,-,3432
55,BUMA.1121.00105,1,1436570,1440002,-,3432
55,BUMA.1121.00029,1,1146202,1149625,-,3423
55,BUMA.1121.00066,1,3673244,3676676,+,3432
55,BUMA.1121.00031,1,1157718,1161147,+,3429
55,BUMA.1121.00108,1,769038,772470,+,3432
55,BUMA.1121.00023,1,2139388,2142817,+,3429
55,BUMA.1121.00035,1,820572,823995,+,3423
55,BUMA.1121.00041,1,1038334,1041766,+,3432
54,BUMA.1121.00057,1,862658,871809,+,9151
54,BUMA.1121.00058,1,733595,742745,-,9150
54,BUMA.1121.00045,1,299321,308473,-,9152
54,BUMA.1121.00051,1,3759379,3768541,+,9162
54,BUMA.1121.00068,1,2593479,2602630,+,9151
54,BUMA.1121.00061,1,3674245,3683418,+,9173
54,BUMA.1121.00060,1,2544577,2553729,-,9152
54,BUMA.1121.00064,1,3774659,3783808,+,9149
54,BUMA.1121.00016,1,1875536,1884712,+,9176
54,BUMA.1121.00003,1,2292540,2301678,+,9138
54,BUMA.1121.00055,1,3439051,3448202,+,9151
54,BUMA.1121.00011,1,1834762,1843916,-,9154
54,BUMA.1121.00037,1,2422697,2431848,+,9151
54,BUMA.1121.00009,1,1798429,1807581,-,9152
54,BUMA.1121.00069,1,3657372,3666545,+,9173
54,BUMA.1121.00088,1,615698,624849,+,9151
54,BUMA.1121.00092,1,3864620,3873769,+,9149
54,BUMA.1121.00074,1,309581,318731,-,9150
54,BUMA.1121.00070,1,3645089,3654245,+,9156
54,BUMA.1121.00093,1,752705,761855,-,9150
54,BUMA.1121.00063,1,3670803,3679976,+,9173
54,BUMA.1121.00033,1,2026913,2036075,+,9162
54,BUMA.1121.00018,1,236026,245174,+,9148
54,BUMA.1121.00080,1,3787087,3796260,+,9173
54,BUMA.1121.00027,1,1946075,1955226,+,9151
54,BUMA.1121.00053,1,3519837,3529004,+,9167
54,BUMA.1121.00059,1,3021879,3031028,+,9149
54,BUMA.1121.00043,1,3890109,3899257,+,9148
54,BUMA.1121.00056,1,156612,165786,-,9174
54,BUMA.1121.00112,1,3308167,3317314,-,9147
54,BUMA.1121.00091,1,713655,722807,-,9152
54,BUMA.1121.00047,1,3197803,3206988,-,9185
54,BUMA.1121.00067,1,645802,654952,-,9150
54,BUMA.1121.00110,1,1025391,1034537,-,9146
54,BUMA.1121.00073,1,3672523,3681681,+,9158
54,BUMA.1121.00072,1,3658951,3668124,+,9173
54,BUMA.1121.00077,1,2448786,2457931,+,9145
54,BUMA.1121.00082,1,3862285,3871458,+,9173
54,BUMA.1121.00062,1,795001,804151,-,9150
54,BUMA.1121.00007,1,268592,277740,-,9148
54,BUMA.1121.00025,1,3014707,3023856,-,9149
54,BUMA.1121.00021,1,406394,415517,+,9123
54,BUMA.1121.00103,1,568412,577554,-,9142
54,BUMA.1121.00096,1,3469876,3479026,-,9150
54,BUMA.1121.00079,1,3874038,3883186,+,9148
54,BUMA.1121.00039,1,3910866,3920032,+,9166
54,BUMA.1121.00083,1,1907912,1917086,-,9174
54,BUMA.1121.00084,1,32069,41220,+,9151
54,BUMA.1121.00049,1,2043036,2052188,-,9152
54,BUMA.1121.00089,1,3761146,3770319,+,9173
54,BUMA.1121.00014,1,3094093,3103237,-,9144
54,BUMA.1121.00090,1,1836121,1845272,+,9151
54,BUMA.1121.00071,1,3676817,3685990,+,9173
54,BUMA.1121.00078,1,2232556,2241705,-,9149
54,BUMA.1121.00102,1,1517867,1527025,-,9158
54,BUMA.1121.00075,1,3249245,3258396,+,9151
54,BUMA.1121.00012,1,2509267,2518415,+,9148
54,BUMA.1121.00076,1,1553844,1562996,-,9152
54,BUMA.1121.00106,1,3535078,3544227,+,9149
54,BUMA.1121.00001,1,274491,283643,-,9152
54,BUMA.1121.00107,1,3738075,3747224,+,9149
54,BUMA.1121.00104,1,1471708,1480848,-,9140
54,BUMA.1121.00099,1,2657732,2666895,-,9163
54,BUMA.1121.00098,1,2470470,2479610,+,9140
54,BUMA.1121.00111,1,3950606,3959746,+,9140
54,BUMA.1121.00109,1,2127545,2136697,-,9152
54,BUMA.1121.00097,1,169921,179072,-,9151
54,BUMA.1121.00094,1,3789364,3798513,+,9149
54,BUMA.1121.00095,1,1877784,1886921,-,9137
54,BUMA.1121.00005,1,3791240,3800391,-,9151
54,BUMA.1121.00101,1,2687526,2696669,-,9143
54,BUMA.1121.00065,1,3819412,3828561,+,9149
54,BUMA.1121.00100,1,1523884,1533045,-,9161
54,BUMA.1121.00105,1,1441369,1450521,-,9152
54,BUMA.1121.00029,1,1150992,1160062,-,9070
54,BUMA.1121.00066,1,3661902,3671075,+,9173
54,BUMA.1121.00031,1,1147207,1156350,+,9143
54,BUMA.1121.00108,1,758521,767670,+,9149
54,BUMA.1121.00023,1,2128869,2138020,+,9151
54,BUMA.1121.00035,1,810064,819204,+,9140
54,BUMA.1121.00041,1,1012323,1021472,+,9149
53,BUMA.1121.00057,1,858630,862393,+,3763
53,BUMA.1121.00058,1,744322,748084,-,3762
53,BUMA.1121.00045,1,308732,312499,-,3767
53,BUMA.1121.00051,1,3755352,3759114,+,3762
53,BUMA.1121.00068,1,2589453,2593215,+,3762
53,BUMA.1121.00061,1,3670218,3673980,+,3762
53,BUMA.1121.00060,1,2553988,2557755,-,3767
53,BUMA.1121.00064,1,3769318,3773081,+,3763
53,BUMA.1121.00016,1,1870197,1873962,+,3765
53,BUMA.1121.00003,1,2288513,2292275,+,3762
53,BUMA.1121.00055,1,3435023,3438786,+,3763
53,BUMA.1121.00011,1,1844179,1847941,-,3762
53,BUMA.1121.00037,1,2417358,2421123,+,3765
53,BUMA.1121.00009,1,1807845,1811607,-,3762
53,BUMA.1121.00069,1,3653345,3657107,+,3762
53,BUMA.1121.00088,1,611671,615434,+,3763
53,BUMA.1121.00092,1,3859279,3863045,+,3766
53,BUMA.1121.00074,1,320308,324071,-,3763
53,BUMA.1121.00070,1,3641062,3644824,+,3762
53,BUMA.1121.00093,1,763430,767195,-,3765
53,BUMA.1121.00063,1,3666776,3670538,+,3762
53,BUMA.1121.00033,1,2021574,2025339,+,3765
53,BUMA.1121.00018,1,232000,235762,+,3762
53,BUMA.1121.00080,1,3783060,3786822,+,3762
53,BUMA.1121.00027,1,1942047,1945810,+,3763
53,BUMA.1121.00053,1,3514497,3518260,+,3763
53,BUMA.1121.00059,1,3016539,3020301,+,3762
53,BUMA.1121.00043,1,3884770,3888535,+,3765
53,BUMA.1121.00056,1,166050,169812,-,3762
53,BUMA.1121.00112,1,3317577,3321340,-,3763
53,BUMA.1121.00091,1,724382,728145,-,3763
53,BUMA.1121.00047,1,3207253,3211015,-,3762
53,BUMA.1121.00067,1,656529,660292,-,3763
53,BUMA.1121.00110,1,1034802,1038564,-,3762
53,BUMA.1121.00073,1,3668496,3672258,+,3762
53,BUMA.1121.00072,1,3654924,3658686,+,3762
53,BUMA.1121.00077,1,2444758,2448520,+,3762
53,BUMA.1121.00082,1,3858258,3862020,+,3762
53,BUMA.1121.00062,1,804414,808177,-,3763
53,BUMA.1121.00007,1,278003,281763,-,3760
53,BUMA.1121.00025,1,3024119,3027881,-,3762
53,BUMA.1121.00021,1,402360,406125,+,3765
53,BUMA.1121.00103,1,577812,581595,-,3783
53,BUMA.1121.00096,1,3479289,3483051,-,3762
53,BUMA.1121.00079,1,3870011,3873774,+,3763
53,BUMA.1121.00039,1,3905527,3909292,+,3765
53,BUMA.1121.00083,1,1917350,1921112,-,3762
53,BUMA.1121.00084,1,28041,31804,+,3763
53,BUMA.1121.00049,1,2052451,2056214,-,3763
53,BUMA.1121.00089,1,3757119,3760881,+,3762
53,BUMA.1121.00014,1,3103506,3107270,-,3764
53,BUMA.1121.00090,1,1830781,1834546,+,3765
53,BUMA.1121.00071,1,3672790,3676552,+,3762
53,BUMA.1121.00078,1,2243284,2247047,-,3763
53,BUMA.1121.00102,1,1527290,1531052,-,3762
53,BUMA.1121.00075,1,3245219,3248981,+,3762
53,BUMA.1121.00012,1,2503928,2507693,+,3765
53,BUMA.1121.00076,1,1563259,1567021,-,3762
53,BUMA.1121.00106,1,3531051,3534814,+,3763
53,BUMA.1121.00001,1,285216,288980,-,3764
53,BUMA.1121.00107,1,3734047,3737816,+,3769
53,BUMA.1121.00104,1,1482422,1486186,-,3764
53,BUMA.1121.00099,1,2667161,2670923,-,3762
53,BUMA.1121.00098,1,2465130,2468893,+,3763
53,BUMA.1121.00111,1,3945267,3949032,+,3765
53,BUMA.1121.00109,1,2138273,2142035,-,3762
53,BUMA.1121.00097,1,179331,183098,-,3767
53,BUMA.1121.00094,1,3785337,3789100,+,3763
53,BUMA.1121.00095,1,1887184,1890946,-,3762
53,BUMA.1121.00005,1,3801968,3805731,-,3763
53,BUMA.1121.00101,1,2696932,2700695,-,3763
53,BUMA.1121.00065,1,3814072,3817834,+,3762
53,BUMA.1121.00100,1,1533309,1537068,-,3759
53,BUMA.1121.00105,1,1450783,1454547,-,3764
53,BUMA.1121.00029,1,1161636,1165400,-,3764
53,BUMA.1121.00066,1,3657875,3661637,+,3762
53,BUMA.1121.00031,1,1143173,1146938,+,3765
53,BUMA.1121.00108,1,753181,756950,+,3769
53,BUMA.1121.00023,1,2123530,2127295,+,3765
53,BUMA.1121.00035,1,804725,808490,+,3765
53,BUMA.1121.00041,1,1006981,1010744,+,3763
52,BUMA.1121.00057,1,853432,858629,+,5197
52,BUMA.1121.00058,1,748086,753283,-,5197
52,BUMA.1121.00045,1,312501,317694,-,5193
52,BUMA.1121.00051,1,3750153,3755351,+,5198
52,BUMA.1121.00068,1,2584258,2589452,+,5194
52,BUMA.1121.00061,1,3665020,3670217,+,5197
52,BUMA.1121.00060,1,2557757,2562950,-,5193
52,BUMA.1121.00064,1,3764124,3769317,+,5193
52,BUMA.1121.00016,1,1865002,1870196,+,5194
52,BUMA.1121.00003,1,2283313,2288512,+,5199
52,BUMA.1121.00055,1,3429824,3435022,+,5198
52,BUMA.1121.00011,1,1847943,1853135,-,5192
52,BUMA.1121.00037,1,2412163,2417357,+,5194
52,BUMA.1121.00009,1,1811609,1816806,-,5197
52,BUMA.1121.00069,1,3648147,3653344,+,5197
52,BUMA.1121.00088,1,606477,611670,+,5193
52,BUMA.1121.00092,1,3854084,3859278,+,5194
52,BUMA.1121.00074,1,324073,329265,-,5192
52,BUMA.1121.00070,1,3635864,3641061,+,5197
52,BUMA.1121.00093,1,767197,772390,-,5193
52,BUMA.1121.00063,1,3661579,3666775,+,5196
52,BUMA.1121.00033,1,2016379,2021573,+,5194
52,BUMA.1121.00018,1,226805,231999,+,5194
52,BUMA.1121.00080,1,3777861,3783059,+,5198
52,BUMA.1121.00027,1,1936849,1942046,+,5197
52,BUMA.1121.00053,1,3509302,3514496,+,5194
52,BUMA.1121.00059,1,3011340,3016538,+,5198
52,BUMA.1121.00043,1,3879575,3884769,+,5194
52,BUMA.1121.00056,1,169814,175011,-,5197
52,BUMA.1121.00112,1,3321342,3326539,-,5197
52,BUMA.1121.00091,1,728147,733343,-,5196
52,BUMA.1121.00047,1,3211017,3216214,-,5197
52,BUMA.1121.00067,1,660294,665486,-,5192
52,BUMA.1121.00110,1,1038566,1043758,-,5192
52,BUMA.1121.00073,1,3663298,3668495,+,5197
52,BUMA.1121.00072,1,3649726,3654923,+,5197
52,BUMA.1121.00077,1,2439562,2444757,+,5195
52,BUMA.1121.00082,1,3853060,3858257,+,5197
52,BUMA.1121.00062,1,808179,813375,-,5196
52,BUMA.1121.00007,1,281765,286963,-,5198
52,BUMA.1121.00025,1,3027883,3033076,-,5193
52,BUMA.1121.00021,1,397164,402359,+,5195
52,BUMA.1121.00103,1,582935,588087,-,5152
52,BUMA.1121.00096,1,3483053,3488250,-,5197
52,BUMA.1121.00079,1,3864817,3870010,+,5193
52,BUMA.1121.00039,1,3900331,3905526,+,5195
52,BUMA.1121.00083,1,1921114,1926310,-,5196
52,BUMA.1121.00084,1,22842,28040,+,5198
52,BUMA.1121.00049,1,2056216,2061408,-,5192
52,BUMA.1121.00089,1,3751920,3757118,+,5198
52,BUMA.1121.00014,1,3107272,3112465,-,5193
52,BUMA.1121.00090,1,1825586,1830780,+,5194
52,BUMA.1121.00071,1,3667592,3672789,+,5197
52,BUMA.1121.00078,1,2247049,2252246,-,5197
52,BUMA.1121.00102,1,1531054,1536262,-,5208
52,BUMA.1121.00075,1,3240020,3245218,+,5198
52,BUMA.1121.00012,1,2498733,2503927,+,5194
52,BUMA.1121.00076,1,1567023,1572220,-,5197
52,BUMA.1121.00106,1,3525857,3531050,+,5193
52,BUMA.1121.00001,1,288982,294175,-,5193
52,BUMA.1121.00107,1,3728850,3734046,+,5196
52,BUMA.1121.00104,1,1486188,1491384,-,5196
52,BUMA.1121.00099,1,2670925,2676122,-,5197
52,BUMA.1121.00098,1,2459931,2465129,+,5198
52,BUMA.1121.00111,1,3940072,3945266,+,5194
52,BUMA.1121.00109,1,2142037,2147242,-,5205
52,BUMA.1121.00097,1,183100,188298,-,5198
52,BUMA.1121.00094,1,3780139,3785336,+,5197
52,BUMA.1121.00095,1,1890948,1896140,-,5192
52,BUMA.1121.00005,1,3805733,3810930,-,5197
52,BUMA.1121.00101,1,2700697,2705891,-,5194
52,BUMA.1121.00065,1,3808877,3814071,+,5194
52,BUMA.1121.00100,1,1537070,1542264,-,5194
52,BUMA.1121.00105,1,1454549,1459746,-,5197
52,BUMA.1121.00029,1,1165402,1170594,-,5192
52,BUMA.1121.00066,1,3652678,3657874,+,5196
52,BUMA.1121.00031,1,1137978,1143172,+,5194
52,BUMA.1121.00108,1,747982,753180,+,5198
52,BUMA.1121.00023,1,2118335,2123529,+,5194
52,BUMA.1121.00035,1,799530,804724,+,5194
52,BUMA.1121.00041,1,1001783,1006980,+,5197
51,BUMA.1121.00057,1,847681,853301,+,5620
51,BUMA.1121.00058,1,753414,759042,-,5628
51,BUMA.1121.00045,1,317825,323495,-,5670
51,BUMA.1121.00051,1,3744423,3750022,+,5599
51,BUMA.1121.00068,1,2578556,2584127,+,5571
51,BUMA.1121.00061,1,3659288,3664889,+,5601
51,BUMA.1121.00060,1,2563081,2568744,-,5663
51,BUMA.1121.00064,1,3758387,3763993,+,5606
51,BUMA.1121.00016,1,1859288,1864871,+,5583
51,BUMA.1121.00003,1,2277541,2283182,+,5641
51,BUMA.1121.00055,1,3424045,3429693,+,5648
51,BUMA.1121.00011,1,1853266,1858867,-,5601
51,BUMA.1121.00037,1,2406491,2412032,+,5541
51,BUMA.1121.00009,1,1816937,1822563,-,5626
51,BUMA.1121.00069,1,3642410,3648016,+,5606
51,BUMA.1121.00088,1,600740,606346,+,5606
51,BUMA.1121.00092,1,3848405,3853953,+,5548
51,BUMA.1121.00074,1,329396,334989,-,5593
51,BUMA.1121.00070,1,3630134,3635733,+,5599
51,BUMA.1121.00093,1,772521,778070,-,5549
51,BUMA.1121.00063,1,3655848,3661448,+,5600
51,BUMA.1121.00033,1,2010658,2016248,+,5590
51,BUMA.1121.00018,1,221070,226674,+,5604
51,BUMA.1121.00080,1,3772068,3777730,+,5662
51,BUMA.1121.00027,1,1931126,1936718,+,5592
51,BUMA.1121.00053,1,3503609,3509171,+,5562
51,BUMA.1121.00059,1,3005610,3011209,+,5599
51,BUMA.1121.00043,1,3873910,3879444,+,5534
51,BUMA.1121.00056,1,175142,180756,-,5614
51,BUMA.1121.00112,1,3326670,3332277,-,5607
51,BUMA.1121.00091,1,733474,739081,-,5607
51,BUMA.1121.00047,1,3216345,3221896,-,5551
51,BUMA.1121.00067,1,665617,671224,-,5607
51,BUMA.1121.00110,1,1043889,1049468,-,5579
51,BUMA.1121.00073,1,3657567,3663167,+,5600
51,BUMA.1121.00072,1,3643991,3649595,+,5604
51,BUMA.1121.00077,1,2433856,2439431,+,5575
51,BUMA.1121.00082,1,3847323,3852929,+,5606
51,BUMA.1121.00062,1,813506,819092,-,5586
51,BUMA.1121.00007,1,287094,292729,-,5635
51,BUMA.1121.00025,1,3033207,3038798,-,5591
51,BUMA.1121.00021,1,391428,397033,+,5605
51,BUMA.1121.00103,1,588218,593810,-,5592
51,BUMA.1121.00096,1,3488381,3493986,-,5605
51,BUMA.1121.00079,1,3859087,3864686,+,5599
51,BUMA.1121.00039,1,3894690,3900200,+,5510
51,BUMA.1121.00083,1,1926441,1932048,-,5607
51,BUMA.1121.00084,1,17056,22711,+,5655
51,BUMA.1121.00049,1,2061539,2067167,-,5628
51,BUMA.1121.00089,1,3746176,3751789,+,5613
51,BUMA.1121.00014,1,3112596,3118166,-,5570
51,BUMA.1121.00090,1,1819886,1825455,+,5569
51,BUMA.1121.00071,1,3661859,3667461,+,5602
51,BUMA.1121.00078,1,2252377,2257954,-,5577
51,BUMA.1121.00102,1,1536393,1541991,-,5598
51,BUMA.1121.00075,1,3234285,3239889,+,5604
51,BUMA.1121.00012,1,2493008,2498602,+,5594
51,BUMA.1121.00076,1,1572351,1577965,-,5614
51,BUMA.1121.00106,1,3520113,3525726,+,5613
51,BUMA.1121.00001,1,294306,299869,-,5563
51,BUMA.1121.00107,1,3723092,3728719,+,5627
51,BUMA.1121.00104,1,1491515,1497134,-,5619
51,BUMA.1121.00099,1,2676253,2681832,-,5579
51,BUMA.1121.00098,1,2454173,2459800,+,5627
51,BUMA.1121.00111,1,3934438,3939941,+,5503
51,BUMA.1121.00109,1,2147373,2152974,-,5601
51,BUMA.1121.00097,1,188429,194113,-,5684
51,BUMA.1121.00094,1,3774374,3780008,+,5634
51,BUMA.1121.00095,1,1896271,1901920,-,5649
51,BUMA.1121.00005,1,3811061,3816640,-,5579
51,BUMA.1121.00101,1,2706022,2711685,-,5663
51,BUMA.1121.00065,1,3803140,3808746,+,5606
51,BUMA.1121.00100,1,1542395,1548030,-,5635
51,BUMA.1121.00105,1,1459877,1465470,-,5593
51,BUMA.1121.00029,1,1170725,1176323,-,5598
51,BUMA.1121.00066,1,3646941,3652547,+,5606
51,BUMA.1121.00031,1,1132278,1137847,+,5569
51,BUMA.1121.00108,1,742281,747851,+,5570
51,BUMA.1121.00023,1,2112642,2118204,+,5562
51,BUMA.1121.00035,1,793788,799399,+,5611
51,BUMA.1121.00041,1,996053,1001652,+,5599
50,BUMA.1121.00057,1,838744,847380,+,8636
50,BUMA.1121.00058,1,759340,767972,-,8632
50,BUMA.1121.00045,1,323796,332430,-,8634
50,BUMA.1121.00051,1,3735491,3744125,+,8634
50,BUMA.1121.00068,1,2569603,2578258,+,8655
50,BUMA.1121.00061,1,3650351,3658987,+,8636
50,BUMA.1121.00060,1,2569045,2577679,-,8634
50,BUMA.1121.00064,1,3749475,3758086,+,8611
50,BUMA.1121.00016,1,1850352,1858987,+,8635
50,BUMA.1121.00003,1,2268604,2277240,+,8636
50,BUMA.1121.00055,1,3415146,3423744,+,8598
50,BUMA.1121.00011,1,1859168,1867802,-,8634
50,BUMA.1121.00037,1,2397551,2406190,+,8639
50,BUMA.1121.00009,1,1822864,1831497,-,8633
50,BUMA.1121.00069,1,3633475,3642109,+,8634
50,BUMA.1121.00088,1,591805,600439,+,8634
50,BUMA.1121.00092,1,3839470,3848104,+,8634
50,BUMA.1121.00074,1,335290,343928,-,8638
50,BUMA.1121.00070,1,3621196,3629833,+,8637
50,BUMA.1121.00093,1,778371,787005,-,8634
50,BUMA.1121.00063,1,3646910,3655547,+,8637
50,BUMA.1121.00033,1,2001721,2010357,+,8636
50,BUMA.1121.00018,1,212135,220769,+,8634
50,BUMA.1121.00080,1,3763136,3771770,+,8634
50,BUMA.1121.00027,1,1922194,1930828,+,8634
50,BUMA.1121.00053,1,3494667,3503308,+,8641
50,BUMA.1121.00059,1,2996675,3005309,+,8634
50,BUMA.1121.00043,1,3864970,3873609,+,8639
50,BUMA.1121.00056,1,181054,189689,-,8635
50,BUMA.1121.00112,1,3332578,3341212,-,8634
50,BUMA.1121.00091,1,739382,748014,-,8632
50,BUMA.1121.00047,1,3223614,3232248,-,8634
50,BUMA.1121.00067,1,671525,680162,-,8637
50,BUMA.1121.00110,1,1049769,1058403,-,8634
50,BUMA.1121.00073,1,3648629,3657266,+,8637
50,BUMA.1121.00072,1,3635056,3643690,+,8634
50,BUMA.1121.00077,1,2424921,2433555,+,8634
50,BUMA.1121.00082,1,3838385,3847022,+,8637
50,BUMA.1121.00062,1,819393,828027,-,8634
50,BUMA.1121.00007,1,293030,301664,-,8634
50,BUMA.1121.00025,1,3039099,3047733,-,8634
50,BUMA.1121.00021,1,381139,391127,+,9988
50,BUMA.1121.00103,1,594111,602753,-,8642
50,BUMA.1121.00096,1,3494287,3502921,-,8634
50,BUMA.1121.00079,1,3850150,3858786,+,8636
50,BUMA.1121.00039,1,3884338,3892976,+,8638
50,BUMA.1121.00083,1,1932349,1940986,-,8637
50,BUMA.1121.00084,1,8122,16755,+,8633
50,BUMA.1121.00049,1,2067468,2076089,-,8621
50,BUMA.1121.00089,1,3737243,3745878,+,8635
50,BUMA.1121.00014,1,3118467,3127104,-,8637
50,BUMA.1121.00090,1,1810949,1819585,+,8636
50,BUMA.1121.00071,1,3652921,3661558,+,8637
50,BUMA.1121.00078,1,2258255,2266904,-,8649
50,BUMA.1121.00102,1,1542292,1550926,-,8634
50,BUMA.1121.00075,1,3225370,3233984,+,8614
50,BUMA.1121.00012,1,2484071,2492707,+,8636
50,BUMA.1121.00076,1,1578266,1586881,-,8615
50,BUMA.1121.00106,1,3511178,3519812,+,8634
50,BUMA.1121.00001,1,300170,308804,-,8634
50,BUMA.1121.00107,1,3714156,3722791,+,8635
50,BUMA.1121.00104,1,1497435,1506069,-,8634
50,BUMA.1121.00099,1,2682133,2690795,-,8662
50,BUMA.1121.00098,1,2445239,2453872,+,8633
50,BUMA.1121.00111,1,3924086,3932723,+,8637
50,BUMA.1121.00109,1,2153275,2161909,-,8634
50,BUMA.1121.00097,1,194414,203059,-,8645
50,BUMA.1121.00094,1,3765439,3774073,+,8634
50,BUMA.1121.00095,1,1902221,1910882,-,8661
50,BUMA.1121.00005,1,3816941,3825577,-,8636
50,BUMA.1121.00101,1,2711986,2720632,-,8646
50,BUMA.1121.00065,1,3794197,3802839,+,8642
50,BUMA.1121.00100,1,1548331,1558277,-,9946
50,BUMA.1121.00105,1,1465771,1474384,-,8613
50,BUMA.1121.00029,1,1176624,1185258,-,8634
50,BUMA.1121.00066,1,3638003,3646640,+,8637
50,BUMA.1121.00031,1,1123341,1131977,+,8636
50,BUMA.1121.00108,1,733346,741980,+,8634
50,BUMA.1121.00023,1,2103707,2112341,+,8634
50,BUMA.1121.00035,1,784853,793487,+,8634
50,BUMA.1121.00041,1,987140,995752,+,8612
49,BUMA.1121.00057,1,816486,828966,+,12480
49,BUMA.1121.00058,1,777857,790336,-,12479
49,BUMA.1121.00045,1,342187,354666,-,12479
49,BUMA.1121.00051,1,3713227,3725718,+,12491
49,BUMA.1121.00068,1,2547358,2559838,+,12480
49,BUMA.1121.00061,1,3628104,3640584,+,12480
49,BUMA.1121.00060,1,2587436,2599915,-,12479
49,BUMA.1121.00064,1,3725685,3738176,+,12491
49,BUMA.1121.00016,1,1826848,1839328,+,12480
49,BUMA.1121.00003,1,2246191,2258671,+,12480
49,BUMA.1121.00055,1,3391439,3403919,+,12480
49,BUMA.1121.00011,1,1877612,1890091,-,12479
49,BUMA.1121.00037,1,2373993,2386473,+,12480
49,BUMA.1121.00009,1,1841327,1853805,-,12478
49,BUMA.1121.00069,1,3611229,3623709,+,12480
49,BUMA.1121.00088,1,568196,580687,+,12491
49,BUMA.1121.00092,1,3817095,3829575,+,12480
49,BUMA.1121.00070,1,3598949,3611429,+,12480
49,BUMA.1121.00093,1,796862,809341,-,12479
49,BUMA.1121.00063,1,3624664,3637144,+,12480
49,BUMA.1121.00033,1,1978177,1990668,+,12491
49,BUMA.1121.00018,1,188695,201175,+,12480
49,BUMA.1121.00080,1,3740872,3753363,+,12491
49,BUMA.1121.00027,1,1899900,1912377,+,12477
49,BUMA.1121.00053,1,3472204,3484684,+,12480
49,BUMA.1121.00059,1,2974397,2986877,+,12480
49,BUMA.1121.00043,1,3841433,3853913,+,12480
49,BUMA.1121.00056,1,199462,211953,-,12491
49,BUMA.1121.00112,1,3351021,3363500,-,12479
49,BUMA.1121.00091,1,759019,771498,-,12479
49,BUMA.1121.00047,1,3241982,3254473,-,12491
49,BUMA.1121.00067,1,690017,702496,-,12479
49,BUMA.1121.00110,1,1069432,1081923,-,12491
49,BUMA.1121.00074,2,744065,756545,+,12480
49,BUMA.1121.00073,1,3626383,3638863,+,12480
49,BUMA.1121.00072,1,3612798,3625278,+,12480
49,BUMA.1121.00077,1,2401401,2413893,+,12492
49,BUMA.1121.00082,1,3816127,3828607,+,12480
49,BUMA.1121.00062,1,837898,850377,-,12479
49,BUMA.1121.00007,1,311471,323962,-,12491
49,BUMA.1121.00025,1,3058693,3071172,-,12479
49,BUMA.1121.00021,1,357463,369943,+,12480
49,BUMA.1121.00103,1,612627,625118,-,12491
49,BUMA.1121.00096,1,3512773,3525252,-,12479
49,BUMA.1121.00079,1,3827925,3840416,+,12491
49,BUMA.1121.00039,1,3859573,3872053,+,12480
49,BUMA.1121.00083,1,1950764,1963243,-,12479
49,BUMA.1121.00084,1,4110842,4123333,+,12491
49,BUMA.1121.00049,1,2085990,2098469,-,12479
49,BUMA.1121.00089,1,3714979,3727470,+,12491
49,BUMA.1121.00014,1,3138135,3150614,-,12479
49,BUMA.1121.00090,1,1787478,1799958,+,12480
49,BUMA.1121.00071,1,3630675,3643155,+,12480
49,BUMA.1121.00078,1,2279176,2291655,-,12479
49,BUMA.1121.00102,1,1561026,1573505,-,12479
49,BUMA.1121.00075,1,3203125,3215605,+,12480
49,BUMA.1121.00012,1,2457505,2469985,+,12480
49,BUMA.1121.00076,1,1596665,1609144,-,12479
49,BUMA.1121.00106,1,3488771,3501251,+,12480
49,BUMA.1121.00001,1,322274,334753,-,12479
49,BUMA.1121.00107,1,3691879,3704359,+,12480
49,BUMA.1121.00104,1,1515961,1528440,-,12479
49,BUMA.1121.00099,1,2700606,2713085,-,12479
49,BUMA.1121.00098,1,2422839,2435319,+,12480
49,BUMA.1121.00111,1,3900559,3913039,+,12480
49,BUMA.1121.00109,1,2171861,2184340,-,12479
49,BUMA.1121.00097,1,212846,225325,-,12479
49,BUMA.1121.00094,1,3743176,3755665,+,12489
49,BUMA.1121.00095,1,1921847,1934326,-,12479
49,BUMA.1121.00005,1,3836645,3849124,-,12479
49,BUMA.1121.00101,1,2730356,2742835,-,12479
49,BUMA.1121.00065,1,3771881,3784361,+,12480
49,BUMA.1121.00100,1,1568097,1580576,-,12479
49,BUMA.1121.00105,1,1484248,1496727,-,12479
49,BUMA.1121.00029,1,1196246,1208725,-,12479
49,BUMA.1121.00066,1,3615756,3628236,+,12480
49,BUMA.1121.00031,1,1099845,1112325,+,12480
49,BUMA.1121.00108,1,711059,723539,+,12480
49,BUMA.1121.00023,1,2080107,2092587,+,12480
49,BUMA.1121.00035,1,761787,774267,+,12480
49,BUMA.1121.00041,1,964671,977151,+,12480
48,BUMA.1121.00057,1,792524,809883,+,17359
48,BUMA.1121.00058,1,796939,814298,-,17359
48,BUMA.1121.00045,1,361269,378628,-,17359
48,BUMA.1121.00051,1,3686751,3704110,+,17359
48,BUMA.1121.00068,1,2523396,2540755,+,17359
48,BUMA.1121.00061,1,3604142,3621501,+,17359
48,BUMA.1121.00060,1,2606518,2623877,-,17359
48,BUMA.1121.00064,1,3700421,3717780,+,17359
48,BUMA.1121.00016,1,1802886,1820245,+,17359
48,BUMA.1121.00003,1,2222229,2239588,+,17359
48,BUMA.1121.00055,1,3367477,3384836,+,17359
48,BUMA.1121.00011,1,1896694,1914053,-,17359
48,BUMA.1121.00037,1,2350031,2367390,+,17359
48,BUMA.1121.00009,1,1860408,1877767,-,17359
48,BUMA.1121.00069,1,3587267,3604626,+,17359
48,BUMA.1121.00088,1,542932,560291,+,17359
48,BUMA.1121.00092,1,3793133,3810492,+,17359
48,BUMA.1121.00070,1,3574987,3592346,+,17359
48,BUMA.1121.00093,1,815944,833303,-,17359
48,BUMA.1121.00063,1,3600702,3618061,+,17359
48,BUMA.1121.00033,1,1952914,1970273,+,17359
48,BUMA.1121.00018,1,164733,182092,+,17359
48,BUMA.1121.00080,1,3714396,3731755,+,17359
48,BUMA.1121.00027,1,1875938,1893297,+,17359
48,BUMA.1121.00053,1,3448242,3465601,+,17359
48,BUMA.1121.00059,1,2950435,2967794,+,17359
48,BUMA.1121.00043,1,3817471,3834830,+,17359
48,BUMA.1121.00056,1,221069,238428,-,17359
48,BUMA.1121.00112,1,3370103,3387462,-,17359
48,BUMA.1121.00091,1,778101,795460,-,17359
48,BUMA.1121.00047,1,3263589,3280948,-,17359
48,BUMA.1121.00067,1,709099,726458,-,17359
48,BUMA.1121.00110,1,1089827,1107202,-,17375
48,BUMA.1121.00074,2,720103,737462,+,17359
48,BUMA.1121.00073,1,3602421,3619780,+,17359
48,BUMA.1121.00072,1,3588836,3606195,+,17359
48,BUMA.1121.00077,1,2376124,2393498,+,17374
48,BUMA.1121.00082,1,3792165,3809524,+,17359
48,BUMA.1121.00062,1,856980,874339,-,17359
48,BUMA.1121.00007,1,331866,349225,-,17359
48,BUMA.1121.00025,1,3077775,3095134,-,17359
48,BUMA.1121.00021,1,333502,350860,+,17358
48,BUMA.1121.00103,1,633023,650382,-,17359
48,BUMA.1121.00096,1,3531855,3549229,-,17374
48,BUMA.1121.00079,1,3801449,3818808,+,17359
48,BUMA.1121.00039,1,3835611,3852970,+,17359
48,BUMA.1121.00083,1,1969846,1987205,-,17359
48,BUMA.1121.00084,1,4085578,4102937,+,17359
48,BUMA.1121.00049,1,2105072,2122431,-,17359
48,BUMA.1121.00089,1,3688503,3705862,+,17359
48,BUMA.1121.00014,1,3157217,3174576,-,17359
48,BUMA.1121.00090,1,1763516,1780875,+,17359
48,BUMA.1121.00071,1,3606713,3624072,+,17359
48,BUMA.1121.00078,1,2298258,2315633,-,17375
48,BUMA.1121.00102,1,1580108,1597467,-,17359
48,BUMA.1121.00075,1,3179163,3196522,+,17359
48,BUMA.1121.00012,1,2433543,2450902,+,17359
48,BUMA.1121.00076,1,1615747,1633106,-,17359
48,BUMA.1121.00106,1,3464809,3482168,+,17359
48,BUMA.1121.00001,1,341356,358715,-,17359
48,BUMA.1121.00107,1,3667917,3685276,+,17359
48,BUMA.1121.00104,1,1535043,1552402,-,17359
48,BUMA.1121.00099,1,2719688,2737047,-,17359
48,BUMA.1121.00098,1,2398877,2416236,+,17359
48,BUMA.1121.00111,1,3876597,3893956,+,17359
48,BUMA.1121.00109,1,2190943,2208302,-,17359
48,BUMA.1121.00097,1,231928,249287,-,17359
48,BUMA.1121.00094,1,3716699,3734058,+,17359
48,BUMA.1121.00095,1,1940930,1958286,-,17356
48,BUMA.1121.00005,1,3855727,3873086,-,17359
48,BUMA.1121.00101,1,2749438,2766797,-,17359
48,BUMA.1121.00065,1,3747919,3765278,+,17359
48,BUMA.1121.00100,1,1587179,1604538,-,17359
48,BUMA.1121.00105,1,1503330,1520689,-,17359
48,BUMA.1121.00029,1,1215328,1232687,-,17359
48,BUMA.1121.00066,1,3591794,3609153,+,17359
48,BUMA.1121.00031,1,1075883,1093242,+,17359
48,BUMA.1121.00108,1,687097,704456,+,17359
48,BUMA.1121.00023,1,2056137,2073504,+,17367
48,BUMA.1121.00035,1,737825,755184,+,17359
48,BUMA.1121.00041,1,940709,958068,+,17359
47,BUMA.1121.00057,1,781923,791217,+,9294
47,BUMA.1121.00058,1,815605,824904,-,9299
47,BUMA.1121.00045,1,379935,389218,-,9283
47,BUMA.1121.00051,1,3676150,3685444,+,9294
47,BUMA.1121.00068,1,2512795,2522089,+,9294
47,BUMA.1121.00061,1,3593541,3602835,+,9294
47,BUMA.1121.00060,1,2625184,2634467,-,9283
47,BUMA.1121.00064,1,3689814,3699114,+,9300
47,BUMA.1121.00016,1,1792281,1801579,+,9298
47,BUMA.1121.00003,1,2211637,2220925,+,9288
47,BUMA.1121.00055,1,3356882,3366170,+,9288
47,BUMA.1121.00011,1,1915360,1924655,-,9295
47,BUMA.1121.00037,1,2339430,2348724,+,9294
47,BUMA.1121.00009,1,1879074,1888366,-,9292
47,BUMA.1121.00069,1,3576666,3585960,+,9294
47,BUMA.1121.00088,1,532337,541625,+,9288
47,BUMA.1121.00092,1,3782520,3791826,+,9306
47,BUMA.1121.00070,1,3564386,3573680,+,9294
47,BUMA.1121.00093,1,834610,843917,-,9307
47,BUMA.1121.00063,1,3590101,3599395,+,9294
47,BUMA.1121.00033,1,1942309,1951607,+,9298
47,BUMA.1121.00018,1,154126,163426,+,9300
47,BUMA.1121.00080,1,3703795,3713089,+,9294
47,BUMA.1121.00027,1,1865327,1874631,+,9304
47,BUMA.1121.00053,1,3437641,3446935,+,9294
47,BUMA.1121.00059,1,2939840,2949128,+,9288
47,BUMA.1121.00043,1,3806864,3816164,+,9300
47,BUMA.1121.00056,1,239735,249030,-,9295
47,BUMA.1121.00112,1,3388769,3398040,-,9271
47,BUMA.1121.00091,1,796767,806074,-,9307
47,BUMA.1121.00047,1,3282255,3291550,-,9295
47,BUMA.1121.00067,1,727762,737057,-,9295
47,BUMA.1121.00110,1,1110091,1119386,-,9295
47,BUMA.1121.00074,2,709505,718799,+,9294
47,BUMA.1121.00073,1,3591820,3601114,+,9294
47,BUMA.1121.00072,1,3578235,3587529,+,9294
47,BUMA.1121.00077,1,2363942,2373236,+,9294
47,BUMA.1121.00082,1,3781564,3790858,+,9294
47,BUMA.1121.00062,1,875646,884941,-,9295
47,BUMA.1121.00007,1,350532,359821,-,9289
47,BUMA.1121.00025,1,3096441,3105742,-,9301
47,BUMA.1121.00021,1,322894,332194,+,9300
47,BUMA.1121.00103,1,651689,660983,-,9294
47,BUMA.1121.00096,1,3552119,3561418,-,9299
47,BUMA.1121.00079,1,3789253,3798562,+,9309
47,BUMA.1121.00039,1,3825010,3834304,+,9294
47,BUMA.1121.00083,1,1988512,1997807,-,9295
47,BUMA.1121.00084,1,4074983,4084271,+,9288
47,BUMA.1121.00049,1,2123738,2133018,-,9280
47,BUMA.1121.00089,1,3677902,3687196,+,9294
47,BUMA.1121.00014,1,3175883,3185178,-,9295
47,BUMA.1121.00090,1,1752915,1762209,+,9294
47,BUMA.1121.00071,1,3596112,3605406,+,9294
47,BUMA.1121.00078,1,2318520,2327821,-,9301
47,BUMA.1121.00102,1,1598774,1608081,-,9307
47,BUMA.1121.00075,1,3168565,3177856,+,9291
47,BUMA.1121.00012,1,2422942,2432236,+,9294
47,BUMA.1121.00076,1,1634413,1643708,-,9295
47,BUMA.1121.00106,1,3454191,3463502,+,9311
47,BUMA.1121.00001,1,360022,369329,-,9307
47,BUMA.1121.00107,1,3657310,3666610,+,9300
47,BUMA.1121.00104,1,1553709,1562998,-,9289
47,BUMA.1121.00099,1,2738354,2747661,-,9307
47,BUMA.1121.00098,1,2388270,2397570,+,9300
47,BUMA.1121.00111,1,3865996,3875290,+,9294
47,BUMA.1121.00109,1,2209606,2218901,-,9295
47,BUMA.1121.00097,1,250594,259889,-,9295
47,BUMA.1121.00094,1,3706098,3715392,+,9294
47,BUMA.1121.00095,1,1959593,1968882,-,9289
47,BUMA.1121.00005,1,3874393,3883688,-,9295
47,BUMA.1121.00101,1,2768104,2777391,-,9287
47,BUMA.1121.00065,1,3737324,3746612,+,9288
47,BUMA.1121.00100,1,1605845,1615146,-,9301
47,BUMA.1121.00105,1,1521996,1531308,-,9312
47,BUMA.1121.00029,1,1233994,1243301,-,9307
47,BUMA.1121.00066,1,3581193,3590487,+,9294
47,BUMA.1121.00031,1,1065282,1074576,+,9294
47,BUMA.1121.00108,1,676505,685790,+,9285
47,BUMA.1121.00023,1,2045577,2054830,+,9253
47,BUMA.1121.00035,1,727212,736518,+,9306
47,BUMA.1121.00041,1,930108,939402,+,9294
46,BUMA.1121.00057,1,731785,778897,+,47112
46,BUMA.1121.00058,1,827928,875023,-,47095
46,BUMA.1121.00045,1,393849,440951,-,47102
46,BUMA.1121.00051,1,3626005,3673124,+,47119
46,BUMA.1121.00068,1,2462660,2509770,+,47110
46,BUMA.1121.00061,1,3543412,3590515,+,47103
46,BUMA.1121.00060,1,2639097,2686199,-,47102
46,BUMA.1121.00064,1,3639663,3686789,+,47126
46,BUMA.1121.00016,1,1742151,1789256,+,47105
46,BUMA.1121.00003,1,2161489,2208612,+,47123
46,BUMA.1121.00055,1,3306750,3353857,+,47107
46,BUMA.1121.00011,1,1927678,1974816,-,47138
46,BUMA.1121.00037,1,2289305,2336405,+,47100
46,BUMA.1121.00009,1,1891390,1938519,-,47129
46,BUMA.1121.00069,1,3526542,3573640,+,47098
46,BUMA.1121.00088,1,482710,529810,+,47100
46,BUMA.1121.00092,1,3732397,3779495,+,47098
46,BUMA.1121.00070,1,3514259,3561361,+,47102
46,BUMA.1121.00093,1,846941,894039,-,47098
46,BUMA.1121.00063,1,3539973,3587075,+,47102
46,BUMA.1121.00033,1,1892155,1939284,+,47129
46,BUMA.1121.00018,1,104003,151101,+,47098
46,BUMA.1121.00080,1,3653663,3700769,+,47106
46,BUMA.1121.00027,1,1815173,1862302,+,47129
46,BUMA.1121.00053,1,3387504,3434616,+,47112
46,BUMA.1121.00059,1,2889709,2936815,+,47106
46,BUMA.1121.00043,1,3756744,3803839,+,47095
46,BUMA.1121.00056,1,252055,299155,-,47100
46,BUMA.1121.00112,1,3401064,3448160,-,47096
46,BUMA.1121.00091,1,809098,856214,-,47116
46,BUMA.1121.00047,1,3294575,3341684,-,47109
46,BUMA.1121.00067,1,740081,787190,-,47109
46,BUMA.1121.00110,1,1122411,1169519,-,47108
46,BUMA.1121.00074,2,659361,706480,+,47119
46,BUMA.1121.00073,1,3541691,3588794,+,47103
46,BUMA.1121.00072,1,3528112,3575209,+,47097
46,BUMA.1121.00077,1,2313811,2360916,+,47105
46,BUMA.1121.00082,1,3731435,3778538,+,47103
46,BUMA.1121.00062,1,887965,935091,-,47126
46,BUMA.1121.00007,1,362844,409939,-,47095
46,BUMA.1121.00025,1,3108766,3155865,-,47099
46,BUMA.1121.00021,1,272769,319869,+,47100
46,BUMA.1121.00103,1,664007,711145,-,47138
46,BUMA.1121.00096,1,3564442,3611556,-,47114
46,BUMA.1121.00079,1,3739124,3786228,+,47104
46,BUMA.1121.00039,1,3774885,3821985,+,47100
46,BUMA.1121.00083,1,2000832,2047936,-,47104
46,BUMA.1121.00084,1,4024830,4071958,+,47128
46,BUMA.1121.00049,1,2137641,2184734,-,47093
46,BUMA.1121.00089,1,3627777,3674876,+,47099
46,BUMA.1121.00014,1,3188202,3235313,-,47111
46,BUMA.1121.00090,1,1702791,1749890,+,47099
46,BUMA.1121.00071,1,3545984,3593086,+,47102
46,BUMA.1121.00078,1,2330845,2377997,-,47152
46,BUMA.1121.00102,1,1611105,1658280,-,47175
46,BUMA.1121.00075,1,3118444,3165539,+,47095
46,BUMA.1121.00012,1,2372802,2419917,+,47115
46,BUMA.1121.00076,1,1646733,1693832,-,47099
46,BUMA.1121.00106,1,3404065,3451166,+,47101
46,BUMA.1121.00001,1,372353,419462,-,47109
46,BUMA.1121.00107,1,3607177,3654285,+,47108
46,BUMA.1121.00104,1,1566022,1613124,-,47102
46,BUMA.1121.00099,1,2750685,2797819,-,47134
46,BUMA.1121.00098,1,2338086,2385245,+,47159
46,BUMA.1121.00111,1,3815869,3862971,+,47102
46,BUMA.1121.00109,1,2221925,2269186,-,47261
46,BUMA.1121.00097,1,262913,310019,-,47106
46,BUMA.1121.00094,1,3655967,3703072,+,47105
46,BUMA.1121.00095,1,1971906,2019026,-,47120
46,BUMA.1121.00005,1,3886713,3933826,-,47113
46,BUMA.1121.00101,1,2782015,2829143,-,47128
46,BUMA.1121.00065,1,3687206,3734299,+,47093
46,BUMA.1121.00100,1,1618170,1665266,-,47096
46,BUMA.1121.00105,1,1534332,1581441,-,47109
46,BUMA.1121.00029,1,1246325,1293427,-,47102
46,BUMA.1121.00066,1,3531065,3578167,+,47102
46,BUMA.1121.00031,1,1015146,1062257,+,47111
46,BUMA.1121.00108,1,624723,671880,+,47157
46,BUMA.1121.00023,1,1995459,2042552,+,47093
46,BUMA.1121.00035,1,677085,724187,+,47102
46,BUMA.1121.00041,1,879922,927083,+,47161
45,BUMA.1121.00057,1,725210,731075,+,5865
45,BUMA.1121.00058,1,875732,881599,-,5867
45,BUMA.1121.00045,1,441664,447537,-,5873
45,BUMA.1121.00051,1,3619425,3625291,+,5866
45,BUMA.1121.00068,1,2456074,2461940,+,5866
45,BUMA.1121.00061,1,3536836,3542702,+,5866
45,BUMA.1121.00060,1,2686912,2692785,-,5873
45,BUMA.1121.00064,1,3633087,3638953,+,5866
45,BUMA.1121.00016,1,1733978,1739844,+,5866
45,BUMA.1121.00003,1,2154910,2160775,+,5865
45,BUMA.1121.00055,1,3300174,3306040,+,5866
45,BUMA.1121.00011,1,1975529,1981396,-,5867
45,BUMA.1121.00037,1,2282818,2288684,+,5866
45,BUMA.1121.00009,1,1939231,1945098,-,5867
45,BUMA.1121.00069,1,3519968,3525832,+,5864
45,BUMA.1121.00088,1,476130,481996,+,5866
45,BUMA.1121.00092,1,3725910,3731776,+,5866
45,BUMA.1121.00070,1,3507683,3513549,+,5866
45,BUMA.1121.00093,1,894660,900527,-,5867
45,BUMA.1121.00063,1,3533398,3539263,+,5865
45,BUMA.1121.00033,1,1885576,1891442,+,5866
45,BUMA.1121.00018,1,97516,103382,+,5866
45,BUMA.1121.00080,1,3647087,3652953,+,5866
45,BUMA.1121.00027,1,1808599,1814463,+,5864
45,BUMA.1121.00053,1,3380928,3386794,+,5866
45,BUMA.1121.00059,1,2883134,2888999,+,5865
45,BUMA.1121.00043,1,3750269,3756123,+,5854
45,BUMA.1121.00056,1,299864,305731,-,5867
45,BUMA.1121.00112,1,3448872,3454739,-,5867
45,BUMA.1121.00091,1,856923,862791,-,5868
45,BUMA.1121.00047,1,3342397,3348264,-,5867
45,BUMA.1121.00067,1,787903,793770,-,5867
45,BUMA.1121.00110,1,1170232,1176099,-,5867
45,BUMA.1121.00074,2,652785,658651,+,5866
45,BUMA.1121.00073,1,3535116,3540981,+,5865
45,BUMA.1121.00072,1,3521537,3527402,+,5865
45,BUMA.1121.00077,1,2307231,2313097,+,5866
45,BUMA.1121.00082,1,3724860,3730725,+,5865
45,BUMA.1121.00062,1,935804,941671,-,5867
45,BUMA.1121.00007,1,412246,418101,-,5855
45,BUMA.1121.00025,1,3156486,3162353,-,5867
45,BUMA.1121.00021,1,266282,272148,+,5866
45,BUMA.1121.00103,1,711858,717725,-,5867
45,BUMA.1121.00096,1,3612268,3618135,-,5867
45,BUMA.1121.00079,1,3732545,3738411,+,5866
45,BUMA.1121.00039,1,3768410,3774264,+,5854
45,BUMA.1121.00083,1,2048645,2054511,-,5866
45,BUMA.1121.00084,1,4018251,4024116,+,5865
45,BUMA.1121.00049,1,2185443,2191310,-,5867
45,BUMA.1121.00089,1,3621201,3627067,+,5866
45,BUMA.1121.00014,1,3235934,3241801,-,5867
45,BUMA.1121.00090,1,1696316,1702170,+,5854
45,BUMA.1121.00071,1,3539409,3545274,+,5865
45,BUMA.1121.00078,1,2378706,2384573,-,5867
45,BUMA.1121.00102,1,1658989,1664856,-,5867
45,BUMA.1121.00075,1,3111864,3117730,+,5866
45,BUMA.1121.00012,1,2366224,2372089,+,5865
45,BUMA.1121.00076,1,1694545,1700412,-,5867
45,BUMA.1121.00106,1,3397489,3403355,+,5866
45,BUMA.1121.00001,1,420174,426041,-,5867
45,BUMA.1121.00107,1,3600601,3606467,+,5866
45,BUMA.1121.00104,1,1613833,1619700,-,5867
45,BUMA.1121.00099,1,2798531,2804398,-,5867
45,BUMA.1121.00098,1,2329914,2335780,+,5866
45,BUMA.1121.00111,1,3809290,3815156,+,5866
45,BUMA.1121.00109,1,2269899,2275766,-,5867
45,BUMA.1121.00097,1,310732,316599,-,5867
45,BUMA.1121.00094,1,3649387,3655253,+,5866
45,BUMA.1121.00095,1,2019735,2025602,-,5867
45,BUMA.1121.00005,1,3934531,3940397,-,5866
45,BUMA.1121.00101,1,2829856,2835723,-,5867
45,BUMA.1121.00065,1,3680626,3686492,+,5866
45,BUMA.1121.00100,1,1665978,1671844,-,5866
45,BUMA.1121.00105,1,1582154,1588021,-,5867
45,BUMA.1121.00029,1,1294139,1300006,-,5867
45,BUMA.1121.00066,1,3524490,3530355,+,5865
45,BUMA.1121.00031,1,1008659,1014525,+,5866
45,BUMA.1121.00108,1,618144,624010,+,5866
45,BUMA.1121.00023,1,1988984,1994838,+,5854
45,BUMA.1121.00035,1,670506,676372,+,5866
45,BUMA.1121.00041,1,873346,879212,+,5866
44,BUMA.1121.00057,1,717595,720703,+,3108
44,BUMA.1121.00058,1,886106,889223,-,3117
44,BUMA.1121.00003,1,2147295,2150402,+,3107
44,BUMA.1121.00027,1,1800986,1804092,+,3106
44,BUMA.1121.00082,1,3717245,3720353,+,3108
44,BUMA.1121.00062,1,944119,947236,-,3117
44,BUMA.1121.00083,1,2059018,2062125,-,3107
44,BUMA.1121.00100,1,1677279,1680385,-,3106
44,BUMA.1121.00105,1,1591009,1594126,-,3117
43,BUMA.1121.00057,1,674864,717594,+,42730
43,BUMA.1121.00058,1,889225,932009,-,42784
43,BUMA.1121.00045,1,455947,498729,-,42782
43,BUMA.1121.00051,1,3537153,3579972,+,42819
43,BUMA.1121.00068,1,2362612,2405305,+,42693
43,BUMA.1121.00061,1,3492561,3535314,+,42753
43,BUMA.1121.00060,1,2701195,2743969,-,42774
43,BUMA.1121.00064,1,3571972,3614730,+,42758
43,BUMA.1121.00016,1,1687176,1729911,+,42735
43,BUMA.1121.00003,1,2104553,2147294,+,42741
43,BUMA.1121.00055,1,3250097,3292836,+,42739
43,BUMA.1121.00011,1,2001338,2044064,-,42726
43,BUMA.1121.00037,1,2205244,2248096,+,42852
43,BUMA.1121.00009,1,1948420,1991126,-,42706
43,BUMA.1121.00069,1,3475955,3518704,+,42749
43,BUMA.1121.00088,1,400048,442879,+,42831
43,BUMA.1121.00092,1,174094,216848,-,42754
43,BUMA.1121.00070,1,3463607,3506344,+,42737
43,BUMA.1121.00093,1,316987,359742,+,42755
43,BUMA.1121.00063,1,3489343,3532105,+,42762
43,BUMA.1121.00033,1,1788281,1831165,+,42884
43,BUMA.1121.00018,1,50586,93450,+,42864
43,BUMA.1121.00080,1,3585880,3628730,+,42850
43,BUMA.1121.00027,1,1758201,1800985,+,42784
43,BUMA.1121.00053,1,3330856,3373590,+,42734
43,BUMA.1121.00059,1,2814804,2857594,+,42790
43,BUMA.1121.00043,1,3703343,3746202,+,42859
43,BUMA.1121.00056,1,359150,401983,-,42833
43,BUMA.1121.00112,1,3464527,3507208,-,42681
43,BUMA.1121.00091,1,881591,924392,-,42801
43,BUMA.1121.00047,1,3400370,3443196,-,42826
43,BUMA.1121.00067,1,812127,854915,-,42788
43,BUMA.1121.00110,1,1184505,1227196,-,42691
43,BUMA.1121.00074,2,591662,634428,+,42766
43,BUMA.1121.00073,1,3491019,3533781,+,42762
43,BUMA.1121.00072,1,3477181,3519886,+,42705
43,BUMA.1121.00077,1,2256132,2298825,+,42693
43,BUMA.1121.00082,1,3674481,3717244,+,42763
43,BUMA.1121.00062,1,947238,990040,-,42802
43,BUMA.1121.00007,1,426678,469479,-,42801
43,BUMA.1121.00025,1,3166420,3209283,-,42863
43,BUMA.1121.00021,1,185028,227931,+,42903
43,BUMA.1121.00103,1,736526,779289,-,42763
43,BUMA.1121.00096,1,3666962,3709720,-,42758
43,BUMA.1121.00079,1,3637611,3680439,+,42828
43,BUMA.1121.00039,1,3720248,3763008,+,42760
43,BUMA.1121.00083,1,2062127,2104889,-,42762
43,BUMA.1121.00084,1,3932535,3975340,+,42805
43,BUMA.1121.00049,1,2212051,2254863,-,42812
43,BUMA.1121.00089,1,3524948,3567782,+,42834
43,BUMA.1121.00014,1,3280359,3323194,-,42835
43,BUMA.1121.00090,1,1646179,1688980,+,42801
43,BUMA.1121.00071,1,3495186,3537947,+,42761
43,BUMA.1121.00078,1,2391910,2434623,-,42713
43,BUMA.1121.00102,1,1684411,1727158,-,42747
43,BUMA.1121.00075,1,3061739,3104526,+,42787
43,BUMA.1121.00012,1,2318902,2361711,+,42809
43,BUMA.1121.00076,1,1707750,1750531,-,42781
43,BUMA.1121.00106,1,3336333,3379064,+,42731
43,BUMA.1121.00001,1,432563,475332,-,42769
43,BUMA.1121.00107,1,3506851,3549595,+,42744
43,BUMA.1121.00104,1,1639337,1682125,-,42788
43,BUMA.1121.00099,1,2809866,2852618,-,42752
43,BUMA.1121.00098,1,2227368,2270123,+,42755
43,BUMA.1121.00111,1,3759111,3801952,+,42841
43,BUMA.1121.00109,1,2294194,2336961,-,42767
43,BUMA.1121.00097,1,319917,362707,-,42790
43,BUMA.1121.00094,1,3553135,3595969,+,42834
43,BUMA.1121.00095,1,2074325,2117026,-,42701
43,BUMA.1121.00005,1,3966042,4008777,-,42735
43,BUMA.1121.00101,1,2839046,2881804,-,42758
43,BUMA.1121.00065,1,3630548,3673291,+,42743
43,BUMA.1121.00100,1,1680387,1723060,-,42673
43,BUMA.1121.00105,1,1594128,1636875,-,42747
43,BUMA.1121.00029,1,1306529,1349341,-,42812
43,BUMA.1121.00066,1,3480353,3523074,+,42721
43,BUMA.1121.00031,1,925978,968831,+,42853
43,BUMA.1121.00108,1,572090,614819,+,42729
43,BUMA.1121.00023,1,1907170,1950045,+,42875
43,BUMA.1121.00035,1,619084,661889,+,42805
43,BUMA.1121.00041,1,823535,866256,+,42721
42,BUMA.1121.00057,1,653658,674218,+,20560
42,BUMA.1121.00058,1,932656,953108,-,20452
42,BUMA.1121.00045,1,499376,519846,-,20470
42,BUMA.1121.00051,1,3515992,3536507,+,20515
42,BUMA.1121.00068,1,2341418,2361966,+,20548
42,BUMA.1121.00061,1,3471380,3491915,+,20535
42,BUMA.1121.00060,1,2744616,2765086,-,20470
42,BUMA.1121.00064,1,3550791,3571326,+,20535
42,BUMA.1121.00016,1,1666041,1686530,+,20489
42,BUMA.1121.00003,1,2083325,2103907,+,20582
42,BUMA.1121.00055,1,3229049,3249451,+,20402
42,BUMA.1121.00011,1,2044711,2065247,-,20536
42,BUMA.1121.00037,1,2184130,2204596,+,20466
42,BUMA.1121.00009,1,1991773,2012323,-,20550
42,BUMA.1121.00069,1,3454824,3475309,+,20485
42,BUMA.1121.00088,1,378972,399402,+,20430
42,BUMA.1121.00092,1,217495,237896,-,20401
42,BUMA.1121.00070,1,3442433,3462961,+,20528
42,BUMA.1121.00093,1,295940,316341,+,20401
42,BUMA.1121.00063,1,3468162,3488697,+,20535
42,BUMA.1121.00033,1,1767051,1787635,+,20584
42,BUMA.1121.00018,1,27802,48345,+,20543
42,BUMA.1121.00080,1,3564726,3585234,+,20508
42,BUMA.1121.00027,1,1737016,1757555,+,20539
42,BUMA.1121.00053,1,3309629,3330210,+,20581
42,BUMA.1121.00059,1,2793650,2814158,+,20508
42,BUMA.1121.00043,1,3682143,3702697,+,20554
42,BUMA.1121.00056,1,402630,423075,-,20445
42,BUMA.1121.00112,1,3507855,3528394,-,20539
42,BUMA.1121.00091,1,925039,945586,-,20547
42,BUMA.1121.00047,1,3443843,3464358,-,20515
42,BUMA.1121.00067,1,856758,877171,-,20413
42,BUMA.1121.00110,1,1227843,1248357,-,20514
42,BUMA.1121.00074,2,570603,591016,+,20413
42,BUMA.1121.00073,1,3469851,3490373,+,20522
42,BUMA.1121.00072,1,3456000,3476535,+,20535
42,BUMA.1121.00077,1,2234972,2255486,+,20514
42,BUMA.1121.00082,1,3653300,3673835,+,20535
42,BUMA.1121.00062,1,990687,1011132,-,20445
42,BUMA.1121.00007,1,470126,490656,-,20530
42,BUMA.1121.00025,1,3211525,3232068,-,20543
42,BUMA.1121.00021,1,162221,182787,+,20566
42,BUMA.1121.00103,1,781529,801968,-,20439
42,BUMA.1121.00096,1,3711962,3732638,-,20676
42,BUMA.1121.00079,1,3616526,3636967,+,20441
42,BUMA.1121.00039,1,3699027,3719602,+,20575
42,BUMA.1121.00083,1,2105536,2126071,-,20535
42,BUMA.1121.00084,1,3911464,3931889,+,20425
42,BUMA.1121.00049,1,2255508,2275960,-,20452
42,BUMA.1121.00089,1,3503857,3524302,+,20445
42,BUMA.1121.00014,1,3323842,3344309,-,20467
42,BUMA.1121.00090,1,1625033,1645533,+,20500
42,BUMA.1121.00071,1,3474016,3494540,+,20524
42,BUMA.1121.00078,1,2435270,2455787,-,20517
42,BUMA.1121.00102,1,1727805,1748340,-,20535
42,BUMA.1121.00075,1,3040577,3061093,+,20516
42,BUMA.1121.00012,1,2297774,2318256,+,20482
42,BUMA.1121.00076,1,1751178,1771694,-,20516
42,BUMA.1121.00106,1,3315224,3335689,+,20465
42,BUMA.1121.00001,1,477574,498135,-,20561
42,BUMA.1121.00107,1,3484114,3504612,+,20498
42,BUMA.1121.00104,1,1682770,1703214,-,20444
42,BUMA.1121.00099,1,2853265,2873796,-,20531
42,BUMA.1121.00098,1,2206261,2226722,+,20461
42,BUMA.1121.00111,1,3737942,3758465,+,20523
42,BUMA.1121.00109,1,2337608,2358179,-,20571
42,BUMA.1121.00097,1,363354,383939,-,20585
42,BUMA.1121.00094,1,3532044,3552489,+,20445
42,BUMA.1121.00095,1,2119267,2139776,-,20509
42,BUMA.1121.00005,1,4009424,4030033,-,20609
42,BUMA.1121.00101,1,2882451,2902968,-,20517
42,BUMA.1121.00065,1,3609351,3629902,+,20551
42,BUMA.1121.00100,1,1723707,1744190,-,20483
42,BUMA.1121.00105,1,1637522,1658080,-,20558
42,BUMA.1121.00029,1,1351583,1372126,-,20543
42,BUMA.1121.00066,1,3459185,3479707,+,20522
42,BUMA.1121.00031,1,904870,925330,+,20460
42,BUMA.1121.00108,1,550939,571444,+,20505
42,BUMA.1121.00023,1,1884431,1904929,+,20498
42,BUMA.1121.00035,1,596286,616843,+,20557
42,BUMA.1121.00041,1,802337,822891,+,20554
41,BUMA.1121.00057,1,629635,652556,+,22921
41,BUMA.1121.00058,1,954209,977134,-,22925
41,BUMA.1121.00045,1,520947,543896,-,22949
41,BUMA.1121.00051,1,3491990,3514890,+,22900
41,BUMA.1121.00068,1,2317401,2340316,+,22915
41,BUMA.1121.00061,1,3447349,3470278,+,22929
41,BUMA.1121.00060,1,2766187,2789136,-,22949
41,BUMA.1121.00064,1,3526752,3549689,+,22937
41,BUMA.1121.00016,1,1638047,1660986,+,22939
41,BUMA.1121.00003,1,2059281,2082223,+,22942
41,BUMA.1121.00055,1,3205054,3227947,+,22893
41,BUMA.1121.00011,1,2066348,2089279,-,22931
41,BUMA.1121.00037,1,2160115,2183028,+,22913
41,BUMA.1121.00009,1,2013424,2036348,-,22924
41,BUMA.1121.00069,1,3430841,3453722,+,22881
41,BUMA.1121.00088,1,354965,377870,+,22905
41,BUMA.1121.00092,1,238999,261926,-,22927
41,BUMA.1121.00070,1,3418415,3441331,+,22916
41,BUMA.1121.00093,1,271910,294836,+,22926
41,BUMA.1121.00063,1,3444158,3467060,+,22902
41,BUMA.1121.00033,1,1739085,1761997,+,22912
41,BUMA.1121.00018,1,3779,26700,+,22921
41,BUMA.1121.00080,1,3540701,3563624,+,22923
41,BUMA.1121.00027,1,1712993,1735914,+,22921
41,BUMA.1121.00053,1,3285559,3308527,+,22968
41,BUMA.1121.00059,1,2769627,2792548,+,22921
41,BUMA.1121.00043,1,3658136,3681041,+,22905
41,BUMA.1121.00056,1,424176,447085,-,22909
41,BUMA.1121.00112,1,3529495,3552399,-,22904
41,BUMA.1121.00091,1,946687,969562,-,22875
41,BUMA.1121.00047,1,3465459,3488368,-,22909
41,BUMA.1121.00067,1,878272,901210,-,22938
41,BUMA.1121.00110,1,1249458,1272423,-,22965
41,BUMA.1121.00074,2,546565,569501,+,22936
41,BUMA.1121.00073,1,3445833,3468749,+,22916
41,BUMA.1121.00072,1,3431974,3454898,+,22924
41,BUMA.1121.00077,1,2210899,2233871,+,22972
41,BUMA.1121.00082,1,3629269,3652198,+,22929
41,BUMA.1121.00062,1,1012233,1035146,-,22913
41,BUMA.1121.00007,1,491757,514678,-,22921
41,BUMA.1121.00025,1,3233169,3256091,-,22922
41,BUMA.1121.00021,1,138163,161119,+,22956
41,BUMA.1121.00103,1,804704,827659,-,22955
41,BUMA.1121.00096,1,3759251,3782168,-,22917
41,BUMA.1121.00079,1,3574154,3597095,+,22941
41,BUMA.1121.00039,1,3669694,3692638,+,22944
41,BUMA.1121.00083,1,2127172,2150102,-,22930
41,BUMA.1121.00084,1,3887451,3910362,+,22911
41,BUMA.1121.00049,1,2277061,2300007,-,22946
41,BUMA.1121.00089,1,3479847,3502755,+,22908
41,BUMA.1121.00014,1,3345410,3368315,-,22905
41,BUMA.1121.00090,1,1597044,1619978,+,22934
41,BUMA.1121.00071,1,3449996,3472914,+,22918
41,BUMA.1121.00078,1,2460841,2483743,-,22902
41,BUMA.1121.00102,1,1749441,1772336,-,22895
41,BUMA.1121.00075,1,3016583,3039475,+,22892
41,BUMA.1121.00012,1,2273753,2296688,+,22935
41,BUMA.1121.00076,1,1772795,1795688,-,22893
41,BUMA.1121.00106,1,3274096,3297033,+,22937
41,BUMA.1121.00001,1,505678,528579,-,22901
41,BUMA.1121.00107,1,3460076,3483012,+,22936
41,BUMA.1121.00104,1,1704315,1727276,-,22961
41,BUMA.1121.00099,1,2874897,2897826,-,22929
41,BUMA.1121.00098,1,2182239,2205159,+,22920
41,BUMA.1121.00111,1,3709956,3732887,+,22931
41,BUMA.1121.00109,1,2362299,2385223,-,22924
41,BUMA.1121.00097,1,385040,407941,-,22901
41,BUMA.1121.00094,1,3508036,3530942,+,22906
41,BUMA.1121.00095,1,2140877,2163782,-,22905
41,BUMA.1121.00005,1,4031134,4054066,-,22932
41,BUMA.1121.00101,1,2904069,2926982,-,22913
41,BUMA.1121.00065,1,3585368,3608249,+,22881
41,BUMA.1121.00100,1,1745291,1768175,-,22884
41,BUMA.1121.00105,1,1659181,1682117,-,22936
41,BUMA.1121.00029,1,1379669,1402528,-,22859
41,BUMA.1121.00066,1,3435169,3458083,+,22914
41,BUMA.1121.00031,1,871600,894535,+,22935
41,BUMA.1121.00108,1,526908,549837,+,22929
41,BUMA.1121.00023,1,1860401,1883329,+,22928
41,BUMA.1121.00035,1,564572,587448,+,22876
41,BUMA.1121.00041,1,778322,801235,+,22913
40,BUMA.1121.00057,1,597657,619387,+,21730
40,BUMA.1121.00058,1,989868,1011598,-,21730
40,BUMA.1121.00045,1,554144,575871,-,21727
40,BUMA.1121.00051,1,3458381,3480111,+,21730
40,BUMA.1121.00068,1,2285384,2307114,+,21730
40,BUMA.1121.00061,1,3415370,3437101,+,21731
40,BUMA.1121.00060,1,2799385,2821112,-,21727
40,BUMA.1121.00064,1,3493523,3515253,+,21730
40,BUMA.1121.00016,1,1606079,1627809,+,21730
40,BUMA.1121.00003,1,2027265,2048995,+,21730
40,BUMA.1121.00055,1,3171840,3193571,+,21731
40,BUMA.1121.00011,1,2099524,2121254,-,21730
40,BUMA.1121.00037,1,2126909,2149875,+,22966
40,BUMA.1121.00009,1,2046601,2068331,-,21730
40,BUMA.1121.00069,1,3398914,3420645,+,21731
40,BUMA.1121.00088,1,322947,344678,+,21731
40,BUMA.1121.00092,1,272214,293944,-,21730
40,BUMA.1121.00074,1,356069,377799,-,21730
40,BUMA.1121.00070,1,3386436,3408167,+,21731
40,BUMA.1121.00093,1,239894,261624,+,21730
40,BUMA.1121.00063,1,3412179,3433910,+,21731
40,BUMA.1121.00033,1,1707117,1728846,+,21729
40,BUMA.1121.00018,1,4121685,4143415,+,21730
40,BUMA.1121.00080,1,3507092,3528822,+,21730
40,BUMA.1121.00027,1,1681018,1702747,+,21729
40,BUMA.1121.00053,1,3253616,3275322,+,21706
40,BUMA.1121.00059,1,2737649,2759379,+,21730
40,BUMA.1121.00043,1,3626165,3647895,+,21730
40,BUMA.1121.00056,1,458964,480694,-,21730
40,BUMA.1121.00112,1,3562648,3584378,-,21730
40,BUMA.1121.00091,1,979824,1001554,-,21730
40,BUMA.1121.00047,1,3500208,3521938,-,21730
40,BUMA.1121.00067,1,911506,933236,-,21730
40,BUMA.1121.00110,1,1282710,1304452,-,21742
40,BUMA.1121.00073,1,3413854,3435585,+,21731
40,BUMA.1121.00072,1,3400164,3421883,+,21719
40,BUMA.1121.00077,1,2178864,2200606,+,21742
40,BUMA.1121.00082,1,3597290,3619021,+,21731
40,BUMA.1121.00062,1,1045405,1067132,-,21727
40,BUMA.1121.00007,1,524927,546657,-,21730
40,BUMA.1121.00025,1,3266331,3288061,-,21730
40,BUMA.1121.00021,1,104598,126328,+,21730
40,BUMA.1121.00103,1,837908,859637,-,21729
40,BUMA.1121.00096,1,3792424,3814154,-,21730
40,BUMA.1121.00079,1,3540545,3562275,+,21730
40,BUMA.1121.00039,1,3637723,3659453,+,21730
40,BUMA.1121.00083,1,2160350,2182081,-,21731
40,BUMA.1121.00084,1,3855435,3877165,+,21730
40,BUMA.1121.00049,1,2310293,2332023,-,21730
40,BUMA.1121.00089,1,3446238,3467968,+,21730
40,BUMA.1121.00014,1,3378555,3400285,-,21730
40,BUMA.1121.00090,1,1565078,1586808,+,21730
40,BUMA.1121.00071,1,3418029,3439748,+,21719
40,BUMA.1121.00078,1,2493988,2515718,-,21730
40,BUMA.1121.00102,1,1782585,1804291,-,21706
40,BUMA.1121.00075,1,2984565,3006295,+,21730
40,BUMA.1121.00012,1,2241783,2263513,+,21730
40,BUMA.1121.00076,1,1805976,1827706,-,21730
40,BUMA.1121.00106,1,3242080,3263810,+,21730
40,BUMA.1121.00001,1,538819,560549,-,21730
40,BUMA.1121.00107,1,3428058,3449788,+,21730
40,BUMA.1121.00104,1,1738165,1759895,-,21730
40,BUMA.1121.00099,1,2908071,2929801,-,21730
40,BUMA.1121.00098,1,2148593,2170323,+,21730
40,BUMA.1121.00111,1,3677986,3699716,+,21730
40,BUMA.1121.00109,1,2395523,2417265,-,21742
40,BUMA.1121.00097,1,419462,441192,-,21730
40,BUMA.1121.00094,1,3474426,3496157,+,21731
40,BUMA.1121.00095,1,2174029,2195759,-,21730
40,BUMA.1121.00005,1,2245105,2266811,+,21706
40,BUMA.1121.00101,1,2937253,2958983,-,21730
40,BUMA.1121.00065,1,3553414,3575120,+,21706
40,BUMA.1121.00100,1,1778475,1800204,-,21729
40,BUMA.1121.00105,1,1692403,1714133,-,21730
40,BUMA.1121.00029,1,1412768,1434498,-,21730
40,BUMA.1121.00066,1,3403200,3424921,+,21721
40,BUMA.1121.00031,1,839630,861360,+,21730
40,BUMA.1121.00108,1,494932,516661,+,21729
40,BUMA.1121.00023,1,1827195,1848925,+,21730
40,BUMA.1121.00035,1,532601,554331,+,21730
40,BUMA.1121.00041,1,746368,768074,+,21706
39,BUMA.1121.00057,1,583675,597655,+,13980
39,BUMA.1121.00058,1,1011599,1025610,-,14011
39,BUMA.1121.00045,1,575874,589899,-,14025
39,BUMA.1121.00051,1,3444321,3458379,+,14058
39,BUMA.1121.00068,1,2269751,2283753,+,14002
39,BUMA.1121.00061,1,3401453,3415368,+,13915
39,BUMA.1121.00060,1,2821115,2835152,-,14037
39,BUMA.1121.00064,1,3479541,3493521,+,13980
39,BUMA.1121.00016,1,1592167,1606077,+,13910
39,BUMA.1121.00003,1,2013353,2027263,+,13910
39,BUMA.1121.00055,1,3157873,3171838,+,13965
39,BUMA.1121.00011,1,2121255,2135237,-,13982
39,BUMA.1121.00037,1,2112988,2126907,+,13919
39,BUMA.1121.00009,1,2068332,2082257,-,13925
39,BUMA.1121.00069,1,3384996,3398912,+,13916
39,BUMA.1121.00088,1,308935,322945,+,14010
39,BUMA.1121.00092,1,293945,307938,-,13993
39,BUMA.1121.00074,1,377800,391781,-,13981
39,BUMA.1121.00070,1,3372518,3386434,+,13916
39,BUMA.1121.00093,1,225894,239892,+,13998
39,BUMA.1121.00063,1,3398261,3412177,+,13916
39,BUMA.1121.00033,1,1693198,1707115,+,13917
39,BUMA.1121.00018,1,4107764,4121683,+,13919
39,BUMA.1121.00080,1,3493122,3507090,+,13968
39,BUMA.1121.00027,1,1667091,1681016,+,13925
39,BUMA.1121.00053,1,3239700,3253614,+,13914
39,BUMA.1121.00059,1,2723631,2737647,+,14016
39,BUMA.1121.00043,1,3610644,3624537,+,13893
39,BUMA.1121.00056,1,480695,494736,-,14041
39,BUMA.1121.00112,1,3584379,3598300,-,13921
39,BUMA.1121.00091,1,1001555,1015542,-,13987
39,BUMA.1121.00047,1,3521939,3535980,-,14041
39,BUMA.1121.00067,1,933237,947206,-,13969
39,BUMA.1121.00110,1,1304453,1318374,-,13921
39,BUMA.1121.00073,1,3399936,3413852,+,13916
39,BUMA.1121.00072,1,3386246,3400162,+,13916
39,BUMA.1121.00077,1,2164942,2178862,+,13920
39,BUMA.1121.00082,1,3583372,3597288,+,13916
39,BUMA.1121.00062,1,1067133,1081162,-,14029
39,BUMA.1121.00007,1,546658,560650,-,13992
39,BUMA.1121.00025,1,3288062,3301982,-,13920
39,BUMA.1121.00021,1,90676,104596,+,13920
39,BUMA.1121.00103,1,859638,873602,-,13964
39,BUMA.1121.00096,1,3814155,3828155,-,14000
39,BUMA.1121.00079,1,3526497,3540543,+,14046
39,BUMA.1121.00039,1,3623802,3637721,+,13919
39,BUMA.1121.00083,1,2182082,2195999,-,13917
39,BUMA.1121.00084,1,3841428,3855433,+,14005
39,BUMA.1121.00049,1,2332024,2346011,-,13987
39,BUMA.1121.00089,1,3432214,3446236,+,14022
39,BUMA.1121.00014,1,3400286,3414200,-,13914
39,BUMA.1121.00090,1,1551157,1565076,+,13919
39,BUMA.1121.00071,1,3404111,3418027,+,13916
39,BUMA.1121.00078,1,2515719,2529621,-,13902
39,BUMA.1121.00102,1,1804292,1818333,-,14041
39,BUMA.1121.00075,1,2970637,2984563,+,13926
39,BUMA.1121.00012,1,2227862,2241781,+,13919
39,BUMA.1121.00076,1,1827707,1841646,-,13939
39,BUMA.1121.00106,1,3228157,3242078,+,13921
39,BUMA.1121.00001,1,560550,574470,-,13920
39,BUMA.1121.00107,1,3414129,3428056,+,13927
39,BUMA.1121.00104,1,1759896,1773922,-,14026
39,BUMA.1121.00099,1,2929802,2943945,-,14143
39,BUMA.1121.00098,1,2134664,2148591,+,13927
39,BUMA.1121.00111,1,3664065,3677984,+,13919
39,BUMA.1121.00109,1,2417266,2431309,-,14043
39,BUMA.1121.00097,1,442812,456702,-,13890
39,BUMA.1121.00094,1,3460402,3474424,+,14022
39,BUMA.1121.00095,1,2197387,2211314,-,13927
39,BUMA.1121.00005,1,2231189,2245103,+,13914
39,BUMA.1121.00101,1,2958984,2972932,-,13948
39,BUMA.1121.00065,1,3539444,3553412,+,13968
39,BUMA.1121.00100,1,1800205,1814162,-,13957
39,BUMA.1121.00105,1,1714134,1728083,-,13949
39,BUMA.1121.00029,1,1434499,1448419,-,13920
39,BUMA.1121.00066,1,3389282,3403198,+,13916
39,BUMA.1121.00031,1,825716,839628,+,13912
39,BUMA.1121.00108,1,480902,494930,+,14028
39,BUMA.1121.00023,1,1813274,1827193,+,13919
39,BUMA.1121.00035,1,518678,532599,+,13921
39,BUMA.1121.00041,1,732417,746366,+,13949
38,BUMA.1121.00057,1,579217,583653,+,4436
38,BUMA.1121.00058,1,1025632,1030069,-,4437
38,BUMA.1121.00045,1,589921,594355,-,4434
38,BUMA.1121.00051,1,3439862,3444299,+,4437
38,BUMA.1121.00068,1,2265292,2269729,+,4437
38,BUMA.1121.00061,1,3396995,3401431,+,4436
38,BUMA.1121.00060,1,2835174,2839608,-,4434
38,BUMA.1121.00064,1,3475082,3479519,+,4437
38,BUMA.1121.00016,1,1587709,1592145,+,4436
38,BUMA.1121.00003,1,1990941,1995378,+,4437
38,BUMA.1121.00055,1,3153413,3157851,+,4438
38,BUMA.1121.00011,1,2135259,2139696,-,4437
38,BUMA.1121.00037,1,2108529,2112966,+,4437
38,BUMA.1121.00009,1,2082279,2086716,-,4437
38,BUMA.1121.00069,1,3380538,3384974,+,4436
38,BUMA.1121.00088,1,304476,308913,+,4437
38,BUMA.1121.00092,1,307960,312397,-,4437
38,BUMA.1121.00074,1,391803,396240,-,4437
38,BUMA.1121.00070,1,3368060,3372496,+,4436
38,BUMA.1121.00093,1,221435,225872,+,4437
38,BUMA.1121.00063,1,3393803,3398239,+,4436
38,BUMA.1121.00033,1,1688739,1693176,+,4437
38,BUMA.1121.00018,1,4103305,4107742,+,4437
38,BUMA.1121.00080,1,3488662,3493100,+,4438
38,BUMA.1121.00027,1,1662633,1667069,+,4436
38,BUMA.1121.00053,1,3235241,3239678,+,4437
38,BUMA.1121.00059,1,2719172,2723609,+,4437
38,BUMA.1121.00043,1,3606184,3610622,+,4438
38,BUMA.1121.00056,1,494758,499196,-,4438
38,BUMA.1121.00112,1,3598322,3602758,-,4436
38,BUMA.1121.00091,1,1015564,1020001,-,4437
38,BUMA.1121.00047,1,3536002,3540440,-,4438
38,BUMA.1121.00067,1,947228,951665,-,4437
38,BUMA.1121.00110,1,1342862,1347339,-,4477
38,BUMA.1121.00073,1,3395478,3399914,+,4436
38,BUMA.1121.00072,1,3381788,3386224,+,4436
38,BUMA.1121.00077,1,2135980,2140404,+,4424
38,BUMA.1121.00082,1,3578914,3583350,+,4436
38,BUMA.1121.00062,1,1081184,1085621,-,4437
38,BUMA.1121.00007,1,582614,587051,-,4437
38,BUMA.1121.00025,1,3302004,3306441,-,4437
38,BUMA.1121.00021,1,86216,90654,+,4438
38,BUMA.1121.00103,1,890730,895167,-,4437
38,BUMA.1121.00096,1,3828177,3832614,-,4437
38,BUMA.1121.00079,1,3522037,3526475,+,4438
38,BUMA.1121.00039,1,3619343,3623780,+,4437
38,BUMA.1121.00083,1,2196021,2200456,-,4435
38,BUMA.1121.00084,1,3836969,3841406,+,4437
38,BUMA.1121.00049,1,2346033,2350470,-,4437
38,BUMA.1121.00089,1,3427754,3432192,+,4438
38,BUMA.1121.00014,1,3445171,3449608,-,4437
38,BUMA.1121.00090,1,1546698,1551135,+,4437
38,BUMA.1121.00071,1,3399656,3404089,+,4433
38,BUMA.1121.00078,1,2529643,2534081,-,4438
38,BUMA.1121.00102,1,1818355,1822792,-,4437
38,BUMA.1121.00075,1,2966181,2970615,+,4434
38,BUMA.1121.00012,1,2223403,2227840,+,4437
38,BUMA.1121.00076,1,1841668,1846102,-,4434
38,BUMA.1121.00106,1,3223698,3228135,+,4437
38,BUMA.1121.00001,1,574492,578929,-,4437
38,BUMA.1121.00107,1,3409670,3414107,+,4437
38,BUMA.1121.00104,1,1773944,1778381,-,4437
38,BUMA.1121.00099,1,2943967,2948404,-,4437
38,BUMA.1121.00098,1,2130208,2134642,+,4434
38,BUMA.1121.00111,1,3659606,3664043,+,4437
38,BUMA.1121.00109,1,2431331,2435768,-,4437
38,BUMA.1121.00097,1,456724,461161,-,4437
38,BUMA.1121.00094,1,3455942,3460380,+,4438
38,BUMA.1121.00095,1,2211336,2215773,-,4437
38,BUMA.1121.00005,1,2226731,2231167,+,4436
38,BUMA.1121.00101,1,2972954,2977392,-,4438
38,BUMA.1121.00065,1,3534985,3539422,+,4437
38,BUMA.1121.00100,1,1814184,1818621,-,4437
38,BUMA.1121.00105,1,1728105,1732542,-,4437
38,BUMA.1121.00029,1,1448441,1452878,-,4437
38,BUMA.1121.00066,1,3384824,3389260,+,4436
38,BUMA.1121.00031,1,800232,804669,+,4437
38,BUMA.1121.00108,1,476447,480880,+,4433
38,BUMA.1121.00023,1,1808815,1813252,+,4437
38,BUMA.1121.00035,1,514219,518656,+,4437
38,BUMA.1121.00041,1,727958,732395,+,4437
37,BUMA.1121.00057,1,564023,577634,+,13611
37,BUMA.1121.00058,1,1030070,1043666,-,13596
37,BUMA.1121.00045,1,595934,609545,-,13611
37,BUMA.1121.00051,1,3426267,3439860,+,13593
37,BUMA.1121.00068,1,2251697,2265290,+,13593
37,BUMA.1121.00061,1,3381813,3395414,+,13601
37,BUMA.1121.00060,1,2841187,2854798,-,13611
37,BUMA.1121.00064,1,3461485,3475080,+,13595
37,BUMA.1121.00016,1,1574114,1587707,+,13593
37,BUMA.1121.00003,1,1977334,1990939,+,13605
37,BUMA.1121.00055,1,3139816,3153411,+,13595
37,BUMA.1121.00011,1,2139697,2153292,-,13595
37,BUMA.1121.00037,1,2094933,2108527,+,13594
37,BUMA.1121.00009,1,2086717,2100313,-,13596
37,BUMA.1121.00069,1,3365358,3378955,+,13597
37,BUMA.1121.00088,1,290880,304474,+,13594
37,BUMA.1121.00092,1,312398,325993,-,13595
37,BUMA.1121.00074,1,396241,409837,-,13596
37,BUMA.1121.00070,1,3352885,3366477,+,13592
37,BUMA.1121.00093,1,207838,221433,+,13595
37,BUMA.1121.00063,1,3378623,3392220,+,13597
37,BUMA.1121.00033,1,1675147,1688737,+,13590
37,BUMA.1121.00018,1,4089709,4103303,+,13594
37,BUMA.1121.00080,1,3475066,3488660,+,13594
37,BUMA.1121.00027,1,1647439,1661050,+,13611
37,BUMA.1121.00053,1,3221644,3235239,+,13595
37,BUMA.1121.00059,1,2705576,2719170,+,13594
37,BUMA.1121.00043,1,3592588,3606182,+,13594
37,BUMA.1121.00056,1,499197,512792,-,13595
37,BUMA.1121.00112,1,3602759,3616354,-,13595
37,BUMA.1121.00091,1,1020002,1033597,-,13595
37,BUMA.1121.00047,1,3540441,3554036,-,13595
37,BUMA.1121.00067,1,951666,965262,-,13596
37,BUMA.1121.00110,1,1347340,1360936,-,13596
37,BUMA.1121.00073,1,3380299,3393895,+,13596
37,BUMA.1121.00072,1,3366594,3380205,+,13611
37,BUMA.1121.00077,1,2122384,2135978,+,13594
37,BUMA.1121.00082,1,3563720,3577331,+,13611
37,BUMA.1121.00062,1,1085622,1099217,-,13595
37,BUMA.1121.00007,1,587052,600650,-,13598
37,BUMA.1121.00025,1,3306442,3320037,-,13595
37,BUMA.1121.00021,1,72620,86214,+,13594
37,BUMA.1121.00103,1,895168,908759,-,13591
37,BUMA.1121.00096,1,3832615,3846211,-,13596
37,BUMA.1121.00079,1,3508442,3522035,+,13593
37,BUMA.1121.00039,1,3605747,3619341,+,13594
37,BUMA.1121.00083,1,2202040,2215651,-,13611
37,BUMA.1121.00084,1,3823373,3836967,+,13594
37,BUMA.1121.00049,1,2350471,2364067,-,13596
37,BUMA.1121.00089,1,3414158,3427752,+,13594
37,BUMA.1121.00014,1,3449609,3463203,-,13594
37,BUMA.1121.00090,1,1533102,1546696,+,13594
37,BUMA.1121.00071,1,3384459,3398070,+,13611
37,BUMA.1121.00078,1,2534082,2547676,-,13594
37,BUMA.1121.00102,1,1822793,1836389,-,13596
37,BUMA.1121.00075,1,2950992,2964603,+,13611
37,BUMA.1121.00012,1,2209810,2223401,+,13591
37,BUMA.1121.00076,1,1847681,1861293,-,13612
37,BUMA.1121.00106,1,3210100,3223696,+,13596
37,BUMA.1121.00001,1,578930,592525,-,13595
37,BUMA.1121.00107,1,3396072,3409668,+,13596
37,BUMA.1121.00104,1,1778382,1791978,-,13596
37,BUMA.1121.00099,1,2948405,2962000,-,13595
37,BUMA.1121.00098,1,2115017,2128629,+,13612
37,BUMA.1121.00111,1,3646010,3659604,+,13594
37,BUMA.1121.00109,1,2435769,2449365,-,13596
37,BUMA.1121.00097,1,461162,474758,-,13596
37,BUMA.1121.00094,1,3442346,3455940,+,13594
37,BUMA.1121.00095,1,2215774,2229370,-,13596
37,BUMA.1121.00005,1,2213134,2226729,+,13595
37,BUMA.1121.00101,1,2977393,2990989,-,13596
37,BUMA.1121.00065,1,3521389,3534983,+,13594
37,BUMA.1121.00100,1,1818622,1832228,-,13606
37,BUMA.1121.00105,1,1732543,1746138,-,13595
37,BUMA.1121.00029,1,1452879,1466474,-,13595
37,BUMA.1121.00066,1,3369630,3383241,+,13611
37,BUMA.1121.00031,1,786637,800230,+,13593
37,BUMA.1121.00108,1,461258,474867,+,13609
37,BUMA.1121.00023,1,1795219,1808813,+,13594
37,BUMA.1121.00035,1,500623,514217,+,13594
37,BUMA.1121.00041,1,713049,727956,+,14907
36,BUMA.1121.00057,1,516379,563202,+,46823
36,BUMA.1121.00058,1,1044487,1091353,-,46866
36,BUMA.1121.00045,1,610350,657247,-,46897
36,BUMA.1121.00051,1,3378602,3425446,+,46844
36,BUMA.1121.00068,1,2204014,2250876,+,46862
36,BUMA.1121.00061,1,3334183,3380992,+,46809
36,BUMA.1121.00060,1,2855603,2902507,-,46904
36,BUMA.1121.00064,1,3413779,3460649,+,46870
36,BUMA.1121.00016,1,1526452,1573293,+,46841
36,BUMA.1121.00003,1,1929608,1976513,+,46905
36,BUMA.1121.00055,1,3090860,3138995,+,48135
36,BUMA.1121.00011,1,2154113,2200956,-,46843
36,BUMA.1121.00037,1,2047312,2094112,+,46800
36,BUMA.1121.00009,1,2101134,2147994,-,46860
36,BUMA.1121.00069,1,3317728,3364537,+,46809
36,BUMA.1121.00088,1,243270,290059,+,46789
36,BUMA.1121.00092,1,326829,373702,-,46873
36,BUMA.1121.00074,1,410658,457576,-,46918
36,BUMA.1121.00070,1,3305257,3352064,+,46807
36,BUMA.1121.00093,1,160128,207002,+,46874
36,BUMA.1121.00063,1,3330993,3377802,+,46809
36,BUMA.1121.00033,1,1627490,1674326,+,46836
36,BUMA.1121.00018,1,4042022,4088888,+,46866
36,BUMA.1121.00080,1,3427369,3474245,+,46876
36,BUMA.1121.00027,1,1599801,1646618,+,46817
36,BUMA.1121.00053,1,3174030,3220823,+,46793
36,BUMA.1121.00059,1,2657848,2704740,+,46892
36,BUMA.1121.00043,1,3544934,3591767,+,46833
36,BUMA.1121.00056,1,513613,560442,-,46829
36,BUMA.1121.00112,1,3617160,3664091,-,46931
36,BUMA.1121.00091,1,1034418,1081268,-,46850
36,BUMA.1121.00047,1,3554857,3601709,-,46852
36,BUMA.1121.00067,1,966083,1012996,-,46913
36,BUMA.1121.00110,1,1361757,1408627,-,46870
36,BUMA.1121.00073,1,3332672,3379478,+,46806
36,BUMA.1121.00072,1,3318966,3365775,+,46809
36,BUMA.1121.00077,1,2074693,2121563,+,46870
36,BUMA.1121.00082,1,3516090,3562899,+,46809
36,BUMA.1121.00062,1,1100038,1148275,-,48237
36,BUMA.1121.00007,1,602784,649713,-,46929
36,BUMA.1121.00025,1,3320858,3367716,-,46858
36,BUMA.1121.00021,1,24896,71799,+,46903
36,BUMA.1121.00103,1,909580,956437,-,46857
36,BUMA.1121.00096,1,3847032,3893878,-,46846
36,BUMA.1121.00079,1,3460716,3507621,+,46905
36,BUMA.1121.00039,1,3558053,3604926,+,46873
36,BUMA.1121.00083,1,2216472,2263280,-,46808
36,BUMA.1121.00084,1,3775770,3822552,+,46782
36,BUMA.1121.00049,1,2364858,2411712,-,46854
36,BUMA.1121.00089,1,3366507,3413337,+,46830
36,BUMA.1121.00014,1,3464024,3510883,-,46859
36,BUMA.1121.00090,1,1485429,1532296,+,46867
36,BUMA.1121.00071,1,3336829,3383638,+,46809
36,BUMA.1121.00078,1,2548498,2595392,-,46894
36,BUMA.1121.00102,1,1837135,1884073,-,46938
36,BUMA.1121.00075,1,2903320,2950171,+,46851
36,BUMA.1121.00012,1,2162143,2208989,+,46846
36,BUMA.1121.00076,1,1862114,1908972,-,46858
36,BUMA.1121.00106,1,3162431,3209279,+,46848
36,BUMA.1121.00001,1,593346,640194,-,46848
36,BUMA.1121.00107,1,3348405,3395251,+,46846
36,BUMA.1121.00104,1,1792814,1839700,-,46886
36,BUMA.1121.00099,1,2962821,3009687,-,46866
36,BUMA.1121.00098,1,2067364,2114196,+,46832
36,BUMA.1121.00111,1,3598350,3645189,+,46839
36,BUMA.1121.00109,1,2450186,2497019,-,46833
36,BUMA.1121.00097,1,475579,522410,-,46831
36,BUMA.1121.00094,1,3394697,3441526,+,46829
36,BUMA.1121.00095,1,2230176,2277031,-,46855
36,BUMA.1121.00005,1,2165447,2212313,+,46866
36,BUMA.1121.00101,1,2991810,3038733,-,46923
36,BUMA.1121.00065,1,3473720,3520568,+,46848
36,BUMA.1121.00100,1,1833063,1879900,-,46837
36,BUMA.1121.00105,1,1746959,1793806,-,46847
36,BUMA.1121.00029,1,1467295,1514106,-,46811
36,BUMA.1121.00066,1,3322000,3368809,+,46809
36,BUMA.1121.00031,1,738944,785816,+,46872
36,BUMA.1121.00108,1,413590,460437,+,46847
36,BUMA.1121.00023,1,1747552,1794398,+,46846
36,BUMA.1121.00035,1,452959,499802,+,46843
36,BUMA.1121.00041,1,665346,712228,+,46882
35,BUMA.1121.00057,1,504774,515153,+,10379
35,BUMA.1121.00058,1,1092579,1102962,-,10383
35,BUMA.1121.00045,1,658473,668856,-,10383
35,BUMA.1121.00051,1,3366994,3377376,+,10382
35,BUMA.1121.00068,1,2192406,2202788,+,10382
35,BUMA.1121.00061,1,3322578,3332957,+,10379
35,BUMA.1121.00060,1,2903733,2914116,-,10383
35,BUMA.1121.00064,1,3402174,3412553,+,10379
35,BUMA.1121.00016,1,1514838,1525226,+,10388
35,BUMA.1121.00003,1,1918008,1928382,+,10374
35,BUMA.1121.00055,1,3079237,3089634,+,10397
35,BUMA.1121.00011,1,2202182,2212560,-,10378
35,BUMA.1121.00037,1,2035698,2046086,+,10388
35,BUMA.1121.00009,1,2149220,2159613,-,10393
35,BUMA.1121.00069,1,3306123,3316502,+,10379
35,BUMA.1121.00088,1,231647,242044,+,10397
35,BUMA.1121.00092,1,374928,385320,-,10392
35,BUMA.1121.00074,1,458802,469182,-,10380
35,BUMA.1121.00070,1,3293652,3304031,+,10379
35,BUMA.1121.00093,1,148511,158902,+,10391
35,BUMA.1121.00063,1,3319388,3329767,+,10379
35,BUMA.1121.00033,1,1615870,1626264,+,10394
35,BUMA.1121.00018,1,4030408,4040796,+,10388
35,BUMA.1121.00080,1,3415778,3426143,+,10365
35,BUMA.1121.00027,1,1588196,1598575,+,10379
35,BUMA.1121.00053,1,3162422,3172804,+,10382
35,BUMA.1121.00059,1,2646231,2656622,+,10391
35,BUMA.1121.00043,1,3533321,3543708,+,10387
35,BUMA.1121.00056,1,561668,572050,-,10382
35,BUMA.1121.00112,1,3665317,3675700,-,10383
35,BUMA.1121.00091,1,1082494,1092869,-,10375
35,BUMA.1121.00047,1,3602935,3613318,-,10383
35,BUMA.1121.00067,1,1014222,1024588,-,10366
35,BUMA.1121.00110,1,1409853,1420234,-,10381
35,BUMA.1121.00073,1,3321067,3331446,+,10379
35,BUMA.1121.00072,1,3307361,3317740,+,10379
35,BUMA.1121.00077,1,2063087,2073467,+,10380
35,BUMA.1121.00082,1,3504485,3514864,+,10379
35,BUMA.1121.00062,1,1149501,1159899,-,10398
35,BUMA.1121.00007,1,650939,661331,-,10392
35,BUMA.1121.00025,1,3368942,3379332,-,10390
35,BUMA.1121.00021,1,13276,23670,+,10394
35,BUMA.1121.00103,1,957663,968044,-,10381
35,BUMA.1121.00096,1,3895104,3905502,-,10398
35,BUMA.1121.00079,1,3449108,3459490,+,10382
35,BUMA.1121.00039,1,3546439,3556827,+,10388
35,BUMA.1121.00083,1,2264506,2274886,-,10380
35,BUMA.1121.00084,1,3764147,3774544,+,10397
35,BUMA.1121.00049,1,2412938,2423321,-,10383
35,BUMA.1121.00089,1,3354900,3365281,+,10381
35,BUMA.1121.00014,1,3512109,3522504,-,10395
35,BUMA.1121.00090,1,1473815,1484203,+,10388
35,BUMA.1121.00071,1,3325224,3335603,+,10379
35,BUMA.1121.00078,1,2596618,2607001,-,10383
35,BUMA.1121.00102,1,1885299,1895659,-,10360
35,BUMA.1121.00075,1,2891697,2902094,+,10397
35,BUMA.1121.00012,1,2150529,2160917,+,10388
35,BUMA.1121.00076,1,1910198,1920596,-,10398
35,BUMA.1121.00106,1,3150814,3161205,+,10391
35,BUMA.1121.00001,1,641420,651809,-,10389
35,BUMA.1121.00107,1,3336797,3347179,+,10382
35,BUMA.1121.00104,1,1840926,1851309,-,10383
35,BUMA.1121.00099,1,3010913,3021305,-,10392
35,BUMA.1121.00098,1,2055750,2066138,+,10388
35,BUMA.1121.00111,1,3586736,3597124,+,10388
35,BUMA.1121.00109,1,2498245,2508628,-,10383
35,BUMA.1121.00097,1,523636,534032,-,10396
35,BUMA.1121.00094,1,3383090,3393471,+,10381
35,BUMA.1121.00095,1,2278257,2288659,-,10402
35,BUMA.1121.00005,1,2153830,2164221,+,10391
35,BUMA.1121.00101,1,3039959,3050342,-,10383
35,BUMA.1121.00065,1,3462115,3472494,+,10379
35,BUMA.1121.00100,1,1881126,1891503,-,10377
35,BUMA.1121.00105,1,1795032,1805424,-,10392
35,BUMA.1121.00029,1,1515332,1525721,-,10389
35,BUMA.1121.00066,1,3310395,3320774,+,10379
35,BUMA.1121.00031,1,727330,737718,+,10388
35,BUMA.1121.00108,1,401973,412364,+,10391
35,BUMA.1121.00023,1,1735938,1746326,+,10388
35,BUMA.1121.00035,1,441345,451733,+,10388
35,BUMA.1121.00041,1,653738,664120,+,10382
34,BUMA.1121.00057,1,498579,503925,+,5346
34,BUMA.1121.00058,1,1103896,1109217,-,5321
34,BUMA.1121.00045,1,669769,675088,-,5319
34,BUMA.1121.00051,1,3360692,3366039,+,5347
34,BUMA.1121.00068,1,2186162,2191508,+,5346
34,BUMA.1121.00061,1,3316379,3321725,+,5346
34,BUMA.1121.00060,1,2915029,2920348,-,5319
34,BUMA.1121.00064,1,3395967,3401313,+,5346
34,BUMA.1121.00016,1,1508579,1513925,+,5346
34,BUMA.1121.00003,1,1911758,1917104,+,5346
34,BUMA.1121.00055,1,3073024,3078370,+,5346
34,BUMA.1121.00011,1,2213431,2218750,-,5319
34,BUMA.1121.00037,1,2029377,2034723,+,5346
34,BUMA.1121.00009,1,2160527,2165836,-,5309
34,BUMA.1121.00069,1,3299922,3305268,+,5346
34,BUMA.1121.00088,1,225398,230744,+,5346
34,BUMA.1121.00092,1,386181,391500,-,5319
34,BUMA.1121.00074,1,470037,475356,-,5319
34,BUMA.1121.00070,1,3287451,3292797,+,5346
34,BUMA.1121.00093,1,142304,147650,+,5346
34,BUMA.1121.00063,1,3313191,3318537,+,5346
34,BUMA.1121.00033,1,1609511,1614857,+,5346
34,BUMA.1121.00018,1,4024154,4029500,+,5346
34,BUMA.1121.00080,1,3409519,3414865,+,5346
34,BUMA.1121.00027,1,1582001,1587347,+,5346
34,BUMA.1121.00053,1,3156186,3161530,+,5344
34,BUMA.1121.00059,1,2640013,2645359,+,5346
34,BUMA.1121.00043,1,3525711,3531057,+,5346
34,BUMA.1121.00056,1,572939,578259,-,5320
34,BUMA.1121.00112,1,3676669,3681988,-,5319
34,BUMA.1121.00091,1,1093742,1099061,-,5319
34,BUMA.1121.00047,1,3614509,3619559,-,5050
34,BUMA.1121.00067,1,1025495,1030816,-,5321
34,BUMA.1121.00110,1,1421114,1426433,-,5319
34,BUMA.1121.00073,1,3314866,3320212,+,5346
34,BUMA.1121.00072,1,3301160,3306506,+,5346
34,BUMA.1121.00077,1,2056863,2062207,+,5344
34,BUMA.1121.00082,1,3498284,3503630,+,5346
34,BUMA.1121.00062,1,1160778,1166097,-,5319
34,BUMA.1121.00007,1,662196,667505,-,5309
34,BUMA.1121.00025,1,3380240,3385559,-,5319
34,BUMA.1121.00021,1,6903,12249,+,5346
34,BUMA.1121.00103,1,968963,974272,-,5309
34,BUMA.1121.00096,1,3906421,3911740,-,5319
34,BUMA.1121.00079,1,3442848,3448195,+,5347
34,BUMA.1121.00039,1,3540143,3545489,+,5346
34,BUMA.1121.00083,1,2275741,2281060,-,5319
34,BUMA.1121.00084,1,3757918,3763261,+,5343
34,BUMA.1121.00049,1,2424228,2429544,-,5316
34,BUMA.1121.00089,1,3348664,3354011,+,5347
34,BUMA.1121.00014,1,3523426,3528735,-,5309
34,BUMA.1121.00090,1,1467548,1472894,+,5346
34,BUMA.1121.00071,1,3319023,3324369,+,5346
34,BUMA.1121.00078,1,2607907,2613213,-,5306
34,BUMA.1121.00102,1,1896502,1901821,-,5319
34,BUMA.1121.00075,1,2885425,2890771,+,5346
34,BUMA.1121.00012,1,2144269,2149615,+,5346
34,BUMA.1121.00076,1,1921534,1926853,-,5319
34,BUMA.1121.00106,1,3144607,3149953,+,5346
34,BUMA.1121.00001,1,652698,658017,-,5319
34,BUMA.1121.00107,1,3330566,3335912,+,5346
34,BUMA.1121.00104,1,1852246,1857565,-,5319
34,BUMA.1121.00099,1,3022151,3027470,-,5319
34,BUMA.1121.00098,1,2049594,2054903,+,5309
34,BUMA.1121.00111,1,3580399,3585736,+,5337
34,BUMA.1121.00109,1,2509468,2514786,-,5318
34,BUMA.1121.00097,1,534957,540269,-,5312
34,BUMA.1121.00094,1,3376854,3382201,+,5347
34,BUMA.1121.00095,1,2289560,2294879,-,5319
34,BUMA.1121.00005,1,2147629,2152975,+,5346
34,BUMA.1121.00101,1,3051280,3056599,-,5319
34,BUMA.1121.00065,1,3455878,3461224,+,5346
34,BUMA.1121.00100,1,1892358,1897677,-,5319
34,BUMA.1121.00105,1,1806351,1811670,-,5319
34,BUMA.1121.00029,1,1526612,1531931,-,5319
34,BUMA.1121.00066,1,3304194,3309540,+,5346
34,BUMA.1121.00031,1,721069,726415,+,5346
34,BUMA.1121.00108,1,395750,401096,+,5346
34,BUMA.1121.00023,1,1729678,1735024,+,5346
34,BUMA.1121.00035,1,435101,440447,+,5346
34,BUMA.1121.00041,1,647543,652889,+,5346
33,BUMA.1121.00057,1,491992,498527,+,6535
33,BUMA.1121.00058,1,1109296,1115830,-,6534
33,BUMA.1121.00045,1,675167,681701,-,6534
33,BUMA.1121.00051,1,3354105,3360640,+,6535
33,BUMA.1121.00068,1,2179575,2186110,+,6535
33,BUMA.1121.00061,1,3309792,3316327,+,6535
33,BUMA.1121.00060,1,2920427,2926961,-,6534
33,BUMA.1121.00064,1,3389380,3395915,+,6535
33,BUMA.1121.00016,1,1501992,1508527,+,6535
33,BUMA.1121.00003,1,1905171,1911706,+,6535
33,BUMA.1121.00055,1,3066437,3072972,+,6535
33,BUMA.1121.00011,1,2218802,2225336,-,6534
33,BUMA.1121.00037,1,2022790,2029325,+,6535
33,BUMA.1121.00009,1,2165925,2172459,-,6534
33,BUMA.1121.00069,1,3293335,3299870,+,6535
33,BUMA.1121.00088,1,218811,225346,+,6535
33,BUMA.1121.00092,1,391579,398113,-,6534
33,BUMA.1121.00074,1,475435,481969,-,6534
33,BUMA.1121.00070,1,3280864,3287399,+,6535
33,BUMA.1121.00093,1,135717,142252,+,6535
33,BUMA.1121.00063,1,3306604,3313139,+,6535
33,BUMA.1121.00033,1,1602925,1609460,+,6535
33,BUMA.1121.00018,1,4017568,4024102,+,6534
33,BUMA.1121.00080,1,3402932,3409467,+,6535
33,BUMA.1121.00027,1,1575414,1581949,+,6535
33,BUMA.1121.00053,1,3147999,3154534,+,6535
33,BUMA.1121.00059,1,2633426,2639961,+,6535
33,BUMA.1121.00043,1,3519124,3525659,+,6535
33,BUMA.1121.00056,1,578338,584872,-,6534
33,BUMA.1121.00112,1,3682067,3688601,-,6534
33,BUMA.1121.00091,1,1099140,1105674,-,6534
33,BUMA.1121.00047,1,3619648,3626182,-,6534
33,BUMA.1121.00067,1,1030895,1037429,-,6534
33,BUMA.1121.00110,1,1426512,1433046,-,6534
33,BUMA.1121.00073,1,3308279,3314814,+,6535
33,BUMA.1121.00072,1,3294573,3301108,+,6535
33,BUMA.1121.00077,1,2050276,2056811,+,6535
33,BUMA.1121.00082,1,3491697,3498232,+,6535
33,BUMA.1121.00062,1,1166176,1172710,-,6534
33,BUMA.1121.00007,1,667594,674148,-,6554
33,BUMA.1121.00025,1,3385638,3392171,-,6533
33,BUMA.1121.00021,1,316,6851,+,6535
33,BUMA.1121.00103,1,974361,980895,-,6534
33,BUMA.1121.00096,1,3911819,3918353,-,6534
33,BUMA.1121.00079,1,3436262,3442797,+,6535
33,BUMA.1121.00039,1,3533556,3540091,+,6535
33,BUMA.1121.00083,1,2281139,2287673,-,6534
33,BUMA.1121.00084,1,3751331,3757866,+,6535
33,BUMA.1121.00049,1,2429623,2436157,-,6534
33,BUMA.1121.00089,1,3342077,3348612,+,6535
33,BUMA.1121.00014,1,3528824,3535358,-,6534
33,BUMA.1121.00090,1,1460963,1467496,+,6533
33,BUMA.1121.00071,1,3312436,3318971,+,6535
33,BUMA.1121.00078,1,2613302,2619836,-,6534
33,BUMA.1121.00102,1,1901900,1908434,-,6534
33,BUMA.1121.00075,1,2878838,2885373,+,6535
33,BUMA.1121.00012,1,2137682,2144217,+,6535
33,BUMA.1121.00076,1,1926932,1933466,-,6534
33,BUMA.1121.00106,1,3138020,3144555,+,6535
33,BUMA.1121.00001,1,658096,664630,-,6534
33,BUMA.1121.00107,1,3323979,3330514,+,6535
33,BUMA.1121.00104,1,1857644,1864178,-,6534
33,BUMA.1121.00099,1,3027522,3034056,-,6534
33,BUMA.1121.00098,1,2042970,2049505,+,6535
33,BUMA.1121.00111,1,3573812,3580347,+,6535
33,BUMA.1121.00109,1,2514865,2521399,-,6534
33,BUMA.1121.00097,1,540358,546892,-,6534
33,BUMA.1121.00094,1,3370267,3376802,+,6535
33,BUMA.1121.00095,1,2294958,2301492,-,6534
33,BUMA.1121.00005,1,2141042,2147577,+,6535
33,BUMA.1121.00101,1,3058278,3064791,-,6513
33,BUMA.1121.00065,1,3449291,3455826,+,6535
33,BUMA.1121.00100,1,1897756,1904290,-,6534
33,BUMA.1121.00105,1,1811749,1818283,-,6534
33,BUMA.1121.00029,1,1532010,1538544,-,6534
33,BUMA.1121.00066,1,3297607,3304142,+,6535
33,BUMA.1121.00031,1,714482,721017,+,6535
33,BUMA.1121.00108,1,389163,395698,+,6535
33,BUMA.1121.00023,1,1723091,1729626,+,6535
33,BUMA.1121.00035,1,428514,435049,+,6535
33,BUMA.1121.00041,1,640956,647491,+,6535
32,BUMA.1121.00057,1,479045,488653,+,9608
32,BUMA.1121.00058,1,1119170,1128816,-,9646
32,BUMA.1121.00045,1,685041,694645,-,9604
32,BUMA.1121.00051,1,3341153,3350765,+,9612
32,BUMA.1121.00068,1,2166522,2176236,+,9714
32,BUMA.1121.00061,1,3296800,3306453,+,9653
32,BUMA.1121.00060,1,2930301,2939905,-,9604
32,BUMA.1121.00064,1,3376434,3386041,+,9607
32,BUMA.1121.00016,1,1489065,1498653,+,9588
32,BUMA.1121.00003,1,1892245,1901832,+,9587
32,BUMA.1121.00055,1,3053454,3063098,+,9644
32,BUMA.1121.00011,1,2228677,2238286,-,9609
32,BUMA.1121.00037,1,2008604,2019451,+,10847
32,BUMA.1121.00009,1,2175776,2185395,-,9619
32,BUMA.1121.00069,1,3280367,3290004,+,9637
32,BUMA.1121.00088,1,205868,215494,+,9626
32,BUMA.1121.00092,1,401430,411051,-,9621
32,BUMA.1121.00074,1,485310,494917,-,9607
32,BUMA.1121.00070,1,3267872,3277525,+,9653
32,BUMA.1121.00093,1,122780,132401,+,9621
32,BUMA.1121.00063,1,3293614,3303265,+,9651
32,BUMA.1121.00033,1,1589975,1599586,+,9611
32,BUMA.1121.00018,1,4004618,4014229,+,9611
32,BUMA.1121.00080,1,3389980,3399592,+,9612
32,BUMA.1121.00027,1,1562467,1572075,+,9608
32,BUMA.1121.00053,1,3135054,3144660,+,9606
32,BUMA.1121.00059,1,2620503,2630087,+,9584
32,BUMA.1121.00043,1,3506172,3515785,+,9613
32,BUMA.1121.00056,1,588213,597825,-,9612
32,BUMA.1121.00112,1,3691941,3701560,-,9619
32,BUMA.1121.00091,1,1109015,1118622,-,9607
32,BUMA.1121.00047,1,3629523,3639145,-,9622
32,BUMA.1121.00067,1,1040770,1050377,-,9607
32,BUMA.1121.00110,1,1436364,1445957,-,9593
32,BUMA.1121.00073,1,3295287,3304940,+,9653
32,BUMA.1121.00072,1,3281581,3291234,+,9653
32,BUMA.1121.00077,1,2037366,2046959,+,9593
32,BUMA.1121.00082,1,3478705,3488358,+,9653
32,BUMA.1121.00062,1,1176050,1185685,-,9635
32,BUMA.1121.00007,1,677489,687110,-,9621
32,BUMA.1121.00025,1,3395511,3405122,-,9611
32,BUMA.1121.00021,1,4034520,4044145,+,9625
32,BUMA.1121.00103,1,987110,996718,-,9608
32,BUMA.1121.00096,1,3921671,3931294,-,9623
32,BUMA.1121.00079,1,3423312,3432924,+,9612
32,BUMA.1121.00039,1,3520606,3530217,+,9611
32,BUMA.1121.00083,1,2291013,2300666,-,9653
32,BUMA.1121.00084,1,3738381,3747991,+,9610
32,BUMA.1121.00049,1,2439497,2449109,-,9612
32,BUMA.1121.00089,1,3329125,3338737,+,9612
32,BUMA.1121.00014,1,3538698,3548325,-,9627
32,BUMA.1121.00090,1,1448013,1457624,+,9611
32,BUMA.1121.00071,1,3299479,3309097,+,9618
32,BUMA.1121.00078,1,2623176,2632797,-,9621
32,BUMA.1121.00102,1,1911774,1921384,-,9610
32,BUMA.1121.00075,1,2865872,2875498,+,9626
32,BUMA.1121.00012,1,2124741,2134343,+,9602
32,BUMA.1121.00076,1,1936807,1946433,-,9626
32,BUMA.1121.00106,1,3125026,3134681,+,9655
32,BUMA.1121.00001,1,667970,677584,-,9614
32,BUMA.1121.00107,1,3310989,3320676,+,9687
32,BUMA.1121.00104,1,1867519,1877144,-,9625
32,BUMA.1121.00099,1,3037396,3046997,-,9601
32,BUMA.1121.00098,1,2030028,2039630,+,9602
32,BUMA.1121.00111,1,3560901,3570513,+,9612
32,BUMA.1121.00109,1,2524740,2534341,-,9601
32,BUMA.1121.00097,1,550233,559856,-,9623
32,BUMA.1121.00094,1,3357306,3366927,+,9621
32,BUMA.1121.00095,1,2304832,2314449,-,9617
32,BUMA.1121.00005,1,2128075,2137703,+,9628
32,BUMA.1121.00101,1,3069692,3079306,-,9614
32,BUMA.1121.00065,1,3436295,3445951,+,9656
32,BUMA.1121.00100,1,1907609,1917217,-,9608
32,BUMA.1121.00105,1,1821623,1831230,-,9607
32,BUMA.1121.00029,1,1541884,1551498,-,9614
32,BUMA.1121.00066,1,3284615,3294268,+,9653
32,BUMA.1121.00031,1,701526,711143,+,9617
32,BUMA.1121.00108,1,374646,384263,+,9617
32,BUMA.1121.00023,1,1710140,1719752,+,9612
32,BUMA.1121.00035,1,415561,425175,+,9614
32,BUMA.1121.00041,1,628001,637617,+,9616
31,BUMA.1121.00057,1,472805,478576,+,5771
31,BUMA.1121.00058,1,1129285,1135055,-,5770
31,BUMA.1121.00045,1,695129,700883,-,5754
31,BUMA.1121.00051,1,3334918,3340684,+,5766
31,BUMA.1121.00068,1,2160287,2166037,+,5750
31,BUMA.1121.00061,1,3290560,3296315,+,5755
31,BUMA.1121.00060,1,2940389,2946143,-,5754
31,BUMA.1121.00064,1,3370194,3375965,+,5771
31,BUMA.1121.00016,1,1481201,1486956,+,5755
31,BUMA.1121.00003,1,1886004,1891769,+,5765
31,BUMA.1121.00055,1,3047214,3052969,+,5755
31,BUMA.1121.00011,1,2238770,2244519,-,5749
31,BUMA.1121.00037,1,2002357,2008112,+,5755
31,BUMA.1121.00009,1,2185864,2191629,-,5765
31,BUMA.1121.00069,1,3274127,3279882,+,5755
31,BUMA.1121.00088,1,199633,205399,+,5766
31,BUMA.1121.00092,1,411535,417290,-,5755
31,BUMA.1121.00074,1,495386,501156,-,5770
31,BUMA.1121.00070,1,3261632,3267387,+,5755
31,BUMA.1121.00093,1,116540,122295,+,5755
31,BUMA.1121.00063,1,3287374,3293129,+,5755
31,BUMA.1121.00033,1,1583728,1589483,+,5755
31,BUMA.1121.00018,1,3998371,4004126,+,5755
31,BUMA.1121.00080,1,3383745,3389511,+,5766
31,BUMA.1121.00027,1,1556227,1561998,+,5771
31,BUMA.1121.00053,1,3128814,3134569,+,5755
31,BUMA.1121.00059,1,2612646,2618396,+,5750
31,BUMA.1121.00043,1,3499926,3505680,+,5754
31,BUMA.1121.00056,1,598294,604059,-,5765
31,BUMA.1121.00112,1,3702051,3707804,-,5753
31,BUMA.1121.00091,1,1119098,1124868,-,5770
31,BUMA.1121.00047,1,3639614,3645379,-,5765
31,BUMA.1121.00067,1,1050846,1056616,-,5770
31,BUMA.1121.00110,1,1446426,1452195,-,5769
31,BUMA.1121.00073,1,3289047,3294802,+,5755
31,BUMA.1121.00072,1,3275346,3281112,+,5766
31,BUMA.1121.00077,1,2031127,2036897,+,5770
31,BUMA.1121.00082,1,3472465,3478236,+,5771
31,BUMA.1121.00062,1,1186161,1191931,-,5770
31,BUMA.1121.00007,1,687601,693346,-,5745
31,BUMA.1121.00025,1,3405613,3411368,-,5755
31,BUMA.1121.00021,1,4028273,4034028,+,5755
31,BUMA.1121.00103,1,997187,1002958,-,5771
31,BUMA.1121.00096,1,3931763,3937527,-,5764
31,BUMA.1121.00079,1,3417077,3422843,+,5766
31,BUMA.1121.00039,1,3514359,3520114,+,5755
31,BUMA.1121.00083,1,2301135,2306905,-,5770
31,BUMA.1121.00084,1,3732146,3737912,+,5766
31,BUMA.1121.00049,1,2449578,2455348,-,5770
31,BUMA.1121.00089,1,3322890,3328656,+,5766
31,BUMA.1121.00014,1,3548816,3554571,-,5755
31,BUMA.1121.00090,1,1441766,1447521,+,5755
31,BUMA.1121.00071,1,3293239,3298994,+,5755
31,BUMA.1121.00078,1,2633281,2639036,-,5755
31,BUMA.1121.00102,1,1921875,1927630,-,5755
31,BUMA.1121.00075,1,2859632,2865403,+,5771
31,BUMA.1121.00012,1,2118495,2124249,+,5754
31,BUMA.1121.00076,1,1946902,1952672,-,5770
31,BUMA.1121.00106,1,3118786,3124557,+,5771
31,BUMA.1121.00001,1,678075,683830,-,5755
31,BUMA.1121.00107,1,3304752,3310497,+,5745
31,BUMA.1121.00104,1,1877613,1883383,-,5770
31,BUMA.1121.00099,1,3047488,3053241,-,5753
31,BUMA.1121.00098,1,2023783,2029536,+,5753
31,BUMA.1121.00111,1,3554662,3560417,+,5755
31,BUMA.1121.00109,1,2534832,2540587,-,5755
31,BUMA.1121.00097,1,561676,567431,-,5755
31,BUMA.1121.00094,1,3351064,3356830,+,5766
31,BUMA.1121.00095,1,2314933,2320688,-,5755
31,BUMA.1121.00005,1,2121828,2127583,+,5755
31,BUMA.1121.00101,1,3079797,3085551,-,5754
31,BUMA.1121.00065,1,3430055,3435826,+,5771
31,BUMA.1121.00100,1,1917709,1923459,-,5750
31,BUMA.1121.00105,1,1831699,1837469,-,5770
31,BUMA.1121.00029,1,1551989,1557744,-,5755
31,BUMA.1121.00066,1,3278375,3284130,+,5755
31,BUMA.1121.00031,1,695279,701034,+,5755
31,BUMA.1121.00108,1,368417,374177,+,5760
31,BUMA.1121.00023,1,1703893,1709648,+,5755
31,BUMA.1121.00035,1,409314,415069,+,5755
31,BUMA.1121.00041,1,621761,627516,+,5755
30,BUMA.1121.00057,1,460406,471511,+,11105
30,BUMA.1121.00058,1,1136349,1147455,-,11106
30,BUMA.1121.00045,1,702177,713265,-,11088
30,BUMA.1121.00051,1,3322528,3333624,+,11096
30,BUMA.1121.00068,1,2147874,2158984,+,11110
30,BUMA.1121.00061,1,3278235,3289266,+,11031
30,BUMA.1121.00060,1,2947437,2958525,-,11088
30,BUMA.1121.00064,1,3357809,3368900,+,11091
30,BUMA.1121.00016,1,1468854,1479916,+,11062
30,BUMA.1121.00003,1,1873596,1884701,+,11105
30,BUMA.1121.00055,1,3034857,3045920,+,11063
30,BUMA.1121.00011,1,2245813,2256905,-,11092
30,BUMA.1121.00037,1,1990007,2001070,+,11063
30,BUMA.1121.00009,1,2192932,2204027,-,11095
30,BUMA.1121.00069,1,3261803,3272833,+,11030
30,BUMA.1121.00088,1,187233,198339,+,11106
30,BUMA.1121.00092,1,418584,429659,-,11075
30,BUMA.1121.00074,1,502450,513542,-,11092
30,BUMA.1121.00070,1,3249309,3260338,+,11029
30,BUMA.1121.00093,1,104172,115246,+,11074
30,BUMA.1121.00063,1,3275048,3286080,+,11032
30,BUMA.1121.00033,1,1571379,1582441,+,11062
30,BUMA.1121.00018,1,3986023,3997086,+,11063
30,BUMA.1121.00080,1,3371355,3382451,+,11096
30,BUMA.1121.00027,1,1543829,1554933,+,11104
30,BUMA.1121.00053,1,3116420,3127511,+,11091
30,BUMA.1121.00059,1,2600246,2611352,+,11106
30,BUMA.1121.00043,1,3487560,3498641,+,11081
30,BUMA.1121.00056,1,605353,616450,-,11097
30,BUMA.1121.00112,1,3709107,3720200,-,11093
30,BUMA.1121.00091,1,1126153,1137215,-,11062
30,BUMA.1121.00047,1,3646673,3657770,-,11097
30,BUMA.1121.00067,1,1057910,1069002,-,11092
30,BUMA.1121.00110,1,1453489,1464569,-,11080
30,BUMA.1121.00073,1,3276713,3287753,+,11040
30,BUMA.1121.00072,1,3263024,3274052,+,11028
30,BUMA.1121.00077,1,2018754,2029833,+,11079
30,BUMA.1121.00082,1,3460066,3471171,+,11105
30,BUMA.1121.00062,1,1193225,1204322,-,11097
30,BUMA.1121.00007,1,694640,705743,-,11103
30,BUMA.1121.00025,1,3412653,3423717,-,11064
30,BUMA.1121.00021,1,4015925,4026988,+,11063
30,BUMA.1121.00103,1,1004252,1015349,-,11097
30,BUMA.1121.00096,1,3938821,3949913,-,11092
30,BUMA.1121.00079,1,3404687,3415783,+,11096
30,BUMA.1121.00039,1,3502011,3513074,+,11063
30,BUMA.1121.00083,1,2308199,2319305,-,11106
30,BUMA.1121.00084,1,3719761,3730852,+,11091
30,BUMA.1121.00049,1,2456651,2467731,-,11080
30,BUMA.1121.00089,1,3310500,3321596,+,11096
30,BUMA.1121.00014,1,3555858,3566923,-,11065
30,BUMA.1121.00090,1,1429418,1440481,+,11063
30,BUMA.1121.00071,1,3280914,3291945,+,11031
30,BUMA.1121.00078,1,2640330,2651423,-,11093
30,BUMA.1121.00102,1,1928933,1939995,-,11062
30,BUMA.1121.00075,1,2847247,2858338,+,11091
30,BUMA.1121.00012,1,2106127,2117208,+,11081
30,BUMA.1121.00076,1,1953966,1965058,-,11092
30,BUMA.1121.00106,1,3106406,3117492,+,11086
30,BUMA.1121.00001,1,685115,696197,-,11082
30,BUMA.1121.00107,1,3292388,3303467,+,11079
30,BUMA.1121.00104,1,1884668,1895754,-,11086
30,BUMA.1121.00099,1,3054535,3065628,-,11093
30,BUMA.1121.00098,1,2010735,2021827,+,11092
30,BUMA.1121.00111,1,3542313,3553377,+,11064
30,BUMA.1121.00109,1,2541872,2552969,-,11097
30,BUMA.1121.00097,1,568725,579828,-,11103
30,BUMA.1121.00094,1,3338674,3349770,+,11096
30,BUMA.1121.00095,1,2321973,2333069,-,11096
30,BUMA.1121.00005,1,2109450,2120525,+,11075
30,BUMA.1121.00101,1,3086855,3097956,-,11101
30,BUMA.1121.00065,1,3417709,3428770,+,11061
30,BUMA.1121.00100,1,1924761,1935866,-,11105
30,BUMA.1121.00105,1,1838763,1849870,-,11107
30,BUMA.1121.00029,1,1559029,1570111,-,11082
30,BUMA.1121.00066,1,3266052,3277081,+,11029
30,BUMA.1121.00031,1,682929,693992,+,11063
30,BUMA.1121.00108,1,356042,367123,+,11081
30,BUMA.1121.00023,1,1691545,1702608,+,11063
30,BUMA.1121.00035,1,396948,408029,+,11081
30,BUMA.1121.00041,1,609375,620467,+,11092
13,BUMA.1121.00057,1,146104,162906,+,16802
13,BUMA.1121.00058,1,1469721,1486600,-,16879
13,BUMA.1121.00045,1,1006427,1023316,-,16889
13,BUMA.1121.00051,1,3008888,3025770,+,16882
13,BUMA.1121.00068,1,1837419,1854282,+,16863
13,BUMA.1121.00061,1,2980821,2997682,+,16861
13,BUMA.1121.00060,1,3251657,3268528,-,16871
13,BUMA.1121.00064,1,3046740,3063641,+,16901
13,BUMA.1121.00016,1,1156954,1173953,+,16999
13,BUMA.1121.00003,1,1540527,1557424,+,16897
13,BUMA.1121.00055,1,2722362,2739198,+,16836
13,BUMA.1121.00011,1,2595689,2612490,-,16801
13,BUMA.1121.00037,1,1646132,1663051,+,16919
13,BUMA.1121.00009,1,2516314,2533202,-,16888
13,BUMA.1121.00069,1,2950173,2967032,+,16859
13,BUMA.1121.00088,1,4015248,4032080,+,16832
13,BUMA.1121.00092,1,726048,742983,-,16935
13,BUMA.1121.00074,1,810626,827492,-,16866
13,BUMA.1121.00070,1,2951909,2968769,+,16860
13,BUMA.1121.00093,1,3883124,3900072,+,16948
13,BUMA.1121.00063,1,2977686,2994546,+,16860
13,BUMA.1121.00033,1,1244437,1261317,+,16880
13,BUMA.1121.00018,1,3675240,3692160,+,16920
13,BUMA.1121.00080,1,3057481,3074415,+,16934
13,BUMA.1121.00027,1,1231207,1248097,+,16890
13,BUMA.1121.00053,1,2803137,2820015,+,16878
13,BUMA.1121.00059,1,2269512,2286337,+,16825
13,BUMA.1121.00043,1,3156108,3172961,+,16853
13,BUMA.1121.00056,1,913092,929955,-,16863
13,BUMA.1121.00112,1,4015649,4032530,-,16881
13,BUMA.1121.00091,1,1451133,1467964,-,16831
13,BUMA.1121.00047,1,3954492,3971355,-,16863
13,BUMA.1121.00067,1,1364979,1381821,-,16842
13,BUMA.1121.00110,1,1762176,1779018,-,16842
13,BUMA.1121.00073,1,2979082,2995944,+,16862
13,BUMA.1121.00072,1,2951659,2968519,+,16860
13,BUMA.1121.00077,1,1704192,1721056,+,16864
13,BUMA.1121.00082,1,3148251,3165113,+,16862
13,BUMA.1121.00062,1,1498641,1515499,-,16858
13,BUMA.1121.00007,1,1001729,1018614,-,16885
13,BUMA.1121.00025,1,3717670,3734577,-,16907
13,BUMA.1121.00021,1,3689542,3706542,+,17000
13,BUMA.1121.00103,1,1310789,1327682,-,16893
13,BUMA.1121.00096,1,221685,238576,-,16891
13,BUMA.1121.00079,1,3091805,3108671,+,16866
13,BUMA.1121.00039,1,3182252,3199169,+,16917
13,BUMA.1121.00083,1,2614247,2631108,-,16861
13,BUMA.1121.00084,1,3407139,3424020,+,16881
13,BUMA.1121.00049,1,2762156,2778989,-,16833
13,BUMA.1121.00089,1,2996890,3013754,+,16864
13,BUMA.1121.00014,1,3861761,3878629,-,16868
13,BUMA.1121.00090,1,1118971,1135888,+,16917
13,BUMA.1121.00071,1,2969521,2986378,+,16857
13,BUMA.1121.00078,1,2948192,2965164,-,16972
13,BUMA.1121.00102,1,2234693,2251643,-,16950
13,BUMA.1121.00075,1,2535851,2552709,+,16858
13,BUMA.1121.00012,1,1795887,1812759,+,16872
13,BUMA.1121.00076,1,2259573,2276418,-,16845
13,BUMA.1121.00106,1,2792437,2809258,+,16821
13,BUMA.1121.00001,1,1007226,1024210,-,16984
13,BUMA.1121.00107,1,2982242,2999089,+,16847
13,BUMA.1121.00104,1,2191622,2208485,-,16863
13,BUMA.1121.00099,1,3358540,3375557,-,17017
13,BUMA.1121.00098,1,1700269,1717172,+,16903
13,BUMA.1121.00111,1,3214044,3230907,+,16863
13,BUMA.1121.00109,1,2856030,2872871,-,16841
13,BUMA.1121.00097,1,873574,890469,-,16895
13,BUMA.1121.00094,1,3025875,3042727,+,16852
13,BUMA.1121.00095,1,2658660,2675467,-,16807
13,BUMA.1121.00005,1,1757478,1774290,+,16812
13,BUMA.1121.00101,1,3394204,3411114,-,16910
13,BUMA.1121.00065,1,3106877,3123757,+,16880
13,BUMA.1121.00100,1,2259083,2275900,-,16817
13,BUMA.1121.00105,1,2144653,2161485,-,16832
13,BUMA.1121.00029,1,1874682,1891579,-,16897
13,BUMA.1121.00066,1,2954576,2971434,+,16858
13,BUMA.1121.00031,1,372147,389022,+,16875
13,BUMA.1121.00108,1,46471,63375,+,16904
13,BUMA.1121.00023,1,1362323,1379174,+,16851
13,BUMA.1121.00035,1,83331,100300,+,16969
13,BUMA.1121.00041,1,274175,291157,+,16982
12,BUMA.1121.00057,1,116996,146103,+,29107
12,BUMA.1121.00058,1,1486602,1515742,-,29140
12,BUMA.1121.00045,1,1023318,1052452,-,29134
12,BUMA.1121.00051,1,2979764,3008887,+,29123
12,BUMA.1121.00068,1,1808315,1837418,+,29103
12,BUMA.1121.00061,1,2951690,2980820,+,29130
12,BUMA.1121.00060,1,3268530,3297664,-,29134
12,BUMA.1121.00064,1,3017641,3046739,+,29098
12,BUMA.1121.00016,1,1127814,1156945,+,29131
12,BUMA.1121.00003,1,1511412,1540526,+,29114
12,BUMA.1121.00055,1,2693255,2722361,+,29106
12,BUMA.1121.00011,1,2612492,2641636,-,29144
12,BUMA.1121.00037,1,1616898,1646131,+,29233
12,BUMA.1121.00009,1,2533204,2562273,-,29069
12,BUMA.1121.00069,1,2921046,2950172,+,29126
12,BUMA.1121.00088,1,3986158,4015247,+,29089
12,BUMA.1121.00092,1,742985,772096,-,29111
12,BUMA.1121.00074,1,827494,856633,-,29139
12,BUMA.1121.00070,1,2922779,2951908,+,29129
12,BUMA.1121.00093,1,3854012,3883123,+,29111
12,BUMA.1121.00063,1,2948555,2977685,+,29130
12,BUMA.1121.00033,1,1215283,1244436,+,29153
12,BUMA.1121.00018,1,3646093,3675239,+,29146
12,BUMA.1121.00080,1,3028336,3057480,+,29144
12,BUMA.1121.00027,1,1202106,1231206,+,29100
12,BUMA.1121.00053,1,2773987,2803136,+,29149
12,BUMA.1121.00059,1,2240395,2269511,+,29116
12,BUMA.1121.00043,1,3126850,3156107,+,29257
12,BUMA.1121.00056,1,929957,959138,-,29181
12,BUMA.1121.00112,1,4032532,4061682,-,29150
12,BUMA.1121.00091,1,1467966,1497077,-,29111
12,BUMA.1121.00047,1,3971357,4000495,-,29138
12,BUMA.1121.00067,1,1381823,1410998,-,29175
12,BUMA.1121.00110,1,1779020,1808099,-,29079
12,BUMA.1121.00073,1,2949951,2979081,+,29130
12,BUMA.1121.00072,1,2922528,2951658,+,29130
12,BUMA.1121.00077,1,1675110,1704191,+,29081
12,BUMA.1121.00082,1,3119108,3148250,+,29142
12,BUMA.1121.00062,1,1515501,1544673,-,29172
12,BUMA.1121.00007,1,1018616,1047751,-,29135
12,BUMA.1121.00025,1,3734579,3763734,-,29155
12,BUMA.1121.00021,1,3660415,3689541,+,29126
12,BUMA.1121.00103,1,1330673,1359811,-,29138
12,BUMA.1121.00096,1,238578,267662,-,29084
12,BUMA.1121.00079,1,3062662,3091804,+,29142
12,BUMA.1121.00039,1,3153141,3182251,+,29110
12,BUMA.1121.00083,1,2631110,2660252,-,29142
12,BUMA.1121.00084,1,3378020,3407138,+,29118
12,BUMA.1121.00049,1,2778991,2808071,-,29080
12,BUMA.1121.00089,1,2967708,2996889,+,29181
12,BUMA.1121.00014,1,3878631,3907880,-,29249
12,BUMA.1121.00090,1,1089773,1118970,+,29197
12,BUMA.1121.00071,1,2940387,2969520,+,29133
12,BUMA.1121.00078,1,2965166,2994287,-,29121
12,BUMA.1121.00102,1,2251645,2280852,-,29207
12,BUMA.1121.00075,1,2506706,2535850,+,29144
12,BUMA.1121.00012,1,1766687,1795886,+,29199
12,BUMA.1121.00076,1,2276420,2305563,-,29143
12,BUMA.1121.00106,1,2763356,2792436,+,29080
12,BUMA.1121.00001,1,1024212,1053338,-,29126
12,BUMA.1121.00107,1,2953122,2982241,+,29119
12,BUMA.1121.00104,1,2208487,2237576,-,29089
12,BUMA.1121.00099,1,3375559,3404691,-,29132
12,BUMA.1121.00098,1,1671105,1700268,+,29163
12,BUMA.1121.00111,1,3184891,3214043,+,29152
12,BUMA.1121.00109,1,2872873,2901986,-,29113
12,BUMA.1121.00097,1,890471,919596,-,29125
12,BUMA.1121.00094,1,2996698,3025874,+,29176
12,BUMA.1121.00095,1,2675469,2704678,-,29209
12,BUMA.1121.00005,1,1728386,1757477,+,29091
12,BUMA.1121.00101,1,3411116,3440217,-,29101
12,BUMA.1121.00065,1,3077698,3106876,+,29178
12,BUMA.1121.00100,1,2275902,2305037,-,29135
12,BUMA.1121.00105,1,2161487,2190645,-,29158
12,BUMA.1121.00029,1,1891581,1920717,-,29136
12,BUMA.1121.00066,1,2925448,2954575,+,29127
12,BUMA.1121.00031,1,342896,372146,+,29250
12,BUMA.1121.00108,1,17317,46470,+,29153
12,BUMA.1121.00023,1,1333248,1362322,+,29074
12,BUMA.1121.00035,1,54185,83330,+,29145
12,BUMA.1121.00041,1,245036,274174,+,29138
11,BUMA.1121.00057,1,105229,116779,+,11550
11,BUMA.1121.00058,1,1515959,1527527,-,11568
11,BUMA.1121.00045,1,1052669,1064207,-,11538
11,BUMA.1121.00051,1,2968008,2979547,+,11539
11,BUMA.1121.00068,1,1783292,1794832,+,11540
11,BUMA.1121.00061,1,2939933,2951473,+,11540
11,BUMA.1121.00060,1,3297881,3309419,-,11538
11,BUMA.1121.00064,1,3005890,3017424,+,11534
11,BUMA.1121.00016,1,1116044,1127597,+,11553
11,BUMA.1121.00003,1,1489640,1501175,+,11535
11,BUMA.1121.00055,1,2681510,2693038,+,11528
11,BUMA.1121.00011,1,2641853,2653379,-,11526
11,BUMA.1121.00037,1,1605139,1616681,+,11542
11,BUMA.1121.00009,1,2562490,2574040,-,11550
11,BUMA.1121.00069,1,2909289,2920829,+,11540
11,BUMA.1121.00088,1,3974401,3985941,+,11540
11,BUMA.1121.00092,1,772313,783867,-,11554
11,BUMA.1121.00074,1,856850,868384,-,11534
11,BUMA.1121.00070,1,2911022,2922562,+,11540
11,BUMA.1121.00093,1,3842241,3853795,+,11554
11,BUMA.1121.00063,1,2936798,2948338,+,11540
11,BUMA.1121.00033,1,1203524,1215066,+,11542
11,BUMA.1121.00018,1,3593650,3605180,+,11530
11,BUMA.1121.00080,1,2999772,3011312,+,11540
11,BUMA.1121.00027,1,1190355,1201889,+,11534
11,BUMA.1121.00053,1,2762236,2773770,+,11534
11,BUMA.1121.00059,1,2228628,2240178,+,11550
11,BUMA.1121.00043,1,3115081,3126633,+,11552
11,BUMA.1121.00056,1,959355,970895,-,11540
11,BUMA.1121.00112,1,4061899,4073441,-,11542
11,BUMA.1121.00091,1,1497294,1508819,-,11525
11,BUMA.1121.00047,1,4016307,4027833,-,11526
11,BUMA.1121.00067,1,1411215,1422749,-,11534
11,BUMA.1121.00110,1,1808316,1819868,-,11552
11,BUMA.1121.00073,1,2938194,2949734,+,11540
11,BUMA.1121.00072,1,2910771,2922311,+,11540
11,BUMA.1121.00077,1,1663345,1674895,+,11550
11,BUMA.1121.00082,1,3107351,3118891,+,11540
11,BUMA.1121.00062,1,1544890,1556440,-,11550
11,BUMA.1121.00007,1,1047968,1059517,-,11549
11,BUMA.1121.00025,1,3804649,3816179,-,11530
11,BUMA.1121.00021,1,3601204,3612746,+,11542
11,BUMA.1121.00103,1,1360028,1371579,-,11551
11,BUMA.1121.00096,1,267879,279440,-,11561
11,BUMA.1121.00079,1,3034100,3045638,+,11538
11,BUMA.1121.00039,1,3141382,3152924,+,11542
11,BUMA.1121.00083,1,2660469,2672009,-,11540
11,BUMA.1121.00084,1,3366269,3377803,+,11534
11,BUMA.1121.00049,1,2808288,2819834,-,11546
11,BUMA.1121.00089,1,2955951,2967491,+,11540
11,BUMA.1121.00014,1,3908097,3919579,-,11482
11,BUMA.1121.00090,1,1078015,1089556,+,11541
11,BUMA.1121.00071,1,2928630,2940170,+,11540
11,BUMA.1121.00078,1,2994504,3006053,-,11549
11,BUMA.1121.00102,1,2281069,2292613,-,11544
11,BUMA.1121.00075,1,2494950,2506489,+,11539
11,BUMA.1121.00012,1,1754924,1766470,+,11546
11,BUMA.1121.00076,1,2305780,2317320,-,11540
11,BUMA.1121.00106,1,2751595,2763139,+,11544
11,BUMA.1121.00001,1,1073416,1084949,-,11533
11,BUMA.1121.00107,1,2941354,2952905,+,11551
11,BUMA.1121.00104,1,2237793,2249337,-,11544
11,BUMA.1121.00099,1,3404908,3416448,-,11540
11,BUMA.1121.00098,1,1659334,1670888,+,11554
11,BUMA.1121.00111,1,3173121,3184674,+,11553
11,BUMA.1121.00109,1,2902203,2913738,-,11535
11,BUMA.1121.00097,1,919813,931348,-,11535
11,BUMA.1121.00094,1,2984941,2996481,+,11540
11,BUMA.1121.00095,1,2704895,2716447,-,11552
11,BUMA.1121.00005,1,1716640,1728169,+,11529
11,BUMA.1121.00101,1,3440434,3451986,-,11552
11,BUMA.1121.00065,1,3065945,3077481,+,11536
11,BUMA.1121.00100,1,2318520,2330070,-,11550
11,BUMA.1121.00105,1,2190862,2202412,-,11550
11,BUMA.1121.00029,1,1957844,1969327,-,11483
11,BUMA.1121.00066,1,2913691,2925231,+,11540
11,BUMA.1121.00031,1,331197,342679,+,11482
11,BUMA.1121.00108,1,5536,17100,+,11564
11,BUMA.1121.00023,1,1321488,1333031,+,11543
11,BUMA.1121.00035,1,33465,44999,+,11534
11,BUMA.1121.00041,1,233280,244819,+,11539
10,BUMA.1121.00057,1,99656,105007,+,5351
10,BUMA.1121.00058,1,1527749,1533100,-,5351
10,BUMA.1121.00045,1,1064429,1069780,-,5351
10,BUMA.1121.00051,1,2962435,2967786,+,5351
10,BUMA.1121.00068,1,1777720,1783071,+,5351
10,BUMA.1121.00061,1,2934345,2939696,+,5351
10,BUMA.1121.00060,1,3309641,3314992,-,5351
10,BUMA.1121.00064,1,3000317,3005668,+,5351
10,BUMA.1121.00016,1,1110471,1115822,+,5351
10,BUMA.1121.00003,1,1484067,1489418,+,5351
10,BUMA.1121.00055,1,2675937,2681288,+,5351
10,BUMA.1121.00011,1,2653600,2658951,-,5351
10,BUMA.1121.00037,1,1599566,1604917,+,5351
10,BUMA.1121.00009,1,2574262,2579613,-,5351
10,BUMA.1121.00069,1,2903702,2909067,+,5365
10,BUMA.1121.00088,1,3968828,3974179,+,5351
10,BUMA.1121.00092,1,784089,789440,-,5351
10,BUMA.1121.00074,1,868606,873957,-,5351
10,BUMA.1121.00070,1,2905434,2910800,+,5366
10,BUMA.1121.00093,1,3836668,3842019,+,5351
10,BUMA.1121.00063,1,2931211,2936576,+,5365
10,BUMA.1121.00033,1,1197951,1203302,+,5351
10,BUMA.1121.00018,1,3588077,3593428,+,5351
10,BUMA.1121.00080,1,2994199,2999550,+,5351
10,BUMA.1121.00027,1,1184782,1190133,+,5351
10,BUMA.1121.00053,1,2756663,2762014,+,5351
10,BUMA.1121.00059,1,2223055,2228406,+,5351
10,BUMA.1121.00043,1,3081080,3086430,+,5350
10,BUMA.1121.00056,1,971117,976468,-,5351
10,BUMA.1121.00112,1,4073663,4079014,-,5351
10,BUMA.1121.00091,1,1509041,1514392,-,5351
10,BUMA.1121.00047,1,4028055,4033406,-,5351
10,BUMA.1121.00067,1,1422971,1428322,-,5351
10,BUMA.1121.00110,1,1820089,1825440,-,5351
10,BUMA.1121.00073,1,2932607,2937972,+,5365
10,BUMA.1121.00072,1,2905184,2910535,+,5351
10,BUMA.1121.00077,1,1657773,1663124,+,5351
10,BUMA.1121.00082,1,3091982,3097332,+,5350
10,BUMA.1121.00062,1,1556662,1562013,-,5351
10,BUMA.1121.00007,1,1059739,1065090,-,5351
10,BUMA.1121.00025,1,3816401,3821752,-,5351
10,BUMA.1121.00021,1,3595631,3600982,+,5351
10,BUMA.1121.00103,1,1371800,1377151,-,5351
10,BUMA.1121.00096,1,279662,285013,-,5351
10,BUMA.1121.00079,1,3028527,3033878,+,5351
10,BUMA.1121.00039,1,3135809,3141160,+,5351
10,BUMA.1121.00083,1,2682028,2687378,-,5350
10,BUMA.1121.00084,1,3360696,3366047,+,5351
10,BUMA.1121.00049,1,2820056,2825407,-,5351
10,BUMA.1121.00089,1,2950378,2955729,+,5351
10,BUMA.1121.00014,1,3919801,3925152,-,5351
10,BUMA.1121.00090,1,1072442,1077793,+,5351
10,BUMA.1121.00071,1,2923043,2928408,+,5365
10,BUMA.1121.00078,1,3006274,3011625,-,5351
10,BUMA.1121.00102,1,2292834,2298185,-,5351
10,BUMA.1121.00075,1,2489378,2494729,+,5351
10,BUMA.1121.00012,1,1749351,1754702,+,5351
10,BUMA.1121.00076,1,2317541,2322892,-,5351
10,BUMA.1121.00106,1,2746022,2751373,+,5351
10,BUMA.1121.00001,1,1085171,1090522,-,5351
10,BUMA.1121.00107,1,2935782,2941133,+,5351
10,BUMA.1121.00104,1,2249559,2254910,-,5351
10,BUMA.1121.00099,1,3416670,3422021,-,5351
10,BUMA.1121.00098,1,1653761,1659112,+,5351
10,BUMA.1121.00111,1,3167548,3172899,+,5351
10,BUMA.1121.00109,1,2913959,2919310,-,5351
10,BUMA.1121.00097,1,931569,936920,-,5351
10,BUMA.1121.00094,1,2979368,2984719,+,5351
10,BUMA.1121.00095,1,2716668,2722019,-,5351
10,BUMA.1121.00005,1,1711068,1716419,+,5351
10,BUMA.1121.00101,1,3452208,3457559,-,5351
10,BUMA.1121.00065,1,3060372,3065723,+,5351
10,BUMA.1121.00100,1,2330292,2335643,-,5351
10,BUMA.1121.00105,1,2202634,2207985,-,5351
10,BUMA.1121.00029,1,1969549,1974900,-,5351
10,BUMA.1121.00066,1,2908104,2913469,+,5365
10,BUMA.1121.00031,1,325624,330975,+,5351
10,BUMA.1121.00108,1,1,5315,+,5314
10,BUMA.1121.00023,1,1315915,1321266,+,5351
10,BUMA.1121.00035,1,27892,33243,+,5351
10,BUMA.1121.00041,1,227708,233059,+,5351
9,BUMA.1121.00057,1,86713,93848,+,7135
9,BUMA.1121.00058,1,1538908,1546043,-,7135
9,BUMA.1121.00045,1,1075584,1082719,-,7135
9,BUMA.1121.00051,1,2949492,2956627,+,7135
9,BUMA.1121.00068,1,1764776,1771914,+,7138
9,BUMA.1121.00061,1,2921404,2928537,+,7133
9,BUMA.1121.00060,1,3320796,3327931,-,7135
9,BUMA.1121.00064,1,2987374,2994509,+,7135
9,BUMA.1121.00016,1,1095939,1103074,+,7135
9,BUMA.1121.00003,1,1471238,1478260,+,7022
9,BUMA.1121.00055,1,2662999,2670134,+,7135
9,BUMA.1121.00011,1,2664757,2671892,-,7135
9,BUMA.1121.00037,1,1585033,1592168,+,7135
9,BUMA.1121.00009,1,2585416,2592551,-,7135
9,BUMA.1121.00069,1,2890762,2897895,+,7133
9,BUMA.1121.00088,1,3955885,3963020,+,7135
9,BUMA.1121.00092,1,795247,802382,-,7135
9,BUMA.1121.00074,1,879761,886896,-,7135
9,BUMA.1121.00070,1,2892494,2899627,+,7133
9,BUMA.1121.00093,1,3823726,3830861,+,7135
9,BUMA.1121.00063,1,2918271,2925404,+,7133
9,BUMA.1121.00033,1,1183418,1190553,+,7135
9,BUMA.1121.00018,1,3573543,3580678,+,7135
9,BUMA.1121.00080,1,2981256,2988391,+,7135
9,BUMA.1121.00027,1,1171842,1178974,+,7132
9,BUMA.1121.00053,1,2743721,2750856,+,7135
9,BUMA.1121.00059,1,2210116,2217251,+,7135
9,BUMA.1121.00043,1,3066547,3073682,+,7135
9,BUMA.1121.00056,1,982276,989411,-,7135
9,BUMA.1121.00112,1,4084821,4091956,-,7135
9,BUMA.1121.00091,1,1521795,1528930,-,7135
9,BUMA.1121.00047,1,4039210,4046345,-,7135
9,BUMA.1121.00067,1,1434126,1441261,-,7135
9,BUMA.1121.00110,1,1832843,1839978,-,7135
9,BUMA.1121.00073,1,2919667,2926800,+,7133
9,BUMA.1121.00072,1,2892244,2899377,+,7133
9,BUMA.1121.00077,1,1643232,1650370,+,7138
9,BUMA.1121.00082,1,3079041,3086174,+,7133
9,BUMA.1121.00062,1,1567821,1574956,-,7135
9,BUMA.1121.00007,1,1072492,1079627,-,7135
9,BUMA.1121.00025,1,3829151,3836286,-,7135
9,BUMA.1121.00021,1,3581098,3588233,+,7135
9,BUMA.1121.00103,1,1382957,1390064,-,7107
9,BUMA.1121.00096,1,290816,297951,-,7135
9,BUMA.1121.00079,1,3015584,3022719,+,7135
9,BUMA.1121.00039,1,3121276,3128411,+,7135
9,BUMA.1121.00083,1,2693186,2700319,-,7133
9,BUMA.1121.00084,1,3347753,3354888,+,7135
9,BUMA.1121.00049,1,2831211,2838346,-,7135
9,BUMA.1121.00089,1,2937435,2944570,+,7135
9,BUMA.1121.00014,1,3932550,3939685,-,7135
9,BUMA.1121.00090,1,1057909,1065044,+,7135
9,BUMA.1121.00071,1,2910102,2917235,+,7133
9,BUMA.1121.00078,1,3017429,3024564,-,7135
9,BUMA.1121.00102,1,2303988,2311123,-,7135
9,BUMA.1121.00075,1,2474843,2481978,+,7135
9,BUMA.1121.00012,1,1734818,1741953,+,7135
9,BUMA.1121.00076,1,2330292,2337427,-,7135
9,BUMA.1121.00106,1,2733083,2740218,+,7135
9,BUMA.1121.00001,1,1097920,1105055,-,7135
9,BUMA.1121.00107,1,2921246,2928379,+,7133
9,BUMA.1121.00104,1,2260713,2267848,-,7135
9,BUMA.1121.00099,1,3427824,3434959,-,7135
9,BUMA.1121.00098,1,1640819,1647954,+,7135
9,BUMA.1121.00111,1,3153012,3160147,+,7135
9,BUMA.1121.00109,1,2925114,2932249,-,7135
9,BUMA.1121.00097,1,942727,949862,-,7135
9,BUMA.1121.00094,1,2966426,2973561,+,7135
9,BUMA.1121.00095,1,2729390,2736525,-,7135
9,BUMA.1121.00005,1,1695221,1702354,+,7133
9,BUMA.1121.00101,1,3463364,3470499,-,7135
9,BUMA.1121.00065,1,3047434,3054569,+,7135
9,BUMA.1121.00100,1,2342831,2349932,-,7101
9,BUMA.1121.00105,1,2213789,2220924,-,7135
9,BUMA.1121.00029,1,1982298,1989432,-,7134
9,BUMA.1121.00066,1,2895164,2902297,+,7133
9,BUMA.1121.00031,1,311091,318226,+,7135
9,BUMA.1121.00108,1,4018133,4025268,+,7135
9,BUMA.1121.00023,1,1301382,1308517,+,7135
9,BUMA.1121.00035,1,13359,20494,+,7135
9,BUMA.1121.00041,1,213172,220307,+,7135
8,BUMA.1121.00057,1,73634,86322,+,12688
8,BUMA.1121.00058,1,1546421,1559108,-,12687
8,BUMA.1121.00045,1,1083097,1095774,-,12677
8,BUMA.1121.00051,1,2936414,2949101,+,12687
8,BUMA.1121.00068,1,1751733,1764397,+,12664
8,BUMA.1121.00061,1,2908325,2921013,+,12688
8,BUMA.1121.00060,1,3328309,3340986,-,12677
8,BUMA.1121.00064,1,2974294,2986983,+,12689
8,BUMA.1121.00016,1,1081519,1095522,+,14003
8,BUMA.1121.00003,1,1458039,1470710,+,12671
8,BUMA.1121.00055,1,2649935,2662621,+,12686
8,BUMA.1121.00011,1,2672283,2684974,-,12691
8,BUMA.1121.00037,1,1571914,1584603,+,12689
8,BUMA.1121.00009,1,2592942,2605630,-,12688
8,BUMA.1121.00069,1,2877685,2890371,+,12686
8,BUMA.1121.00088,1,3942821,3955507,+,12686
8,BUMA.1121.00092,1,802760,815444,-,12684
8,BUMA.1121.00074,1,887287,899974,-,12687
8,BUMA.1121.00070,1,2879415,2892103,+,12688
8,BUMA.1121.00093,1,3810663,3823348,+,12685
8,BUMA.1121.00063,1,2905192,2917880,+,12688
8,BUMA.1121.00033,1,1170339,1183027,+,12688
8,BUMA.1121.00018,1,3560508,3573139,+,12631
8,BUMA.1121.00080,1,2968178,2980865,+,12687
8,BUMA.1121.00027,1,1158763,1171451,+,12688
8,BUMA.1121.00053,1,2730642,2743330,+,12688
8,BUMA.1121.00059,1,2197038,2209725,+,12687
8,BUMA.1121.00043,1,3053466,3066156,+,12690
8,BUMA.1121.00056,1,989802,1002489,-,12687
8,BUMA.1121.00112,1,4092347,4105032,-,12685
8,BUMA.1121.00091,1,1529321,1541997,-,12676
8,BUMA.1121.00047,1,4046736,4059423,-,12687
8,BUMA.1121.00067,1,1441652,1454339,-,12687
8,BUMA.1121.00110,1,1840382,1853070,-,12688
8,BUMA.1121.00073,1,2906588,2919276,+,12688
8,BUMA.1121.00072,1,2879165,2891853,+,12688
8,BUMA.1121.00077,1,1630139,1642828,+,12689
8,BUMA.1121.00082,1,3065962,3078650,+,12688
8,BUMA.1121.00062,1,1575347,1588033,-,12686
8,BUMA.1121.00007,1,1080006,1094000,-,13994
8,BUMA.1121.00025,1,3836690,3849320,-,12630
8,BUMA.1121.00021,1,3567992,3580681,+,12689
8,BUMA.1121.00103,1,1390468,1403145,-,12677
8,BUMA.1121.00096,1,298342,311027,-,12685
8,BUMA.1121.00079,1,3002506,3015193,+,12687
8,BUMA.1121.00039,1,3108170,3120859,+,12689
8,BUMA.1121.00083,1,2700710,2713397,-,12687
8,BUMA.1121.00084,1,3334674,3347362,+,12688
8,BUMA.1121.00049,1,2838737,2851422,-,12685
8,BUMA.1121.00089,1,2924356,2937044,+,12688
8,BUMA.1121.00014,1,3940076,3952764,-,12688
8,BUMA.1121.00090,1,1044803,1057492,+,12689
8,BUMA.1121.00071,1,2897024,2909711,+,12687
8,BUMA.1121.00078,1,3024955,3037642,-,12687
8,BUMA.1121.00102,1,2311514,2324201,-,12687
8,BUMA.1121.00075,1,2461777,2474452,+,12675
8,BUMA.1121.00012,1,1721726,1734414,+,12688
8,BUMA.1121.00076,1,2337818,2350492,-,12674
8,BUMA.1121.00106,1,2720002,2732692,+,12690
8,BUMA.1121.00001,1,1105446,1118134,-,12688
8,BUMA.1121.00107,1,2908191,2920868,+,12677
8,BUMA.1121.00104,1,2268239,2280925,-,12686
8,BUMA.1121.00099,1,3435350,3447948,-,12598
8,BUMA.1121.00098,1,1627776,1640441,+,12665
8,BUMA.1121.00111,1,3139932,3152621,+,12689
8,BUMA.1121.00109,1,2932640,2945261,-,12621
8,BUMA.1121.00097,1,950253,962940,-,12687
8,BUMA.1121.00094,1,2953347,2966035,+,12688
8,BUMA.1121.00095,1,2738182,2750824,-,12642
8,BUMA.1121.00005,1,1682144,1694830,+,12686
8,BUMA.1121.00101,1,3470890,3483584,-,12694
8,BUMA.1121.00065,1,3034355,3047043,+,12688
8,BUMA.1121.00100,1,2350323,2362940,-,12617
8,BUMA.1121.00105,1,2221315,2234003,-,12688
8,BUMA.1121.00029,1,1989823,2002511,-,12688
8,BUMA.1121.00066,1,2882085,2894773,+,12688
8,BUMA.1121.00031,1,298011,310700,+,12689
8,BUMA.1121.00108,1,4005044,4017729,+,12685
8,BUMA.1121.00023,1,1288290,1300978,+,12688
8,BUMA.1121.00035,1,279,12968,+,12689
8,BUMA.1121.00041,1,200103,212781,+,12678
7,BUMA.1121.00057,1,58125,73071,+,14946
7,BUMA.1121.00058,1,1559671,1574614,-,14943
7,BUMA.1121.00045,1,1096337,1111312,-,14975
7,BUMA.1121.00051,1,2920915,2935851,+,14936
7,BUMA.1121.00068,1,1736241,1751170,+,14929
7,BUMA.1121.00061,1,2892837,2907762,+,14925
7,BUMA.1121.00060,1,3341549,3356524,-,14975
7,BUMA.1121.00064,1,2958804,2973731,+,14927
7,BUMA.1121.00016,1,1066027,1080956,+,14929
7,BUMA.1121.00003,1,1442545,1457476,+,14931
7,BUMA.1121.00055,1,2634434,2649372,+,14938
7,BUMA.1121.00011,1,2685546,2700488,-,14942
7,BUMA.1121.00037,1,1556422,1571351,+,14929
7,BUMA.1121.00009,1,2606193,2621158,-,14965
7,BUMA.1121.00069,1,2862162,2877122,+,14960
7,BUMA.1121.00088,1,3927332,3942258,+,14926
7,BUMA.1121.00092,1,816007,830946,-,14939
7,BUMA.1121.00074,1,900537,915480,-,14943
7,BUMA.1121.00070,1,2863907,2878852,+,14945
7,BUMA.1121.00093,1,3795162,3810100,+,14938
7,BUMA.1121.00063,1,2889683,2904629,+,14946
7,BUMA.1121.00033,1,1154881,1169776,+,14895
7,BUMA.1121.00018,1,3545016,3559945,+,14929
7,BUMA.1121.00080,1,2952677,2967615,+,14938
7,BUMA.1121.00027,1,1143274,1158200,+,14926
7,BUMA.1121.00053,1,2715154,2730079,+,14925
7,BUMA.1121.00059,1,2181535,2196475,+,14940
7,BUMA.1121.00043,1,3037960,3052903,+,14943
7,BUMA.1121.00056,1,1003052,1017991,-,14939
7,BUMA.1121.00112,1,4105595,4120510,-,14915
7,BUMA.1121.00091,1,1542560,1557503,-,14943
7,BUMA.1121.00047,1,4059986,4074925,-,14939
7,BUMA.1121.00067,1,1454902,1469845,-,14943
7,BUMA.1121.00110,1,1853633,1868571,-,14938
7,BUMA.1121.00073,1,2891079,2906025,+,14946
7,BUMA.1121.00072,1,2863765,2878602,+,14837
7,BUMA.1121.00077,1,1614639,1629576,+,14937
7,BUMA.1121.00082,1,3050437,3065399,+,14962
7,BUMA.1121.00062,1,1588596,1603518,-,14922
7,BUMA.1121.00007,1,1094563,1109497,-,14934
7,BUMA.1121.00025,1,3849883,3864813,-,14930
7,BUMA.1121.00021,1,3552500,3567429,+,14929
7,BUMA.1121.00103,1,1403708,1418664,-,14956
7,BUMA.1121.00096,1,311590,326506,-,14916
7,BUMA.1121.00079,1,2987006,3001943,+,14937
7,BUMA.1121.00039,1,3092678,3107607,+,14929
7,BUMA.1121.00083,1,2713960,2728923,-,14963
7,BUMA.1121.00084,1,3319185,3334111,+,14926
7,BUMA.1121.00049,1,2851985,2866927,-,14942
7,BUMA.1121.00089,1,2908855,2923793,+,14938
7,BUMA.1121.00014,1,3953327,3968257,-,14930
7,BUMA.1121.00090,1,1029311,1044240,+,14929
7,BUMA.1121.00071,1,2881533,2896461,+,14928
7,BUMA.1121.00078,1,3038204,3053112,-,14908
7,BUMA.1121.00102,1,2324764,2339715,-,14951
7,BUMA.1121.00075,1,2446278,2461214,+,14936
7,BUMA.1121.00012,1,1706217,1721163,+,14946
7,BUMA.1121.00076,1,2351055,2365993,-,14938
7,BUMA.1121.00106,1,2704511,2719439,+,14928
7,BUMA.1121.00001,1,1118697,1133632,-,14935
7,BUMA.1121.00107,1,2892692,2907630,+,14938
7,BUMA.1121.00104,1,2281488,2296429,-,14941
7,BUMA.1121.00099,1,3448504,3463441,-,14937
7,BUMA.1121.00098,1,1612288,1627213,+,14925
7,BUMA.1121.00111,1,3124440,3139369,+,14929
7,BUMA.1121.00109,1,2945824,2960776,-,14952
7,BUMA.1121.00097,1,963503,978449,-,14946
7,BUMA.1121.00094,1,2937846,2952784,+,14938
7,BUMA.1121.00095,1,2751386,2766324,-,14938
7,BUMA.1121.00005,1,1666645,1681581,+,14936
7,BUMA.1121.00101,1,3484147,3499088,-,14941
7,BUMA.1121.00065,1,3018855,3033792,+,14937
7,BUMA.1121.00100,1,2363503,2378443,-,14940
7,BUMA.1121.00105,1,2234566,2249503,-,14937
7,BUMA.1121.00029,1,2003074,2018008,-,14934
7,BUMA.1121.00066,1,2866590,2881522,+,14932
7,BUMA.1121.00031,1,282519,297448,+,14929
7,BUMA.1121.00108,1,3989587,4004481,+,14894
7,BUMA.1121.00023,1,1272851,1287727,+,14876
7,BUMA.1121.00035,1,4106645,4121580,+,14935
7,BUMA.1121.00041,1,184591,199533,+,14942
6,BUMA.1121.00057,1,50679,57706,+,7027
6,BUMA.1121.00058,1,1575072,1582100,-,7028
6,BUMA.1121.00045,1,1111727,1118755,-,7028
6,BUMA.1121.00051,1,2913452,2920481,+,7029
6,BUMA.1121.00068,1,1728793,1735804,+,7011
6,BUMA.1121.00061,1,2885376,2892405,+,7029
6,BUMA.1121.00060,1,3356939,3363967,-,7028
6,BUMA.1121.00064,1,2951296,2958325,+,7029
6,BUMA.1121.00016,1,1058588,1065617,+,7029
6,BUMA.1121.00003,1,1435032,1442061,+,7029
6,BUMA.1121.00055,1,2626933,2633962,+,7029
6,BUMA.1121.00011,1,2700950,2707960,-,7010
6,BUMA.1121.00037,1,1548983,1556012,+,7029
6,BUMA.1121.00009,1,2621565,2628593,-,7028
6,BUMA.1121.00069,1,2854717,2861746,+,7029
6,BUMA.1121.00088,1,3919845,3926874,+,7029
6,BUMA.1121.00092,1,831495,838523,-,7028
6,BUMA.1121.00074,1,915917,922945,-,7028
6,BUMA.1121.00070,1,2856445,2863473,+,7028
6,BUMA.1121.00093,1,3787584,3794613,+,7029
6,BUMA.1121.00063,1,2882222,2889251,+,7029
6,BUMA.1121.00033,1,1147380,1154409,+,7029
6,BUMA.1121.00018,1,3537577,3544606,+,7029
6,BUMA.1121.00080,1,2945207,2952236,+,7029
6,BUMA.1121.00027,1,1135746,1142774,+,7028
6,BUMA.1121.00053,1,2707695,2714722,+,7027
6,BUMA.1121.00059,1,2174048,2181077,+,7029
6,BUMA.1121.00043,1,3030452,3037481,+,7029
6,BUMA.1121.00056,1,1018439,1025467,-,7028
6,BUMA.1121.00112,1,4120981,4127991,-,7010
6,BUMA.1121.00091,1,1557942,1564968,-,7026
6,BUMA.1121.00047,1,464,7470,-,7006
6,BUMA.1121.00047,1,4075373,4082401,-,7028
6,BUMA.1121.00067,1,1470282,1477310,-,7028
6,BUMA.1121.00110,1,1868992,1876018,-,7026
6,BUMA.1121.00073,1,2883618,2890646,+,7028
6,BUMA.1121.00072,1,2856298,2863326,+,7028
6,BUMA.1121.00077,1,1607191,1614218,+,7027
6,BUMA.1121.00082,1,3042989,3050018,+,7029
6,BUMA.1121.00062,1,1603923,1610951,-,7028
6,BUMA.1121.00007,1,1109922,1116950,-,7028
6,BUMA.1121.00025,1,3865223,3872251,-,7028
6,BUMA.1121.00021,1,3545061,3552090,+,7029
6,BUMA.1121.00103,1,1419133,1426161,-,7028
6,BUMA.1121.00096,1,326998,334026,-,7028
6,BUMA.1121.00079,1,2979536,2986565,+,7029
6,BUMA.1121.00039,1,3085239,3092268,+,7029
6,BUMA.1121.00083,1,2729342,2736370,-,7028
6,BUMA.1121.00084,1,3311705,3318734,+,7029
6,BUMA.1121.00049,1,2867338,2874366,-,7028
6,BUMA.1121.00089,1,2901378,2908407,+,7029
6,BUMA.1121.00014,1,3968667,3975695,-,7028
6,BUMA.1121.00090,1,1021872,1028901,+,7029
6,BUMA.1121.00071,1,2874071,2881100,+,7029
6,BUMA.1121.00078,1,3053531,3060465,-,6934
6,BUMA.1121.00102,1,2340126,2347152,-,7026
6,BUMA.1121.00075,1,2438758,2445785,+,7027
6,BUMA.1121.00012,1,1698712,1705741,+,7029
6,BUMA.1121.00076,1,2366486,2373512,-,7026
6,BUMA.1121.00106,1,2697024,2704053,+,7029
6,BUMA.1121.00001,1,1134090,1141118,-,7028
6,BUMA.1121.00107,1,2885233,2892262,+,7029
6,BUMA.1121.00104,1,2296896,2303924,-,7028
6,BUMA.1121.00099,1,3463875,3470903,-,7028
6,BUMA.1121.00098,1,1604782,1611811,+,7029
6,BUMA.1121.00111,1,3117001,3124030,+,7029
6,BUMA.1121.00109,1,2961229,2968257,-,7028
6,BUMA.1121.00097,1,978876,985904,-,7028
6,BUMA.1121.00094,1,2930362,2937391,+,7029
6,BUMA.1121.00095,1,2766779,2773795,-,7016
6,BUMA.1121.00005,1,1659191,1666220,+,7029
6,BUMA.1121.00101,1,3499527,3506555,-,7028
6,BUMA.1121.00065,1,3011298,3018327,+,7029
6,BUMA.1121.00100,1,2378924,2385952,-,7028
6,BUMA.1121.00105,1,2250013,2257041,-,7028
6,BUMA.1121.00029,1,2018459,2025487,-,7028
6,BUMA.1121.00066,1,2859146,2866175,+,7029
6,BUMA.1121.00031,1,275080,282109,+,7029
6,BUMA.1121.00108,1,3982121,3989150,+,7029
6,BUMA.1121.00023,1,1265391,1272420,+,7029
6,BUMA.1121.00035,1,4099144,4106173,+,7029
6,BUMA.1121.00041,1,177139,184166,+,7027
5,BUMA.1121.00057,1,41159,50003,+,8844
5,BUMA.1121.00058,1,1582778,1591621,-,8843
5,BUMA.1121.00045,1,1119432,1128279,-,8847
5,BUMA.1121.00051,1,2903929,2912775,+,8846
5,BUMA.1121.00068,1,1707356,1716202,+,8846
5,BUMA.1121.00061,1,2875853,2884699,+,8846
5,BUMA.1121.00060,1,3364644,3373491,-,8847
5,BUMA.1121.00064,1,2941775,2950619,+,8844
5,BUMA.1121.00016,1,1049068,1057912,+,8844
5,BUMA.1121.00003,1,1425510,1434356,+,8846
5,BUMA.1121.00055,1,2617398,2626257,+,8859
5,BUMA.1121.00011,1,2723258,2732110,-,8852
5,BUMA.1121.00037,1,1539462,1548306,+,8844
5,BUMA.1121.00009,1,2638199,2647039,-,8840
5,BUMA.1121.00069,1,2845194,2854040,+,8846
5,BUMA.1121.00088,1,3847989,3856835,+,8846
5,BUMA.1121.00092,1,839201,848044,-,8843
5,BUMA.1121.00074,1,923622,932465,-,8843
5,BUMA.1121.00070,1,2846922,2855768,+,8846
5,BUMA.1121.00093,1,3778063,3786907,+,8844
5,BUMA.1121.00063,1,2872699,2881545,+,8846
5,BUMA.1121.00033,1,1125408,1134251,+,8843
5,BUMA.1121.00018,1,3528050,3536900,+,8850
5,BUMA.1121.00080,1,2935684,2944530,+,8846
5,BUMA.1121.00027,1,1126225,1135069,+,8844
5,BUMA.1121.00053,1,2698171,2707019,+,8848
5,BUMA.1121.00059,1,2164515,2173371,+,8856
5,BUMA.1121.00043,1,3020925,3029775,+,8850
5,BUMA.1121.00056,1,1026145,1034990,-,8845
5,BUMA.1121.00112,1,4128668,4137513,-,8845
5,BUMA.1121.00091,1,1576438,1585281,-,8843
5,BUMA.1121.00047,1,8148,16993,-,8845
5,BUMA.1121.00047,1,4083079,4091933,-,8854
5,BUMA.1121.00067,1,1477987,1486830,-,8843
5,BUMA.1121.00110,1,1876695,1885540,-,8845
5,BUMA.1121.00073,1,2874095,2882941,+,8846
5,BUMA.1121.00072,1,2846775,2855621,+,8846
5,BUMA.1121.00077,1,1597669,1606516,+,8847
5,BUMA.1121.00082,1,3033466,3042312,+,8846
5,BUMA.1121.00062,1,1620828,1629671,-,8843
5,BUMA.1121.00007,1,1117627,1126472,-,8845
5,BUMA.1121.00025,1,3872929,3881778,-,8849
5,BUMA.1121.00021,1,3535546,3544384,+,8838
5,BUMA.1121.00103,1,1426838,1435685,-,8847
5,BUMA.1121.00096,1,334689,343536,-,8847
5,BUMA.1121.00079,1,2970015,2978860,+,8845
5,BUMA.1121.00039,1,3075718,3084562,+,8844
5,BUMA.1121.00083,1,2737048,2745893,-,8845
5,BUMA.1121.00084,1,3302171,3311028,+,8857
5,BUMA.1121.00049,1,2889457,2898313,-,8856
5,BUMA.1121.00089,1,2891855,2900701,+,8846
5,BUMA.1121.00014,1,3976373,3985216,-,8843
5,BUMA.1121.00090,1,1012351,1021195,+,8844
5,BUMA.1121.00071,1,2864548,2873394,+,8846
5,BUMA.1121.00078,1,3067032,3075874,-,8842
5,BUMA.1121.00102,1,2347829,2356674,-,8845
5,BUMA.1121.00075,1,2429236,2438082,+,8846
5,BUMA.1121.00012,1,1689191,1698035,+,8844
5,BUMA.1121.00076,1,2374189,2383034,-,8845
5,BUMA.1121.00106,1,2676698,2685555,+,8857
5,BUMA.1121.00001,1,1141796,1150638,-,8842
5,BUMA.1121.00107,1,2875711,2884557,+,8846
5,BUMA.1121.00104,1,2304601,2313458,-,8857
5,BUMA.1121.00099,1,3471580,3480427,-,8847
5,BUMA.1121.00098,1,1595260,1604106,+,8846
5,BUMA.1121.00111,1,3107480,3116324,+,8844
5,BUMA.1121.00109,1,2968934,2977779,-,8845
5,BUMA.1121.00097,1,986581,995428,-,8847
5,BUMA.1121.00094,1,2920839,2929685,+,8846
5,BUMA.1121.00095,1,2774472,2783317,-,8845
5,BUMA.1121.00005,1,1640037,1648883,+,8846
5,BUMA.1121.00101,1,3507232,3516077,-,8845
5,BUMA.1121.00065,1,2992159,3001003,+,8844
5,BUMA.1121.00100,1,2386629,2395476,-,8847
5,BUMA.1121.00105,1,2257718,2266561,-,8843
5,BUMA.1121.00029,1,2026165,2035007,-,8842
5,BUMA.1121.00066,1,2849623,2858469,+,8846
5,BUMA.1121.00031,1,265559,274403,+,8844
5,BUMA.1121.00108,1,3972598,3981446,+,8848
5,BUMA.1121.00023,1,1255870,1264714,+,8844
5,BUMA.1121.00035,1,4089624,4098467,+,8843
5,BUMA.1121.00041,1,109181,118029,+,8848
4,BUMA.1121.00057,1,35736,40727,+,4991
4,BUMA.1121.00058,1,1592054,1597061,-,5007
4,BUMA.1121.00045,1,1128712,1133703,-,4991
4,BUMA.1121.00051,1,2898506,2903498,+,4992
4,BUMA.1121.00068,1,1701932,1706924,+,4992
4,BUMA.1121.00061,1,2870429,2875421,+,4992
4,BUMA.1121.00060,1,3373924,3378915,-,4991
4,BUMA.1121.00064,1,2936351,2941343,+,4992
4,BUMA.1121.00016,1,1043637,1048629,+,4992
4,BUMA.1121.00003,1,1420073,1425064,+,4991
4,BUMA.1121.00055,1,2612052,2617043,+,4991
4,BUMA.1121.00011,1,2732542,2737533,-,4991
4,BUMA.1121.00037,1,1534038,1539030,+,4992
4,BUMA.1121.00009,1,2647479,2652469,-,4990
4,BUMA.1121.00069,1,2839770,2844762,+,4992
4,BUMA.1121.00088,1,3842565,3847557,+,4992
4,BUMA.1121.00092,1,848477,853468,-,4991
4,BUMA.1121.00074,1,932898,937889,-,4991
4,BUMA.1121.00070,1,2841498,2846490,+,4992
4,BUMA.1121.00093,1,3772639,3777631,+,4992
4,BUMA.1121.00063,1,2867275,2872267,+,4992
4,BUMA.1121.00033,1,1119990,1124982,+,4992
4,BUMA.1121.00018,1,3522626,3527618,+,4992
4,BUMA.1121.00080,1,2930261,2935253,+,4992
4,BUMA.1121.00027,1,1120802,1125793,+,4991
4,BUMA.1121.00053,1,2692747,2697739,+,4992
4,BUMA.1121.00059,1,2159258,2164249,+,4991
4,BUMA.1121.00043,1,3015507,3020499,+,4992
4,BUMA.1121.00056,1,1035423,1040413,-,4990
4,BUMA.1121.00112,1,4137946,4142937,-,4991
4,BUMA.1121.00091,1,1585714,1590705,-,4991
4,BUMA.1121.00047,1,17426,22417,-,4991
4,BUMA.1121.00067,1,1487263,1492254,-,4991
4,BUMA.1121.00110,1,1885973,1890963,-,4990
4,BUMA.1121.00073,1,2868671,2873663,+,4992
4,BUMA.1121.00072,1,2841351,2846343,+,4992
4,BUMA.1121.00077,1,1592246,1597237,+,4991
4,BUMA.1121.00082,1,3028042,3033034,+,4992
4,BUMA.1121.00062,1,1630104,1635095,-,4991
4,BUMA.1121.00007,1,1126912,1131918,-,5006
4,BUMA.1121.00025,1,3882211,3887202,-,4991
4,BUMA.1121.00021,1,3530128,3535120,+,4992
4,BUMA.1121.00103,1,1436118,1441108,-,4990
4,BUMA.1121.00096,1,343969,348959,-,4990
4,BUMA.1121.00079,1,2964592,2969584,+,4992
4,BUMA.1121.00039,1,3070300,3075292,+,4992
4,BUMA.1121.00083,1,2746326,2751317,-,4991
4,BUMA.1121.00084,1,3296913,3301905,+,4992
4,BUMA.1121.00049,1,2898579,2903570,-,4991
4,BUMA.1121.00089,1,2886432,2891423,+,4991
4,BUMA.1121.00014,1,3985643,3990634,-,4991
4,BUMA.1121.00090,1,1006927,1011919,+,4992
4,BUMA.1121.00071,1,2859125,2864116,+,4991
4,BUMA.1121.00078,1,3076306,3081296,-,4990
4,BUMA.1121.00102,1,2357107,2362098,-,4991
4,BUMA.1121.00075,1,2423813,2428804,+,4991
4,BUMA.1121.00012,1,1683773,1688765,+,4992
4,BUMA.1121.00076,1,2383467,2388458,-,4991
4,BUMA.1121.00106,1,2671441,2676432,+,4991
4,BUMA.1121.00001,1,1151065,1156056,-,4991
4,BUMA.1121.00107,1,2870287,2875279,+,4992
4,BUMA.1121.00104,1,2313724,2318715,-,4991
4,BUMA.1121.00099,1,3480853,3485843,-,4990
4,BUMA.1121.00098,1,1589837,1594828,+,4991
4,BUMA.1121.00111,1,3102062,3107054,+,4992
4,BUMA.1121.00109,1,2978212,2983202,-,4990
4,BUMA.1121.00097,1,995861,1000851,-,4990
4,BUMA.1121.00094,1,2915416,2920407,+,4991
4,BUMA.1121.00095,1,2783750,2788740,-,4990
4,BUMA.1121.00005,1,1634609,1639600,+,4991
4,BUMA.1121.00101,1,3516510,3521501,-,4991
4,BUMA.1121.00065,1,2986735,2991727,+,4992
4,BUMA.1121.00100,1,2395909,2400899,-,4990
4,BUMA.1121.00105,1,2266994,2271984,-,4990
4,BUMA.1121.00029,1,2035434,2040425,-,4991
4,BUMA.1121.00066,1,2844199,2849191,+,4992
4,BUMA.1121.00031,1,260141,265133,+,4992
4,BUMA.1121.00108,1,3967175,3972166,+,4991
4,BUMA.1121.00023,1,1250447,1255438,+,4991
4,BUMA.1121.00035,1,4084206,4089198,+,4992
4,BUMA.1121.00041,1,103758,108749,+,4991
3,BUMA.1121.00057,1,24554,35735,+,11181
3,BUMA.1121.00058,1,1598659,1609825,-,11166
3,BUMA.1121.00045,1,1133705,1144868,-,11163
3,BUMA.1121.00051,1,2887362,2898505,+,11143
3,BUMA.1121.00068,1,1690787,1701931,+,11144
3,BUMA.1121.00061,1,2859248,2870428,+,11180
3,BUMA.1121.00060,1,3378917,3390086,-,11169
3,BUMA.1121.00064,1,2925210,2936350,+,11140
3,BUMA.1121.00016,1,1032430,1043636,+,11206
3,BUMA.1121.00003,1,1408890,1420072,+,11182
3,BUMA.1121.00055,1,2600887,2612051,+,11164
3,BUMA.1121.00011,1,2737535,2748714,-,11179
3,BUMA.1121.00037,1,1522862,1534037,+,11175
3,BUMA.1121.00009,1,2652471,2663634,-,11163
3,BUMA.1121.00069,1,2828599,2839769,+,11170
3,BUMA.1121.00088,1,3831367,3842564,+,11197
3,BUMA.1121.00092,1,853470,864655,-,11185
3,BUMA.1121.00074,1,937891,949048,-,11157
3,BUMA.1121.00070,1,2830319,2841497,+,11178
3,BUMA.1121.00093,1,3761453,3772638,+,11185
3,BUMA.1121.00063,1,2856093,2867274,+,11181
3,BUMA.1121.00033,1,1108827,1119989,+,11162
3,BUMA.1121.00018,1,3511477,3522625,+,11148
3,BUMA.1121.00080,1,2919118,2930260,+,11142
3,BUMA.1121.00027,1,1109607,1120801,+,11194
3,BUMA.1121.00053,1,2681576,2692746,+,11170
3,BUMA.1121.00059,1,2148083,2159257,+,11174
3,BUMA.1121.00043,1,3004348,3015506,+,11158
3,BUMA.1121.00056,1,1040415,1051602,-,11187
3,BUMA.1121.00112,1,4142939,4154112,-,11173
3,BUMA.1121.00091,1,1590707,1601887,-,11180
3,BUMA.1121.00047,1,22419,33560,-,11141
3,BUMA.1121.00067,1,1492256,1503395,-,11139
3,BUMA.1121.00110,1,1890965,1902132,-,11167
3,BUMA.1121.00073,1,2857492,2868670,+,11178
3,BUMA.1121.00072,1,2830176,2841350,+,11174
3,BUMA.1121.00077,1,1581077,1592245,+,11168
3,BUMA.1121.00082,1,3016860,3028041,+,11181
3,BUMA.1121.00062,1,1635097,1646226,-,11129
3,BUMA.1121.00007,1,1133516,1144653,-,11137
3,BUMA.1121.00025,1,3887204,3898357,-,11153
3,BUMA.1121.00021,1,3518966,3530127,+,11161
3,BUMA.1121.00103,1,1441110,1452254,-,11144
3,BUMA.1121.00096,1,348961,360119,-,11158
3,BUMA.1121.00079,1,2953450,2964591,+,11141
3,BUMA.1121.00039,1,3059142,3070299,+,11157
3,BUMA.1121.00083,1,2751319,2762499,-,11180
3,BUMA.1121.00084,1,3285681,3296912,+,11231
3,BUMA.1121.00049,1,2903572,2914749,-,11177
3,BUMA.1121.00089,1,2875243,2886431,+,11188
3,BUMA.1121.00014,1,3990636,4001810,-,11174
3,BUMA.1121.00090,1,995728,1006926,+,11198
3,BUMA.1121.00071,1,2847943,2859124,+,11181
3,BUMA.1121.00078,1,3081298,3092440,-,11142
3,BUMA.1121.00102,1,2362100,2373309,-,11209
3,BUMA.1121.00075,1,2412592,2423812,+,11220
3,BUMA.1121.00012,1,1672627,1683772,+,11145
3,BUMA.1121.00076,1,2388460,2399679,-,11219
3,BUMA.1121.00106,1,2660227,2671440,+,11213
3,BUMA.1121.00001,1,1156058,1167255,-,11197
3,BUMA.1121.00107,1,2859132,2870286,+,11154
3,BUMA.1121.00104,1,2318717,2329894,-,11177
3,BUMA.1121.00099,1,3485845,3497029,-,11184
3,BUMA.1121.00098,1,1578699,1589836,+,11137
3,BUMA.1121.00111,1,3090849,3102061,+,11212
3,BUMA.1121.00109,1,2983204,2994348,-,11144
3,BUMA.1121.00097,1,1000853,1012067,-,11214
3,BUMA.1121.00094,1,2904234,2915415,+,11181
3,BUMA.1121.00095,1,2788742,2799945,-,11203
3,BUMA.1121.00005,1,1623480,1634608,+,11128
3,BUMA.1121.00101,1,3521503,3532694,-,11191
3,BUMA.1121.00065,1,2975526,2986734,+,11208
3,BUMA.1121.00100,1,2400901,2412095,-,11194
3,BUMA.1121.00105,1,2271986,2283203,-,11217
3,BUMA.1121.00029,1,2040427,2051591,-,11164
3,BUMA.1121.00066,1,2833017,2844198,+,11181
3,BUMA.1121.00031,1,248965,260140,+,11175
3,BUMA.1121.00108,1,3955976,3967174,+,11198
3,BUMA.1121.00023,1,1239268,1250446,+,11178
3,BUMA.1121.00035,1,4073007,4084205,+,11198
3,BUMA.1121.00041,1,92579,103757,+,11178
2,BUMA.1121.00057,1,5853,20358,+,14505
2,BUMA.1121.00058,1,1614031,1627259,-,13228
2,BUMA.1121.00045,1,1149068,1162292,-,13224
2,BUMA.1121.00051,1,2869981,2883168,+,13187
2,BUMA.1121.00068,1,1673375,1686587,+,13212
2,BUMA.1121.00061,1,2840588,2855054,+,14466
2,BUMA.1121.00060,1,3394286,3407510,-,13224
2,BUMA.1121.00064,1,2907806,2921016,+,13210
2,BUMA.1121.00016,1,1014880,1028236,+,13356
2,BUMA.1121.00003,1,1391504,1404690,+,13186
2,BUMA.1121.00055,1,2583492,2596685,+,13193
2,BUMA.1121.00011,1,2752914,2766210,-,13296
2,BUMA.1121.00037,1,1505413,1518668,+,13255
2,BUMA.1121.00009,1,2667828,2681130,-,13302
2,BUMA.1121.00069,1,2809901,2824405,+,14504
2,BUMA.1121.00088,1,3813971,3827177,+,13206
2,BUMA.1121.00092,1,868844,882061,-,13217
2,BUMA.1121.00074,1,953242,966459,-,13217
2,BUMA.1121.00070,1,2811707,2826135,+,14428
2,BUMA.1121.00093,1,3744047,3757263,+,13216
2,BUMA.1121.00063,1,2837416,2851899,+,14483
2,BUMA.1121.00033,1,1091348,1104633,+,13285
2,BUMA.1121.00018,1,3494024,3507283,+,13259
2,BUMA.1121.00080,1,2901731,2914924,+,13193
2,BUMA.1121.00027,1,1090900,1105405,+,14505
2,BUMA.1121.00053,1,2664136,2677376,+,13240
2,BUMA.1121.00059,1,2130685,2143889,+,13204
2,BUMA.1121.00043,1,2986841,3000154,+,13313
2,BUMA.1121.00056,1,1055802,1068990,-,13188
2,BUMA.1121.00112,1,4158312,4171513,-,13201
2,BUMA.1121.00091,1,1606087,1619345,-,13258
2,BUMA.1121.00047,1,37754,50942,-,13188
2,BUMA.1121.00067,1,1507589,1520812,-,13223
2,BUMA.1121.00110,1,1906326,1919543,-,13217
2,BUMA.1121.00073,1,2838823,2853308,+,14485
2,BUMA.1121.00072,1,2811465,2825982,+,14517
2,BUMA.1121.00077,1,1563669,1576883,+,13214
2,BUMA.1121.00082,1,2998149,3012666,+,14517
2,BUMA.1121.00062,1,1650426,1663671,-,13245
2,BUMA.1121.00007,1,1148853,1162116,-,13263
2,BUMA.1121.00025,1,3902551,3915811,-,13260
2,BUMA.1121.00021,1,3501472,3514772,+,13300
2,BUMA.1121.00103,1,1456448,1469668,-,13220
2,BUMA.1121.00096,1,364319,377702,-,13383
2,BUMA.1121.00079,1,2936069,2949256,+,13187
2,BUMA.1121.00039,1,3041638,3054948,+,13310
2,BUMA.1121.00083,1,2766693,2781211,-,14518
2,BUMA.1121.00084,1,3268285,3281491,+,13206
2,BUMA.1121.00049,1,2918949,2932170,-,13221
2,BUMA.1121.00089,1,2857856,2871043,+,13187
2,BUMA.1121.00014,1,4006004,4019251,-,13247
2,BUMA.1121.00090,1,978240,991534,+,13294
2,BUMA.1121.00071,1,2829278,2843749,+,14471
2,BUMA.1121.00078,1,3096640,3109820,-,13180
2,BUMA.1121.00102,1,2377505,2390727,-,13222
2,BUMA.1121.00075,1,2393826,2408392,+,14566
2,BUMA.1121.00012,1,1655165,1668433,+,13268
2,BUMA.1121.00076,1,2403879,2418449,-,14570
2,BUMA.1121.00106,1,2642770,2656025,+,13255
2,BUMA.1121.00001,1,1171449,1184787,-,13338
2,BUMA.1121.00107,1,2841762,2854938,+,13176
2,BUMA.1121.00104,1,2334094,2348622,-,14528
2,BUMA.1121.00099,1,3501229,3514439,-,13210
2,BUMA.1121.00098,1,1561336,1574511,+,13175
2,BUMA.1121.00111,1,3073402,3086655,+,13253
2,BUMA.1121.00109,1,2998542,3011844,-,13302
2,BUMA.1121.00097,1,1016261,1029475,-,13214
2,BUMA.1121.00094,1,2886847,2900034,+,13187
2,BUMA.1121.00095,1,2804139,2817335,-,13196
2,BUMA.1121.00005,1,1606070,1619280,+,13210
2,BUMA.1121.00101,1,3536888,3550077,-,13189
2,BUMA.1121.00065,1,2958060,2971326,+,13266
2,BUMA.1121.00100,1,2416289,2429536,-,13247
2,BUMA.1121.00105,1,2287409,2300583,-,13174
2,BUMA.1121.00029,1,2055785,2069208,-,13423
2,BUMA.1121.00066,1,2814306,2828823,+,14517
2,BUMA.1121.00031,1,231513,244771,+,13258
2,BUMA.1121.00108,1,3938540,3951776,+,13236
2,BUMA.1121.00023,1,1221754,1235074,+,13320
2,BUMA.1121.00035,1,4055407,4068813,+,13406
2,BUMA.1121.00041,1,75168,88379,+,13211
1,BUMA.1121.00057,1,1,5432,+,5431
1,BUMA.1121.00058,1,1627679,1633149,-,5470
1,BUMA.1121.00045,1,1162712,1168183,-,5471
1,BUMA.1121.00051,1,2864093,2869560,+,5467
1,BUMA.1121.00068,1,1667477,1672947,+,5470
1,BUMA.1121.00061,1,2834698,2840167,+,5469
1,BUMA.1121.00060,1,3407930,3413401,-,5471
1,BUMA.1121.00064,1,2901916,2907385,+,5469
1,BUMA.1121.00016,1,1009108,1014459,+,5351
1,BUMA.1121.00003,1,1385606,1391085,+,5479
1,BUMA.1121.00055,1,2577635,2583071,+,5436
1,BUMA.1121.00011,1,2766635,2772106,-,5471
1,BUMA.1121.00037,1,1499556,1504992,+,5436
1,BUMA.1121.00009,1,2681555,2687026,-,5471
1,BUMA.1121.00069,1,2804011,2809480,+,5469
1,BUMA.1121.00088,1,3808078,3813550,+,5472
1,BUMA.1121.00092,1,882481,887951,-,5470
1,BUMA.1121.00074,1,966879,972349,-,5470
1,BUMA.1121.00070,1,2805817,2811286,+,5469
1,BUMA.1121.00093,1,3738157,3743626,+,5469
1,BUMA.1121.00063,1,2831526,2836995,+,5469
1,BUMA.1121.00033,1,1085576,1090927,+,5351
1,BUMA.1121.00018,1,3488252,3493603,+,5351
1,BUMA.1121.00080,1,2895841,2901310,+,5469
1,BUMA.1121.00027,1,1085011,1090479,+,5468
1,BUMA.1121.00053,1,2658245,2663715,+,5470
1,BUMA.1121.00059,1,2124795,2130264,+,5469
1,BUMA.1121.00043,1,2981069,2986420,+,5351
1,BUMA.1121.00056,1,1069410,1074880,-,5470
1,BUMA.1121.00112,1,4171933,4177404,-,5471
1,BUMA.1121.00091,1,1619765,1625236,-,5471
1,BUMA.1121.00047,1,51362,56832,-,5470
1,BUMA.1121.00067,1,1521232,1526702,-,5470
1,BUMA.1121.00110,1,1919963,1925434,-,5471
1,BUMA.1121.00073,1,2832933,2838402,+,5469
1,BUMA.1121.00072,1,2805575,2811044,+,5469
1,BUMA.1121.00077,1,1557778,1563248,+,5470
1,BUMA.1121.00082,1,2992259,2997728,+,5469
1,BUMA.1121.00062,1,1664091,1669561,-,5470
1,BUMA.1121.00007,1,1162541,1168012,-,5471
1,BUMA.1121.00025,1,3916231,3921583,-,5352
1,BUMA.1121.00021,1,3495615,3501051,+,5436
1,BUMA.1121.00103,1,1470080,1475559,-,5479
1,BUMA.1121.00096,1,378122,383593,-,5471
1,BUMA.1121.00079,1,2930179,2935648,+,5469
1,BUMA.1121.00039,1,3035781,3041217,+,5436
1,BUMA.1121.00083,1,2781631,2787101,-,5470
1,BUMA.1121.00084,1,3262392,3267864,+,5472
1,BUMA.1121.00049,1,2932590,2938060,-,5470
1,BUMA.1121.00089,1,2851966,2857435,+,5469
1,BUMA.1121.00014,1,4019671,4025108,-,5437
1,BUMA.1121.00090,1,972383,977819,+,5436
1,BUMA.1121.00071,1,2823388,2828857,+,5469
1,BUMA.1121.00078,1,3110240,3115677,-,5437
1,BUMA.1121.00102,1,2391147,2396618,-,5471
1,BUMA.1121.00075,1,2387935,2393405,+,5470
1,BUMA.1121.00012,1,1649308,1654744,+,5436
1,BUMA.1121.00076,1,2418869,2424340,-,5471
1,BUMA.1121.00106,1,2636880,2642349,+,5469
1,BUMA.1121.00001,1,1185207,1190559,-,5352
1,BUMA.1121.00107,1,2835871,2841350,+,5479
1,BUMA.1121.00104,1,2349042,2354512,-,5470
1,BUMA.1121.00099,1,3514859,3520328,-,5469
1,BUMA.1121.00098,1,1555440,1560910,+,5470
1,BUMA.1121.00111,1,3067545,3072981,+,5436
1,BUMA.1121.00109,1,3012264,3017744,-,5480
1,BUMA.1121.00097,1,1029887,1035366,-,5479
1,BUMA.1121.00094,1,2880957,2886426,+,5469
1,BUMA.1121.00095,1,2817755,2823213,-,5458
1,BUMA.1121.00005,1,1600179,1605649,+,5470
1,BUMA.1121.00101,1,3550497,3555968,-,5471
1,BUMA.1121.00065,1,2952170,2957639,+,5469
1,BUMA.1121.00100,1,2429956,2435436,-,5480
1,BUMA.1121.00105,1,2302354,2307827,-,5473
1,BUMA.1121.00029,1,2069628,2074980,-,5352
1,BUMA.1121.00066,1,2808416,2813885,+,5469
1,BUMA.1121.00031,1,225656,231092,+,5436
1,BUMA.1121.00108,1,3932649,3938119,+,5470
1,BUMA.1121.00023,1,1215897,1221333,+,5436
1,BUMA.1121.00035,1,4049635,4054986,+,5351
1,BUMA.1121.00041,1,69277,74747,+,5470
14,BUMA.1121.00057,1,166797,193091,+,26294
14,BUMA.1121.00058,1,1427922,1454207,-,26285
14,BUMA.1121.00045,1,976278,1002550,-,26272
14,BUMA.1121.00051,1,3029663,3057288,+,27625
14,BUMA.1121.00068,1,1858166,1884478,+,26312
14,BUMA.1121.00061,1,3001573,3027791,+,26218
14,BUMA.1121.00060,1,3221502,3247780,-,26278
14,BUMA.1121.00064,1,3067553,3093868,+,26315
14,BUMA.1121.00016,1,1177840,1204128,+,26288
14,BUMA.1121.00003,1,1584482,1610741,+,26259
14,BUMA.1121.00055,1,2743085,2769380,+,26295
14,BUMA.1121.00011,1,2555713,2581985,-,26272
14,BUMA.1121.00037,1,1699072,1725370,+,26298
14,BUMA.1121.00009,1,2468360,2494651,-,26291
14,BUMA.1121.00069,1,2970920,2997199,+,26279
14,BUMA.1121.00088,1,4035972,4062276,+,26304
14,BUMA.1121.00092,1,695804,722155,-,26351
14,BUMA.1121.00074,1,780395,806702,-,26307
14,BUMA.1121.00070,1,2972660,2998878,+,26218
14,BUMA.1121.00093,1,3903964,3930316,+,26352
14,BUMA.1121.00063,1,2998437,3024661,+,26224
14,BUMA.1121.00033,1,1281670,1307952,+,26282
14,BUMA.1121.00018,1,3696047,3722353,+,26306
14,BUMA.1121.00080,1,3078308,3105915,+,27607
14,BUMA.1121.00027,1,1251989,1278273,+,26284
14,BUMA.1121.00053,1,2823910,2850229,+,26319
14,BUMA.1121.00059,1,2290224,2316521,+,26297
14,BUMA.1121.00043,1,3196426,3222721,+,26295
14,BUMA.1121.00056,1,881586,909198,-,27612
14,BUMA.1121.00112,1,3985494,4011767,-,26273
14,BUMA.1121.00091,1,1420945,1447237,-,26292
14,BUMA.1121.00047,1,3922960,3950598,-,27638
14,BUMA.1121.00067,1,1334749,1361062,-,26313
14,BUMA.1121.00110,1,1728806,1755101,-,26295
14,BUMA.1121.00073,1,2999835,3026060,+,26225
14,BUMA.1121.00072,1,2972410,2998692,+,26282
14,BUMA.1121.00077,1,1728131,1754428,+,26297
14,BUMA.1121.00082,1,3169004,3195286,+,26282
14,BUMA.1121.00062,1,1468420,1494717,-,26297
14,BUMA.1121.00007,1,971509,997840,-,26331
14,BUMA.1121.00025,1,3687477,3713782,-,26305
14,BUMA.1121.00021,1,3724582,3750899,+,26317
14,BUMA.1121.00103,1,1280613,1306882,-,26269
14,BUMA.1121.00096,1,184378,210715,-,26337
14,BUMA.1121.00079,1,3112560,3138795,+,26235
14,BUMA.1121.00039,1,3212000,3238312,+,26312
14,BUMA.1121.00083,1,2584074,2610355,-,26281
14,BUMA.1121.00084,1,3427907,3454162,+,26255
14,BUMA.1121.00049,1,2731995,2758260,-,26265
14,BUMA.1121.00089,1,3017647,3045260,+,27613
14,BUMA.1121.00014,1,3831587,3857873,-,26286
14,BUMA.1121.00090,1,1139344,1165645,+,26301
14,BUMA.1121.00071,1,2990269,3016550,+,26281
14,BUMA.1121.00078,1,2917977,2944289,-,26312
14,BUMA.1121.00102,1,2204505,2230797,-,26292
14,BUMA.1121.00075,1,2556618,2582894,+,26276
14,BUMA.1121.00012,1,1816646,1842973,+,26327
14,BUMA.1121.00076,1,2229394,2255663,-,26269
14,BUMA.1121.00106,1,2813140,2839384,+,26244
14,BUMA.1121.00001,1,959834,986127,-,26293
14,BUMA.1121.00107,1,3002987,3029282,+,26295
14,BUMA.1121.00104,1,2161448,2187739,-,26291
14,BUMA.1121.00099,1,3328311,3354657,-,26346
14,BUMA.1121.00098,1,1721048,1747333,+,26285
14,BUMA.1121.00111,1,3250771,3277058,+,26287
14,BUMA.1121.00109,1,2819097,2845362,-,26265
14,BUMA.1121.00097,1,843406,869697,-,26291
14,BUMA.1121.00094,1,3046620,3074233,+,27613
14,BUMA.1121.00095,1,2619376,2645682,-,26306
14,BUMA.1121.00005,1,1783708,1809994,+,26286
14,BUMA.1121.00101,1,3363994,3390311,-,26317
14,BUMA.1121.00065,1,3127644,3153911,+,26267
14,BUMA.1121.00100,1,2209360,2235622,-,26262
14,BUMA.1121.00105,1,2114487,2140764,-,26277
14,BUMA.1121.00029,1,1833428,1859721,-,26293
14,BUMA.1121.00066,1,2975325,3001607,+,26282
14,BUMA.1121.00031,1,392909,419196,+,26287
14,BUMA.1121.00108,1,67253,93522,+,26269
14,BUMA.1121.00023,1,1402139,1428472,+,26333
14,BUMA.1121.00035,1,107066,133354,+,26288
14,BUMA.1121.00041,1,300886,327185,+,26299
15,BUMA.1121.00057,1,195759,203868,+,8109
15,BUMA.1121.00058,1,1417144,1425254,-,8110
15,BUMA.1121.00045,1,965500,973610,-,8110
15,BUMA.1121.00051,1,3059956,3068065,+,8109
15,BUMA.1121.00068,1,1887145,1895254,+,8109
15,BUMA.1121.00060,1,3210723,3218833,-,8110
15,BUMA.1121.00064,1,3096535,3104644,+,8109
15,BUMA.1121.00016,1,1206795,1214904,+,8109
15,BUMA.1121.00003,1,1613408,1621517,+,8109
15,BUMA.1121.00055,1,2772048,2780159,+,8111
15,BUMA.1121.00011,1,2544936,2553046,-,8110
15,BUMA.1121.00037,1,1728037,1736146,+,8109
15,BUMA.1121.00009,1,2457582,2465692,-,8110
15,BUMA.1121.00069,1,2999867,3007976,+,8109
15,BUMA.1121.00088,1,4064944,4073053,+,8109
15,BUMA.1121.00092,1,685026,693136,-,8110
15,BUMA.1121.00074,1,769618,777728,-,8110
15,BUMA.1121.00093,1,3932984,3941093,+,8109
15,BUMA.1121.00033,1,1310619,1318726,+,8107
15,BUMA.1121.00018,1,3725020,3733128,+,8108
15,BUMA.1121.00080,1,3108583,3116692,+,8109
15,BUMA.1121.00027,1,1280941,1289048,+,8107
15,BUMA.1121.00053,1,2852896,2861005,+,8109
15,BUMA.1121.00059,1,2319189,2327298,+,8109
15,BUMA.1121.00043,1,3225388,3233497,+,8109
15,BUMA.1121.00056,1,870808,878918,-,8110
15,BUMA.1121.00112,1,3974717,3982827,-,8110
15,BUMA.1121.00047,1,3912182,3920292,-,8110
15,BUMA.1121.00067,1,1323972,1332082,-,8110
15,BUMA.1121.00110,1,1718028,1726138,-,8110
15,BUMA.1121.00072,1,3001360,3009469,+,8109
15,BUMA.1121.00077,1,1757096,1765207,+,8111
15,BUMA.1121.00082,1,3197954,3206063,+,8109
15,BUMA.1121.00062,1,1457642,1465752,-,8110
15,BUMA.1121.00007,1,960732,968842,-,8110
15,BUMA.1121.00025,1,3676700,3684810,-,8110
15,BUMA.1121.00021,1,3753566,3761675,+,8109
15,BUMA.1121.00103,1,1269836,1277946,-,8110
15,BUMA.1121.00096,1,173601,181711,-,8110
15,BUMA.1121.00079,1,3141462,3149571,+,8109
15,BUMA.1121.00039,1,3240979,3249088,+,8109
15,BUMA.1121.00083,1,2573296,2581406,-,8110
15,BUMA.1121.00084,1,3456830,3464939,+,8109
15,BUMA.1121.00049,1,2721218,2729328,-,8110
15,BUMA.1121.00089,1,3047928,3056037,+,8109
15,BUMA.1121.00014,1,3819475,3828920,-,9445
15,BUMA.1121.00090,1,1168312,1176421,+,8109
15,BUMA.1121.00071,1,3019218,3027327,+,8109
15,BUMA.1121.00078,1,2907200,2915310,-,8110
15,BUMA.1121.00102,1,2193728,2201838,-,8110
15,BUMA.1121.00075,1,2585562,2593671,+,8109
15,BUMA.1121.00012,1,1845640,1853749,+,8109
15,BUMA.1121.00076,1,2218616,2226726,-,8110
15,BUMA.1121.00106,1,2842052,2850161,+,8109
15,BUMA.1121.00001,1,949058,957167,-,8109
15,BUMA.1121.00107,1,3031955,3040064,+,8109
15,BUMA.1121.00104,1,2150670,2158780,-,8110
15,BUMA.1121.00099,1,3317534,3325644,-,8110
15,BUMA.1121.00098,1,1750000,1758109,+,8109
15,BUMA.1121.00111,1,3279725,3287834,+,8109
15,BUMA.1121.00109,1,2808320,2816430,-,8110
15,BUMA.1121.00097,1,832629,840739,-,8110
15,BUMA.1121.00094,1,3076901,3085010,+,8109
15,BUMA.1121.00101,1,3353217,3361327,-,8110
15,BUMA.1121.00065,1,3156578,3164687,+,8109
15,BUMA.1121.00105,1,2103710,2111820,-,8110
15,BUMA.1121.00029,1,1822651,1830761,-,8110
15,BUMA.1121.00066,1,3004275,3012384,+,8109
15,BUMA.1121.00031,1,421863,429972,+,8109
15,BUMA.1121.00108,1,96190,104299,+,8109
15,BUMA.1121.00023,1,1431139,1439248,+,8109
15,BUMA.1121.00035,1,136021,144130,+,8109
16,BUMA.1121.00057,1,203870,209595,+,5725
16,BUMA.1121.00058,1,1411417,1417143,-,5726
16,BUMA.1121.00045,1,959773,965499,-,5726
16,BUMA.1121.00051,1,3068067,3073792,+,5725
16,BUMA.1121.00068,1,1895256,1900981,+,5725
16,BUMA.1121.00060,1,3204996,3210722,-,5726
16,BUMA.1121.00064,1,3104646,3110371,+,5725
16,BUMA.1121.00016,1,1214906,1220631,+,5725
16,BUMA.1121.00003,1,1621519,1627245,+,5726
16,BUMA.1121.00055,1,2780161,2785886,+,5725
16,BUMA.1121.00011,1,2504384,2510079,-,5695
16,BUMA.1121.00011,1,2539210,2544935,-,5725
16,BUMA.1121.00037,1,1736148,1741873,+,5725
16,BUMA.1121.00009,1,2451855,2457581,-,5726
16,BUMA.1121.00069,1,3007978,3013703,+,5725
16,BUMA.1121.00088,1,4073055,4078780,+,5725
16,BUMA.1121.00092,1,679299,685025,-,5726
16,BUMA.1121.00074,1,763891,769617,-,5726
16,BUMA.1121.00093,1,3941095,3946820,+,5725
16,BUMA.1121.00033,1,1318728,1324452,+,5724
16,BUMA.1121.00018,1,3733130,3738854,+,5724
16,BUMA.1121.00080,1,3116694,3122419,+,5725
16,BUMA.1121.00027,1,1289050,1294775,+,5725
16,BUMA.1121.00053,1,2861007,2866732,+,5725
16,BUMA.1121.00059,1,2327300,2333025,+,5725
16,BUMA.1121.00043,1,3233499,3239224,+,5725
16,BUMA.1121.00056,1,865081,870807,-,5726
16,BUMA.1121.00112,1,3968990,3974716,-,5726
16,BUMA.1121.00047,1,3906455,3912181,-,5726
16,BUMA.1121.00067,1,1318245,1323971,-,5726
16,BUMA.1121.00110,1,1712301,1718027,-,5726
16,BUMA.1121.00072,1,3009471,3015196,+,5725
16,BUMA.1121.00077,1,1765209,1770935,+,5726
16,BUMA.1121.00082,1,3206065,3211790,+,5725
16,BUMA.1121.00062,1,1451915,1457641,-,5726
16,BUMA.1121.00007,1,955005,960731,-,5726
16,BUMA.1121.00025,1,3670973,3676699,-,5726
16,BUMA.1121.00021,1,3761677,3767402,+,5725
16,BUMA.1121.00103,1,1264109,1269835,-,5726
16,BUMA.1121.00096,1,167874,173600,-,5726
16,BUMA.1121.00079,1,3149573,3155298,+,5725
16,BUMA.1121.00039,1,3249090,3254815,+,5725
16,BUMA.1121.00083,1,2567569,2573295,-,5726
16,BUMA.1121.00084,1,3464941,3470666,+,5725
16,BUMA.1121.00049,1,2715491,2721217,-,5726
16,BUMA.1121.00089,1,3056039,3061764,+,5725
16,BUMA.1121.00014,1,3813748,3819474,-,5726
16,BUMA.1121.00090,1,1176423,1182148,+,5725
16,BUMA.1121.00071,1,3027329,3033054,+,5725
16,BUMA.1121.00078,1,2901473,2907199,-,5726
16,BUMA.1121.00102,1,2188001,2193727,-,5726
16,BUMA.1121.00075,1,2593673,2599398,+,5725
16,BUMA.1121.00012,1,1853751,1859476,+,5725
16,BUMA.1121.00076,1,2212889,2218615,-,5726
16,BUMA.1121.00106,1,2850163,2855888,+,5725
16,BUMA.1121.00001,1,943331,949057,-,5726
16,BUMA.1121.00107,1,3040066,3045791,+,5725
16,BUMA.1121.00104,1,2144943,2150669,-,5726
16,BUMA.1121.00099,1,3311807,3317533,-,5726
16,BUMA.1121.00098,1,1758111,1763836,+,5725
16,BUMA.1121.00111,1,3287836,3293558,+,5722
16,BUMA.1121.00109,1,2802593,2808319,-,5726
16,BUMA.1121.00097,1,826902,832628,-,5726
16,BUMA.1121.00094,1,3085012,3090737,+,5725
16,BUMA.1121.00101,1,3347490,3353216,-,5726
16,BUMA.1121.00065,1,3164689,3170414,+,5725
16,BUMA.1121.00105,1,2097983,2103709,-,5726
16,BUMA.1121.00029,1,1816924,1822650,-,5726
16,BUMA.1121.00066,1,3012386,3018111,+,5725
16,BUMA.1121.00031,1,429974,435699,+,5725
16,BUMA.1121.00108,1,104301,110026,+,5725
16,BUMA.1121.00023,1,1439250,1444975,+,5725
16,BUMA.1121.00035,1,144132,149857,+,5725
17,BUMA.1121.00057,1,209597,224551,+,14954
17,BUMA.1121.00058,1,1396342,1411416,-,15074
17,BUMA.1121.00045,1,944637,959772,-,15135
17,BUMA.1121.00051,1,3073794,3088788,+,14994
17,BUMA.1121.00068,1,1900983,1915913,+,14930
17,BUMA.1121.00061,1,3030192,3045096,+,14904
17,BUMA.1121.00060,1,3189868,3204995,-,15127
17,BUMA.1121.00064,1,3110373,3125399,+,15026
17,BUMA.1121.00016,1,1220633,1235669,+,15036
17,BUMA.1121.00003,1,1627247,1642230,+,14983
17,BUMA.1121.00055,1,2785888,2800858,+,14970
17,BUMA.1121.00011,1,2489073,2504383,-,15310
17,BUMA.1121.00011,1,2523935,2539209,-,15274
17,BUMA.1121.00037,1,1741875,1756897,+,15022
17,BUMA.1121.00009,1,2436767,2451854,-,15087
17,BUMA.1121.00069,1,3013705,3028667,+,14962
17,BUMA.1121.00088,1,4078782,4093784,+,15002
17,BUMA.1121.00092,1,664315,679298,-,14983
17,BUMA.1121.00074,1,748864,763890,-,15026
17,BUMA.1121.00070,1,3001360,3016216,+,14856
17,BUMA.1121.00093,1,3946822,3961805,+,14983
17,BUMA.1121.00063,1,3027051,3041955,+,14904
17,BUMA.1121.00033,1,1324454,1339423,+,14969
17,BUMA.1121.00018,1,3738856,3753922,+,15066
17,BUMA.1121.00080,1,3122421,3137495,+,15074
17,BUMA.1121.00027,1,1294777,1309735,+,14958
17,BUMA.1121.00053,1,2866734,2881704,+,14970
17,BUMA.1121.00059,1,2333027,2348146,+,15119
17,BUMA.1121.00043,1,3239226,3254206,+,14980
17,BUMA.1121.00056,1,850046,865080,-,15034
17,BUMA.1121.00112,1,3954030,3968989,-,14959
17,BUMA.1121.00091,1,1371608,1386618,-,15010
17,BUMA.1121.00047,1,3891444,3906454,-,15010
17,BUMA.1121.00067,1,1303202,1318244,-,15042
17,BUMA.1121.00110,1,1697274,1712300,-,15026
17,BUMA.1121.00073,1,3028530,3043434,+,14904
17,BUMA.1121.00072,1,3015198,3030160,+,14962
17,BUMA.1121.00077,1,1770937,1785963,+,15026
17,BUMA.1121.00082,1,3211792,3226754,+,14962
17,BUMA.1121.00062,1,1436936,1451914,-,14978
17,BUMA.1121.00007,1,940089,955004,-,14915
17,BUMA.1121.00025,1,3655922,3670972,-,15050
17,BUMA.1121.00021,1,3767404,3782430,+,15026
17,BUMA.1121.00103,1,1249126,1264108,-,14982
17,BUMA.1121.00096,1,152863,167873,-,15010
17,BUMA.1121.00079,1,3155300,3170350,+,15050
17,BUMA.1121.00039,1,3254817,3269771,+,14954
17,BUMA.1121.00083,1,2552606,2567568,-,14962
17,BUMA.1121.00084,1,3470668,3485646,+,14978
17,BUMA.1121.00049,1,2700472,2715490,-,15018
17,BUMA.1121.00089,1,3061766,3076800,+,15034
17,BUMA.1121.00014,1,3798729,3813747,-,15018
17,BUMA.1121.00090,1,1182150,1197192,+,15042
17,BUMA.1121.00071,1,3033056,3048018,+,14962
17,BUMA.1121.00078,1,2886454,2901472,-,15018
17,BUMA.1121.00102,1,2173006,2188000,-,14994
17,BUMA.1121.00075,1,2599400,2614377,+,14977
17,BUMA.1121.00012,1,1859478,1874464,+,14986
17,BUMA.1121.00076,1,2197910,2212888,-,14978
17,BUMA.1121.00106,1,2855890,2870956,+,15066
17,BUMA.1121.00001,1,928294,943330,-,15036
17,BUMA.1121.00107,1,3045793,3060819,+,15026
17,BUMA.1121.00104,1,2129908,2144942,-,15034
17,BUMA.1121.00099,1,3296876,3311806,-,14930
17,BUMA.1121.00098,1,1763838,1778880,+,15042
17,BUMA.1121.00111,1,3293560,3308554,+,14994
17,BUMA.1121.00109,1,2787586,2802592,-,15006
17,BUMA.1121.00097,1,811842,826901,-,15059
17,BUMA.1121.00094,1,3090739,3105773,+,15034
17,BUMA.1121.00095,1,2568551,2583601,-,15050
17,BUMA.1121.00005,1,1842351,1857336,+,14985
17,BUMA.1121.00101,1,3332479,3347489,-,15010
17,BUMA.1121.00065,1,3170416,3185418,+,15002
17,BUMA.1121.00100,1,2170209,2185135,-,14926
17,BUMA.1121.00105,1,2082996,2097982,-,14986
17,BUMA.1121.00029,1,1801913,1816923,-,15010
17,BUMA.1121.00066,1,3018113,3033075,+,14962
17,BUMA.1121.00031,1,435701,450751,+,15050
17,BUMA.1121.00108,1,110028,125054,+,15026
17,BUMA.1121.00023,1,1444977,1459895,+,14918
17,BUMA.1121.00035,1,149859,164861,+,15002
17,BUMA.1121.00041,1,361516,376510,+,14994
18,BUMA.1121.00057,1,225743,238759,+,13016
18,BUMA.1121.00058,1,1382962,1396000,-,13038
18,BUMA.1121.00045,1,930548,943575,-,13027
18,BUMA.1121.00051,1,3089980,3102999,+,13019
18,BUMA.1121.00068,1,1916865,1929883,+,13018
18,BUMA.1121.00061,1,3046214,3059230,+,13016
18,BUMA.1121.00060,1,3175779,3188806,-,13027
18,BUMA.1121.00064,1,3126591,3139611,+,13020
18,BUMA.1121.00016,1,1236852,1249863,+,13011
18,BUMA.1121.00003,1,1642909,1655937,+,13028
18,BUMA.1121.00055,1,2802290,2815305,+,13015
18,BUMA.1121.00011,1,2474623,2487649,-,13026
18,BUMA.1121.00011,1,2510129,2522859,-,12730
18,BUMA.1121.00037,1,1757849,1770860,+,13011
18,BUMA.1121.00009,1,2422565,2435585,-,13020
18,BUMA.1121.00069,1,3029859,3042875,+,13016
18,BUMA.1121.00088,1,4094856,4107874,+,13018
18,BUMA.1121.00092,1,649868,662893,-,13025
18,BUMA.1121.00074,1,734657,747682,-,13025
18,BUMA.1121.00070,1,3017408,3030424,+,13016
18,BUMA.1121.00093,1,3963237,3976252,+,13015
18,BUMA.1121.00063,1,3043147,3056162,+,13015
18,BUMA.1121.00033,1,1340735,1353763,+,13028
18,BUMA.1121.00018,1,3755354,3768365,+,13011
18,BUMA.1121.00080,1,3138687,3151707,+,13020
18,BUMA.1121.00027,1,1310927,1323942,+,13015
18,BUMA.1121.00053,1,2883016,2896036,+,13020
18,BUMA.1121.00059,1,2349338,2362354,+,13016
18,BUMA.1121.00043,1,3255269,3268280,+,13011
18,BUMA.1121.00056,1,835833,848864,-,13031
18,BUMA.1121.00112,1,3939953,3952980,-,13027
18,BUMA.1121.00091,1,1357443,1370426,-,12983
18,BUMA.1121.00047,1,3877232,3890262,-,13030
18,BUMA.1121.00067,1,1288994,1302020,-,13026
18,BUMA.1121.00110,1,1682824,1695852,-,13028
18,BUMA.1121.00073,1,3044626,3057641,+,13015
18,BUMA.1121.00072,1,3031352,3044367,+,13015
18,BUMA.1121.00077,1,1787395,1800411,+,13016
18,BUMA.1121.00082,1,3227946,3240962,+,13016
18,BUMA.1121.00062,1,1422717,1435754,-,13037
18,BUMA.1121.00007,1,926061,939087,-,13026
18,BUMA.1121.00025,1,3641479,3654500,-,13021
18,BUMA.1121.00021,1,3783862,3796878,+,13016
18,BUMA.1121.00103,1,1235030,1248064,-,13034
18,BUMA.1121.00096,1,138163,151201,-,13038
18,BUMA.1121.00079,1,3171542,3184562,+,13020
18,BUMA.1121.00039,1,3271203,3284214,+,13011
18,BUMA.1121.00083,1,2538398,2551424,-,13026
18,BUMA.1121.00084,1,3486718,3499736,+,13018
18,BUMA.1121.00049,1,2686263,2699290,-,13027
18,BUMA.1121.00089,1,3077992,3091013,+,13021
18,BUMA.1121.00014,1,3784646,3797667,-,13021
18,BUMA.1121.00090,1,1198624,1211640,+,13016
18,BUMA.1121.00071,1,3049105,3062120,+,13015
18,BUMA.1121.00078,1,2872113,2885152,-,13039
18,BUMA.1121.00102,1,2159266,2172304,-,13038
18,BUMA.1121.00075,1,2615689,2628706,+,13017
18,BUMA.1121.00012,1,1875536,1888552,+,13016
18,BUMA.1121.00076,1,2183580,2196608,-,13028
18,BUMA.1121.00106,1,2872148,2885163,+,13015
18,BUMA.1121.00001,1,913846,926872,-,13026
18,BUMA.1121.00107,1,3062011,3075045,+,13034
18,BUMA.1121.00104,1,2115821,2128846,-,13025
18,BUMA.1121.00099,1,3282915,3295934,-,13019
18,BUMA.1121.00098,1,1780072,1793088,+,13016
18,BUMA.1121.00111,1,3309506,3322517,+,13011
18,BUMA.1121.00109,1,2773377,2786404,-,13027
18,BUMA.1121.00097,1,797513,810540,-,13027
18,BUMA.1121.00094,1,3106486,3119505,+,13019
18,BUMA.1121.00095,1,2554454,2567489,-,13035
18,BUMA.1121.00005,1,1858407,1871427,+,13020
18,BUMA.1121.00101,1,3318499,3331537,-,13038
18,BUMA.1121.00065,1,3186730,3199747,+,13017
18,BUMA.1121.00100,1,2156121,2169145,-,13024
18,BUMA.1121.00105,1,2068904,2081934,-,13030
18,BUMA.1121.00029,1,1787585,1800611,-,13026
18,BUMA.1121.00066,1,3034216,3047231,+,13015
18,BUMA.1121.00031,1,452183,465194,+,13011
18,BUMA.1121.00108,1,126006,139026,+,13020
18,BUMA.1121.00023,1,1460487,1473503,+,13016
18,BUMA.1121.00035,1,166293,179309,+,13016
18,BUMA.1121.00041,1,377822,390839,+,13017
19,BUMA.1121.00057,1,239188,271467,+,32279
19,BUMA.1121.00058,1,1350340,1382532,-,32192
19,BUMA.1121.00045,1,897994,930118,-,32124
19,BUMA.1121.00051,1,3103428,3135769,+,32341
19,BUMA.1121.00068,1,1930312,1962514,+,32202
19,BUMA.1121.00061,1,3059659,3091893,+,32234
19,BUMA.1121.00060,1,3143225,3175349,-,32124
19,BUMA.1121.00064,1,3140040,3172210,+,32170
19,BUMA.1121.00016,1,1250293,1282437,+,32144
19,BUMA.1121.00003,1,1656366,1688554,+,32188
19,BUMA.1121.00055,1,2815734,2847878,+,32144
19,BUMA.1121.00011,1,2441930,2474193,-,32263
19,BUMA.1121.00037,1,1771289,1803472,+,32183
19,BUMA.1121.00009,1,2389974,2422135,-,32161
19,BUMA.1121.00069,1,3043274,3075493,+,32219
19,BUMA.1121.00088,1,4108303,4140547,+,32244
19,BUMA.1121.00092,1,617189,649438,-,32249
19,BUMA.1121.00074,1,702035,734227,-,32192
19,BUMA.1121.00070,1,3030853,3062975,+,32122
19,BUMA.1121.00093,1,3976681,4008930,+,32249
19,BUMA.1121.00063,1,3056591,3088834,+,32243
19,BUMA.1121.00033,1,1354192,1386377,+,32185
19,BUMA.1121.00018,1,3768794,3800975,+,32181
19,BUMA.1121.00080,1,3152135,3184446,+,32311
19,BUMA.1121.00027,1,1324371,1356655,+,32284
19,BUMA.1121.00053,1,2896465,2928667,+,32202
19,BUMA.1121.00059,1,2362783,2394999,+,32216
19,BUMA.1121.00043,1,3268709,3300839,+,32130
19,BUMA.1121.00056,1,803139,835403,-,32264
19,BUMA.1121.00112,1,3907093,3939523,-,32430
19,BUMA.1121.00091,1,1324771,1357013,-,32242
19,BUMA.1121.00047,1,3844472,3876802,-,32330
19,BUMA.1121.00067,1,1256381,1288564,-,32183
19,BUMA.1121.00110,1,1650212,1682394,-,32182
19,BUMA.1121.00073,1,3058065,3090314,+,32249
19,BUMA.1121.00072,1,3044796,3077040,+,32244
19,BUMA.1121.00077,1,1800840,1833021,+,32181
19,BUMA.1121.00082,1,3241391,3273643,+,32252
19,BUMA.1121.00062,1,1390066,1422287,-,32221
19,BUMA.1121.00007,1,893382,925631,-,32249
19,BUMA.1121.00025,1,3608868,3641049,-,32181
19,BUMA.1121.00021,1,3797307,3829518,+,32211
19,BUMA.1121.00103,1,1202405,1234600,-,32195
19,BUMA.1121.00096,1,105560,137733,-,32173
19,BUMA.1121.00079,1,3184991,3217310,+,32319
19,BUMA.1121.00039,1,3284643,3316837,+,32194
19,BUMA.1121.00083,1,2505716,2537968,-,32252
19,BUMA.1121.00084,1,3500165,3532394,+,32229
19,BUMA.1121.00049,1,2653546,2685833,-,32287
19,BUMA.1121.00089,1,3091442,3123706,+,32264
19,BUMA.1121.00014,1,3752045,3784216,-,32171
19,BUMA.1121.00090,1,1212069,1244222,+,32153
19,BUMA.1121.00071,1,3062536,3094781,+,32245
19,BUMA.1121.00078,1,2839460,2871683,-,32223
19,BUMA.1121.00102,1,2126586,2158836,-,32250
19,BUMA.1121.00075,1,2629135,2661346,+,32211
19,BUMA.1121.00012,1,1888981,1921155,+,32174
19,BUMA.1121.00076,1,2150934,2183150,-,32216
19,BUMA.1121.00106,1,2885592,2917729,+,32137
19,BUMA.1121.00001,1,881305,913416,-,32111
19,BUMA.1121.00107,1,3075474,3107624,+,32150
19,BUMA.1121.00104,1,2083181,2115391,-,32210
19,BUMA.1121.00099,1,3250263,3282485,-,32222
19,BUMA.1121.00098,1,1793517,1825644,+,32127
19,BUMA.1121.00111,1,3322946,3355217,+,32271
19,BUMA.1121.00109,1,2740703,2772947,-,32244
19,BUMA.1121.00097,1,764861,797083,-,32222
19,BUMA.1121.00094,1,3119934,3152201,+,32267
19,BUMA.1121.00095,1,2521819,2554024,-,32205
19,BUMA.1121.00005,1,1871850,1904031,+,32181
19,BUMA.1121.00101,1,3285911,3318069,-,32158
19,BUMA.1121.00065,1,3200176,3232410,+,32234
19,BUMA.1121.00100,1,2123503,2155691,-,32188
19,BUMA.1121.00105,1,2036282,2068474,-,32192
19,BUMA.1121.00029,1,1755044,1787155,-,32111
19,BUMA.1121.00066,1,3047649,3079898,+,32249
19,BUMA.1121.00031,1,465623,497803,+,32180
19,BUMA.1121.00108,1,139464,171586,+,32122
19,BUMA.1121.00023,1,1473932,1506145,+,32213
19,BUMA.1121.00035,1,179738,211822,+,32084
19,BUMA.1121.00041,1,391268,423494,+,32226
20,BUMA.1121.00057,1,271469,288868,+,17399
20,BUMA.1121.00058,1,1333097,1350339,-,17242
20,BUMA.1121.00045,1,880769,897993,-,17224
20,BUMA.1121.00051,1,3135771,3153139,+,17368
20,BUMA.1121.00068,1,1962516,1979776,+,17260
20,BUMA.1121.00061,1,3091895,3109213,+,17318
20,BUMA.1121.00060,1,3126000,3143224,-,17224
20,BUMA.1121.00064,1,3172212,3189296,+,17084
20,BUMA.1121.00016,1,1282439,1299691,+,17252
20,BUMA.1121.00003,1,1688556,1705744,+,17188
20,BUMA.1121.00055,1,2847880,2864961,+,17081
20,BUMA.1121.00011,1,2424704,2441929,-,17225
20,BUMA.1121.00037,1,1803474,1820783,+,17309
20,BUMA.1121.00009,1,2372547,2389973,-,17426
20,BUMA.1121.00069,1,3075495,3092775,+,17280
20,BUMA.1121.00088,1,1,17131,+,17130
20,BUMA.1121.00092,1,599996,617188,-,17192
20,BUMA.1121.00074,1,684958,702034,-,17076
20,BUMA.1121.00070,1,3062977,3080295,+,17318
20,BUMA.1121.00093,1,4008932,4026124,+,17192
20,BUMA.1121.00063,1,3088836,3106154,+,17318
20,BUMA.1121.00033,1,1386379,1403589,+,17210
20,BUMA.1121.00018,1,3800977,3818213,+,17236
20,BUMA.1121.00080,1,3184448,3201948,+,17500
20,BUMA.1121.00027,1,1356657,1373951,+,17294
20,BUMA.1121.00053,1,2928669,2946041,+,17372
20,BUMA.1121.00059,1,2395001,2412117,+,17116
20,BUMA.1121.00043,1,3300841,3318220,+,17379
20,BUMA.1121.00056,1,785650,803138,-,17488
20,BUMA.1121.00112,1,3889981,3907092,-,17111
20,BUMA.1121.00091,1,1307419,1324770,-,17351
20,BUMA.1121.00047,1,3827087,3844471,-,17384
20,BUMA.1121.00067,1,1239236,1256380,-,17144
20,BUMA.1121.00110,1,1633037,1650211,-,17174
20,BUMA.1121.00073,1,3090316,3107634,+,17318
20,BUMA.1121.00072,1,3077042,3093997,+,16955
20,BUMA.1121.00077,1,1833023,1850301,+,17278
20,BUMA.1121.00082,1,3273645,3290963,+,17318
20,BUMA.1121.00062,1,1372863,1390065,-,17202
20,BUMA.1121.00007,1,876228,893381,-,17153
20,BUMA.1121.00025,1,3591639,3608867,-,17228
20,BUMA.1121.00021,1,3829520,3846599,+,17079
20,BUMA.1121.00103,1,1184666,1202404,-,17738
20,BUMA.1121.00096,1,88372,105559,-,17187
20,BUMA.1121.00079,1,3217312,3234470,+,17158
20,BUMA.1121.00039,1,3316839,3334361,+,17522
20,BUMA.1121.00083,1,2488429,2505715,-,17286
20,BUMA.1121.00084,1,3532396,3549557,+,17161
20,BUMA.1121.00049,1,2636302,2653545,-,17243
20,BUMA.1121.00089,1,3123708,3141164,+,17456
20,BUMA.1121.00014,1,3734746,3752044,-,17298
20,BUMA.1121.00090,1,1244224,1261328,+,17104
20,BUMA.1121.00071,1,3094783,3111929,+,17146
20,BUMA.1121.00078,1,2821896,2839459,-,17563
20,BUMA.1121.00102,1,2109130,2126585,-,17455
20,BUMA.1121.00075,1,2661348,2678720,+,17372
20,BUMA.1121.00012,1,1921157,1938389,+,17232
20,BUMA.1121.00076,1,2133681,2150933,-,17252
20,BUMA.1121.00106,1,2917731,2934785,+,17054
20,BUMA.1121.00001,1,864043,881304,-,17261
20,BUMA.1121.00107,1,3107626,3124778,+,17152
20,BUMA.1121.00104,1,2066120,2083180,-,17060
20,BUMA.1121.00099,1,3233059,3250262,-,17203
20,BUMA.1121.00098,1,1825646,1842817,+,17171
20,BUMA.1121.00111,1,3355219,3372454,+,17235
20,BUMA.1121.00109,1,2723276,2740702,-,17426
20,BUMA.1121.00097,1,747657,764860,-,17203
20,BUMA.1121.00094,1,3152203,3169337,+,17134
20,BUMA.1121.00095,1,2504756,2521818,-,17062
20,BUMA.1121.00005,1,1904033,1921462,+,17429
20,BUMA.1121.00101,1,3268631,3285910,-,17279
20,BUMA.1121.00065,1,3232412,3249832,+,17420
20,BUMA.1121.00100,1,2106080,2123502,-,17422
20,BUMA.1121.00105,1,2019018,2036281,-,17263
20,BUMA.1121.00029,1,1737894,1755043,-,17149
20,BUMA.1121.00066,1,3079900,3097031,+,17131
20,BUMA.1121.00031,1,497805,515111,+,17306
20,BUMA.1121.00108,1,171588,188735,+,17147
20,BUMA.1121.00023,1,1506147,1523363,+,17216
20,BUMA.1121.00035,1,211824,228989,+,17165
20,BUMA.1121.00041,1,423496,440754,+,17258
21,BUMA.1121.00057,1,288876,294941,+,6065
21,BUMA.1121.00058,1,1327032,1333089,-,6057
21,BUMA.1121.00045,1,874678,880743,-,6065
21,BUMA.1121.00051,1,3153147,3159206,+,6059
21,BUMA.1121.00068,1,1979784,1985851,+,6067
21,BUMA.1121.00061,1,3109221,3115286,+,6065
21,BUMA.1121.00060,1,3119909,3125974,-,6065
21,BUMA.1121.00064,1,3189304,3195369,+,6065
21,BUMA.1121.00016,1,1299699,1305764,+,6065
21,BUMA.1121.00003,1,1705752,1711826,+,6074
21,BUMA.1121.00055,1,2864969,2871034,+,6065
21,BUMA.1121.00011,1,2418630,2424696,-,6066
21,BUMA.1121.00037,1,1820791,1826856,+,6065
21,BUMA.1121.00009,1,2366476,2372539,-,6063
21,BUMA.1121.00069,1,3092783,3098848,+,6065
21,BUMA.1121.00088,1,17139,23204,+,6065
21,BUMA.1121.00092,1,592326,598392,-,6066
21,BUMA.1121.00074,1,678884,684950,-,6066
21,BUMA.1121.00070,1,3080303,3086368,+,6065
21,BUMA.1121.00093,1,4027728,4033793,+,6065
21,BUMA.1121.00063,1,3106162,3112227,+,6065
21,BUMA.1121.00033,1,1403597,1409662,+,6065
21,BUMA.1121.00018,1,3818221,3824286,+,6065
21,BUMA.1121.00080,1,3201956,3208015,+,6059
21,BUMA.1121.00027,1,1373959,1380024,+,6065
21,BUMA.1121.00053,1,2946049,2952114,+,6065
21,BUMA.1121.00059,1,2412131,2418192,+,6061
21,BUMA.1121.00043,1,3318228,3324293,+,6065
21,BUMA.1121.00056,1,779582,785642,-,6060
21,BUMA.1121.00112,1,3883907,3889973,-,6066
21,BUMA.1121.00091,1,1301345,1307411,-,6066
21,BUMA.1121.00047,1,3821019,3827079,-,6060
21,BUMA.1121.00067,1,1233162,1239228,-,6066
21,BUMA.1121.00110,1,1626961,1633029,-,6068
21,BUMA.1121.00073,1,3107642,3113707,+,6065
21,BUMA.1121.00072,1,3094005,3100070,+,6065
21,BUMA.1121.00077,1,1850309,1856376,+,6067
21,BUMA.1121.00082,1,3290971,3297036,+,6065
21,BUMA.1121.00062,1,1366789,1372855,-,6066
21,BUMA.1121.00007,1,870156,876220,-,6064
21,BUMA.1121.00025,1,3585565,3591631,-,6066
21,BUMA.1121.00021,1,3846607,3852672,+,6065
21,BUMA.1121.00103,1,1178599,1184657,-,6058
21,BUMA.1121.00096,1,82307,88364,-,6057
21,BUMA.1121.00079,1,3234478,3240537,+,6059
21,BUMA.1121.00039,1,3334369,3340434,+,6065
21,BUMA.1121.00083,1,2482355,2488421,-,6066
21,BUMA.1121.00084,1,3549583,3555644,+,6061
21,BUMA.1121.00049,1,2630228,2636294,-,6066
21,BUMA.1121.00089,1,3141172,3147231,+,6059
21,BUMA.1121.00014,1,3728672,3734738,-,6066
21,BUMA.1121.00090,1,1261336,1267401,+,6065
21,BUMA.1121.00071,1,3111937,3118002,+,6065
21,BUMA.1121.00078,1,2815822,2821888,-,6066
21,BUMA.1121.00102,1,2103056,2109122,-,6066
21,BUMA.1121.00075,1,2678728,2684775,+,6047
21,BUMA.1121.00012,1,1938397,1944462,+,6065
21,BUMA.1121.00076,1,2127625,2133673,-,6048
21,BUMA.1121.00106,1,2934793,2940858,+,6065
21,BUMA.1121.00001,1,857969,864035,-,6066
21,BUMA.1121.00107,1,3124786,3130845,+,6059
21,BUMA.1121.00104,1,2060046,2066112,-,6066
21,BUMA.1121.00099,1,3226985,3233051,-,6066
21,BUMA.1121.00098,1,1842825,1848884,+,6059
21,BUMA.1121.00111,1,3374058,3380123,+,6065
21,BUMA.1121.00109,1,2717199,2723268,-,6069
21,BUMA.1121.00097,1,741573,747649,-,6076
21,BUMA.1121.00094,1,3169359,3175413,+,6054
21,BUMA.1121.00095,1,2498665,2504730,-,6065
21,BUMA.1121.00005,1,1921477,1927538,+,6061
21,BUMA.1121.00101,1,3262560,3268623,-,6063
21,BUMA.1121.00065,1,3249840,3255886,+,6046
21,BUMA.1121.00100,1,2100006,2106072,-,6066
21,BUMA.1121.00105,1,2012944,2019010,-,6066
21,BUMA.1121.00029,1,1731820,1737886,-,6066
21,BUMA.1121.00066,1,3097039,3103104,+,6065
21,BUMA.1121.00031,1,515119,521184,+,6065
21,BUMA.1121.00108,1,188743,194808,+,6065
21,BUMA.1121.00023,1,1523371,1529436,+,6065
21,BUMA.1121.00035,1,228997,235062,+,6065
21,BUMA.1121.00041,1,440762,446827,+,6065
22,BUMA.1121.00057,1,295471,303032,+,7561
22,BUMA.1121.00058,1,1318946,1326502,-,7556
22,BUMA.1121.00045,1,866588,874148,-,7560
22,BUMA.1121.00051,1,3159736,3167297,+,7561
22,BUMA.1121.00068,1,1986381,1993940,+,7559
22,BUMA.1121.00061,1,3115816,3123377,+,7561
22,BUMA.1121.00060,1,3111819,3119379,-,7560
22,BUMA.1121.00064,1,3195899,3203458,+,7559
22,BUMA.1121.00016,1,1306294,1313853,+,7559
22,BUMA.1121.00003,1,1712356,1719917,+,7561
22,BUMA.1121.00055,1,2871564,2879123,+,7559
22,BUMA.1121.00011,1,2410542,2418100,-,7558
22,BUMA.1121.00037,1,1827386,1834945,+,7559
22,BUMA.1121.00009,1,2358388,2365946,-,7558
22,BUMA.1121.00069,1,3099378,3106939,+,7561
22,BUMA.1121.00088,1,23734,31293,+,7559
22,BUMA.1121.00092,1,584238,591796,-,7558
22,BUMA.1121.00074,1,670796,678354,-,7558
22,BUMA.1121.00070,1,3086898,3094459,+,7561
22,BUMA.1121.00093,1,4034323,4041882,+,7559
22,BUMA.1121.00063,1,3112757,3120318,+,7561
22,BUMA.1121.00033,1,1410192,1417751,+,7559
22,BUMA.1121.00018,1,3824816,3832375,+,7559
22,BUMA.1121.00080,1,3208545,3216106,+,7561
22,BUMA.1121.00027,1,1380554,1388114,+,7560
22,BUMA.1121.00053,1,2952644,2960204,+,7560
22,BUMA.1121.00059,1,2418722,2426279,+,7557
22,BUMA.1121.00043,1,3324823,3332382,+,7559
22,BUMA.1121.00056,1,771492,779052,-,7560
22,BUMA.1121.00112,1,3875817,3883377,-,7560
22,BUMA.1121.00091,1,1293255,1300815,-,7560
22,BUMA.1121.00047,1,3812929,3820489,-,7560
22,BUMA.1121.00067,1,1225074,1232632,-,7558
22,BUMA.1121.00110,1,1618873,1626431,-,7558
22,BUMA.1121.00073,1,3114237,3121798,+,7561
22,BUMA.1121.00072,1,3100600,3108161,+,7561
22,BUMA.1121.00077,1,1856906,1864464,+,7558
22,BUMA.1121.00082,1,3297566,3305127,+,7561
22,BUMA.1121.00062,1,1358716,1366259,-,7543
22,BUMA.1121.00007,1,862066,869626,-,7560
22,BUMA.1121.00025,1,3577477,3585035,-,7558
22,BUMA.1121.00021,1,3853202,3860761,+,7559
22,BUMA.1121.00103,1,1170511,1178069,-,7558
22,BUMA.1121.00096,1,74219,81777,-,7558
22,BUMA.1121.00079,1,3241067,3248628,+,7561
22,BUMA.1121.00039,1,3340964,3348523,+,7559
22,BUMA.1121.00083,1,2474265,2481825,-,7560
22,BUMA.1121.00084,1,3556174,3563733,+,7559
22,BUMA.1121.00049,1,2622140,2629698,-,7558
22,BUMA.1121.00089,1,3147761,3155322,+,7561
22,BUMA.1121.00014,1,3720585,3728142,-,7557
22,BUMA.1121.00090,1,1267931,1275490,+,7559
22,BUMA.1121.00071,1,3118532,3126093,+,7561
22,BUMA.1121.00078,1,2807732,2815292,-,7560
22,BUMA.1121.00102,1,2094966,2102526,-,7560
22,BUMA.1121.00075,1,2685305,2692864,+,7559
22,BUMA.1121.00012,1,1944992,1952551,+,7559
22,BUMA.1121.00076,1,2119537,2127095,-,7558
22,BUMA.1121.00106,1,2941388,2948947,+,7559
22,BUMA.1121.00001,1,849881,857439,-,7558
22,BUMA.1121.00107,1,3131375,3138934,+,7559
22,BUMA.1121.00104,1,2051958,2059516,-,7558
22,BUMA.1121.00099,1,3218897,3226455,-,7558
22,BUMA.1121.00098,1,1849414,1856973,+,7559
22,BUMA.1121.00111,1,3380653,3388212,+,7559
22,BUMA.1121.00109,1,2709109,2716669,-,7560
22,BUMA.1121.00097,1,733483,741043,-,7560
22,BUMA.1121.00094,1,3175943,3183504,+,7561
22,BUMA.1121.00095,1,2490577,2498135,-,7558
22,BUMA.1121.00005,1,1928068,1935629,+,7561
22,BUMA.1121.00101,1,3254472,3262030,-,7558
22,BUMA.1121.00065,1,3256416,3263975,+,7559
22,BUMA.1121.00100,1,2091918,2099476,-,7558
22,BUMA.1121.00105,1,2004856,2012414,-,7558
22,BUMA.1121.00029,1,1723732,1731290,-,7558
22,BUMA.1121.00066,1,3103634,3111192,+,7558
22,BUMA.1121.00031,1,521714,529273,+,7559
22,BUMA.1121.00108,1,195338,202882,+,7544
22,BUMA.1121.00023,1,1529966,1537525,+,7559
22,BUMA.1121.00035,1,235592,243151,+,7559
22,BUMA.1121.00041,1,447357,454916,+,7559
23,BUMA.1121.00057,1,303500,353347,+,49847
23,BUMA.1121.00058,1,1250750,1300588,-,49838
23,BUMA.1121.00045,1,816287,866130,-,49843
23,BUMA.1121.00051,1,3167765,3217591,+,49826
23,BUMA.1121.00068,1,1994400,2044240,+,49840
23,BUMA.1121.00061,1,3123845,3173687,+,49842
23,BUMA.1121.00060,1,3061519,3111361,-,49842
23,BUMA.1121.00064,1,3203926,3253768,+,49842
23,BUMA.1121.00016,1,1314320,1364161,+,49841
23,BUMA.1121.00003,1,1720376,1770226,+,49850
23,BUMA.1121.00055,1,2879591,2929422,+,49831
23,BUMA.1121.00011,1,2360216,2410082,-,49866
23,BUMA.1121.00037,1,1835412,1885241,+,49829
23,BUMA.1121.00009,1,2308092,2357921,-,49829
23,BUMA.1121.00069,1,3107407,3157249,+,49842
23,BUMA.1121.00088,1,31760,81596,+,49836
23,BUMA.1121.00092,1,533929,583770,-,49841
23,BUMA.1121.00074,1,620482,670328,-,49846
23,BUMA.1121.00070,1,3094927,3144769,+,49842
23,BUMA.1121.00093,1,4042350,4092206,+,49856
23,BUMA.1121.00063,1,3120786,3170628,+,49842
23,BUMA.1121.00033,1,1418218,1468045,+,49827
23,BUMA.1121.00018,1,3832843,3882670,+,49827
23,BUMA.1121.00080,1,3216575,3266401,+,49826
23,BUMA.1121.00027,1,1388581,1438418,+,49837
23,BUMA.1121.00053,1,2960671,3010513,+,49842
23,BUMA.1121.00059,1,2444637,2494497,+,49860
23,BUMA.1121.00043,1,3332849,3382673,+,49824
23,BUMA.1121.00056,1,721191,771024,-,49833
23,BUMA.1121.00112,1,3825531,3875359,-,49828
23,BUMA.1121.00091,1,1242953,1292787,-,49834
23,BUMA.1121.00047,1,3762624,3812468,-,49844
23,BUMA.1121.00067,1,1174760,1224606,-,49846
23,BUMA.1121.00110,1,1568584,1618413,-,49829
23,BUMA.1121.00073,1,3122266,3172108,+,49842
23,BUMA.1121.00072,1,3108629,3158471,+,49842
23,BUMA.1121.00077,1,1864924,1914750,+,49826
23,BUMA.1121.00082,1,3305595,3355437,+,49842
23,BUMA.1121.00062,1,1308395,1358248,-,49853
23,BUMA.1121.00007,1,810142,859966,-,49824
23,BUMA.1121.00025,1,3527180,3577009,-,49829
23,BUMA.1121.00021,1,3861228,3911064,+,49836
23,BUMA.1121.00103,1,1120194,1170053,-,49859
23,BUMA.1121.00096,1,23910,73759,-,49849
23,BUMA.1121.00079,1,3249096,3298946,+,49850
23,BUMA.1121.00039,1,3348990,3398824,+,49834
23,BUMA.1121.00083,1,2423954,2473797,-,49843
23,BUMA.1121.00084,1,3564201,3614041,+,49840
23,BUMA.1121.00049,1,2571825,2621672,-,49847
23,BUMA.1121.00089,1,3155790,3205622,+,49832
23,BUMA.1121.00014,1,3670286,3720118,-,49832
23,BUMA.1121.00090,1,1275957,1325787,+,49830
23,BUMA.1121.00071,1,3126561,3176403,+,49842
23,BUMA.1121.00078,1,2757400,2807265,-,49865
23,BUMA.1121.00102,1,2044641,2094499,-,49858
23,BUMA.1121.00075,1,2693332,2743165,+,49833
23,BUMA.1121.00012,1,1953018,2002860,+,49842
23,BUMA.1121.00076,1,2069233,2119069,-,49836
23,BUMA.1121.00106,1,2949415,2999267,+,49852
23,BUMA.1121.00001,1,799579,849414,-,49835
23,BUMA.1121.00107,1,3139401,3189257,+,49856
23,BUMA.1121.00104,1,2001647,2051490,-,49843
23,BUMA.1121.00099,1,3168580,3218439,-,49859
23,BUMA.1121.00098,1,1857434,1907271,+,49837
23,BUMA.1121.00111,1,3388679,3438505,+,49826
23,BUMA.1121.00109,1,2658819,2708648,-,49829
23,BUMA.1121.00097,1,683170,733022,-,49852
23,BUMA.1121.00094,1,3183972,3233812,+,49840
23,BUMA.1121.00095,1,2440275,2490116,-,49841
23,BUMA.1121.00005,1,1954451,2004282,+,49831
23,BUMA.1121.00101,1,3204197,3254014,-,49817
23,BUMA.1121.00065,1,3264443,3314271,+,49828
23,BUMA.1121.00100,1,2041612,2091458,-,49846
23,BUMA.1121.00105,1,1954554,2004388,-,49834
23,BUMA.1121.00029,1,1673431,1723265,-,49834
23,BUMA.1121.00066,1,3111663,3161505,+,49842
23,BUMA.1121.00031,1,529739,579577,+,49838
23,BUMA.1121.00108,1,203343,253176,+,49833
23,BUMA.1121.00023,1,1537993,1587816,+,49823
23,BUMA.1121.00035,1,243618,293453,+,49835
23,BUMA.1121.00041,1,455384,505224,+,49840
24,BUMA.1121.00057,1,353349,366276,+,12927
24,BUMA.1121.00058,1,1237823,1250749,-,12926
24,BUMA.1121.00045,1,803383,816286,-,12903
24,BUMA.1121.00051,1,3217593,3230510,+,12917
24,BUMA.1121.00068,1,2044242,2057149,+,12907
24,BUMA.1121.00061,1,3173689,3186616,+,12927
24,BUMA.1121.00060,1,3048615,3061518,-,12903
24,BUMA.1121.00064,1,3253770,3266688,+,12918
24,BUMA.1121.00016,1,1364163,1377085,+,12922
24,BUMA.1121.00003,1,1770228,1783157,+,12929
24,BUMA.1121.00055,1,2929424,2942351,+,12927
24,BUMA.1121.00011,1,2347297,2360215,-,12918
24,BUMA.1121.00037,1,1885243,1898166,+,12923
24,BUMA.1121.00009,1,2295176,2308091,-,12915
24,BUMA.1121.00069,1,3157251,3170178,+,12927
24,BUMA.1121.00088,1,81598,94513,+,12915
24,BUMA.1121.00092,1,521001,533928,-,12927
24,BUMA.1121.00074,1,607563,620481,-,12918
24,BUMA.1121.00070,1,3144771,3157698,+,12927
24,BUMA.1121.00093,1,1,12900,+,12899
24,BUMA.1121.00063,1,3170630,3183557,+,12927
24,BUMA.1121.00033,1,1468047,1480967,+,12920
24,BUMA.1121.00018,1,3882672,3895586,+,12914
24,BUMA.1121.00080,1,3266403,3279320,+,12917
24,BUMA.1121.00027,1,1438420,1451346,+,12926
24,BUMA.1121.00053,1,3010515,3023427,+,12912
24,BUMA.1121.00059,1,2494499,2507426,+,12927
24,BUMA.1121.00043,1,3382675,3395598,+,12923
24,BUMA.1121.00056,1,708264,721190,-,12926
24,BUMA.1121.00112,1,3812614,3825530,-,12916
24,BUMA.1121.00091,1,1230034,1242952,-,12918
24,BUMA.1121.00047,1,3749706,3762623,-,12917
24,BUMA.1121.00067,1,1161841,1174759,-,12918
24,BUMA.1121.00110,1,1555667,1568583,-,12916
24,BUMA.1121.00073,1,3172110,3185037,+,12927
24,BUMA.1121.00072,1,3158473,3171397,+,12924
24,BUMA.1121.00077,1,1914752,1927669,+,12917
24,BUMA.1121.00082,1,3355439,3368366,+,12927
24,BUMA.1121.00062,1,1295476,1308394,-,12918
24,BUMA.1121.00007,1,797212,810141,-,12929
24,BUMA.1121.00025,1,3514264,3527179,-,12915
24,BUMA.1121.00021,1,3911066,3923990,+,12924
24,BUMA.1121.00103,1,1107287,1120193,-,12906
24,BUMA.1121.00096,1,10980,23909,-,12929
24,BUMA.1121.00079,1,3298948,3311865,+,12917
24,BUMA.1121.00039,1,3398826,3411750,+,12924
24,BUMA.1121.00083,1,2411026,2423953,-,12927
24,BUMA.1121.00084,1,3614043,3626971,+,12928
24,BUMA.1121.00049,1,2558897,2571824,-,12927
24,BUMA.1121.00089,1,3205624,3218550,+,12926
24,BUMA.1121.00014,1,3657359,3670285,-,12926
24,BUMA.1121.00090,1,1325789,1338712,+,12923
24,BUMA.1121.00071,1,3176405,3189329,+,12924
24,BUMA.1121.00078,1,2744481,2757399,-,12918
24,BUMA.1121.00102,1,2031713,2044640,-,12927
24,BUMA.1121.00075,1,2743167,2756094,+,12927
24,BUMA.1121.00012,1,2002862,2015785,+,12923
24,BUMA.1121.00076,1,2056305,2069232,-,12927
24,BUMA.1121.00106,1,2999269,3012187,+,12918
24,BUMA.1121.00001,1,786660,799578,-,12918
24,BUMA.1121.00107,1,3189259,3202177,+,12918
24,BUMA.1121.00104,1,1988719,2001646,-,12927
24,BUMA.1121.00099,1,3155672,3168579,-,12907
24,BUMA.1121.00098,1,1907273,1920178,+,12905
24,BUMA.1121.00111,1,3438507,3451433,+,12926
24,BUMA.1121.00109,1,2645906,2658818,-,12912
24,BUMA.1121.00097,1,670251,683169,-,12918
24,BUMA.1121.00094,1,3233814,3246728,+,12914
24,BUMA.1121.00095,1,2427358,2440274,-,12916
24,BUMA.1121.00005,1,2004284,2017211,+,12927
24,BUMA.1121.00101,1,3191282,3204196,-,12914
24,BUMA.1121.00065,1,3314273,3327190,+,12917
24,BUMA.1121.00100,1,2028692,2041611,-,12919
24,BUMA.1121.00105,1,1941626,1954553,-,12927
24,BUMA.1121.00029,1,1660514,1673430,-,12916
24,BUMA.1121.00066,1,3161507,3174434,+,12927
24,BUMA.1121.00031,1,579579,592505,+,12926
24,BUMA.1121.00108,1,253178,266084,+,12906
24,BUMA.1121.00023,1,1587818,1600741,+,12923
24,BUMA.1121.00035,1,293455,306373,+,12918
24,BUMA.1121.00041,1,505226,518149,+,12923
25,BUMA.1121.00057,1,367790,373733,+,5943
25,BUMA.1121.00058,1,1231630,1237574,-,5944
25,BUMA.1121.00045,1,797335,803279,-,5944
25,BUMA.1121.00051,1,3230808,3236752,+,5944
25,BUMA.1121.00068,1,2057398,2063341,+,5943
25,BUMA.1121.00061,1,3188082,3194024,+,5942
25,BUMA.1121.00060,1,3042567,3048511,-,5944
25,BUMA.1121.00064,1,3266937,3272881,+,5944
25,BUMA.1121.00016,1,1377239,1383182,+,5943
25,BUMA.1121.00003,1,1783455,1789398,+,5943
25,BUMA.1121.00055,1,2942600,2948544,+,5944
25,BUMA.1121.00011,1,2341153,2347097,-,5944
25,BUMA.1121.00037,1,1898320,1904263,+,5943
25,BUMA.1121.00009,1,2288983,2294927,-,5944
25,BUMA.1121.00069,1,3171680,3177623,+,5943
25,BUMA.1121.00088,1,94713,100657,+,5944
25,BUMA.1121.00092,1,514758,520703,-,5945
25,BUMA.1121.00074,1,600056,606000,-,5944
25,BUMA.1121.00070,1,3159138,3165081,+,5943
25,BUMA.1121.00093,1,13198,19142,+,5944
25,BUMA.1121.00063,1,3184970,3190913,+,5943
25,BUMA.1121.00033,1,1481121,1487064,+,5943
25,BUMA.1121.00018,1,3895740,3901683,+,5943
25,BUMA.1121.00080,1,3279618,3285562,+,5944
25,BUMA.1121.00027,1,1452859,1458802,+,5943
25,BUMA.1121.00053,1,3023581,3029524,+,5943
25,BUMA.1121.00059,1,2507675,2513619,+,5944
25,BUMA.1121.00043,1,3397066,3403008,+,5942
25,BUMA.1121.00056,1,702119,708064,-,5945
25,BUMA.1121.00112,1,3805204,3811147,-,5943
25,BUMA.1121.00091,1,1222477,1228420,-,5943
25,BUMA.1121.00047,1,3743463,3749408,-,5945
25,BUMA.1121.00067,1,1155647,1161592,-,5945
25,BUMA.1121.00110,1,1549442,1555416,-,5974
25,BUMA.1121.00073,1,3186531,3192474,+,5943
25,BUMA.1121.00072,1,3172914,3178857,+,5943
25,BUMA.1121.00077,1,1927918,1933891,+,5973
25,BUMA.1121.00082,1,3369880,3375823,+,5943
25,BUMA.1121.00062,1,1289332,1295276,-,5944
25,BUMA.1121.00007,1,790969,796914,-,5945
25,BUMA.1121.00025,1,3508167,3514111,-,5944
25,BUMA.1121.00021,1,3924144,3930088,+,5944
25,BUMA.1121.00103,1,1101094,1107038,-,5944
25,BUMA.1121.00096,1,4737,10682,-,5945
25,BUMA.1121.00079,1,3312163,3318107,+,5944
25,BUMA.1121.00039,1,3411904,3417848,+,5944
25,BUMA.1121.00083,1,2403568,2409512,-,5944
25,BUMA.1121.00084,1,3627171,3633115,+,5944
25,BUMA.1121.00049,1,2552752,2558697,-,5945
25,BUMA.1121.00089,1,3218750,3224694,+,5944
25,BUMA.1121.00014,1,3651166,3657110,-,5944
25,BUMA.1121.00090,1,1338866,1344809,+,5943
25,BUMA.1121.00071,1,3190814,3196757,+,5943
25,BUMA.1121.00078,1,2738336,2744281,-,5945
25,BUMA.1121.00102,1,2025568,2031513,-,5945
25,BUMA.1121.00075,1,2756394,2762335,+,5941
25,BUMA.1121.00012,1,2015939,2021882,+,5943
25,BUMA.1121.00076,1,2050063,2056005,-,5942
25,BUMA.1121.00106,1,3012387,3018331,+,5944
25,BUMA.1121.00001,1,780467,786411,-,5944
25,BUMA.1121.00107,1,3202377,3208320,+,5943
25,BUMA.1121.00104,1,1982526,1988470,-,5944
25,BUMA.1121.00099,1,3149577,3155521,-,5944
25,BUMA.1121.00098,1,1920476,1926419,+,5943
25,BUMA.1121.00111,1,3451682,3457625,+,5943
25,BUMA.1121.00109,1,2638481,2644439,-,5958
25,BUMA.1121.00097,1,664009,669953,-,5944
25,BUMA.1121.00094,1,3246931,3252874,+,5943
25,BUMA.1121.00095,1,2421155,2427109,-,5954
25,BUMA.1121.00005,1,2017411,2023354,+,5943
25,BUMA.1121.00101,1,3183727,3189670,-,5943
25,BUMA.1121.00065,1,3327439,3333383,+,5944
25,BUMA.1121.00100,1,2022499,2028443,-,5944
25,BUMA.1121.00105,1,1935481,1941426,-,5945
25,BUMA.1121.00029,1,1654321,1660265,-,5944
25,BUMA.1121.00066,1,3175948,3181891,+,5943
25,BUMA.1121.00031,1,592754,598697,+,5943
25,BUMA.1121.00108,1,266345,272288,+,5943
25,BUMA.1121.00023,1,1600895,1606838,+,5943
25,BUMA.1121.00035,1,306622,312565,+,5943
25,BUMA.1121.00041,1,518303,524246,+,5943
26,BUMA.1121.00057,1,378428,398546,+,20118
26,BUMA.1121.00058,1,1206820,1226934,-,20114
26,BUMA.1121.00045,1,772525,792638,-,20113
26,BUMA.1121.00051,1,3241450,3261568,+,20118
26,BUMA.1121.00068,1,2068049,2088131,+,20082
26,BUMA.1121.00061,1,3198721,3218839,+,20118
26,BUMA.1121.00060,1,3017757,3037870,-,20113
26,BUMA.1121.00064,1,3277578,3297692,+,20114
26,BUMA.1121.00016,1,1387878,1407992,+,20114
26,BUMA.1121.00003,1,1794087,1814206,+,20119
26,BUMA.1121.00055,1,2953241,2973325,+,20084
26,BUMA.1121.00011,1,2316339,2336446,-,20107
26,BUMA.1121.00037,1,1910285,1930396,+,20111
26,BUMA.1121.00009,1,2264200,2284287,-,20087
26,BUMA.1121.00069,1,3182320,3202438,+,20118
26,BUMA.1121.00088,1,105354,125489,+,20135
26,BUMA.1121.00092,1,489949,510063,-,20114
26,BUMA.1121.00074,1,575250,595360,-,20110
26,BUMA.1121.00070,1,3169778,3189896,+,20118
26,BUMA.1121.00093,1,23838,43952,+,20114
26,BUMA.1121.00063,1,3195610,3215728,+,20118
26,BUMA.1121.00033,1,1491781,1511895,+,20114
26,BUMA.1121.00018,1,3906392,3926506,+,20114
26,BUMA.1121.00080,1,3290261,3310371,+,20110
26,BUMA.1121.00027,1,1463497,1483615,+,20118
26,BUMA.1121.00053,1,3034231,3054374,+,20143
26,BUMA.1121.00059,1,2518316,2538434,+,20118
26,BUMA.1121.00043,1,3407717,3427828,+,20111
26,BUMA.1121.00056,1,677302,697420,-,20118
26,BUMA.1121.00112,1,3780427,3800509,-,20082
26,BUMA.1121.00091,1,1197665,1217779,-,20114
26,BUMA.1121.00047,1,3718646,3738764,-,20118
26,BUMA.1121.00067,1,1130829,1150943,-,20114
26,BUMA.1121.00110,1,1524666,1544754,-,20088
26,BUMA.1121.00073,1,3197171,3217289,+,20118
26,BUMA.1121.00072,1,3183553,3203670,+,20117
26,BUMA.1121.00077,1,1938580,1958666,+,20086
26,BUMA.1121.00082,1,3380520,3400638,+,20118
26,BUMA.1121.00062,1,1264505,1284636,-,20131
26,BUMA.1121.00007,1,766142,786271,-,20129
26,BUMA.1121.00025,1,3483345,3503459,-,20114
26,BUMA.1121.00021,1,3934807,3954922,+,20115
26,BUMA.1121.00103,1,1076281,1096398,-,20117
26,BUMA.1121.00096,1,4009373,4029451,-,20078
26,BUMA.1121.00079,1,3322803,3342938,+,20135
26,BUMA.1121.00039,1,3422545,3442663,+,20118
26,BUMA.1121.00083,1,2378754,2398872,-,20118
26,BUMA.1121.00084,1,3637812,3657930,+,20118
26,BUMA.1121.00049,1,2527918,2548057,-,20139
26,BUMA.1121.00089,1,3229394,3249512,+,20118
26,BUMA.1121.00014,1,3626351,3646466,-,20115
26,BUMA.1121.00090,1,1349518,1369632,+,20114
26,BUMA.1121.00071,1,3201453,3221571,+,20118
26,BUMA.1121.00078,1,2713513,2733631,-,20118
26,BUMA.1121.00102,1,2000756,2020870,-,20114
26,BUMA.1121.00075,1,2767042,2787183,+,20141
26,BUMA.1121.00012,1,2026592,2046699,+,20107
26,BUMA.1121.00076,1,2025213,2045356,-,20143
26,BUMA.1121.00106,1,3023037,3043176,+,20139
26,BUMA.1121.00001,1,755671,775759,-,20088
26,BUMA.1121.00107,1,3213027,3233146,+,20119
26,BUMA.1121.00104,1,1957691,1977830,-,20139
26,BUMA.1121.00099,1,3124770,3144881,-,20111
26,BUMA.1121.00098,1,1931117,1951230,+,20113
26,BUMA.1121.00111,1,3462343,3482457,+,20114
26,BUMA.1121.00109,1,2613660,2633785,-,20125
26,BUMA.1121.00097,1,639195,659313,-,20118
26,BUMA.1121.00094,1,3257580,3277698,+,20118
26,BUMA.1121.00095,1,2396372,2416459,-,20087
26,BUMA.1121.00005,1,2028050,2048168,+,20118
26,BUMA.1121.00101,1,3158917,3179031,-,20114
26,BUMA.1121.00065,1,3338080,3358215,+,20135
26,BUMA.1121.00100,1,1997689,2017803,-,20114
26,BUMA.1121.00105,1,1910642,1930785,-,20143
26,BUMA.1121.00029,1,1629499,1649613,-,20114
26,BUMA.1121.00066,1,3186588,3206706,+,20118
26,BUMA.1121.00031,1,603398,623512,+,20114
26,BUMA.1121.00108,1,276985,297101,+,20116
26,BUMA.1121.00023,1,1611539,1631653,+,20114
26,BUMA.1121.00035,1,317274,337381,+,20107
26,BUMA.1121.00041,1,528964,549078,+,20114
27,BUMA.1121.00057,1,398858,408372,+,9514
27,BUMA.1121.00058,1,1197054,1206586,-,9532
27,BUMA.1121.00045,1,762666,772212,-,9546
27,BUMA.1121.00051,1,3261880,3271399,+,9519
27,BUMA.1121.00068,1,2088443,2097954,+,9511
27,BUMA.1121.00061,1,3219151,3228650,+,9499
27,BUMA.1121.00060,1,3007898,3017444,-,9546
27,BUMA.1121.00064,1,3297925,3307458,+,9533
27,BUMA.1121.00016,1,1408304,1417793,+,9489
27,BUMA.1121.00003,1,1814518,1824040,+,9522
27,BUMA.1121.00055,1,2973637,2983111,+,9474
27,BUMA.1121.00011,1,2306525,2316026,-,9501
27,BUMA.1121.00037,1,1930708,1940199,+,9491
27,BUMA.1121.00009,1,2254379,2263887,-,9508
27,BUMA.1121.00069,1,3202750,3212249,+,9499
27,BUMA.1121.00088,1,127398,136918,+,9520
27,BUMA.1121.00092,1,480139,489636,-,9497
27,BUMA.1121.00074,1,565484,575016,-,9532
27,BUMA.1121.00070,1,3190208,3199707,+,9499
27,BUMA.1121.00093,1,44264,53762,+,9498
27,BUMA.1121.00063,1,3216040,3225539,+,9499
27,BUMA.1121.00033,1,1512207,1521698,+,9491
27,BUMA.1121.00018,1,3926818,3936323,+,9505
27,BUMA.1121.00080,1,3310604,3320137,+,9533
27,BUMA.1121.00027,1,1483927,1493441,+,9514
27,BUMA.1121.00053,1,3056282,3065768,+,9486
27,BUMA.1121.00059,1,2538746,2548279,+,9533
27,BUMA.1121.00043,1,3428140,3437631,+,9491
27,BUMA.1121.00056,1,667471,676989,-,9518
27,BUMA.1121.00112,1,3770589,3780114,-,9525
27,BUMA.1121.00091,1,1187868,1197352,-,9484
27,BUMA.1121.00047,1,3708834,3718333,-,9499
27,BUMA.1121.00067,1,1121063,1130595,-,9532
27,BUMA.1121.00110,1,1514847,1524353,-,9506
27,BUMA.1121.00073,1,3217601,3227100,+,9499
27,BUMA.1121.00072,1,3203982,3213477,+,9495
27,BUMA.1121.00077,1,1958978,1968485,+,9507
27,BUMA.1121.00082,1,3400950,3410449,+,9499
27,BUMA.1121.00062,1,1254752,1264271,-,9519
27,BUMA.1121.00007,1,756296,765829,-,9533
27,BUMA.1121.00025,1,3473528,3483032,-,9504
27,BUMA.1121.00021,1,3955234,3964725,+,9491
27,BUMA.1121.00103,1,1064862,1074372,-,9510
27,BUMA.1121.00096,1,3999563,4009060,-,9497
27,BUMA.1121.00079,1,3343171,3352671,+,9500
27,BUMA.1121.00039,1,3442975,3452466,+,9491
27,BUMA.1121.00083,1,2368943,2378441,-,9498
27,BUMA.1121.00084,1,3659839,3669359,+,9520
27,BUMA.1121.00049,1,2518119,2527605,-,9486
27,BUMA.1121.00089,1,3249824,3259343,+,9519
27,BUMA.1121.00014,1,3616548,3626038,-,9490
27,BUMA.1121.00090,1,1369944,1379435,+,9491
27,BUMA.1121.00071,1,3221883,3231381,+,9498
27,BUMA.1121.00078,1,2702063,2711604,-,9541
27,BUMA.1121.00102,1,1991024,2000522,-,9498
27,BUMA.1121.00075,1,2787495,2796982,+,9487
27,BUMA.1121.00012,1,2047011,2056509,+,9498
27,BUMA.1121.00076,1,2015414,2024900,-,9486
27,BUMA.1121.00106,1,3045084,3054545,+,9461
27,BUMA.1121.00001,1,745868,755358,-,9490
27,BUMA.1121.00107,1,3233458,3242944,+,9486
27,BUMA.1121.00104,1,1946297,1955782,-,9485
27,BUMA.1121.00099,1,3115061,3124457,-,9396
27,BUMA.1121.00098,1,1951542,1961020,+,9478
27,BUMA.1121.00111,1,3482769,3492260,+,9491
27,BUMA.1121.00109,1,2603852,2613347,-,9495
27,BUMA.1121.00097,1,629372,638882,-,9510
27,BUMA.1121.00094,1,3278010,3287529,+,9519
27,BUMA.1121.00095,1,2384956,2394463,-,9507
27,BUMA.1121.00005,1,2050076,2059562,+,9486
27,BUMA.1121.00101,1,3147497,3157009,-,9512
27,BUMA.1121.00065,1,3358527,3368026,+,9499
27,BUMA.1121.00100,1,1987905,1997376,-,9471
27,BUMA.1121.00105,1,1899224,1908732,-,9508
27,BUMA.1121.00029,1,1619696,1629186,-,9490
27,BUMA.1121.00066,1,3207018,3216517,+,9499
27,BUMA.1121.00031,1,623824,633315,+,9491
27,BUMA.1121.00108,1,297413,306941,+,9528
27,BUMA.1121.00023,1,1631965,1641456,+,9491
27,BUMA.1121.00035,1,337693,347184,+,9491
27,BUMA.1121.00041,1,549390,558888,+,9498
28,BUMA.1121.00057,1,408661,420155,+,11494
28,BUMA.1121.00058,1,1185238,1196764,-,11526
28,BUMA.1121.00045,1,750900,762376,-,11476
28,BUMA.1121.00051,1,3271688,3283187,+,11499
28,BUMA.1121.00068,1,2098243,2109784,+,11541
28,BUMA.1121.00061,1,3228939,3240429,+,11490
28,BUMA.1121.00060,1,2996132,3007608,-,11476
28,BUMA.1121.00064,1,3307747,3319245,+,11498
28,BUMA.1121.00016,1,1418082,1429596,+,11514
28,BUMA.1121.00003,1,1824329,1835808,+,11479
28,BUMA.1121.00055,1,2983400,2994894,+,11494
28,BUMA.1121.00011,1,2294818,2306235,-,11417
28,BUMA.1121.00037,1,1940488,1951996,+,11508
28,BUMA.1121.00009,1,2242594,2254089,-,11495
28,BUMA.1121.00069,1,3212538,3224021,+,11483
28,BUMA.1121.00088,1,137207,148681,+,11474
28,BUMA.1121.00092,1,468366,479849,-,11483
28,BUMA.1121.00074,1,553712,565194,-,11482
28,BUMA.1121.00070,1,3199996,3211486,+,11490
28,BUMA.1121.00093,1,54051,65535,+,11484
28,BUMA.1121.00063,1,3225828,3237318,+,11490
28,BUMA.1121.00033,1,1521987,1533500,+,11513
28,BUMA.1121.00018,1,3936612,3948110,+,11498
28,BUMA.1121.00080,1,3320426,3331919,+,11493
28,BUMA.1121.00027,1,1493730,1505244,+,11514
28,BUMA.1121.00053,1,3066057,3077594,+,11537
28,BUMA.1121.00059,1,2548568,2560051,+,11483
28,BUMA.1121.00043,1,3437920,3449393,+,11473
28,BUMA.1121.00056,1,655764,667181,-,11417
28,BUMA.1121.00112,1,3758813,3770299,-,11486
28,BUMA.1121.00091,1,1176072,1187578,-,11506
28,BUMA.1121.00047,1,3697022,3708544,-,11522
28,BUMA.1121.00067,1,1109261,1120773,-,11512
28,BUMA.1121.00110,1,1503077,1514557,-,11480
28,BUMA.1121.00073,1,3227389,3238879,+,11490
28,BUMA.1121.00072,1,3213766,3225245,+,11479
28,BUMA.1121.00077,1,1968774,1980255,+,11481
28,BUMA.1121.00082,1,3410738,3422228,+,11490
28,BUMA.1121.00062,1,1242978,1254462,-,11484
28,BUMA.1121.00007,1,744507,756006,-,11499
28,BUMA.1121.00025,1,3461746,3473238,-,11492
28,BUMA.1121.00021,1,3965014,3976532,+,11518
28,BUMA.1121.00103,1,1053055,1064572,-,11517
28,BUMA.1121.00096,1,3987828,3999273,-,11445
28,BUMA.1121.00079,1,3352960,3364453,+,11493
28,BUMA.1121.00039,1,3452755,3464230,+,11475
28,BUMA.1121.00083,1,2357164,2368653,-,11489
28,BUMA.1121.00084,1,3669648,3681142,+,11494
28,BUMA.1121.00049,1,2506330,2517829,-,11499
28,BUMA.1121.00089,1,3259632,3271050,+,11418
28,BUMA.1121.00014,1,3604735,3616258,-,11523
28,BUMA.1121.00090,1,1379724,1391216,+,11492
28,BUMA.1121.00071,1,3231670,3243149,+,11479
28,BUMA.1121.00078,1,2690286,2701773,-,11487
28,BUMA.1121.00102,1,1979223,1990734,-,11511
28,BUMA.1121.00075,1,2797271,2808782,+,11511
28,BUMA.1121.00012,1,2056798,2068296,+,11498
28,BUMA.1121.00076,1,2003614,2015124,-,11510
28,BUMA.1121.00106,1,3056230,3067733,+,11503
28,BUMA.1121.00001,1,734062,745578,-,11516
28,BUMA.1121.00107,1,3243233,3254700,+,11467
28,BUMA.1121.00104,1,1934525,1946007,-,11482
28,BUMA.1121.00099,1,3103301,3114771,-,11470
28,BUMA.1121.00098,1,1961309,1972805,+,11496
28,BUMA.1121.00111,1,3492549,3504090,+,11541
28,BUMA.1121.00109,1,2592091,2603562,-,11471
28,BUMA.1121.00097,1,617614,629082,-,11468
28,BUMA.1121.00094,1,3287818,3299241,+,11423
28,BUMA.1121.00095,1,2373217,2384666,-,11449
28,BUMA.1121.00005,1,2059851,2071379,+,11528
28,BUMA.1121.00101,1,3135737,3147207,-,11470
28,BUMA.1121.00065,1,3368315,3379793,+,11478
28,BUMA.1121.00100,1,1976107,1987615,-,11508
28,BUMA.1121.00105,1,1887436,1898934,-,11498
28,BUMA.1121.00029,1,1607896,1619406,-,11510
28,BUMA.1121.00066,1,3216806,3228295,+,11489
28,BUMA.1121.00031,1,633604,645113,+,11509
28,BUMA.1121.00108,1,307230,318663,+,11433
28,BUMA.1121.00023,1,1641745,1653293,+,11548
28,BUMA.1121.00035,1,347473,359009,+,11536
28,BUMA.1121.00041,1,559177,570703,+,11526
29,BUMA.1121.00057,1,420206,457957,+,37751
29,BUMA.1121.00058,1,1148313,1185187,-,36874
29,BUMA.1121.00045,1,714124,750849,-,36725
29,BUMA.1121.00051,1,3283238,3320034,+,36796
29,BUMA.1121.00068,1,2109854,2147053,+,37199
29,BUMA.1121.00061,1,3240480,3277377,+,36897
29,BUMA.1121.00060,1,2959384,2996081,-,36697
29,BUMA.1121.00064,1,3319296,3356951,+,37655
29,BUMA.1121.00016,1,1430960,1467996,+,37036
29,BUMA.1121.00003,1,1835874,1872737,+,36863
29,BUMA.1121.00055,1,2996258,3033998,+,37740
29,BUMA.1121.00011,1,2257764,2294767,-,37003
29,BUMA.1121.00037,1,1952047,1989148,+,37101
29,BUMA.1121.00009,1,2204894,2242543,-,37649
29,BUMA.1121.00069,1,3224072,3260945,+,36873
29,BUMA.1121.00088,1,148732,186375,+,37643
29,BUMA.1121.00092,1,430524,468315,-,37791
29,BUMA.1121.00074,1,515992,553661,-,37669
29,BUMA.1121.00070,1,3211537,3248451,+,36914
29,BUMA.1121.00093,1,65586,103307,+,37721
29,BUMA.1121.00063,1,3237369,3274190,+,36821
29,BUMA.1121.00033,1,1533551,1570520,+,36969
29,BUMA.1121.00018,1,3948161,3985164,+,37003
29,BUMA.1121.00080,1,3331970,3368861,+,36891
29,BUMA.1121.00027,1,1505295,1542971,+,37676
29,BUMA.1121.00053,1,3077645,3115562,+,37917
29,BUMA.1121.00059,1,2560102,2597797,+,37695
29,BUMA.1121.00043,1,3449444,3486701,+,37257
29,BUMA.1121.00056,1,618944,655713,-,36769
29,BUMA.1121.00112,1,3721059,3758762,-,37703
29,BUMA.1121.00091,1,1138074,1176021,-,37947
29,BUMA.1121.00047,1,3660264,3696971,-,36707
29,BUMA.1121.00067,1,1071452,1109210,-,37758
29,BUMA.1121.00110,1,1465469,1503026,-,37557
29,BUMA.1121.00073,1,3238930,3275855,+,36925
29,BUMA.1121.00072,1,3225296,3262166,+,36870
29,BUMA.1121.00077,1,1980306,2017854,+,37548
29,BUMA.1121.00082,1,3422279,3459208,+,36929
29,BUMA.1121.00062,1,1205180,1242927,-,37747
29,BUMA.1121.00007,1,706602,744456,-,37854
29,BUMA.1121.00025,1,3424576,3461695,-,37119
29,BUMA.1121.00021,1,3976583,4015067,+,38484
29,BUMA.1121.00103,1,1016208,1053004,-,36796
29,BUMA.1121.00096,1,3950781,3987758,-,36977
29,BUMA.1121.00079,1,3364503,3402238,+,37735
29,BUMA.1121.00039,1,3464281,3501152,+,36871
29,BUMA.1121.00083,1,2320163,2357113,-,36950
29,BUMA.1121.00084,1,3681193,3718902,+,37709
29,BUMA.1121.00049,1,2468590,2506279,-,37689
29,BUMA.1121.00089,1,3271101,3308006,+,36905
29,BUMA.1121.00014,1,3567782,3604684,-,36902
29,BUMA.1121.00090,1,1391267,1428559,+,37292
29,BUMA.1121.00071,1,3243200,3280056,+,36856
29,BUMA.1121.00078,1,2652282,2690235,-,37953
29,BUMA.1121.00102,1,1940854,1979172,-,38318
29,BUMA.1121.00075,1,2808833,2846389,+,37556
29,BUMA.1121.00012,1,2068347,2105268,+,36921
29,BUMA.1121.00076,1,1965916,2003563,-,37647
29,BUMA.1121.00106,1,3067784,3105541,+,37757
29,BUMA.1121.00001,1,697055,734011,-,36956
29,BUMA.1121.00107,1,3254751,3291529,+,36778
29,BUMA.1121.00104,1,1896619,1934474,-,37855
29,BUMA.1121.00099,1,3066486,3103250,-,36764
29,BUMA.1121.00098,1,1972856,2009877,+,37021
29,BUMA.1121.00111,1,3504141,3541454,+,37313
29,BUMA.1121.00109,1,2553827,2592040,-,38213
29,BUMA.1121.00097,1,580686,617563,-,36877
29,BUMA.1121.00094,1,3299292,3336181,+,36889
29,BUMA.1121.00095,1,2333933,2371693,-,37760
29,BUMA.1121.00005,1,2071430,2108591,+,37161
29,BUMA.1121.00101,1,3098815,3135686,-,36871
29,BUMA.1121.00065,1,3379844,3416850,+,37006
29,BUMA.1121.00100,1,1936726,1976056,-,39330
29,BUMA.1121.00105,1,1850728,1887385,-,36657
29,BUMA.1121.00029,1,1570969,1607845,-,36876
29,BUMA.1121.00066,1,3228346,3265194,+,36848
29,BUMA.1121.00031,1,645164,682070,+,36906
29,BUMA.1121.00108,1,318714,355281,+,36567
29,BUMA.1121.00023,1,1653344,1690686,+,37342
29,BUMA.1121.00035,1,359060,396090,+,37030
29,BUMA.1121.00041,1,570754,608516,+,37762
60,BUMA.1121.00057,1,955426,960843,+,5417
60,BUMA.1121.00109,1,2031821,2037234,-,5413
61,BUMA.1121.00057,1,965442,969018,+,3576
61,BUMA.1121.00064,1,3875272,3878845,+,3573
61,BUMA.1121.00059,1,3562078,3565654,-,3576
61,BUMA.1121.00091,1,198503,202079,+,3576
61,BUMA.1121.00110,1,474524,478100,+,3576
61,BUMA.1121.00077,1,3005317,3008893,-,3576
61,BUMA.1121.00107,1,159981,163557,-,3576
61,BUMA.1121.00109,1,2022208,2025778,-,3570
61,BUMA.1121.00100,1,989145,992721,+,3576
62,BUMA.1121.00057,1,974849,980230,+,5381
62,BUMA.1121.00064,1,3884770,3890152,+,5382
62,BUMA.1121.00088,1,730007,735396,+,5389
62,BUMA.1121.00112,1,3203942,3209348,-,5406
62,BUMA.1121.00084,1,3995432,4000813,+,5381
62,BUMA.1121.00106,1,3647268,3652660,+,5392
62,BUMA.1121.00109,1,2010906,2016287,-,5381
63,BUMA.1121.00057,1,983016,995595,+,12579
63,BUMA.1121.00112,1,3188602,3201149,-,12547
63,BUMA.1121.00109,1,1995572,2008117,-,12545
64,BUMA.1121.00057,1,995607,1003393,+,7786
64,BUMA.1121.00058,1,641148,648946,-,7798
64,BUMA.1121.00045,1,177166,184956,-,7790
64,BUMA.1121.00051,1,3888051,3895849,+,7798
64,BUMA.1121.00068,1,2716175,2723962,+,7787
64,BUMA.1121.00061,1,3760928,3768766,+,7838
64,BUMA.1121.00060,1,2422421,2430211,-,7790
64,BUMA.1121.00064,1,3907669,3915466,+,7797
64,BUMA.1121.00016,1,1978353,1986142,+,7789
64,BUMA.1121.00003,1,2395125,2402905,+,7780
64,BUMA.1121.00055,1,3532701,3540488,+,7787
64,BUMA.1121.00011,1,1744853,1752644,-,7791
64,BUMA.1121.00037,1,2521066,2528856,+,7790
64,BUMA.1121.00009,1,1669149,1676934,-,7785
64,BUMA.1121.00069,1,3751808,3759760,+,7952
64,BUMA.1121.00088,1,750244,758040,+,7796
64,BUMA.1121.00092,1,3994300,4002096,+,7796
64,BUMA.1121.00074,1,181776,189574,-,7798
64,BUMA.1121.00070,1,3743504,3751288,+,7784
64,BUMA.1121.00093,1,624378,632174,-,7796
64,BUMA.1121.00063,1,3754228,3762014,+,7786
64,BUMA.1121.00033,1,2158527,2166316,+,7789
64,BUMA.1121.00018,1,383017,390807,+,7790
64,BUMA.1121.00080,1,3914319,3922117,+,7798
64,BUMA.1121.00027,1,2048293,2056089,+,7796
64,BUMA.1121.00053,1,3634130,3641919,+,7789
64,BUMA.1121.00059,1,3111833,3119631,+,7798
64,BUMA.1121.00043,1,4028993,4036783,+,7790
64,BUMA.1121.00056,1,32115,39913,-,7798
64,BUMA.1121.00112,1,3180794,3188588,-,7794
64,BUMA.1121.00091,1,628384,636173,-,7789
64,BUMA.1121.00047,1,3071947,3079745,-,7798
64,BUMA.1121.00067,1,512682,520480,-,7798
64,BUMA.1121.00110,1,923578,931347,-,7769
64,BUMA.1121.00073,1,3767747,3775533,+,7786
64,BUMA.1121.00072,1,3748820,3756794,+,7974
64,BUMA.1121.00077,1,2551968,2559737,+,7769
64,BUMA.1121.00082,1,3975871,3983657,+,7786
64,BUMA.1121.00062,1,682736,690534,-,7798
64,BUMA.1121.00007,1,177769,185556,-,7787
64,BUMA.1121.00025,1,2869073,2876863,-,7790
64,BUMA.1121.00021,1,498530,506321,+,7791
64,BUMA.1121.00103,1,457505,465295,-,7790
64,BUMA.1121.00096,1,3381137,3388927,-,7790
64,BUMA.1121.00079,1,3967566,3975363,+,7797
64,BUMA.1121.00039,1,4019538,4027326,+,7788
64,BUMA.1121.00083,1,1795714,1803500,-,7786
64,BUMA.1121.00084,1,124273,132067,+,7794
64,BUMA.1121.00049,1,1954908,1962697,-,7789
64,BUMA.1121.00089,1,3889590,3897388,+,7798
64,BUMA.1121.00014,1,3005401,3013190,-,7789
64,BUMA.1121.00090,1,1987997,1995787,+,7790
64,BUMA.1121.00071,1,3756872,3764713,+,7841
64,BUMA.1121.00078,1,2142426,2149519,-,7093
64,BUMA.1121.00102,1,1384326,1392113,-,7787
64,BUMA.1121.00075,1,3341402,3349194,+,7792
64,BUMA.1121.00012,1,2601437,2609225,+,7788
64,BUMA.1121.00076,1,1463045,1470837,-,7792
64,BUMA.1121.00106,1,3667505,3675301,+,7796
64,BUMA.1121.00001,1,183682,191470,-,7788
64,BUMA.1121.00107,1,3830269,3838057,+,7788
64,BUMA.1121.00104,1,1380853,1388651,-,7798
64,BUMA.1121.00099,1,2562409,2570199,-,7790
64,BUMA.1121.00098,1,2567967,2575761,+,7794
64,BUMA.1121.00111,1,27331,35121,+,7790
64,BUMA.1121.00109,1,1987780,1995558,-,7778
64,BUMA.1121.00097,1,81195,88984,-,7789
64,BUMA.1121.00094,1,3902907,3910705,+,7798
64,BUMA.1121.00095,1,1769673,1777461,-,7788
64,BUMA.1121.00005,1,3700428,3708212,-,7784
64,BUMA.1121.00101,1,2581208,2588995,-,7787
64,BUMA.1121.00065,1,3939611,3947399,+,7788
64,BUMA.1121.00100,1,1431584,1439358,-,7774
64,BUMA.1121.00105,1,1350515,1358313,-,7798
64,BUMA.1121.00029,1,1060180,1067973,-,7793
64,BUMA.1121.00066,1,3756274,3764060,+,7786
64,BUMA.1121.00031,1,1237247,1245037,+,7790
64,BUMA.1121.00108,1,853898,861685,+,7787
64,BUMA.1121.00023,1,2221042,2228832,+,7790
64,BUMA.1121.00035,1,905313,913101,+,7788
64,BUMA.1121.00041,1,1115888,1123673,+,7785
65,BUMA.1121.00057,1,1003697,1019252,+,15555
65,BUMA.1121.00058,1,625403,641004,-,15601
65,BUMA.1121.00045,1,161443,177085,-,15642
65,BUMA.1121.00051,1,3896075,3911879,+,15804
65,BUMA.1121.00068,1,2724022,2739793,+,15771
65,BUMA.1121.00061,1,3768981,3784634,+,15653
65,BUMA.1121.00060,1,2406635,2422277,-,15642
65,BUMA.1121.00064,1,3915729,3931341,+,15612
65,BUMA.1121.00016,1,1986419,2001780,+,15361
65,BUMA.1121.00003,1,2403343,2419000,+,15657
65,BUMA.1121.00055,1,3540681,3556297,+,15616
65,BUMA.1121.00011,1,1729115,1744625,-,15510
65,BUMA.1121.00037,1,2531702,2547055,+,15353
65,BUMA.1121.00009,1,1653474,1668935,-,15461
65,BUMA.1121.00069,1,3759974,3775627,+,15653
65,BUMA.1121.00088,1,758184,773788,+,15604
65,BUMA.1121.00092,1,4002345,4017659,+,15314
65,BUMA.1121.00074,1,165845,181457,-,15612
65,BUMA.1121.00070,1,3751502,3767155,+,15653
65,BUMA.1121.00093,1,608829,624143,-,15314
65,BUMA.1121.00063,1,3762229,3777882,+,15653
65,BUMA.1121.00033,1,2166495,2182043,+,15548
65,BUMA.1121.00018,1,391040,406442,+,15402
65,BUMA.1121.00080,1,3922282,3938082,+,15800
65,BUMA.1121.00027,1,2056227,2071884,+,15657
65,BUMA.1121.00053,1,3642085,3657802,+,15717
65,BUMA.1121.00059,1,3119894,3135506,+,15612
65,BUMA.1121.00043,1,4037067,4052420,+,15353
65,BUMA.1121.00056,1,16144,31929,-,15785
65,BUMA.1121.00112,1,3165224,3180734,-,15510
65,BUMA.1121.00091,1,612440,628142,-,15702
65,BUMA.1121.00047,1,3055933,3071733,-,15800
65,BUMA.1121.00067,1,496950,512566,-,15616
65,BUMA.1121.00110,1,907851,923455,-,15604
65,BUMA.1121.00073,1,3775748,3791401,+,15653
65,BUMA.1121.00072,1,3757003,3772656,+,15653
65,BUMA.1121.00077,1,2559878,2575485,+,15607
65,BUMA.1121.00082,1,3983872,3999525,+,15653
65,BUMA.1121.00062,1,666878,682543,-,15665
65,BUMA.1121.00007,1,161643,177349,-,15706
65,BUMA.1121.00025,1,2853429,2868831,-,15402
65,BUMA.1121.00021,1,506416,521779,+,15363
65,BUMA.1121.00103,1,441592,457298,-,15706
65,BUMA.1121.00096,1,3365574,3380937,-,15363
65,BUMA.1121.00079,1,3975521,3991320,+,15799
65,BUMA.1121.00039,1,4027666,4043029,+,15363
65,BUMA.1121.00083,1,1779846,1795499,-,15653
65,BUMA.1121.00084,1,132302,147910,+,15608
65,BUMA.1121.00049,1,1939069,1954820,-,15751
65,BUMA.1121.00089,1,3897665,3913450,+,15785
65,BUMA.1121.00014,1,2989871,3005250,-,15379
65,BUMA.1121.00090,1,1996190,2011749,+,15559
65,BUMA.1121.00071,1,3764928,3780581,+,15653
65,BUMA.1121.00078,1,2126908,2142268,-,15360
65,BUMA.1121.00102,1,1368471,1384139,-,15668
65,BUMA.1121.00075,1,3349296,3364963,+,15667
65,BUMA.1121.00012,1,2609474,2624837,+,15363
65,BUMA.1121.00076,1,1447261,1462929,-,15668
65,BUMA.1121.00106,1,3675515,3691123,+,15608
65,BUMA.1121.00001,1,168210,183573,-,15363
65,BUMA.1121.00107,1,3838215,3853920,+,15705
65,BUMA.1121.00104,1,1365079,1380646,-,15567
65,BUMA.1121.00099,1,2546650,2562209,-,15559
65,BUMA.1121.00098,1,2575961,2591667,+,15706
65,BUMA.1121.00111,1,35349,50714,+,15365
65,BUMA.1121.00109,1,1971852,1987468,-,15616
65,BUMA.1121.00097,1,65212,80967,-,15755
65,BUMA.1121.00094,1,3910982,3926783,+,15801
65,BUMA.1121.00095,1,1754044,1769494,-,15450
65,BUMA.1121.00005,1,3684824,3700186,-,15362
65,BUMA.1121.00101,1,2565295,2580952,-,15657
65,BUMA.1121.00065,1,3947599,3963305,+,15706
65,BUMA.1121.00100,1,1415587,1431391,-,15804
65,BUMA.1121.00105,1,1334840,1350448,-,15608
65,BUMA.1121.00029,1,1044631,1059994,-,15363
65,BUMA.1121.00066,1,3764274,3779927,+,15653
65,BUMA.1121.00031,1,1245181,1260510,+,15329
65,BUMA.1121.00108,1,861759,877367,+,15608
65,BUMA.1121.00023,1,2229074,2244427,+,15353
65,BUMA.1121.00035,1,913392,928755,+,15363
65,BUMA.1121.00041,1,1123845,1139251,+,15406
66,BUMA.1121.00057,1,1019317,1022989,+,3672
66,BUMA.1121.00058,1,620210,623883,-,3673
66,BUMA.1121.00045,1,157704,161377,-,3673
66,BUMA.1121.00051,1,3911943,3915615,+,3672
66,BUMA.1121.00068,1,2739858,2743530,+,3672
66,BUMA.1121.00061,1,3784700,3788371,+,3671
66,BUMA.1121.00060,1,2402896,2406569,-,3673
66,BUMA.1121.00064,1,3931406,3935078,+,3672
66,BUMA.1121.00016,1,2001846,2005518,+,3672
66,BUMA.1121.00003,1,2419067,2422739,+,3672
66,BUMA.1121.00055,1,3556362,3560034,+,3672
66,BUMA.1121.00011,1,1725377,1729050,-,3673
66,BUMA.1121.00037,1,2547120,2550799,+,3679
66,BUMA.1121.00009,1,1649736,1653409,-,3673
66,BUMA.1121.00069,1,3775692,3779364,+,3672
66,BUMA.1121.00088,1,773853,777525,+,3672
66,BUMA.1121.00092,1,4017724,4021396,+,3672
66,BUMA.1121.00074,1,162107,165780,-,3673
66,BUMA.1121.00070,1,3767220,3770892,+,3672
66,BUMA.1121.00093,1,605091,608764,-,3673
66,BUMA.1121.00063,1,3777947,3781619,+,3672
66,BUMA.1121.00033,1,2182112,2185784,+,3672
66,BUMA.1121.00018,1,406506,410178,+,3672
66,BUMA.1121.00080,1,3938157,3941819,+,3662
66,BUMA.1121.00027,1,2071948,2075620,+,3672
66,BUMA.1121.00053,1,3659319,3662991,+,3672
66,BUMA.1121.00059,1,3135571,3139243,+,3672
66,BUMA.1121.00043,1,4052485,4056157,+,3672
66,BUMA.1121.00056,1,12406,16079,-,3673
66,BUMA.1121.00112,1,3161484,3165157,-,3673
66,BUMA.1121.00091,1,608701,612374,-,3673
66,BUMA.1121.00047,1,3052195,3055868,-,3673
66,BUMA.1121.00067,1,493212,496875,-,3663
66,BUMA.1121.00110,1,904114,907787,-,3673
66,BUMA.1121.00073,1,3791466,3795138,+,3672
66,BUMA.1121.00072,1,3772721,3776393,+,3672
66,BUMA.1121.00077,1,2575549,2579221,+,3672
66,BUMA.1121.00082,1,3999590,4003262,+,3672
66,BUMA.1121.00062,1,663140,666803,-,3663
66,BUMA.1121.00007,1,157905,161578,-,3673
66,BUMA.1121.00025,1,2849692,2853365,-,3673
66,BUMA.1121.00021,1,521844,525516,+,3672
66,BUMA.1121.00103,1,437855,441528,-,3673
66,BUMA.1121.00096,1,3361837,3365510,-,3673
66,BUMA.1121.00079,1,3991385,3995056,+,3671
66,BUMA.1121.00039,1,4043094,4046782,+,3688
66,BUMA.1121.00083,1,1776108,1779781,-,3673
66,BUMA.1121.00084,1,147975,151647,+,3672
66,BUMA.1121.00049,1,1935331,1939004,-,3673
66,BUMA.1121.00089,1,3913515,3917187,+,3672
66,BUMA.1121.00014,1,2986133,2989806,-,3673
66,BUMA.1121.00090,1,2011814,2015486,+,3672
66,BUMA.1121.00071,1,3780646,3784318,+,3672
66,BUMA.1121.00078,1,2123170,2126843,-,3673
66,BUMA.1121.00102,1,1364733,1368406,-,3673
66,BUMA.1121.00075,1,3365028,3368700,+,3672
66,BUMA.1121.00012,1,2624907,2628579,+,3672
66,BUMA.1121.00076,1,1443523,1447196,-,3673
66,BUMA.1121.00106,1,3691188,3694860,+,3672
66,BUMA.1121.00001,1,164472,168145,-,3673
66,BUMA.1121.00107,1,3853986,3857658,+,3672
66,BUMA.1121.00104,1,1361341,1365014,-,3673
66,BUMA.1121.00099,1,2542908,2546581,-,3673
66,BUMA.1121.00098,1,2591732,2595404,+,3672
66,BUMA.1121.00111,1,50780,54452,+,3672
66,BUMA.1121.00109,1,1968114,1971787,-,3673
66,BUMA.1121.00097,1,61474,65147,-,3673
66,BUMA.1121.00094,1,3926848,3930520,+,3672
66,BUMA.1121.00095,1,1750304,1753978,-,3674
66,BUMA.1121.00005,1,3681085,3684758,-,3673
66,BUMA.1121.00101,1,2561557,2565230,-,3673
66,BUMA.1121.00065,1,3963371,3967043,+,3672
66,BUMA.1121.00100,1,1411850,1415522,-,3672
66,BUMA.1121.00105,1,1331102,1334775,-,3673
66,BUMA.1121.00029,1,1040893,1044566,-,3673
66,BUMA.1121.00066,1,3779992,3783664,+,3672
66,BUMA.1121.00031,1,1260623,1264295,+,3672
66,BUMA.1121.00108,1,877432,881104,+,3672
66,BUMA.1121.00023,1,2244492,2248164,+,3672
66,BUMA.1121.00035,1,928820,932492,+,3672
66,BUMA.1121.00041,1,1139316,1142988,+,3672
67,BUMA.1121.00057,1,1022991,1035035,+,12044
67,BUMA.1121.00058,1,608152,620209,-,12057
67,BUMA.1121.00045,1,145705,157703,-,11998
67,BUMA.1121.00051,1,3915617,3927662,+,12045
67,BUMA.1121.00068,1,2743532,2755561,+,12029
67,BUMA.1121.00061,1,3788373,3800429,+,12056
67,BUMA.1121.00060,1,2390897,2402895,-,11998
67,BUMA.1121.00064,1,3935080,3947127,+,12047
67,BUMA.1121.00016,1,2005520,2017596,+,12076
67,BUMA.1121.00003,1,2422741,2434769,+,12028
67,BUMA.1121.00055,1,3560036,3572066,+,12030
67,BUMA.1121.00011,1,1713329,1725376,-,12047
67,BUMA.1121.00037,1,2550801,2562877,+,12076
67,BUMA.1121.00009,1,1637699,1649735,-,12036
67,BUMA.1121.00069,1,3779366,3791423,+,12057
67,BUMA.1121.00088,1,777527,789620,+,12093
67,BUMA.1121.00092,1,4021398,4033471,+,12073
67,BUMA.1121.00074,1,150046,162106,-,12060
67,BUMA.1121.00070,1,3770894,3782957,+,12063
67,BUMA.1121.00093,1,593016,605090,-,12074
67,BUMA.1121.00063,1,3781621,3793676,+,12055
67,BUMA.1121.00033,1,2185786,2197833,+,12047
67,BUMA.1121.00018,1,410180,422286,+,12106
67,BUMA.1121.00080,1,3941821,3953877,+,12056
67,BUMA.1121.00027,1,2075622,2087741,+,12119
67,BUMA.1121.00053,1,3662993,3675033,+,12040
67,BUMA.1121.00059,1,3139245,3151284,+,12039
67,BUMA.1121.00043,1,4056159,4068235,+,12076
67,BUMA.1121.00056,1,334,12405,-,12071
67,BUMA.1121.00112,1,3149431,3161483,-,12052
67,BUMA.1121.00091,1,596654,608700,-,12046
67,BUMA.1121.00047,1,3040110,3052194,-,12084
67,BUMA.1121.00067,1,481113,493211,-,12098
67,BUMA.1121.00110,1,892063,904113,-,12050
67,BUMA.1121.00073,1,3795140,3807202,+,12062
67,BUMA.1121.00072,1,3776395,3788450,+,12055
67,BUMA.1121.00077,1,2579223,2591273,+,12050
67,BUMA.1121.00082,1,4003264,4015332,+,12068
67,BUMA.1121.00062,1,651111,663139,-,12028
67,BUMA.1121.00007,1,145845,157904,-,12059
67,BUMA.1121.00025,1,2837578,2849691,-,12113
67,BUMA.1121.00021,1,525518,537592,+,12074
67,BUMA.1121.00103,1,425722,437854,-,12132
67,BUMA.1121.00096,1,3349779,3361836,-,12057
67,BUMA.1121.00079,1,3995058,4007141,+,12083
67,BUMA.1121.00039,1,1,12013,+,12012
67,BUMA.1121.00083,1,1764038,1776107,-,12069
67,BUMA.1121.00084,1,151649,163680,+,12031
67,BUMA.1121.00049,1,1923266,1935330,-,12064
67,BUMA.1121.00089,1,3917189,3929259,+,12070
67,BUMA.1121.00014,1,2974069,2986132,-,12063
67,BUMA.1121.00090,1,2015488,2027534,+,12046
67,BUMA.1121.00071,1,3784320,3796388,+,12068
67,BUMA.1121.00078,1,2111135,2123169,-,12034
67,BUMA.1121.00102,1,1352705,1364732,-,12027
67,BUMA.1121.00075,1,3368702,3380752,+,12050
67,BUMA.1121.00012,1,2628581,2640624,+,12043
67,BUMA.1121.00076,1,1431471,1443522,-,12051
67,BUMA.1121.00106,1,3694862,3706894,+,12032
67,BUMA.1121.00001,1,152403,164471,-,12068
67,BUMA.1121.00107,1,3857660,3869726,+,12066
67,BUMA.1121.00104,1,1349271,1361340,-,12069
67,BUMA.1121.00099,1,2530852,2542907,-,12055
67,BUMA.1121.00098,1,2595406,2607443,+,12037
67,BUMA.1121.00111,1,54454,66518,+,12064
67,BUMA.1121.00109,1,1955991,1968113,-,12122
67,BUMA.1121.00097,1,49428,61473,-,12045
67,BUMA.1121.00094,1,3930522,3942586,+,12064
67,BUMA.1121.00095,1,1738251,1750303,-,12052
67,BUMA.1121.00005,1,3669032,3681084,-,12052
67,BUMA.1121.00101,1,2549551,2561556,-,12005
67,BUMA.1121.00065,1,3967045,3979125,+,12080
67,BUMA.1121.00100,1,1399805,1411849,-,12044
67,BUMA.1121.00105,1,1319061,1331101,-,12040
67,BUMA.1121.00029,1,1028824,1040892,-,12068
67,BUMA.1121.00066,1,3783666,3795734,+,12068
67,BUMA.1121.00031,1,1264297,1276371,+,12074
67,BUMA.1121.00108,1,881106,893142,+,12036
67,BUMA.1121.00023,1,2248166,2260236,+,12070
67,BUMA.1121.00035,1,932494,944567,+,12073
67,BUMA.1121.00041,1,1142990,1155014,+,12024
68,BUMA.1121.00057,1,1037978,1053636,+,15658
68,BUMA.1121.00058,1,589786,605436,-,15650
68,BUMA.1121.00045,1,127314,142965,-,15651
68,BUMA.1121.00051,1,3930637,3946279,+,15642
68,BUMA.1121.00068,1,2758400,2774058,+,15658
68,BUMA.1121.00061,1,3803340,3818998,+,15658
68,BUMA.1121.00060,1,2372498,2388149,-,15651
68,BUMA.1121.00064,1,3949942,3965600,+,15658
68,BUMA.1121.00016,1,2020561,2036208,+,15647
68,BUMA.1121.00003,1,2437524,2453174,+,15650
68,BUMA.1121.00055,1,3574863,3590514,+,15651
68,BUMA.1121.00011,1,1694981,1710638,-,15657
68,BUMA.1121.00037,1,2565698,2581363,+,15665
68,BUMA.1121.00009,1,1619131,1634773,-,15642
68,BUMA.1121.00069,1,3794334,3809992,+,15658
68,BUMA.1121.00088,1,792443,808101,+,15658
68,BUMA.1121.00092,1,4036300,4051958,+,15658
68,BUMA.1121.00074,1,131494,147152,-,15658
68,BUMA.1121.00070,1,3785746,3801404,+,15658
68,BUMA.1121.00093,1,574546,590204,-,15658
68,BUMA.1121.00063,1,3796587,3812245,+,15658
68,BUMA.1121.00033,1,2200518,2216157,+,15639
68,BUMA.1121.00018,1,425099,440764,+,15665
68,BUMA.1121.00080,1,3956789,3972446,+,15657
68,BUMA.1121.00027,1,2090612,2106269,+,15657
68,BUMA.1121.00053,1,3677954,3693613,+,15659
68,BUMA.1121.00059,1,3154173,3169831,+,15658
68,BUMA.1121.00043,1,4071112,4086780,+,15668
68,BUMA.1121.00056,1,3966172,3981823,-,15651
68,BUMA.1121.00112,1,3130968,3146618,-,15650
68,BUMA.1121.00091,1,578046,593704,-,15658
68,BUMA.1121.00047,1,3021542,3037184,-,15642
68,BUMA.1121.00067,1,462555,478213,-,15658
68,BUMA.1121.00110,1,873597,889246,-,15649
68,BUMA.1121.00073,1,3809982,3825640,+,15658
68,BUMA.1121.00072,1,3791361,3807019,+,15658
68,BUMA.1121.00077,1,2594154,2609803,+,15649
68,BUMA.1121.00082,1,4018243,4033901,+,15658
68,BUMA.1121.00062,1,632597,648247,-,15650
68,BUMA.1121.00007,1,127468,143119,-,15651
68,BUMA.1121.00025,1,2819125,2834790,-,15665
68,BUMA.1121.00021,1,540509,556174,+,15665
68,BUMA.1121.00103,1,407206,422855,-,15649
68,BUMA.1121.00096,1,3331315,3346958,-,15643
68,BUMA.1121.00079,1,4010012,4025670,+,15658
68,BUMA.1121.00039,1,14914,30579,+,15665
68,BUMA.1121.00083,1,1745470,1761128,-,15658
68,BUMA.1121.00084,1,166387,182037,+,15650
68,BUMA.1121.00049,1,1904902,1920560,-,15658
68,BUMA.1121.00089,1,3932064,3947715,+,15651
68,BUMA.1121.00014,1,2955544,2971201,-,15657
68,BUMA.1121.00090,1,2030379,2046044,+,15665
68,BUMA.1121.00071,1,3799299,3814957,+,15658
68,BUMA.1121.00078,1,2092763,2108419,-,15656
68,BUMA.1121.00102,1,1334129,1349787,-,15658
68,BUMA.1121.00075,1,3383437,3399096,+,15659
68,BUMA.1121.00012,1,2643501,2659166,+,15665
68,BUMA.1121.00076,1,1413128,1428787,-,15659
68,BUMA.1121.00106,1,3709717,3725367,+,15650
68,BUMA.1121.00001,1,133767,149599,-,15832
68,BUMA.1121.00107,1,3872533,3888187,+,15654
68,BUMA.1121.00104,1,1330915,1346565,-,15650
68,BUMA.1121.00099,1,2512483,2528141,-,15658
68,BUMA.1121.00098,1,2610240,2625896,+,15656
68,BUMA.1121.00111,1,69427,85086,+,15659
68,BUMA.1121.00109,1,1937393,1953050,-,15657
68,BUMA.1121.00097,1,31019,46678,-,15659
68,BUMA.1121.00094,1,3945391,3961042,+,15651
68,BUMA.1121.00095,1,1719617,1735279,-,15662
68,BUMA.1121.00005,1,3650498,3666164,-,15666
68,BUMA.1121.00101,1,2531157,2546767,-,15610
68,BUMA.1121.00065,1,3981948,3997599,+,15651
68,BUMA.1121.00100,1,1381288,1396931,-,15643
68,BUMA.1121.00105,1,1300609,1316259,-,15650
68,BUMA.1121.00029,1,1010028,1025860,-,15832
68,BUMA.1121.00066,1,3798645,3814303,+,15658
68,BUMA.1121.00031,1,1279240,1294885,+,15645
68,BUMA.1121.00108,1,895899,911557,+,15658
68,BUMA.1121.00023,1,2262921,2278586,+,15665
68,BUMA.1121.00035,1,947404,963069,+,15665
68,BUMA.1121.00041,1,1158001,1173659,+,15658
69,BUMA.1121.00057,1,1053637,1084709,+,31072
69,BUMA.1121.00058,1,558832,589784,-,30952
69,BUMA.1121.00045,1,96231,127312,-,31081
69,BUMA.1121.00051,1,3946280,3977257,+,30977
69,BUMA.1121.00068,1,2774059,2804936,+,30877
69,BUMA.1121.00061,1,3818999,3849885,+,30886
69,BUMA.1121.00060,1,2341415,2372496,-,31081
69,BUMA.1121.00064,1,3965601,3996673,+,31072
69,BUMA.1121.00016,1,2036212,2067105,+,30893
69,BUMA.1121.00003,1,2453175,2484152,+,30977
69,BUMA.1121.00055,1,3590515,3621491,+,30976
69,BUMA.1121.00011,1,1664105,1694979,-,30874
69,BUMA.1121.00037,1,2581364,2612525,+,31161
69,BUMA.1121.00009,1,1588101,1619129,-,31028
69,BUMA.1121.00069,1,3809993,3840879,+,30886
69,BUMA.1121.00088,1,808102,839269,+,31167
69,BUMA.1121.00092,1,4051959,4082928,+,30969
69,BUMA.1121.00074,1,100420,131492,-,31072
69,BUMA.1121.00070,1,3801405,3832291,+,30886
69,BUMA.1121.00093,1,543575,574544,-,30969
69,BUMA.1121.00063,1,3812246,3843132,+,30886
69,BUMA.1121.00033,1,2216161,2247055,+,30894
69,BUMA.1121.00018,1,440765,471930,+,31165
69,BUMA.1121.00080,1,3972447,4003519,+,31072
69,BUMA.1121.00027,1,2106270,2137340,+,31070
69,BUMA.1121.00053,1,3693614,3724497,+,30883
69,BUMA.1121.00059,1,3169832,3200867,+,31035
69,BUMA.1121.00043,1,4086781,4117667,+,30886
69,BUMA.1121.00056,1,3935192,3966170,-,30978
69,BUMA.1121.00112,1,3099882,3130966,-,31084
69,BUMA.1121.00091,1,547166,578044,-,30878
69,BUMA.1121.00047,1,2990562,3021540,-,30978
69,BUMA.1121.00067,1,431490,462553,-,31063
69,BUMA.1121.00110,1,842717,873595,-,30878
69,BUMA.1121.00073,1,3825641,3856527,+,30886
69,BUMA.1121.00072,1,3807020,3837906,+,30886
69,BUMA.1121.00077,1,2609804,2640682,+,30878
69,BUMA.1121.00082,1,4033902,4064788,+,30886
69,BUMA.1121.00062,1,601709,632595,-,30886
69,BUMA.1121.00007,1,96566,127466,-,30900
69,BUMA.1121.00025,1,2787958,2819123,-,31165
69,BUMA.1121.00021,1,556175,587341,+,31166
69,BUMA.1121.00103,1,374722,405625,-,30903
69,BUMA.1121.00096,1,3299118,3331313,-,32195
69,BUMA.1121.00079,1,4025671,4056743,+,31072
69,BUMA.1121.00039,1,30580,61748,+,31168
69,BUMA.1121.00083,1,1714582,1745468,-,30886
69,BUMA.1121.00084,1,182038,213015,+,30977
69,BUMA.1121.00049,1,1873827,1904900,-,31073
69,BUMA.1121.00089,1,3947716,3978694,+,30978
69,BUMA.1121.00014,1,2924389,2955542,-,31153
69,BUMA.1121.00090,1,2046045,2077210,+,31165
69,BUMA.1121.00071,1,3814958,3845844,+,30886
69,BUMA.1121.00078,1,2062166,2092761,-,30595
69,BUMA.1121.00102,1,1302963,1334127,-,31164
69,BUMA.1121.00075,1,3399097,3430169,+,31072
69,BUMA.1121.00012,1,2659167,2690329,+,31162
69,BUMA.1121.00076,1,1382053,1413126,-,31073
69,BUMA.1121.00106,1,3725368,3756441,+,31073
69,BUMA.1121.00001,1,102605,133765,-,31160
69,BUMA.1121.00107,1,3889769,3920671,+,30902
69,BUMA.1121.00104,1,1299839,1330913,-,31074
69,BUMA.1121.00099,1,2481482,2512481,-,30999
69,BUMA.1121.00098,1,2627475,2658375,+,30900
69,BUMA.1121.00111,1,85087,116251,+,31164
69,BUMA.1121.00109,1,1906297,1937391,-,31094
69,BUMA.1121.00097,1,24,31017,-,30993
69,BUMA.1121.00094,1,3961043,3992016,+,30973
69,BUMA.1121.00095,1,1688722,1719615,-,30893
69,BUMA.1121.00005,1,3619619,3650496,-,30877
69,BUMA.1121.00101,1,2500083,2531155,-,31072
69,BUMA.1121.00065,1,3997600,4028764,+,31164
69,BUMA.1121.00100,1,1350307,1381286,-,30979
69,BUMA.1121.00105,1,1269719,1300607,-,30888
69,BUMA.1121.00029,1,978867,1010026,-,31159
69,BUMA.1121.00066,1,3814304,3845189,+,30885
69,BUMA.1121.00031,1,1294889,1326059,+,31170
69,BUMA.1121.00108,1,911558,942608,+,31050
69,BUMA.1121.00023,1,2278587,2309743,+,31156
69,BUMA.1121.00035,1,963070,994230,+,31160
69,BUMA.1121.00041,1,1173660,1204824,+,31164
70,BUMA.1121.00057,1,1084711,1094295,+,9584
70,BUMA.1121.00058,1,549261,558831,-,9570
70,BUMA.1121.00045,1,86635,96230,-,9595
70,BUMA.1121.00051,1,3977259,3986840,+,9581
70,BUMA.1121.00068,1,2804938,2814511,+,9573
70,BUMA.1121.00061,1,3849887,3859471,+,9584
70,BUMA.1121.00060,1,2331819,2341414,-,9595
70,BUMA.1121.00064,1,3996675,4006259,+,9584
70,BUMA.1121.00016,1,2067107,2076667,+,9560
70,BUMA.1121.00003,1,2484154,2493749,+,9595
70,BUMA.1121.00055,1,3621493,3631077,+,9584
70,BUMA.1121.00011,1,1654509,1664104,-,9595
70,BUMA.1121.00037,1,2612527,2622118,+,9591
70,BUMA.1121.00009,1,1578517,1588100,-,9583
70,BUMA.1121.00069,1,3840881,3850465,+,9584
70,BUMA.1121.00088,1,839271,848866,+,9595
70,BUMA.1121.00092,1,4082930,4092500,+,9570
70,BUMA.1121.00074,1,90835,100419,-,9584
70,BUMA.1121.00070,1,3832293,3841877,+,9584
70,BUMA.1121.00093,1,534004,543574,-,9570
70,BUMA.1121.00063,1,3843134,3852718,+,9584
70,BUMA.1121.00033,1,2247057,2256648,+,9591
70,BUMA.1121.00018,1,471932,481523,+,9591
70,BUMA.1121.00080,1,4003521,4013105,+,9584
70,BUMA.1121.00027,1,2137342,2146937,+,9595
70,BUMA.1121.00053,1,3724499,3734094,+,9595
70,BUMA.1121.00059,1,3200869,3210427,+,9558
70,BUMA.1121.00043,1,4117669,4127253,+,9584
70,BUMA.1121.00056,1,3925600,3935191,-,9591
70,BUMA.1121.00112,1,3090286,3099881,-,9595
70,BUMA.1121.00091,1,537581,547165,-,9584
70,BUMA.1121.00047,1,2980979,2990561,-,9582
70,BUMA.1121.00067,1,421905,431489,-,9584
70,BUMA.1121.00110,1,833121,842716,-,9595
70,BUMA.1121.00073,1,3856529,3866113,+,9584
70,BUMA.1121.00072,1,3837908,3847492,+,9584
70,BUMA.1121.00077,1,2640684,2650275,+,9591
70,BUMA.1121.00082,1,4064790,4074374,+,9584
70,BUMA.1121.00062,1,592113,601708,-,9595
70,BUMA.1121.00007,1,86971,96565,-,9594
70,BUMA.1121.00025,1,2778366,2787957,-,9591
70,BUMA.1121.00021,1,587343,596927,+,9584
70,BUMA.1121.00103,1,365114,374721,-,9607
70,BUMA.1121.00096,1,3289533,3299117,-,9584
70,BUMA.1121.00079,1,4056745,4066328,+,9583
70,BUMA.1121.00039,1,61750,71341,+,9591
70,BUMA.1121.00083,1,1704997,1714581,-,9584
70,BUMA.1121.00084,1,213017,222612,+,9595
70,BUMA.1121.00049,1,1864231,1873826,-,9595
70,BUMA.1121.00089,1,3978696,3988287,+,9591
70,BUMA.1121.00014,1,2914775,2924388,-,9613
70,BUMA.1121.00090,1,2077212,2086803,+,9591
70,BUMA.1121.00071,1,3845846,3855430,+,9584
70,BUMA.1121.00078,1,2052584,2062165,-,9581
70,BUMA.1121.00102,1,1293393,1302962,-,9569
70,BUMA.1121.00075,1,3430171,3439766,+,9595
70,BUMA.1121.00012,1,2690331,2699922,+,9591
70,BUMA.1121.00076,1,1372457,1382052,-,9595
70,BUMA.1121.00106,1,3756443,3766038,+,9595
70,BUMA.1121.00001,1,93013,102604,-,9591
70,BUMA.1121.00107,1,3920673,3930268,+,9595
70,BUMA.1121.00104,1,1290243,1299838,-,9595
70,BUMA.1121.00099,1,2471886,2481481,-,9595
70,BUMA.1121.00098,1,2658377,2667971,+,9594
70,BUMA.1121.00111,1,116253,125837,+,9584
70,BUMA.1121.00109,1,1896703,1906296,-,9593
70,BUMA.1121.00097,1,4058429,4067985,-,9556
70,BUMA.1121.00094,1,3992018,4001609,+,9591
70,BUMA.1121.00095,1,1679114,1688721,-,9607
70,BUMA.1121.00005,1,3610013,3619618,-,9605
70,BUMA.1121.00101,1,2490487,2500082,-,9595
70,BUMA.1121.00065,1,4028766,4038336,+,9570
70,BUMA.1121.00100,1,1340711,1350306,-,9595
70,BUMA.1121.00105,1,1260123,1269718,-,9595
70,BUMA.1121.00029,1,969275,978866,-,9591
70,BUMA.1121.00066,1,3845191,3854775,+,9584
70,BUMA.1121.00031,1,1326061,1335674,+,9613
70,BUMA.1121.00108,1,942610,952205,+,9595
70,BUMA.1121.00023,1,2309745,2319336,+,9591
70,BUMA.1121.00035,1,994232,1003821,+,9589
70,BUMA.1121.00041,1,1204826,1214421,+,9595
71,BUMA.1121.00057,1,1094464,1100276,+,5812
71,BUMA.1121.00058,1,543280,549092,-,5812
71,BUMA.1121.00045,1,80654,86466,-,5812
71,BUMA.1121.00051,1,1,5813,+,5812
71,BUMA.1121.00068,1,2814680,2820483,+,5803
71,BUMA.1121.00061,1,1,5813,+,5812
71,BUMA.1121.00060,1,2325838,2331650,-,5812
71,BUMA.1121.00064,1,1,5813,+,5812
71,BUMA.1121.00016,1,2078179,2083991,+,5812
71,BUMA.1121.00003,1,2493918,2499721,+,5803
71,BUMA.1121.00055,1,3631246,3637055,+,5809
71,BUMA.1121.00011,1,1648528,1654340,-,5812
71,BUMA.1121.00037,1,2622287,2628099,+,5812
71,BUMA.1121.00009,1,1572545,1578348,-,5803
71,BUMA.1121.00069,1,1,5813,+,5812
71,BUMA.1121.00088,1,849035,854847,+,5812
71,BUMA.1121.00092,1,1,5813,+,5812
71,BUMA.1121.00074,1,84854,90666,-,5812
71,BUMA.1121.00070,1,1,5813,+,5812
71,BUMA.1121.00093,1,528023,533835,-,5812
71,BUMA.1121.00063,1,1,5813,+,5812
71,BUMA.1121.00033,1,2256817,2262629,+,5812
71,BUMA.1121.00018,1,481692,487504,+,5812
71,BUMA.1121.00080,1,1,5813,+,5812
71,BUMA.1121.00027,1,2147106,2152918,+,5812
71,BUMA.1121.00053,1,3734263,3740074,+,5811
71,BUMA.1121.00059,1,3210596,3216408,+,5812
71,BUMA.1121.00043,1,4127422,4133233,+,5811
71,BUMA.1121.00056,1,3919619,3925431,-,5812
71,BUMA.1121.00112,1,3084305,3090117,-,5812
71,BUMA.1121.00091,1,531600,537412,-,5812
71,BUMA.1121.00047,1,2974998,2980810,-,5812
71,BUMA.1121.00067,1,415924,421736,-,5812
71,BUMA.1121.00110,1,827131,832952,-,5821
71,BUMA.1121.00073,1,1,5813,+,5812
71,BUMA.1121.00072,1,1,5813,+,5812
71,BUMA.1121.00077,1,2650443,2656264,+,5821
71,BUMA.1121.00082,1,1,5813,+,5812
71,BUMA.1121.00062,1,586132,591944,-,5812
71,BUMA.1121.00007,1,80990,86802,-,5812
71,BUMA.1121.00025,1,2772384,2778197,-,5813
71,BUMA.1121.00021,1,597096,602899,+,5803
71,BUMA.1121.00103,1,359134,364945,-,5811
71,BUMA.1121.00096,1,3283552,3289364,-,5812
71,BUMA.1121.00079,1,1,5813,+,5812
71,BUMA.1121.00039,1,71510,77322,+,5812
71,BUMA.1121.00083,1,1699016,1704828,-,5812
71,BUMA.1121.00084,1,222781,228593,+,5812
71,BUMA.1121.00049,1,1858250,1864062,-,5812
71,BUMA.1121.00089,1,1,5813,+,5812
71,BUMA.1121.00014,1,2908794,2914606,-,5812
71,BUMA.1121.00090,1,2086972,2092784,+,5812
71,BUMA.1121.00071,1,1,5813,+,5812
71,BUMA.1121.00078,1,2046603,2052415,-,5812
71,BUMA.1121.00102,1,1287412,1293224,-,5812
71,BUMA.1121.00075,1,3439935,3445747,+,5812
71,BUMA.1121.00012,1,2700091,2705903,+,5812
71,BUMA.1121.00076,1,1366476,1372288,-,5812
71,BUMA.1121.00106,1,3766207,3772019,+,5812
71,BUMA.1121.00001,1,87032,92844,-,5812
71,BUMA.1121.00107,1,3930437,3936249,+,5812
71,BUMA.1121.00104,1,1284262,1290074,-,5812
71,BUMA.1121.00099,1,2465906,2471718,-,5812
71,BUMA.1121.00098,1,2668140,2673949,+,5809
71,BUMA.1121.00111,1,126006,131809,+,5803
71,BUMA.1121.00109,1,1890722,1896534,-,5812
71,BUMA.1121.00097,1,4052448,4058260,-,5812
71,BUMA.1121.00094,1,1,5813,+,5812
71,BUMA.1121.00095,1,1673134,1678945,-,5811
71,BUMA.1121.00005,1,3604032,3609844,-,5812
71,BUMA.1121.00101,1,2484506,2490318,-,5812
71,BUMA.1121.00065,1,1,5812,+,5811
71,BUMA.1121.00100,1,1334730,1340542,-,5812
71,BUMA.1121.00105,1,1254142,1259954,-,5812
71,BUMA.1121.00029,1,963294,969106,-,5812
71,BUMA.1121.00066,1,1,5813,+,5812
71,BUMA.1121.00031,1,1335843,1341655,+,5812
71,BUMA.1121.00108,1,952373,958182,+,5809
71,BUMA.1121.00023,1,2319505,2325317,+,5812
71,BUMA.1121.00035,1,1003990,1009802,+,5812
71,BUMA.1121.00041,1,1214590,1220402,+,5812
72,BUMA.1121.00057,1,1100277,1114768,+,14491
72,BUMA.1121.00058,1,528790,543278,-,14488
72,BUMA.1121.00045,1,66180,80652,-,14472
72,BUMA.1121.00051,1,5814,20305,+,14491
72,BUMA.1121.00068,1,2820484,2834975,+,14491
72,BUMA.1121.00061,1,5814,20305,+,14491
72,BUMA.1121.00060,1,2311364,2325836,-,14472
72,BUMA.1121.00064,1,5814,20305,+,14491
72,BUMA.1121.00016,1,2083992,2098483,+,14491
72,BUMA.1121.00003,1,2499722,2514204,+,14482
72,BUMA.1121.00055,1,3638639,3653145,+,14506
72,BUMA.1121.00011,1,1634055,1648526,-,14471
72,BUMA.1121.00037,1,2628100,2642591,+,14491
72,BUMA.1121.00009,1,1558053,1572543,-,14490
72,BUMA.1121.00069,1,5814,20305,+,14491
72,BUMA.1121.00088,1,854848,869339,+,14491
72,BUMA.1121.00092,1,5814,20305,+,14491
72,BUMA.1121.00074,1,70362,84852,-,14490
72,BUMA.1121.00070,1,5814,20305,+,14491
72,BUMA.1121.00093,1,513531,528021,-,14490
72,BUMA.1121.00063,1,5814,20301,+,14487
72,BUMA.1121.00033,1,2262630,2277121,+,14491
72,BUMA.1121.00018,1,487505,501996,+,14491
72,BUMA.1121.00080,1,5814,20305,+,14491
72,BUMA.1121.00027,1,2152919,2167410,+,14491
72,BUMA.1121.00053,1,3740075,3754552,+,14477
72,BUMA.1121.00059,1,3216409,3230900,+,14491
72,BUMA.1121.00043,1,4133234,4147725,+,14491
72,BUMA.1121.00056,1,3905127,3919617,-,14490
72,BUMA.1121.00112,1,3069836,3084303,-,14467
72,BUMA.1121.00091,1,517120,531598,-,14478
72,BUMA.1121.00047,1,2960506,2974996,-,14490
72,BUMA.1121.00067,1,401432,415922,-,14490
72,BUMA.1121.00110,1,812639,827129,-,14490
72,BUMA.1121.00073,1,5814,20305,+,14491
72,BUMA.1121.00072,1,5814,20305,+,14491
72,BUMA.1121.00077,1,2656265,2670754,+,14489
72,BUMA.1121.00082,1,5814,20305,+,14491
72,BUMA.1121.00062,1,571640,586130,-,14490
72,BUMA.1121.00007,1,66498,80988,-,14490
72,BUMA.1121.00025,1,2757892,2772382,-,14490
72,BUMA.1121.00021,1,602900,617391,+,14491
72,BUMA.1121.00103,1,344642,359132,-,14490
72,BUMA.1121.00096,1,3269057,3283550,-,14493
72,BUMA.1121.00079,1,5814,20305,+,14491
72,BUMA.1121.00039,1,77323,91814,+,14491
72,BUMA.1121.00083,1,1684524,1699014,-,14490
72,BUMA.1121.00084,1,228594,243085,+,14491
72,BUMA.1121.00049,1,1843758,1858248,-,14490
72,BUMA.1121.00089,1,5814,20305,+,14491
72,BUMA.1121.00014,1,2894302,2908792,-,14490
72,BUMA.1121.00090,1,2092785,2107276,+,14491
72,BUMA.1121.00071,1,5814,20301,+,14487
72,BUMA.1121.00078,1,2032111,2046601,-,14490
72,BUMA.1121.00102,1,1272920,1287410,-,14490
72,BUMA.1121.00075,1,3445748,3460174,+,14426
72,BUMA.1121.00012,1,2705904,2720395,+,14491
72,BUMA.1121.00076,1,1352000,1366474,-,14474
72,BUMA.1121.00106,1,3772020,3786511,+,14491
72,BUMA.1121.00001,1,72540,87030,-,14490
72,BUMA.1121.00107,1,3936250,3950728,+,14478
72,BUMA.1121.00104,1,1269777,1284260,-,14483
72,BUMA.1121.00099,1,2451426,2465904,-,14478
72,BUMA.1121.00098,1,2675534,2690040,+,14506
72,BUMA.1121.00111,1,131810,146301,+,14491
72,BUMA.1121.00109,1,1876242,1890720,-,14478
72,BUMA.1121.00097,1,4037956,4052446,-,14490
72,BUMA.1121.00094,1,5814,20303,+,14489
72,BUMA.1121.00095,1,1658652,1673132,-,14480
72,BUMA.1121.00005,1,3589540,3604030,-,14490
72,BUMA.1121.00101,1,2469905,2484504,-,14599
72,BUMA.1121.00065,1,5813,20304,+,14491
72,BUMA.1121.00100,1,1320247,1334728,-,14481
72,BUMA.1121.00105,1,1239650,1254140,-,14490
72,BUMA.1121.00029,1,948802,963292,-,14490
72,BUMA.1121.00066,1,5814,20305,+,14491
72,BUMA.1121.00031,1,1341656,1356151,+,14495
72,BUMA.1121.00108,1,959766,974272,+,14506
72,BUMA.1121.00023,1,2325318,2339809,+,14491
72,BUMA.1121.00035,1,1009803,1024294,+,14491
72,BUMA.1121.00041,1,1220403,1234892,+,14489
73,BUMA.1121.00057,1,1114769,1120124,+,5355
73,BUMA.1121.00058,1,523396,528699,-,5303
73,BUMA.1121.00045,1,60849,66154,-,5305
73,BUMA.1121.00051,1,20306,25703,+,5397
73,BUMA.1121.00068,1,2834976,2840383,+,5407
73,BUMA.1121.00061,1,20310,25678,+,5368
73,BUMA.1121.00060,1,2306040,2311345,-,5305
73,BUMA.1121.00064,1,20306,25714,+,5408
73,BUMA.1121.00016,1,2098484,2103850,+,5366
73,BUMA.1121.00003,1,2514206,2519518,+,5312
73,BUMA.1121.00055,1,3653171,3658549,+,5378
73,BUMA.1121.00011,1,1628698,1634022,-,5324
73,BUMA.1121.00037,1,2642592,2648014,+,5422
73,BUMA.1121.00009,1,1552735,1558051,-,5316
73,BUMA.1121.00069,1,20306,25678,+,5372
73,BUMA.1121.00088,1,869365,874730,+,5365
73,BUMA.1121.00092,1,20306,25648,+,5342
73,BUMA.1121.00074,1,64973,70294,-,5321
73,BUMA.1121.00070,1,20310,25678,+,5368
73,BUMA.1121.00093,1,508187,513498,-,5311
73,BUMA.1121.00063,1,20302,25671,+,5369
73,BUMA.1121.00033,1,2277122,2282467,+,5345
73,BUMA.1121.00018,1,502015,507370,+,5355
73,BUMA.1121.00080,1,20306,25689,+,5383
73,BUMA.1121.00027,1,2167411,2172745,+,5334
73,BUMA.1121.00053,1,3754580,3759967,+,5387
73,BUMA.1121.00059,1,3230901,3236271,+,5370
73,BUMA.1121.00043,1,4147726,4153113,+,5387
73,BUMA.1121.00056,1,3899777,3905080,-,5303
73,BUMA.1121.00112,1,3064504,3069795,-,5291
73,BUMA.1121.00091,1,511782,517094,-,5312
73,BUMA.1121.00047,1,2955128,2960431,-,5303
73,BUMA.1121.00067,1,396022,401343,-,5321
73,BUMA.1121.00110,1,807264,812585,-,5321
73,BUMA.1121.00073,1,20310,25678,+,5368
73,BUMA.1121.00072,1,20306,25678,+,5372
73,BUMA.1121.00077,1,2670755,2676128,+,5373
73,BUMA.1121.00082,1,20306,25678,+,5372
73,BUMA.1121.00062,1,566246,571558,-,5312
73,BUMA.1121.00007,1,61182,66493,-,5311
73,BUMA.1121.00025,1,2752517,2757838,-,5321
73,BUMA.1121.00021,1,617392,622758,+,5366
73,BUMA.1121.00103,1,339283,344637,-,5354
73,BUMA.1121.00096,1,3263691,3269003,-,5312
73,BUMA.1121.00079,1,20306,25814,+,5508
73,BUMA.1121.00039,1,91815,97216,+,5401
73,BUMA.1121.00083,1,1679150,1684491,-,5341
73,BUMA.1121.00084,1,243086,248385,+,5299
73,BUMA.1121.00049,1,1838422,1843725,-,5303
73,BUMA.1121.00089,1,20310,25654,+,5344
73,BUMA.1121.00014,1,2888957,2894258,-,5301
73,BUMA.1121.00090,1,2107277,2112664,+,5387
73,BUMA.1121.00071,1,20302,25674,+,5372
73,BUMA.1121.00078,1,2026732,2032057,-,5325
73,BUMA.1121.00102,1,1267480,1272782,-,5302
73,BUMA.1121.00075,1,3461393,3466831,+,5438
73,BUMA.1121.00012,1,2720396,2725790,+,5394
73,BUMA.1121.00076,1,1345370,1350676,-,5306
73,BUMA.1121.00106,1,3786544,3791888,+,5344
73,BUMA.1121.00001,1,67109,72430,-,5321
73,BUMA.1121.00107,1,3950733,3956119,+,5386
73,BUMA.1121.00104,1,1263182,1268488,-,5306
73,BUMA.1121.00099,1,2446046,2451358,-,5312
73,BUMA.1121.00098,1,2690045,2695384,+,5339
73,BUMA.1121.00111,1,146331,151622,+,5291
73,BUMA.1121.00109,1,1870848,1876160,-,5312
73,BUMA.1121.00097,1,4032597,4037909,-,5312
73,BUMA.1121.00094,1,20308,25661,+,5353
73,BUMA.1121.00095,1,1653191,1658512,-,5321
73,BUMA.1121.00005,1,3584121,3589423,-,5302
73,BUMA.1121.00101,1,2464515,2469816,-,5301
73,BUMA.1121.00065,1,20358,25722,+,5364
73,BUMA.1121.00100,1,1314867,1320179,-,5312
73,BUMA.1121.00105,1,1234285,1239596,-,5311
73,BUMA.1121.00029,1,943434,948755,-,5321
73,BUMA.1121.00066,1,20310,25678,+,5368
73,BUMA.1121.00031,1,1356258,1361558,+,5300
73,BUMA.1121.00108,1,974273,979638,+,5365
73,BUMA.1121.00023,1,2339810,2345239,+,5429
73,BUMA.1121.00035,1,1024295,1029689,+,5394
73,BUMA.1121.00041,1,1234899,1240300,+,5401
74,BUMA.1121.00057,1,1120777,1136236,+,15459
74,BUMA.1121.00058,1,507299,522744,-,15445
74,BUMA.1121.00045,1,44752,60197,-,15445
74,BUMA.1121.00051,1,26356,41817,+,15461
74,BUMA.1121.00068,1,2841056,2856494,+,15438
74,BUMA.1121.00061,1,26331,41798,+,15467
74,BUMA.1121.00060,1,2289943,2305388,-,15445
74,BUMA.1121.00064,1,26367,41809,+,15442
74,BUMA.1121.00016,1,2104503,2119947,+,15444
74,BUMA.1121.00003,1,2520171,2535616,+,15445
74,BUMA.1121.00055,1,3659202,3674666,+,15464
74,BUMA.1121.00011,1,1612588,1628046,-,15458
74,BUMA.1121.00037,1,2648685,2664130,+,15445
74,BUMA.1121.00009,1,1536627,1552083,-,15456
74,BUMA.1121.00069,1,26331,41800,+,15469
74,BUMA.1121.00088,1,875383,890844,+,15461
74,BUMA.1121.00092,1,26301,41736,+,15435
74,BUMA.1121.00074,1,48870,64321,-,15451
74,BUMA.1121.00070,1,26331,41804,+,15473
74,BUMA.1121.00093,1,492099,507535,-,15436
74,BUMA.1121.00063,1,26324,41793,+,15469
74,BUMA.1121.00033,1,2283120,2298567,+,15447
74,BUMA.1121.00018,1,508023,523468,+,15445
74,BUMA.1121.00080,1,26342,41804,+,15462
74,BUMA.1121.00027,1,2173398,2188855,+,15457
74,BUMA.1121.00053,1,3760620,3776049,+,15429
74,BUMA.1121.00059,1,3236924,3252374,+,15450
74,BUMA.1121.00043,1,4153766,4169212,+,15446
74,BUMA.1121.00056,1,3883660,3899125,-,15465
74,BUMA.1121.00112,1,3048504,3063852,-,15348
74,BUMA.1121.00091,1,495672,511109,-,15437
74,BUMA.1121.00047,1,2939013,2954476,-,15463
74,BUMA.1121.00067,1,379919,395370,-,15451
74,BUMA.1121.00110,1,791148,806612,-,15464
74,BUMA.1121.00073,1,26331,41804,+,15473
74,BUMA.1121.00072,1,26331,41799,+,15468
74,BUMA.1121.00077,1,2676781,2692244,+,15463
74,BUMA.1121.00082,1,26331,41804,+,15473
74,BUMA.1121.00062,1,550142,565594,-,15452
74,BUMA.1121.00007,1,45070,60530,-,15460
74,BUMA.1121.00025,1,2736419,2751865,-,15446
74,BUMA.1121.00021,1,623411,638861,+,15450
74,BUMA.1121.00103,1,323153,338631,-,15478
74,BUMA.1121.00096,1,3247578,3263039,-,15461
74,BUMA.1121.00079,1,26467,41928,+,15461
74,BUMA.1121.00039,1,97869,113323,+,15454
74,BUMA.1121.00083,1,1663024,1678498,-,15474
74,BUMA.1121.00084,1,249038,264492,+,15454
74,BUMA.1121.00049,1,1820995,1836457,-,15462
74,BUMA.1121.00089,1,26307,41771,+,15464
74,BUMA.1121.00014,1,2872842,2888286,-,15444
74,BUMA.1121.00090,1,2113337,2128776,+,15439
74,BUMA.1121.00071,1,26327,41796,+,15469
74,BUMA.1121.00078,1,2010639,2026091,-,15452
74,BUMA.1121.00102,1,1251386,1266828,-,15442
74,BUMA.1121.00075,1,3467484,3482957,+,15473
74,BUMA.1121.00012,1,2726463,2741892,+,15429
74,BUMA.1121.00076,1,1329244,1344718,-,15474
74,BUMA.1121.00106,1,3792541,3808010,+,15469
74,BUMA.1121.00001,1,51007,66457,-,15450
74,BUMA.1121.00107,1,3956772,3972126,+,15354
74,BUMA.1121.00104,1,1247056,1262530,-,15474
74,BUMA.1121.00099,1,2430043,2445394,-,15351
74,BUMA.1121.00098,1,2696037,2711466,+,15429
74,BUMA.1121.00111,1,152275,167739,+,15464
74,BUMA.1121.00109,1,1854734,1870196,-,15462
74,BUMA.1121.00097,1,4016482,4031945,-,15463
74,BUMA.1121.00094,1,26314,41778,+,15464
74,BUMA.1121.00095,1,1637087,1652539,-,15452
74,BUMA.1121.00005,1,3567809,3583469,-,15660
74,BUMA.1121.00101,1,2448520,2463863,-,15343
74,BUMA.1121.00065,1,26375,41837,+,15462
74,BUMA.1121.00100,1,1298752,1314215,-,15463
74,BUMA.1121.00105,1,1218154,1233633,-,15479
74,BUMA.1121.00029,1,927324,942782,-,15458
74,BUMA.1121.00066,1,26331,41797,+,15466
74,BUMA.1121.00031,1,1362229,1377674,+,15445
74,BUMA.1121.00108,1,980291,995725,+,15434
74,BUMA.1121.00023,1,2345892,2361341,+,15449
74,BUMA.1121.00035,1,1030342,1045791,+,15449
74,BUMA.1121.00041,1,1240953,1256397,+,15444
75,BUMA.1121.00057,1,1136238,1145062,+,8824
75,BUMA.1121.00058,1,498490,507298,-,8808
75,BUMA.1121.00045,1,35934,44751,-,8817
75,BUMA.1121.00051,1,41819,50643,+,8824
75,BUMA.1121.00068,1,2856496,2865320,+,8824
75,BUMA.1121.00061,1,41800,50624,+,8824
75,BUMA.1121.00060,1,2281125,2289942,-,8817
75,BUMA.1121.00064,1,41811,50635,+,8824
75,BUMA.1121.00016,1,2119949,2128772,+,8823
75,BUMA.1121.00003,1,2535618,2544435,+,8817
75,BUMA.1121.00055,1,3674668,3683492,+,8824
75,BUMA.1121.00011,1,1603763,1612587,-,8824
75,BUMA.1121.00037,1,2664132,2672956,+,8824
75,BUMA.1121.00009,1,1527809,1536626,-,8817
75,BUMA.1121.00069,1,41802,50626,+,8824
75,BUMA.1121.00088,1,890846,899671,+,8825
75,BUMA.1121.00092,1,41738,50562,+,8824
75,BUMA.1121.00074,1,40045,48869,-,8824
75,BUMA.1121.00070,1,41806,50630,+,8824
75,BUMA.1121.00093,1,483274,492098,-,8824
75,BUMA.1121.00063,1,41795,50619,+,8824
75,BUMA.1121.00033,1,2298569,2307392,+,8823
75,BUMA.1121.00018,1,523470,532294,+,8824
75,BUMA.1121.00080,1,41806,50630,+,8824
75,BUMA.1121.00027,1,2188857,2197681,+,8824
75,BUMA.1121.00053,1,3776051,3784875,+,8824
75,BUMA.1121.00059,1,3252376,3261200,+,8824
75,BUMA.1121.00043,1,4169214,4177999,+,8785
75,BUMA.1121.00056,1,3874835,3883659,-,8824
75,BUMA.1121.00112,1,3039679,3048503,-,8824
75,BUMA.1121.00091,1,486847,495671,-,8824
75,BUMA.1121.00047,1,2930188,2939012,-,8824
75,BUMA.1121.00067,1,371094,379918,-,8824
75,BUMA.1121.00110,1,782330,791147,-,8817
75,BUMA.1121.00073,1,41806,50630,+,8824
75,BUMA.1121.00072,1,41801,50625,+,8824
75,BUMA.1121.00077,1,2692246,2701063,+,8817
75,BUMA.1121.00082,1,41806,50630,+,8824
75,BUMA.1121.00062,1,541317,550141,-,8824
75,BUMA.1121.00007,1,36245,45069,-,8824
75,BUMA.1121.00025,1,2727594,2736418,-,8824
75,BUMA.1121.00021,1,638863,647688,+,8825
75,BUMA.1121.00103,1,314328,323152,-,8824
75,BUMA.1121.00096,1,3238760,3247577,-,8817
75,BUMA.1121.00079,1,41930,50754,+,8824
75,BUMA.1121.00039,1,113325,122142,+,8817
75,BUMA.1121.00083,1,1654199,1663023,-,8824
75,BUMA.1121.00084,1,264494,273318,+,8824
75,BUMA.1121.00049,1,1812169,1820994,-,8825
75,BUMA.1121.00089,1,41773,50597,+,8824
75,BUMA.1121.00014,1,2864017,2872841,-,8824
75,BUMA.1121.00090,1,2128778,2137602,+,8824
75,BUMA.1121.00071,1,41798,50622,+,8824
75,BUMA.1121.00078,1,2001815,2010638,-,8823
75,BUMA.1121.00102,1,1242561,1251385,-,8824
75,BUMA.1121.00075,1,3482959,3491783,+,8824
75,BUMA.1121.00012,1,2741894,2750718,+,8824
75,BUMA.1121.00076,1,1320419,1329243,-,8824
75,BUMA.1121.00106,1,3808012,3816836,+,8824
75,BUMA.1121.00001,1,42182,51006,-,8824
75,BUMA.1121.00107,1,3972128,3980945,+,8817
75,BUMA.1121.00104,1,1238231,1247055,-,8824
75,BUMA.1121.00099,1,2421218,2430042,-,8824
75,BUMA.1121.00098,1,2711468,2720292,+,8824
75,BUMA.1121.00111,1,167741,176565,+,8824
75,BUMA.1121.00109,1,1845916,1854733,-,8817
75,BUMA.1121.00097,1,4007694,4016481,-,8787
75,BUMA.1121.00094,1,41780,50604,+,8824
75,BUMA.1121.00095,1,1626684,1635488,-,8804
75,BUMA.1121.00005,1,3558984,3567808,-,8824
75,BUMA.1121.00101,1,2439695,2448519,-,8824
75,BUMA.1121.00065,1,41839,50663,+,8824
75,BUMA.1121.00100,1,1289927,1298751,-,8824
75,BUMA.1121.00105,1,1207751,1216555,-,8804
75,BUMA.1121.00029,1,918499,927323,-,8824
75,BUMA.1121.00066,1,41799,50621,+,8822
75,BUMA.1121.00031,1,1377676,1386500,+,8824
75,BUMA.1121.00108,1,995727,1004551,+,8824
75,BUMA.1121.00023,1,2361343,2370167,+,8824
75,BUMA.1121.00035,1,1045793,1054617,+,8824
75,BUMA.1121.00041,1,1256399,1265223,+,8824
76,BUMA.1121.00057,1,1145063,1175014,+,29951
76,BUMA.1121.00058,1,468534,498488,-,29954
76,BUMA.1121.00045,1,5997,35932,-,29935
76,BUMA.1121.00051,1,50644,80676,+,30032
76,BUMA.1121.00068,1,2865321,2895265,+,29944
76,BUMA.1121.00061,1,50625,80570,+,29945
76,BUMA.1121.00060,1,2251188,2281123,-,29935
76,BUMA.1121.00064,1,50636,80605,+,29969
76,BUMA.1121.00016,1,2128773,2158725,+,29952
76,BUMA.1121.00003,1,2544436,2574422,+,29986
76,BUMA.1121.00055,1,3683493,3713413,+,29920
76,BUMA.1121.00011,1,1573787,1603761,-,29974
76,BUMA.1121.00037,1,2672957,2702950,+,29993
76,BUMA.1121.00009,1,1497857,1527807,-,29950
76,BUMA.1121.00069,1,50627,80572,+,29945
76,BUMA.1121.00088,1,899672,929618,+,29946
76,BUMA.1121.00092,1,50563,80476,+,29913
76,BUMA.1121.00074,1,10078,40043,-,29965
76,BUMA.1121.00070,1,50631,80576,+,29945
76,BUMA.1121.00093,1,453360,483272,-,29912
76,BUMA.1121.00063,1,50620,80565,+,29945
76,BUMA.1121.00033,1,2307393,2337357,+,29964
76,BUMA.1121.00018,1,532295,562253,+,29958
76,BUMA.1121.00080,1,50631,80585,+,29954
76,BUMA.1121.00027,1,2197682,2227614,+,29932
76,BUMA.1121.00053,1,3784876,3814849,+,29973
76,BUMA.1121.00059,1,3261201,3291163,+,29962
76,BUMA.1121.00043,1,25,30002,+,29977
76,BUMA.1121.00056,1,3844832,3874833,-,30001
76,BUMA.1121.00112,1,3009693,3039677,-,29984
76,BUMA.1121.00091,1,456854,486845,-,29991
76,BUMA.1121.00047,1,2900212,2930186,-,29974
76,BUMA.1121.00067,1,341149,371092,-,29943
76,BUMA.1121.00110,1,752389,782328,-,29939
76,BUMA.1121.00073,1,50631,80576,+,29945
76,BUMA.1121.00072,1,50626,80569,+,29943
76,BUMA.1121.00077,1,2701064,2731004,+,29940
76,BUMA.1121.00082,1,50631,80576,+,29945
76,BUMA.1121.00062,1,511359,541315,-,29956
76,BUMA.1121.00007,1,6334,36243,-,29909
76,BUMA.1121.00025,1,2697627,2727592,-,29965
76,BUMA.1121.00021,1,647689,677607,+,29918
76,BUMA.1121.00103,1,284361,314326,-,29965
76,BUMA.1121.00096,1,3208729,3238758,-,30029
76,BUMA.1121.00079,1,50755,80773,+,30018
76,BUMA.1121.00039,1,122143,152076,+,29933
76,BUMA.1121.00083,1,1624253,1654197,-,29944
76,BUMA.1121.00084,1,273319,303293,+,29974
76,BUMA.1121.00049,1,1782254,1812167,-,29913
76,BUMA.1121.00089,1,50598,80600,+,30002
76,BUMA.1121.00014,1,2834084,2864015,-,29931
76,BUMA.1121.00090,1,2137603,2167554,+,29951
76,BUMA.1121.00071,1,50623,80533,+,29910
76,BUMA.1121.00078,1,1971936,2001813,-,29877
76,BUMA.1121.00102,1,1212557,1242559,-,30002
76,BUMA.1121.00075,1,3491784,3521749,+,29965
76,BUMA.1121.00012,1,2750719,2780676,+,29957
76,BUMA.1121.00076,1,1290460,1320417,-,29957
76,BUMA.1121.00106,1,3816837,3846791,+,29954
76,BUMA.1121.00001,1,12273,42180,-,29907
76,BUMA.1121.00107,1,3980946,4010797,+,29851
76,BUMA.1121.00104,1,1208289,1238229,-,29940
76,BUMA.1121.00099,1,2391273,2421216,-,29943
76,BUMA.1121.00098,1,2720293,2750213,+,29920
76,BUMA.1121.00111,1,176566,206531,+,29965
76,BUMA.1121.00109,1,1815973,1845914,-,29941
76,BUMA.1121.00097,1,3977739,4007692,-,29953
76,BUMA.1121.00094,1,50605,80617,+,30012
76,BUMA.1121.00095,1,1596826,1626682,-,29856
76,BUMA.1121.00005,1,3529078,3558982,-,29904
76,BUMA.1121.00101,1,2409730,2439693,-,29963
76,BUMA.1121.00065,1,50664,80621,+,29957
76,BUMA.1121.00100,1,1260034,1289925,-,29891
76,BUMA.1121.00105,1,1177788,1207749,-,29961
76,BUMA.1121.00029,1,888590,918497,-,29907
76,BUMA.1121.00066,1,50622,80535,+,29913
76,BUMA.1121.00031,1,1386501,1416425,+,29924
76,BUMA.1121.00108,1,1004552,1034462,+,29910
76,BUMA.1121.00023,1,2370168,2400085,+,29917
76,BUMA.1121.00035,1,1054618,1084526,+,29908
76,BUMA.1121.00041,1,1265224,1295176,+,29952
77,BUMA.1121.00057,1,1175856,1180976,+,5120
77,BUMA.1121.00058,1,462572,467691,-,5119
77,BUMA.1121.00045,1,31,5151,-,5120
77,BUMA.1121.00051,1,81521,86640,+,5119
77,BUMA.1121.00068,1,2917035,2922155,+,5120
77,BUMA.1121.00061,1,81415,86535,+,5120
77,BUMA.1121.00060,1,2245222,2250342,-,5120
77,BUMA.1121.00064,1,84021,89140,+,5119
77,BUMA.1121.00016,1,2159565,2164685,+,5120
77,BUMA.1121.00003,1,2575270,2580390,+,5120
77,BUMA.1121.00055,1,3714257,3719377,+,5120
77,BUMA.1121.00011,1,1563183,1568303,-,5120
77,BUMA.1121.00037,1,2703790,2708910,+,5120
77,BUMA.1121.00009,1,1487254,1492373,-,5119
77,BUMA.1121.00069,1,81417,86537,+,5120
77,BUMA.1121.00088,1,933034,938153,+,5119
77,BUMA.1121.00092,1,81316,86436,+,5120
77,BUMA.1121.00074,1,331,5450,-,5119
77,BUMA.1121.00070,1,81421,86541,+,5120
77,BUMA.1121.00093,1,447400,452520,-,5120
77,BUMA.1121.00063,1,81409,86529,+,5120
77,BUMA.1121.00033,1,2338197,2343316,+,5119
77,BUMA.1121.00018,1,563093,568213,+,5120
77,BUMA.1121.00080,1,84001,89120,+,5119
77,BUMA.1121.00027,1,2228456,2233576,+,5120
77,BUMA.1121.00053,1,3815691,3820810,+,5119
77,BUMA.1121.00059,1,3292007,3297126,+,5119
77,BUMA.1121.00043,1,54142,59262,+,5120
77,BUMA.1121.00056,1,3823048,3828168,-,5120
77,BUMA.1121.00112,1,3003724,3008844,-,5120
77,BUMA.1121.00091,1,450890,456010,-,5120
77,BUMA.1121.00047,1,2894248,2899367,-,5119
77,BUMA.1121.00067,1,332614,337733,-,5119
77,BUMA.1121.00110,1,746425,751545,-,5120
77,BUMA.1121.00073,1,81421,86541,+,5120
77,BUMA.1121.00072,1,81414,86534,+,5120
77,BUMA.1121.00077,1,2731848,2736968,+,5120
77,BUMA.1121.00082,1,81421,86541,+,5120
77,BUMA.1121.00062,1,502824,507944,-,5120
77,BUMA.1121.00007,1,367,5487,-,5120
77,BUMA.1121.00025,1,2691667,2696787,-,5120
77,BUMA.1121.00021,1,678447,683567,+,5120
77,BUMA.1121.00103,1,278399,283519,-,5120
77,BUMA.1121.00096,1,3188497,3193617,-,5120
77,BUMA.1121.00079,1,81618,86737,+,5119
77,BUMA.1121.00039,1,152916,158036,+,5120
77,BUMA.1121.00083,1,1618288,1623408,-,5120
77,BUMA.1121.00084,1,306709,311828,+,5119
77,BUMA.1121.00049,1,1773719,1778838,-,5119
77,BUMA.1121.00089,1,97264,102384,+,5120
77,BUMA.1121.00014,1,2828124,2833244,-,5120
77,BUMA.1121.00090,1,2168394,2173514,+,5120
77,BUMA.1121.00071,1,81378,86498,+,5120
77,BUMA.1121.00078,1,1964373,1969493,-,5120
77,BUMA.1121.00102,1,1206595,1211715,-,5120
77,BUMA.1121.00075,1,3522591,3527711,+,5120
77,BUMA.1121.00012,1,2781516,2786636,+,5120
77,BUMA.1121.00076,1,1284498,1289618,-,5120
77,BUMA.1121.00106,1,3847635,3852754,+,5119
77,BUMA.1121.00001,1,31,5151,-,5120
77,BUMA.1121.00107,1,4011640,4016758,+,5118
77,BUMA.1121.00104,1,1199755,1204874,-,5119
77,BUMA.1121.00099,1,2372286,2377405,-,5119
77,BUMA.1121.00098,1,2764083,2769203,+,5120
77,BUMA.1121.00111,1,207371,212491,+,5120
77,BUMA.1121.00109,1,1807437,1812557,-,5120
77,BUMA.1121.00097,1,3960504,3965624,-,5120
77,BUMA.1121.00094,1,81462,86581,+,5119
77,BUMA.1121.00095,1,1586014,1591131,-,5117
77,BUMA.1121.00005,1,3523114,3528234,-,5120
77,BUMA.1121.00101,1,2391256,2396375,-,5119
77,BUMA.1121.00065,1,81465,86585,+,5120
77,BUMA.1121.00100,1,1252468,1257588,-,5120
77,BUMA.1121.00105,1,1136696,1141814,-,5118
77,BUMA.1121.00029,1,873108,878228,-,5120
77,BUMA.1121.00066,1,81304,86424,+,5120
77,BUMA.1121.00031,1,1417265,1422385,+,5120
77,BUMA.1121.00108,1,1051966,1057086,+,5120
77,BUMA.1121.00023,1,2400925,2406045,+,5120
77,BUMA.1121.00035,1,1095307,1100427,+,5120
77,BUMA.1121.00041,1,1297381,1302501,+,5120
78,BUMA.1121.00057,1,1181307,1184630,+,3323
78,BUMA.1121.00058,1,458918,462241,-,3323
78,BUMA.1121.00045,1,4015931,4019255,-,3324
78,BUMA.1121.00051,1,86971,90298,+,3327
78,BUMA.1121.00068,1,2922486,2925812,+,3326
78,BUMA.1121.00061,1,86866,90190,+,3324
78,BUMA.1121.00060,1,2241567,2244891,-,3324
78,BUMA.1121.00064,1,89471,92795,+,3324
78,BUMA.1121.00016,1,2165016,2168340,+,3324
78,BUMA.1121.00003,1,2580721,2584045,+,3324
78,BUMA.1121.00055,1,3719708,3723031,+,3323
78,BUMA.1121.00011,1,1559528,1562852,-,3324
78,BUMA.1121.00037,1,2709241,2712563,+,3322
78,BUMA.1121.00009,1,1483599,1486923,-,3324
78,BUMA.1121.00069,1,86868,90191,+,3323
78,BUMA.1121.00088,1,938484,941807,+,3323
78,BUMA.1121.00092,1,86767,90090,+,3323
78,BUMA.1121.00074,1,3797142,3800466,-,3324
78,BUMA.1121.00070,1,86872,90196,+,3324
78,BUMA.1121.00093,1,443746,447069,-,3323
78,BUMA.1121.00063,1,86860,90184,+,3324
78,BUMA.1121.00033,1,2343647,2346970,+,3323
78,BUMA.1121.00018,1,568544,571868,+,3324
78,BUMA.1121.00080,1,89451,92775,+,3324
78,BUMA.1121.00027,1,2233907,2237231,+,3324
78,BUMA.1121.00053,1,3821147,3824472,+,3325
78,BUMA.1121.00059,1,3297457,3300780,+,3323
78,BUMA.1121.00043,1,59593,62917,+,3324
78,BUMA.1121.00056,1,3819393,3822717,-,3324
78,BUMA.1121.00112,1,3000067,3003393,-,3326
78,BUMA.1121.00091,1,447235,450559,-,3324
78,BUMA.1121.00047,1,2890590,2893917,-,3327
78,BUMA.1121.00067,1,328959,332283,-,3324
78,BUMA.1121.00110,1,742770,746094,-,3324
78,BUMA.1121.00073,1,86872,90196,+,3324
78,BUMA.1121.00072,1,86865,90189,+,3324
78,BUMA.1121.00077,1,2737299,2740623,+,3324
78,BUMA.1121.00082,1,86872,90196,+,3324
78,BUMA.1121.00062,1,499169,502493,-,3324
78,BUMA.1121.00007,1,4050971,4054259,-,3288
78,BUMA.1121.00025,1,2688012,2691336,-,3324
78,BUMA.1121.00021,1,683898,687206,+,3308
78,BUMA.1121.00103,1,274746,278068,-,3322
78,BUMA.1121.00096,1,3184842,3188166,-,3324
78,BUMA.1121.00079,1,87068,90394,+,3326
78,BUMA.1121.00039,1,158367,161691,+,3324
78,BUMA.1121.00083,1,1614633,1617957,-,3324
78,BUMA.1121.00084,1,312159,315482,+,3323
78,BUMA.1121.00049,1,1770064,1773388,-,3324
78,BUMA.1121.00089,1,102715,106039,+,3324
78,BUMA.1121.00014,1,2824471,2827793,-,3322
78,BUMA.1121.00090,1,2173845,2177169,+,3324
78,BUMA.1121.00071,1,86829,90153,+,3324
78,BUMA.1121.00078,1,1960719,1964042,-,3323
78,BUMA.1121.00102,1,1202940,1206264,-,3324
78,BUMA.1121.00075,1,3528042,3531365,+,3323
78,BUMA.1121.00012,1,2786967,2790291,+,3324
78,BUMA.1121.00076,1,1280844,1284167,-,3323
78,BUMA.1121.00106,1,3853085,3856408,+,3323
78,BUMA.1121.00001,1,4087350,4090674,-,3324
78,BUMA.1121.00107,1,4017089,4020415,+,3326
78,BUMA.1121.00104,1,1196101,1199424,-,3323
78,BUMA.1121.00099,1,2368631,2371955,-,3324
78,BUMA.1121.00098,1,2769534,2772846,+,3312
78,BUMA.1121.00111,1,212822,216146,+,3324
78,BUMA.1121.00109,1,1803782,1807106,-,3324
78,BUMA.1121.00097,1,3956849,3960173,-,3324
78,BUMA.1121.00094,1,86912,90238,+,3326
78,BUMA.1121.00095,1,1582358,1585683,-,3325
78,BUMA.1121.00005,1,3519460,3522784,-,3324
78,BUMA.1121.00101,1,2387600,2390925,-,3325
78,BUMA.1121.00065,1,86916,90240,+,3324
78,BUMA.1121.00100,1,1248825,1252137,-,3312
78,BUMA.1121.00105,1,1133042,1136365,-,3323
78,BUMA.1121.00029,1,869453,872777,-,3324
78,BUMA.1121.00066,1,86755,90079,+,3324
78,BUMA.1121.00031,1,1422716,1426038,+,3322
78,BUMA.1121.00108,1,1057417,1060741,+,3324
78,BUMA.1121.00023,1,2406376,2409698,+,3322
78,BUMA.1121.00035,1,1100758,1104082,+,3324
78,BUMA.1121.00041,1,1302832,1306156,+,3324
79,BUMA.1121.00057,1,1199382,1216530,+,17148
79,BUMA.1121.00058,1,438460,455590,-,17130
79,BUMA.1121.00045,1,3980904,3998053,-,17149
79,BUMA.1121.00051,1,105050,122239,+,17189
79,BUMA.1121.00068,1,2929140,2946231,+,17091
79,BUMA.1121.00061,1,104942,122023,+,17081
79,BUMA.1121.00060,1,2206540,2223689,-,17149
79,BUMA.1121.00064,1,110290,127421,+,17131
79,BUMA.1121.00016,1,2187991,2205168,+,17177
79,BUMA.1121.00003,1,2601523,2618589,+,17066
79,BUMA.1121.00055,1,3740507,3757618,+,17111
79,BUMA.1121.00011,1,1525269,1542411,-,17142
79,BUMA.1121.00037,1,2727595,2744791,+,17196
79,BUMA.1121.00009,1,1463182,1480270,-,17088
79,BUMA.1121.00069,1,94810,111907,+,17097
79,BUMA.1121.00088,1,956559,973603,+,17044
79,BUMA.1121.00092,1,93419,110484,+,17065
79,BUMA.1121.00074,1,3762490,3779647,-,17157
79,BUMA.1121.00070,1,104948,122017,+,17069
79,BUMA.1121.00093,1,423351,440417,-,17066
79,BUMA.1121.00063,1,104936,122003,+,17067
79,BUMA.1121.00033,1,2350298,2367468,+,17170
79,BUMA.1121.00018,1,590435,607547,+,17112
79,BUMA.1121.00080,1,107527,124725,+,17198
79,BUMA.1121.00027,1,2251981,2269135,+,17154
79,BUMA.1121.00053,1,3844357,3861464,+,17107
79,BUMA.1121.00059,1,3324217,3341339,+,17122
79,BUMA.1121.00043,1,80653,97819,+,17166
79,BUMA.1121.00056,1,3787500,3804597,-,17097
79,BUMA.1121.00112,1,2965481,2982555,-,17074
79,BUMA.1121.00091,1,426733,443907,-,17174
79,BUMA.1121.00047,1,2858656,2875838,-,17182
79,BUMA.1121.00067,1,294286,311464,-,17178
79,BUMA.1121.00110,1,704015,721117,-,17102
79,BUMA.1121.00073,1,104948,122013,+,17065
79,BUMA.1121.00072,1,98703,115829,+,17126
79,BUMA.1121.00077,1,2762276,2779380,+,17104
79,BUMA.1121.00082,1,104948,122058,+,17110
79,BUMA.1121.00062,1,469517,486619,-,17102
79,BUMA.1121.00007,1,4017460,4034567,-,17107
79,BUMA.1121.00025,1,2652331,2669445,-,17114
79,BUMA.1121.00021,1,707190,724357,+,17167
79,BUMA.1121.00103,1,248095,265184,-,17089
79,BUMA.1121.00096,1,3149819,3166924,-,17105
79,BUMA.1121.00079,1,105146,122327,+,17181
79,BUMA.1121.00039,1,184322,201362,+,17040
79,BUMA.1121.00083,1,1582770,1599881,-,17111
79,BUMA.1121.00084,1,330234,347353,+,17119
79,BUMA.1121.00049,1,1735472,1752569,-,17097
79,BUMA.1121.00089,1,120836,137932,+,17096
79,BUMA.1121.00014,1,2791672,2808817,-,17145
79,BUMA.1121.00090,1,2193101,2210256,+,17155
79,BUMA.1121.00071,1,94880,111973,+,17093
79,BUMA.1121.00078,1,1940366,1957435,-,17069
79,BUMA.1121.00102,1,1168385,1185461,-,17076
79,BUMA.1121.00075,1,3548136,3565229,+,17093
79,BUMA.1121.00012,1,2810332,2827425,+,17093
79,BUMA.1121.00076,1,1246971,1264072,-,17101
79,BUMA.1121.00106,1,3871205,3888310,+,17105
79,BUMA.1121.00001,1,4053302,4070451,-,17149
79,BUMA.1121.00107,1,4033753,4050828,+,17075
79,BUMA.1121.00104,1,1160315,1177394,-,17079
79,BUMA.1121.00099,1,2334447,2351586,-,17139
79,BUMA.1121.00098,1,2788600,2805750,+,17150
79,BUMA.1121.00111,1,219474,236650,+,17176
79,BUMA.1121.00109,1,1765268,1782364,-,17096
79,BUMA.1121.00097,1,3936447,3953521,-,17074
79,BUMA.1121.00094,1,104990,122138,+,17148
79,BUMA.1121.00095,1,1561961,1579030,-,17069
79,BUMA.1121.00005,1,3484517,3501659,-,17142
79,BUMA.1121.00101,1,2367170,2384272,-,17102
79,BUMA.1121.00065,1,93568,110734,+,17166
79,BUMA.1121.00100,1,1226816,1243882,-,17066
79,BUMA.1121.00105,1,1104565,1121723,-,17158
79,BUMA.1121.00029,1,835397,852554,-,17157
79,BUMA.1121.00066,1,102110,119205,+,17095
79,BUMA.1121.00031,1,1441692,1458797,+,17105
79,BUMA.1121.00108,1,1074879,1091996,+,17117
79,BUMA.1121.00023,1,2426247,2443384,+,17137
79,BUMA.1121.00035,1,1120506,1137641,+,17135
79,BUMA.1121.00041,1,1324180,1341316,+,17136
80,BUMA.1121.00057,1,1223491,1227659,+,4168
80,BUMA.1121.00058,1,428936,433105,-,4169
80,BUMA.1121.00045,1,3971230,3975399,-,4169
80,BUMA.1121.00051,1,126537,130705,+,4168
80,BUMA.1121.00068,1,2956072,2960241,+,4169
80,BUMA.1121.00061,1,127114,131282,+,4168
80,BUMA.1121.00060,1,2196866,2201035,-,4169
80,BUMA.1121.00064,1,132777,136945,+,4168
80,BUMA.1121.00016,1,2229250,2233418,+,4168
80,BUMA.1121.00003,1,2628908,2633075,+,4167
80,BUMA.1121.00055,1,3762974,3767142,+,4168
80,BUMA.1121.00011,1,1497282,1501449,-,4167
80,BUMA.1121.00037,1,2765196,2769364,+,4168
80,BUMA.1121.00009,1,1445986,1450153,-,4167
80,BUMA.1121.00069,1,116995,121163,+,4168
80,BUMA.1121.00088,1,980309,984477,+,4168
80,BUMA.1121.00092,1,115589,119757,+,4168
80,BUMA.1121.00074,1,3752966,3757135,-,4169
80,BUMA.1121.00070,1,127106,131274,+,4168
80,BUMA.1121.00093,1,414078,418247,-,4169
80,BUMA.1121.00063,1,127091,131259,+,4168
80,BUMA.1121.00033,1,2380964,2385132,+,4168
80,BUMA.1121.00018,1,630689,634857,+,4168
80,BUMA.1121.00080,1,170957,175125,+,4168
80,BUMA.1121.00027,1,2287717,2291883,+,4166
80,BUMA.1121.00053,1,3866563,3870733,+,4170
80,BUMA.1121.00059,1,3346429,3350597,+,4168
80,BUMA.1121.00043,1,117105,121273,+,4168
80,BUMA.1121.00056,1,3779034,3783203,-,4169
80,BUMA.1121.00112,1,2954094,2958265,-,4171
80,BUMA.1121.00091,1,417466,421635,-,4169
80,BUMA.1121.00047,1,2850190,2854359,-,4169
80,BUMA.1121.00067,1,284762,288931,-,4169
80,BUMA.1121.00110,1,690814,694983,-,4169
80,BUMA.1121.00073,1,127104,131272,+,4168
80,BUMA.1121.00072,1,120902,125070,+,4168
80,BUMA.1121.00077,1,2788412,2792580,+,4168
80,BUMA.1121.00082,1,127409,131577,+,4168
80,BUMA.1121.00062,1,452676,456845,-,4169
80,BUMA.1121.00007,1,3992929,3997101,-,4172
80,BUMA.1121.00025,1,2625021,2629189,-,4168
80,BUMA.1121.00021,1,764122,768288,+,4166
80,BUMA.1121.00103,1,238845,243014,-,4169
80,BUMA.1121.00096,1,3140574,3144743,-,4169
80,BUMA.1121.00079,1,126625,130793,+,4168
80,BUMA.1121.00039,1,221850,226017,+,4167
80,BUMA.1121.00083,1,1573251,1577420,-,4169
80,BUMA.1121.00084,1,354042,358210,+,4168
80,BUMA.1121.00049,1,1724348,1728517,-,4169
80,BUMA.1121.00089,1,142230,146398,+,4168
80,BUMA.1121.00014,1,2765621,2769790,-,4169
80,BUMA.1121.00090,1,2229390,2233558,+,4168
80,BUMA.1121.00071,1,117066,121234,+,4168
80,BUMA.1121.00078,1,1880066,1884234,-,4168
80,BUMA.1121.00102,1,1159116,1163287,-,4171
80,BUMA.1121.00075,1,3571918,3576087,+,4169
80,BUMA.1121.00012,1,2849295,2853462,+,4167
80,BUMA.1121.00076,1,1236112,1240282,-,4170
80,BUMA.1121.00106,1,3893654,3897822,+,4168
80,BUMA.1121.00001,1,4035543,4039712,-,4169
80,BUMA.1121.00107,1,4056349,4060518,+,4169
80,BUMA.1121.00104,1,1149190,1153359,-,4169
80,BUMA.1121.00099,1,2326062,2330232,-,4170
80,BUMA.1121.00098,1,2811592,2815760,+,4168
80,BUMA.1121.00111,1,263347,267514,+,4167
80,BUMA.1121.00109,1,1756016,1760185,-,4169
80,BUMA.1121.00097,1,3912004,3916173,-,4169
80,BUMA.1121.00094,1,126436,130604,+,4168
80,BUMA.1121.00095,1,1548047,1552218,-,4171
80,BUMA.1121.00005,1,3443961,3448128,-,4167
80,BUMA.1121.00101,1,2357917,2362086,-,4169
80,BUMA.1121.00065,1,120640,124808,+,4168
80,BUMA.1121.00100,1,1217568,1221737,-,4169
80,BUMA.1121.00105,1,1087723,1091892,-,4169
80,BUMA.1121.00029,1,823364,827533,-,4169
80,BUMA.1121.00066,1,124297,128465,+,4168
80,BUMA.1121.00031,1,1468634,1472802,+,4168
80,BUMA.1121.00108,1,1111029,1115194,+,4165
80,BUMA.1121.00023,1,2458357,2462524,+,4167
80,BUMA.1121.00035,1,1145505,1149673,+,4168
80,BUMA.1121.00041,1,1354479,1358647,+,4168
81,BUMA.1121.00057,1,1227806,1241517,+,13711
81,BUMA.1121.00058,1,415088,428789,-,13701
81,BUMA.1121.00045,1,3957273,3971083,-,13810
81,BUMA.1121.00051,1,130852,144665,+,13813
81,BUMA.1121.00068,1,2960388,2974158,+,13770
81,BUMA.1121.00061,1,131429,145128,+,13699
81,BUMA.1121.00060,1,2182909,2196719,-,13810
81,BUMA.1121.00064,1,137092,150767,+,13675
81,BUMA.1121.00016,1,2233565,2247295,+,13730
81,BUMA.1121.00003,1,2633222,2646874,+,13652
81,BUMA.1121.00055,1,3767289,3781026,+,13737
81,BUMA.1121.00011,1,1483451,1497135,-,13684
81,BUMA.1121.00037,1,2769511,2783233,+,13722
81,BUMA.1121.00009,1,1432163,1445839,-,13676
81,BUMA.1121.00069,1,121310,135009,+,13699
81,BUMA.1121.00088,1,984624,998328,+,13704
81,BUMA.1121.00092,1,119904,133572,+,13668
81,BUMA.1121.00074,1,3739088,3752819,-,13731
81,BUMA.1121.00070,1,131421,145120,+,13699
81,BUMA.1121.00093,1,400264,413931,-,13667
81,BUMA.1121.00063,1,131406,145105,+,13699
81,BUMA.1121.00033,1,2385279,2398978,+,13699
81,BUMA.1121.00018,1,635004,648694,+,13690
81,BUMA.1121.00080,1,175272,189124,+,13852
81,BUMA.1121.00027,1,2292030,2305760,+,13730
81,BUMA.1121.00053,1,3870880,3884658,+,13778
81,BUMA.1121.00059,1,3350744,3364450,+,13706
81,BUMA.1121.00043,1,121420,135120,+,13700
81,BUMA.1121.00056,1,3765082,3778887,-,13805
81,BUMA.1121.00112,1,2940215,2953947,-,13732
81,BUMA.1121.00091,1,403557,417319,-,13762
81,BUMA.1121.00047,1,2836249,2850043,-,13794
81,BUMA.1121.00067,1,270869,284615,-,13746
81,BUMA.1121.00110,1,676928,690667,-,13739
81,BUMA.1121.00073,1,131419,145118,+,13699
81,BUMA.1121.00072,1,125217,138916,+,13699
81,BUMA.1121.00077,1,2792727,2806485,+,13758
81,BUMA.1121.00082,1,131724,145423,+,13699
81,BUMA.1121.00062,1,438831,452529,-,13698
81,BUMA.1121.00007,1,3979019,3992782,-,13763
81,BUMA.1121.00025,1,2611176,2624874,-,13698
81,BUMA.1121.00021,1,768434,782101,+,13667
81,BUMA.1121.00103,1,224936,238698,-,13762
81,BUMA.1121.00096,1,3126690,3140429,-,13739
81,BUMA.1121.00079,1,130940,144800,+,13860
81,BUMA.1121.00039,1,227747,241538,+,13791
81,BUMA.1121.00083,1,1559406,1573104,-,13698
81,BUMA.1121.00084,1,358357,372053,+,13696
81,BUMA.1121.00049,1,1710481,1724201,-,13720
81,BUMA.1121.00089,1,146545,160350,+,13805
81,BUMA.1121.00014,1,2751767,2765474,-,13707
81,BUMA.1121.00090,1,2233705,2247387,+,13682
81,BUMA.1121.00071,1,121381,135080,+,13699
81,BUMA.1121.00078,1,1864656,1878339,-,13683
81,BUMA.1121.00102,1,1145263,1158969,-,13706
81,BUMA.1121.00075,1,3576234,3589953,+,13719
81,BUMA.1121.00012,1,2853609,2867315,+,13706
81,BUMA.1121.00076,1,1222237,1235965,-,13728
81,BUMA.1121.00106,1,3897969,3911651,+,13682
81,BUMA.1121.00001,1,4021675,4035396,-,13721
81,BUMA.1121.00107,1,4060665,4074329,+,13664
81,BUMA.1121.00104,1,1135315,1149043,-,13728
81,BUMA.1121.00099,1,2312080,2325915,-,13835
81,BUMA.1121.00098,1,2815907,2829687,+,13780
81,BUMA.1121.00111,1,267661,281407,+,13746
81,BUMA.1121.00109,1,1742169,1755869,-,13700
81,BUMA.1121.00097,1,3898251,3911857,-,13606
81,BUMA.1121.00094,1,130751,144554,+,13803
81,BUMA.1121.00095,1,1534191,1547900,-,13709
81,BUMA.1121.00005,1,3430186,3443814,-,13628
81,BUMA.1121.00101,1,2344062,2357770,-,13708
81,BUMA.1121.00065,1,124955,138693,+,13738
81,BUMA.1121.00100,1,1203702,1217421,-,13719
81,BUMA.1121.00105,1,1073896,1087576,-,13680
81,BUMA.1121.00029,1,809544,823217,-,13673
81,BUMA.1121.00066,1,128612,142311,+,13699
81,BUMA.1121.00031,1,1472949,1486632,+,13683
81,BUMA.1121.00108,1,1115341,1129041,+,13700
81,BUMA.1121.00023,1,2462671,2476396,+,13725
81,BUMA.1121.00035,1,1149820,1163470,+,13650
81,BUMA.1121.00041,1,1358794,1372556,+,13762
82,BUMA.1121.00057,1,1241519,1245896,+,4377
82,BUMA.1121.00058,1,410707,415087,-,4380
82,BUMA.1121.00045,1,3952891,3957272,-,4381
82,BUMA.1121.00051,1,144667,149050,+,4383
82,BUMA.1121.00068,1,3011494,3015872,+,4378
82,BUMA.1121.00061,1,175281,179657,+,4376
82,BUMA.1121.00060,1,2178527,2182908,-,4381
82,BUMA.1121.00064,1,188391,192770,+,4379
82,BUMA.1121.00016,1,2247297,2251675,+,4378
82,BUMA.1121.00003,1,2646876,2651256,+,4380
82,BUMA.1121.00055,1,3818832,3823209,+,4377
82,BUMA.1121.00011,1,1479068,1483450,-,4382
82,BUMA.1121.00037,1,2783235,2787615,+,4380
82,BUMA.1121.00009,1,1427782,1432162,-,4380
82,BUMA.1121.00069,1,136564,140940,+,4376
82,BUMA.1121.00088,1,1035952,1040330,+,4378
82,BUMA.1121.00092,1,3716017,3720399,-,4382
82,BUMA.1121.00074,1,3734707,3739087,-,4380
82,BUMA.1121.00070,1,146913,151290,+,4377
82,BUMA.1121.00093,1,906038,910420,+,4382
82,BUMA.1121.00063,1,172306,176682,+,4376
82,BUMA.1121.00033,1,2398980,2403359,+,4379
82,BUMA.1121.00018,1,648696,653075,+,4379
82,BUMA.1121.00080,1,189126,193509,+,4383
82,BUMA.1121.00027,1,2342029,2346404,+,4375
82,BUMA.1121.00053,1,3922434,3926812,+,4378
82,BUMA.1121.00059,1,3364452,3368831,+,4379
82,BUMA.1121.00043,1,135122,139502,+,4380
82,BUMA.1121.00056,1,3760698,3765081,-,4383
82,BUMA.1121.00112,1,2935831,2940214,-,4383
82,BUMA.1121.00091,1,399173,403556,-,4383
82,BUMA.1121.00047,1,2831865,2836248,-,4383
82,BUMA.1121.00067,1,229725,234104,-,4379
82,BUMA.1121.00110,1,672548,676927,-,4379
82,BUMA.1121.00073,1,173236,177612,+,4376
82,BUMA.1121.00072,1,147227,151604,+,4377
82,BUMA.1121.00077,1,2806487,2810865,+,4378
82,BUMA.1121.00082,1,181696,186072,+,4376
82,BUMA.1121.00062,1,434450,438830,-,4380
82,BUMA.1121.00007,1,3974639,3979018,-,4379
82,BUMA.1121.00025,1,2606796,2611175,-,4379
82,BUMA.1121.00021,1,782103,786482,+,4379
82,BUMA.1121.00103,1,220553,224935,-,4382
82,BUMA.1121.00096,1,3122312,3126689,-,4377
82,BUMA.1121.00079,1,182532,186914,+,4382
82,BUMA.1121.00039,1,241540,245919,+,4379
82,BUMA.1121.00083,1,1518757,1523133,-,4376
82,BUMA.1121.00084,1,372055,376434,+,4379
82,BUMA.1121.00049,1,1706101,1710480,-,4379
82,BUMA.1121.00089,1,160352,164735,+,4383
82,BUMA.1121.00014,1,2747387,2751766,-,4379
82,BUMA.1121.00090,1,2247389,2251768,+,4379
82,BUMA.1121.00071,1,163457,167833,+,4376
82,BUMA.1121.00078,1,1860275,1864655,-,4380
82,BUMA.1121.00102,1,1140882,1145262,-,4380
82,BUMA.1121.00075,1,3589955,3594333,+,4378
82,BUMA.1121.00012,1,2904005,2908383,+,4378
82,BUMA.1121.00076,1,1217856,1222236,-,4380
82,BUMA.1121.00106,1,3911653,3916033,+,4380
82,BUMA.1121.00001,1,3979147,3983525,-,4378
82,BUMA.1121.00107,1,4074331,4078709,+,4378
82,BUMA.1121.00104,1,1130934,1135314,-,4380
82,BUMA.1121.00099,1,2267901,2272283,-,4382
82,BUMA.1121.00098,1,2866016,2870392,+,4376
82,BUMA.1121.00111,1,281409,285788,+,4379
82,BUMA.1121.00109,1,1737789,1742168,-,4379
82,BUMA.1121.00097,1,3893872,3898250,-,4378
82,BUMA.1121.00094,1,144556,148938,+,4382
82,BUMA.1121.00095,1,1529812,1534190,-,4378
82,BUMA.1121.00005,1,3425807,3430185,-,4378
82,BUMA.1121.00101,1,2339670,2344061,-,4391
82,BUMA.1121.00065,1,176317,180696,+,4379
82,BUMA.1121.00100,1,1199323,1203701,-,4378
82,BUMA.1121.00105,1,1069515,1073895,-,4380
82,BUMA.1121.00029,1,764524,768902,-,4378
82,BUMA.1121.00066,1,144042,148418,+,4376
82,BUMA.1121.00031,1,1486634,1491013,+,4379
82,BUMA.1121.00108,1,1129043,1133421,+,4378
82,BUMA.1121.00023,1,2476398,2480777,+,4379
82,BUMA.1121.00035,1,1201624,1206002,+,4378
82,BUMA.1121.00041,1,1409690,1414066,+,4376
83,BUMA.1121.00057,1,1246082,1258251,+,12169
83,BUMA.1121.00058,1,398282,410422,-,12140
83,BUMA.1121.00045,1,3940535,3952691,-,12156
83,BUMA.1121.00051,1,149263,161409,+,12146
83,BUMA.1121.00068,1,3016120,3028309,+,12189
83,BUMA.1121.00061,1,179866,192067,+,12201
83,BUMA.1121.00060,1,2166185,2178341,-,12156
83,BUMA.1121.00064,1,192998,205139,+,12141
83,BUMA.1121.00016,1,2251960,2264115,+,12155
83,BUMA.1121.00003,1,2651462,2663590,+,12128
83,BUMA.1121.00055,1,3823606,3835761,+,12155
83,BUMA.1121.00011,1,1466722,1478886,-,12164
83,BUMA.1121.00037,1,2788529,2800674,+,12145
83,BUMA.1121.00009,1,1415398,1427540,-,12142
83,BUMA.1121.00069,1,141153,153355,+,12202
83,BUMA.1121.00088,1,1040606,1052751,+,12145
83,BUMA.1121.00092,1,3703637,3715782,-,12145
83,BUMA.1121.00074,1,3722331,3734471,-,12140
83,BUMA.1121.00070,1,151503,163705,+,12202
83,BUMA.1121.00093,1,910655,922800,+,12145
83,BUMA.1121.00063,1,176902,189103,+,12201
83,BUMA.1121.00033,1,2403791,2415944,+,12153
83,BUMA.1121.00018,1,653654,665730,+,12076
83,BUMA.1121.00080,1,193777,205941,+,12164
83,BUMA.1121.00027,1,2346541,2358700,+,12159
83,BUMA.1121.00053,1,3928626,3940770,+,12144
83,BUMA.1121.00059,1,3369375,3381515,+,12140
83,BUMA.1121.00043,1,139913,152073,+,12160
83,BUMA.1121.00056,1,3748293,3760457,-,12164
83,BUMA.1121.00112,1,2923525,2935666,-,12141
83,BUMA.1121.00091,1,386835,398981,-,12146
83,BUMA.1121.00047,1,2819372,2831519,-,12147
83,BUMA.1121.00067,1,217377,229517,-,12140
83,BUMA.1121.00110,1,660317,672453,-,12136
83,BUMA.1121.00073,1,177833,190035,+,12202
83,BUMA.1121.00072,1,151821,164004,+,12183
83,BUMA.1121.00077,1,2810960,2823096,+,12136
83,BUMA.1121.00082,1,186293,198498,+,12205
83,BUMA.1121.00062,1,422004,434144,-,12140
83,BUMA.1121.00007,1,3962277,3974418,-,12141
83,BUMA.1121.00025,1,2594099,2606175,-,12076
83,BUMA.1121.00021,1,786719,798864,+,12145
83,BUMA.1121.00103,1,208260,220395,-,12135
83,BUMA.1121.00096,1,3110024,3122173,-,12149
83,BUMA.1121.00079,1,187175,199329,+,12154
83,BUMA.1121.00039,1,246419,258569,+,12150
83,BUMA.1121.00083,1,1506338,1518543,-,12205
83,BUMA.1121.00084,1,376601,388741,+,12140
83,BUMA.1121.00049,1,1693740,1705881,-,12141
83,BUMA.1121.00089,1,165004,177168,+,12164
83,BUMA.1121.00014,1,2734243,2746393,-,12150
83,BUMA.1121.00090,1,2252116,2264256,+,12140
83,BUMA.1121.00071,1,168046,180229,+,12183
83,BUMA.1121.00078,1,1847895,1860024,-,12129
83,BUMA.1121.00102,1,1128496,1140641,-,12145
83,BUMA.1121.00075,1,3594631,3606777,+,12146
83,BUMA.1121.00012,1,2908918,2921047,+,12129
83,BUMA.1121.00076,1,1205397,1217544,-,12147
83,BUMA.1121.00106,1,3916465,3928591,+,12126
83,BUMA.1121.00001,1,3966325,3978470,-,12145
83,BUMA.1121.00107,1,4078874,4091025,+,12151
83,BUMA.1121.00104,1,1118572,1130713,-,12141
83,BUMA.1121.00099,1,2255527,2267687,-,12160
83,BUMA.1121.00098,1,2870585,2882741,+,12156
83,BUMA.1121.00111,1,286612,298762,+,12150
83,BUMA.1121.00109,1,1725392,1737534,-,12142
83,BUMA.1121.00097,1,3881557,3893693,-,12136
83,BUMA.1121.00094,1,149206,161370,+,12164
83,BUMA.1121.00095,1,1517501,1529647,-,12146
83,BUMA.1121.00005,1,3413426,3425564,-,12138
83,BUMA.1121.00101,1,2327377,2339513,-,12136
83,BUMA.1121.00065,1,180882,193023,+,12141
83,BUMA.1121.00100,1,1186877,1199018,-,12141
83,BUMA.1121.00105,1,1056929,1069064,-,12135
83,BUMA.1121.00029,1,751940,764085,-,12145
83,BUMA.1121.00066,1,148625,160809,+,12184
83,BUMA.1121.00031,1,1491759,1503904,+,12145
83,BUMA.1121.00108,1,1133585,1145707,+,12122
83,BUMA.1121.00023,1,2481538,2493688,+,12150
83,BUMA.1121.00035,1,1206715,1218860,+,12145
83,BUMA.1121.00041,1,1414275,1426453,+,12178
84,BUMA.1121.00057,1,1258394,1270640,+,12246
84,BUMA.1121.00058,1,385819,398062,-,12243
84,BUMA.1121.00045,1,3928133,3940364,-,12231
84,BUMA.1121.00051,1,161587,173835,+,12248
84,BUMA.1121.00068,1,3028585,3040840,+,12255
84,BUMA.1121.00061,1,192210,204444,+,12234
84,BUMA.1121.00060,1,2153776,2166007,-,12231
84,BUMA.1121.00064,1,205324,217564,+,12240
84,BUMA.1121.00016,1,2264341,2276584,+,12243
84,BUMA.1121.00003,1,2665426,2677674,+,12248
84,BUMA.1121.00055,1,3835966,3848226,+,12260
84,BUMA.1121.00011,1,1454239,1466495,-,12256
84,BUMA.1121.00037,1,2802530,2814774,+,12244
84,BUMA.1121.00009,1,1402962,1415199,-,12237
84,BUMA.1121.00069,1,153498,165735,+,12237
84,BUMA.1121.00088,1,1052999,1065239,+,12240
84,BUMA.1121.00092,1,3691097,3703375,-,12278
84,BUMA.1121.00074,1,3709828,3722069,-,12241
84,BUMA.1121.00070,1,163848,176082,+,12234
84,BUMA.1121.00093,1,923062,935339,+,12277
84,BUMA.1121.00063,1,189246,201481,+,12235
84,BUMA.1121.00033,1,2416219,2428473,+,12254
84,BUMA.1121.00018,1,665935,678184,+,12249
84,BUMA.1121.00080,1,206098,218338,+,12240
84,BUMA.1121.00027,1,2358871,2371122,+,12251
84,BUMA.1121.00053,1,3942509,3954758,+,12249
84,BUMA.1121.00059,1,3381735,3393975,+,12240
84,BUMA.1121.00043,1,152243,164486,+,12243
84,BUMA.1121.00056,1,3735880,3748129,-,12249
84,BUMA.1121.00112,1,2911050,2923298,-,12248
84,BUMA.1121.00091,1,374389,386629,-,12240
84,BUMA.1121.00047,1,2806966,2819215,-,12249
84,BUMA.1121.00067,1,204930,217171,-,12241
84,BUMA.1121.00110,1,647899,660133,-,12234
84,BUMA.1121.00073,1,190178,202413,+,12235
84,BUMA.1121.00072,1,164147,176384,+,12237
84,BUMA.1121.00077,1,2823287,2835520,+,12233
84,BUMA.1121.00082,1,198641,210878,+,12237
84,BUMA.1121.00062,1,409457,421721,-,12264
84,BUMA.1121.00007,1,3949849,3962078,-,12229
84,BUMA.1121.00025,1,2581643,2593893,-,12250
84,BUMA.1121.00021,1,799112,811361,+,12249
84,BUMA.1121.00103,1,194237,206487,-,12250
84,BUMA.1121.00096,1,3097601,3109867,-,12266
84,BUMA.1121.00079,1,199507,211763,+,12256
84,BUMA.1121.00039,1,258781,271030,+,12249
84,BUMA.1121.00083,1,1493957,1506195,-,12238
84,BUMA.1121.00084,1,388919,401157,+,12238
84,BUMA.1121.00049,1,1681129,1693366,-,12237
84,BUMA.1121.00089,1,177332,189580,+,12248
84,BUMA.1121.00014,1,2721752,2734002,-,12250
84,BUMA.1121.00090,1,2266084,2278333,+,12249
84,BUMA.1121.00071,1,180372,192609,+,12237
84,BUMA.1121.00078,1,1833903,1846151,-,12248
84,BUMA.1121.00102,1,1114502,1126751,-,12249
84,BUMA.1121.00075,1,3606962,3619209,+,12247
84,BUMA.1121.00012,1,2922821,2935071,+,12250
84,BUMA.1121.00076,1,1192957,1205205,-,12248
84,BUMA.1121.00106,1,3928832,3941078,+,12246
84,BUMA.1121.00001,1,3953849,3966099,-,12250
84,BUMA.1121.00107,1,4091308,4103549,+,12241
84,BUMA.1121.00104,1,1106044,1118282,-,12238
84,BUMA.1121.00099,1,2243069,2255293,-,12224
84,BUMA.1121.00098,1,2882947,2895194,+,12247
84,BUMA.1121.00111,1,298967,311216,+,12249
84,BUMA.1121.00109,1,1712937,1725207,-,12270
84,BUMA.1121.00097,1,3869134,3881365,-,12231
84,BUMA.1121.00094,1,161506,173754,+,12248
84,BUMA.1121.00095,1,1505044,1517286,-,12242
84,BUMA.1121.00005,1,3401004,3413255,-,12251
84,BUMA.1121.00101,1,2313340,2325582,-,12242
84,BUMA.1121.00065,1,193215,205466,+,12251
84,BUMA.1121.00100,1,1174458,1186706,-,12248
84,BUMA.1121.00105,1,1042856,1055086,-,12230
84,BUMA.1121.00029,1,739464,751714,-,12250
84,BUMA.1121.00066,1,160952,173189,+,12237
84,BUMA.1121.00031,1,1504130,1516379,+,12249
84,BUMA.1121.00108,1,1145877,1158100,+,12223
84,BUMA.1121.00023,1,2493865,2506115,+,12250
84,BUMA.1121.00035,1,1219072,1231321,+,12249
84,BUMA.1121.00041,1,1426659,1438897,+,12238
85,BUMA.1121.00057,1,1270642,1277545,+,6903
85,BUMA.1121.00058,1,377485,384361,-,6876
85,BUMA.1121.00045,1,3921244,3928132,-,6888
85,BUMA.1121.00051,1,173837,180772,+,6935
85,BUMA.1121.00068,1,3040842,3047752,+,6910
85,BUMA.1121.00061,1,204446,211356,+,6910
85,BUMA.1121.00060,1,2146887,2153775,-,6888
85,BUMA.1121.00064,1,217566,224466,+,6900
85,BUMA.1121.00016,1,2278186,2285094,+,6908
85,BUMA.1121.00003,1,2677676,2684571,+,6895
85,BUMA.1121.00055,1,3849682,3856576,+,6894
85,BUMA.1121.00011,1,1447350,1454238,-,6888
85,BUMA.1121.00037,1,2816376,2823322,+,6946
85,BUMA.1121.00009,1,1396039,1402961,-,6922
85,BUMA.1121.00069,1,165737,172647,+,6910
85,BUMA.1121.00088,1,1065241,1072135,+,6894
85,BUMA.1121.00092,1,3684173,3691096,-,6923
85,BUMA.1121.00074,1,3702926,3709827,-,6901
85,BUMA.1121.00070,1,176084,182994,+,6910
85,BUMA.1121.00093,1,935341,942264,+,6923
85,BUMA.1121.00063,1,201483,208364,+,6881
85,BUMA.1121.00033,1,2430075,2437002,+,6927
85,BUMA.1121.00018,1,678186,685103,+,6917
85,BUMA.1121.00080,1,218340,225241,+,6901
85,BUMA.1121.00027,1,2371124,2378044,+,6920
85,BUMA.1121.00053,1,3954760,3961673,+,6913
85,BUMA.1121.00059,1,3393977,3400878,+,6901
85,BUMA.1121.00043,1,166088,173038,+,6950
85,BUMA.1121.00056,1,3728944,3735879,-,6935
85,BUMA.1121.00112,1,2904139,2911049,-,6910
85,BUMA.1121.00091,1,367450,374388,-,6938
85,BUMA.1121.00047,1,2800030,2806965,-,6935
85,BUMA.1121.00067,1,198028,204929,-,6901
85,BUMA.1121.00110,1,640988,647898,-,6910
85,BUMA.1121.00073,1,202415,209325,+,6910
85,BUMA.1121.00072,1,176386,183296,+,6910
85,BUMA.1121.00077,1,2835522,2842431,+,6909
85,BUMA.1121.00082,1,210880,217790,+,6910
85,BUMA.1121.00062,1,401085,407995,-,6910
85,BUMA.1121.00007,1,3942927,3949848,-,6921
85,BUMA.1121.00025,1,2574725,2581642,-,6917
85,BUMA.1121.00021,1,811363,818302,+,6939
85,BUMA.1121.00103,1,187317,194236,-,6919
85,BUMA.1121.00096,1,3089220,3096143,-,6923
85,BUMA.1121.00079,1,213221,220151,+,6930
85,BUMA.1121.00039,1,271032,277960,+,6928
85,BUMA.1121.00083,1,1487046,1493956,-,6910
85,BUMA.1121.00084,1,401159,408069,+,6910
85,BUMA.1121.00049,1,1674227,1681128,-,6901
85,BUMA.1121.00089,1,189582,196517,+,6935
85,BUMA.1121.00014,1,2714821,2721751,-,6930
85,BUMA.1121.00090,1,2278335,2285263,+,6928
85,BUMA.1121.00071,1,192611,199521,+,6910
85,BUMA.1121.00078,1,1826959,1833902,-,6943
85,BUMA.1121.00102,1,1107577,1114501,-,6924
85,BUMA.1121.00075,1,3619211,3626129,+,6918
85,BUMA.1121.00012,1,2935073,2942014,+,6941
85,BUMA.1121.00076,1,1186037,1192956,-,6919
85,BUMA.1121.00106,1,3941080,3947983,+,6903
85,BUMA.1121.00001,1,3946931,3953848,-,6917
85,BUMA.1121.00107,1,4103551,4110442,+,6891
85,BUMA.1121.00104,1,1099141,1106043,-,6902
85,BUMA.1121.00099,1,2236151,2243068,-,6917
85,BUMA.1121.00098,1,2895196,2902101,+,6905
85,BUMA.1121.00111,1,311218,318157,+,6939
85,BUMA.1121.00109,1,1704576,1711481,-,6905
85,BUMA.1121.00097,1,3862245,3869133,-,6888
85,BUMA.1121.00094,1,173756,180691,+,6935
85,BUMA.1121.00095,1,1498131,1505043,-,6912
85,BUMA.1121.00005,1,3394111,3401003,-,6892
85,BUMA.1121.00101,1,2306458,2313339,-,6881
85,BUMA.1121.00065,1,205468,212392,+,6924
85,BUMA.1121.00100,1,1166079,1173000,-,6921
85,BUMA.1121.00105,1,1035938,1042855,-,6917
85,BUMA.1121.00029,1,732535,739463,-,6928
85,BUMA.1121.00066,1,173191,180101,+,6910
85,BUMA.1121.00031,1,1516381,1523302,+,6921
85,BUMA.1121.00108,1,1158102,1165003,+,6901
85,BUMA.1121.00023,1,2506117,2513045,+,6928
85,BUMA.1121.00035,1,1231323,1238251,+,6928
85,BUMA.1121.00041,1,1438899,1445816,+,6917
86,BUMA.1121.00057,1,1277546,1281455,+,3909
86,BUMA.1121.00058,1,373575,377483,-,3908
86,BUMA.1121.00045,1,3917335,3921242,-,3907
86,BUMA.1121.00051,1,180773,184682,+,3909
86,BUMA.1121.00068,1,3047753,3051660,+,3907
86,BUMA.1121.00061,1,211357,215264,+,3907
86,BUMA.1121.00060,1,2142978,2146885,-,3907
86,BUMA.1121.00064,1,224468,228376,+,3908
86,BUMA.1121.00016,1,2285095,2289003,+,3908
86,BUMA.1121.00003,1,2684572,2688479,+,3907
86,BUMA.1121.00055,1,3856577,3860485,+,3908
86,BUMA.1121.00011,1,1443441,1447348,-,3907
86,BUMA.1121.00037,1,2823323,2827231,+,3908
86,BUMA.1121.00009,1,1392131,1396037,-,3906
86,BUMA.1121.00069,1,172648,176555,+,3907
86,BUMA.1121.00088,1,1072137,1076045,+,3908
86,BUMA.1121.00092,1,3680263,3684171,-,3908
86,BUMA.1121.00074,1,3699016,3702924,-,3908
86,BUMA.1121.00070,1,182995,186902,+,3907
86,BUMA.1121.00093,1,942265,946174,+,3909
86,BUMA.1121.00063,1,208365,212272,+,3907
86,BUMA.1121.00033,1,2437003,2440911,+,3908
86,BUMA.1121.00018,1,685104,689012,+,3908
86,BUMA.1121.00080,1,225243,229151,+,3908
86,BUMA.1121.00027,1,2378045,2381952,+,3907
86,BUMA.1121.00053,1,3961674,3965568,+,3894
86,BUMA.1121.00059,1,3400880,3404788,+,3908
86,BUMA.1121.00043,1,173039,176946,+,3907
86,BUMA.1121.00056,1,3725034,3728942,-,3908
86,BUMA.1121.00112,1,2900231,2904137,-,3906
86,BUMA.1121.00091,1,363542,367448,-,3906
86,BUMA.1121.00047,1,2796121,2800028,-,3907
86,BUMA.1121.00067,1,194118,198026,-,3908
86,BUMA.1121.00110,1,637081,640986,-,3905
86,BUMA.1121.00073,1,209326,213233,+,3907
86,BUMA.1121.00072,1,183297,187204,+,3907
86,BUMA.1121.00077,1,2842432,2846338,+,3906
86,BUMA.1121.00082,1,217791,221698,+,3907
86,BUMA.1121.00062,1,397175,401083,-,3908
86,BUMA.1121.00007,1,3939019,3942925,-,3906
86,BUMA.1121.00025,1,2570816,2574723,-,3907
86,BUMA.1121.00021,1,818303,822211,+,3908
86,BUMA.1121.00103,1,183420,187315,-,3895
86,BUMA.1121.00096,1,3085311,3089218,-,3907
86,BUMA.1121.00079,1,220152,224061,+,3909
86,BUMA.1121.00039,1,277961,281869,+,3908
86,BUMA.1121.00083,1,1483138,1487044,-,3906
86,BUMA.1121.00084,1,408070,411977,+,3907
86,BUMA.1121.00049,1,1670317,1674225,-,3908
86,BUMA.1121.00089,1,196518,200427,+,3909
86,BUMA.1121.00014,1,2710913,2714819,-,3906
86,BUMA.1121.00090,1,2285264,2289172,+,3908
86,BUMA.1121.00071,1,199522,203429,+,3907
86,BUMA.1121.00078,1,1823051,1826957,-,3906
86,BUMA.1121.00102,1,1103681,1107575,-,3894
86,BUMA.1121.00075,1,3626130,3630037,+,3907
86,BUMA.1121.00012,1,2942015,2945923,+,3908
86,BUMA.1121.00076,1,1182129,1186035,-,3906
86,BUMA.1121.00106,1,3947984,3951892,+,3908
86,BUMA.1121.00001,1,3943022,3946929,-,3907
86,BUMA.1121.00107,1,4,3916,+,3912
86,BUMA.1121.00104,1,1095233,1099139,-,3906
86,BUMA.1121.00099,1,2232243,2236149,-,3906
86,BUMA.1121.00098,1,2902102,2906009,+,3907
86,BUMA.1121.00111,1,318158,322066,+,3908
86,BUMA.1121.00109,1,1700668,1704574,-,3906
86,BUMA.1121.00097,1,3858337,3862243,-,3906
86,BUMA.1121.00094,1,180692,184599,+,3907
86,BUMA.1121.00095,1,1494221,1498129,-,3908
86,BUMA.1121.00005,1,3390203,3394109,-,3906
86,BUMA.1121.00101,1,2302549,2306456,-,3907
86,BUMA.1121.00065,1,212393,216300,+,3907
86,BUMA.1121.00100,1,1162170,1166077,-,3907
86,BUMA.1121.00105,1,1032028,1035936,-,3908
86,BUMA.1121.00029,1,728626,732533,-,3907
86,BUMA.1121.00066,1,180102,184009,+,3907
86,BUMA.1121.00031,1,1523303,1527210,+,3907
86,BUMA.1121.00108,1,1165004,1168912,+,3908
86,BUMA.1121.00023,1,2513046,2516953,+,3907
86,BUMA.1121.00035,1,1238252,1242160,+,3908
86,BUMA.1121.00041,1,1445817,1449724,+,3907
87,BUMA.1121.00057,1,1281508,1292008,+,10500
87,BUMA.1121.00058,1,363125,373522,-,10397
87,BUMA.1121.00045,1,3906782,3917282,-,10500
87,BUMA.1121.00051,1,184735,195218,+,10483
87,BUMA.1121.00068,1,3051713,3062230,+,10517
87,BUMA.1121.00061,1,215317,225809,+,10492
87,BUMA.1121.00060,1,2132425,2142925,-,10500
87,BUMA.1121.00064,1,228429,238842,+,10413
87,BUMA.1121.00016,1,2289056,2299538,+,10482
87,BUMA.1121.00003,1,2688532,2699035,+,10503
87,BUMA.1121.00055,1,3860538,3870920,+,10382
87,BUMA.1121.00011,1,1432893,1443366,-,10473
87,BUMA.1121.00037,1,2827284,2837785,+,10501
87,BUMA.1121.00009,1,1381591,1392078,-,10487
87,BUMA.1121.00069,1,176608,187110,+,10502
87,BUMA.1121.00088,1,1076098,1086511,+,10413
87,BUMA.1121.00092,1,3669688,3680210,-,10522
87,BUMA.1121.00074,1,3688549,3698963,-,10414
87,BUMA.1121.00070,1,186955,197449,+,10494
87,BUMA.1121.00093,1,946227,956748,+,10521
87,BUMA.1121.00063,1,212325,222827,+,10502
87,BUMA.1121.00033,1,2440964,2451464,+,10500
87,BUMA.1121.00018,1,689065,699564,+,10499
87,BUMA.1121.00080,1,229204,239617,+,10413
87,BUMA.1121.00027,1,2382005,2392507,+,10502
87,BUMA.1121.00053,1,3967241,3977630,+,10389
87,BUMA.1121.00059,1,3404841,3415248,+,10407
87,BUMA.1121.00043,1,176999,187468,+,10469
87,BUMA.1121.00056,1,3714497,3724981,-,10484
87,BUMA.1121.00112,1,2889664,2900178,-,10514
87,BUMA.1121.00091,1,352940,363489,-,10549
87,BUMA.1121.00047,1,2785586,2796068,-,10482
87,BUMA.1121.00067,1,183651,194065,-,10414
87,BUMA.1121.00110,1,626544,637028,-,10484
87,BUMA.1121.00073,1,213286,223788,+,10502
87,BUMA.1121.00072,1,187257,197751,+,10494
87,BUMA.1121.00077,1,2846391,2856874,+,10483
87,BUMA.1121.00082,1,221751,232253,+,10502
87,BUMA.1121.00062,1,386646,397122,-,10476
87,BUMA.1121.00007,1,3928475,3938966,-,10491
87,BUMA.1121.00025,1,2560263,2570763,-,10500
87,BUMA.1121.00021,1,822264,832754,+,10490
87,BUMA.1121.00103,1,171243,181759,-,10516
87,BUMA.1121.00096,1,3074753,3085258,-,10505
87,BUMA.1121.00079,1,224114,234597,+,10483
87,BUMA.1121.00039,1,281922,292410,+,10488
87,BUMA.1121.00083,1,1472582,1483085,-,10503
87,BUMA.1121.00084,1,412030,422425,+,10395
87,BUMA.1121.00049,1,1659850,1670264,-,10414
87,BUMA.1121.00089,1,200480,210963,+,10483
87,BUMA.1121.00014,1,2700369,2710860,-,10491
87,BUMA.1121.00090,1,2289225,2299715,+,10490
87,BUMA.1121.00071,1,203482,213976,+,10494
87,BUMA.1121.00078,1,1812488,1822998,-,10510
87,BUMA.1121.00102,1,1091592,1101971,-,10379
87,BUMA.1121.00075,1,3630090,3640474,+,10384
87,BUMA.1121.00012,1,2945976,2956447,+,10471
87,BUMA.1121.00076,1,1171691,1182076,-,10385
87,BUMA.1121.00106,1,3951945,3962349,+,10404
87,BUMA.1121.00001,1,3932478,3942969,-,10491
87,BUMA.1121.00107,1,3969,14459,+,10490
87,BUMA.1121.00104,1,1084748,1095180,-,10432
87,BUMA.1121.00099,1,2221693,2232190,-,10497
87,BUMA.1121.00098,1,2906062,2916570,+,10508
87,BUMA.1121.00111,1,322119,332601,+,10482
87,BUMA.1121.00109,1,1690132,1700615,-,10483
87,BUMA.1121.00097,1,3847785,3858284,-,10499
87,BUMA.1121.00094,1,184652,195135,+,10483
87,BUMA.1121.00095,1,1483666,1494168,-,10502
87,BUMA.1121.00005,1,3379631,3390150,-,10519
87,BUMA.1121.00101,1,2292058,2302496,-,10438
87,BUMA.1121.00065,1,216353,226872,+,10519
87,BUMA.1121.00100,1,1151633,1162117,-,10484
87,BUMA.1121.00105,1,1021579,1031975,-,10396
87,BUMA.1121.00029,1,718082,728573,-,10491
87,BUMA.1121.00066,1,184062,194557,+,10495
87,BUMA.1121.00031,1,1527263,1537753,+,10490
87,BUMA.1121.00108,1,1168965,1179386,+,10421
87,BUMA.1121.00023,1,2517006,2527507,+,10501
87,BUMA.1121.00035,1,1242213,1252703,+,10490
87,BUMA.1121.00041,1,1449777,1460169,+,10392
88,BUMA.1121.00057,1,1293178,1313659,+,20481
88,BUMA.1121.00058,1,341479,361955,-,20476
88,BUMA.1121.00045,1,3885150,3905612,-,20462
88,BUMA.1121.00051,1,196388,216843,+,20455
88,BUMA.1121.00068,1,3063400,3083904,+,20504
88,BUMA.1121.00061,1,226979,247477,+,20498
88,BUMA.1121.00060,1,2110793,2131255,-,20462
88,BUMA.1121.00064,1,240012,260489,+,20477
88,BUMA.1121.00016,1,2300708,2321200,+,20492
88,BUMA.1121.00003,1,2700205,2720524,+,20319
88,BUMA.1121.00055,1,3872090,3892566,+,20476
88,BUMA.1121.00011,1,1411288,1431723,-,20435
88,BUMA.1121.00037,1,2838955,2859404,+,20449
88,BUMA.1121.00009,1,1359939,1380421,-,20482
88,BUMA.1121.00069,1,188280,208779,+,20499
88,BUMA.1121.00088,1,1087681,1108166,+,20485
88,BUMA.1121.00092,1,3648053,3668518,-,20465
88,BUMA.1121.00074,1,3666918,3687379,-,20461
88,BUMA.1121.00070,1,198619,219117,+,20498
88,BUMA.1121.00093,1,957918,978384,+,20466
88,BUMA.1121.00063,1,223997,244494,+,20497
88,BUMA.1121.00033,1,2452634,2473121,+,20487
88,BUMA.1121.00018,1,700734,721219,+,20485
88,BUMA.1121.00080,1,240787,261258,+,20471
88,BUMA.1121.00027,1,2393677,2414152,+,20475
88,BUMA.1121.00053,1,3978800,3999277,+,20477
88,BUMA.1121.00059,1,3416418,3436876,+,20458
88,BUMA.1121.00043,1,188638,209145,+,20507
88,BUMA.1121.00056,1,3692832,3713327,-,20495
88,BUMA.1121.00112,1,2868009,2888494,-,20485
88,BUMA.1121.00091,1,331301,351770,-,20469
88,BUMA.1121.00047,1,2763962,2784416,-,20454
88,BUMA.1121.00067,1,162020,182481,-,20461
88,BUMA.1121.00110,1,604896,625374,-,20478
88,BUMA.1121.00073,1,224958,245455,+,20497
88,BUMA.1121.00072,1,198921,219418,+,20497
88,BUMA.1121.00077,1,2858044,2878522,+,20478
88,BUMA.1121.00082,1,233423,253922,+,20499
88,BUMA.1121.00062,1,364957,385476,-,20519
88,BUMA.1121.00007,1,3906841,3927305,-,20464
88,BUMA.1121.00025,1,2538609,2559093,-,20484
88,BUMA.1121.00021,1,833924,854415,+,20491
88,BUMA.1121.00103,1,149612,170073,-,20461
88,BUMA.1121.00096,1,3053105,3073583,-,20478
88,BUMA.1121.00079,1,235767,256211,+,20444
88,BUMA.1121.00039,1,293580,314094,+,20514
88,BUMA.1121.00083,1,1450914,1471412,-,20498
88,BUMA.1121.00084,1,423595,444072,+,20477
88,BUMA.1121.00049,1,1638185,1658680,-,20495
88,BUMA.1121.00089,1,212133,232577,+,20444
88,BUMA.1121.00014,1,2678726,2699199,-,20473
88,BUMA.1121.00090,1,2300885,2321373,+,20488
88,BUMA.1121.00071,1,215146,235645,+,20499
88,BUMA.1121.00078,1,1790852,1811318,-,20466
88,BUMA.1121.00102,1,1069916,1090422,-,20506
88,BUMA.1121.00075,1,3641644,3662140,+,20496
88,BUMA.1121.00012,1,2957617,2978118,+,20501
88,BUMA.1121.00076,1,1150026,1170521,-,20495
88,BUMA.1121.00106,1,3963519,3983995,+,20476
88,BUMA.1121.00001,1,3910830,3931308,-,20478
88,BUMA.1121.00107,1,15629,36098,+,20469
88,BUMA.1121.00104,1,1063094,1083578,-,20484
88,BUMA.1121.00099,1,2200082,2220523,-,20441
88,BUMA.1121.00098,1,2917740,2938272,+,20532
88,BUMA.1121.00111,1,333771,354260,+,20489
88,BUMA.1121.00109,1,1668508,1688962,-,20454
88,BUMA.1121.00097,1,3826140,3846615,-,20475
88,BUMA.1121.00094,1,196305,216743,+,20438
88,BUMA.1121.00095,1,1462015,1482496,-,20481
88,BUMA.1121.00005,1,3357997,3378461,-,20464
88,BUMA.1121.00101,1,2270405,2290888,-,20483
88,BUMA.1121.00065,1,228042,248527,+,20485
88,BUMA.1121.00100,1,1130046,1150463,-,20417
88,BUMA.1121.00105,1,1000021,1020409,-,20388
88,BUMA.1121.00029,1,696435,716912,-,20477
88,BUMA.1121.00066,1,195727,216224,+,20497
88,BUMA.1121.00031,1,1538923,1559395,+,20472
88,BUMA.1121.00108,1,1180556,1201011,+,20455
88,BUMA.1121.00023,1,2528677,2549168,+,20491
88,BUMA.1121.00035,1,1253873,1274352,+,20479
88,BUMA.1121.00041,1,1461339,1481824,+,20485
89,BUMA.1121.00057,1,1313677,1317461,+,3784
89,BUMA.1121.00058,1,337676,341461,-,3785
89,BUMA.1121.00045,1,3881392,3885132,-,3740
89,BUMA.1121.00051,1,216861,220645,+,3784
89,BUMA.1121.00068,1,3083922,3087706,+,3784
89,BUMA.1121.00061,1,247495,251279,+,3784
89,BUMA.1121.00060,1,2107035,2110775,-,3740
89,BUMA.1121.00064,1,260507,264291,+,3784
89,BUMA.1121.00016,1,2321218,2325002,+,3784
89,BUMA.1121.00003,1,2720542,2724326,+,3784
89,BUMA.1121.00055,1,3892584,3896378,+,3794
89,BUMA.1121.00011,1,1407485,1411270,-,3785
89,BUMA.1121.00037,1,2859422,2863206,+,3784
89,BUMA.1121.00009,1,1356136,1359921,-,3785
89,BUMA.1121.00069,1,208797,212581,+,3784
89,BUMA.1121.00088,1,1108184,1111968,+,3784
89,BUMA.1121.00092,1,3644250,3648035,-,3785
89,BUMA.1121.00074,1,3663115,3666900,-,3785
89,BUMA.1121.00070,1,219135,222919,+,3784
89,BUMA.1121.00093,1,978402,982186,+,3784
89,BUMA.1121.00063,1,244512,248296,+,3784
89,BUMA.1121.00033,1,2473139,2476922,+,3783
89,BUMA.1121.00018,1,721237,725021,+,3784
89,BUMA.1121.00080,1,261276,265060,+,3784
89,BUMA.1121.00027,1,2414170,2417953,+,3783
89,BUMA.1121.00053,1,3999295,4003079,+,3784
89,BUMA.1121.00059,1,3436894,3440678,+,3784
89,BUMA.1121.00043,1,209163,212947,+,3784
89,BUMA.1121.00056,1,3689029,3692814,-,3785
89,BUMA.1121.00112,1,2864206,2867991,-,3785
89,BUMA.1121.00091,1,327488,331283,-,3795
89,BUMA.1121.00047,1,2760159,2763944,-,3785
89,BUMA.1121.00067,1,158217,162002,-,3785
89,BUMA.1121.00110,1,601093,604878,-,3785
89,BUMA.1121.00073,1,245473,249257,+,3784
89,BUMA.1121.00072,1,219436,223220,+,3784
89,BUMA.1121.00077,1,2878540,2882322,+,3782
89,BUMA.1121.00082,1,253940,257724,+,3784
89,BUMA.1121.00062,1,361154,364939,-,3785
89,BUMA.1121.00007,1,3903038,3906823,-,3785
89,BUMA.1121.00025,1,2534806,2538591,-,3785
89,BUMA.1121.00021,1,854433,858217,+,3784
89,BUMA.1121.00103,1,145809,149594,-,3785
89,BUMA.1121.00096,1,3049302,3053087,-,3785
89,BUMA.1121.00079,1,256229,260013,+,3784
89,BUMA.1121.00039,1,314112,317896,+,3784
89,BUMA.1121.00083,1,1447111,1450896,-,3785
89,BUMA.1121.00084,1,444090,447874,+,3784
89,BUMA.1121.00049,1,1634382,1638167,-,3785
89,BUMA.1121.00089,1,232595,236379,+,3784
89,BUMA.1121.00014,1,2674923,2678708,-,3785
89,BUMA.1121.00090,1,2321391,2325175,+,3784
89,BUMA.1121.00071,1,235663,239447,+,3784
89,BUMA.1121.00078,1,1787049,1790834,-,3785
89,BUMA.1121.00102,1,1066113,1069898,-,3785
89,BUMA.1121.00075,1,3662158,3665941,+,3783
89,BUMA.1121.00012,1,2978136,2981920,+,3784
89,BUMA.1121.00076,1,1146223,1150008,-,3785
89,BUMA.1121.00106,1,1,3743,+,3742
89,BUMA.1121.00001,1,3907027,3910812,-,3785
89,BUMA.1121.00107,1,36116,39900,+,3784
89,BUMA.1121.00104,1,1059291,1063076,-,3785
89,BUMA.1121.00099,1,2196264,2200064,-,3800
89,BUMA.1121.00098,1,2938290,2942084,+,3794
89,BUMA.1121.00111,1,354278,358062,+,3784
89,BUMA.1121.00109,1,1664705,1668490,-,3785
89,BUMA.1121.00097,1,3822337,3826122,-,3785
89,BUMA.1121.00094,1,216761,220545,+,3784
89,BUMA.1121.00095,1,1458197,1461997,-,3800
89,BUMA.1121.00005,1,3354194,3357979,-,3785
89,BUMA.1121.00101,1,2266602,2270387,-,3785
89,BUMA.1121.00065,1,248545,252329,+,3784
89,BUMA.1121.00100,1,1126243,1130028,-,3785
89,BUMA.1121.00105,1,996218,1000003,-,3785
89,BUMA.1121.00029,1,692632,696417,-,3785
89,BUMA.1121.00066,1,216242,220026,+,3784
89,BUMA.1121.00031,1,1559413,1563197,+,3784
89,BUMA.1121.00108,1,1201029,1204813,+,3784
89,BUMA.1121.00023,1,2549186,2552970,+,3784
89,BUMA.1121.00035,1,1274370,1278154,+,3784
89,BUMA.1121.00041,1,1481842,1485626,+,3784
90,BUMA.1121.00057,1,1317863,1324311,+,6448
90,BUMA.1121.00058,1,330840,337276,-,6436
90,BUMA.1121.00045,1,3874555,3880991,-,6436
90,BUMA.1121.00051,1,221046,227482,+,6436
90,BUMA.1121.00068,1,3088107,3094543,+,6436
90,BUMA.1121.00061,1,251681,258123,+,6442
90,BUMA.1121.00060,1,2100198,2106634,-,6436
90,BUMA.1121.00064,1,264692,271134,+,6442
90,BUMA.1121.00016,1,2325403,2331839,+,6436
90,BUMA.1121.00003,1,2724727,2731163,+,6436
90,BUMA.1121.00055,1,3896779,3903221,+,6442
90,BUMA.1121.00011,1,1400647,1407083,-,6436
90,BUMA.1121.00037,1,2863606,2870042,+,6436
90,BUMA.1121.00009,1,1349299,1355735,-,6436
90,BUMA.1121.00069,1,212983,219425,+,6442
90,BUMA.1121.00088,1,1112370,1118806,+,6436
90,BUMA.1121.00092,1,3637407,3643849,-,6442
90,BUMA.1121.00074,1,3656277,3662713,-,6436
90,BUMA.1121.00070,1,223321,229763,+,6442
90,BUMA.1121.00093,1,982587,989029,+,6442
90,BUMA.1121.00063,1,248698,255140,+,6442
90,BUMA.1121.00033,1,2477322,2483758,+,6436
90,BUMA.1121.00018,1,725421,731857,+,6436
90,BUMA.1121.00080,1,265462,271898,+,6436
90,BUMA.1121.00027,1,2418355,2424791,+,6436
90,BUMA.1121.00053,1,4003480,4009916,+,6436
90,BUMA.1121.00059,1,3441080,3447516,+,6436
90,BUMA.1121.00043,1,213347,219783,+,6436
90,BUMA.1121.00056,1,3682185,3688627,-,6442
90,BUMA.1121.00112,1,2857368,2863804,-,6436
90,BUMA.1121.00091,1,320651,327087,-,6436
90,BUMA.1121.00047,1,2753322,2759758,-,6436
90,BUMA.1121.00067,1,151379,157815,-,6436
90,BUMA.1121.00110,1,594256,600693,-,6437
90,BUMA.1121.00073,1,249659,256101,+,6442
90,BUMA.1121.00072,1,223622,230064,+,6442
90,BUMA.1121.00077,1,2882723,2889159,+,6436
90,BUMA.1121.00082,1,258126,264568,+,6442
90,BUMA.1121.00062,1,354317,360753,-,6436
90,BUMA.1121.00007,1,3896201,3902638,-,6437
90,BUMA.1121.00025,1,2527970,2534406,-,6436
90,BUMA.1121.00021,1,858617,865053,+,6436
90,BUMA.1121.00103,1,138973,145409,-,6436
90,BUMA.1121.00096,1,3042465,3048901,-,6436
90,BUMA.1121.00079,1,260414,266850,+,6436
90,BUMA.1121.00039,1,318296,324732,+,6436
90,BUMA.1121.00083,1,1440267,1446709,-,6442
90,BUMA.1121.00084,1,448276,454712,+,6436
90,BUMA.1121.00049,1,1627538,1633980,-,6442
90,BUMA.1121.00089,1,236781,243223,+,6442
90,BUMA.1121.00014,1,2668087,2674523,-,6436
90,BUMA.1121.00090,1,2325575,2332011,+,6436
90,BUMA.1121.00071,1,239849,246291,+,6442
90,BUMA.1121.00078,1,1780213,1786649,-,6436
90,BUMA.1121.00102,1,1059276,1065716,-,6440
90,BUMA.1121.00075,1,3666343,3672785,+,6442
90,BUMA.1121.00012,1,2982320,2988756,+,6436
90,BUMA.1121.00076,1,1139379,1145821,-,6442
90,BUMA.1121.00106,1,4145,10587,+,6442
90,BUMA.1121.00001,1,3900190,3906626,-,6436
90,BUMA.1121.00107,1,40301,46737,+,6436
90,BUMA.1121.00104,1,1052447,1058889,-,6442
90,BUMA.1121.00099,1,2189450,2195865,-,6415
90,BUMA.1121.00098,1,2942484,2948920,+,6436
90,BUMA.1121.00111,1,358462,364898,+,6436
90,BUMA.1121.00109,1,1657868,1664304,-,6436
90,BUMA.1121.00097,1,3815499,3821935,-,6436
90,BUMA.1121.00094,1,220946,227388,+,6442
90,BUMA.1121.00095,1,1450062,1456498,-,6436
90,BUMA.1121.00005,1,3347358,3353794,-,6436
90,BUMA.1121.00101,1,2259764,2266200,-,6436
90,BUMA.1121.00065,1,252729,259165,+,6436
90,BUMA.1121.00100,1,1119406,1125842,-,6436
90,BUMA.1121.00105,1,989374,995816,-,6442
90,BUMA.1121.00029,1,685795,692231,-,6436
90,BUMA.1121.00066,1,220428,226870,+,6442
90,BUMA.1121.00031,1,1563597,1570033,+,6436
90,BUMA.1121.00108,1,1205214,1211650,+,6436
90,BUMA.1121.00023,1,2553370,2559806,+,6436
90,BUMA.1121.00035,1,1278555,1284991,+,6436
90,BUMA.1121.00041,1,1486026,1492474,+,6448
91,BUMA.1121.00057,1,1324464,1330478,+,6014
91,BUMA.1121.00058,1,324687,330688,-,6001
91,BUMA.1121.00045,1,3868391,3874403,-,6012
91,BUMA.1121.00051,1,227635,233636,+,6001
91,BUMA.1121.00068,1,3094696,3100706,+,6010
91,BUMA.1121.00061,1,258276,264290,+,6014
91,BUMA.1121.00060,1,2094034,2100046,-,6012
91,BUMA.1121.00064,1,271287,277289,+,6002
91,BUMA.1121.00016,1,2331992,2337968,+,5976
91,BUMA.1121.00003,1,2731316,2737329,+,6013
91,BUMA.1121.00055,1,3903374,3909386,+,6012
91,BUMA.1121.00011,1,1394571,1400495,-,5924
91,BUMA.1121.00037,1,2870195,2876208,+,6013
91,BUMA.1121.00009,1,1343133,1349147,-,6014
91,BUMA.1121.00069,1,219578,225592,+,6014
91,BUMA.1121.00088,1,1118959,1124960,+,6001
91,BUMA.1121.00092,1,3631253,3637255,-,6002
91,BUMA.1121.00074,1,3650124,3656125,-,6001
91,BUMA.1121.00070,1,229916,235928,+,6012
91,BUMA.1121.00093,1,989182,995184,+,6002
91,BUMA.1121.00063,1,255293,261303,+,6010
91,BUMA.1121.00033,1,2483911,2489907,+,5996
91,BUMA.1121.00018,1,732010,737904,+,5894
91,BUMA.1121.00080,1,272051,278052,+,6001
91,BUMA.1121.00027,1,2424944,2430956,+,6012
91,BUMA.1121.00053,1,4010069,4016070,+,6001
91,BUMA.1121.00059,1,3447669,3453670,+,6001
91,BUMA.1121.00043,1,219936,225949,+,6013
91,BUMA.1121.00056,1,3676032,3682033,-,6001
91,BUMA.1121.00112,1,2851203,2857216,-,6013
91,BUMA.1121.00091,1,314487,320499,-,6012
91,BUMA.1121.00047,1,2747169,2753170,-,6001
91,BUMA.1121.00067,1,145226,151227,-,6001
91,BUMA.1121.00110,1,588107,594104,-,5997
91,BUMA.1121.00073,1,256254,262266,+,6012
91,BUMA.1121.00072,1,230217,236231,+,6014
91,BUMA.1121.00077,1,2889312,2895309,+,5997
91,BUMA.1121.00082,1,264721,270735,+,6014
91,BUMA.1121.00062,1,348163,354165,-,6002
91,BUMA.1121.00007,1,3890034,3896049,-,6015
91,BUMA.1121.00025,1,2521924,2527818,-,5894
91,BUMA.1121.00021,1,865206,871219,+,6013
91,BUMA.1121.00103,1,132818,138821,-,6003
91,BUMA.1121.00096,1,3036312,3042313,-,6001
91,BUMA.1121.00079,1,267003,273004,+,6001
91,BUMA.1121.00039,1,324885,330898,+,6013
91,BUMA.1121.00083,1,1434101,1440115,-,6014
91,BUMA.1121.00084,1,454865,460867,+,6002
91,BUMA.1121.00049,1,1621374,1627386,-,6012
91,BUMA.1121.00089,1,243376,249377,+,6001
91,BUMA.1121.00014,1,2661922,2667935,-,6013
91,BUMA.1121.00090,1,2332164,2338177,+,6013
91,BUMA.1121.00071,1,246444,252455,+,6011
91,BUMA.1121.00078,1,1774060,1780061,-,6001
91,BUMA.1121.00102,1,1053123,1059124,-,6001
91,BUMA.1121.00075,1,3672938,3678940,+,6002
91,BUMA.1121.00012,1,2988909,2994905,+,5996
91,BUMA.1121.00076,1,1133224,1139227,-,6003
91,BUMA.1121.00106,1,10740,16742,+,6002
91,BUMA.1121.00001,1,3894027,3900038,-,6011
91,BUMA.1121.00107,1,46890,52902,+,6012
91,BUMA.1121.00104,1,1046293,1052295,-,6002
91,BUMA.1121.00099,1,2183295,2189298,-,6003
91,BUMA.1121.00098,1,2949073,2955088,+,6015
91,BUMA.1121.00111,1,365051,371064,+,6013
91,BUMA.1121.00109,1,1651704,1657716,-,6012
91,BUMA.1121.00097,1,3809356,3815347,-,5991
91,BUMA.1121.00094,1,227541,233542,+,6001
91,BUMA.1121.00095,1,1443909,1449910,-,6001
91,BUMA.1121.00005,1,3341202,3347206,-,6004
91,BUMA.1121.00101,1,2253600,2259612,-,6012
91,BUMA.1121.00065,1,259318,265330,+,6012
91,BUMA.1121.00100,1,1113253,1119254,-,6001
91,BUMA.1121.00105,1,983215,989222,-,6007
91,BUMA.1121.00029,1,679632,685643,-,6011
91,BUMA.1121.00066,1,227023,233030,+,6007
91,BUMA.1121.00031,1,1570186,1576199,+,6013
91,BUMA.1121.00108,1,1211803,1217815,+,6012
91,BUMA.1121.00023,1,2559959,2565972,+,6013
91,BUMA.1121.00035,1,1285144,1291155,+,6011
91,BUMA.1121.00041,1,1492627,1498624,+,5997
92,BUMA.1121.00057,1,1333401,1337921,+,4520
92,BUMA.1121.00058,1,317259,321779,-,4520
92,BUMA.1121.00045,1,3860978,3865498,-,4520
92,BUMA.1121.00051,1,236631,241151,+,4520
92,BUMA.1121.00068,1,3103621,3108141,+,4520
92,BUMA.1121.00061,1,267202,271722,+,4520
92,BUMA.1121.00060,1,2086629,2091149,-,4520
92,BUMA.1121.00064,1,280188,284708,+,4520
92,BUMA.1121.00016,1,2340875,2345395,+,4520
92,BUMA.1121.00003,1,2740252,2744775,+,4523
92,BUMA.1121.00055,1,3912309,3916829,+,4520
92,BUMA.1121.00011,1,1387095,1391615,-,4520
92,BUMA.1121.00037,1,2879147,2883667,+,4520
92,BUMA.1121.00009,1,1335649,1340169,-,4520
92,BUMA.1121.00069,1,228507,233027,+,4520
92,BUMA.1121.00088,1,1127859,1132379,+,4520
92,BUMA.1121.00092,1,3623841,3628361,-,4520
92,BUMA.1121.00074,1,3642688,3647208,-,4520
92,BUMA.1121.00070,1,238843,243363,+,4520
92,BUMA.1121.00093,1,998075,1002595,+,4520
92,BUMA.1121.00063,1,264218,268738,+,4520
92,BUMA.1121.00033,1,2492830,2497349,+,4519
92,BUMA.1121.00018,1,740859,745379,+,4520
92,BUMA.1121.00080,1,280935,285455,+,4520
92,BUMA.1121.00027,1,2433895,2438415,+,4520
92,BUMA.1121.00053,1,4019049,4023569,+,4520
92,BUMA.1121.00059,1,3456569,3461089,+,4520
92,BUMA.1121.00043,1,228889,233409,+,4520
92,BUMA.1121.00056,1,3668596,3673116,-,4520
92,BUMA.1121.00112,1,2843743,2848263,-,4520
92,BUMA.1121.00091,1,307027,311547,-,4520
92,BUMA.1121.00047,1,2739709,2744229,-,4520
92,BUMA.1121.00067,1,137806,142326,-,4520
92,BUMA.1121.00110,1,580647,585167,-,4520
92,BUMA.1121.00073,1,265181,269701,+,4520
92,BUMA.1121.00072,1,239146,243666,+,4520
92,BUMA.1121.00077,1,2898248,2902768,+,4520
92,BUMA.1121.00082,1,273650,278170,+,4520
92,BUMA.1121.00062,1,340727,345247,-,4520
92,BUMA.1121.00007,1,3882614,3887134,-,4520
92,BUMA.1121.00025,1,2514448,2518968,-,4520
92,BUMA.1121.00021,1,874150,878670,+,4520
92,BUMA.1121.00103,1,125398,129918,-,4520
92,BUMA.1121.00096,1,3028916,3033436,-,4520
92,BUMA.1121.00079,1,275911,280431,+,4520
92,BUMA.1121.00039,1,333814,338334,+,4520
92,BUMA.1121.00083,1,1426665,1431185,-,4520
92,BUMA.1121.00084,1,463758,468278,+,4520
92,BUMA.1121.00049,1,1613938,1618442,-,4504
92,BUMA.1121.00089,1,252292,256812,+,4520
92,BUMA.1121.00014,1,2654446,2658966,-,4520
92,BUMA.1121.00090,1,2341140,2345660,+,4520
92,BUMA.1121.00071,1,255370,259890,+,4520
92,BUMA.1121.00078,1,1766650,1771170,-,4520
92,BUMA.1121.00102,1,1045639,1050159,-,4520
92,BUMA.1121.00075,1,3681887,3686407,+,4520
92,BUMA.1121.00012,1,2997805,3002325,+,4520
92,BUMA.1121.00076,1,1125756,1130276,-,4520
92,BUMA.1121.00106,1,19665,24185,+,4520
92,BUMA.1121.00001,1,3886527,3891047,-,4520
92,BUMA.1121.00107,1,55801,60321,+,4520
92,BUMA.1121.00104,1,1038865,1043385,-,4520
92,BUMA.1121.00099,1,2175833,2180364,-,4531
92,BUMA.1121.00098,1,2958004,2962524,+,4520
92,BUMA.1121.00111,1,374027,378547,+,4520
92,BUMA.1121.00109,1,1644276,1648796,-,4520
92,BUMA.1121.00097,1,3801928,3806448,-,4520
92,BUMA.1121.00094,1,236457,240977,+,4520
92,BUMA.1121.00095,1,1436473,1440993,-,4520
92,BUMA.1121.00005,1,3333750,3338270,-,4520
92,BUMA.1121.00101,1,2246172,2250692,-,4520
92,BUMA.1121.00065,1,268277,272797,+,4520
92,BUMA.1121.00100,1,1105841,1110361,-,4520
92,BUMA.1121.00105,1,975763,980283,-,4520
92,BUMA.1121.00029,1,672188,676708,-,4520
92,BUMA.1121.00066,1,235945,240465,+,4520
92,BUMA.1121.00031,1,1579138,1583658,+,4520
92,BUMA.1121.00108,1,1220770,1225290,+,4520
92,BUMA.1121.00023,1,2568895,2573415,+,4520
92,BUMA.1121.00035,1,1294054,1298574,+,4520
92,BUMA.1121.00041,1,1501523,1506043,+,4520
93,BUMA.1121.00057,1,1339638,1372313,+,32675
93,BUMA.1121.00058,1,282829,315571,-,32742
93,BUMA.1121.00045,1,3826568,3859268,-,32700
93,BUMA.1121.00051,1,242855,275551,+,32696
93,BUMA.1121.00068,1,3109841,3142538,+,32697
93,BUMA.1121.00061,1,273439,306146,+,32707
93,BUMA.1121.00060,1,2052219,2084919,-,32700
93,BUMA.1121.00064,1,286396,319050,+,32654
93,BUMA.1121.00016,1,2347089,2379821,+,32732
93,BUMA.1121.00003,1,2746492,2779167,+,32675
93,BUMA.1121.00055,1,3918523,3951183,+,32660
93,BUMA.1121.00011,1,1352691,1385408,-,32717
93,BUMA.1121.00037,1,2885361,2918107,+,32746
93,BUMA.1121.00009,1,1301217,1333941,-,32724
93,BUMA.1121.00069,1,234740,267442,+,32702
93,BUMA.1121.00088,1,1134067,1166781,+,32714
93,BUMA.1121.00092,1,3589467,3622147,-,32680
93,BUMA.1121.00074,1,3608358,3641000,-,32642
93,BUMA.1121.00070,1,245080,277787,+,32707
93,BUMA.1121.00093,1,1004289,1036970,+,32681
93,BUMA.1121.00063,1,270455,303162,+,32707
93,BUMA.1121.00033,1,2499043,2531758,+,32715
93,BUMA.1121.00018,1,747088,779815,+,32727
93,BUMA.1121.00080,1,287143,319846,+,32703
93,BUMA.1121.00027,1,2440116,2472776,+,32660
93,BUMA.1121.00053,1,4037273,4069979,+,32706
93,BUMA.1121.00059,1,3462777,3495464,+,32687
93,BUMA.1121.00043,1,235102,269204,+,34102
93,BUMA.1121.00056,1,3634197,3666892,-,32695
93,BUMA.1121.00112,1,2809334,2842035,-,32701
93,BUMA.1121.00091,1,272637,305333,-,32696
93,BUMA.1121.00047,1,2705319,2738005,-,32686
93,BUMA.1121.00067,1,103476,136118,-,32642
93,BUMA.1121.00110,1,546224,578944,-,32720
93,BUMA.1121.00073,1,271418,304125,+,32707
93,BUMA.1121.00072,1,245383,278090,+,32707
93,BUMA.1121.00077,1,2904471,2937192,+,32721
93,BUMA.1121.00082,1,279887,312594,+,32707
93,BUMA.1121.00062,1,306338,339039,-,32701
93,BUMA.1121.00007,1,3848208,3880910,-,32702
93,BUMA.1121.00025,1,2480013,2512739,-,32726
93,BUMA.1121.00021,1,880447,913175,+,32728
93,BUMA.1121.00103,1,91018,123688,-,32670
93,BUMA.1121.00096,1,2982508,3015191,-,32683
93,BUMA.1121.00079,1,282135,314845,+,32710
93,BUMA.1121.00039,1,340044,372741,+,32697
93,BUMA.1121.00083,1,1392242,1424948,-,32706
93,BUMA.1121.00084,1,469966,502666,+,32700
93,BUMA.1121.00049,1,1579555,1612243,-,32688
93,BUMA.1121.00089,1,258516,291212,+,32696
93,BUMA.1121.00014,1,2619974,2652720,-,32746
93,BUMA.1121.00090,1,2347354,2380088,+,32734
93,BUMA.1121.00071,1,261607,294314,+,32707
93,BUMA.1121.00078,1,1720291,1752968,-,32677
93,BUMA.1121.00102,1,999242,1031947,-,32705
93,BUMA.1121.00075,1,3688117,3720813,+,32696
93,BUMA.1121.00012,1,3004041,3036753,+,32712
93,BUMA.1121.00076,1,1091350,1124046,-,32696
93,BUMA.1121.00106,1,25889,58601,+,32712
93,BUMA.1121.00001,1,3852099,3884833,-,32734
93,BUMA.1121.00107,1,62014,94723,+,32709
93,BUMA.1121.00104,1,1004461,1037161,-,32700
93,BUMA.1121.00099,1,2141435,2174129,-,32694
93,BUMA.1121.00098,1,2964232,2996914,+,32682
93,BUMA.1121.00111,1,380250,412952,+,32702
93,BUMA.1121.00109,1,1597827,1630584,-,32757
93,BUMA.1121.00097,1,3767523,3800242,-,32719
93,BUMA.1121.00094,1,242681,275389,+,32708
93,BUMA.1121.00095,1,1402061,1434776,-,32715
93,BUMA.1121.00005,1,3299393,3332040,-,32647
93,BUMA.1121.00101,1,2211817,2244484,-,32667
93,BUMA.1121.00065,1,274514,307192,+,32678
93,BUMA.1121.00100,1,1059452,1092148,-,32696
93,BUMA.1121.00105,1,941368,974069,-,32701
93,BUMA.1121.00029,1,637767,670494,-,32727
93,BUMA.1121.00066,1,242182,274887,+,32705
93,BUMA.1121.00031,1,1585384,1618134,+,32750
93,BUMA.1121.00108,1,1226991,1259681,+,32690
93,BUMA.1121.00023,1,2575109,2607836,+,32727
93,BUMA.1121.00035,1,1300268,1333006,+,32738
93,BUMA.1121.00041,1,1507737,1540451,+,32714
94,BUMA.1121.00057,1,1376695,1397096,+,20401
94,BUMA.1121.00058,1,258111,278446,-,20335
94,BUMA.1121.00045,1,3801891,3822131,-,20240
94,BUMA.1121.00051,1,281246,301589,+,20343
94,BUMA.1121.00068,1,3146911,3167229,+,20318
94,BUMA.1121.00061,1,310521,330640,+,20119
94,BUMA.1121.00060,1,2027542,2047782,-,20240
94,BUMA.1121.00064,1,323432,343771,+,20339
94,BUMA.1121.00016,1,2384231,2404473,+,20242
94,BUMA.1121.00003,1,2783539,2803808,+,20269
94,BUMA.1121.00055,1,3955575,3975921,+,20346
94,BUMA.1121.00011,1,1327963,1348245,-,20282
94,BUMA.1121.00037,1,2922517,2942777,+,20260
94,BUMA.1121.00009,1,1276542,1296843,-,20301
94,BUMA.1121.00069,1,271812,292057,+,20245
94,BUMA.1121.00088,1,1172476,1192798,+,20322
94,BUMA.1121.00092,1,3564766,3585084,-,20318
94,BUMA.1121.00074,1,3583636,3603975,-,20339
94,BUMA.1121.00070,1,282157,302422,+,20265
94,BUMA.1121.00093,1,1041352,1061670,+,20318
94,BUMA.1121.00063,1,307527,327678,+,20151
94,BUMA.1121.00033,1,2536167,2556445,+,20278
94,BUMA.1121.00018,1,784243,804513,+,20270
94,BUMA.1121.00080,1,325541,345884,+,20343
94,BUMA.1121.00027,1,2477167,2497464,+,20297
94,BUMA.1121.00053,1,20,20284,+,20264
94,BUMA.1121.00059,1,3501159,3521481,+,20322
94,BUMA.1121.00043,1,273633,293965,+,20332
94,BUMA.1121.00056,1,3609505,3629814,-,20309
94,BUMA.1121.00112,1,2784686,2804951,-,20265
94,BUMA.1121.00091,1,246693,266938,-,20245
94,BUMA.1121.00047,1,2679280,2699623,-,20343
94,BUMA.1121.00067,1,78723,99093,-,20370
94,BUMA.1121.00110,1,521575,541840,-,20265
94,BUMA.1121.00073,1,308500,328740,+,20240
94,BUMA.1121.00072,1,282451,302614,+,20163
94,BUMA.1121.00077,1,2941575,2961841,+,20266
94,BUMA.1121.00082,1,316976,337274,+,20298
94,BUMA.1121.00062,1,281609,301955,-,20346
94,BUMA.1121.00007,1,3823561,3843816,-,20255
94,BUMA.1121.00025,1,2455314,2475584,-,20270
94,BUMA.1121.00021,1,917585,937838,+,20253
94,BUMA.1121.00103,1,64705,85001,-,20296
94,BUMA.1121.00096,1,2956580,2976822,-,20242
94,BUMA.1121.00079,1,319225,339568,+,20343
94,BUMA.1121.00039,1,377179,397440,+,20261
94,BUMA.1121.00083,1,1367561,1387859,-,20298
94,BUMA.1121.00084,1,508361,528618,+,20257
94,BUMA.1121.00049,1,1554866,1575172,-,20306
94,BUMA.1121.00089,1,295594,315903,+,20309
94,BUMA.1121.00014,1,2595303,2615563,-,20260
94,BUMA.1121.00090,1,2384497,2404757,+,20260
94,BUMA.1121.00071,1,298686,318957,+,20271
94,BUMA.1121.00078,1,1694297,1714562,-,20265
94,BUMA.1121.00102,1,973125,993407,-,20282
94,BUMA.1121.00075,1,3725194,3745524,+,20330
94,BUMA.1121.00012,1,3041163,3061436,+,20273
94,BUMA.1121.00076,1,1066635,1086968,-,20333
94,BUMA.1121.00106,1,62983,83323,+,20340
94,BUMA.1121.00001,1,3827429,3847680,-,20251
94,BUMA.1121.00107,1,99106,119442,+,20336
94,BUMA.1121.00104,1,979749,1000078,-,20329
94,BUMA.1121.00099,1,2116760,2137042,-,20282
94,BUMA.1121.00098,1,3001298,3021515,+,20217
94,BUMA.1121.00111,1,418967,439213,+,20246
94,BUMA.1121.00109,1,1573142,1593434,-,20292
94,BUMA.1121.00097,1,3742858,3763112,-,20254
94,BUMA.1121.00094,1,279771,300079,+,20308
94,BUMA.1121.00095,1,1377404,1397689,-,20285
94,BUMA.1121.00005,1,3273241,3293409,-,20168
94,BUMA.1121.00101,1,2187157,2207396,-,20239
94,BUMA.1121.00065,1,311578,331803,+,20225
94,BUMA.1121.00100,1,1034854,1055069,-,20215
94,BUMA.1121.00105,1,916702,936985,-,20283
94,BUMA.1121.00029,1,613100,633338,-,20238
94,BUMA.1121.00066,1,279259,299527,+,20268
94,BUMA.1121.00031,1,1622544,1642804,+,20260
94,BUMA.1121.00108,1,1264072,1284333,+,20261
94,BUMA.1121.00023,1,2612255,2632532,+,20277
94,BUMA.1121.00035,1,1337424,1357675,+,20251
94,BUMA.1121.00041,1,1544878,1565184,+,20306
95,BUMA.1121.00057,1,1399244,1405001,+,5757
95,BUMA.1121.00058,1,250217,255965,-,5748
95,BUMA.1121.00045,1,3793975,3799744,-,5769
95,BUMA.1121.00051,1,303737,309505,+,5768
95,BUMA.1121.00068,1,3169392,3175150,+,5758
95,BUMA.1121.00061,1,332788,338536,+,5748
95,BUMA.1121.00060,1,2019626,2025395,-,5769
95,BUMA.1121.00064,1,345919,351688,+,5769
95,BUMA.1121.00016,1,2406593,2412349,+,5756
95,BUMA.1121.00003,1,2805968,2811750,+,5782
95,BUMA.1121.00055,1,3978069,3983817,+,5748
95,BUMA.1121.00011,1,1320047,1325816,-,5769
95,BUMA.1121.00037,1,2944897,2950654,+,5757
95,BUMA.1121.00009,1,1268648,1274395,-,5747
95,BUMA.1121.00069,1,294205,299953,+,5748
95,BUMA.1121.00088,1,1194946,1200703,+,5757
95,BUMA.1121.00092,1,3556850,3562619,-,5769
95,BUMA.1121.00074,1,3575720,3581489,-,5769
95,BUMA.1121.00070,1,304570,310318,+,5748
95,BUMA.1121.00093,1,1063818,1069587,+,5769
95,BUMA.1121.00063,1,329826,335574,+,5748
95,BUMA.1121.00033,1,2558565,2564297,+,5732
95,BUMA.1121.00018,1,806605,812352,+,5747
95,BUMA.1121.00080,1,348032,353800,+,5768
95,BUMA.1121.00027,1,2499612,2505369,+,5757
95,BUMA.1121.00053,1,22432,28180,+,5748
95,BUMA.1121.00059,1,3523629,3529410,+,5781
95,BUMA.1121.00043,1,296085,301842,+,5757
95,BUMA.1121.00056,1,3601598,3607358,-,5760
95,BUMA.1121.00112,1,2776777,2782539,-,5762
95,BUMA.1121.00091,1,238782,244545,-,5763
95,BUMA.1121.00047,1,2671364,2677133,-,5769
95,BUMA.1121.00067,1,70807,76576,-,5769
95,BUMA.1121.00110,1,513628,519421,-,5793
95,BUMA.1121.00073,1,330888,336636,+,5748
95,BUMA.1121.00072,1,304762,310510,+,5748
95,BUMA.1121.00077,1,2963996,2969790,+,5794
95,BUMA.1121.00082,1,339422,345170,+,5748
95,BUMA.1121.00062,1,273714,279462,-,5748
95,BUMA.1121.00007,1,3815666,3821414,-,5748
95,BUMA.1121.00025,1,2447476,2453223,-,5747
95,BUMA.1121.00021,1,939958,945715,+,5757
95,BUMA.1121.00103,1,56820,62559,-,5739
95,BUMA.1121.00096,1,2948685,2954433,-,5748
95,BUMA.1121.00079,1,341716,347496,+,5780
95,BUMA.1121.00039,1,399560,405293,+,5733
95,BUMA.1121.00083,1,1359666,1365414,-,5748
95,BUMA.1121.00084,1,530766,536514,+,5748
95,BUMA.1121.00049,1,1546938,1552719,-,5781
95,BUMA.1121.00089,1,318051,323811,+,5760
95,BUMA.1121.00014,1,2587399,2593156,-,5757
95,BUMA.1121.00090,1,2406877,2412634,+,5757
95,BUMA.1121.00071,1,321105,326853,+,5748
95,BUMA.1121.00078,1,1686386,1692149,-,5763
95,BUMA.1121.00102,1,965230,970978,-,5748
95,BUMA.1121.00075,1,3747672,3753434,+,5762
95,BUMA.1121.00012,1,3063556,3069313,+,5757
95,BUMA.1121.00076,1,1058726,1064488,-,5762
95,BUMA.1121.00106,1,85471,91252,+,5781
95,BUMA.1121.00001,1,3819553,3825310,-,5757
95,BUMA.1121.00107,1,121587,127380,+,5793
95,BUMA.1121.00104,1,971821,977602,-,5781
95,BUMA.1121.00099,1,2108844,2114613,-,5769
95,BUMA.1121.00098,1,3023663,3029411,+,5748
95,BUMA.1121.00111,1,441333,447090,+,5757
95,BUMA.1121.00109,1,1565248,1570996,-,5748
95,BUMA.1121.00097,1,3734963,3740711,-,5748
95,BUMA.1121.00094,1,302227,307987,+,5760
95,BUMA.1121.00095,1,1369498,1375246,-,5748
95,BUMA.1121.00005,1,3265335,3271094,-,5759
95,BUMA.1121.00101,1,2179312,2185005,-,5693
95,BUMA.1121.00065,1,333951,339704,+,5753
95,BUMA.1121.00100,1,1026959,1032707,-,5748
95,BUMA.1121.00105,1,908807,914555,-,5748
95,BUMA.1121.00029,1,605224,610981,-,5757
95,BUMA.1121.00066,1,301675,307423,+,5748
95,BUMA.1121.00031,1,1644952,1650709,+,5757
95,BUMA.1121.00108,1,1286481,1292262,+,5781
95,BUMA.1121.00023,1,2634652,2640409,+,5757
95,BUMA.1121.00035,1,1359795,1365552,+,5757
95,BUMA.1121.00041,1,1567332,1573095,+,5763
96,BUMA.1121.00057,1,1405603,1410209,+,4606
96,BUMA.1121.00058,1,243723,248339,-,4616
96,BUMA.1121.00045,1,3788767,3793345,-,4578
96,BUMA.1121.00051,1,310233,314834,+,4601
96,BUMA.1121.00068,1,3175773,3180379,+,4606
96,BUMA.1121.00061,1,339130,343724,+,4594
96,BUMA.1121.00060,1,2014434,2019012,-,4578
96,BUMA.1121.00064,1,352287,356893,+,4606
96,BUMA.1121.00016,1,2412921,2417521,+,4600
96,BUMA.1121.00003,1,2812366,2816971,+,4605
96,BUMA.1121.00055,1,3985696,3990301,+,4605
96,BUMA.1121.00011,1,1314863,1319465,-,4602
96,BUMA.1121.00037,1,2952560,2957160,+,4600
96,BUMA.1121.00009,1,1263410,1268006,-,4596
96,BUMA.1121.00069,1,300550,305156,+,4606
96,BUMA.1121.00088,1,1201252,1205853,+,4601
96,BUMA.1121.00092,1,3551583,3556189,-,4606
96,BUMA.1121.00074,1,3570542,3575158,-,4616
96,BUMA.1121.00070,1,310915,315521,+,4606
96,BUMA.1121.00093,1,1070248,1074854,+,4606
96,BUMA.1121.00063,1,336171,340777,+,4606
96,BUMA.1121.00033,1,2566156,2570761,+,4605
96,BUMA.1121.00018,1,812941,817541,+,4600
96,BUMA.1121.00080,1,354479,359080,+,4601
96,BUMA.1121.00027,1,2505970,2510576,+,4606
96,BUMA.1121.00053,1,28827,33436,+,4609
96,BUMA.1121.00059,1,3529972,3534573,+,4601
96,BUMA.1121.00043,1,302375,306975,+,4600
96,BUMA.1121.00056,1,3596350,3600966,-,4616
96,BUMA.1121.00112,1,2771528,2776133,-,4605
96,BUMA.1121.00091,1,230973,235579,-,4606
96,BUMA.1121.00047,1,2666148,2670764,-,4616
96,BUMA.1121.00067,1,65653,70269,-,4616
96,BUMA.1121.00110,1,508425,513031,-,4606
96,BUMA.1121.00073,1,337232,341838,+,4606
96,BUMA.1121.00072,1,311099,315705,+,4606
96,BUMA.1121.00077,1,2970387,2974995,+,4608
96,BUMA.1121.00082,1,345767,350373,+,4606
96,BUMA.1121.00062,1,268555,273161,-,4606
96,BUMA.1121.00007,1,3810483,3815089,-,4606
96,BUMA.1121.00025,1,2442272,2446887,-,4615
96,BUMA.1121.00021,1,946296,950897,+,4601
96,BUMA.1121.00103,1,50335,54941,-,4606
96,BUMA.1121.00096,1,2943449,2948055,-,4606
96,BUMA.1121.00079,1,348135,352736,+,4601
96,BUMA.1121.00039,1,405930,410530,+,4600
96,BUMA.1121.00083,1,1354463,1359069,-,4606
96,BUMA.1121.00084,1,537127,541728,+,4601
96,BUMA.1121.00049,1,1541693,1546299,-,4606
96,BUMA.1121.00089,1,324443,329044,+,4601
96,BUMA.1121.00014,1,2582235,2586850,-,4615
96,BUMA.1121.00090,1,2413215,2417815,+,4600
96,BUMA.1121.00071,1,327450,332056,+,4606
96,BUMA.1121.00078,1,1681150,1685776,-,4626
96,BUMA.1121.00102,1,960029,964635,-,4606
96,BUMA.1121.00075,1,3755308,3759913,+,4605
96,BUMA.1121.00012,1,3069870,3074471,+,4601
96,BUMA.1121.00076,1,1052255,1056860,-,4605
96,BUMA.1121.00106,1,91819,96420,+,4601
96,BUMA.1121.00001,1,3814333,3818948,-,4615
96,BUMA.1121.00107,1,127973,132472,+,4499
96,BUMA.1121.00104,1,966528,971134,-,4606
96,BUMA.1121.00099,1,2103583,2108190,-,4607
96,BUMA.1121.00098,1,3030060,3034638,+,4578
96,BUMA.1121.00111,1,447695,452295,+,4600
96,BUMA.1121.00109,1,1558694,1563300,-,4606
96,BUMA.1121.00097,1,3728540,3733136,-,4596
96,BUMA.1121.00094,1,308619,313220,+,4601
96,BUMA.1121.00095,1,1364293,1368909,-,4616
96,BUMA.1121.00005,1,3258436,3263042,-,4606
96,BUMA.1121.00101,1,2174064,2178666,-,4602
96,BUMA.1121.00065,1,340391,344997,+,4606
96,BUMA.1121.00100,1,1021603,1026199,-,4596
96,BUMA.1121.00105,1,903565,908181,-,4616
96,BUMA.1121.00029,1,600012,604627,-,4615
96,BUMA.1121.00066,1,308020,312626,+,4606
96,BUMA.1121.00031,1,1651330,1655930,+,4600
96,BUMA.1121.00108,1,1294133,1298728,+,4595
96,BUMA.1121.00023,1,2640990,2645590,+,4600
96,BUMA.1121.00035,1,1366085,1370685,+,4600
96,BUMA.1121.00041,1,1573765,1578353,+,4588
97,BUMA.1121.00057,1,1410210,1424897,+,14687
97,BUMA.1121.00058,1,227724,243721,-,15997
97,BUMA.1121.00045,1,3774113,3788765,-,14652
97,BUMA.1121.00051,1,314839,330815,+,15976
97,BUMA.1121.00068,1,3180380,3196352,+,15972
97,BUMA.1121.00061,1,343725,358392,+,14667
97,BUMA.1121.00060,1,1999780,2014432,-,14652
97,BUMA.1121.00064,1,356894,371591,+,14697
97,BUMA.1121.00016,1,2417526,2432251,+,14725
97,BUMA.1121.00003,1,2816972,2831635,+,14663
97,BUMA.1121.00055,1,3990302,4004962,+,14660
97,BUMA.1121.00011,1,1300169,1314861,-,14692
97,BUMA.1121.00037,1,2957165,2971849,+,14684
97,BUMA.1121.00009,1,1248711,1263408,-,14697
97,BUMA.1121.00069,1,305157,319815,+,14658
97,BUMA.1121.00088,1,1205858,1220526,+,14668
97,BUMA.1121.00092,1,3535618,3551581,-,15963
97,BUMA.1121.00074,1,3555896,3570540,-,14644
97,BUMA.1121.00070,1,315522,330179,+,14657
97,BUMA.1121.00093,1,1074855,1090818,+,15963
97,BUMA.1121.00063,1,340778,355466,+,14688
97,BUMA.1121.00033,1,2572350,2587131,+,14781
97,BUMA.1121.00018,1,817546,832290,+,14744
97,BUMA.1121.00080,1,359085,375062,+,15977
97,BUMA.1121.00027,1,2510577,2525261,+,14684
97,BUMA.1121.00053,1,33437,48181,+,14744
97,BUMA.1121.00059,1,3534578,3549252,+,14674
97,BUMA.1121.00043,1,306980,321684,+,14704
97,BUMA.1121.00056,1,3580391,3596348,-,15957
97,BUMA.1121.00112,1,2756829,2771526,-,14697
97,BUMA.1121.00091,1,216253,230971,-,14718
97,BUMA.1121.00047,1,2650189,2666146,-,15957
97,BUMA.1121.00067,1,51007,65651,-,14644
97,BUMA.1121.00110,1,490848,506836,-,15988
97,BUMA.1121.00073,1,341839,356496,+,14657
97,BUMA.1121.00072,1,315706,330401,+,14695
97,BUMA.1121.00077,1,2976584,2992569,+,15985
97,BUMA.1121.00082,1,350374,365070,+,14696
97,BUMA.1121.00062,1,252583,268553,-,15970
97,BUMA.1121.00007,1,3795798,3810481,-,14683
97,BUMA.1121.00025,1,2427557,2442270,-,14713
97,BUMA.1121.00021,1,950932,965714,+,14782
97,BUMA.1121.00103,1,35685,50333,-,14648
97,BUMA.1121.00096,1,2928800,2943447,-,14647
97,BUMA.1121.00079,1,352741,368710,+,15969
97,BUMA.1121.00039,1,410535,425265,+,14730
97,BUMA.1121.00083,1,1339766,1354461,-,14695
97,BUMA.1121.00084,1,541733,556419,+,14686
97,BUMA.1121.00049,1,1527005,1541691,-,14686
97,BUMA.1121.00089,1,329049,345018,+,15969
97,BUMA.1121.00014,1,2567551,2582233,-,14682
97,BUMA.1121.00090,1,2417820,2432617,+,14797
97,BUMA.1121.00071,1,332057,346716,+,14659
97,BUMA.1121.00078,1,1666414,1681148,-,14734
97,BUMA.1121.00102,1,945364,960027,-,14663
97,BUMA.1121.00075,1,3759914,3774570,+,14656
97,BUMA.1121.00012,1,3074476,3089160,+,14684
97,BUMA.1121.00076,1,1037595,1052253,-,14658
97,BUMA.1121.00106,1,96425,111093,+,14668
97,BUMA.1121.00001,1,3799554,3814331,-,14777
97,BUMA.1121.00107,1,132473,147164,+,14691
97,BUMA.1121.00104,1,951851,966526,-,14675
97,BUMA.1121.00099,1,2088823,2103581,-,14758
97,BUMA.1121.00098,1,3036228,3052205,+,15977
97,BUMA.1121.00111,1,452310,467022,+,14712
97,BUMA.1121.00109,1,1543959,1558692,-,14733
97,BUMA.1121.00097,1,3712517,3728538,-,16021
97,BUMA.1121.00094,1,313225,329213,+,15988
97,BUMA.1121.00095,1,1349640,1364291,-,14651
97,BUMA.1121.00005,1,3243748,3258434,-,14686
97,BUMA.1121.00101,1,2159376,2174062,-,14686
97,BUMA.1121.00065,1,344998,359648,+,14650
97,BUMA.1121.00100,1,1006902,1021601,-,14699
97,BUMA.1121.00105,1,888909,903563,-,14654
97,BUMA.1121.00029,1,585252,600010,-,14758
97,BUMA.1121.00066,1,312627,327285,+,14658
97,BUMA.1121.00031,1,1655935,1671940,+,16005
97,BUMA.1121.00108,1,1298729,1313419,+,14690
97,BUMA.1121.00023,1,2645595,2660281,+,14686
97,BUMA.1121.00035,1,1370690,1385470,+,14780
97,BUMA.1121.00041,1,1578354,1594316,+,15962
98,BUMA.1121.00057,1,1434274,1460030,+,25756
98,BUMA.1121.00058,1,192577,218327,-,25750
98,BUMA.1121.00045,1,3738961,3764720,-,25759
98,BUMA.1121.00051,1,340210,366041,+,25831
98,BUMA.1121.00068,1,3205737,3231533,+,25796
98,BUMA.1121.00061,1,367711,393443,+,25732
98,BUMA.1121.00060,1,1964628,1990387,-,25759
98,BUMA.1121.00064,1,380989,406722,+,25733
98,BUMA.1121.00016,1,2441644,2467457,+,25813
98,BUMA.1121.00003,1,2833889,2859683,+,25794
98,BUMA.1121.00055,1,4014365,4040200,+,25835
98,BUMA.1121.00011,1,1263811,1290768,-,26957
98,BUMA.1121.00037,1,2981242,3006992,+,25750
98,BUMA.1121.00009,1,1213519,1239317,-,25798
98,BUMA.1121.00069,1,329132,354865,+,25733
98,BUMA.1121.00088,1,1229922,1255668,+,25746
98,BUMA.1121.00092,1,3500427,3526222,-,25795
98,BUMA.1121.00074,1,3519478,3545288,-,25810
98,BUMA.1121.00070,1,339497,365203,+,25706
98,BUMA.1121.00093,1,1100214,1126008,+,25794
98,BUMA.1121.00063,1,364784,390489,+,25705
98,BUMA.1121.00033,1,2596524,2622312,+,25788
98,BUMA.1121.00018,1,841683,867477,+,25794
98,BUMA.1121.00080,1,384457,410257,+,25800
98,BUMA.1121.00027,1,2534658,2560405,+,25747
98,BUMA.1121.00053,1,57498,83207,+,25709
98,BUMA.1121.00059,1,3588841,3614575,+,25734
98,BUMA.1121.00043,1,331078,356875,+,25797
98,BUMA.1121.00056,1,3545191,3570996,-,25805
98,BUMA.1121.00112,1,2721636,2747433,-,25797
98,BUMA.1121.00091,1,151576,177397,-,25821
98,BUMA.1121.00047,1,2614974,2640794,-,25820
98,BUMA.1121.00067,1,15793,41612,-,25819
98,BUMA.1121.00110,1,424658,450442,-,25784
98,BUMA.1121.00073,1,365815,391523,+,25708
98,BUMA.1121.00072,1,339721,365454,+,25733
98,BUMA.1121.00077,1,3032973,3058755,+,25782
98,BUMA.1121.00082,1,374463,400196,+,25733
98,BUMA.1121.00062,1,217381,243178,-,25797
98,BUMA.1121.00007,1,3760599,3786414,-,25815
98,BUMA.1121.00025,1,2392369,2418164,-,25795
98,BUMA.1121.00021,1,975099,1000871,+,25772
98,BUMA.1121.00103,1,505,26292,-,25787
98,BUMA.1121.00096,1,2897072,2922908,-,25836
98,BUMA.1121.00079,1,378105,403937,+,25832
98,BUMA.1121.00039,1,450837,476610,+,25773
98,BUMA.1121.00083,1,1304639,1330373,-,25734
98,BUMA.1121.00084,1,565812,591624,+,25812
98,BUMA.1121.00049,1,1491808,1517609,-,25801
98,BUMA.1121.00089,1,354413,380232,+,25819
98,BUMA.1121.00014,1,2532405,2558164,-,25759
98,BUMA.1121.00090,1,2442010,2467783,+,25773
98,BUMA.1121.00071,1,356036,381743,+,25707
98,BUMA.1121.00078,1,1631381,1657094,-,25713
98,BUMA.1121.00102,1,910252,936047,-,25795
98,BUMA.1121.00075,1,3783967,3809761,+,25794
98,BUMA.1121.00012,1,3098545,3124332,+,25787
98,BUMA.1121.00076,1,1002398,1028198,-,25800
98,BUMA.1121.00106,1,120489,146258,+,25769
98,BUMA.1121.00001,1,3764370,3790161,-,25791
98,BUMA.1121.00107,1,182339,208171,+,25832
98,BUMA.1121.00104,1,916663,942458,-,25795
98,BUMA.1121.00099,1,2053742,2079513,-,25771
98,BUMA.1121.00098,1,3061523,3087267,+,25744
98,BUMA.1121.00111,1,476407,502210,+,25803
98,BUMA.1121.00109,1,1508723,1534534,-,25811
98,BUMA.1121.00097,1,3663684,3689443,-,25759
98,BUMA.1121.00094,1,338608,364426,+,25818
98,BUMA.1121.00095,1,1314434,1340246,-,25812
98,BUMA.1121.00005,1,3208559,3234356,-,25797
98,BUMA.1121.00101,1,2110527,2136380,-,25853
98,BUMA.1121.00065,1,369033,394910,+,25877
98,BUMA.1121.00100,1,946440,972172,-,25732
98,BUMA.1121.00105,1,853751,879514,-,25763
98,BUMA.1121.00029,1,550078,575859,-,25781
98,BUMA.1121.00066,1,336605,362302,+,25697
98,BUMA.1121.00031,1,1681327,1707085,+,25758
98,BUMA.1121.00108,1,1322812,1348545,+,25733
98,BUMA.1121.00023,1,2669674,2695445,+,25771
98,BUMA.1121.00035,1,1394863,1420661,+,25798
98,BUMA.1121.00041,1,1603633,1629386,+,25753
99,BUMA.1121.00057,1,1460570,1475809,+,15239
99,BUMA.1121.00058,1,176750,192037,-,15287
99,BUMA.1121.00045,1,3723191,3738421,-,15230
99,BUMA.1121.00051,1,366581,381829,+,15248
99,BUMA.1121.00068,1,3232073,3247327,+,15254
99,BUMA.1121.00061,1,393983,409223,+,15240
99,BUMA.1121.00060,1,1948858,1964088,-,15230
99,BUMA.1121.00064,1,407262,422582,+,15320
99,BUMA.1121.00016,1,2467997,2483235,+,15238
99,BUMA.1121.00003,1,2860223,2875492,+,15269
99,BUMA.1121.00055,1,4040740,4055996,+,15256
99,BUMA.1121.00011,1,1248016,1263271,-,15255
99,BUMA.1121.00037,1,3007532,3022779,+,15247
99,BUMA.1121.00009,1,1197724,1212979,-,15255
99,BUMA.1121.00069,1,355405,370642,+,15237
99,BUMA.1121.00088,1,1256208,1271487,+,15279
99,BUMA.1121.00092,1,3484575,3499887,-,15312
99,BUMA.1121.00074,1,3504141,3518938,-,14797
99,BUMA.1121.00070,1,365743,380974,+,15231
99,BUMA.1121.00093,1,1126548,1141860,+,15312
99,BUMA.1121.00063,1,391029,406269,+,15240
99,BUMA.1121.00033,1,2622852,2638079,+,15227
99,BUMA.1121.00018,1,868017,883249,+,15232
99,BUMA.1121.00080,1,410797,425578,+,14781
99,BUMA.1121.00027,1,2560945,2576183,+,15238
99,BUMA.1121.00053,1,83747,98977,+,15230
99,BUMA.1121.00059,1,3615115,3630394,+,15279
99,BUMA.1121.00043,1,357415,372613,+,15198
99,BUMA.1121.00056,1,3529403,3544651,-,15248
99,BUMA.1121.00112,1,2705877,2721096,-,15219
99,BUMA.1121.00091,1,135772,151036,-,15264
99,BUMA.1121.00047,1,2599186,2614434,-,15248
99,BUMA.1121.00067,1,1,15253,-,15252
99,BUMA.1121.00110,1,408791,424118,-,15327
99,BUMA.1121.00073,1,392063,407302,+,15239
99,BUMA.1121.00072,1,365994,381232,+,15238
99,BUMA.1121.00077,1,3059295,3074621,+,15326
99,BUMA.1121.00082,1,400736,415976,+,15240
99,BUMA.1121.00062,1,201570,216841,-,15271
99,BUMA.1121.00007,1,3744796,3760059,-,15263
99,BUMA.1121.00025,1,2376597,2391829,-,15232
99,BUMA.1121.00021,1,1001411,1016657,+,15246
99,BUMA.1121.00103,1,4044677,4059482,-,14805
99,BUMA.1121.00096,1,2881269,2896532,-,15263
99,BUMA.1121.00079,1,404477,419725,+,15248
99,BUMA.1121.00039,1,477150,492396,+,15246
99,BUMA.1121.00083,1,1288859,1304099,-,15240
99,BUMA.1121.00084,1,592164,607440,+,15276
99,BUMA.1121.00049,1,1475980,1491268,-,15288
99,BUMA.1121.00089,1,380772,396020,+,15248
99,BUMA.1121.00014,1,2516619,2531865,-,15246
99,BUMA.1121.00090,1,2468323,2483569,+,15246
99,BUMA.1121.00071,1,382283,397515,+,15232
99,BUMA.1121.00078,1,1615572,1630841,-,15269
99,BUMA.1121.00102,1,894443,909712,-,15269
99,BUMA.1121.00075,1,3810301,3825607,+,15306
99,BUMA.1121.00012,1,3124872,3140093,+,15221
99,BUMA.1121.00076,1,986616,1001858,-,15242
99,BUMA.1121.00106,1,146798,162086,+,15288
99,BUMA.1121.00001,1,3748576,3763830,-,15254
99,BUMA.1121.00107,1,208711,223926,+,15215
99,BUMA.1121.00104,1,900827,916123,-,15296
99,BUMA.1121.00099,1,2037926,2053202,-,15276
99,BUMA.1121.00098,1,3087807,3103050,+,15243
99,BUMA.1121.00111,1,502750,517996,+,15246
99,BUMA.1121.00109,1,1492950,1508183,-,15233
99,BUMA.1121.00097,1,3647876,3663144,-,15268
99,BUMA.1121.00094,1,364966,380214,+,15248
99,BUMA.1121.00095,1,1298647,1313894,-,15247
99,BUMA.1121.00005,1,3192756,3208019,-,15263
99,BUMA.1121.00101,1,2094756,2109987,-,15231
99,BUMA.1121.00065,1,395450,410692,+,15242
99,BUMA.1121.00100,1,930634,945900,-,15266
99,BUMA.1121.00105,1,837923,853211,-,15288
99,BUMA.1121.00029,1,534292,549538,-,15246
99,BUMA.1121.00066,1,362842,378075,+,15233
99,BUMA.1121.00031,1,1707625,1722831,+,15206
99,BUMA.1121.00108,1,1349085,1364304,+,15219
99,BUMA.1121.00023,1,2695985,2711240,+,15255
99,BUMA.1121.00035,1,1421201,1436447,+,15246
99,BUMA.1121.00041,1,1629926,1645195,+,15269
100,BUMA.1121.00057,1,1476557,1489726,+,13169
100,BUMA.1121.00058,1,162926,176003,-,13077
100,BUMA.1121.00045,1,3709243,3722444,-,13201
100,BUMA.1121.00051,1,382577,395695,+,13118
100,BUMA.1121.00068,1,3248015,3261183,+,13168
100,BUMA.1121.00061,1,409971,423140,+,13169
100,BUMA.1121.00060,1,1934905,1948111,-,13206
100,BUMA.1121.00064,1,423330,436464,+,13134
100,BUMA.1121.00016,1,2483983,2497058,+,13075
100,BUMA.1121.00003,1,2876240,2889315,+,13075
100,BUMA.1121.00055,1,4056744,4069843,+,13099
100,BUMA.1121.00011,1,1234203,1247269,-,13066
100,BUMA.1121.00037,1,3023527,3036686,+,13159
100,BUMA.1121.00009,1,1183895,1196977,-,13082
100,BUMA.1121.00069,1,371390,384505,+,13115
100,BUMA.1121.00088,1,1272235,1285348,+,13113
100,BUMA.1121.00092,1,3470679,3483828,-,13149
100,BUMA.1121.00074,1,3490293,3503394,-,13101
100,BUMA.1121.00070,1,381722,394890,+,13168
100,BUMA.1121.00093,1,1142608,1155757,+,13149
100,BUMA.1121.00063,1,407017,420153,+,13136
100,BUMA.1121.00033,1,2638827,2651872,+,13045
100,BUMA.1121.00018,1,883997,897071,+,13074
100,BUMA.1121.00080,1,426326,439478,+,13152
100,BUMA.1121.00027,1,2576931,2590087,+,13156
100,BUMA.1121.00053,1,99725,112876,+,13151
100,BUMA.1121.00059,1,3631142,3644269,+,13127
100,BUMA.1121.00043,1,374953,388022,+,13069
100,BUMA.1121.00056,1,3515528,3528656,-,13128
100,BUMA.1121.00112,1,2692002,2705130,-,13128
100,BUMA.1121.00091,1,121922,135025,-,13103
100,BUMA.1121.00047,1,2585246,2598439,-,13193
100,BUMA.1121.00067,1,4014223,4027301,-,13078
100,BUMA.1121.00110,1,394932,408044,-,13112
100,BUMA.1121.00073,1,408050,421219,+,13169
100,BUMA.1121.00072,1,381980,395102,+,13122
100,BUMA.1121.00077,1,3075369,3088481,+,13112
100,BUMA.1121.00082,1,416724,429893,+,13169
100,BUMA.1121.00062,1,187697,200823,-,13126
100,BUMA.1121.00007,1,3730955,3744049,-,13094
100,BUMA.1121.00025,1,2362776,2375850,-,13074
100,BUMA.1121.00021,1,1017405,1030469,+,13064
100,BUMA.1121.00103,1,4030810,4043930,-,13120
100,BUMA.1121.00096,1,2867403,2880522,-,13119
100,BUMA.1121.00079,1,420473,433593,+,13120
100,BUMA.1121.00039,1,493144,506278,+,13134
100,BUMA.1121.00083,1,1274943,1288112,-,13169
100,BUMA.1121.00084,1,608188,621308,+,13120
100,BUMA.1121.00049,1,1462088,1475233,-,13145
100,BUMA.1121.00089,1,396768,409896,+,13128
100,BUMA.1121.00014,1,2502728,2515872,-,13144
100,BUMA.1121.00090,1,2484317,2497406,+,13089
100,BUMA.1121.00071,1,398263,411432,+,13169
100,BUMA.1121.00078,1,1601721,1614825,-,13104
100,BUMA.1121.00102,1,880555,893696,-,13141
100,BUMA.1121.00075,1,3827947,3841033,+,13086
100,BUMA.1121.00012,1,3140841,3153930,+,13089
100,BUMA.1121.00076,1,971180,984277,-,13097
100,BUMA.1121.00106,1,162834,175934,+,13100
100,BUMA.1121.00001,1,3734790,3747829,-,13039
100,BUMA.1121.00107,1,224674,237783,+,13109
100,BUMA.1121.00104,1,886975,900080,-,13105
100,BUMA.1121.00099,1,2024121,2037179,-,13058
100,BUMA.1121.00098,1,3103798,3116892,+,13094
100,BUMA.1121.00111,1,518744,531812,+,13068
100,BUMA.1121.00109,1,1479137,1492203,-,13066
100,BUMA.1121.00097,1,3634078,3647129,-,13051
100,BUMA.1121.00094,1,380962,394114,+,13152
100,BUMA.1121.00095,1,1284787,1297900,-,13113
100,BUMA.1121.00005,1,3178878,3192009,-,13131
100,BUMA.1121.00101,1,2080892,2094009,-,13117
100,BUMA.1121.00065,1,411440,424631,+,13191
100,BUMA.1121.00100,1,916811,929887,-,13076
100,BUMA.1121.00105,1,824020,837176,-,13156
100,BUMA.1121.00029,1,520507,533546,-,13039
100,BUMA.1121.00066,1,378823,391992,+,13169
100,BUMA.1121.00031,1,1723579,1736698,+,13119
100,BUMA.1121.00108,1,1365052,1378136,+,13084
100,BUMA.1121.00023,1,2711988,2725057,+,13069
100,BUMA.1121.00035,1,1437195,1450234,+,13039
100,BUMA.1121.00041,1,1645943,1659089,+,13146
101,BUMA.1121.00057,1,1489754,1498541,+,8787
101,BUMA.1121.00058,1,154109,162899,-,8790
101,BUMA.1121.00045,1,3700422,3709215,-,8793
101,BUMA.1121.00051,1,395723,404505,+,8782
101,BUMA.1121.00068,1,3261223,3270010,+,8787
101,BUMA.1121.00061,1,423168,431950,+,8782
101,BUMA.1121.00060,1,1926084,1934877,-,8793
101,BUMA.1121.00064,1,436504,445291,+,8787
101,BUMA.1121.00016,1,2497090,2505880,+,8790
101,BUMA.1121.00003,1,2889355,2898147,+,8792
101,BUMA.1121.00055,1,4069883,4078650,+,8767
101,BUMA.1121.00011,1,1225385,1234163,-,8778
101,BUMA.1121.00037,1,3036714,3045496,+,8782
101,BUMA.1121.00009,1,1175063,1183855,-,8792
101,BUMA.1121.00069,1,384533,393315,+,8782
101,BUMA.1121.00088,1,1285376,1294163,+,8787
101,BUMA.1121.00092,1,3461851,3470639,-,8788
101,BUMA.1121.00074,1,3481487,3490265,-,8778
101,BUMA.1121.00070,1,394918,403700,+,8782
101,BUMA.1121.00093,1,1155797,1164584,+,8787
101,BUMA.1121.00063,1,420181,428958,+,8777
101,BUMA.1121.00033,1,2651904,2660690,+,8786
101,BUMA.1121.00018,1,897103,905893,+,8790
101,BUMA.1121.00080,1,439506,448288,+,8782
101,BUMA.1121.00027,1,2590115,2598897,+,8782
101,BUMA.1121.00053,1,112904,121686,+,8782
101,BUMA.1121.00059,1,3644297,3653074,+,8777
101,BUMA.1121.00043,1,388050,396832,+,8782
101,BUMA.1121.00056,1,3506717,3515500,-,8783
101,BUMA.1121.00112,1,2683179,2691962,-,8783
101,BUMA.1121.00091,1,113126,121894,-,8768
101,BUMA.1121.00047,1,2576435,2585218,-,8783
101,BUMA.1121.00067,1,4005397,4014195,-,8798
101,BUMA.1121.00110,1,386099,394892,-,8793
101,BUMA.1121.00073,1,421247,430029,+,8782
101,BUMA.1121.00072,1,395130,403912,+,8782
101,BUMA.1121.00077,1,3088521,3097313,+,8792
101,BUMA.1121.00082,1,429921,438703,+,8782
101,BUMA.1121.00062,1,178901,187669,-,8768
101,BUMA.1121.00007,1,3722118,3730915,-,8797
101,BUMA.1121.00025,1,2353953,2362744,-,8791
101,BUMA.1121.00021,1,1030497,1039279,+,8782
101,BUMA.1121.00103,1,4021981,4030770,-,8789
101,BUMA.1121.00096,1,2858602,2867375,-,8773
101,BUMA.1121.00079,1,433621,442403,+,8782
101,BUMA.1121.00039,1,506306,515088,+,8782
101,BUMA.1121.00083,1,1266132,1274915,-,8783
101,BUMA.1121.00084,1,621335,630109,+,8774
101,BUMA.1121.00049,1,1453272,1462060,-,8788
101,BUMA.1121.00089,1,409924,418706,+,8782
101,BUMA.1121.00014,1,2471894,2480685,-,8791
101,BUMA.1121.00090,1,2497434,2506216,+,8782
101,BUMA.1121.00071,1,411460,420242,+,8782
101,BUMA.1121.00078,1,1592893,1601688,-,8795
101,BUMA.1121.00102,1,871757,880527,-,8770
101,BUMA.1121.00075,1,3841061,3849841,+,8780
101,BUMA.1121.00012,1,3174958,3183740,+,8782
101,BUMA.1121.00076,1,962369,971152,-,8783
101,BUMA.1121.00106,1,175962,184729,+,8767
101,BUMA.1121.00001,1,3705359,3714150,-,8791
101,BUMA.1121.00107,1,237823,246665,+,8842
101,BUMA.1121.00104,1,878179,886947,-,8768
101,BUMA.1121.00099,1,2015302,2024080,-,8778
101,BUMA.1121.00098,1,3116920,3125694,+,8774
101,BUMA.1121.00111,1,531840,540622,+,8782
101,BUMA.1121.00109,1,1470298,1479096,-,8798
101,BUMA.1121.00097,1,3625246,3633992,-,8746
101,BUMA.1121.00094,1,394142,402924,+,8782
101,BUMA.1121.00095,1,1275965,1284701,-,8736
101,BUMA.1121.00005,1,3170070,3178838,-,8768
101,BUMA.1121.00101,1,2072062,2080851,-,8789
101,BUMA.1121.00065,1,424659,433440,+,8781
101,BUMA.1121.00100,1,907970,916771,-,8801
101,BUMA.1121.00105,1,815218,823993,-,8775
101,BUMA.1121.00029,1,491075,499866,-,8791
101,BUMA.1121.00066,1,392020,400802,+,8782
101,BUMA.1121.00031,1,1736730,1745520,+,8790
101,BUMA.1121.00108,1,1378164,1386966,+,8802
101,BUMA.1121.00023,1,2747096,2755877,+,8781
101,BUMA.1121.00035,1,1470875,1479665,+,8790
101,BUMA.1121.00041,1,1659117,1667904,+,8787
102,BUMA.1121.00057,1,1500259,1508353,+,8094
102,BUMA.1121.00058,1,144352,152391,-,8039
102,BUMA.1121.00045,1,3690667,3698704,-,8037
102,BUMA.1121.00051,1,406223,414264,+,8041
102,BUMA.1121.00068,1,3271728,3279783,+,8055
102,BUMA.1121.00061,1,433668,441714,+,8046
102,BUMA.1121.00060,1,1916329,1924366,-,8037
102,BUMA.1121.00064,1,447009,455042,+,8033
102,BUMA.1121.00016,1,2507598,2515620,+,8022
102,BUMA.1121.00003,1,2899865,2908002,+,8137
102,BUMA.1121.00055,1,4080368,4088396,+,8028
102,BUMA.1121.00011,1,1215598,1223667,-,8069
102,BUMA.1121.00037,1,3047214,3055258,+,8044
102,BUMA.1121.00009,1,1165233,1173345,-,8112
102,BUMA.1121.00069,1,395033,403079,+,8046
102,BUMA.1121.00088,1,1295881,1303953,+,8072
102,BUMA.1121.00092,1,3452101,3460133,-,8032
102,BUMA.1121.00074,1,3471738,3479769,-,8031
102,BUMA.1121.00070,1,405418,413464,+,8046
102,BUMA.1121.00093,1,1166303,1174336,+,8033
102,BUMA.1121.00063,1,430676,438722,+,8046
102,BUMA.1121.00033,1,2662408,2670442,+,8034
102,BUMA.1121.00018,1,907611,915701,+,8090
102,BUMA.1121.00080,1,450005,458045,+,8040
102,BUMA.1121.00027,1,2600615,2608721,+,8106
102,BUMA.1121.00053,1,123404,131496,+,8092
102,BUMA.1121.00059,1,3654792,3662824,+,8032
102,BUMA.1121.00043,1,398550,406620,+,8070
102,BUMA.1121.00056,1,3496947,3504999,-,8052
102,BUMA.1121.00112,1,2673452,2681461,-,8009
102,BUMA.1121.00091,1,103319,111408,-,8089
102,BUMA.1121.00047,1,2566665,2574717,-,8052
102,BUMA.1121.00067,1,3995639,4003679,-,8040
102,BUMA.1121.00110,1,376330,384381,-,8051
102,BUMA.1121.00073,1,431747,439793,+,8046
102,BUMA.1121.00072,1,405630,413676,+,8046
102,BUMA.1121.00077,1,3099032,3107084,+,8052
102,BUMA.1121.00082,1,440421,448467,+,8046
102,BUMA.1121.00062,1,169149,177183,-,8034
102,BUMA.1121.00007,1,3712316,3720400,-,8084
102,BUMA.1121.00025,1,2344145,2352235,-,8090
102,BUMA.1121.00021,1,1040997,1049066,+,8069
102,BUMA.1121.00103,1,4012255,4020263,-,8008
102,BUMA.1121.00096,1,2848864,2856884,-,8020
102,BUMA.1121.00079,1,444121,452160,+,8039
102,BUMA.1121.00039,1,516806,524898,+,8092
102,BUMA.1121.00083,1,1256369,1264414,-,8045
102,BUMA.1121.00084,1,631827,639874,+,8047
102,BUMA.1121.00049,1,1443440,1451554,-,8114
102,BUMA.1121.00089,1,420424,428477,+,8053
102,BUMA.1121.00014,1,2462082,2470176,-,8094
102,BUMA.1121.00090,1,2507934,2516026,+,8092
102,BUMA.1121.00071,1,421960,430006,+,8046
102,BUMA.1121.00078,1,1583107,1591175,-,8068
102,BUMA.1121.00102,1,861995,870039,-,8044
102,BUMA.1121.00075,1,3851559,3859640,+,8081
102,BUMA.1121.00012,1,3185458,3193492,+,8034
102,BUMA.1121.00076,1,952570,960651,-,8081
102,BUMA.1121.00106,1,186447,194531,+,8084
102,BUMA.1121.00001,1,3695572,3703641,-,8069
102,BUMA.1121.00107,1,248383,256414,+,8031
102,BUMA.1121.00104,1,868378,876461,-,8083
102,BUMA.1121.00099,1,2005459,2013583,-,8124
102,BUMA.1121.00098,1,3127412,3135457,+,8045
102,BUMA.1121.00111,1,542340,550408,+,8068
102,BUMA.1121.00109,1,1460524,1468580,-,8056
102,BUMA.1121.00097,1,3615436,3623528,-,8092
102,BUMA.1121.00094,1,404642,412683,+,8041
102,BUMA.1121.00095,1,1266218,1274247,-,8029
102,BUMA.1121.00005,1,3160332,3168353,-,8021
102,BUMA.1121.00101,1,2062300,2070344,-,8044
102,BUMA.1121.00065,1,435158,443180,+,8022
102,BUMA.1121.00100,1,898249,906252,-,8003
102,BUMA.1121.00105,1,805473,813500,-,8027
102,BUMA.1121.00029,1,481264,489357,-,8093
102,BUMA.1121.00066,1,402520,410566,+,8046
102,BUMA.1121.00031,1,1747238,1755282,+,8044
102,BUMA.1121.00108,1,1388684,1396732,+,8048
102,BUMA.1121.00023,1,2757595,2765699,+,8104
102,BUMA.1121.00035,1,1481383,1489455,+,8072
102,BUMA.1121.00041,1,1669622,1677638,+,8016
103,BUMA.1121.00057,1,1508442,1518309,+,9867
103,BUMA.1121.00058,1,134395,144254,-,9859
103,BUMA.1121.00045,1,3680671,3690578,-,9907
103,BUMA.1121.00051,1,414350,424149,+,9799
103,BUMA.1121.00068,1,3279869,3289778,+,9909
103,BUMA.1121.00061,1,441800,451525,+,9725
103,BUMA.1121.00060,1,1906333,1916240,-,9907
103,BUMA.1121.00064,1,455131,464915,+,9784
103,BUMA.1121.00016,1,2515706,2525526,+,9820
103,BUMA.1121.00003,1,2908091,2917934,+,9843
103,BUMA.1121.00055,1,4088485,4098323,+,9838
103,BUMA.1121.00011,1,1205761,1215509,-,9748
103,BUMA.1121.00037,1,3055344,3065291,+,9947
103,BUMA.1121.00009,1,1155364,1165144,-,9780
103,BUMA.1121.00069,1,403168,412801,+,9633
103,BUMA.1121.00088,1,1304054,1313881,+,9827
103,BUMA.1121.00092,1,3442195,3452012,-,9817
103,BUMA.1121.00074,1,3461732,3471649,-,9917
103,BUMA.1121.00070,1,413550,423100,+,9550
103,BUMA.1121.00093,1,1174425,1184231,+,9806
103,BUMA.1121.00063,1,438808,448529,+,9721
103,BUMA.1121.00033,1,2670528,2680285,+,9757
103,BUMA.1121.00018,1,915787,925685,+,9898
103,BUMA.1121.00080,1,458131,468001,+,9870
103,BUMA.1121.00027,1,2608810,2618699,+,9889
103,BUMA.1121.00053,1,131597,141505,+,9908
103,BUMA.1121.00059,1,3662937,3672802,+,9865
103,BUMA.1121.00043,1,408299,418071,+,9772
103,BUMA.1121.00056,1,3486998,3496861,-,9863
103,BUMA.1121.00112,1,2663693,2673366,-,9673
103,BUMA.1121.00091,1,91871,101628,-,9757
103,BUMA.1121.00047,1,2556756,2566579,-,9823
103,BUMA.1121.00067,1,3985690,3995553,-,9863
103,BUMA.1121.00110,1,366404,376244,-,9840
103,BUMA.1121.00073,1,439879,449589,+,9710
103,BUMA.1121.00072,1,413765,423499,+,9734
103,BUMA.1121.00077,1,3107170,3117010,+,9840
103,BUMA.1121.00082,1,448556,458367,+,9811
103,BUMA.1121.00062,1,159156,169051,-,9895
103,BUMA.1121.00007,1,3702348,3712227,-,9879
103,BUMA.1121.00025,1,2334192,2344059,-,9867
103,BUMA.1121.00021,1,1049155,1059020,+,9865
103,BUMA.1121.00103,1,4002339,4012157,-,9818
103,BUMA.1121.00096,1,2838908,2848778,-,9870
103,BUMA.1121.00079,1,452246,462120,+,9874
103,BUMA.1121.00039,1,524984,534923,+,9939
103,BUMA.1121.00083,1,1246461,1256280,-,9819
103,BUMA.1121.00084,1,639963,649753,+,9790
103,BUMA.1121.00049,1,1433478,1443354,-,9876
103,BUMA.1121.00089,1,428563,438426,+,9863
103,BUMA.1121.00014,1,2452193,2461996,-,9803
103,BUMA.1121.00090,1,2516112,2525923,+,9811
103,BUMA.1121.00071,1,430092,439783,+,9691
103,BUMA.1121.00078,1,1573157,1582997,-,9840
103,BUMA.1121.00102,1,851906,861897,-,9991
103,BUMA.1121.00075,1,3859729,3869617,+,9888
103,BUMA.1121.00012,1,3193578,3203357,+,9779
103,BUMA.1121.00076,1,942590,952481,-,9891
103,BUMA.1121.00106,1,194620,204478,+,9858
103,BUMA.1121.00001,1,3685635,3695486,-,9851
103,BUMA.1121.00107,1,256512,266194,+,9682
103,BUMA.1121.00104,1,858430,868289,-,9859
103,BUMA.1121.00099,1,1995552,2005373,-,9821
103,BUMA.1121.00098,1,3135543,3145278,+,9735
103,BUMA.1121.00111,1,550494,560313,+,9819
103,BUMA.1121.00109,1,1450678,1460438,-,9760
103,BUMA.1121.00097,1,3605592,3615326,-,9734
103,BUMA.1121.00094,1,412769,422630,+,9861
103,BUMA.1121.00095,1,1256312,1266120,-,9808
103,BUMA.1121.00005,1,3150565,3160234,-,9669
103,BUMA.1121.00101,1,2052450,2062211,-,9761
103,BUMA.1121.00065,1,443266,453121,+,9855
103,BUMA.1121.00100,1,888272,898163,-,9891
103,BUMA.1121.00105,1,794268,805375,-,11107
103,BUMA.1121.00029,1,471311,481178,-,9867
103,BUMA.1121.00066,1,410649,420371,+,9722
103,BUMA.1121.00031,1,1755368,1765315,+,9947
103,BUMA.1121.00108,1,1396821,1406484,+,9663
103,BUMA.1121.00023,1,2765785,2775747,+,9962
103,BUMA.1121.00035,1,1489541,1499440,+,9899
103,BUMA.1121.00041,1,1677727,1687755,+,10028
104,BUMA.1121.00057,1,1518310,1531632,+,13322
104,BUMA.1121.00058,1,121068,134393,-,13325
104,BUMA.1121.00045,1,3667375,3680669,-,13294
104,BUMA.1121.00051,1,424150,437509,+,13359
104,BUMA.1121.00068,1,3289779,3303225,+,13446
104,BUMA.1121.00061,1,451526,464808,+,13282
104,BUMA.1121.00060,1,1893045,1906331,-,13286
104,BUMA.1121.00064,1,464916,478129,+,13213
104,BUMA.1121.00016,1,2525527,2538678,+,13151
104,BUMA.1121.00003,1,2917935,2931200,+,13265
104,BUMA.1121.00055,1,29,12590,+,12561
104,BUMA.1121.00011,1,1192511,1205759,-,13248
104,BUMA.1121.00037,1,3065292,3078493,+,13201
104,BUMA.1121.00009,1,1142156,1155362,-,13206
104,BUMA.1121.00069,1,412802,426031,+,13229
104,BUMA.1121.00088,1,1313882,1326934,+,13052
104,BUMA.1121.00092,1,3428928,3442193,-,13265
104,BUMA.1121.00074,1,3448559,3461730,-,13171
104,BUMA.1121.00070,1,423101,436380,+,13279
104,BUMA.1121.00093,1,1184232,1197497,+,13265
104,BUMA.1121.00063,1,448530,461830,+,13300
104,BUMA.1121.00033,1,2680286,2693437,+,13151
104,BUMA.1121.00018,1,925686,938829,+,13143
104,BUMA.1121.00080,1,468002,481337,+,13335
104,BUMA.1121.00027,1,2618700,2632024,+,13324
104,BUMA.1121.00053,1,141506,154693,+,13187
104,BUMA.1121.00059,1,3672803,3686140,+,13337
104,BUMA.1121.00043,1,418072,431207,+,13135
104,BUMA.1121.00056,1,3473709,3486996,-,13287
104,BUMA.1121.00112,1,2650539,2663691,-,13152
104,BUMA.1121.00091,1,78570,91869,-,13299
104,BUMA.1121.00047,1,2543435,2556754,-,13319
104,BUMA.1121.00067,1,3972537,3985688,-,13151
104,BUMA.1121.00110,1,353103,366402,-,13299
104,BUMA.1121.00073,1,449590,462871,+,13281
104,BUMA.1121.00072,1,423500,436744,+,13244
104,BUMA.1121.00077,1,3117011,3130309,+,13298
104,BUMA.1121.00082,1,458368,471668,+,13300
104,BUMA.1121.00062,1,145837,159154,-,13317
104,BUMA.1121.00007,1,3689146,3702346,-,13200
104,BUMA.1121.00025,1,2321047,2334190,-,13143
104,BUMA.1121.00021,1,1059021,1072197,+,13176
104,BUMA.1121.00103,1,3989081,4002337,-,13256
104,BUMA.1121.00096,1,2825685,2838906,-,13221
104,BUMA.1121.00079,1,462121,475447,+,13326
104,BUMA.1121.00039,1,534924,548098,+,13174
104,BUMA.1121.00083,1,1233159,1246459,-,13300
104,BUMA.1121.00084,1,649754,663053,+,13299
104,BUMA.1121.00049,1,1420225,1433476,-,13251
104,BUMA.1121.00089,1,438427,451714,+,13287
104,BUMA.1121.00014,1,2438989,2452191,-,13202
104,BUMA.1121.00090,1,2525924,2539066,+,13142
104,BUMA.1121.00071,1,439784,453064,+,13280
104,BUMA.1121.00078,1,1559832,1573155,-,13323
104,BUMA.1121.00102,1,838705,851904,-,13199
104,BUMA.1121.00075,1,3869618,3882853,+,13235
104,BUMA.1121.00012,1,3203358,3216568,+,13210
104,BUMA.1121.00076,1,929353,942588,-,13235
104,BUMA.1121.00106,1,204479,217696,+,13217
104,BUMA.1121.00001,1,3672475,3685633,-,13158
104,BUMA.1121.00107,1,266195,279408,+,13213
104,BUMA.1121.00104,1,845213,858428,-,13215
104,BUMA.1121.00099,1,1982335,1995550,-,13215
104,BUMA.1121.00098,1,3145279,3158447,+,13168
104,BUMA.1121.00111,1,560314,573457,+,13143
104,BUMA.1121.00109,1,1437427,1450676,-,13249
104,BUMA.1121.00097,1,3592454,3605590,-,13136
104,BUMA.1121.00094,1,422631,435936,+,13305
104,BUMA.1121.00095,1,1243056,1256310,-,13254
104,BUMA.1121.00005,1,3137272,3150563,-,13291
104,BUMA.1121.00101,1,2039299,2052448,-,13149
104,BUMA.1121.00065,1,453122,466309,+,13187
104,BUMA.1121.00100,1,875060,888270,-,13210
104,BUMA.1121.00105,1,780467,794266,-,13799
104,BUMA.1121.00029,1,458166,471309,-,13143
104,BUMA.1121.00066,1,420372,433672,+,13300
104,BUMA.1121.00031,1,1765316,1778504,+,13188
104,BUMA.1121.00108,1,1406485,1419667,+,13182
104,BUMA.1121.00023,1,2775748,2788891,+,13143
104,BUMA.1121.00035,1,1499441,1512584,+,13143
104,BUMA.1121.00041,1,1687756,1701066,+,13310
105,BUMA.1121.00057,1,1532530,1553435,+,20905
105,BUMA.1121.00058,1,99209,120171,-,20962
105,BUMA.1121.00045,1,3645669,3666478,-,20809
105,BUMA.1121.00051,1,446977,467843,+,20866
105,BUMA.1121.00068,1,3304123,3325052,+,20929
105,BUMA.1121.00061,1,465706,486586,+,20880
105,BUMA.1121.00060,1,1871339,1892148,-,20809
105,BUMA.1121.00064,1,479027,499939,+,20912
105,BUMA.1121.00016,1,2539576,2560418,+,20842
105,BUMA.1121.00003,1,2932098,2952830,+,20732
105,BUMA.1121.00055,1,13488,34436,+,20948
105,BUMA.1121.00011,1,1170709,1191614,-,20905
105,BUMA.1121.00037,1,3079391,3100234,+,20843
105,BUMA.1121.00009,1,1120268,1141259,-,20991
105,BUMA.1121.00069,1,426929,447840,+,20911
105,BUMA.1121.00088,1,1327832,1348624,+,20792
105,BUMA.1121.00092,1,3407123,3428031,-,20908
105,BUMA.1121.00074,1,3426754,3447662,-,20908
105,BUMA.1121.00070,1,437278,458120,+,20842
105,BUMA.1121.00093,1,1198395,1219303,+,20908
105,BUMA.1121.00063,1,462728,483639,+,20911
105,BUMA.1121.00033,1,2694335,2715165,+,20830
105,BUMA.1121.00018,1,939727,960547,+,20820
105,BUMA.1121.00080,1,482235,503173,+,20938
105,BUMA.1121.00027,1,2632922,2653833,+,20911
105,BUMA.1121.00053,1,155591,176406,+,20815
105,BUMA.1121.00059,1,3687038,3707897,+,20859
105,BUMA.1121.00043,1,432105,452948,+,20843
105,BUMA.1121.00056,1,3451874,3472812,-,20938
105,BUMA.1121.00112,1,2628766,2649642,-,20876
105,BUMA.1121.00091,1,56784,77673,-,20889
105,BUMA.1121.00047,1,2521600,2542538,-,20938
105,BUMA.1121.00067,1,3950748,3971640,-,20892
105,BUMA.1121.00110,1,331266,352206,-,20940
105,BUMA.1121.00073,1,463769,484680,+,20911
105,BUMA.1121.00072,1,437642,458527,+,20885
105,BUMA.1121.00077,1,3131207,3152147,+,20940
105,BUMA.1121.00082,1,472566,493477,+,20911
105,BUMA.1121.00062,1,124048,144940,-,20892
105,BUMA.1121.00007,1,3667355,3688249,-,20894
105,BUMA.1121.00025,1,2299324,2320150,-,20826
105,BUMA.1121.00021,1,1073095,1093962,+,20867
105,BUMA.1121.00103,1,3967257,3988184,-,20927
105,BUMA.1121.00096,1,2803948,2824788,-,20840
105,BUMA.1121.00079,1,476345,497230,+,20885
105,BUMA.1121.00039,1,548996,569878,+,20882
105,BUMA.1121.00083,1,1211351,1232262,-,20911
105,BUMA.1121.00084,1,663951,684840,+,20889
105,BUMA.1121.00049,1,1398420,1419328,-,20908
105,BUMA.1121.00089,1,452612,473550,+,20938
105,BUMA.1121.00014,1,2417267,2438092,-,20825
105,BUMA.1121.00090,1,2539964,2560813,+,20849
105,BUMA.1121.00071,1,453962,474873,+,20911
105,BUMA.1121.00078,1,1538051,1558935,-,20884
105,BUMA.1121.00102,1,793355,814244,-,20889
105,BUMA.1121.00075,1,3883751,3904623,+,20872
105,BUMA.1121.00012,1,3217466,3238299,+,20833
105,BUMA.1121.00076,1,907606,928456,-,20850
105,BUMA.1121.00106,1,218594,239437,+,20843
105,BUMA.1121.00001,1,3644179,3664986,-,20807
105,BUMA.1121.00107,1,280306,301123,+,20817
105,BUMA.1121.00104,1,823377,844316,-,20939
105,BUMA.1121.00099,1,1959270,1981438,-,22168
105,BUMA.1121.00098,1,3159345,3180170,+,20825
105,BUMA.1121.00111,1,574355,595198,+,20843
105,BUMA.1121.00109,1,1415611,1436530,-,20919
105,BUMA.1121.00097,1,3570736,3591557,-,20821
105,BUMA.1121.00094,1,436834,457748,+,20914
105,BUMA.1121.00095,1,1221264,1242159,-,20895
105,BUMA.1121.00005,1,3115463,3136375,-,20912
105,BUMA.1121.00101,1,2017428,2038402,-,20974
105,BUMA.1121.00065,1,467207,488080,+,20873
105,BUMA.1121.00100,1,853330,874163,-,20833
105,BUMA.1121.00105,1,758688,779570,-,20882
105,BUMA.1121.00029,1,436408,457269,-,20861
105,BUMA.1121.00066,1,434570,455457,+,20887
105,BUMA.1121.00031,1,1779402,1800233,+,20831
105,BUMA.1121.00108,1,1420565,1441468,+,20903
105,BUMA.1121.00023,1,2789789,2810571,+,20782
105,BUMA.1121.00035,1,1513482,1534289,+,20807
105,BUMA.1121.00041,1,1701964,1722824,+,20860
106,BUMA.1121.00057,1,1554366,1564372,+,10006
106,BUMA.1121.00058,1,88272,98277,-,10005
106,BUMA.1121.00045,1,3634732,3644737,-,10005
106,BUMA.1121.00051,1,468774,478780,+,10006
106,BUMA.1121.00068,1,3325983,3335989,+,10006
106,BUMA.1121.00061,1,487517,497523,+,10006
106,BUMA.1121.00060,1,1860402,1870407,-,10005
106,BUMA.1121.00064,1,500870,510877,+,10007
106,BUMA.1121.00016,1,2561349,2571354,+,10005
106,BUMA.1121.00003,1,2953761,2963766,+,10005
106,BUMA.1121.00055,1,35367,45374,+,10007
106,BUMA.1121.00011,1,1159773,1169777,-,10004
106,BUMA.1121.00037,1,3101165,3111170,+,10005
106,BUMA.1121.00009,1,1109330,1119336,-,10006
106,BUMA.1121.00069,1,448771,458777,+,10006
106,BUMA.1121.00088,1,1349555,1359561,+,10006
106,BUMA.1121.00092,1,3396185,3406191,-,10006
106,BUMA.1121.00074,1,3415816,3425822,-,10006
106,BUMA.1121.00070,1,459051,469057,+,10006
106,BUMA.1121.00093,1,1220234,1230241,+,10007
106,BUMA.1121.00063,1,484570,494576,+,10006
106,BUMA.1121.00033,1,2716096,2726101,+,10005
106,BUMA.1121.00018,1,961478,971483,+,10005
106,BUMA.1121.00080,1,504104,514111,+,10007
106,BUMA.1121.00027,1,2654764,2664770,+,10006
106,BUMA.1121.00053,1,177337,187343,+,10006
106,BUMA.1121.00059,1,3708828,3718846,+,10018
106,BUMA.1121.00043,1,453879,463884,+,10005
106,BUMA.1121.00056,1,3440936,3450942,-,10006
106,BUMA.1121.00112,1,2617829,2627834,-,10005
106,BUMA.1121.00091,1,45847,55852,-,10005
106,BUMA.1121.00047,1,2510662,2520668,-,10006
106,BUMA.1121.00067,1,3939810,3949816,-,10006
106,BUMA.1121.00110,1,320329,330334,-,10005
106,BUMA.1121.00073,1,485611,495617,+,10006
106,BUMA.1121.00072,1,459458,469464,+,10006
106,BUMA.1121.00077,1,3153078,3163084,+,10006
106,BUMA.1121.00082,1,494408,504414,+,10006
106,BUMA.1121.00062,1,113111,123116,-,10005
106,BUMA.1121.00007,1,3656419,3666423,-,10004
106,BUMA.1121.00025,1,2288388,2298392,-,10004
106,BUMA.1121.00021,1,1094893,1104889,+,9996
106,BUMA.1121.00103,1,3956331,3966325,-,9994
106,BUMA.1121.00096,1,2793011,2803016,-,10005
106,BUMA.1121.00079,1,498161,508168,+,10007
106,BUMA.1121.00039,1,570809,580814,+,10005
106,BUMA.1121.00083,1,1200414,1210419,-,10005
106,BUMA.1121.00084,1,685771,695777,+,10006
106,BUMA.1121.00049,1,1387471,1397488,-,10017
106,BUMA.1121.00089,1,474481,484488,+,10007
106,BUMA.1121.00014,1,2406331,2416335,-,10004
106,BUMA.1121.00090,1,2561744,2571750,+,10006
106,BUMA.1121.00071,1,475804,485810,+,10006
106,BUMA.1121.00078,1,1527124,1537119,-,9995
106,BUMA.1121.00102,1,782503,792423,-,9920
106,BUMA.1121.00075,1,3905554,3915538,+,9984
106,BUMA.1121.00012,1,3239230,3249235,+,10005
106,BUMA.1121.00076,1,896691,906674,-,9983
106,BUMA.1121.00106,1,240368,250386,+,10018
106,BUMA.1121.00001,1,3633243,3643247,-,10004
106,BUMA.1121.00107,1,302054,312060,+,10006
106,BUMA.1121.00104,1,812440,822445,-,10005
106,BUMA.1121.00099,1,1948333,1958338,-,10005
106,BUMA.1121.00098,1,3181101,3191106,+,10005
106,BUMA.1121.00111,1,596129,606134,+,10005
106,BUMA.1121.00109,1,1404674,1414679,-,10005
106,BUMA.1121.00097,1,3559799,3569804,-,10005
106,BUMA.1121.00094,1,458679,468686,+,10007
106,BUMA.1121.00095,1,1210327,1220332,-,10005
106,BUMA.1121.00005,1,3104527,3114532,-,10005
106,BUMA.1121.00101,1,2006490,2016496,-,10006
106,BUMA.1121.00065,1,489011,498994,+,9983
106,BUMA.1121.00100,1,842393,852398,-,10005
106,BUMA.1121.00105,1,747751,757756,-,10005
106,BUMA.1121.00029,1,425472,435476,-,10004
106,BUMA.1121.00066,1,456388,466394,+,10006
106,BUMA.1121.00031,1,1801164,1811169,+,10005
106,BUMA.1121.00108,1,1442399,1452404,+,10005
106,BUMA.1121.00023,1,2811502,2821507,+,10005
106,BUMA.1121.00035,1,1535220,1545225,+,10005
106,BUMA.1121.00041,1,1723755,1733761,+,10006
107,BUMA.1121.00057,1,1564373,1571031,+,6658
107,BUMA.1121.00058,1,81612,88270,-,6658
107,BUMA.1121.00045,1,3628062,3634730,-,6668
107,BUMA.1121.00051,1,478781,485449,+,6668
107,BUMA.1121.00068,1,3335990,3342658,+,6668
107,BUMA.1121.00061,1,497524,504182,+,6658
107,BUMA.1121.00060,1,1853732,1860400,-,6668
107,BUMA.1121.00064,1,510878,517546,+,6668
107,BUMA.1121.00016,1,2571355,2578042,+,6687
107,BUMA.1121.00003,1,2963767,2970435,+,6668
107,BUMA.1121.00055,1,45375,52043,+,6668
107,BUMA.1121.00011,1,1153103,1159771,-,6668
107,BUMA.1121.00037,1,3111171,3117849,+,6678
107,BUMA.1121.00009,1,1102660,1109328,-,6668
107,BUMA.1121.00069,1,458778,465436,+,6658
107,BUMA.1121.00088,1,1359562,1366200,+,6638
107,BUMA.1121.00092,1,3389515,3396183,-,6668
107,BUMA.1121.00074,1,3409146,3415814,-,6668
107,BUMA.1121.00070,1,469058,475716,+,6658
107,BUMA.1121.00093,1,1230242,1236910,+,6668
107,BUMA.1121.00063,1,494577,501235,+,6658
107,BUMA.1121.00033,1,2726102,2732779,+,6677
107,BUMA.1121.00018,1,971484,978130,+,6646
107,BUMA.1121.00080,1,514112,520780,+,6668
107,BUMA.1121.00027,1,2664771,2671427,+,6656
107,BUMA.1121.00053,1,187344,194002,+,6658
107,BUMA.1121.00059,1,3718847,3725505,+,6658
107,BUMA.1121.00043,1,463885,470573,+,6688
107,BUMA.1121.00056,1,3434266,3440934,-,6668
107,BUMA.1121.00112,1,2611147,2617827,-,6680
107,BUMA.1121.00091,1,39147,45845,-,6698
107,BUMA.1121.00047,1,2504002,2510660,-,6658
107,BUMA.1121.00067,1,3933140,3939808,-,6668
107,BUMA.1121.00110,1,313652,320327,-,6675
107,BUMA.1121.00073,1,495618,502276,+,6658
107,BUMA.1121.00072,1,469465,476123,+,6658
107,BUMA.1121.00077,1,3163085,3169760,+,6675
107,BUMA.1121.00082,1,504415,511073,+,6658
107,BUMA.1121.00062,1,106441,113109,-,6668
107,BUMA.1121.00007,1,3649749,3656417,-,6668
107,BUMA.1121.00025,1,2281740,2288386,-,6646
107,BUMA.1121.00021,1,1106480,1113163,+,6683
107,BUMA.1121.00103,1,3948078,3954740,-,6662
107,BUMA.1121.00096,1,2786351,2793009,-,6658
107,BUMA.1121.00079,1,508169,514835,+,6666
107,BUMA.1121.00039,1,580815,587493,+,6678
107,BUMA.1121.00083,1,1193754,1200412,-,6658
107,BUMA.1121.00084,1,695778,702446,+,6668
107,BUMA.1121.00049,1,1380791,1387469,-,6678
107,BUMA.1121.00089,1,484489,491157,+,6668
107,BUMA.1121.00014,1,2399651,2406329,-,6678
107,BUMA.1121.00090,1,2571751,2578397,+,6646
107,BUMA.1121.00071,1,485811,492469,+,6658
107,BUMA.1121.00078,1,1520480,1527122,-,6642
107,BUMA.1121.00102,1,775828,782501,-,6673
107,BUMA.1121.00075,1,3917141,3923822,+,6681
107,BUMA.1121.00012,1,3249236,3255912,+,6676
107,BUMA.1121.00076,1,888403,895087,-,6684
107,BUMA.1121.00106,1,250387,257055,+,6668
107,BUMA.1121.00001,1,3626543,3633241,-,6698
107,BUMA.1121.00107,1,312061,318739,+,6678
107,BUMA.1121.00104,1,805770,812438,-,6668
107,BUMA.1121.00099,1,1941663,1948331,-,6668
107,BUMA.1121.00098,1,3191107,3197763,+,6656
107,BUMA.1121.00111,1,606135,612781,+,6646
107,BUMA.1121.00109,1,1398004,1404672,-,6668
107,BUMA.1121.00097,1,3553218,3559797,-,6579
107,BUMA.1121.00094,1,468687,475190,+,6503
107,BUMA.1121.00095,1,1203669,1210325,-,6656
107,BUMA.1121.00005,1,3097837,3104525,-,6688
107,BUMA.1121.00101,1,1999788,2006488,-,6700
107,BUMA.1121.00065,1,500598,507281,+,6683
107,BUMA.1121.00100,1,835718,842391,-,6673
107,BUMA.1121.00105,1,741081,747749,-,6668
107,BUMA.1121.00029,1,418782,425470,-,6688
107,BUMA.1121.00066,1,466395,473053,+,6658
107,BUMA.1121.00031,1,1811170,1817848,+,6678
107,BUMA.1121.00108,1,1452405,1459073,+,6668
107,BUMA.1121.00023,1,2821508,2828196,+,6688
107,BUMA.1121.00035,1,1545226,1551914,+,6688
107,BUMA.1121.00041,1,1733762,1740440,+,6678
108,BUMA.1121.00057,1,1571033,1579468,+,8435
108,BUMA.1121.00058,1,73211,81611,-,8400
108,BUMA.1121.00045,1,3619643,3628061,-,8418
108,BUMA.1121.00051,1,485451,493983,+,8532
108,BUMA.1121.00068,1,3342660,3351167,+,8507
108,BUMA.1121.00061,1,504184,512601,+,8417
108,BUMA.1121.00060,1,1845313,1853731,-,8418
108,BUMA.1121.00064,1,517548,525929,+,8381
108,BUMA.1121.00016,1,2578044,2586452,+,8408
108,BUMA.1121.00003,1,2970437,2978899,+,8462
108,BUMA.1121.00055,1,52045,60507,+,8462
108,BUMA.1121.00011,1,1144684,1153102,-,8418
108,BUMA.1121.00037,1,3117851,3126250,+,8399
108,BUMA.1121.00009,1,1094205,1102659,-,8454
108,BUMA.1121.00069,1,465438,473847,+,8409
108,BUMA.1121.00088,1,1366202,1374601,+,8399
108,BUMA.1121.00092,1,3381096,3389514,-,8418
108,BUMA.1121.00074,1,3400799,3409145,-,8346
108,BUMA.1121.00070,1,475718,484041,+,8323
108,BUMA.1121.00093,1,1236912,1245329,+,8417
108,BUMA.1121.00063,1,501237,509553,+,8316
108,BUMA.1121.00033,1,2732781,2741223,+,8442
108,BUMA.1121.00018,1,978132,986566,+,8434
108,BUMA.1121.00080,1,520782,529339,+,8557
108,BUMA.1121.00027,1,2671429,2679817,+,8388
108,BUMA.1121.00053,1,194004,202457,+,8453
108,BUMA.1121.00059,1,3725507,3733897,+,8390
108,BUMA.1121.00043,1,470575,479028,+,8453
108,BUMA.1121.00056,1,3425784,3434265,-,8481
108,BUMA.1121.00112,1,2602773,2611146,-,8373
108,BUMA.1121.00091,1,30499,39146,-,8647
108,BUMA.1121.00047,1,2495520,2504001,-,8481
108,BUMA.1121.00067,1,3924569,3933139,-,8570
108,BUMA.1121.00110,1,305197,313651,-,8454
108,BUMA.1121.00073,1,502278,510664,+,8386
108,BUMA.1121.00072,1,476125,484469,+,8344
108,BUMA.1121.00077,1,3169762,3178215,+,8453
108,BUMA.1121.00082,1,511075,519492,+,8417
108,BUMA.1121.00062,1,98103,106440,-,8337
108,BUMA.1121.00007,1,3641330,3649748,-,8418
108,BUMA.1121.00025,1,2273303,2281739,-,8436
108,BUMA.1121.00021,1,1113165,1121591,+,8426
108,BUMA.1121.00103,1,3939704,3948077,-,8373
108,BUMA.1121.00096,1,2777941,2786350,-,8409
108,BUMA.1121.00079,1,514837,523375,+,8538
108,BUMA.1121.00039,1,587495,595957,+,8462
108,BUMA.1121.00083,1,1185335,1193753,-,8418
108,BUMA.1121.00084,1,702448,710847,+,8399
108,BUMA.1121.00049,1,1372354,1380790,-,8436
108,BUMA.1121.00089,1,491159,499710,+,8551
108,BUMA.1121.00014,1,2391178,2399650,-,8472
108,BUMA.1121.00090,1,2578399,2586825,+,8426
108,BUMA.1121.00071,1,492471,500867,+,8396
108,BUMA.1121.00078,1,1512088,1520479,-,8391
108,BUMA.1121.00102,1,741423,749803,-,8380
108,BUMA.1121.00075,1,3923824,3932239,+,8415
108,BUMA.1121.00012,1,3255914,3264358,+,8444
108,BUMA.1121.00076,1,879984,888402,-,8418
108,BUMA.1121.00106,1,257057,265447,+,8390
108,BUMA.1121.00001,1,3618088,3626542,-,8454
108,BUMA.1121.00107,1,318741,327342,+,8601
108,BUMA.1121.00104,1,797369,805769,-,8400
108,BUMA.1121.00099,1,1933181,1941662,-,8481
108,BUMA.1121.00098,1,3197765,3206361,+,8596
108,BUMA.1121.00111,1,612783,621209,+,8426
108,BUMA.1121.00109,1,1389621,1398003,-,8382
108,BUMA.1121.00097,1,3544728,3553217,-,8489
108,BUMA.1121.00094,1,475192,483738,+,8546
108,BUMA.1121.00095,1,1195232,1203668,-,8436
108,BUMA.1121.00005,1,3089437,3097836,-,8399
108,BUMA.1121.00101,1,1991387,1999787,-,8400
108,BUMA.1121.00065,1,507283,515682,+,8399
108,BUMA.1121.00100,1,827263,835717,-,8454
108,BUMA.1121.00105,1,732590,741080,-,8490
108,BUMA.1121.00029,1,410309,418781,-,8472
108,BUMA.1121.00066,1,473055,481472,+,8417
108,BUMA.1121.00031,1,1817850,1826302,+,8452
108,BUMA.1121.00108,1,1459075,1467464,+,8389
108,BUMA.1121.00023,1,2828198,2836759,+,8561
108,BUMA.1121.00035,1,1551916,1560378,+,8462
108,BUMA.1121.00041,1,1740442,1748895,+,8453
109,BUMA.1121.00057,1,1579682,1609872,+,30190
109,BUMA.1121.00058,1,42796,72998,-,30202
109,BUMA.1121.00045,1,3589219,3619430,-,30211
109,BUMA.1121.00051,1,494197,524366,+,30169
109,BUMA.1121.00068,1,3351381,3381488,+,30107
109,BUMA.1121.00061,1,512815,543041,+,30226
109,BUMA.1121.00060,1,1814889,1845100,-,30211
109,BUMA.1121.00064,1,526143,556402,+,30259
109,BUMA.1121.00016,1,2586666,2616987,+,30321
109,BUMA.1121.00003,1,2979113,3009293,+,30180
109,BUMA.1121.00055,1,60721,90873,+,30152
109,BUMA.1121.00011,1,1114154,1144471,-,30317
109,BUMA.1121.00037,1,3126464,3156682,+,30218
109,BUMA.1121.00009,1,1063830,1093992,-,30162
109,BUMA.1121.00069,1,474061,504285,+,30224
109,BUMA.1121.00088,1,1374815,1405022,+,30207
109,BUMA.1121.00092,1,3350649,3380883,-,30234
109,BUMA.1121.00074,1,3370359,3400586,-,30227
109,BUMA.1121.00070,1,484255,514485,+,30230
109,BUMA.1121.00093,1,1245543,1275777,+,30234
109,BUMA.1121.00063,1,509767,539996,+,30229
109,BUMA.1121.00033,1,2741437,2771564,+,30127
109,BUMA.1121.00018,1,986780,1017090,+,30310
109,BUMA.1121.00080,1,529553,559715,+,30162
109,BUMA.1121.00027,1,2680031,2710241,+,30210
109,BUMA.1121.00053,1,202671,232872,+,30201
109,BUMA.1121.00059,1,3734111,3764340,+,30229
109,BUMA.1121.00043,1,479242,509448,+,30206
109,BUMA.1121.00056,1,3395397,3425571,-,30174
109,BUMA.1121.00112,1,2572314,2602560,-,30246
109,BUMA.1121.00091,1,1,30286,-,30285
109,BUMA.1121.00047,1,2465126,2495307,-,30181
109,BUMA.1121.00067,1,3894070,3924356,-,30286
109,BUMA.1121.00110,1,274800,304984,-,30184
109,BUMA.1121.00073,1,510878,541108,+,30230
109,BUMA.1121.00072,1,484683,514913,+,30230
109,BUMA.1121.00077,1,3178429,3208607,+,30178
109,BUMA.1121.00082,1,519706,549936,+,30230
109,BUMA.1121.00062,1,67649,97890,-,30241
109,BUMA.1121.00007,1,3610882,3641117,-,30235
109,BUMA.1121.00025,1,2242780,2273090,-,30310
109,BUMA.1121.00021,1,1121805,1151942,+,30137
109,BUMA.1121.00103,1,3909317,3939491,-,30174
109,BUMA.1121.00096,1,2747597,2777728,-,30131
109,BUMA.1121.00079,1,523589,553803,+,30214
109,BUMA.1121.00039,1,596171,626331,+,30160
109,BUMA.1121.00083,1,1154892,1185122,-,30230
109,BUMA.1121.00084,1,711061,741266,+,30205
109,BUMA.1121.00049,1,1341878,1372141,-,30263
109,BUMA.1121.00089,1,499924,530098,+,30174
109,BUMA.1121.00014,1,2360797,2390965,-,30168
109,BUMA.1121.00090,1,2587039,2617267,+,30228
109,BUMA.1121.00071,1,501081,531311,+,30230
109,BUMA.1121.00078,1,1481578,1511872,-,30294
109,BUMA.1121.00102,1,710968,741210,-,30242
109,BUMA.1121.00075,1,22,30221,+,30199
109,BUMA.1121.00012,1,3264572,3294859,+,30287
109,BUMA.1121.00076,1,849567,879771,-,30204
109,BUMA.1121.00106,1,265661,295890,+,30229
109,BUMA.1121.00001,1,3587746,3617875,-,30129
109,BUMA.1121.00107,1,327556,357773,+,30217
109,BUMA.1121.00104,1,766946,797156,-,30210
109,BUMA.1121.00099,1,1902833,1932968,-,30135
109,BUMA.1121.00098,1,3206575,3236755,+,30180
109,BUMA.1121.00111,1,621423,651645,+,30222
109,BUMA.1121.00109,1,1359213,1389408,-,30195
109,BUMA.1121.00097,1,3514314,3544515,-,30201
109,BUMA.1121.00094,1,483952,514139,+,30187
109,BUMA.1121.00095,1,1164763,1195019,-,30256
109,BUMA.1121.00005,1,3059042,3089224,-,30182
109,BUMA.1121.00101,1,1960996,1991174,-,30178
109,BUMA.1121.00065,1,515896,546044,+,30148
109,BUMA.1121.00100,1,796874,827050,-,30176
109,BUMA.1121.00105,1,702181,732377,-,30196
109,BUMA.1121.00029,1,379910,410096,-,30186
109,BUMA.1121.00066,1,481686,511916,+,30230
109,BUMA.1121.00031,1,1826516,1856706,+,30190
109,BUMA.1121.00108,1,1467678,1497920,+,30242
109,BUMA.1121.00023,1,2836973,2867261,+,30288
109,BUMA.1121.00035,1,1560592,1590820,+,30228
109,BUMA.1121.00041,1,1749109,1779371,+,30262
110,BUMA.1121.00057,1,1611001,1653099,+,42098
110,BUMA.1121.00058,1,19,41666,-,41647
110,BUMA.1121.00045,1,3546432,3588089,-,41657
110,BUMA.1121.00051,1,525495,567155,+,41660
110,BUMA.1121.00068,1,3382605,3424239,+,41634
110,BUMA.1121.00061,1,544170,585793,+,41623
110,BUMA.1121.00060,1,1772102,1813759,-,41657
110,BUMA.1121.00064,1,557532,599190,+,41658
110,BUMA.1121.00016,1,2618117,2659771,+,41654
110,BUMA.1121.00003,1,3010419,3052043,+,41624
110,BUMA.1121.00055,1,91999,133641,+,41642
110,BUMA.1121.00011,1,1071361,1113027,-,41666
110,BUMA.1121.00037,1,3157812,3199445,+,41633
110,BUMA.1121.00009,1,1021014,1062716,-,41702
110,BUMA.1121.00069,1,505414,547030,+,41616
110,BUMA.1121.00088,1,1406152,1447802,+,41650
110,BUMA.1121.00092,1,3307841,3349519,-,41678
110,BUMA.1121.00074,1,3327571,3369228,-,41657
110,BUMA.1121.00070,1,515614,557235,+,41621
110,BUMA.1121.00093,1,1276906,1318585,+,41679
110,BUMA.1121.00063,1,541125,582750,+,41625
110,BUMA.1121.00033,1,2772695,2814338,+,41643
110,BUMA.1121.00018,1,1018221,1059856,+,41635
110,BUMA.1121.00080,1,560844,602505,+,41661
110,BUMA.1121.00027,1,2711370,2752994,+,41624
110,BUMA.1121.00053,1,234003,275637,+,41634
110,BUMA.1121.00059,1,3765469,3807140,+,41671
110,BUMA.1121.00043,1,510579,552273,+,41694
110,BUMA.1121.00056,1,3352606,3394267,-,41661
110,BUMA.1121.00112,1,2529562,2571184,-,41622
110,BUMA.1121.00091,1,3978965,4020633,-,41668
110,BUMA.1121.00047,1,2422335,2463996,-,41661
110,BUMA.1121.00067,1,3851285,3892940,-,41655
110,BUMA.1121.00110,1,232010,273670,-,41660
110,BUMA.1121.00073,1,542237,583860,+,41623
110,BUMA.1121.00072,1,516042,557665,+,41623
110,BUMA.1121.00077,1,3209736,3251401,+,41665
110,BUMA.1121.00082,1,551065,592691,+,41626
110,BUMA.1121.00062,1,24853,66519,-,41666
110,BUMA.1121.00007,1,3568128,3609755,-,41627
110,BUMA.1121.00025,1,2200013,2241648,-,41635
110,BUMA.1121.00021,1,1153073,1194709,+,41636
110,BUMA.1121.00103,1,3865208,3908187,-,42979
110,BUMA.1121.00096,1,2704787,2746473,-,41686
110,BUMA.1121.00079,1,554932,596592,+,41660
110,BUMA.1121.00039,1,627462,669080,+,41618
110,BUMA.1121.00083,1,1112137,1153762,-,41625
110,BUMA.1121.00084,1,742395,784045,+,41650
110,BUMA.1121.00049,1,1297779,1340748,-,42969
110,BUMA.1121.00089,1,531227,572877,+,41650
110,BUMA.1121.00014,1,2318030,2359665,-,41635
110,BUMA.1121.00090,1,2618398,2660034,+,41636
110,BUMA.1121.00071,1,532440,574065,+,41625
110,BUMA.1121.00078,1,1438791,1480447,-,41656
110,BUMA.1121.00102,1,668166,709838,-,41672
110,BUMA.1121.00075,1,31350,72993,+,41643
110,BUMA.1121.00012,1,3295990,3337633,+,41643
110,BUMA.1121.00076,1,806793,848437,-,41644
110,BUMA.1121.00106,1,297019,338659,+,41640
110,BUMA.1121.00001,1,3544971,3586614,-,41643
110,BUMA.1121.00107,1,358902,400558,+,41656
110,BUMA.1121.00104,1,724183,765816,-,41633
110,BUMA.1121.00099,1,1860041,1901703,-,41662
110,BUMA.1121.00098,1,3237881,3279564,+,41683
110,BUMA.1121.00111,1,652776,694424,+,41648
110,BUMA.1121.00109,1,1315128,1358086,-,42958
110,BUMA.1121.00097,1,3471524,3513187,-,41663
110,BUMA.1121.00094,1,515268,556929,+,41661
110,BUMA.1121.00095,1,1122016,1163633,-,41617
110,BUMA.1121.00005,1,3016279,3057912,-,41633
110,BUMA.1121.00101,1,1918211,1959866,-,41655
110,BUMA.1121.00065,1,547170,588819,+,41649
110,BUMA.1121.00100,1,754067,795744,-,41677
110,BUMA.1121.00105,1,659383,701049,-,41666
110,BUMA.1121.00029,1,335782,378778,-,42996
110,BUMA.1121.00066,1,513045,554670,+,41625
110,BUMA.1121.00031,1,1857836,1899476,+,41640
110,BUMA.1121.00108,1,1499049,1540702,+,41653
110,BUMA.1121.00023,1,2868392,2910020,+,41628
110,BUMA.1121.00035,1,1591951,1633594,+,41643
110,BUMA.1121.00041,1,1780500,1822161,+,41661
111,BUMA.1121.00057,1,1653100,1662327,+,9227
111,BUMA.1121.00058,1,4049048,4058409,-,9361
111,BUMA.1121.00045,1,3537073,3546430,-,9357
111,BUMA.1121.00051,1,567156,576383,+,9227
111,BUMA.1121.00068,1,3424240,3433456,+,9216
111,BUMA.1121.00061,1,585794,595021,+,9227
111,BUMA.1121.00060,1,1762743,1772100,-,9357
111,BUMA.1121.00064,1,599191,608437,+,9246
111,BUMA.1121.00016,1,2659772,2669016,+,9244
111,BUMA.1121.00003,1,3052044,3061290,+,9246
111,BUMA.1121.00055,1,133642,142869,+,9227
111,BUMA.1121.00011,1,1062004,1071359,-,9355
111,BUMA.1121.00037,1,3199446,3208690,+,9244
111,BUMA.1121.00009,1,1011703,1021012,-,9309
111,BUMA.1121.00069,1,547031,556258,+,9227
111,BUMA.1121.00088,1,1447803,1457030,+,9227
111,BUMA.1121.00092,1,3298479,3307839,-,9360
111,BUMA.1121.00074,1,3318191,3327569,-,9378
111,BUMA.1121.00070,1,557236,566463,+,9227
111,BUMA.1121.00093,1,1318586,1327813,+,9227
111,BUMA.1121.00063,1,582751,591977,+,9226
111,BUMA.1121.00033,1,2814339,2823584,+,9245
111,BUMA.1121.00018,1,1059857,1069102,+,9245
111,BUMA.1121.00080,1,602506,611733,+,9227
111,BUMA.1121.00027,1,2752995,2762222,+,9227
111,BUMA.1121.00053,1,275638,284883,+,9245
111,BUMA.1121.00059,1,3807141,3816386,+,9245
111,BUMA.1121.00043,1,552274,561518,+,9244
111,BUMA.1121.00056,1,3343247,3352604,-,9357
111,BUMA.1121.00112,1,2520188,2529560,-,9372
111,BUMA.1121.00091,1,3969730,3978963,-,9233
111,BUMA.1121.00047,1,2412976,2422333,-,9357
111,BUMA.1121.00067,1,3841905,3851283,-,9378
111,BUMA.1121.00110,1,222636,232008,-,9372
111,BUMA.1121.00073,1,583861,593088,+,9227
111,BUMA.1121.00072,1,557666,566893,+,9227
111,BUMA.1121.00077,1,3251402,3260644,+,9242
111,BUMA.1121.00082,1,592692,601919,+,9227
111,BUMA.1121.00062,1,15476,24851,-,9375
111,BUMA.1121.00007,1,3558763,3568126,-,9363
111,BUMA.1121.00025,1,2190636,2200011,-,9375
111,BUMA.1121.00021,1,1194710,1203954,+,9244
111,BUMA.1121.00103,1,3855841,3865206,-,9365
111,BUMA.1121.00096,1,2695424,2704785,-,9361
111,BUMA.1121.00079,1,596593,605820,+,9227
111,BUMA.1121.00039,1,669081,678325,+,9244
111,BUMA.1121.00083,1,1102909,1112135,-,9226
111,BUMA.1121.00084,1,784046,793274,+,9228
111,BUMA.1121.00049,1,1288384,1297777,-,9393
111,BUMA.1121.00089,1,572878,582105,+,9227
111,BUMA.1121.00014,1,2308636,2318028,-,9392
111,BUMA.1121.00090,1,2660035,2669279,+,9244
111,BUMA.1121.00071,1,574066,583293,+,9227
111,BUMA.1121.00078,1,1429437,1438789,-,9352
111,BUMA.1121.00102,1,658792,668164,-,9372
111,BUMA.1121.00075,1,72994,82204,+,9210
111,BUMA.1121.00012,1,3337634,3346878,+,9244
111,BUMA.1121.00076,1,797445,806791,-,9346
111,BUMA.1121.00106,1,338660,347887,+,9227
111,BUMA.1121.00001,1,3535577,3544969,-,9392
111,BUMA.1121.00107,1,400559,409775,+,9216
111,BUMA.1121.00104,1,714818,724181,-,9363
111,BUMA.1121.00099,1,1850683,1860039,-,9356
111,BUMA.1121.00098,1,3279565,3288793,+,9228
111,BUMA.1121.00111,1,694425,703669,+,9244
111,BUMA.1121.00109,1,1305746,1315126,-,9380
111,BUMA.1121.00097,1,3462166,3471522,-,9356
111,BUMA.1121.00094,1,556930,566175,+,9245
111,BUMA.1121.00095,1,1112653,1122014,-,9361
111,BUMA.1121.00005,1,3007033,3016277,-,9244
111,BUMA.1121.00101,1,1908850,1918209,-,9359
111,BUMA.1121.00065,1,588820,598047,+,9227
111,BUMA.1121.00100,1,744688,754065,-,9377
111,BUMA.1121.00105,1,650006,659381,-,9375
111,BUMA.1121.00029,1,326388,335780,-,9392
111,BUMA.1121.00066,1,554671,563898,+,9227
111,BUMA.1121.00031,1,1899477,1908721,+,9244
111,BUMA.1121.00108,1,1540703,1549929,+,9226
111,BUMA.1121.00023,1,2910021,2919265,+,9244
111,BUMA.1121.00035,1,1633595,1642839,+,9244
111,BUMA.1121.00041,1,1822162,1831386,+,9224
112,BUMA.1121.00057,1,1662558,1666270,+,3712
112,BUMA.1121.00058,1,4035748,4039461,-,3713
112,BUMA.1121.00045,1,3533247,3536976,-,3729
112,BUMA.1121.00051,1,576611,580328,+,3717
112,BUMA.1121.00068,1,3444395,3448134,+,3739
112,BUMA.1121.00061,1,595259,598971,+,3712
112,BUMA.1121.00060,1,1758917,1762646,-,3729
112,BUMA.1121.00064,1,608683,612395,+,3712
112,BUMA.1121.00016,1,2700277,2704015,+,3738
112,BUMA.1121.00003,1,3061503,3065247,+,3744
112,BUMA.1121.00055,1,143103,146816,+,3713
112,BUMA.1121.00011,1,1058159,1061907,-,3748
112,BUMA.1121.00037,1,3208936,3212674,+,3738
112,BUMA.1121.00009,1,1007765,1011545,-,3780
112,BUMA.1121.00069,1,556496,560200,+,3704
112,BUMA.1121.00088,1,1457261,1461001,+,3740
112,BUMA.1121.00092,1,3294643,3298382,-,3739
112,BUMA.1121.00074,1,3292008,3295764,-,3756
112,BUMA.1121.00070,1,566720,570432,+,3712
112,BUMA.1121.00093,1,1328044,1331783,+,3739
112,BUMA.1121.00063,1,592215,595927,+,3712
112,BUMA.1121.00033,1,2823830,2827567,+,3737
112,BUMA.1121.00018,1,1069330,1073058,+,3728
112,BUMA.1121.00080,1,611961,615717,+,3756
112,BUMA.1121.00027,1,2762453,2766165,+,3712
112,BUMA.1121.00053,1,285105,288817,+,3712
112,BUMA.1121.00059,1,3816614,3820367,+,3753
112,BUMA.1121.00043,1,561752,565495,+,3743
112,BUMA.1121.00056,1,3339401,3343150,-,3749
112,BUMA.1121.00112,1,2500441,2504189,-,3748
112,BUMA.1121.00091,1,3965763,3969502,-,3739
112,BUMA.1121.00047,1,2409162,2412879,-,3717
112,BUMA.1121.00067,1,3815722,3819478,-,3756
112,BUMA.1121.00110,1,217459,221209,-,3750
112,BUMA.1121.00073,1,593345,597057,+,3712
112,BUMA.1121.00072,1,567150,570856,+,3706
112,BUMA.1121.00077,1,3262203,3265953,+,3750
112,BUMA.1121.00082,1,639965,643677,+,3712
112,BUMA.1121.00062,1,2173,5889,-,3716
112,BUMA.1121.00007,1,3554923,3558666,-,3743
112,BUMA.1121.00025,1,2186810,2190539,-,3729
112,BUMA.1121.00021,1,1204200,1207957,+,3757
112,BUMA.1121.00103,1,3852012,3855744,-,3732
112,BUMA.1121.00096,1,2691575,2695327,-,3752
112,BUMA.1121.00079,1,606048,609765,+,3717
112,BUMA.1121.00039,1,678571,682354,+,3783
112,BUMA.1121.00083,1,1061151,1064863,-,3712
112,BUMA.1121.00084,1,805447,809177,+,3730
112,BUMA.1121.00049,1,1284539,1288287,-,3748
112,BUMA.1121.00089,1,582333,586082,+,3749
112,BUMA.1121.00014,1,2265069,2268807,-,3738
112,BUMA.1121.00090,1,2669525,2673254,+,3729
112,BUMA.1121.00071,1,583549,587261,+,3712
112,BUMA.1121.00078,1,1425628,1429340,-,3712
112,BUMA.1121.00102,1,654983,658695,-,3712
112,BUMA.1121.00075,1,82438,86178,+,3740
112,BUMA.1121.00012,1,3347124,3350880,+,3756
112,BUMA.1121.00076,1,793608,797348,-,3740
112,BUMA.1121.00106,1,348115,351868,+,3753
112,BUMA.1121.00001,1,3531734,3535480,-,3746
112,BUMA.1121.00107,1,410009,413749,+,3740
112,BUMA.1121.00104,1,710981,714721,-,3740
112,BUMA.1121.00099,1,1846845,1850586,-,3741
112,BUMA.1121.00098,1,3289063,3292837,+,3774
112,BUMA.1121.00111,1,703903,707659,+,3756
112,BUMA.1121.00109,1,1301894,1305649,-,3755
112,BUMA.1121.00097,1,3458312,3462069,-,3757
112,BUMA.1121.00094,1,566403,570152,+,3749
112,BUMA.1121.00095,1,1108835,1112556,-,3721
112,BUMA.1121.00005,1,3003075,3006805,-,3730
112,BUMA.1121.00101,1,1905013,1908753,-,3740
112,BUMA.1121.00065,1,629305,633045,+,3740
112,BUMA.1121.00100,1,740874,744591,-,3717
112,BUMA.1121.00105,1,629256,632988,-,3732
112,BUMA.1121.00029,1,322553,326291,-,3738
112,BUMA.1121.00066,1,564193,567905,+,3712
112,BUMA.1121.00031,1,1951304,1955042,+,3738
112,BUMA.1121.00108,1,1550160,1553899,+,3739
112,BUMA.1121.00023,1,2919505,2923279,+,3774
112,BUMA.1121.00035,1,1643085,1646841,+,3756
112,BUMA.1121.00041,1,1831620,1835341,+,3721
113,BUMA.1121.00057,1,1666328,1670424,+,4096
113,BUMA.1121.00064,1,612446,616549,+,4103
113,BUMA.1121.00027,1,2766223,2770318,+,4095
113,BUMA.1121.00082,1,643728,647831,+,4103
113,BUMA.1121.00083,1,1056996,1061100,-,4104
113,BUMA.1121.00071,1,587312,591415,+,4103
113,BUMA.1121.00066,1,567956,572059,+,4103
113,BUMA.1121.00041,1,1835392,1839495,+,4103
114,BUMA.1121.00057,1,1676544,1686661,+,10117
114,BUMA.1121.00058,1,4022662,4032779,-,10117
114,BUMA.1121.00045,1,3518836,3528701,-,9865
114,BUMA.1121.00051,1,583281,593398,+,10117
114,BUMA.1121.00068,1,3452110,3462227,+,10117
114,BUMA.1121.00061,1,599828,609945,+,10117
114,BUMA.1121.00060,1,1744506,1754371,-,9865
114,BUMA.1121.00064,1,622669,632786,+,10117
114,BUMA.1121.00016,1,2706966,2717083,+,10117
114,BUMA.1121.00003,1,3067983,3078100,+,10117
114,BUMA.1121.00055,1,150863,160728,+,9865
114,BUMA.1121.00011,1,1044359,1054476,-,10117
114,BUMA.1121.00037,1,3216863,3226980,+,10117
114,BUMA.1121.00009,1,993462,1003579,-,10117
114,BUMA.1121.00069,1,560853,570970,+,10117
114,BUMA.1121.00088,1,1463970,1474087,+,10117
114,BUMA.1121.00092,1,3278982,3289090,-,10108
114,BUMA.1121.00074,1,3276338,3286455,-,10117
114,BUMA.1121.00070,1,571114,581231,+,10117
114,BUMA.1121.00093,1,1337336,1347444,+,10108
114,BUMA.1121.00063,1,596881,606998,+,10117
114,BUMA.1121.00033,1,2830520,2840636,+,10116
114,BUMA.1121.00018,1,1076011,1086128,+,10117
114,BUMA.1121.00080,1,621270,631387,+,10117
114,BUMA.1121.00027,1,2776435,2786552,+,10117
114,BUMA.1121.00053,1,291553,301418,+,9865
114,BUMA.1121.00059,1,3828935,3839052,+,10117
114,BUMA.1121.00043,1,568448,578565,+,10117
114,BUMA.1121.00056,1,3326314,3336431,-,10117
114,BUMA.1121.00112,1,2484900,2495017,-,10117
114,BUMA.1121.00091,1,3953161,3963026,-,9865
114,BUMA.1121.00047,1,2396092,2406209,-,10117
114,BUMA.1121.00067,1,3800052,3810169,-,10117
114,BUMA.1121.00110,1,204621,214489,-,9868
114,BUMA.1121.00073,1,597739,607856,+,10117
114,BUMA.1121.00072,1,571488,581605,+,10117
114,BUMA.1121.00077,1,3268923,3278791,+,9868
114,BUMA.1121.00082,1,653951,664068,+,10117
114,BUMA.1121.00062,1,3965885,3976002,-,10117
114,BUMA.1121.00007,1,3541011,3550876,-,9865
114,BUMA.1121.00025,1,2173740,2183857,-,10117
114,BUMA.1121.00021,1,1210910,1221027,+,10117
114,BUMA.1121.00103,1,3838166,3848031,-,9865
114,BUMA.1121.00096,1,2677414,2687528,-,10114
114,BUMA.1121.00079,1,612715,622832,+,10117
114,BUMA.1121.00039,1,686642,696759,+,10117
114,BUMA.1121.00083,1,1040760,1050877,-,10117
114,BUMA.1121.00084,1,811545,821662,+,10117
114,BUMA.1121.00049,1,1270375,1280492,-,10117
114,BUMA.1121.00089,1,589052,599169,+,10117
114,BUMA.1121.00014,1,2252252,2262117,-,9865
114,BUMA.1121.00090,1,2676206,2686071,+,9865
114,BUMA.1121.00071,1,597535,607652,+,10117
114,BUMA.1121.00078,1,1413146,1423263,-,10117
114,BUMA.1121.00102,1,642750,652615,-,9865
114,BUMA.1121.00075,1,89130,99235,+,10105
114,BUMA.1121.00012,1,3355168,3365285,+,10117
114,BUMA.1121.00076,1,780550,790655,-,10105
114,BUMA.1121.00106,1,355915,366032,+,10117
114,BUMA.1121.00001,1,3518916,3528781,-,9865
114,BUMA.1121.00107,1,420696,430561,+,9865
114,BUMA.1121.00104,1,697911,708028,-,10117
114,BUMA.1121.00099,1,1832681,1842798,-,10117
114,BUMA.1121.00098,1,3298405,3308522,+,10117
114,BUMA.1121.00111,1,710612,720477,+,9865
114,BUMA.1121.00109,1,1289408,1299525,-,10117
114,BUMA.1121.00097,1,3440264,3450129,-,9865
114,BUMA.1121.00094,1,573121,583238,+,10117
114,BUMA.1121.00095,1,1092023,1101888,-,9865
114,BUMA.1121.00005,1,2990589,3000706,-,10117
114,BUMA.1121.00101,1,1889605,1899722,-,10117
114,BUMA.1121.00065,1,635998,646115,+,10117
114,BUMA.1121.00100,1,721143,731237,-,10094
114,BUMA.1121.00105,1,609326,619443,-,10117
114,BUMA.1121.00029,1,309735,319600,-,9865
114,BUMA.1121.00066,1,578179,588296,+,10117
114,BUMA.1121.00031,1,1957994,1967859,+,9865
114,BUMA.1121.00108,1,1559191,1569056,+,9865
114,BUMA.1121.00023,1,2926232,2936097,+,9865
114,BUMA.1121.00035,1,1649794,1659659,+,9865
114,BUMA.1121.00041,1,1845616,1855481,+,9865
115,BUMA.1121.00057,1,1688153,1703557,+,15404
115,BUMA.1121.00058,1,4004395,4019857,-,15462
115,BUMA.1121.00045,1,3491503,3506956,-,15453
115,BUMA.1121.00051,1,594884,610287,+,15403
115,BUMA.1121.00068,1,3463728,3479127,+,15399
115,BUMA.1121.00061,1,611437,626849,+,15412
115,BUMA.1121.00060,1,1717173,1732626,-,15453
115,BUMA.1121.00064,1,634287,649689,+,15402
115,BUMA.1121.00016,1,2718575,2734025,+,15450
115,BUMA.1121.00003,1,3079601,3095018,+,15417
115,BUMA.1121.00055,1,172614,188028,+,15414
115,BUMA.1121.00011,1,1027467,1042867,-,15400
115,BUMA.1121.00037,1,3228472,3243910,+,15438
115,BUMA.1121.00009,1,976531,991961,-,15430
115,BUMA.1121.00069,1,572462,587856,+,15394
115,BUMA.1121.00088,1,1475579,1490991,+,15412
115,BUMA.1121.00092,1,3262086,3277490,-,15404
115,BUMA.1121.00074,1,3259424,3274837,-,15413
115,BUMA.1121.00070,1,582723,598135,+,15412
115,BUMA.1121.00093,1,1348936,1364339,+,15403
115,BUMA.1121.00063,1,608490,623896,+,15406
115,BUMA.1121.00033,1,2842128,2857565,+,15437
115,BUMA.1121.00018,1,1087620,1103058,+,15438
115,BUMA.1121.00080,1,632888,648300,+,15412
115,BUMA.1121.00027,1,2788044,2803447,+,15403
115,BUMA.1121.00053,1,313298,328710,+,15412
115,BUMA.1121.00059,1,3840544,3855956,+,15412
115,BUMA.1121.00043,1,580057,595508,+,15451
115,BUMA.1121.00056,1,3309409,3324822,-,15413
115,BUMA.1121.00112,1,2467973,2483399,-,15426
115,BUMA.1121.00091,1,3925846,3941281,-,15435
115,BUMA.1121.00047,1,2379193,2394606,-,15413
115,BUMA.1121.00067,1,3783138,3798551,-,15413
115,BUMA.1121.00110,1,176024,192740,-,16716
115,BUMA.1121.00073,1,609348,624760,+,15412
115,BUMA.1121.00072,1,583097,598509,+,15412
115,BUMA.1121.00077,1,3290672,3307385,+,16713
115,BUMA.1121.00082,1,665560,680972,+,15412
115,BUMA.1121.00062,1,3948975,3964384,-,15409
115,BUMA.1121.00007,1,3513734,3529136,-,15402
115,BUMA.1121.00025,1,2156809,2172248,-,15439
115,BUMA.1121.00021,1,1222519,1237957,+,15438
115,BUMA.1121.00103,1,3810861,3826287,-,15426
115,BUMA.1121.00096,1,2660487,2675913,-,15426
115,BUMA.1121.00079,1,624317,639729,+,15412
115,BUMA.1121.00039,1,698251,713689,+,15438
115,BUMA.1121.00083,1,1023855,1039268,-,15413
115,BUMA.1121.00084,1,823154,838556,+,15402
115,BUMA.1121.00049,1,1252148,1268874,-,16726
115,BUMA.1121.00089,1,600661,616073,+,15412
115,BUMA.1121.00014,1,2224933,2240372,-,15439
115,BUMA.1121.00090,1,2697951,2713376,+,15425
115,BUMA.1121.00071,1,609144,624556,+,15412
115,BUMA.1121.00078,1,1396249,1411654,-,15405
115,BUMA.1121.00102,1,615470,630870,-,15400
115,BUMA.1121.00075,1,100727,116139,+,15412
115,BUMA.1121.00012,1,3366777,3382202,+,15425
115,BUMA.1121.00076,1,763645,779058,-,15413
115,BUMA.1121.00106,1,367524,382936,+,15412
115,BUMA.1121.00001,1,3491610,3507036,-,15426
115,BUMA.1121.00107,1,442442,457854,+,15412
115,BUMA.1121.00104,1,680997,696410,-,15413
115,BUMA.1121.00099,1,1815781,1831180,-,15399
115,BUMA.1121.00098,1,3311336,3326748,+,15412
115,BUMA.1121.00111,1,733971,749365,+,15394
115,BUMA.1121.00109,1,1272490,1287916,-,15426
115,BUMA.1121.00097,1,3412956,3428385,-,15429
115,BUMA.1121.00094,1,584730,600142,+,15412
115,BUMA.1121.00095,1,1064729,1080143,-,15414
115,BUMA.1121.00005,1,2973651,2989089,-,15438
115,BUMA.1121.00101,1,1872695,1888104,-,15409
115,BUMA.1121.00065,1,647607,663045,+,15438
115,BUMA.1121.00100,1,704239,719651,-,15412
115,BUMA.1121.00105,1,592422,607834,-,15412
115,BUMA.1121.00029,1,282429,297855,-,15426
115,BUMA.1121.00066,1,589788,605200,+,15412
115,BUMA.1121.00031,1,1979739,1995177,+,15438
115,BUMA.1121.00108,1,1580936,1596360,+,15424
115,BUMA.1121.00023,1,2947977,2963415,+,15438
115,BUMA.1121.00035,1,1671539,1686964,+,15425
115,BUMA.1121.00041,1,1867361,1882799,+,15438
116,BUMA.1121.00057,1,1705537,1727518,+,21981
116,BUMA.1121.00058,1,3980441,4002415,-,21974
116,BUMA.1121.00045,1,3467537,3489523,-,21986
116,BUMA.1121.00051,1,612267,634258,+,21991
116,BUMA.1121.00068,1,3481107,3503040,+,21933
116,BUMA.1121.00061,1,628829,650810,+,21981
116,BUMA.1121.00060,1,1693207,1715193,-,21986
116,BUMA.1121.00064,1,651669,673654,+,21985
116,BUMA.1121.00016,1,2736005,2757998,+,21993
116,BUMA.1121.00003,1,3096998,3118964,+,21966
116,BUMA.1121.00055,1,190008,211982,+,21974
116,BUMA.1121.00011,1,1003498,1025487,-,21989
116,BUMA.1121.00037,1,3245890,3267883,+,21993
116,BUMA.1121.00009,1,952577,974551,-,21974
116,BUMA.1121.00069,1,589836,611817,+,21981
116,BUMA.1121.00088,1,1492971,1514957,+,21986
116,BUMA.1121.00092,1,3238107,3260106,-,21999
116,BUMA.1121.00074,1,3235459,3257444,-,21985
116,BUMA.1121.00070,1,600115,622096,+,21981
116,BUMA.1121.00093,1,1366319,1388318,+,21999
116,BUMA.1121.00063,1,625876,647857,+,21981
116,BUMA.1121.00033,1,2859545,2881538,+,21993
116,BUMA.1121.00018,1,1105038,1127031,+,21993
116,BUMA.1121.00080,1,650280,672272,+,21992
116,BUMA.1121.00027,1,2805427,2827408,+,21981
116,BUMA.1121.00053,1,330690,352681,+,21991
116,BUMA.1121.00059,1,3857936,3879910,+,21974
116,BUMA.1121.00043,1,597488,619466,+,21978
116,BUMA.1121.00056,1,3285444,3307429,-,21985
116,BUMA.1121.00112,1,2444020,2465993,-,21973
116,BUMA.1121.00091,1,3901899,3923866,-,21967
116,BUMA.1121.00047,1,2355220,2377213,-,21993
116,BUMA.1121.00067,1,3759173,3781158,-,21985
116,BUMA.1121.00110,1,152056,174044,-,21988
116,BUMA.1121.00073,1,626740,648721,+,21981
116,BUMA.1121.00072,1,600489,622470,+,21981
116,BUMA.1121.00077,1,3309365,3331351,+,21986
116,BUMA.1121.00082,1,682952,704933,+,21981
116,BUMA.1121.00062,1,3925022,3946995,-,21973
116,BUMA.1121.00007,1,3489776,3511753,-,21977
116,BUMA.1121.00025,1,2132836,2154829,-,21993
116,BUMA.1121.00021,1,1239937,1261930,+,21993
116,BUMA.1121.00103,1,3786902,3808881,-,21979
116,BUMA.1121.00096,1,2636599,2658507,-,21908
116,BUMA.1121.00079,1,641709,663701,+,21992
116,BUMA.1121.00039,1,715669,737657,+,21988
116,BUMA.1121.00083,1,999894,1021875,-,21981
116,BUMA.1121.00084,1,840536,862509,+,21973
116,BUMA.1121.00049,1,1228183,1250168,-,21985
116,BUMA.1121.00089,1,618053,640038,+,21985
116,BUMA.1121.00014,1,2200960,2222953,-,21993
116,BUMA.1121.00090,1,2715356,2737335,+,21979
116,BUMA.1121.00071,1,626536,648516,+,21980
116,BUMA.1121.00078,1,1372270,1394269,-,21999
116,BUMA.1121.00102,1,591536,613490,-,21954
116,BUMA.1121.00075,1,118119,140092,+,21973
116,BUMA.1121.00012,1,3384182,3406175,+,21993
116,BUMA.1121.00076,1,739692,761665,-,21973
116,BUMA.1121.00106,1,384916,406901,+,21985
116,BUMA.1121.00001,1,3467638,3489630,-,21992
116,BUMA.1121.00107,1,459834,481810,+,21976
116,BUMA.1121.00104,1,657027,679017,-,21990
116,BUMA.1121.00099,1,1791828,1813801,-,21973
116,BUMA.1121.00098,1,3328728,3350701,+,21973
116,BUMA.1121.00111,1,751345,773362,+,22017
116,BUMA.1121.00109,1,1248545,1270510,-,21965
116,BUMA.1121.00097,1,3389006,3410976,-,21970
116,BUMA.1121.00094,1,602122,624107,+,21985
116,BUMA.1121.00095,1,1040777,1062749,-,21972
116,BUMA.1121.00005,1,2949697,2971671,-,21974
116,BUMA.1121.00101,1,1848741,1870715,-,21974
116,BUMA.1121.00065,1,665025,687004,+,21979
116,BUMA.1121.00100,1,680291,702259,-,21968
116,BUMA.1121.00105,1,568458,590442,-,21984
116,BUMA.1121.00029,1,258456,280449,-,21993
116,BUMA.1121.00066,1,607180,629161,+,21981
116,BUMA.1121.00031,1,1997157,2019150,+,21993
116,BUMA.1121.00108,1,1598340,1620307,+,21967
116,BUMA.1121.00023,1,2965395,2987388,+,21993
116,BUMA.1121.00035,1,1688944,1710937,+,21993
116,BUMA.1121.00041,1,1884779,1906760,+,21981
117,BUMA.1121.00057,1,1727520,1738799,+,11279
117,BUMA.1121.00058,1,3969160,3980440,-,11280
117,BUMA.1121.00045,1,3454671,3465952,-,11281
117,BUMA.1121.00051,1,634260,645578,+,11318
117,BUMA.1121.00068,1,3503042,3514347,+,11305
117,BUMA.1121.00061,1,650812,662091,+,11279
117,BUMA.1121.00060,1,1680341,1691622,-,11281
117,BUMA.1121.00064,1,673656,684943,+,11287
117,BUMA.1121.00016,1,2758000,2769312,+,11312
117,BUMA.1121.00003,1,3118966,3130246,+,11280
117,BUMA.1121.00055,1,211984,223277,+,11293
117,BUMA.1121.00011,1,990632,1001914,-,11282
117,BUMA.1121.00037,1,3267885,3279220,+,11335
117,BUMA.1121.00009,1,941322,952576,-,11254
117,BUMA.1121.00069,1,611819,623098,+,11279
117,BUMA.1121.00088,1,1514959,1526239,+,11280
117,BUMA.1121.00092,1,3226810,3238106,-,11296
117,BUMA.1121.00074,1,3224171,3235458,-,11287
117,BUMA.1121.00070,1,622098,633377,+,11279
117,BUMA.1121.00093,1,1388320,1399616,+,11296
117,BUMA.1121.00063,1,647859,659138,+,11279
117,BUMA.1121.00033,1,2881540,2892822,+,11282
117,BUMA.1121.00018,1,1127033,1138329,+,11296
117,BUMA.1121.00080,1,672274,683582,+,11308
117,BUMA.1121.00027,1,2827410,2838689,+,11279
117,BUMA.1121.00053,1,352683,364000,+,11317
117,BUMA.1121.00059,1,3879912,3891181,+,11269
117,BUMA.1121.00043,1,619468,630750,+,11282
117,BUMA.1121.00056,1,3274164,3285443,-,11279
117,BUMA.1121.00112,1,2432739,2444019,-,11280
117,BUMA.1121.00091,1,3890611,3901898,-,11287
117,BUMA.1121.00047,1,2343890,2355219,-,11329
117,BUMA.1121.00067,1,3747891,3759172,-,11281
117,BUMA.1121.00110,1,139203,150472,-,11269
117,BUMA.1121.00073,1,648723,660002,+,11279
117,BUMA.1121.00072,1,622472,633751,+,11279
117,BUMA.1121.00077,1,3332933,3344205,+,11272
117,BUMA.1121.00082,1,704935,716214,+,11279
117,BUMA.1121.00062,1,3913691,3925021,-,11330
117,BUMA.1121.00007,1,3478497,3489775,-,11278
117,BUMA.1121.00025,1,2121539,2132835,-,11296
117,BUMA.1121.00021,1,1261932,1273211,+,11279
117,BUMA.1121.00103,1,3774034,3785315,-,11281
117,BUMA.1121.00096,1,2625312,2636598,-,11286
117,BUMA.1121.00079,1,663703,674989,+,11286
117,BUMA.1121.00039,1,737659,748959,+,11300
117,BUMA.1121.00083,1,988614,999893,-,11279
117,BUMA.1121.00084,1,862511,873820,+,11309
117,BUMA.1121.00049,1,1216903,1228182,-,11279
117,BUMA.1121.00089,1,640040,651319,+,11279
117,BUMA.1121.00014,1,2189652,2200959,-,11307
117,BUMA.1121.00090,1,2737337,2748630,+,11293
117,BUMA.1121.00071,1,648518,659740,+,11222
117,BUMA.1121.00078,1,1359401,1370685,-,11284
117,BUMA.1121.00102,1,580240,591535,-,11295
117,BUMA.1121.00075,1,140094,151373,+,11279
117,BUMA.1121.00012,1,3406177,3417470,+,11293
117,BUMA.1121.00076,1,728412,739691,-,11279
117,BUMA.1121.00106,1,406903,418182,+,11279
117,BUMA.1121.00001,1,3456348,3467637,-,11289
117,BUMA.1121.00107,1,481812,493107,+,11295
117,BUMA.1121.00104,1,645747,657026,-,11279
117,BUMA.1121.00099,1,1780553,1791827,-,11274
117,BUMA.1121.00098,1,3350703,3362013,+,11310
117,BUMA.1121.00111,1,773364,784653,+,11289
117,BUMA.1121.00109,1,1237234,1248544,-,11310
117,BUMA.1121.00097,1,3377725,3389005,-,11280
117,BUMA.1121.00094,1,624109,635388,+,11279
117,BUMA.1121.00095,1,1029495,1040776,-,11281
117,BUMA.1121.00005,1,2938415,2949696,-,11281
117,BUMA.1121.00101,1,1837473,1848740,-,11267
117,BUMA.1121.00065,1,687006,698330,+,11324
117,BUMA.1121.00100,1,669017,680290,-,11273
117,BUMA.1121.00105,1,557161,568457,-,11296
117,BUMA.1121.00029,1,247167,258455,-,11288
117,BUMA.1121.00066,1,629163,640442,+,11279
117,BUMA.1121.00031,1,2019152,2030480,+,11328
117,BUMA.1121.00108,1,1620309,1631589,+,11280
117,BUMA.1121.00023,1,2987390,2998704,+,11314
117,BUMA.1121.00035,1,1710939,1722228,+,11289
117,BUMA.1121.00041,1,1906762,1918042,+,11280
118,BUMA.1121.00057,1,1740188,1765628,+,25440
118,BUMA.1121.00058,1,3942226,3967770,-,25544
118,BUMA.1121.00045,1,3427907,3453281,-,25374
118,BUMA.1121.00051,1,646967,672408,+,25441
118,BUMA.1121.00068,1,3515722,3541181,+,25459
118,BUMA.1121.00061,1,663480,688920,+,25440
118,BUMA.1121.00060,1,1653577,1678951,-,25374
118,BUMA.1121.00064,1,686332,711825,+,25493
118,BUMA.1121.00016,1,2770701,2796255,+,25554
118,BUMA.1121.00003,1,3131635,3157046,+,25411
118,BUMA.1121.00055,1,224652,250067,+,25415
118,BUMA.1121.00011,1,963791,989242,-,25451
118,BUMA.1121.00037,1,3280609,3306113,+,25504
118,BUMA.1121.00009,1,914381,939947,-,25566
118,BUMA.1121.00069,1,624473,649926,+,25453
118,BUMA.1121.00088,1,1527628,1553079,+,25451
118,BUMA.1121.00092,1,3200023,3225420,-,25397
118,BUMA.1121.00074,1,3197290,3222781,-,25491
118,BUMA.1121.00070,1,634752,660203,+,25451
118,BUMA.1121.00093,1,1401005,1426403,+,25398
118,BUMA.1121.00063,1,660513,685925,+,25412
118,BUMA.1121.00033,1,2894211,2919757,+,25546
118,BUMA.1121.00018,1,1139718,1165108,+,25390
118,BUMA.1121.00080,1,684971,710413,+,25442
118,BUMA.1121.00027,1,2840078,2865473,+,25395
118,BUMA.1121.00053,1,365389,390837,+,25448
118,BUMA.1121.00059,1,3892570,3918015,+,25445
118,BUMA.1121.00043,1,632139,657704,+,25565
118,BUMA.1121.00056,1,3247333,3272774,-,25441
118,BUMA.1121.00112,1,2405802,2431349,-,25547
118,BUMA.1121.00091,1,3863697,3889221,-,25524
118,BUMA.1121.00047,1,2317060,2342500,-,25440
118,BUMA.1121.00067,1,3721000,3746516,-,25516
118,BUMA.1121.00110,1,112272,137813,-,25541
118,BUMA.1121.00073,1,661377,686828,+,25451
118,BUMA.1121.00072,1,635126,660580,+,25454
118,BUMA.1121.00077,1,3345594,3371188,+,25594
118,BUMA.1121.00082,1,717603,743043,+,25440
118,BUMA.1121.00062,1,3886862,3912301,-,25439
118,BUMA.1121.00007,1,3451727,3477107,-,25380
118,BUMA.1121.00025,1,2094760,2120149,-,25389
118,BUMA.1121.00021,1,1274600,1300207,+,25607
118,BUMA.1121.00103,1,3747099,3772644,-,25545
118,BUMA.1121.00096,1,2598377,2623937,-,25560
118,BUMA.1121.00079,1,676378,701922,+,25544
118,BUMA.1121.00039,1,750348,775851,+,25503
118,BUMA.1121.00083,1,961785,987224,-,25439
118,BUMA.1121.00084,1,875209,900660,+,25451
118,BUMA.1121.00049,1,1190073,1215513,-,25440
118,BUMA.1121.00089,1,652708,678150,+,25442
118,BUMA.1121.00014,1,2162699,2188262,-,25563
118,BUMA.1121.00090,1,2750019,2775626,+,25607
118,BUMA.1121.00071,1,661129,686566,+,25437
118,BUMA.1121.00078,1,1332487,1358012,-,25525
118,BUMA.1121.00102,1,553436,578865,-,25429
118,BUMA.1121.00075,1,152748,178230,+,25482
118,BUMA.1121.00012,1,3418859,3444362,+,25503
118,BUMA.1121.00076,1,701553,727037,-,25484
118,BUMA.1121.00106,1,419571,445117,+,25546
118,BUMA.1121.00001,1,3429352,3454958,-,25606
118,BUMA.1121.00107,1,494496,519940,+,25444
118,BUMA.1121.00104,1,618929,644357,-,25428
118,BUMA.1121.00099,1,1753662,1779163,-,25501
118,BUMA.1121.00098,1,3363402,3388847,+,25445
118,BUMA.1121.00111,1,786042,811594,+,25552
118,BUMA.1121.00109,1,1210309,1235844,-,25535
118,BUMA.1121.00097,1,3350779,3376335,-,25556
118,BUMA.1121.00094,1,636777,662220,+,25443
118,BUMA.1121.00095,1,1002553,1028105,-,25552
118,BUMA.1121.00005,1,2911558,2937026,-,25468
118,BUMA.1121.00101,1,1810649,1836098,-,25449
118,BUMA.1121.00065,1,699705,725160,+,25455
118,BUMA.1121.00100,1,642148,667627,-,25479
118,BUMA.1121.00105,1,530374,555771,-,25397
118,BUMA.1121.00029,1,220223,245777,-,25554
118,BUMA.1121.00066,1,641817,667268,+,25451
118,BUMA.1121.00031,1,2031869,2057408,+,25539
118,BUMA.1121.00108,1,1632978,1658430,+,25452
118,BUMA.1121.00023,1,3000093,3025710,+,25617
118,BUMA.1121.00035,1,1723617,1749172,+,25555
118,BUMA.1121.00041,1,1919417,1945080,+,25663
119,BUMA.1121.00057,1,1767271,1773801,+,6530
119,BUMA.1121.00058,1,3934052,3940583,-,6531
119,BUMA.1121.00045,1,3419733,3426264,-,6531
119,BUMA.1121.00051,1,674051,680581,+,6530
119,BUMA.1121.00068,1,3542824,3549354,+,6530
119,BUMA.1121.00061,1,690563,697093,+,6530
119,BUMA.1121.00060,1,1645403,1651934,-,6531
119,BUMA.1121.00064,1,713468,719998,+,6530
119,BUMA.1121.00016,1,2797898,2804428,+,6530
119,BUMA.1121.00003,1,3158689,3165219,+,6530
119,BUMA.1121.00055,1,251710,258240,+,6530
119,BUMA.1121.00011,1,955617,962148,-,6531
119,BUMA.1121.00037,1,3307756,3314257,+,6501
119,BUMA.1121.00009,1,906207,912738,-,6531
119,BUMA.1121.00069,1,651569,658099,+,6530
119,BUMA.1121.00088,1,1554722,1561252,+,6530
119,BUMA.1121.00092,1,3191849,3198380,-,6531
119,BUMA.1121.00074,1,3189116,3195647,-,6531
119,BUMA.1121.00070,1,661846,668376,+,6530
119,BUMA.1121.00093,1,1428046,1434576,+,6530
119,BUMA.1121.00063,1,687568,694098,+,6530
119,BUMA.1121.00033,1,2921400,2927930,+,6530
119,BUMA.1121.00018,1,1166751,1173281,+,6530
119,BUMA.1121.00080,1,712056,718586,+,6530
119,BUMA.1121.00027,1,2867116,2873646,+,6530
119,BUMA.1121.00053,1,392480,399010,+,6530
119,BUMA.1121.00059,1,3919658,3926188,+,6530
119,BUMA.1121.00043,1,659347,665877,+,6530
119,BUMA.1121.00056,1,3239159,3245690,-,6531
119,BUMA.1121.00112,1,2397615,2404159,-,6544
119,BUMA.1121.00091,1,3855523,3862054,-,6531
119,BUMA.1121.00047,1,2308886,2315417,-,6531
119,BUMA.1121.00067,1,3712826,3719357,-,6531
119,BUMA.1121.00110,1,104098,110629,-,6531
119,BUMA.1121.00073,1,688471,695001,+,6530
119,BUMA.1121.00072,1,662223,668753,+,6530
119,BUMA.1121.00077,1,3372831,3379361,+,6530
119,BUMA.1121.00082,1,744686,751216,+,6530
119,BUMA.1121.00062,1,3878688,3885219,-,6531
119,BUMA.1121.00007,1,3443553,3450084,-,6531
119,BUMA.1121.00025,1,2086586,2093117,-,6531
119,BUMA.1121.00021,1,1301850,1308381,+,6531
119,BUMA.1121.00103,1,3738925,3745456,-,6531
119,BUMA.1121.00096,1,2590203,2596734,-,6531
119,BUMA.1121.00079,1,703565,710095,+,6530
119,BUMA.1121.00039,1,796553,803083,+,6530
119,BUMA.1121.00083,1,953611,960142,-,6531
119,BUMA.1121.00084,1,902303,908833,+,6530
119,BUMA.1121.00049,1,1181899,1188430,-,6531
119,BUMA.1121.00089,1,679793,686323,+,6530
119,BUMA.1121.00014,1,2154554,2161056,-,6502
119,BUMA.1121.00090,1,2777269,2783799,+,6530
119,BUMA.1121.00071,1,688209,694739,+,6530
119,BUMA.1121.00078,1,1324313,1330844,-,6531
119,BUMA.1121.00102,1,545262,551793,-,6531
119,BUMA.1121.00075,1,179873,186414,+,6541
119,BUMA.1121.00012,1,3446005,3452536,+,6531
119,BUMA.1121.00076,1,693366,699910,-,6544
119,BUMA.1121.00106,1,446760,453290,+,6530
119,BUMA.1121.00001,1,3421178,3427709,-,6531
119,BUMA.1121.00107,1,521583,528113,+,6530
119,BUMA.1121.00104,1,610755,617286,-,6531
119,BUMA.1121.00099,1,1745488,1752019,-,6531
119,BUMA.1121.00098,1,3390490,3397020,+,6530
119,BUMA.1121.00111,1,813237,819767,+,6530
119,BUMA.1121.00109,1,1202135,1208666,-,6531
119,BUMA.1121.00097,1,3342605,3349136,-,6531
119,BUMA.1121.00094,1,663863,670393,+,6530
119,BUMA.1121.00095,1,994379,1000910,-,6531
119,BUMA.1121.00005,1,2903371,2909915,-,6544
119,BUMA.1121.00101,1,1802462,1809006,-,6544
119,BUMA.1121.00065,1,726803,733333,+,6530
119,BUMA.1121.00100,1,633974,640505,-,6531
119,BUMA.1121.00105,1,522200,528731,-,6531
119,BUMA.1121.00029,1,212049,218580,-,6531
119,BUMA.1121.00066,1,668911,675441,+,6530
119,BUMA.1121.00031,1,2059051,2065552,+,6501
119,BUMA.1121.00108,1,1660073,1666603,+,6530
119,BUMA.1121.00023,1,3027353,3033883,+,6530
119,BUMA.1121.00035,1,1750815,1757345,+,6530
119,BUMA.1121.00041,1,1946723,1953253,+,6530
120,BUMA.1121.00057,1,1777340,1804533,+,27193
120,BUMA.1121.00058,1,3903259,3930508,-,27249
120,BUMA.1121.00045,1,3388916,3416214,-,27298
120,BUMA.1121.00051,1,684140,711450,+,27310
120,BUMA.1121.00068,1,3552873,3580018,+,27145
120,BUMA.1121.00061,1,700627,727829,+,27202
120,BUMA.1121.00060,1,1614586,1641884,-,27298
120,BUMA.1121.00064,1,723542,750884,+,27342
120,BUMA.1121.00016,1,2808043,2835223,+,27180
120,BUMA.1121.00003,1,3168783,3196058,+,27275
120,BUMA.1121.00055,1,261794,289009,+,27215
120,BUMA.1121.00011,1,924714,952078,-,27364
120,BUMA.1121.00037,1,3317820,3345035,+,27215
120,BUMA.1121.00009,1,875381,902653,-,27272
120,BUMA.1121.00069,1,661633,688841,+,27208
120,BUMA.1121.00088,1,1564831,1592036,+,27205
120,BUMA.1121.00092,1,3161048,3188320,-,27272
120,BUMA.1121.00074,1,3158204,3185527,-,27323
120,BUMA.1121.00070,1,671910,699114,+,27204
120,BUMA.1121.00093,1,1438105,1465377,+,27272
120,BUMA.1121.00063,1,697632,724743,+,27111
120,BUMA.1121.00033,1,2931464,2958678,+,27214
120,BUMA.1121.00018,1,1176810,1204128,+,27318
120,BUMA.1121.00080,1,722160,749470,+,27310
120,BUMA.1121.00027,1,2877185,2904377,+,27192
120,BUMA.1121.00053,1,402569,429941,+,27372
120,BUMA.1121.00059,1,3929727,3957038,+,27311
120,BUMA.1121.00043,1,669406,696620,+,27214
120,BUMA.1121.00056,1,3208297,3235585,-,27288
120,BUMA.1121.00112,1,2366757,2394081,-,27324
120,BUMA.1121.00091,1,3824554,3851959,-,27405
120,BUMA.1121.00047,1,2278042,2305337,-,27295
120,BUMA.1121.00067,1,3682029,3709287,-,27258
120,BUMA.1121.00110,1,73201,100496,-,27295
120,BUMA.1121.00073,1,698535,725742,+,27207
120,BUMA.1121.00072,1,672287,699493,+,27206
120,BUMA.1121.00077,1,3382963,3410258,+,27295
120,BUMA.1121.00082,1,754750,781958,+,27208
120,BUMA.1121.00062,1,3847897,3875144,-,27247
120,BUMA.1121.00007,1,3412526,3439864,-,27338
120,BUMA.1121.00025,1,2055747,2083057,-,27310
120,BUMA.1121.00021,1,1311914,1339129,+,27215
120,BUMA.1121.00103,1,3708120,3735411,-,27291
120,BUMA.1121.00096,1,2559426,2586689,-,27263
120,BUMA.1121.00079,1,713689,740934,+,27245
120,BUMA.1121.00039,1,806622,833835,+,27213
120,BUMA.1121.00083,1,922869,950077,-,27208
120,BUMA.1121.00084,1,912352,939556,+,27204
120,BUMA.1121.00049,1,1151117,1178385,-,27268
120,BUMA.1121.00089,1,689897,717184,+,27287
120,BUMA.1121.00014,1,2123742,2150957,-,27215
120,BUMA.1121.00090,1,2787343,2814558,+,27215
120,BUMA.1121.00071,1,698273,725479,+,27206
120,BUMA.1121.00078,1,1293522,1320749,-,27227
120,BUMA.1121.00102,1,514400,541708,-,27308
120,BUMA.1121.00075,1,189978,217276,+,27298
120,BUMA.1121.00012,1,3456070,3483293,+,27223
120,BUMA.1121.00076,1,662508,689807,-,27299
120,BUMA.1121.00106,1,456844,484109,+,27265
120,BUMA.1121.00001,1,3390394,3417601,-,27207
120,BUMA.1121.00107,1,531677,558978,+,27301
120,BUMA.1121.00104,1,579934,607211,-,27277
120,BUMA.1121.00099,1,1714521,1741874,-,27353
120,BUMA.1121.00098,1,3400514,3427824,+,27310
120,BUMA.1121.00111,1,823297,850644,+,27347
120,BUMA.1121.00109,1,1171204,1198476,-,27272
120,BUMA.1121.00097,1,3311816,3339076,-,27260
120,BUMA.1121.00094,1,673952,701231,+,27279
120,BUMA.1121.00095,1,963587,990855,-,27268
120,BUMA.1121.00005,1,2872646,2899837,-,27191
120,BUMA.1121.00101,1,1771640,1798933,-,27293
120,BUMA.1121.00065,1,736867,764122,+,27255
120,BUMA.1121.00100,1,603199,630450,-,27251
120,BUMA.1121.00105,1,491379,518670,-,27291
120,BUMA.1121.00029,1,181305,208513,-,27208
120,BUMA.1121.00066,1,678975,706183,+,27208
120,BUMA.1121.00031,1,2069123,2096338,+,27215
120,BUMA.1121.00108,1,1670127,1697332,+,27205
120,BUMA.1121.00023,1,3037402,3064617,+,27215
120,BUMA.1121.00035,1,1760875,1788083,+,27208
120,BUMA.1121.00041,1,1956797,1984030,+,27233
121,BUMA.1121.00057,1,1804820,1821065,+,16245
121,BUMA.1121.00058,1,3886642,3902972,-,16330
121,BUMA.1121.00045,1,3372470,3388644,-,16174
121,BUMA.1121.00051,1,711737,727988,+,16251
121,BUMA.1121.00068,1,3580306,3596420,+,16114
121,BUMA.1121.00061,1,728117,744445,+,16328
121,BUMA.1121.00060,1,1598146,1614314,-,16168
121,BUMA.1121.00064,1,751175,767333,+,16158
121,BUMA.1121.00016,1,2835511,2851687,+,16176
121,BUMA.1121.00003,1,3196346,3212489,+,16143
121,BUMA.1121.00055,1,289296,305449,+,16153
121,BUMA.1121.00011,1,908137,924426,-,16289
121,BUMA.1121.00037,1,3345322,3361476,+,16154
121,BUMA.1121.00009,1,858845,875093,-,16248
121,BUMA.1121.00069,1,689129,705460,+,16331
121,BUMA.1121.00088,1,1592323,1608606,+,16283
121,BUMA.1121.00092,1,3144600,3160761,-,16161
121,BUMA.1121.00074,1,3141760,3157912,-,16152
121,BUMA.1121.00070,1,699402,715606,+,16204
121,BUMA.1121.00093,1,1465664,1481826,+,16162
121,BUMA.1121.00063,1,725031,741347,+,16316
121,BUMA.1121.00033,1,2958965,2975150,+,16185
121,BUMA.1121.00018,1,1204415,1220607,+,16192
121,BUMA.1121.00080,1,749757,766087,+,16330
121,BUMA.1121.00027,1,2904664,2920827,+,16163
121,BUMA.1121.00053,1,430232,446322,+,16090
121,BUMA.1121.00059,1,3957329,3973474,+,16145
121,BUMA.1121.00043,1,696908,713238,+,16330
121,BUMA.1121.00056,1,3191778,3208010,-,16232
121,BUMA.1121.00112,1,2350346,2366470,-,16124
121,BUMA.1121.00091,1,3808110,3824266,-,16156
121,BUMA.1121.00047,1,2261518,2277755,-,16237
121,BUMA.1121.00067,1,3665493,3681741,-,16248
121,BUMA.1121.00110,1,56679,72913,-,16234
121,BUMA.1121.00073,1,726030,742361,+,16331
121,BUMA.1121.00072,1,699781,716112,+,16331
121,BUMA.1121.00077,1,3410546,3426821,+,16275
121,BUMA.1121.00082,1,782246,798577,+,16331
121,BUMA.1121.00062,1,3831422,3847609,-,16187
121,BUMA.1121.00007,1,3396054,3412239,-,16185
121,BUMA.1121.00025,1,2039269,2055460,-,16191
121,BUMA.1121.00021,1,1339416,1355658,+,16242
121,BUMA.1121.00103,1,3691693,3707833,-,16140
121,BUMA.1121.00096,1,2542897,2559139,-,16242
121,BUMA.1121.00079,1,741221,757474,+,16253
121,BUMA.1121.00039,1,834122,850370,+,16248
121,BUMA.1121.00083,1,906217,922581,-,16364
121,BUMA.1121.00084,1,939843,956040,+,16197
121,BUMA.1121.00049,1,1133221,1149389,-,16168
121,BUMA.1121.00089,1,717471,733741,+,16270
121,BUMA.1121.00014,1,2107254,2123455,-,16201
121,BUMA.1121.00090,1,2814845,2831009,+,16164
121,BUMA.1121.00071,1,725767,741896,+,16129
121,BUMA.1121.00078,1,1277139,1293235,-,16096
121,BUMA.1121.00102,1,497845,514113,-,16268
121,BUMA.1121.00075,1,217564,233806,+,16242
121,BUMA.1121.00012,1,3483581,3499767,+,16186
121,BUMA.1121.00076,1,645939,662220,-,16281
121,BUMA.1121.00106,1,484397,500678,+,16281
121,BUMA.1121.00001,1,3373940,3390107,-,16167
121,BUMA.1121.00107,1,559265,575439,+,16174
121,BUMA.1121.00104,1,563389,579647,-,16258
121,BUMA.1121.00099,1,1698132,1714237,-,16105
121,BUMA.1121.00098,1,3428112,3444241,+,16129
121,BUMA.1121.00111,1,850931,867037,+,16106
121,BUMA.1121.00109,1,1154749,1170916,-,16167
121,BUMA.1121.00097,1,3295355,3311532,-,16177
121,BUMA.1121.00094,1,701518,717782,+,16264
121,BUMA.1121.00095,1,947145,963302,-,16157
121,BUMA.1121.00005,1,2856210,2872359,-,16149
121,BUMA.1121.00101,1,1755176,1771352,-,16176
121,BUMA.1121.00065,1,764409,780555,+,16146
121,BUMA.1121.00100,1,586739,602907,-,16168
121,BUMA.1121.00105,1,474924,491091,-,16167
121,BUMA.1121.00029,1,164857,181018,-,16161
121,BUMA.1121.00066,1,706471,722799,+,16328
121,BUMA.1121.00031,1,2096625,2112805,+,16180
121,BUMA.1121.00108,1,1697620,1713747,+,16127
121,BUMA.1121.00023,1,3064904,3081066,+,16162
121,BUMA.1121.00035,1,1788370,1804522,+,16152
121,BUMA.1121.00041,1,1985757,2001978,+,16221
122,BUMA.1121.00057,1,1821113,1829011,+,7898
122,BUMA.1121.00058,1,3878816,3886608,-,7792
122,BUMA.1121.00045,1,3364537,3372436,-,7899
122,BUMA.1121.00051,1,728036,735934,+,7898
122,BUMA.1121.00068,1,3596468,3604377,+,7909
122,BUMA.1121.00061,1,744467,752352,+,7885
122,BUMA.1121.00060,1,1590213,1598112,-,7899
122,BUMA.1121.00064,1,767355,775287,+,7932
122,BUMA.1121.00016,1,2851709,2859642,+,7933
122,BUMA.1121.00003,1,3212513,3220426,+,7913
122,BUMA.1121.00055,1,305471,313365,+,7894
122,BUMA.1121.00011,1,900279,908103,-,7824
122,BUMA.1121.00037,1,3361498,3369422,+,7924
122,BUMA.1121.00009,1,850993,858823,-,7830
122,BUMA.1121.00069,1,705508,713350,+,7842
122,BUMA.1121.00088,1,1608628,1616551,+,7923
122,BUMA.1121.00092,1,3136637,3144566,-,7929
122,BUMA.1121.00074,1,3133806,3141726,-,7920
122,BUMA.1121.00070,1,715654,723510,+,7856
122,BUMA.1121.00093,1,1481848,1489789,+,7941
122,BUMA.1121.00063,1,741395,749237,+,7842
122,BUMA.1121.00033,1,2975172,2983112,+,7940
122,BUMA.1121.00018,1,1220629,1228552,+,7923
122,BUMA.1121.00080,1,766135,774042,+,7907
122,BUMA.1121.00027,1,2920852,2928681,+,7829
122,BUMA.1121.00053,1,446345,454274,+,7929
122,BUMA.1121.00059,1,3973496,3981385,+,7889
122,BUMA.1121.00043,1,713260,721192,+,7932
122,BUMA.1121.00056,1,3183876,3191756,-,7880
122,BUMA.1121.00112,1,2342404,2350324,-,7920
122,BUMA.1121.00091,1,3800159,3808076,-,7917
122,BUMA.1121.00047,1,2253589,2261496,-,7907
122,BUMA.1121.00067,1,3656093,3663981,-,7888
122,BUMA.1121.00110,1,48744,56645,-,7901
122,BUMA.1121.00073,1,742409,750266,+,7857
122,BUMA.1121.00072,1,716160,724033,+,7873
122,BUMA.1121.00077,1,3426843,3434756,+,7913
122,BUMA.1121.00082,1,798625,806514,+,7889
122,BUMA.1121.00062,1,3823555,3831388,-,7833
122,BUMA.1121.00007,1,3388174,3396032,-,7858
122,BUMA.1121.00025,1,2031324,2039235,-,7911
122,BUMA.1121.00021,1,1355680,1363612,+,7932
122,BUMA.1121.00103,1,3683840,3691671,-,7831
122,BUMA.1121.00096,1,2534969,2542875,-,7906
122,BUMA.1121.00079,1,757521,765432,+,7911
122,BUMA.1121.00039,1,850392,858313,+,7921
122,BUMA.1121.00083,1,898306,906195,-,7889
122,BUMA.1121.00084,1,956062,963985,+,7923
122,BUMA.1121.00049,1,1125279,1133187,-,7908
122,BUMA.1121.00089,1,733790,741670,+,7880
122,BUMA.1121.00014,1,2099309,2107220,-,7911
122,BUMA.1121.00090,1,2831031,2838999,+,7968
122,BUMA.1121.00071,1,741944,749829,+,7885
122,BUMA.1121.00078,1,1269201,1277104,-,7903
122,BUMA.1121.00102,1,489940,497811,-,7871
122,BUMA.1121.00075,1,233828,241751,+,7923
122,BUMA.1121.00012,1,3499789,3507713,+,7924
122,BUMA.1121.00076,1,637994,645905,-,7911
122,BUMA.1121.00106,1,500726,508637,+,7911
122,BUMA.1121.00001,1,3366055,3373906,-,7851
122,BUMA.1121.00107,1,575461,583400,+,7939
122,BUMA.1121.00104,1,555456,563367,-,7911
122,BUMA.1121.00099,1,1690218,1698122,-,7904
122,BUMA.1121.00098,1,3444281,3452137,+,7856
122,BUMA.1121.00111,1,867059,874963,+,7904
122,BUMA.1121.00109,1,1146840,1154727,-,7887
122,BUMA.1121.00097,1,3287481,3295333,-,7852
122,BUMA.1121.00094,1,717830,725719,+,7889
122,BUMA.1121.00095,1,939232,947123,-,7891
122,BUMA.1121.00005,1,2848256,2856176,-,7920
122,BUMA.1121.00101,1,1747230,1755154,-,7924
122,BUMA.1121.00065,1,780577,788484,+,7907
122,BUMA.1121.00100,1,578786,586717,-,7931
122,BUMA.1121.00105,1,467058,474890,-,7832
122,BUMA.1121.00029,1,156934,164823,-,7889
122,BUMA.1121.00066,1,722841,730659,+,7818
122,BUMA.1121.00031,1,2112826,2120749,+,7923
122,BUMA.1121.00108,1,1713795,1721728,+,7933
122,BUMA.1121.00023,1,3081088,3089011,+,7923
122,BUMA.1121.00035,1,1804544,1812445,+,7901
122,BUMA.1121.00041,1,2002000,2009848,+,7848
123,BUMA.1121.00057,1,1829761,1848386,+,18625
123,BUMA.1121.00058,1,3859450,3878065,-,18615
123,BUMA.1121.00045,1,3345201,3363786,-,18585
123,BUMA.1121.00051,1,736684,755311,+,18627
123,BUMA.1121.00068,1,3605127,3623711,+,18584
123,BUMA.1121.00061,1,753106,771737,+,18631
123,BUMA.1121.00060,1,1570877,1589462,-,18585
123,BUMA.1121.00064,1,776037,794666,+,18629
123,BUMA.1121.00016,1,2860392,2878996,+,18604
123,BUMA.1121.00003,1,3221176,3239792,+,18616
123,BUMA.1121.00055,1,314115,332746,+,18631
123,BUMA.1121.00011,1,880941,899528,-,18587
123,BUMA.1121.00037,1,3370172,3388785,+,18613
123,BUMA.1121.00009,1,831664,850242,-,18578
123,BUMA.1121.00069,1,714116,732733,+,18617
123,BUMA.1121.00088,1,1617301,1635913,+,18612
123,BUMA.1121.00092,1,3117285,3135886,-,18601
123,BUMA.1121.00074,1,3114441,3133055,-,18614
123,BUMA.1121.00070,1,724260,742891,+,18631
123,BUMA.1121.00093,1,1490539,1509155,+,18616
123,BUMA.1121.00063,1,749987,768596,+,18609
123,BUMA.1121.00033,1,2985459,3004072,+,18613
123,BUMA.1121.00018,1,1229302,1247926,+,18624
123,BUMA.1121.00080,1,774792,793418,+,18626
123,BUMA.1121.00027,1,2929431,2948044,+,18613
123,BUMA.1121.00053,1,455024,473657,+,18633
123,BUMA.1121.00059,1,3982135,4000765,+,18630
123,BUMA.1121.00043,1,721942,740551,+,18609
123,BUMA.1121.00056,1,3164513,3183125,-,18612
123,BUMA.1121.00112,1,2323040,2341653,-,18613
123,BUMA.1121.00091,1,3780815,3799408,-,18593
123,BUMA.1121.00047,1,2234226,2252838,-,18612
123,BUMA.1121.00067,1,3636744,3655342,-,18598
123,BUMA.1121.00110,1,29383,47993,-,18610
123,BUMA.1121.00073,1,751016,769647,+,18631
123,BUMA.1121.00072,1,724799,743430,+,18631
123,BUMA.1121.00077,1,3435506,3454140,+,18634
123,BUMA.1121.00082,1,807264,825895,+,18631
123,BUMA.1121.00062,1,3804173,3822804,-,18631
123,BUMA.1121.00007,1,3368819,3387423,-,18604
123,BUMA.1121.00025,1,2011964,2030573,-,18609
123,BUMA.1121.00021,1,1364362,1382883,+,18521
123,BUMA.1121.00103,1,3664504,3683089,-,18585
123,BUMA.1121.00096,1,2515595,2534203,-,18608
123,BUMA.1121.00079,1,766182,784813,+,18631
123,BUMA.1121.00039,1,859063,877676,+,18613
123,BUMA.1121.00083,1,878939,897555,-,18616
123,BUMA.1121.00084,1,964735,983347,+,18612
123,BUMA.1121.00049,1,1105918,1124528,-,18610
123,BUMA.1121.00089,1,742420,761047,+,18627
123,BUMA.1121.00014,1,2079960,2098558,-,18598
123,BUMA.1121.00090,1,2839749,2858362,+,18613
123,BUMA.1121.00071,1,750583,769214,+,18631
123,BUMA.1121.00078,1,1249851,1268450,-,18599
123,BUMA.1121.00102,1,470571,489174,-,18603
123,BUMA.1121.00075,1,242500,261118,+,18618
123,BUMA.1121.00012,1,3508463,3527059,+,18596
123,BUMA.1121.00076,1,618639,637243,-,18604
123,BUMA.1121.00106,1,509387,527994,+,18607
123,BUMA.1121.00001,1,3346715,3365304,-,18589
123,BUMA.1121.00107,1,584150,602762,+,18612
123,BUMA.1121.00104,1,536100,554705,-,18605
123,BUMA.1121.00099,1,1670850,1689463,-,18613
123,BUMA.1121.00098,1,3452887,3471513,+,18626
123,BUMA.1121.00111,1,875713,894335,+,18622
123,BUMA.1121.00109,1,1127480,1146089,-,18609
123,BUMA.1121.00097,1,3268114,3286730,-,18616
123,BUMA.1121.00094,1,726469,745088,+,18619
123,BUMA.1121.00095,1,919883,938481,-,18598
123,BUMA.1121.00005,1,2828961,2847505,-,18544
123,BUMA.1121.00101,1,1727877,1746479,-,18602
123,BUMA.1121.00065,1,789250,807862,+,18612
123,BUMA.1121.00100,1,559467,578035,-,18568
123,BUMA.1121.00105,1,447697,466307,-,18610
123,BUMA.1121.00029,1,137594,156183,-,18589
123,BUMA.1121.00066,1,731409,750040,+,18631
123,BUMA.1121.00031,1,2121499,2140112,+,18613
123,BUMA.1121.00108,1,1722478,1741087,+,18609
123,BUMA.1121.00023,1,3089761,3108378,+,18617
123,BUMA.1121.00035,1,1813195,1831799,+,18604
123,BUMA.1121.00041,1,2010598,2029200,+,18602
124,BUMA.1121.00057,1,1853862,1872742,+,18880
124,BUMA.1121.00058,1,3835220,3854046,-,18826
124,BUMA.1121.00045,1,3320945,3339822,-,18877
124,BUMA.1121.00051,1,760821,779675,+,18854
124,BUMA.1121.00068,1,3629187,3648074,+,18887
124,BUMA.1121.00061,1,777154,795946,+,18792
124,BUMA.1121.00060,1,1546558,1565435,-,18877
124,BUMA.1121.00064,1,800070,818947,+,18877
124,BUMA.1121.00016,1,2884426,2903273,+,18847
124,BUMA.1121.00003,1,3245322,3264300,+,18978
124,BUMA.1121.00055,1,338274,357066,+,18792
124,BUMA.1121.00011,1,856530,875451,-,18921
124,BUMA.1121.00037,1,3394243,3413182,+,18939
124,BUMA.1121.00009,1,807285,826199,-,18914
124,BUMA.1121.00069,1,738191,756961,+,18770
124,BUMA.1121.00088,1,1641416,1660309,+,18893
124,BUMA.1121.00092,1,3092935,3111813,-,18878
124,BUMA.1121.00074,1,3089942,3108825,-,18883
124,BUMA.1121.00070,1,748323,767115,+,18792
124,BUMA.1121.00093,1,1514622,1533500,+,18878
124,BUMA.1121.00063,1,774012,792800,+,18788
124,BUMA.1121.00033,1,3009529,3028416,+,18887
124,BUMA.1121.00018,1,1253375,1272315,+,18940
124,BUMA.1121.00080,1,798828,817688,+,18860
124,BUMA.1121.00027,1,2953487,2972361,+,18874
124,BUMA.1121.00053,1,479246,498132,+,18886
124,BUMA.1121.00059,1,2212,21077,+,18865
124,BUMA.1121.00043,1,746378,765220,+,18842
124,BUMA.1121.00056,1,3140130,3158978,-,18848
124,BUMA.1121.00112,1,2298761,2317595,-,18834
124,BUMA.1121.00091,1,3756308,3775221,-,18913
124,BUMA.1121.00047,1,2209870,2228664,-,18794
124,BUMA.1121.00067,1,3612430,3631290,-,18860
124,BUMA.1121.00110,1,10479,29331,-,18852
124,BUMA.1121.00073,1,775077,793869,+,18792
124,BUMA.1121.00072,1,748841,767633,+,18792
124,BUMA.1121.00077,1,3454169,3473021,+,18852
124,BUMA.1121.00082,1,831344,850136,+,18792
124,BUMA.1121.00062,1,3779807,3798701,-,18894
124,BUMA.1121.00007,1,3344338,3363384,-,19046
124,BUMA.1121.00025,1,1987557,2006502,-,18945
124,BUMA.1121.00021,1,1388323,1407228,+,18905
124,BUMA.1121.00103,1,3640256,3659227,-,18971
124,BUMA.1121.00096,1,2491204,2510123,-,18919
124,BUMA.1121.00079,1,790411,809242,+,18831
124,BUMA.1121.00039,1,883161,902016,+,18855
124,BUMA.1121.00083,1,854684,873476,-,18792
124,BUMA.1121.00084,1,988832,1007606,+,18774
124,BUMA.1121.00049,1,1081612,1100491,-,18879
124,BUMA.1121.00089,1,766613,785461,+,18848
124,BUMA.1121.00014,1,2055528,2074419,-,18891
124,BUMA.1121.00090,1,2863784,2882679,+,18895
124,BUMA.1121.00071,1,774663,793455,+,18792
124,BUMA.1121.00078,1,1225286,1244286,-,19000
124,BUMA.1121.00102,1,446212,465072,-,18860
124,BUMA.1121.00075,1,266629,285510,+,18881
124,BUMA.1121.00012,1,3532475,3551019,+,18544
124,BUMA.1121.00076,1,594274,613149,-,18875
124,BUMA.1121.00106,1,533389,552217,+,18828
124,BUMA.1121.00001,1,3322279,3341153,-,18874
124,BUMA.1121.00107,1,608153,627000,+,18847
124,BUMA.1121.00104,1,511932,530832,-,18900
124,BUMA.1121.00099,1,1646536,1665468,-,18932
124,BUMA.1121.00098,1,3476967,3495769,+,18802
124,BUMA.1121.00111,1,899874,918840,+,18966
124,BUMA.1121.00109,1,1103036,1121954,-,18918
124,BUMA.1121.00097,1,3243718,3262570,-,18852
124,BUMA.1121.00094,1,750654,769502,+,18848
124,BUMA.1121.00095,1,895575,914404,-,18829
124,BUMA.1121.00005,1,2804659,2823511,-,18852
124,BUMA.1121.00101,1,1703466,1722331,-,18865
124,BUMA.1121.00065,1,813275,832110,+,18835
124,BUMA.1121.00100,1,535090,553950,-,18860
124,BUMA.1121.00105,1,423430,442279,-,18849
124,BUMA.1121.00029,1,113146,132067,-,18921
124,BUMA.1121.00066,1,755489,774281,+,18792
124,BUMA.1121.00031,1,2145551,2164448,+,18897
124,BUMA.1121.00108,1,1746461,1765377,+,18916
124,BUMA.1121.00023,1,3113881,3132755,+,18874
124,BUMA.1121.00035,1,1837222,1856132,+,18910
124,BUMA.1121.00041,1,2034699,2053606,+,18907
125,BUMA.1121.00057,1,1883244,1893255,+,10011
125,BUMA.1121.00058,1,3812104,3822115,-,10011
125,BUMA.1121.00045,1,3267655,3277666,-,10011
125,BUMA.1121.00051,1,798898,808907,+,10009
125,BUMA.1121.00068,1,3663881,3673893,+,10012
125,BUMA.1121.00061,1,806468,816479,+,10011
125,BUMA.1121.00060,1,1493268,1503279,-,10011
125,BUMA.1121.00064,1,830660,840671,+,10011
125,BUMA.1121.00016,1,2908796,2918809,+,10013
125,BUMA.1121.00003,1,3281844,3291855,+,10011
125,BUMA.1121.00055,1,371383,381393,+,10010
125,BUMA.1121.00011,1,792763,802774,-,10011
125,BUMA.1121.00037,1,3426178,3436191,+,10013
125,BUMA.1121.00009,1,779755,789766,-,10011
125,BUMA.1121.00069,1,759383,769394,+,10011
125,BUMA.1121.00088,1,1672024,1682035,+,10011
125,BUMA.1121.00092,1,3072029,3082040,-,10011
125,BUMA.1121.00074,1,3068217,3078229,-,10012
125,BUMA.1121.00070,1,777638,787649,+,10011
125,BUMA.1121.00093,1,1544395,1554405,+,10010
125,BUMA.1121.00063,1,803321,813332,+,10011
125,BUMA.1121.00033,1,3033941,3043950,+,10009
125,BUMA.1121.00018,1,1341583,1351602,+,10019
125,BUMA.1121.00080,1,827358,837368,+,10010
125,BUMA.1121.00027,1,2982863,2992872,+,10009
125,BUMA.1121.00053,1,509847,519857,+,10010
125,BUMA.1121.00059,1,32790,42816,+,10026
125,BUMA.1121.00043,1,770745,780756,+,10011
125,BUMA.1121.00056,1,3119617,3129628,-,10011
125,BUMA.1121.00112,1,2271230,2281242,-,10012
125,BUMA.1121.00091,1,3740770,3750781,-,10011
125,BUMA.1121.00047,1,2190189,2200200,-,10011
125,BUMA.1121.00067,1,3590706,3600717,-,10011
125,BUMA.1121.00110,1,3998707,4008719,-,10012
125,BUMA.1121.00073,1,804392,814403,+,10011
125,BUMA.1121.00072,1,770302,780313,+,10011
125,BUMA.1121.00077,1,3483527,3493537,+,10010
125,BUMA.1121.00082,1,900333,910344,+,10011
125,BUMA.1121.00062,1,3756691,3766702,-,10011
125,BUMA.1121.00007,1,3329858,3339860,-,10002
125,BUMA.1121.00025,1,1908269,1918289,-,10020
125,BUMA.1121.00021,1,1412753,1422764,+,10011
125,BUMA.1121.00103,1,3615821,3625832,-,10011
125,BUMA.1121.00096,1,2468063,2478075,-,10012
125,BUMA.1121.00079,1,820954,830963,+,10009
125,BUMA.1121.00039,1,907541,917552,+,10011
125,BUMA.1121.00083,1,794475,804487,-,10012
125,BUMA.1121.00084,1,1019321,1029332,+,10011
125,BUMA.1121.00049,1,1050823,1060834,-,10011
125,BUMA.1121.00089,1,795963,805973,+,10010
125,BUMA.1121.00014,1,2029913,2039925,-,10012
125,BUMA.1121.00090,1,2888204,2898215,+,10011
125,BUMA.1121.00071,1,796258,806269,+,10011
125,BUMA.1121.00078,1,1202169,1212180,-,10011
125,BUMA.1121.00102,1,430675,440687,-,10012
125,BUMA.1121.00075,1,303030,313039,+,10009
125,BUMA.1121.00012,1,3568466,3578479,+,10013
125,BUMA.1121.00076,1,566742,576753,-,10011
125,BUMA.1121.00106,1,565322,575333,+,10011
125,BUMA.1121.00001,1,3306705,3316713,-,10008
125,BUMA.1121.00107,1,639525,649536,+,10011
125,BUMA.1121.00104,1,488813,498825,-,10012
125,BUMA.1121.00099,1,1574609,1584621,-,10012
125,BUMA.1121.00098,1,3513297,3523308,+,10011
125,BUMA.1121.00111,1,924365,934375,+,10010
125,BUMA.1121.00109,1,1085420,1095424,-,10004
125,BUMA.1121.00097,1,3216188,3226198,-,10010
125,BUMA.1121.00094,1,780004,790013,+,10009
125,BUMA.1121.00095,1,871229,881241,-,10012
125,BUMA.1121.00005,1,2781685,2791696,-,10011
125,BUMA.1121.00101,1,1679694,1689701,-,10007
125,BUMA.1121.00065,1,842612,852622,+,10010
125,BUMA.1121.00100,1,511977,521992,-,10015
125,BUMA.1121.00105,1,400313,410325,-,10012
125,BUMA.1121.00029,1,97569,107580,-,10011
125,BUMA.1121.00066,1,780367,790378,+,10011
125,BUMA.1121.00031,1,2178779,2188790,+,10011
125,BUMA.1121.00108,1,1782895,1792905,+,10010
125,BUMA.1121.00023,1,3147086,3157099,+,10013
125,BUMA.1121.00035,1,1861698,1871708,+,10010
125,BUMA.1121.00041,1,2064108,2074135,+,10027
126,BUMA.1121.00057,1,1896296,1930279,+,33983
126,BUMA.1121.00058,1,3773750,3809060,-,35310
126,BUMA.1121.00045,1,3230693,3264640,-,33947
126,BUMA.1121.00051,1,811945,845946,+,34001
126,BUMA.1121.00068,1,3676881,3711064,+,34183
126,BUMA.1121.00061,1,819524,853523,+,33999
126,BUMA.1121.00060,1,1456306,1490253,-,33947
126,BUMA.1121.00064,1,843659,877764,+,34105
126,BUMA.1121.00016,1,2921937,2956034,+,34097
126,BUMA.1121.00003,1,3294837,3328825,+,33988
126,BUMA.1121.00055,1,385879,419923,+,34044
126,BUMA.1121.00011,1,755799,789782,-,33983
126,BUMA.1121.00037,1,3439249,3473277,+,34028
126,BUMA.1121.00009,1,742593,776774,-,34181
126,BUMA.1121.00069,1,772431,806363,+,33932
126,BUMA.1121.00088,1,1685066,1719079,+,34013
126,BUMA.1121.00092,1,3035008,3069041,-,34033
126,BUMA.1121.00074,1,3031136,3065230,-,34094
126,BUMA.1121.00070,1,790694,824639,+,33945
126,BUMA.1121.00093,1,1557394,1591420,+,34026
126,BUMA.1121.00063,1,816373,850374,+,34001
126,BUMA.1121.00033,1,3047028,3081026,+,33998
126,BUMA.1121.00018,1,1354681,1388666,+,33985
126,BUMA.1121.00080,1,840406,874414,+,34008
126,BUMA.1121.00027,1,2995940,3029988,+,34048
126,BUMA.1121.00053,1,522853,556886,+,34033
126,BUMA.1121.00059,1,47115,81100,+,33985
126,BUMA.1121.00043,1,783842,817860,+,34018
126,BUMA.1121.00056,1,3082573,3116608,-,34035
126,BUMA.1121.00112,1,2234136,2268172,-,34036
126,BUMA.1121.00091,1,3703726,3737775,-,34049
126,BUMA.1121.00047,1,2153049,2187152,-,34103
126,BUMA.1121.00067,1,3553624,3587676,-,34052
126,BUMA.1121.00110,1,3961734,3995712,-,33978
126,BUMA.1121.00073,1,817448,851393,+,33945
126,BUMA.1121.00072,1,783358,817356,+,33998
126,BUMA.1121.00077,1,3496533,3530539,+,34006
126,BUMA.1121.00082,1,913389,947411,+,34022
126,BUMA.1121.00062,1,3719611,3753661,-,34050
126,BUMA.1121.00007,1,3292939,3326877,-,33938
126,BUMA.1121.00025,1,1871198,1905190,-,33992
126,BUMA.1121.00021,1,1425844,1459788,+,33944
126,BUMA.1121.00103,1,3578837,3612805,-,33968
126,BUMA.1121.00096,1,2431027,2465030,-,34003
126,BUMA.1121.00079,1,833951,868023,+,34072
126,BUMA.1121.00039,1,920554,954515,+,33961
126,BUMA.1121.00083,1,757408,791431,-,34023
126,BUMA.1121.00084,1,1032377,1066416,+,34039
126,BUMA.1121.00049,1,1013768,1047786,-,34018
126,BUMA.1121.00089,1,808983,843077,+,34094
126,BUMA.1121.00014,1,1992826,2026905,-,34079
126,BUMA.1121.00090,1,2901224,2935212,+,33988
126,BUMA.1121.00071,1,809314,843333,+,34019
126,BUMA.1121.00078,1,1165146,1199160,-,34014
126,BUMA.1121.00102,1,393544,427680,-,34136
126,BUMA.1121.00075,1,316056,350048,+,33992
126,BUMA.1121.00012,1,3581551,3615559,+,34008
126,BUMA.1121.00076,1,529688,563726,-,34038
126,BUMA.1121.00106,1,578371,612429,+,34058
126,BUMA.1121.00001,1,3269561,3303620,-,34059
126,BUMA.1121.00107,1,652553,686690,+,34137
126,BUMA.1121.00104,1,451764,485776,-,34012
126,BUMA.1121.00099,1,1537595,1571621,-,34026
126,BUMA.1121.00098,1,3526304,3560281,+,33977
126,BUMA.1121.00111,1,937433,971549,+,34116
126,BUMA.1121.00109,1,1048418,1082411,-,33993
126,BUMA.1121.00097,1,3179221,3213172,-,33951
126,BUMA.1121.00094,1,793023,827126,+,34103
126,BUMA.1121.00095,1,834324,868234,-,33910
126,BUMA.1121.00005,1,2744698,2778656,-,33958
126,BUMA.1121.00101,1,1642748,1676713,-,33965
126,BUMA.1121.00065,1,855632,889543,+,33911
126,BUMA.1121.00100,1,474955,508982,-,34027
126,BUMA.1121.00105,1,363290,397311,-,34021
126,BUMA.1121.00029,1,60484,94477,-,33993
126,BUMA.1121.00066,1,793416,827412,+,33996
126,BUMA.1121.00031,1,2191799,2225785,+,33986
126,BUMA.1121.00108,1,1795887,1829855,+,33968
126,BUMA.1121.00023,1,3160115,3194131,+,34016
126,BUMA.1121.00035,1,1874787,1908732,+,33945
126,BUMA.1121.00041,1,2078470,2112473,+,34003
127,BUMA.1121.00057,1,1931786,1961635,+,29849
127,BUMA.1121.00058,1,3742404,3772244,-,29840
127,BUMA.1121.00045,1,3199348,3229187,-,29839
127,BUMA.1121.00051,1,847453,877404,+,29951
127,BUMA.1121.00068,1,3712568,3742484,+,29916
127,BUMA.1121.00061,1,855030,884819,+,29789
127,BUMA.1121.00060,1,1424961,1454800,-,29839
127,BUMA.1121.00064,1,879274,909121,+,29847
127,BUMA.1121.00016,1,2957544,2987382,+,29838
127,BUMA.1121.00003,1,3330332,3360432,+,30100
127,BUMA.1121.00055,1,421430,451269,+,29839
127,BUMA.1121.00011,1,724476,754290,-,29814
127,BUMA.1121.00037,1,3474787,3504617,+,29830
127,BUMA.1121.00009,1,711255,741093,-,29838
127,BUMA.1121.00069,1,807870,837686,+,29816
127,BUMA.1121.00088,1,1720589,1750407,+,29818
127,BUMA.1121.00092,1,3003684,3033502,-,29818
127,BUMA.1121.00074,1,2999772,3029627,-,29855
127,BUMA.1121.00070,1,826146,855937,+,29791
127,BUMA.1121.00093,1,1592927,1622744,+,29817
127,BUMA.1121.00063,1,851881,881697,+,29816
127,BUMA.1121.00033,1,3082536,3112361,+,29825
127,BUMA.1121.00018,1,1390176,1419992,+,29816
127,BUMA.1121.00080,1,875921,905883,+,29962
127,BUMA.1121.00027,1,3031495,3061318,+,29823
127,BUMA.1121.00053,1,558393,588317,+,29924
127,BUMA.1121.00059,1,82610,112447,+,29837
127,BUMA.1121.00043,1,819367,849233,+,29866
127,BUMA.1121.00056,1,3051156,3081067,-,29911
127,BUMA.1121.00112,1,2202832,2232636,-,29804
127,BUMA.1121.00091,1,3672340,3702220,-,29880
127,BUMA.1121.00047,1,2121622,2151543,-,29921
127,BUMA.1121.00067,1,3522088,3552115,-,30027
127,BUMA.1121.00110,1,3930475,3960228,-,29753
127,BUMA.1121.00073,1,852900,882689,+,29789
127,BUMA.1121.00072,1,818857,848644,+,29787
127,BUMA.1121.00077,1,3532046,3561801,+,29755
127,BUMA.1121.00082,1,948921,978762,+,29841
127,BUMA.1121.00062,1,3688256,3718105,-,29849
127,BUMA.1121.00007,1,3261580,3291433,-,29853
127,BUMA.1121.00025,1,1839871,1869689,-,29818
127,BUMA.1121.00021,1,1461298,1491146,+,29848
127,BUMA.1121.00103,1,3547472,3577331,-,29859
127,BUMA.1121.00096,1,2399694,2429521,-,29827
127,BUMA.1121.00079,1,869533,899358,+,29825
127,BUMA.1121.00039,1,956025,985849,+,29824
127,BUMA.1121.00083,1,726057,755899,-,29842
127,BUMA.1121.00084,1,1067926,1097780,+,29854
127,BUMA.1121.00049,1,982453,1012262,-,29809
127,BUMA.1121.00089,1,844584,874495,+,29911
127,BUMA.1121.00014,1,1961486,1991317,-,29831
127,BUMA.1121.00090,1,2936722,2966576,+,29854
127,BUMA.1121.00071,1,844836,874649,+,29813
127,BUMA.1121.00078,1,1133782,1163637,-,29855
127,BUMA.1121.00102,1,362240,392038,-,29798
127,BUMA.1121.00075,1,351555,381409,+,29854
127,BUMA.1121.00012,1,3617069,3646896,+,29827
127,BUMA.1121.00076,1,498326,528182,-,29856
127,BUMA.1121.00106,1,613939,643794,+,29855
127,BUMA.1121.00001,1,3238196,3268052,-,29856
127,BUMA.1121.00107,1,688200,717896,+,29696
127,BUMA.1121.00104,1,420483,450255,-,29772
127,BUMA.1121.00099,1,1506286,1536125,-,29839
127,BUMA.1121.00098,1,3561788,3591596,+,29808
127,BUMA.1121.00111,1,973059,1002904,+,29845
127,BUMA.1121.00109,1,1017082,1046912,-,29830
127,BUMA.1121.00097,1,3147838,3177715,-,29877
127,BUMA.1121.00094,1,828636,858519,+,29883
127,BUMA.1121.00095,1,803007,832818,-,29811
127,BUMA.1121.00005,1,2713343,2743189,-,29846
127,BUMA.1121.00101,1,1611363,1641242,-,29879
127,BUMA.1121.00065,1,891050,920936,+,29886
127,BUMA.1121.00100,1,443608,473449,-,29841
127,BUMA.1121.00105,1,331934,361781,-,29847
127,BUMA.1121.00029,1,29137,58975,-,29838
127,BUMA.1121.00066,1,828919,858735,+,29816
127,BUMA.1121.00031,1,2227295,2257125,+,29830
127,BUMA.1121.00108,1,1831362,1861217,+,29855
127,BUMA.1121.00023,1,3195641,3225484,+,29843
127,BUMA.1121.00035,1,1910242,1940101,+,29859
127,BUMA.1121.00041,1,2113980,2143828,+,29848
258,BUMA.1121.00058,1,1968638,1972308,+,3670
258,BUMA.1121.00112,1,375816,379483,+,3667
258,BUMA.1121.00014,1,195533,199178,+,3645
259,BUMA.1121.00058,1,2123867,2127777,+,3910
259,BUMA.1121.00016,1,554162,558070,-,3908
259,BUMA.1121.00092,1,1367378,1371287,+,3909
259,BUMA.1121.00093,1,3254995,3258903,-,3908
259,BUMA.1121.00033,1,627495,631392,-,3897
259,BUMA.1121.00053,1,2153144,2157052,-,3908
259,BUMA.1121.00043,1,2513159,2517067,-,3908
259,BUMA.1121.00110,1,2363411,2367320,+,3909
259,BUMA.1121.00077,1,1115916,1119824,-,3908
259,BUMA.1121.00090,1,528824,532732,-,3908
259,BUMA.1121.00078,1,3604965,3608874,+,3909
259,BUMA.1121.00102,1,2887676,2891585,+,3909
259,BUMA.1121.00095,1,3260940,3264849,+,3909
259,BUMA.1121.00005,1,1157121,1161029,-,3908
259,BUMA.1121.00101,1,38325,42231,+,3906
259,BUMA.1121.00029,1,2517171,2521079,+,3908
259,BUMA.1121.00041,1,3737904,3741812,-,3908
260,BUMA.1121.00058,1,2991489,2994695,+,3206
260,BUMA.1121.00045,1,2483017,2486223,+,3206
260,BUMA.1121.00068,1,325368,328574,-,3206
260,BUMA.1121.00060,1,708760,711966,+,3206
260,BUMA.1121.00016,1,3773097,3776303,-,3206
260,BUMA.1121.00009,1,19339,22545,+,3206
260,BUMA.1121.00033,1,3872330,3875520,-,3190
260,BUMA.1121.00018,1,2166993,2170199,-,3206
260,BUMA.1121.00043,1,1679971,1683177,-,3206
260,BUMA.1121.00112,1,1437659,1440865,+,3206
260,BUMA.1121.00062,1,2991595,2994801,+,3206
260,BUMA.1121.00007,1,2488836,2492042,+,3206
260,BUMA.1121.00025,1,1089589,1092795,+,3206
260,BUMA.1121.00021,1,2225739,2228945,-,3206
260,BUMA.1121.00103,1,2837455,2840661,+,3206
260,BUMA.1121.00096,1,1701873,1705079,+,3206
260,BUMA.1121.00039,1,1712337,1715543,-,3206
260,BUMA.1121.00014,1,1188670,1191876,+,3206
260,BUMA.1121.00090,1,3766460,3769665,-,3205
260,BUMA.1121.00078,1,375848,379054,+,3206
260,BUMA.1121.00012,1,295817,299023,-,3206
260,BUMA.1121.00001,1,2464222,2467428,+,3206
260,BUMA.1121.00111,1,1765815,1769021,-,3206
260,BUMA.1121.00109,1,351605,354811,+,3206
260,BUMA.1121.00100,1,3756986,3760192,+,3206
260,BUMA.1121.00029,1,3345416,3348622,+,3206
260,BUMA.1121.00031,1,3025224,3028430,-,3206
260,BUMA.1121.00023,1,4034943,4038149,-,3206
260,BUMA.1121.00035,1,2741479,2744685,-,3206
260,BUMA.1121.00041,1,2877314,2880520,-,3206
261,BUMA.1121.00058,1,3439287,3442738,+,3451
261,BUMA.1121.00018,1,1715836,1719282,-,3446
261,BUMA.1121.00025,1,1540570,1544016,+,3446
262,BUMA.1121.00058,1,3462098,3472720,+,10622
262,BUMA.1121.00068,1,1365660,1376762,+,11102
262,BUMA.1121.00055,1,2273406,2284482,+,11076
262,BUMA.1121.00092,1,1176089,1186728,-,10639
262,BUMA.1121.00074,1,2749388,2760012,+,10624
262,BUMA.1121.00093,1,3439425,3450064,+,10639
262,BUMA.1121.00018,1,1690385,1701004,-,10619
262,BUMA.1121.00059,1,1825895,1836534,+,10639
262,BUMA.1121.00043,1,1152180,1162799,-,10619
262,BUMA.1121.00112,1,238682,249763,-,11081
262,BUMA.1121.00047,1,1854485,1865122,+,10637
262,BUMA.1121.00062,1,1959296,1969935,-,10639
262,BUMA.1121.00007,1,1457751,1468390,-,10639
262,BUMA.1121.00025,1,1558848,1569467,+,10619
262,BUMA.1121.00103,1,1805562,1816180,-,10618
262,BUMA.1121.00079,1,2628073,2638711,+,10638
262,BUMA.1121.00049,1,3227149,3237782,-,10633
262,BUMA.1121.00014,1,1676185,1686801,+,10616
262,BUMA.1121.00090,1,3250113,3260732,-,10619
262,BUMA.1121.00078,1,3407680,3418319,-,10639
262,BUMA.1121.00075,1,2087131,2097770,+,10639
262,BUMA.1121.00012,1,3902992,3913611,-,10619
262,BUMA.1121.00076,1,2716298,2726937,-,10639
262,BUMA.1121.00001,1,2946204,2956823,+,10619
262,BUMA.1121.00107,1,2519030,2529669,+,10639
262,BUMA.1121.00099,1,3812528,3823167,-,10639
262,BUMA.1121.00098,1,1253693,1264332,+,10639
262,BUMA.1121.00094,1,1113603,1124240,-,10637
262,BUMA.1121.00065,1,1197129,1207760,-,10631
262,BUMA.1121.00105,1,2598352,2608973,-,10621
262,BUMA.1121.00031,1,2530445,2541061,-,10616
262,BUMA.1121.00108,1,3633342,3643981,+,10639
262,BUMA.1121.00023,1,3506582,3517200,-,10618
262,BUMA.1121.00035,1,2239056,2249675,-,10619
263,BUMA.1121.00058,1,3475442,3479041,+,3599
263,BUMA.1121.00068,1,1378589,1382181,+,3592
263,BUMA.1121.00055,1,2286624,2290215,+,3591
263,BUMA.1121.00092,1,1170673,1174264,-,3591
263,BUMA.1121.00074,1,2761961,2765547,+,3586
263,BUMA.1121.00093,1,3451889,3455480,+,3591
263,BUMA.1121.00018,1,1685366,1688959,-,3593
263,BUMA.1121.00059,1,1838420,1842011,+,3591
263,BUMA.1121.00043,1,1147161,1150754,-,3593
263,BUMA.1121.00112,1,232608,236199,-,3591
263,BUMA.1121.00047,1,1866997,1870588,+,3591
263,BUMA.1121.00062,1,1953878,1957469,-,3591
263,BUMA.1121.00007,1,1452355,1455924,-,3569
263,BUMA.1121.00025,1,1570893,1574486,+,3593
263,BUMA.1121.00103,1,1800152,1803735,-,3583
263,BUMA.1121.00079,1,2640538,2644129,+,3591
263,BUMA.1121.00049,1,3221607,3225198,-,3591
263,BUMA.1121.00014,1,1688227,1691820,+,3593
263,BUMA.1121.00090,1,3245094,3248687,-,3593
263,BUMA.1121.00078,1,3402262,3405853,-,3591
263,BUMA.1121.00075,1,2099899,2103487,+,3588
263,BUMA.1121.00012,1,3897973,3901566,-,3593
263,BUMA.1121.00076,1,2710581,2714169,-,3588
263,BUMA.1121.00001,1,2958249,2961842,+,3593
263,BUMA.1121.00107,1,2531496,2535087,+,3591
263,BUMA.1121.00099,1,3807118,3810701,-,3583
263,BUMA.1121.00098,1,1266735,1270326,+,3591
263,BUMA.1121.00094,1,1108137,1111728,-,3591
263,BUMA.1121.00065,1,1191663,1195254,-,3591
263,BUMA.1121.00105,1,2592887,2596475,-,3588
263,BUMA.1121.00031,1,2525426,2529019,-,3593
263,BUMA.1121.00108,1,3646110,3649701,+,3591
263,BUMA.1121.00023,1,3501563,3505156,-,3593
263,BUMA.1121.00035,1,2234037,2237630,-,3593
264,BUMA.1121.00058,1,3828236,3833298,+,5062
264,BUMA.1121.00068,1,3651455,3657758,-,6303
264,BUMA.1121.00055,1,358987,364054,-,5067
264,BUMA.1121.00062,1,3772823,3777885,+,5062
264,BUMA.1121.00103,1,3633270,3638332,+,5062
264,BUMA.1121.00096,1,2484220,2489282,+,5062
264,BUMA.1121.00078,1,1218302,1223364,+,5062
264,BUMA.1121.00106,1,554138,559200,-,5062
264,BUMA.1121.00104,1,504946,510008,+,5062
264,BUMA.1121.00095,1,888591,893653,+,5062
264,BUMA.1121.00005,1,2797817,2802735,+,4918
264,BUMA.1121.00100,1,528106,533168,+,5062
264,BUMA.1121.00105,1,416446,421508,+,5062
265,BUMA.1121.00058,1,4041852,4048746,+,6894
265,BUMA.1121.00068,1,3435110,3442003,-,6893
265,BUMA.1121.00062,1,8280,15174,+,6894
265,BUMA.1121.00084,1,793710,801843,-,8133
266,BUMA.1121.00045,1,1605615,1612767,+,7152
266,BUMA.1121.00051,1,2414364,2421516,-,7152
266,BUMA.1121.00060,1,3850874,3858026,+,7152
266,BUMA.1121.00064,1,2457621,2464773,-,7152
266,BUMA.1121.00011,1,3207812,3214964,+,7152
266,BUMA.1121.00088,1,3360811,3367963,-,7152
266,BUMA.1121.00074,1,1409595,1416747,+,7152
266,BUMA.1121.00080,1,2444602,2451754,-,7152
266,BUMA.1121.00059,1,1633623,1640774,-,7151
266,BUMA.1121.00056,1,1518134,1525286,+,7152
266,BUMA.1121.00112,1,535315,542467,+,7152
266,BUMA.1121.00091,1,2063597,2072035,+,8438
266,BUMA.1121.00047,1,500488,507640,+,7152
266,BUMA.1121.00067,1,1964328,1971480,+,7152
266,BUMA.1121.00007,1,1651662,1658814,+,7152
266,BUMA.1121.00079,1,2440393,2447544,-,7151
266,BUMA.1121.00084,1,2815136,2822288,-,7152
266,BUMA.1121.00049,1,3425137,3432289,+,7152
266,BUMA.1121.00089,1,2401335,2408487,-,7152
266,BUMA.1121.00075,1,1895087,1902239,-,7152
266,BUMA.1121.00076,1,2911814,2918966,+,7152
266,BUMA.1121.00106,1,2190146,2197287,-,7141
266,BUMA.1121.00107,1,2318195,2325347,-,7152
266,BUMA.1121.00104,1,2791193,2798345,+,7152
266,BUMA.1121.00094,1,2431650,2438802,-,7152
267,BUMA.1121.00045,1,2939959,2944304,+,4345
267,BUMA.1121.00060,1,1165566,1169911,+,4345
267,BUMA.1121.00088,1,1993218,1997562,-,4344
267,BUMA.1121.00112,1,1941546,1945891,+,4345
267,BUMA.1121.00084,1,1338663,1343007,-,4344
267,BUMA.1121.00107,1,1016746,1021091,-,4345
268,BUMA.1121.00045,1,3081575,3085649,+,4074
268,BUMA.1121.00060,1,1307164,1311238,+,4074
268,BUMA.1121.00014,1,3249957,3254031,+,4074
268,BUMA.1121.00031,1,996430,1000503,-,4073
269,BUMA.1121.00045,1,3279889,3288102,+,8213
269,BUMA.1121.00060,1,1505502,1513715,+,8213
270,BUMA.1121.00045,1,3294644,3298791,+,4147
270,BUMA.1121.00060,1,1520257,1524404,+,4147
271,BUMA.1121.00045,1,3298841,3305145,+,6304
271,BUMA.1121.00060,1,1524454,1530758,+,6304
271,BUMA.1121.00012,1,3555842,3562127,-,6285
272,BUMA.1121.00045,1,3305147,3320376,+,15229
272,BUMA.1121.00060,1,1530760,1545989,+,15229
272,BUMA.1121.00003,1,3264868,3280120,-,15252
272,BUMA.1121.00011,1,840731,855961,+,15230
272,BUMA.1121.00009,1,791488,806716,+,15228
272,BUMA.1121.00112,1,2282965,2298192,+,15227
272,BUMA.1121.00075,1,286080,301307,-,15227
272,BUMA.1121.00076,1,578476,593703,+,15227
272,BUMA.1121.00099,1,1630735,1645965,+,15230
272,BUMA.1121.00098,1,3496337,3511573,-,15236
272,BUMA.1121.00097,1,3227921,3243149,+,15228
272,BUMA.1121.00108,1,1765945,1781172,-,15227
273,BUMA.1121.00045,1,3999649,4002984,+,3335
273,BUMA.1121.00060,1,2225285,2228620,+,3335
274,BUMA.1121.00051,1,780376,787637,+,7261
274,BUMA.1121.00092,1,3083763,3092248,-,8485
274,BUMA.1121.00093,1,1534186,1542671,+,8485
274,BUMA.1121.00080,1,818389,825634,+,7245
274,BUMA.1121.00047,1,2201923,2209168,-,7245
275,BUMA.1121.00051,1,3772421,3776883,+,4462
275,BUMA.1121.00080,1,3800140,3804602,+,4462
275,BUMA.1121.00056,1,148271,152733,-,4462
275,BUMA.1121.00047,1,3189462,3193924,-,4462
275,BUMA.1121.00089,1,3774199,3778661,+,4462
275,BUMA.1121.00090,1,1853870,1858622,+,4752
275,BUMA.1121.00102,1,1509526,1513988,-,4462
276,BUMA.1121.00051,1,3788527,3792498,+,3971
276,BUMA.1121.00080,1,3816246,3820217,+,3971
276,BUMA.1121.00056,1,134015,137986,-,3971
276,BUMA.1121.00047,1,3173847,3177818,-,3971
276,BUMA.1121.00089,1,3791517,3795488,+,3971
276,BUMA.1121.00090,1,1869055,1873106,+,4051
276,BUMA.1121.00102,1,1495123,1499094,-,3971
277,BUMA.1121.00051,1,3794065,3803443,+,9378
277,BUMA.1121.00080,1,3821784,3831162,+,9378
277,BUMA.1121.00056,1,123070,132448,-,9378
277,BUMA.1121.00047,1,3162902,3172280,-,9378
277,BUMA.1121.00089,1,3797055,3806433,+,9378
277,BUMA.1121.00090,1,1873316,1882394,+,9078
277,BUMA.1121.00102,1,1485533,1494913,-,9380
278,BUMA.1121.00068,1,243586,254296,+,10710
278,BUMA.1121.00062,1,3065792,3075259,-,9467
278,BUMA.1121.00078,1,450105,459572,-,9467
278,BUMA.1121.00097,1,2443873,2453339,-,9466
279,BUMA.1121.00068,1,1344463,1351060,+,6597
279,BUMA.1121.00107,1,2497864,2504472,+,6608
280,BUMA.1121.00068,1,2413744,2421762,+,8018
280,BUMA.1121.00096,1,3651748,3659765,-,8017
280,BUMA.1121.00095,1,2059111,2067128,-,8017
281,BUMA.1121.00068,1,2423295,2428480,+,5185
281,BUMA.1121.00096,1,3645030,3650215,-,5185
281,BUMA.1121.00095,1,2052419,2057584,-,5165
282,BUMA.1121.00068,1,2438902,2445154,+,6252
282,BUMA.1121.00067,1,529470,535720,-,6250
282,BUMA.1121.00096,1,3629054,3635306,-,6252
282,BUMA.1121.00095,1,2035549,2041802,-,6253
283,BUMA.1121.00068,1,2612701,2616952,+,4251
283,BUMA.1121.00101,1,2673204,2677455,-,4251
284,BUMA.1121.00068,1,2711072,2714323,+,3251
284,BUMA.1121.00070,1,3739127,3742378,+,3251
284,BUMA.1121.00103,2,3359943,3363206,+,3263
284,BUMA.1121.00082,1,3970819,3974070,+,3251
284,BUMA.1121.00083,1,1805300,1808551,-,3251
284,BUMA.1121.00098,1,2562876,2566115,+,3239
284,BUMA.1121.00101,1,2590846,2594073,-,3227
284,BUMA.1121.00066,1,3751898,3755149,+,3251
285,BUMA.1121.00068,1,2896196,2900713,+,4517
285,BUMA.1121.00096,1,3203288,3207803,-,4515
285,BUMA.1121.00099,1,2385828,2390344,-,4516
285,BUMA.1121.00098,1,2751143,2755660,+,4517
286,BUMA.1121.00068,1,2903526,2910871,+,7345
286,BUMA.1121.00043,1,38196,44298,+,6102
287,BUMA.1121.00068,1,2910993,2916010,+,5017
287,BUMA.1121.00041,2,1417685,1424064,+,6379
288,BUMA.1121.00064,1,105522,108747,+,3225
288,BUMA.1121.00055,1,3735752,3738977,+,3225
288,BUMA.1121.00074,1,3781190,3784415,-,3225
288,BUMA.1121.00067,1,313007,316232,-,3225
288,BUMA.1121.00062,1,488162,491387,-,3225
288,BUMA.1121.00049,1,1754112,1757337,-,3225
288,BUMA.1121.00102,1,1187004,1190220,-,3216
288,BUMA.1121.00104,1,1178937,1182162,-,3225
289,BUMA.1121.00064,1,1518143,1521372,+,3229
289,BUMA.1121.00074,1,2338867,2342096,-,3229
289,BUMA.1121.00067,1,2895148,2898377,-,3229
290,BUMA.1121.00064,1,2039547,2050958,+,11411
290,BUMA.1121.00055,1,1601783,1613194,+,11411
290,BUMA.1121.00080,1,2043586,2054997,+,11411
290,BUMA.1121.00112,1,968583,979996,-,11413
290,BUMA.1121.00110,1,2773287,2784682,-,11395
290,BUMA.1121.00077,1,698343,709738,+,11395
290,BUMA.1121.00079,1,2038858,2050269,+,11411
291,BUMA.1121.00064,1,3621552,3625726,+,4174
291,BUMA.1121.00011,1,1988757,1992931,-,4174
291,BUMA.1121.00080,1,3635552,3639726,+,4174
291,BUMA.1121.00067,1,801131,805305,-,4174
291,BUMA.1121.00074,2,641250,645424,+,4174
291,BUMA.1121.00049,1,2198671,2202845,-,4174
291,BUMA.1121.00014,1,2287017,2291141,-,4124
291,BUMA.1121.00106,1,3385954,3390128,+,4174
291,BUMA.1121.00104,1,1627061,1631235,-,4174
291,BUMA.1121.00109,1,2283127,2287301,-,4174
291,BUMA.1121.00031,1,1927699,1931823,+,4124
292,BUMA.1121.00064,1,3626939,3633085,+,6146
292,BUMA.1121.00011,1,1981397,1987543,-,6146
292,BUMA.1121.00080,1,3640939,3647085,+,6146
292,BUMA.1121.00067,1,793771,799917,-,6146
292,BUMA.1121.00074,2,646637,652783,+,6146
292,BUMA.1121.00049,1,2191311,2197457,-,6146
292,BUMA.1121.00106,1,3391341,3397487,+,6146
292,BUMA.1121.00104,1,1619701,1625847,-,6146
292,BUMA.1121.00109,1,2275767,2281913,-,6146
293,BUMA.1121.00016,1,1971999,1978351,+,6352
293,BUMA.1121.00043,1,3983439,3989807,+,6368
294,BUMA.1121.00016,1,3101397,3104910,+,3513
294,BUMA.1121.00043,1,963344,966858,+,3514
295,BUMA.1121.00016,1,3244985,3266847,+,21862
295,BUMA.1121.00043,1,1094243,1116108,+,21865
296,BUMA.1121.00016,1,3280621,3286026,+,5405
296,BUMA.1121.00043,1,1129200,1134605,+,5405
297,BUMA.1121.00016,1,3679459,3682747,+,3288
297,BUMA.1121.00033,1,3776483,3779772,+,3289
297,BUMA.1121.00043,1,1592204,1595493,+,3289
298,BUMA.1121.00016,1,3683087,3692341,+,9254
298,BUMA.1121.00033,1,3780112,3787984,+,7872
299,BUMA.1121.00016,1,3695477,3698701,+,3224
299,BUMA.1121.00033,1,3793883,3797106,+,3223
300,BUMA.1121.00003,1,681522,687706,+,6184
300,BUMA.1121.00011,1,3461630,3467817,-,6187
300,BUMA.1121.00009,1,3369308,3375495,-,6187
300,BUMA.1121.00099,1,160569,166763,-,6194
300,BUMA.1121.00098,1,798800,804984,+,6184
300,BUMA.1121.00097,1,1733907,1740086,-,6179
301,BUMA.1121.00003,1,1567751,1571965,+,4214
301,BUMA.1121.00043,1,3178445,3182640,+,4195
301,BUMA.1121.00001,1,998648,1002842,-,4194
302,BUMA.1121.00003,1,1995400,2000508,+,5108
302,BUMA.1121.00110,1,1337672,1342840,-,5168
302,BUMA.1121.00077,1,2140479,2145647,+,5168
303,BUMA.1121.00003,1,2389042,2393573,+,4531
303,BUMA.1121.00053,1,3628195,3632739,+,4544
303,BUMA.1121.00102,1,1394241,1398765,-,4524
303,BUMA.1121.00099,1,2571751,2576282,-,4531
304,BUMA.1121.00055,1,563900,569902,+,6002
304,BUMA.1121.00021,1,1603179,1609180,+,6001
305,BUMA.1121.00055,1,792347,796143,+,3796
305,BUMA.1121.00041,1,2509471,2513269,+,3798
306,BUMA.1121.00055,1,796761,802490,+,5729
306,BUMA.1121.00011,1,375094,380824,-,5730
306,BUMA.1121.00082,1,1325817,1331550,+,5733
306,BUMA.1121.00007,1,3001479,3007209,-,5730
306,BUMA.1121.00103,1,3195519,3201251,-,5732
306,BUMA.1121.00083,1,373276,379009,-,5733
306,BUMA.1121.00098,1,3945045,3950775,+,5730
306,BUMA.1121.00041,1,2515249,2520981,+,5732
307,BUMA.1121.00055,1,3295985,3300172,+,4187
307,BUMA.1121.00053,1,3376739,3380926,+,4187
307,BUMA.1121.00007,1,418102,423529,-,5427
307,BUMA.1121.00090,1,1692127,1696314,+,4187
307,BUMA.1121.00078,1,2384574,2388762,-,4188
307,BUMA.1121.00102,1,1677057,1681261,-,4204
307,BUMA.1121.00075,1,3107675,3111862,+,4187
307,BUMA.1121.00076,1,1700413,1704601,-,4188
307,BUMA.1121.00111,1,3805101,3809288,+,4187
307,BUMA.1121.00065,1,3676438,3680624,+,4186
307,BUMA.1121.00100,1,1671845,1676041,-,4196
308,BUMA.1121.00011,1,381042,384667,+,3625
308,BUMA.1121.00103,1,3201469,3205094,+,3625
309,BUMA.1121.00011,1,1503618,1507401,+,3783
309,BUMA.1121.00097,1,3919086,3922869,+,3783
309,BUMA.1121.00108,1,1104332,1108116,-,3784
310,BUMA.1121.00011,1,1508034,1511081,+,3047
310,BUMA.1121.00097,1,3923502,3926549,+,3047
310,BUMA.1121.00005,1,3457513,3460528,+,3015
310,BUMA.1121.00108,1,1100653,1103700,-,3047
311,BUMA.1121.00011,1,1511573,1514641,+,3068
311,BUMA.1121.00097,1,3928277,3931349,+,3072
311,BUMA.1121.00005,1,3462309,3465377,+,3068
311,BUMA.1121.00108,1,1097092,1100160,-,3068
312,BUMA.1121.00011,1,2714701,2718046,+,3345
312,BUMA.1121.00049,1,2880918,2884239,+,3321
313,BUMA.1121.00037,1,134605,140587,+,5982
313,BUMA.1121.00018,1,3613718,3619702,-,5984
313,BUMA.1121.00025,1,3790127,3796111,+,5984
313,BUMA.1121.00021,1,3629249,3635233,-,5984
313,BUMA.1121.00012,1,205558,211548,+,5990
313,BUMA.1121.00111,1,1683596,1689578,+,5982
313,BUMA.1121.00029,1,1939473,1945454,+,5981
314,BUMA.1121.00037,1,149127,152592,+,3465
314,BUMA.1121.00111,1,1695578,1699038,+,3460
315,BUMA.1121.00037,1,2255692,2259931,+,4239
315,BUMA.1121.00021,1,236669,240908,+,4239
315,BUMA.1121.00014,1,3267188,3271427,-,4239
315,BUMA.1121.00031,1,979033,983272,+,4239
315,BUMA.1121.00023,1,1958881,1963120,+,4239
316,BUMA.1121.00037,1,2752911,2757293,+,4382
316,BUMA.1121.00018,1,615289,619694,+,4405
316,BUMA.1121.00007,1,4005004,4009409,-,4405
316,BUMA.1121.00025,1,2640185,2644590,-,4405
316,BUMA.1121.00039,1,208188,212593,+,4405
316,BUMA.1121.00014,1,2779171,2783576,-,4405
316,BUMA.1121.00090,1,2217082,2221487,+,4405
316,BUMA.1121.00078,1,1929424,1933829,-,4405
316,BUMA.1121.00012,1,2834251,2838656,+,4405
316,BUMA.1121.00005,1,3473287,3477692,-,4405
316,BUMA.1121.00023,1,2450210,2454141,+,3931
317,BUMA.1121.00037,1,3417086,3422979,+,5893
317,BUMA.1121.00014,1,2044395,2051623,-,7228
317,BUMA.1121.00031,1,2168352,2175580,+,7228
317,BUMA.1121.00023,1,3136659,3143887,+,7228
318,BUMA.1121.00011,2,39,22416,+,22377
318,BUMA.1121.00009,2,39,22539,+,22500
318,BUMA.1121.00039,2,2563613,2585979,-,22366
318,BUMA.1121.00029,2,3195044,3217416,-,22372
318,BUMA.1121.00021,2,1890923,1913236,+,22313
318,BUMA.1121.00107,2,2453975,2476477,-,22502
318,BUMA.1121.00023,2,1465640,1488026,+,22386
318,BUMA.1121.00067,2,2585045,2607494,-,22449
318,BUMA.1121.00035,2,3212301,3234666,-,22365
318,BUMA.1121.00005,2,2803319,2825814,+,22495
318,BUMA.1121.00100,2,2475776,2498175,+,22399
318,BUMA.1121.00016,2,2312678,2334961,-,22283
318,BUMA.1121.00099,2,1627808,1650358,+,22550
318,BUMA.1121.00094,2,1414156,1436578,+,22422
318,BUMA.1121.00093,2,1538687,1561120,-,22433
318,BUMA.1121.00097,2,1218389,1240743,+,22354
318,BUMA.1121.00109,2,20158,42529,-,22371
318,BUMA.1121.00018,2,2408766,2431213,-,22447
318,BUMA.1121.00110,2,1008618,1031056,-,22438
318,BUMA.1121.00079,2,1371971,1394398,+,22427
318,BUMA.1121.00075,2,1664472,1687005,+,22533
318,BUMA.1121.00066,2,1351441,1373942,+,22501
318,BUMA.1121.00089,2,1359292,1381725,+,22433
318,BUMA.1121.00057,2,700208,722762,-,22554
318,BUMA.1121.00090,2,2358989,2381342,+,22353
318,BUMA.1121.00027,2,2427668,2450142,+,22474
318,BUMA.1121.00062,2,390016,412474,-,22458
318,BUMA.1121.00091,2,2233940,2256399,-,22459
318,BUMA.1121.00098,2,1626241,1648498,+,22257
318,BUMA.1121.00092,2,1383230,1405662,+,22432
318,BUMA.1121.00031,2,562217,584580,+,22363
318,BUMA.1121.00096,2,1585076,1607649,+,22573
318,BUMA.1121.00073,2,1345967,1368480,+,22513
318,BUMA.1121.00103,2,3287828,3310220,+,22392
318,BUMA.1121.00084,2,16889,39289,+,22400
318,BUMA.1121.00014,2,1495726,1518155,+,22429
318,BUMA.1121.00111,2,646464,668806,+,22342
318,BUMA.1121.00007,2,1411992,1434517,+,22525
318,BUMA.1121.00072,2,1342069,1364580,+,22511
318,BUMA.1121.00071,2,1345207,1367705,+,22498
318,BUMA.1121.00077,2,2302243,2324682,-,22439
318,BUMA.1121.00003,2,2520714,2543112,-,22398
318,BUMA.1121.00104,2,1463321,1485801,+,22480
318,BUMA.1121.00074,2,2970709,2993209,-,22500
318,BUMA.1121.00060,2,810431,832882,-,22451
318,BUMA.1121.00088,2,1313009,1335440,+,22431
318,BUMA.1121.00053,2,1658352,1680805,+,22453
318,BUMA.1121.00025,2,2742682,2765129,-,22447
318,BUMA.1121.00070,2,1346012,1368525,+,22513
318,BUMA.1121.00049,2,27433,49967,+,22534
318,BUMA.1121.00078,2,1748114,1770693,-,22579
318,BUMA.1121.00069,2,1343543,1366044,+,22501
318,BUMA.1121.00102,2,1422105,1444498,+,22393
318,BUMA.1121.00112,2,2997691,3020077,-,22386
318,BUMA.1121.00041,2,2313246,2335820,+,22574
318,BUMA.1121.00068,2,3079375,3101623,+,22248
318,BUMA.1121.00076,2,2258437,2280971,+,22534
318,BUMA.1121.00033,2,2109908,2132272,+,22364
318,BUMA.1121.00101,2,2020205,2042695,-,22490
318,BUMA.1121.00105,2,1130987,1153394,-,22407
318,BUMA.1121.00061,2,1335606,1358118,+,22512
318,BUMA.1121.00063,2,1344719,1367232,+,22513
318,BUMA.1121.00059,2,2266570,2289161,-,22591
318,BUMA.1121.00058,2,1919482,1941910,+,22428
318,BUMA.1121.00043,2,975928,998295,-,22367
318,BUMA.1121.00055,2,1279100,1301586,-,22486
318,BUMA.1121.00065,2,1416878,1439307,+,22429
318,BUMA.1121.00064,2,1285519,1308044,+,22525
318,BUMA.1121.00047,2,2301400,2323899,+,22499
318,BUMA.1121.00037,2,1731183,1753540,+,22357
318,BUMA.1121.00106,2,425567,448064,-,22497
318,BUMA.1121.00051,2,1371345,1393826,+,22481
318,BUMA.1121.00045,2,1261094,1283538,+,22444
318,BUMA.1121.00056,2,2612324,2634757,-,22433
318,BUMA.1121.00095,2,3240544,3262979,-,22435
318,BUMA.1121.00082,2,1376149,1398662,+,22513
318,BUMA.1121.00001,2,816598,838998,-,22400
318,BUMA.1121.00108,2,1596974,1619418,+,22444
318,BUMA.1121.00083,2,39,22552,+,22513
318,BUMA.1121.00080,2,1372625,1395115,+,22490
318,BUMA.1121.00012,2,307357,329745,-,22388
319,BUMA.1121.00011,2,23560,27723,+,4163
319,BUMA.1121.00009,2,59062,63240,+,4178
319,BUMA.1121.00039,2,2558324,2562469,-,4145
319,BUMA.1121.00029,2,3189755,3193900,-,4145
319,BUMA.1121.00021,2,1914380,1918527,+,4147
319,BUMA.1121.00107,2,2448616,2452831,-,4215
319,BUMA.1121.00023,2,1524111,1528255,+,4144
319,BUMA.1121.00067,2,2579728,2583901,-,4173
319,BUMA.1121.00035,2,3207012,3211157,-,4145
319,BUMA.1121.00005,2,2826958,2831159,+,4201
319,BUMA.1121.00100,2,2499319,2503518,+,4199
319,BUMA.1121.00016,2,2307356,2311564,-,4208
319,BUMA.1121.00099,2,1651502,1655665,+,4163
319,BUMA.1121.00094,2,1437722,1441874,+,4152
319,BUMA.1121.00093,2,1533352,1537543,-,4191
319,BUMA.1121.00097,2,1241900,1246078,+,4178
319,BUMA.1121.00109,2,14827,19014,-,4187
319,BUMA.1121.00018,2,2403470,2407622,-,4152
319,BUMA.1121.00079,2,1395542,1399693,+,4151
319,BUMA.1121.00075,2,1723563,1727716,+,4153
319,BUMA.1121.00066,2,1375035,1379200,+,4165
319,BUMA.1121.00089,2,1382869,1387020,+,4151
319,BUMA.1121.00057,2,694891,699064,-,4173
319,BUMA.1121.00090,2,2382486,2386630,+,4144
319,BUMA.1121.00027,2,2451284,2455455,+,4171
319,BUMA.1121.00062,2,384720,388872,-,4152
319,BUMA.1121.00091,2,2228623,2232796,-,4173
319,BUMA.1121.00098,2,1649642,1653823,+,4181
319,BUMA.1121.00092,2,1406806,1410996,+,4190
319,BUMA.1121.00031,2,585724,589868,+,4144
319,BUMA.1121.00096,2,1608793,1612974,+,4181
319,BUMA.1121.00073,2,1369624,1373789,+,4165
319,BUMA.1121.00103,2,3311364,3315542,+,4178
319,BUMA.1121.00084,2,40433,44584,+,4151
319,BUMA.1121.00014,2,1519299,1523443,+,4144
319,BUMA.1121.00111,2,669950,674094,+,4144
319,BUMA.1121.00007,2,1435661,1439824,+,4163
319,BUMA.1121.00072,2,1365724,1369885,+,4161
319,BUMA.1121.00071,2,1368849,1373014,+,4165
319,BUMA.1121.00003,2,2515408,2519556,-,4148
319,BUMA.1121.00104,2,1486945,1491089,+,4144
319,BUMA.1121.00074,2,2965392,2969565,-,4173
319,BUMA.1121.00060,2,805087,809287,-,4200
319,BUMA.1121.00088,2,1336584,1340737,+,4153
319,BUMA.1121.00053,2,1681949,1686150,+,4201
319,BUMA.1121.00025,2,2737386,2741538,-,4152
319,BUMA.1121.00070,2,1369669,1373834,+,4165
319,BUMA.1121.00049,2,51111,55270,+,4159
319,BUMA.1121.00078,2,1742777,1746923,-,4146
319,BUMA.1121.00069,2,1367188,1371353,+,4165
319,BUMA.1121.00102,2,1445642,1449814,+,4172
319,BUMA.1121.00112,2,2992391,2996547,-,4156
319,BUMA.1121.00041,2,2336929,2341092,+,4163
319,BUMA.1121.00068,2,3102767,3106957,+,4190
319,BUMA.1121.00076,2,2317529,2321683,+,4154
319,BUMA.1121.00033,2,2133415,2137559,+,4144
319,BUMA.1121.00101,2,2014870,2019061,-,4191
319,BUMA.1121.00105,2,1125679,1129843,-,4164
319,BUMA.1121.00061,2,1359262,1363427,+,4165
319,BUMA.1121.00063,2,1368376,1372541,+,4165
319,BUMA.1121.00059,2,2261281,2265426,-,4145
319,BUMA.1121.00058,2,1943054,1947198,+,4144
319,BUMA.1121.00043,2,935242,939387,-,4145
319,BUMA.1121.00055,2,1273811,1277956,-,4145
319,BUMA.1121.00065,2,1440451,1444595,+,4144
319,BUMA.1121.00064,2,1309188,1313369,+,4181
319,BUMA.1121.00047,2,2325043,2329215,+,4172
319,BUMA.1121.00037,2,1754684,1758828,+,4144
319,BUMA.1121.00106,2,420263,424423,-,4160
319,BUMA.1121.00051,2,1394970,1399121,+,4151
319,BUMA.1121.00045,2,1284682,1288881,+,4199
319,BUMA.1121.00056,2,2607028,2611180,-,4152
319,BUMA.1121.00095,2,3235213,3239388,-,4175
319,BUMA.1121.00082,2,1399806,1403971,+,4165
319,BUMA.1121.00001,2,811309,815454,-,4145
319,BUMA.1121.00108,2,1620562,1624743,+,4181
319,BUMA.1121.00083,2,23696,27861,+,4165
319,BUMA.1121.00080,2,1396259,1400410,+,4151
319,BUMA.1121.00012,2,302058,306213,-,4155
320,BUMA.1121.00011,2,27725,32501,+,4776
320,BUMA.1121.00009,2,63242,68043,+,4801
320,BUMA.1121.00039,2,2553544,2558323,-,4779
320,BUMA.1121.00029,2,3184975,3189754,-,4779
320,BUMA.1121.00021,2,1918529,1923307,+,4778
320,BUMA.1121.00107,2,2443816,2448615,-,4799
320,BUMA.1121.00023,2,1528257,1533047,+,4790
320,BUMA.1121.00067,2,2574925,2579727,-,4802
320,BUMA.1121.00035,2,3202232,3207011,-,4779
320,BUMA.1121.00005,2,2831161,2835950,+,4789
320,BUMA.1121.00100,2,2503520,2508297,+,4777
320,BUMA.1121.00016,2,2302569,2307355,-,4786
320,BUMA.1121.00099,2,1655667,1660465,+,4798
320,BUMA.1121.00094,2,1441876,1446653,+,4777
320,BUMA.1121.00093,2,1528561,1533351,-,4790
320,BUMA.1121.00097,2,1246080,1250887,+,4807
320,BUMA.1121.00109,2,10123,14826,-,4703
320,BUMA.1121.00018,2,2398680,2403469,-,4789
320,BUMA.1121.00110,2,1002571,1007413,-,4842
320,BUMA.1121.00079,2,1399695,1404490,+,4795
320,BUMA.1121.00075,2,1727718,1732494,+,4776
320,BUMA.1121.00066,2,1379202,1383987,+,4785
320,BUMA.1121.00089,2,1387022,1391799,+,4777
320,BUMA.1121.00057,2,690120,694890,-,4770
320,BUMA.1121.00090,2,2386632,2391421,+,4789
320,BUMA.1121.00027,2,2455457,2460225,+,4768
320,BUMA.1121.00062,2,379929,384719,-,4790
320,BUMA.1121.00091,2,2223832,2228622,-,4790
320,BUMA.1121.00098,2,1653825,1658622,+,4797
320,BUMA.1121.00092,2,1410998,1415787,+,4789
320,BUMA.1121.00031,2,589870,594647,+,4777
320,BUMA.1121.00096,2,1612976,1617764,+,4788
320,BUMA.1121.00073,2,1373791,1378576,+,4785
320,BUMA.1121.00103,2,3315544,3320321,+,4777
320,BUMA.1121.00084,2,44586,49019,+,4433
320,BUMA.1121.00014,2,1523445,1528223,+,4778
320,BUMA.1121.00111,2,674096,678889,+,4793
320,BUMA.1121.00007,2,1439826,1444624,+,4798
320,BUMA.1121.00072,2,1369887,1374671,+,4784
320,BUMA.1121.00071,2,1373016,1377792,+,4776
320,BUMA.1121.00077,2,2296193,2301038,-,4845
320,BUMA.1121.00003,2,2510618,2515407,-,4789
320,BUMA.1121.00104,2,1491091,1495880,+,4789
320,BUMA.1121.00074,2,2960610,2965391,-,4781
320,BUMA.1121.00060,2,800311,805086,-,4775
320,BUMA.1121.00088,2,1340739,1345537,+,4798
320,BUMA.1121.00053,2,1686152,1690962,+,4810
320,BUMA.1121.00025,2,2732596,2737385,-,4789
320,BUMA.1121.00070,2,1373836,1378621,+,4785
320,BUMA.1121.00049,2,55272,60061,+,4789
320,BUMA.1121.00078,2,1738001,1742776,-,4775
320,BUMA.1121.00069,2,1371355,1376140,+,4785
320,BUMA.1121.00102,2,1449816,1454605,+,4789
320,BUMA.1121.00112,2,2987600,2992390,-,4790
320,BUMA.1121.00041,2,2341094,2345862,+,4768
320,BUMA.1121.00068,2,3106959,3111772,+,4813
320,BUMA.1121.00076,2,2321685,2326462,+,4777
320,BUMA.1121.00033,2,2137561,2142329,+,4768
320,BUMA.1121.00101,2,2010070,2014869,-,4799
320,BUMA.1121.00105,2,1120888,1125678,-,4790
320,BUMA.1121.00061,2,1363429,1368214,+,4785
320,BUMA.1121.00063,2,1372543,1377328,+,4785
320,BUMA.1121.00059,2,2256490,2261280,-,4790
320,BUMA.1121.00058,2,1947200,1952018,+,4818
320,BUMA.1121.00043,2,930462,935241,-,4779
320,BUMA.1121.00055,2,1269031,1273810,-,4779
320,BUMA.1121.00065,2,1444597,1449322,+,4725
320,BUMA.1121.00064,2,1313371,1318151,+,4780
320,BUMA.1121.00047,2,2329217,2333991,+,4774
320,BUMA.1121.00037,2,1758830,1763608,+,4778
320,BUMA.1121.00106,2,415472,420262,-,4790
320,BUMA.1121.00051,2,1399123,1403899,+,4776
320,BUMA.1121.00045,2,1288883,1293657,+,4774
320,BUMA.1121.00056,2,2602248,2607027,-,4779
320,BUMA.1121.00095,2,3230418,3235212,-,4794
320,BUMA.1121.00082,2,1403973,1408758,+,4785
320,BUMA.1121.00001,2,806529,811308,-,4779
320,BUMA.1121.00108,2,1624745,1629531,+,4786
320,BUMA.1121.00083,2,27863,32648,+,4785
320,BUMA.1121.00080,2,1400412,1405188,+,4776
320,BUMA.1121.00012,2,297278,302057,-,4779
321,BUMA.1121.00011,2,35697,40286,+,4589
321,BUMA.1121.00009,2,71214,75784,+,4570
321,BUMA.1121.00039,2,2545823,2550347,-,4524
321,BUMA.1121.00029,2,3177205,3181778,-,4573
321,BUMA.1121.00021,2,1926504,1931042,+,4538
321,BUMA.1121.00107,2,2436066,2440635,-,4569
321,BUMA.1121.00023,2,1536233,1540793,+,4560
321,BUMA.1121.00067,2,2567185,2571734,-,4549
321,BUMA.1121.00035,2,3194469,3199035,-,4566
321,BUMA.1121.00005,2,2839131,2843725,+,4594
321,BUMA.1121.00100,2,2511469,2516024,+,4555
321,BUMA.1121.00016,2,2294848,2299372,-,4524
321,BUMA.1121.00099,2,1663656,1668248,+,4592
321,BUMA.1121.00094,2,1449872,1454445,+,4573
321,BUMA.1121.00093,2,1520818,1525384,-,4566
321,BUMA.1121.00097,2,1254062,1258639,+,4577
321,BUMA.1121.00109,2,2386,6943,-,4557
321,BUMA.1121.00018,2,2389685,2395543,-,5858
321,BUMA.1121.00110,2,994823,999385,-,4562
321,BUMA.1121.00079,2,1407686,1412238,+,4552
321,BUMA.1121.00075,2,1735681,1741530,+,5849
321,BUMA.1121.00066,2,1387195,1391730,+,4535
321,BUMA.1121.00089,2,1395018,1399591,+,4573
321,BUMA.1121.00057,2,682454,686998,-,4544
321,BUMA.1121.00090,2,2394569,2399100,+,4531
321,BUMA.1121.00027,2,2463346,2467890,+,4544
321,BUMA.1121.00062,2,372173,376737,-,4564
321,BUMA.1121.00091,2,2216095,2220646,-,4551
321,BUMA.1121.00098,2,1661808,1666359,+,4551
321,BUMA.1121.00092,2,1418964,1423530,+,4566
321,BUMA.1121.00031,2,597844,602375,+,4531
321,BUMA.1121.00096,2,1620961,1625520,+,4559
321,BUMA.1121.00073,2,1381784,1386327,+,4543
321,BUMA.1121.00103,2,3323504,3328154,+,4650
321,BUMA.1121.00084,2,52200,56750,+,4550
321,BUMA.1121.00014,2,1531409,1535940,+,4531
321,BUMA.1121.00111,2,735957,740488,+,4531
321,BUMA.1121.00007,2,1447806,1452385,+,4579
321,BUMA.1121.00072,2,1377842,1382385,+,4543
321,BUMA.1121.00071,2,1381000,1385543,+,4543
321,BUMA.1121.00077,2,2288444,2293007,-,4563
321,BUMA.1121.00003,2,2502905,2507484,-,4579
321,BUMA.1121.00104,2,1499076,1503635,+,4559
321,BUMA.1121.00074,2,2952870,2957425,-,4555
321,BUMA.1121.00060,2,792513,797108,-,4595
321,BUMA.1121.00088,2,1348718,1353268,+,4550
321,BUMA.1121.00053,2,1694132,1698730,+,4598
321,BUMA.1121.00025,2,2723601,2729459,-,5858
321,BUMA.1121.00070,2,1381829,1386372,+,4543
321,BUMA.1121.00049,2,63257,67816,+,4559
321,BUMA.1121.00078,2,1730269,1734815,-,4546
321,BUMA.1121.00069,2,1379348,1383891,+,4543
321,BUMA.1121.00102,2,1457791,1462360,+,4569
321,BUMA.1121.00112,2,2979865,2984419,-,4554
321,BUMA.1121.00041,2,2349059,2353693,+,4634
321,BUMA.1121.00068,2,3114957,3119545,+,4588
321,BUMA.1121.00076,2,2329649,2335498,+,5849
321,BUMA.1121.00033,2,2145526,2150050,+,4524
321,BUMA.1121.00101,2,2002310,2006868,-,4558
321,BUMA.1121.00105,2,1113291,1117855,-,4564
321,BUMA.1121.00061,2,1371422,1375965,+,4543
321,BUMA.1121.00063,2,1380536,1385079,+,4543
321,BUMA.1121.00059,2,2248748,2253298,-,4550
321,BUMA.1121.00058,2,1955237,1959863,+,4626
321,BUMA.1121.00043,2,922801,927325,-,4524
321,BUMA.1121.00055,2,1261312,1265856,-,4544
321,BUMA.1121.00065,2,1452492,1457030,+,4538
321,BUMA.1121.00064,2,1321336,1325891,+,4555
321,BUMA.1121.00047,2,2337221,2341811,+,4590
321,BUMA.1121.00037,2,1766794,1771325,+,4531
321,BUMA.1121.00106,2,407728,412287,-,4559
321,BUMA.1121.00051,2,1407151,1411724,+,4573
321,BUMA.1121.00045,2,1296861,1301455,+,4594
321,BUMA.1121.00056,2,2594456,2599029,-,4573
321,BUMA.1121.00095,2,3222655,3227226,-,4571
321,BUMA.1121.00082,2,1411966,1416509,+,4543
321,BUMA.1121.00001,2,798780,803332,-,4552
321,BUMA.1121.00108,2,1632722,1637280,+,4558
321,BUMA.1121.00083,2,35856,40399,+,4543
321,BUMA.1121.00080,2,1408396,1412962,+,4566
321,BUMA.1121.00012,2,289544,294081,-,4537
322,BUMA.1121.00011,2,42712,46961,+,4249
322,BUMA.1121.00009,2,78210,82459,+,4249
322,BUMA.1121.00039,2,2539149,2543397,-,4248
322,BUMA.1121.00029,2,3170531,3174779,-,4248
322,BUMA.1121.00021,2,1933468,1937717,+,4249
322,BUMA.1121.00107,2,2429392,2433640,-,4248
322,BUMA.1121.00023,2,1543219,1547468,+,4249
322,BUMA.1121.00067,2,2560511,2564759,-,4248
322,BUMA.1121.00035,2,3187795,3192043,-,4248
322,BUMA.1121.00005,2,2846151,2850400,+,4249
322,BUMA.1121.00100,2,2518450,2522699,+,4249
322,BUMA.1121.00016,2,2288174,2292422,-,4248
322,BUMA.1121.00099,2,1670674,1674923,+,4249
322,BUMA.1121.00094,2,1456871,1461120,+,4249
322,BUMA.1121.00093,2,1514144,1518392,-,4248
322,BUMA.1121.00097,2,1261065,1265314,+,4249
322,BUMA.1121.00109,2,3322781,3327045,-,4264
322,BUMA.1121.00018,2,2383011,2387259,-,4248
322,BUMA.1121.00110,2,988149,992397,-,4248
322,BUMA.1121.00079,2,1414664,1418912,+,4248
322,BUMA.1121.00075,2,1743956,1748205,+,4249
322,BUMA.1121.00066,2,1394156,1398405,+,4249
322,BUMA.1121.00089,2,1402017,1406266,+,4249
322,BUMA.1121.00057,2,675780,680028,-,4248
322,BUMA.1121.00090,2,2401526,2405775,+,4249
322,BUMA.1121.00027,2,2470316,2474565,+,4249
322,BUMA.1121.00062,2,365499,369747,-,4248
322,BUMA.1121.00091,2,2209421,2213669,-,4248
322,BUMA.1121.00098,2,1668785,1673034,+,4249
322,BUMA.1121.00092,2,1425956,1430205,+,4249
322,BUMA.1121.00031,2,604801,609050,+,4249
322,BUMA.1121.00096,2,1627946,1632195,+,4249
322,BUMA.1121.00073,2,1388753,1393002,+,4249
322,BUMA.1121.00103,2,3330580,3334829,+,4249
322,BUMA.1121.00084,2,59176,63425,+,4249
322,BUMA.1121.00014,2,1538366,1542615,+,4249
322,BUMA.1121.00111,2,742914,747163,+,4249
322,BUMA.1121.00007,2,1454811,1459059,+,4248
322,BUMA.1121.00072,2,1384811,1389060,+,4249
322,BUMA.1121.00071,2,1387969,1392218,+,4249
322,BUMA.1121.00077,2,2281767,2286018,-,4251
322,BUMA.1121.00003,2,2496231,2500479,-,4248
322,BUMA.1121.00104,2,1506061,1510310,+,4249
322,BUMA.1121.00074,2,2946196,2950444,-,4248
322,BUMA.1121.00060,2,785839,790087,-,4248
322,BUMA.1121.00088,2,1355694,1359943,+,4249
322,BUMA.1121.00053,2,1701156,1705405,+,4249
322,BUMA.1121.00025,2,2716927,2721175,-,4248
322,BUMA.1121.00070,2,1388798,1393047,+,4249
322,BUMA.1121.00049,2,70242,74491,+,4249
322,BUMA.1121.00078,2,1723595,1727843,-,4248
322,BUMA.1121.00069,2,1386317,1390566,+,4249
322,BUMA.1121.00102,2,1464786,1469035,+,4249
322,BUMA.1121.00112,2,2973191,2977439,-,4248
322,BUMA.1121.00041,2,2356119,2360368,+,4249
322,BUMA.1121.00068,2,3121965,3126213,+,4248
322,BUMA.1121.00076,2,2337924,2342137,+,4213
322,BUMA.1121.00033,2,2152476,2156725,+,4249
322,BUMA.1121.00101,2,1995636,1999884,-,4248
322,BUMA.1121.00105,2,1106617,1110865,-,4248
322,BUMA.1121.00061,2,1378391,1382640,+,4249
322,BUMA.1121.00063,2,1387505,1391754,+,4249
322,BUMA.1121.00059,2,2242075,2246322,-,4247
322,BUMA.1121.00058,2,1962289,1966538,+,4249
322,BUMA.1121.00043,2,916127,920375,-,4248
322,BUMA.1121.00055,2,1254638,1258886,-,4248
322,BUMA.1121.00065,2,1459456,1463705,+,4249
322,BUMA.1121.00064,2,1328317,1332566,+,4249
322,BUMA.1121.00047,2,2344237,2348486,+,4249
322,BUMA.1121.00037,2,1773751,1778000,+,4249
322,BUMA.1121.00106,2,401054,405302,-,4248
322,BUMA.1121.00051,2,1414150,1418399,+,4249
322,BUMA.1121.00045,2,1303881,1308130,+,4249
322,BUMA.1121.00056,2,2587782,2592030,-,4248
322,BUMA.1121.00095,2,3215981,3220229,-,4248
322,BUMA.1121.00082,2,1418935,1423184,+,4249
322,BUMA.1121.00001,2,792106,796354,-,4248
322,BUMA.1121.00108,2,1639706,1643955,+,4249
322,BUMA.1121.00083,2,42825,47074,+,4249
322,BUMA.1121.00080,2,1415388,1419637,+,4249
322,BUMA.1121.00012,2,282870,287118,-,4248
323,BUMA.1121.00011,2,50266,54867,+,4601
323,BUMA.1121.00009,2,87018,91626,+,4608
323,BUMA.1121.00039,2,2531299,2535895,-,4596
323,BUMA.1121.00029,2,3162653,3167249,-,4596
323,BUMA.1121.00021,2,1940971,1945567,+,4596
323,BUMA.1121.00107,2,2383727,2388345,-,4618
323,BUMA.1121.00023,2,1550722,1555317,+,4595
323,BUMA.1121.00067,2,2552581,2557188,-,4607
323,BUMA.1121.00035,2,3179924,3184520,-,4596
323,BUMA.1121.00005,2,2854516,2859124,+,4608
323,BUMA.1121.00100,2,2563265,2567865,+,4600
323,BUMA.1121.00016,2,2280234,2284814,-,4580
323,BUMA.1121.00099,2,1679203,1683802,+,4599
323,BUMA.1121.00094,2,1464421,1469021,+,4600
323,BUMA.1121.00093,2,1506258,1510858,-,4600
323,BUMA.1121.00097,2,1268662,1273219,+,4557
323,BUMA.1121.00109,2,3314833,3319494,-,4661
323,BUMA.1121.00018,2,2375150,2379746,-,4596
323,BUMA.1121.00110,2,979261,983853,-,4592
323,BUMA.1121.00079,2,1422233,1426838,+,4605
323,BUMA.1121.00075,2,1751551,1756155,+,4604
323,BUMA.1121.00066,2,1403675,1408268,+,4593
323,BUMA.1121.00089,2,1409568,1414168,+,4600
323,BUMA.1121.00057,2,667903,672488,-,4585
323,BUMA.1121.00090,2,2409074,2413669,+,4595
323,BUMA.1121.00027,2,2477857,2482441,+,4584
323,BUMA.1121.00062,2,321803,326411,-,4608
323,BUMA.1121.00091,2,2201587,2206176,-,4589
323,BUMA.1121.00098,2,1690544,1695114,+,4570
323,BUMA.1121.00092,2,1433491,1438090,+,4599
323,BUMA.1121.00031,2,612304,616899,+,4595
323,BUMA.1121.00096,2,1636424,1641018,+,4594
323,BUMA.1121.00073,2,1419016,1423623,+,4607
323,BUMA.1121.00103,2,3365071,3369650,+,4579
323,BUMA.1121.00084,2,66718,71317,+,4599
323,BUMA.1121.00014,2,1545869,1550463,+,4594
323,BUMA.1121.00111,2,750427,755022,+,4595
323,BUMA.1121.00007,2,1500356,1504947,+,4591
323,BUMA.1121.00072,2,1397967,1402563,+,4596
323,BUMA.1121.00071,2,1418596,1423192,+,4596
323,BUMA.1121.00077,2,2272880,2277472,-,4592
323,BUMA.1121.00003,2,2487276,2491900,-,4624
323,BUMA.1121.00104,2,1513668,1518267,+,4599
323,BUMA.1121.00074,2,2938288,2942883,-,4595
323,BUMA.1121.00060,2,773317,777912,-,4595
323,BUMA.1121.00088,2,1363235,1367834,+,4599
323,BUMA.1121.00053,2,1713349,1717972,+,4623
323,BUMA.1121.00025,2,2709066,2713662,-,4596
323,BUMA.1121.00070,2,1398633,1403236,+,4603
323,BUMA.1121.00049,2,77764,82348,+,4584
323,BUMA.1121.00078,2,1715640,1720219,-,4579
323,BUMA.1121.00069,2,1395491,1400098,+,4607
323,BUMA.1121.00102,2,1472361,1476953,+,4592
323,BUMA.1121.00112,2,2965338,2969905,-,4567
323,BUMA.1121.00041,2,2363647,2368233,+,4586
323,BUMA.1121.00068,2,7484,12071,+,4587
323,BUMA.1121.00076,2,2382142,2386747,+,4605
323,BUMA.1121.00033,2,2160038,2164633,+,4595
323,BUMA.1121.00101,2,1986787,1991378,-,4591
323,BUMA.1121.00105,2,1062014,1066618,-,4604
323,BUMA.1121.00061,2,1406845,1411452,+,4607
323,BUMA.1121.00063,2,1417770,1422370,+,4600
323,BUMA.1121.00059,2,2234170,2238778,-,4608
323,BUMA.1121.00058,2,1969844,1974443,+,4599
323,BUMA.1121.00043,2,898572,903168,-,4596
323,BUMA.1121.00055,2,1245270,1249870,-,4600
323,BUMA.1121.00065,2,1466988,1471572,+,4584
323,BUMA.1121.00064,2,1335864,1340465,+,4601
323,BUMA.1121.00047,2,2352774,2357359,+,4585
323,BUMA.1121.00037,2,1781265,1785860,+,4595
323,BUMA.1121.00106,2,391703,396303,-,4600
323,BUMA.1121.00051,2,1421700,1426300,+,4600
323,BUMA.1121.00045,2,1316057,1320651,+,4594
323,BUMA.1121.00056,2,2579879,2584480,-,4601
323,BUMA.1121.00095,2,3149641,3154251,-,4610
323,BUMA.1121.00082,2,1462272,1466879,+,4607
323,BUMA.1121.00001,2,784228,788824,-,4596
323,BUMA.1121.00108,2,1647249,1651858,+,4609
323,BUMA.1121.00083,2,86162,90769,+,4607
323,BUMA.1121.00080,2,1422937,1427537,+,4600
323,BUMA.1121.00012,2,265366,269962,-,4596
324,BUMA.1121.00011,2,54943,58554,+,3611
324,BUMA.1121.00009,2,91714,95325,+,3611
324,BUMA.1121.00039,2,2527601,2531211,-,3610
324,BUMA.1121.00029,2,3158954,3162565,-,3611
324,BUMA.1121.00021,2,1945655,1949266,+,3611
324,BUMA.1121.00107,2,2378578,2382204,-,3626
324,BUMA.1121.00023,2,1555405,1559016,+,3611
324,BUMA.1121.00067,2,2548883,2552493,-,3610
324,BUMA.1121.00035,2,3176226,3179836,-,3610
324,BUMA.1121.00005,2,2859209,2862820,+,3611
324,BUMA.1121.00100,2,2567953,2571564,+,3611
324,BUMA.1121.00016,2,2276536,2280146,-,3610
324,BUMA.1121.00099,2,1683890,1687501,+,3611
324,BUMA.1121.00094,2,1469109,1472720,+,3611
324,BUMA.1121.00093,2,1502560,1506170,-,3610
324,BUMA.1121.00097,2,1273307,1276918,+,3611
324,BUMA.1121.00109,2,3311135,3314745,-,3610
324,BUMA.1121.00018,2,2371452,2375062,-,3610
324,BUMA.1121.00110,2,975563,979173,-,3610
324,BUMA.1121.00079,2,1426925,1430536,+,3611
324,BUMA.1121.00075,2,1756243,1759854,+,3611
324,BUMA.1121.00066,2,1408356,1411967,+,3611
324,BUMA.1121.00089,2,1414256,1417867,+,3611
324,BUMA.1121.00057,2,664205,667815,-,3610
324,BUMA.1121.00090,2,2413757,2417368,+,3611
324,BUMA.1121.00027,2,2482529,2486140,+,3611
324,BUMA.1121.00062,2,318105,321715,-,3610
324,BUMA.1121.00091,2,2197889,2201499,-,3610
324,BUMA.1121.00098,2,1695202,1698813,+,3611
324,BUMA.1121.00092,2,1438178,1441789,+,3611
324,BUMA.1121.00031,2,616987,620598,+,3611
324,BUMA.1121.00096,2,1641106,1644717,+,3611
324,BUMA.1121.00073,2,1423711,1427322,+,3611
324,BUMA.1121.00103,2,3369738,3373349,+,3611
324,BUMA.1121.00084,2,71405,75016,+,3611
324,BUMA.1121.00014,2,1550551,1554162,+,3611
324,BUMA.1121.00111,2,755110,758721,+,3611
324,BUMA.1121.00007,2,1505035,1508646,+,3611
324,BUMA.1121.00072,2,1402651,1406262,+,3611
324,BUMA.1121.00071,2,1423280,1426891,+,3611
324,BUMA.1121.00077,2,2269182,2272792,-,3610
324,BUMA.1121.00003,2,2483578,2487188,-,3610
324,BUMA.1121.00104,2,1518355,1521966,+,3611
324,BUMA.1121.00074,2,2934590,2938200,-,3610
324,BUMA.1121.00060,2,769619,773229,-,3610
324,BUMA.1121.00088,2,1367922,1371533,+,3611
324,BUMA.1121.00053,2,1718060,1721671,+,3611
324,BUMA.1121.00025,2,2705368,2708978,-,3610
324,BUMA.1121.00070,2,1403324,1406935,+,3611
324,BUMA.1121.00049,2,82436,86047,+,3611
324,BUMA.1121.00078,2,1711942,1715552,-,3610
324,BUMA.1121.00069,2,1400186,1403797,+,3611
324,BUMA.1121.00102,2,1477041,1480652,+,3611
324,BUMA.1121.00112,2,2961640,2965250,-,3610
324,BUMA.1121.00041,2,2368321,2371932,+,3611
324,BUMA.1121.00068,2,12159,15770,+,3611
324,BUMA.1121.00076,2,2386835,2390446,+,3611
324,BUMA.1121.00033,2,2164721,2168332,+,3611
324,BUMA.1121.00101,2,1983089,1986699,-,3610
324,BUMA.1121.00105,2,1058316,1061926,-,3610
324,BUMA.1121.00061,2,1411540,1415151,+,3611
324,BUMA.1121.00063,2,1422458,1426069,+,3611
324,BUMA.1121.00059,2,2230472,2234082,-,3610
324,BUMA.1121.00058,2,1974531,1978142,+,3611
324,BUMA.1121.00043,2,894874,898484,-,3610
324,BUMA.1121.00055,2,1241572,1245182,-,3610
324,BUMA.1121.00065,2,1471660,1475271,+,3611
324,BUMA.1121.00064,2,1340553,1344164,+,3611
324,BUMA.1121.00047,2,2357447,2361058,+,3611
324,BUMA.1121.00037,2,1785948,1789559,+,3611
324,BUMA.1121.00106,2,388005,391615,-,3610
324,BUMA.1121.00051,2,1426388,1429999,+,3611
324,BUMA.1121.00045,2,1320739,1324350,+,3611
324,BUMA.1121.00056,2,2576181,2579791,-,3610
324,BUMA.1121.00095,2,3145943,3149553,-,3610
324,BUMA.1121.00082,2,1466967,1470578,+,3611
324,BUMA.1121.00001,2,780530,784140,-,3610
324,BUMA.1121.00108,2,1651946,1655557,+,3611
324,BUMA.1121.00083,2,90857,94468,+,3611
324,BUMA.1121.00080,2,1427625,1431236,+,3611
324,BUMA.1121.00012,2,261668,265278,-,3610
325,BUMA.1121.00011,2,58555,63033,+,4478
325,BUMA.1121.00009,2,95326,99765,+,4439
325,BUMA.1121.00039,2,2523099,2527599,-,4500
325,BUMA.1121.00029,2,3154493,3158952,-,4459
325,BUMA.1121.00021,2,1949267,1953731,+,4464
325,BUMA.1121.00107,2,2374164,2378576,-,4412
325,BUMA.1121.00023,2,1559017,1563447,+,4430
325,BUMA.1121.00067,2,2544435,2548881,-,4446
325,BUMA.1121.00035,2,3171775,3176224,-,4449
325,BUMA.1121.00005,2,2862821,2867278,+,4457
325,BUMA.1121.00100,2,2571565,2576161,+,4596
325,BUMA.1121.00016,2,2272086,2276534,-,4448
325,BUMA.1121.00099,2,1687502,1691958,+,4456
325,BUMA.1121.00094,2,1472721,1477173,+,4452
325,BUMA.1121.00093,2,1498081,1502558,-,4477
325,BUMA.1121.00097,2,1276919,1281408,+,4489
325,BUMA.1121.00109,2,3306664,3311133,-,4469
325,BUMA.1121.00018,2,2366972,2371450,-,4478
325,BUMA.1121.00110,2,971098,975561,-,4463
325,BUMA.1121.00079,2,1430537,1434977,+,4440
325,BUMA.1121.00075,2,1759855,1764333,+,4478
325,BUMA.1121.00066,2,1411968,1416405,+,4437
325,BUMA.1121.00089,2,1417868,1422313,+,4445
325,BUMA.1121.00057,2,659766,664203,-,4437
325,BUMA.1121.00090,2,2417369,2421828,+,4459
325,BUMA.1121.00027,2,2486141,2490579,+,4438
325,BUMA.1121.00062,2,313668,318103,-,4435
325,BUMA.1121.00091,2,2193407,2197887,-,4480
325,BUMA.1121.00098,2,1698814,1703381,+,4567
325,BUMA.1121.00092,2,1441790,1446268,+,4478
325,BUMA.1121.00031,2,620599,625027,+,4428
325,BUMA.1121.00096,2,1644718,1649250,+,4532
325,BUMA.1121.00073,2,1427323,1431760,+,4437
325,BUMA.1121.00103,2,3373350,3377820,+,4470
325,BUMA.1121.00084,2,75017,79462,+,4445
325,BUMA.1121.00014,2,1554163,1558612,+,4449
325,BUMA.1121.00111,2,758722,763171,+,4449
325,BUMA.1121.00007,2,1508647,1513155,+,4508
325,BUMA.1121.00072,2,1406263,1410698,+,4435
325,BUMA.1121.00071,2,1426892,1431327,+,4435
325,BUMA.1121.00077,2,2264717,2269180,-,4463
325,BUMA.1121.00003,2,2479157,2483576,-,4419
325,BUMA.1121.00104,2,1521967,1526462,+,4495
325,BUMA.1121.00074,2,2930142,2934588,-,4446
325,BUMA.1121.00088,2,1371534,1375979,+,4445
325,BUMA.1121.00053,2,1721672,1726163,+,4491
325,BUMA.1121.00025,2,2700888,2705366,-,4478
325,BUMA.1121.00070,2,1406936,1411372,+,4436
325,BUMA.1121.00049,2,86048,90522,+,4474
325,BUMA.1121.00078,2,1707496,1711940,-,4444
325,BUMA.1121.00069,2,1403798,1408229,+,4431
325,BUMA.1121.00102,2,1480653,1485150,+,4497
325,BUMA.1121.00112,2,2957204,2961638,-,4434
325,BUMA.1121.00041,2,2371933,2376417,+,4484
325,BUMA.1121.00068,2,15771,20178,+,4407
325,BUMA.1121.00076,2,2390447,2394935,+,4488
325,BUMA.1121.00033,2,2168333,2172772,+,4439
325,BUMA.1121.00101,2,1978625,1983087,-,4462
325,BUMA.1121.00105,2,1053879,1058314,-,4435
325,BUMA.1121.00061,2,1415152,1419588,+,4436
325,BUMA.1121.00063,2,1426070,1430506,+,4436
325,BUMA.1121.00059,2,2226004,2230470,-,4466
325,BUMA.1121.00058,2,1978143,1982600,+,4457
325,BUMA.1121.00043,2,890344,894872,-,4528
325,BUMA.1121.00055,2,1237069,1241570,-,4501
325,BUMA.1121.00065,2,1475272,1479734,+,4462
325,BUMA.1121.00064,2,1344165,1348601,+,4436
325,BUMA.1121.00047,2,2361059,2365521,+,4462
325,BUMA.1121.00037,2,1789560,1794008,+,4448
325,BUMA.1121.00106,2,383559,388003,-,4444
325,BUMA.1121.00051,2,1430000,1434439,+,4439
325,BUMA.1121.00045,2,1324351,1328797,+,4446
325,BUMA.1121.00056,2,2571735,2576179,-,4444
325,BUMA.1121.00095,2,3141519,3145941,-,4422
325,BUMA.1121.00082,2,1470579,1475016,+,4437
325,BUMA.1121.00001,2,776079,780528,-,4449
325,BUMA.1121.00108,2,1655558,1659967,+,4409
325,BUMA.1121.00083,2,94469,98906,+,4437
325,BUMA.1121.00080,2,1431237,1435676,+,4439
325,BUMA.1121.00012,2,257138,261666,-,4528
326,BUMA.1121.00011,2,65496,76171,+,10675
326,BUMA.1121.00009,2,102252,112932,+,10680
326,BUMA.1121.00039,2,2509947,2520647,-,10700
326,BUMA.1121.00029,2,3141330,3152030,-,10700
326,BUMA.1121.00021,2,1956194,1966899,+,10705
326,BUMA.1121.00107,2,2361084,2371701,-,10617
326,BUMA.1121.00023,2,1565900,1576590,+,10690
326,BUMA.1121.00067,2,2531248,2541972,-,10724
326,BUMA.1121.00035,2,3158612,3169312,-,10700
326,BUMA.1121.00005,2,2869744,2880448,+,10704
326,BUMA.1121.00100,2,2578622,2589320,+,10698
326,BUMA.1121.00016,2,2258960,2269623,-,10663
326,BUMA.1121.00099,2,1694421,1705132,+,10711
326,BUMA.1121.00094,2,1479636,1490328,+,10692
326,BUMA.1121.00093,2,1484908,1495618,-,10710
326,BUMA.1121.00097,2,1283858,1294567,+,10709
326,BUMA.1121.00109,2,3293497,3304201,-,10704
326,BUMA.1121.00018,2,2353809,2364509,-,10700
326,BUMA.1121.00110,2,957975,968654,-,10679
326,BUMA.1121.00079,2,1437557,1448247,+,10690
326,BUMA.1121.00075,2,1766796,1777488,+,10692
326,BUMA.1121.00066,2,1418868,1429558,+,10690
326,BUMA.1121.00089,2,1424776,1435467,+,10691
326,BUMA.1121.00057,2,646603,657303,-,10700
326,BUMA.1121.00090,2,2424291,2434981,+,10690
326,BUMA.1121.00027,2,2493042,2503732,+,10690
326,BUMA.1121.00062,2,300487,311205,-,10718
326,BUMA.1121.00091,2,2180216,2190944,-,10728
326,BUMA.1121.00098,2,1705852,1716550,+,10698
326,BUMA.1121.00092,2,1448731,1459431,+,10700
326,BUMA.1121.00031,2,625054,635745,+,10691
326,BUMA.1121.00096,2,1651705,1662417,+,10712
326,BUMA.1121.00073,2,1434223,1444913,+,10690
326,BUMA.1121.00103,2,3380280,3390988,+,10708
326,BUMA.1121.00084,2,81931,92634,+,10703
326,BUMA.1121.00014,2,1558639,1569330,+,10691
326,BUMA.1121.00111,2,765634,776324,+,10690
326,BUMA.1121.00007,2,1515618,1526294,+,10676
326,BUMA.1121.00072,2,1413161,1423851,+,10690
326,BUMA.1121.00071,2,1433790,1444480,+,10690
326,BUMA.1121.00077,2,2251594,2262273,-,10679
326,BUMA.1121.00003,2,2465985,2476694,-,10709
326,BUMA.1121.00104,2,1528925,1539615,+,10690
326,BUMA.1121.00074,2,2916975,2927679,-,10704
326,BUMA.1121.00088,2,1378448,1389132,+,10684
326,BUMA.1121.00053,2,1728619,1739323,+,10704
326,BUMA.1121.00025,2,2687725,2698425,-,10700
326,BUMA.1121.00070,2,1413835,1424525,+,10690
326,BUMA.1121.00049,2,92985,103677,+,10692
326,BUMA.1121.00078,2,1694326,1705033,-,10707
326,BUMA.1121.00069,2,1410692,1421382,+,10690
326,BUMA.1121.00102,2,1487605,1498297,+,10692
326,BUMA.1121.00112,2,2944062,2954788,-,10726
326,BUMA.1121.00041,2,2378880,2389573,+,10693
326,BUMA.1121.00068,2,22633,33304,+,10671
326,BUMA.1121.00076,2,2397398,2408091,+,10693
326,BUMA.1121.00033,2,2175235,2185908,+,10673
326,BUMA.1121.00101,2,1965444,1976163,-,10719
326,BUMA.1121.00105,2,1040716,1051410,-,10694
326,BUMA.1121.00061,2,1422051,1432741,+,10690
326,BUMA.1121.00063,2,1432969,1443659,+,10690
326,BUMA.1121.00059,2,2212830,2223535,-,10705
326,BUMA.1121.00058,2,1985061,1995765,+,10704
326,BUMA.1121.00043,2,877240,887881,-,10641
326,BUMA.1121.00055,2,1223914,1234606,-,10692
326,BUMA.1121.00065,2,1482197,1492887,+,10690
326,BUMA.1121.00064,2,1351064,1361758,+,10694
326,BUMA.1121.00047,2,2367984,2378675,+,10691
326,BUMA.1121.00037,2,1796471,1807162,+,10691
326,BUMA.1121.00106,2,370378,381096,-,10718
326,BUMA.1121.00051,2,1436902,1447593,+,10691
326,BUMA.1121.00045,2,1331253,1341920,+,10667
326,BUMA.1121.00056,2,2558571,2569272,-,10701
326,BUMA.1121.00095,2,3128330,3139059,-,10729
326,BUMA.1121.00082,2,1477485,1488169,+,10684
326,BUMA.1121.00001,2,762916,773616,-,10700
326,BUMA.1121.00108,2,1662420,1673126,+,10706
326,BUMA.1121.00083,2,101375,112059,+,10684
326,BUMA.1121.00080,2,1438139,1448830,+,10691
326,BUMA.1121.00012,2,243978,254682,-,10704
327,BUMA.1121.00011,2,76172,79453,+,3281
327,BUMA.1121.00009,2,112933,116275,+,3342
327,BUMA.1121.00039,2,2506630,2509945,-,3315
327,BUMA.1121.00029,2,3138013,3141328,-,3315
327,BUMA.1121.00021,2,1966900,1970215,+,3315
327,BUMA.1121.00107,2,2357707,2361082,-,3375
327,BUMA.1121.00023,2,1576591,1579916,+,3325
327,BUMA.1121.00067,2,2527921,2531246,-,3325
327,BUMA.1121.00035,2,3155295,3158610,-,3315
327,BUMA.1121.00005,2,2880449,2883791,+,3342
327,BUMA.1121.00100,2,2589321,2592655,+,3334
327,BUMA.1121.00016,2,2255610,2258958,-,3348
327,BUMA.1121.00099,2,1705133,1708524,+,3391
327,BUMA.1121.00094,2,1490329,1493664,+,3335
327,BUMA.1121.00093,2,1481620,1484906,-,3286
327,BUMA.1121.00097,2,1294568,1297909,+,3341
327,BUMA.1121.00109,2,3290140,3293495,-,3355
327,BUMA.1121.00018,2,2350485,2353807,-,3322
327,BUMA.1121.00110,2,954646,957973,-,3327
327,BUMA.1121.00079,2,1448248,1451593,+,3345
327,BUMA.1121.00075,2,1777489,1780798,+,3309
327,BUMA.1121.00066,2,1429559,1432904,+,3345
327,BUMA.1121.00089,2,1435468,1438814,+,3346
327,BUMA.1121.00057,2,643278,646601,-,3323
327,BUMA.1121.00090,2,2434982,2438307,+,3325
327,BUMA.1121.00027,2,2503733,2507066,+,3333
327,BUMA.1121.00062,2,297161,300485,-,3324
327,BUMA.1121.00091,2,2176856,2180214,-,3358
327,BUMA.1121.00098,2,1716551,1719909,+,3358
327,BUMA.1121.00092,2,1459432,1462728,+,3296
327,BUMA.1121.00031,2,635746,639060,+,3314
327,BUMA.1121.00096,2,1662418,1665760,+,3342
327,BUMA.1121.00073,2,1444914,1448259,+,3345
327,BUMA.1121.00103,2,1,3367,+,3366
327,BUMA.1121.00084,2,92635,95955,+,3320
327,BUMA.1121.00014,2,1569331,1572645,+,3314
327,BUMA.1121.00111,2,776325,779666,+,3341
327,BUMA.1121.00007,2,1526295,1529633,+,3338
327,BUMA.1121.00072,2,1423852,1427197,+,3345
327,BUMA.1121.00071,2,1444481,1447826,+,3345
327,BUMA.1121.00077,2,2248265,2251592,-,3327
327,BUMA.1121.00003,2,2462633,2465983,-,3350
327,BUMA.1121.00104,2,1539616,1542914,+,3298
327,BUMA.1121.00074,2,2913638,2916973,-,3335
327,BUMA.1121.00088,2,1389133,1392464,+,3331
327,BUMA.1121.00053,2,1739324,1742666,+,3342
327,BUMA.1121.00025,2,2684401,2687723,-,3322
327,BUMA.1121.00070,2,1424526,1427871,+,3345
327,BUMA.1121.00049,2,103678,107009,+,3331
327,BUMA.1121.00078,2,1690983,1694324,-,3341
327,BUMA.1121.00069,2,1421383,1424728,+,3345
327,BUMA.1121.00102,2,1498298,1501660,+,3362
327,BUMA.1121.00112,2,2940726,2944060,-,3334
327,BUMA.1121.00041,2,2389574,2392947,+,3373
327,BUMA.1121.00068,2,33305,36640,+,3335
327,BUMA.1121.00076,2,2408092,2411401,+,3309
327,BUMA.1121.00033,2,2185909,2189234,+,3325
327,BUMA.1121.00101,2,1962078,1965442,-,3364
327,BUMA.1121.00105,2,1037376,1040714,-,3338
327,BUMA.1121.00061,2,1432742,1436087,+,3345
327,BUMA.1121.00063,2,1443660,1447005,+,3345
327,BUMA.1121.00059,2,2209527,2212828,-,3301
327,BUMA.1121.00058,2,1995766,1999086,+,3320
327,BUMA.1121.00043,2,873900,877238,-,3338
327,BUMA.1121.00055,2,1220547,1223912,-,3365
327,BUMA.1121.00065,2,1492888,1496239,+,3351
327,BUMA.1121.00064,2,1361759,1365118,+,3359
327,BUMA.1121.00047,2,2378676,2382021,+,3345
327,BUMA.1121.00037,2,1807163,1810477,+,3314
327,BUMA.1121.00106,2,367066,370376,-,3310
327,BUMA.1121.00051,2,1447594,1450939,+,3345
327,BUMA.1121.00045,2,1341921,1345296,+,3375
327,BUMA.1121.00056,2,2555233,2558569,-,3336
327,BUMA.1121.00095,2,3124972,3128328,-,3356
327,BUMA.1121.00082,2,1488170,1491515,+,3345
327,BUMA.1121.00001,2,759599,762914,-,3315
327,BUMA.1121.00108,2,1673127,1676495,+,3368
327,BUMA.1121.00083,2,112060,115405,+,3345
327,BUMA.1121.00080,2,1448831,1452176,+,3345
327,BUMA.1121.00012,2,240619,243976,-,3357
328,BUMA.1121.00011,2,79455,91960,+,12505
328,BUMA.1121.00009,2,116277,128773,+,12496
328,BUMA.1121.00039,2,2494118,2506629,-,12511
328,BUMA.1121.00029,2,3125508,3138012,-,12504
328,BUMA.1121.00021,2,1970217,1982721,+,12504
328,BUMA.1121.00107,2,2345233,2357706,-,12473
328,BUMA.1121.00023,2,1579918,1592422,+,12504
328,BUMA.1121.00067,2,2515366,2527920,-,12554
328,BUMA.1121.00035,2,3142790,3155294,-,12504
328,BUMA.1121.00005,2,2883793,2896304,+,12511
328,BUMA.1121.00100,2,2592657,2605148,+,12491
328,BUMA.1121.00016,2,2243117,2255609,-,12492
328,BUMA.1121.00099,2,1708526,1721081,+,12555
328,BUMA.1121.00094,2,1493666,1506212,+,12546
328,BUMA.1121.00093,2,1469104,1481619,-,12515
328,BUMA.1121.00097,2,1297911,1310450,+,12539
328,BUMA.1121.00109,2,3277594,3290139,-,12545
328,BUMA.1121.00018,2,2337980,2350484,-,12504
328,BUMA.1121.00110,2,942115,954645,-,12530
328,BUMA.1121.00079,2,1451595,1464157,+,12562
328,BUMA.1121.00075,2,1780800,1793324,+,12524
328,BUMA.1121.00066,2,1432906,1445449,+,12543
328,BUMA.1121.00089,2,1438816,1451369,+,12553
328,BUMA.1121.00057,2,630727,643277,-,12550
328,BUMA.1121.00090,2,2438309,2450813,+,12504
328,BUMA.1121.00027,2,2507068,2519610,+,12542
328,BUMA.1121.00062,2,284617,297160,-,12543
328,BUMA.1121.00091,2,2164344,2176855,-,12511
328,BUMA.1121.00098,2,1719911,1732418,+,12507
328,BUMA.1121.00092,2,1462730,1475245,+,12515
328,BUMA.1121.00031,2,639062,651564,+,12502
328,BUMA.1121.00096,2,1665762,1678280,+,12518
328,BUMA.1121.00073,2,1448261,1460804,+,12543
328,BUMA.1121.00103,2,3369,15902,+,12533
328,BUMA.1121.00084,2,95957,108468,+,12511
328,BUMA.1121.00014,2,1572647,1585151,+,12504
328,BUMA.1121.00111,2,790500,802965,+,12465
328,BUMA.1121.00007,2,1529635,1542137,+,12502
328,BUMA.1121.00072,2,1427199,1439742,+,12543
328,BUMA.1121.00071,2,1447828,1460371,+,12543
328,BUMA.1121.00077,2,2235734,2248264,-,12530
328,BUMA.1121.00003,2,2450120,2462632,-,12512
328,BUMA.1121.00104,2,1542916,1555470,+,12554
328,BUMA.1121.00074,2,2901090,2913637,-,12547
328,BUMA.1121.00088,2,1392466,1404977,+,12511
328,BUMA.1121.00053,2,1742668,1755220,+,12552
328,BUMA.1121.00025,2,2671896,2684400,-,12504
328,BUMA.1121.00070,2,1427873,1440416,+,12543
328,BUMA.1121.00049,2,107011,119543,+,12532
328,BUMA.1121.00078,2,1678472,1690982,-,12510
328,BUMA.1121.00069,2,1424730,1437273,+,12543
328,BUMA.1121.00102,2,1501662,1514230,+,12568
328,BUMA.1121.00112,2,2928214,2940725,-,12511
328,BUMA.1121.00041,2,2392949,2405460,+,12511
328,BUMA.1121.00068,2,36642,49145,+,12503
328,BUMA.1121.00076,2,2411403,2423928,+,12525
328,BUMA.1121.00033,2,2189236,2201737,+,12501
328,BUMA.1121.00101,2,1949564,1962077,-,12513
328,BUMA.1121.00105,2,1024860,1037375,-,12515
328,BUMA.1121.00061,2,1436089,1448632,+,12543
328,BUMA.1121.00063,2,1447007,1459550,+,12543
328,BUMA.1121.00059,2,2196987,2209526,-,12539
328,BUMA.1121.00058,2,1999088,2011610,+,12522
328,BUMA.1121.00043,2,861382,873899,-,12517
328,BUMA.1121.00055,2,1208021,1220546,-,12525
328,BUMA.1121.00065,2,1496241,1508781,+,12540
328,BUMA.1121.00064,2,1365120,1377624,+,12504
328,BUMA.1121.00047,2,2382023,2394583,+,12560
328,BUMA.1121.00037,2,1810479,1822984,+,12505
328,BUMA.1121.00106,2,354540,367065,-,12525
328,BUMA.1121.00051,2,1450941,1463466,+,12525
328,BUMA.1121.00045,2,1345298,1357822,+,12524
328,BUMA.1121.00056,2,2542679,2555232,-,12553
328,BUMA.1121.00095,2,3112447,3124971,-,12524
328,BUMA.1121.00082,2,1491517,1504060,+,12543
328,BUMA.1121.00001,2,747095,759598,-,12503
328,BUMA.1121.00108,2,1676497,1689015,+,12518
328,BUMA.1121.00083,2,115407,127950,+,12543
328,BUMA.1121.00080,2,1452178,1464703,+,12525
328,BUMA.1121.00012,2,228122,240618,-,12496
329,BUMA.1121.00011,2,93515,120021,+,26506
329,BUMA.1121.00009,2,130337,156847,+,26510
329,BUMA.1121.00039,2,2466111,2492544,-,26433
329,BUMA.1121.00029,2,3097501,3123943,-,26442
329,BUMA.1121.00021,2,1984324,2010808,+,26484
329,BUMA.1121.00107,2,2317178,2343671,-,26493
329,BUMA.1121.00023,2,1593977,1620470,+,26493
329,BUMA.1121.00067,2,2487319,2513801,-,26482
329,BUMA.1121.00035,2,3114783,3141225,-,26442
329,BUMA.1121.00005,2,2897868,2924348,+,26480
329,BUMA.1121.00100,2,2606712,2633215,+,26503
329,BUMA.1121.00016,2,2215126,2241552,-,26426
329,BUMA.1121.00099,2,1722633,1749104,+,26471
329,BUMA.1121.00094,2,1507776,1534289,+,26513
329,BUMA.1121.00093,2,1441049,1467530,-,26481
329,BUMA.1121.00097,2,1312002,1338437,+,26435
329,BUMA.1121.00109,2,3249564,3276029,-,26465
329,BUMA.1121.00018,2,2309988,2336415,-,26427
329,BUMA.1121.00110,2,914068,940562,-,26494
329,BUMA.1121.00079,2,1465721,1492231,+,26510
329,BUMA.1121.00075,2,1794888,1821329,+,26441
329,BUMA.1121.00066,2,1447013,1473452,+,26439
329,BUMA.1121.00089,2,1452933,1479447,+,26514
329,BUMA.1121.00057,2,602648,629162,-,26514
329,BUMA.1121.00090,2,2452386,2478819,+,26433
329,BUMA.1121.00027,2,2521174,2547668,+,26494
329,BUMA.1121.00062,2,256642,283058,-,26416
329,BUMA.1121.00091,2,2136258,2162761,-,26503
329,BUMA.1121.00098,2,1733992,1760488,+,26496
329,BUMA.1121.00092,2,1476818,1503299,+,26481
329,BUMA.1121.00031,2,653137,679570,+,26433
329,BUMA.1121.00096,2,1679832,1706324,+,26492
329,BUMA.1121.00073,2,1462367,1488807,+,26440
329,BUMA.1121.00103,2,17466,43947,+,26481
329,BUMA.1121.00084,2,110032,136472,+,26440
329,BUMA.1121.00014,2,1586724,1613157,+,26433
329,BUMA.1121.00111,2,804538,830972,+,26434
329,BUMA.1121.00007,2,1543692,1570172,+,26480
329,BUMA.1121.00072,2,1441306,1467746,+,26440
329,BUMA.1121.00071,2,1461935,1488375,+,26440
329,BUMA.1121.00077,2,2207688,2234182,-,26494
329,BUMA.1121.00003,2,2422075,2448567,-,26492
329,BUMA.1121.00104,2,1557034,1583470,+,26436
329,BUMA.1121.00074,2,2873043,2899525,-,26482
329,BUMA.1121.00088,2,1406541,1432981,+,26440
329,BUMA.1121.00053,2,1756772,1783300,+,26528
329,BUMA.1121.00025,2,2643904,2670331,-,26427
329,BUMA.1121.00070,2,1441980,1468420,+,26440
329,BUMA.1121.00049,2,121107,147620,+,26513
329,BUMA.1121.00078,2,1650437,1676907,-,26470
329,BUMA.1121.00069,2,1438837,1465276,+,26439
329,BUMA.1121.00102,2,1515803,1542331,+,26528
329,BUMA.1121.00112,2,2900199,2926661,-,26462
329,BUMA.1121.00041,2,2407024,2433516,+,26492
329,BUMA.1121.00068,2,50709,77210,+,26501
329,BUMA.1121.00076,2,2425492,2451934,+,26442
329,BUMA.1121.00033,2,2203301,2229792,+,26491
329,BUMA.1121.00101,2,1921571,1948020,-,26449
329,BUMA.1121.00105,2,996901,1023301,-,26400
329,BUMA.1121.00061,2,1450196,1476635,+,26439
329,BUMA.1121.00063,2,1461114,1487554,+,26440
329,BUMA.1121.00059,2,2168948,2195422,-,26474
329,BUMA.1121.00058,2,2013174,2039623,+,26449
329,BUMA.1121.00043,2,833350,859817,-,26467
329,BUMA.1121.00055,2,1180027,1206450,-,26423
329,BUMA.1121.00065,2,1510354,1536787,+,26433
329,BUMA.1121.00064,2,1379188,1405650,+,26462
329,BUMA.1121.00047,2,2396147,2422661,+,26514
329,BUMA.1121.00037,2,1824548,1850981,+,26433
329,BUMA.1121.00106,2,326541,352975,-,26434
329,BUMA.1121.00051,2,1465030,1491544,+,26514
329,BUMA.1121.00045,2,1359396,1385858,+,26462
329,BUMA.1121.00056,2,2514600,2541114,-,26514
329,BUMA.1121.00095,2,3084412,3110894,-,26482
329,BUMA.1121.00082,2,1505624,1532064,+,26440
329,BUMA.1121.00001,2,719088,745530,-,26442
329,BUMA.1121.00108,2,1690579,1717036,+,26457
329,BUMA.1121.00083,2,129514,155954,+,26440
329,BUMA.1121.00080,2,1466267,1492781,+,26514
329,BUMA.1121.00012,2,200116,226548,-,26432
330,BUMA.1121.00011,2,121243,131328,+,10085
330,BUMA.1121.00009,2,158069,168154,+,10085
330,BUMA.1121.00039,2,2454803,2464889,-,10086
330,BUMA.1121.00029,2,3086179,3096279,-,10100
330,BUMA.1121.00021,2,2012030,2022116,+,10086
330,BUMA.1121.00107,2,2305887,2315956,-,10069
330,BUMA.1121.00023,2,1632488,1642570,+,10082
330,BUMA.1121.00067,2,2476013,2486097,-,10084
330,BUMA.1121.00035,2,3103461,3113561,-,10100
330,BUMA.1121.00005,2,2925570,2935644,+,10074
330,BUMA.1121.00100,2,2634437,2644501,+,10064
330,BUMA.1121.00016,2,2203824,2213904,-,10080
330,BUMA.1121.00099,2,1750326,1760401,+,10075
330,BUMA.1121.00094,2,1535511,1545610,+,10099
330,BUMA.1121.00093,2,1429743,1439827,-,10084
330,BUMA.1121.00097,2,1339659,1349743,+,10084
330,BUMA.1121.00109,2,3238257,3248342,-,10085
330,BUMA.1121.00018,2,2298680,2308766,-,10086
330,BUMA.1121.00110,2,902760,912846,-,10086
330,BUMA.1121.00079,2,1493453,1503526,+,10073
330,BUMA.1121.00075,2,1822548,1832626,+,10078
330,BUMA.1121.00066,2,1474674,1484748,+,10074
330,BUMA.1121.00089,2,1480669,1490783,+,10114
330,BUMA.1121.00057,2,591341,601426,-,10085
330,BUMA.1121.00090,2,2480041,2490138,+,10097
330,BUMA.1121.00027,2,2548890,2558974,+,10084
330,BUMA.1121.00062,2,245346,255420,-,10074
330,BUMA.1121.00091,2,2124962,2135036,-,10074
330,BUMA.1121.00098,2,1761710,1771794,+,10084
330,BUMA.1121.00092,2,1504521,1514605,+,10084
330,BUMA.1121.00031,2,680792,690884,+,10092
330,BUMA.1121.00096,2,1707546,1717631,+,10085
330,BUMA.1121.00073,2,1490029,1500103,+,10074
330,BUMA.1121.00103,2,45169,55244,+,10075
330,BUMA.1121.00084,2,137694,147779,+,10085
330,BUMA.1121.00014,2,1614379,1624461,+,10082
330,BUMA.1121.00111,2,832194,842280,+,10086
330,BUMA.1121.00007,2,1571394,1581468,+,10074
330,BUMA.1121.00072,2,1468968,1479042,+,10074
330,BUMA.1121.00071,2,1489597,1499671,+,10074
330,BUMA.1121.00077,2,2196380,2206466,-,10086
330,BUMA.1121.00003,2,2410778,2420853,-,10075
330,BUMA.1121.00104,2,1584692,1594777,+,10085
330,BUMA.1121.00074,2,2861737,2871821,-,10084
330,BUMA.1121.00088,2,1434203,1444288,+,10085
330,BUMA.1121.00053,2,1784522,1794606,+,10084
330,BUMA.1121.00025,2,2632596,2642682,-,10086
330,BUMA.1121.00070,2,1469642,1479713,+,10071
330,BUMA.1121.00049,2,148842,158896,+,10054
330,BUMA.1121.00078,2,1639141,1649215,-,10074
330,BUMA.1121.00069,2,1466498,1476572,+,10074
330,BUMA.1121.00102,2,1543553,1553652,+,10099
330,BUMA.1121.00112,2,2888903,2898977,-,10074
330,BUMA.1121.00041,2,2434738,2444812,+,10074
330,BUMA.1121.00068,2,78432,88515,+,10083
330,BUMA.1121.00076,2,2453156,2463235,+,10079
330,BUMA.1121.00033,2,2231014,2241100,+,10086
330,BUMA.1121.00101,2,1910265,1920349,-,10084
330,BUMA.1121.00105,2,985605,995679,-,10074
330,BUMA.1121.00061,2,1477857,1487922,+,10065
330,BUMA.1121.00063,2,1488776,1498850,+,10074
330,BUMA.1121.00059,2,2157627,2167726,-,10099
330,BUMA.1121.00058,2,2040845,2050930,+,10085
330,BUMA.1121.00043,2,822043,832128,-,10085
330,BUMA.1121.00055,2,1168706,1178805,-,10099
330,BUMA.1121.00065,2,1538009,1548093,+,10084
330,BUMA.1121.00064,2,1406872,1416971,+,10099
330,BUMA.1121.00047,2,2423883,2433982,+,10099
330,BUMA.1121.00037,2,1852203,1862285,+,10082
330,BUMA.1121.00106,2,315210,325319,-,10109
330,BUMA.1121.00051,2,1492766,1502864,+,10098
330,BUMA.1121.00045,2,1387080,1397164,+,10084
330,BUMA.1121.00056,2,2503264,2513378,-,10114
330,BUMA.1121.00095,2,3073106,3083190,-,10084
330,BUMA.1121.00082,2,1533286,1543360,+,10074
330,BUMA.1121.00001,2,707766,717866,-,10100
330,BUMA.1121.00108,2,1718258,1728343,+,10085
330,BUMA.1121.00083,2,157176,167250,+,10074
330,BUMA.1121.00080,2,1494003,1504102,+,10099
330,BUMA.1121.00012,2,188814,198894,-,10080
331,BUMA.1121.00011,2,132749,139425,+,6676
331,BUMA.1121.00009,2,169575,176256,+,6681
331,BUMA.1121.00039,2,2446704,2453383,-,6679
331,BUMA.1121.00029,2,3078080,3084759,-,6679
331,BUMA.1121.00021,2,2023537,2030213,+,6676
331,BUMA.1121.00107,2,2297788,2304467,-,6679
331,BUMA.1121.00023,2,1643991,1650665,+,6674
331,BUMA.1121.00067,2,2467917,2474590,-,6673
331,BUMA.1121.00035,2,3095362,3102041,-,6679
331,BUMA.1121.00005,2,2937065,2943741,+,6676
331,BUMA.1121.00100,2,2645922,2652603,+,6681
331,BUMA.1121.00016,2,2195725,2202404,-,6679
331,BUMA.1121.00099,2,1761822,1768498,+,6676
331,BUMA.1121.00094,2,1547031,1553712,+,6681
331,BUMA.1121.00093,2,1421647,1428323,-,6676
331,BUMA.1121.00097,2,1351164,1357845,+,6681
331,BUMA.1121.00109,2,3230182,3236837,-,6655
331,BUMA.1121.00018,2,2290584,2297260,-,6676
331,BUMA.1121.00110,2,894659,901340,-,6681
331,BUMA.1121.00079,2,1504947,1511628,+,6681
331,BUMA.1121.00075,2,1834047,1840723,+,6676
331,BUMA.1121.00066,2,1486169,1492845,+,6676
331,BUMA.1121.00089,2,1492204,1498885,+,6681
331,BUMA.1121.00057,2,583245,589921,-,6676
331,BUMA.1121.00090,2,2491559,2498238,+,6679
331,BUMA.1121.00027,2,2560395,2567071,+,6676
331,BUMA.1121.00062,2,237250,243926,-,6676
331,BUMA.1121.00091,2,2116861,2123542,-,6681
331,BUMA.1121.00098,2,1773215,1779896,+,6681
331,BUMA.1121.00092,2,1516026,1522702,+,6676
331,BUMA.1121.00031,2,692305,698981,+,6676
331,BUMA.1121.00096,2,1719052,1725728,+,6676
331,BUMA.1121.00073,2,1501524,1508200,+,6676
331,BUMA.1121.00103,2,56665,63341,+,6676
331,BUMA.1121.00084,2,149200,155876,+,6676
331,BUMA.1121.00014,2,1625882,1632558,+,6676
331,BUMA.1121.00111,2,843701,850377,+,6676
331,BUMA.1121.00007,2,1582889,1589570,+,6681
331,BUMA.1121.00072,2,1480463,1487139,+,6676
331,BUMA.1121.00071,2,1501092,1507768,+,6676
331,BUMA.1121.00077,2,2188276,2194960,-,6684
331,BUMA.1121.00003,2,2402682,2409358,-,6676
331,BUMA.1121.00104,2,1596198,1602874,+,6676
331,BUMA.1121.00074,2,2853641,2860317,-,6676
331,BUMA.1121.00088,2,1445709,1452385,+,6676
331,BUMA.1121.00053,2,1796027,1802703,+,6676
331,BUMA.1121.00025,2,2624500,2631176,-,6676
331,BUMA.1121.00070,2,1481134,1487810,+,6676
331,BUMA.1121.00049,2,160317,166993,+,6676
331,BUMA.1121.00078,2,1631044,1637721,-,6677
331,BUMA.1121.00069,2,1477993,1484669,+,6676
331,BUMA.1121.00102,2,1555073,1561749,+,6676
331,BUMA.1121.00112,2,2880807,2887483,-,6676
331,BUMA.1121.00041,2,2446236,2452909,+,6673
331,BUMA.1121.00068,2,89936,96613,+,6677
331,BUMA.1121.00076,2,2464656,2471332,+,6676
331,BUMA.1121.00033,2,2242521,2249232,+,6711
331,BUMA.1121.00101,2,1902164,1908845,-,6681
331,BUMA.1121.00105,2,977509,984185,-,6676
331,BUMA.1121.00061,2,1489343,1496019,+,6676
331,BUMA.1121.00063,2,1500271,1506947,+,6676
331,BUMA.1121.00059,2,2149531,2156207,-,6676
331,BUMA.1121.00058,2,2052351,2059027,+,6676
331,BUMA.1121.00043,2,813947,820623,-,6676
331,BUMA.1121.00055,2,1160610,1167286,-,6676
331,BUMA.1121.00065,2,1549514,1556195,+,6681
331,BUMA.1121.00064,2,1418392,1425068,+,6676
331,BUMA.1121.00047,2,2435403,2442084,+,6681
331,BUMA.1121.00037,2,1863706,1870382,+,6676
331,BUMA.1121.00106,2,307114,313787,-,6673
331,BUMA.1121.00051,2,1504285,1510966,+,6681
331,BUMA.1121.00045,2,1398585,1405261,+,6676
331,BUMA.1121.00056,2,2495163,2501844,-,6681
331,BUMA.1121.00095,2,3065005,3071683,-,6678
331,BUMA.1121.00082,2,1544784,1551457,+,6673
331,BUMA.1121.00001,2,699667,706346,-,6679
331,BUMA.1121.00108,2,1729764,1736445,+,6681
331,BUMA.1121.00083,2,168674,175347,+,6673
331,BUMA.1121.00080,2,1505523,1512204,+,6681
331,BUMA.1121.00012,2,180718,187394,-,6676
332,BUMA.1121.00011,2,141894,145258,+,3364
332,BUMA.1121.00009,2,178753,182118,+,3365
332,BUMA.1121.00039,2,2440881,2444237,-,3356
332,BUMA.1121.00029,2,3064281,3067645,-,3364
332,BUMA.1121.00021,2,2040649,2044005,+,3356
332,BUMA.1121.00107,2,2291952,2295316,-,3364
332,BUMA.1121.00023,2,1653112,1656476,+,3364
332,BUMA.1121.00067,2,2462068,2465432,-,3364
332,BUMA.1121.00035,2,3081562,3084926,-,3364
332,BUMA.1121.00005,2,2946242,2949558,+,3316
332,BUMA.1121.00100,2,2655063,2658427,+,3364
332,BUMA.1121.00016,2,2189894,2193258,-,3364
332,BUMA.1121.00099,2,1770983,1774347,+,3364
332,BUMA.1121.00094,2,1556179,1559543,+,3364
332,BUMA.1121.00093,2,1415816,1419180,-,3364
332,BUMA.1121.00097,2,1360315,1363679,+,3364
332,BUMA.1121.00109,2,3224333,3227696,-,3363
332,BUMA.1121.00018,2,2284753,2288117,-,3364
332,BUMA.1121.00110,2,888823,892187,-,3364
332,BUMA.1121.00079,2,1515414,1518772,+,3358
332,BUMA.1121.00075,2,1843211,1846575,+,3364
332,BUMA.1121.00066,2,1495302,1498666,+,3364
332,BUMA.1121.00089,2,1501352,1504716,+,3364
332,BUMA.1121.00057,2,577413,580777,-,3364
332,BUMA.1121.00090,2,2500705,2504061,+,3356
332,BUMA.1121.00027,2,2569538,2572902,+,3364
332,BUMA.1121.00062,2,231401,234765,-,3364
332,BUMA.1121.00091,2,2111018,2114382,-,3364
332,BUMA.1121.00098,2,1782363,1785727,+,3364
332,BUMA.1121.00092,2,1525169,1528533,+,3364
332,BUMA.1121.00031,2,701448,704804,+,3356
332,BUMA.1121.00096,2,1728202,1731566,+,3364
332,BUMA.1121.00073,2,1510660,1514024,+,3364
332,BUMA.1121.00103,2,65802,69166,+,3364
332,BUMA.1121.00084,2,158407,161782,+,3375
332,BUMA.1121.00014,2,1635025,1638389,+,3364
332,BUMA.1121.00111,2,852844,856208,+,3364
332,BUMA.1121.00007,2,1592035,1595399,+,3364
332,BUMA.1121.00072,2,1489599,1492963,+,3364
332,BUMA.1121.00071,2,1510225,1513589,+,3364
332,BUMA.1121.00077,2,2182442,2185804,-,3362
332,BUMA.1121.00003,2,2396844,2400208,-,3364
332,BUMA.1121.00104,2,1605341,1608705,+,3364
332,BUMA.1121.00074,2,2847792,2851156,-,3364
332,BUMA.1121.00088,2,1454908,1458272,+,3364
332,BUMA.1121.00053,2,1805188,1808552,+,3364
332,BUMA.1121.00025,2,2618669,2622033,-,3364
332,BUMA.1121.00070,2,1490270,1493634,+,3364
332,BUMA.1121.00049,2,169460,172824,+,3364
332,BUMA.1121.00078,2,1625213,1628577,-,3364
332,BUMA.1121.00069,2,1487129,1490493,+,3364
332,BUMA.1121.00102,2,1565535,1568893,+,3358
332,BUMA.1121.00112,2,2874956,2878320,-,3364
332,BUMA.1121.00041,2,2455399,2458764,+,3365
332,BUMA.1121.00068,2,99068,102433,+,3365
332,BUMA.1121.00076,2,2473820,2477184,+,3364
332,BUMA.1121.00033,2,2278862,2282226,+,3364
332,BUMA.1121.00101,2,1896335,1899699,-,3364
332,BUMA.1121.00105,2,971618,974969,-,3351
332,BUMA.1121.00061,2,1498479,1501843,+,3364
332,BUMA.1121.00063,2,1509407,1512771,+,3364
332,BUMA.1121.00059,2,2143700,2147064,-,3364
332,BUMA.1121.00058,2,2061512,2064876,+,3364
332,BUMA.1121.00043,2,780950,784314,-,3364
332,BUMA.1121.00055,2,1154761,1158125,-,3364
332,BUMA.1121.00065,2,1558662,1562026,+,3364
332,BUMA.1121.00064,2,1427553,1430917,+,3364
332,BUMA.1121.00047,2,2445870,2449228,+,3358
332,BUMA.1121.00037,2,1872849,1876205,+,3356
332,BUMA.1121.00106,2,301216,304567,-,3351
332,BUMA.1121.00051,2,1514752,1518110,+,3358
332,BUMA.1121.00045,2,1407749,1411113,+,3364
332,BUMA.1121.00056,2,2489332,2492696,-,3364
332,BUMA.1121.00095,2,3059197,3062561,-,3364
332,BUMA.1121.00082,2,1553917,1557281,+,3364
332,BUMA.1121.00001,2,685867,689231,-,3364
332,BUMA.1121.00108,2,1738933,1742297,+,3364
332,BUMA.1121.00083,2,177807,181171,+,3364
332,BUMA.1121.00080,2,1515990,1519348,+,3358
332,BUMA.1121.00012,2,147721,151085,-,3364
333,BUMA.1121.00011,2,148414,154070,+,5656
333,BUMA.1121.00009,2,185285,190950,+,5665
333,BUMA.1121.00039,2,2432083,2437725,-,5642
333,BUMA.1121.00029,2,3055491,3061133,-,5642
333,BUMA.1121.00021,2,2047160,2052803,+,5643
333,BUMA.1121.00107,2,2283131,2288795,-,5664
333,BUMA.1121.00023,2,1659623,1665266,+,5643
333,BUMA.1121.00067,2,2453268,2458910,-,5642
333,BUMA.1121.00035,2,3072772,3078414,-,5642
333,BUMA.1121.00005,2,2953875,2959540,+,5665
333,BUMA.1121.00100,2,2661570,2667212,+,5642
333,BUMA.1121.00016,2,2181104,2186746,-,5642
333,BUMA.1121.00099,2,1777495,1783160,+,5665
333,BUMA.1121.00094,2,1562690,1568346,+,5656
333,BUMA.1121.00093,2,1407004,1412668,-,5664
333,BUMA.1121.00097,2,1366844,1372486,+,5642
333,BUMA.1121.00109,2,3215534,3221198,-,5664
333,BUMA.1121.00018,2,2275963,2281605,-,5642
333,BUMA.1121.00110,2,880021,885676,-,5655
333,BUMA.1121.00079,2,1521918,1527574,+,5656
333,BUMA.1121.00075,2,1849730,1855395,+,5665
333,BUMA.1121.00066,2,1501822,1507487,+,5665
333,BUMA.1121.00089,2,1507863,1513519,+,5656
333,BUMA.1121.00057,2,568610,574265,-,5655
333,BUMA.1121.00090,2,2507216,2512859,+,5643
333,BUMA.1121.00027,2,2576050,2581706,+,5656
333,BUMA.1121.00062,2,222579,228243,-,5664
333,BUMA.1121.00091,2,2102215,2107870,-,5655
333,BUMA.1121.00098,2,1788883,1794525,+,5642
333,BUMA.1121.00092,2,1531680,1537345,+,5665
333,BUMA.1121.00031,2,707959,713602,+,5643
333,BUMA.1121.00096,2,1734713,1740384,+,5671
333,BUMA.1121.00073,2,1517180,1522822,+,5642
333,BUMA.1121.00103,2,72300,77965,+,5665
333,BUMA.1121.00084,2,164941,170606,+,5665
333,BUMA.1121.00014,2,1641536,1647201,+,5665
333,BUMA.1121.00111,2,859355,864998,+,5643
333,BUMA.1121.00007,2,1598556,1604199,+,5643
333,BUMA.1121.00072,2,1496119,1501784,+,5665
333,BUMA.1121.00071,2,1516745,1522387,+,5642
333,BUMA.1121.00077,2,2173640,2179295,-,5655
333,BUMA.1121.00003,2,2388019,2393661,-,5642
333,BUMA.1121.00104,2,1611850,1617492,+,5642
333,BUMA.1121.00074,2,2838992,2844634,-,5642
333,BUMA.1121.00088,2,1461419,1467084,+,5665
333,BUMA.1121.00053,2,1811709,1817365,+,5656
333,BUMA.1121.00025,2,2609879,2615521,-,5642
333,BUMA.1121.00070,2,1496790,1502432,+,5642
333,BUMA.1121.00049,2,175971,181627,+,5656
333,BUMA.1121.00078,2,1616410,1622065,-,5655
333,BUMA.1121.00069,2,1493649,1499291,+,5642
333,BUMA.1121.00102,2,1572040,1577705,+,5665
333,BUMA.1121.00112,2,2866143,2871807,-,5664
333,BUMA.1121.00041,2,2461921,2467563,+,5642
333,BUMA.1121.00068,2,105590,111241,+,5651
333,BUMA.1121.00076,2,2480340,2486005,+,5665
333,BUMA.1121.00033,2,2285373,2291038,+,5665
333,BUMA.1121.00101,2,1887523,1893178,-,5655
333,BUMA.1121.00105,2,962785,968449,-,5664
333,BUMA.1121.00061,2,1504999,1510641,+,5642
333,BUMA.1121.00063,2,1515927,1521569,+,5642
333,BUMA.1121.00059,2,2134888,2140543,-,5655
333,BUMA.1121.00058,2,2068032,2073688,+,5656
333,BUMA.1121.00043,2,772160,777802,-,5642
333,BUMA.1121.00055,2,1145961,1151603,-,5642
333,BUMA.1121.00065,2,1565173,1570838,+,5665
333,BUMA.1121.00064,2,1434074,1439730,+,5656
333,BUMA.1121.00047,2,2452375,2458031,+,5656
333,BUMA.1121.00037,2,1879360,1885003,+,5643
333,BUMA.1121.00106,2,292395,298059,-,5664
333,BUMA.1121.00051,2,1521256,1526912,+,5656
333,BUMA.1121.00045,2,1414270,1419935,+,5665
333,BUMA.1121.00056,2,2480529,2486184,-,5655
333,BUMA.1121.00095,2,3050376,3056040,-,5664
333,BUMA.1121.00082,2,1560437,1566102,+,5665
333,BUMA.1121.00001,2,677077,682719,-,5642
333,BUMA.1121.00108,2,1745454,1751119,+,5665
333,BUMA.1121.00083,2,184327,189992,+,5665
333,BUMA.1121.00080,2,1522495,1528151,+,5656
333,BUMA.1121.00012,2,138931,144573,-,5642
334,BUMA.1121.00011,2,154306,158248,+,3942
334,BUMA.1121.00009,2,191177,195119,+,3942
334,BUMA.1121.00039,2,2427891,2431834,-,3943
334,BUMA.1121.00029,2,3051299,3055242,-,3943
334,BUMA.1121.00021,2,2053052,2056994,+,3942
334,BUMA.1121.00107,2,2278961,2282904,-,3943
334,BUMA.1121.00023,2,1665515,1669457,+,3942
334,BUMA.1121.00067,2,2449076,2453010,-,3934
334,BUMA.1121.00035,2,3068580,3072523,-,3943
334,BUMA.1121.00005,2,2959767,2963708,+,3941
334,BUMA.1121.00100,2,2667470,2671404,+,3934
334,BUMA.1121.00016,2,2176912,2180855,-,3943
334,BUMA.1121.00099,2,1783387,1787329,+,3942
334,BUMA.1121.00094,2,1568582,1572524,+,3942
334,BUMA.1121.00093,2,1402834,1406777,-,3943
334,BUMA.1121.00097,2,1372744,1376678,+,3934
334,BUMA.1121.00109,2,3211364,3215307,-,3943
334,BUMA.1121.00018,2,2271771,2275714,-,3943
334,BUMA.1121.00110,2,875842,879785,-,3943
334,BUMA.1121.00079,2,1527810,1531752,+,3942
334,BUMA.1121.00075,2,1855622,1859564,+,3942
334,BUMA.1121.00066,2,1507714,1511656,+,3942
334,BUMA.1121.00089,2,1513755,1517697,+,3942
334,BUMA.1121.00057,2,564431,568374,-,3943
334,BUMA.1121.00090,2,2513108,2517050,+,3942
334,BUMA.1121.00027,2,2581942,2585884,+,3942
334,BUMA.1121.00062,2,218409,222352,-,3943
334,BUMA.1121.00091,2,2098036,2101979,-,3943
334,BUMA.1121.00098,2,1794783,1798717,+,3934
334,BUMA.1121.00092,2,1537572,1541514,+,3942
334,BUMA.1121.00031,2,713851,717793,+,3942
334,BUMA.1121.00096,2,1740620,1744562,+,3942
334,BUMA.1121.00073,2,1523080,1527014,+,3934
334,BUMA.1121.00103,2,78192,82134,+,3942
334,BUMA.1121.00084,2,170833,174775,+,3942
334,BUMA.1121.00014,2,1647428,1651370,+,3942
334,BUMA.1121.00111,2,865247,869189,+,3942
334,BUMA.1121.00007,2,1604448,1608390,+,3942
334,BUMA.1121.00072,2,1502011,1505953,+,3942
334,BUMA.1121.00071,2,1522645,1526579,+,3934
334,BUMA.1121.00077,2,2169461,2173404,-,3943
334,BUMA.1121.00003,2,2383827,2387761,-,3934
334,BUMA.1121.00104,2,1617750,1621684,+,3934
334,BUMA.1121.00074,2,2834800,2838734,-,3934
334,BUMA.1121.00088,2,1467311,1471253,+,3942
334,BUMA.1121.00053,2,1817601,1821543,+,3942
334,BUMA.1121.00025,2,2605687,2609630,-,3943
334,BUMA.1121.00070,2,1502690,1506624,+,3934
334,BUMA.1121.00049,2,181863,185805,+,3942
334,BUMA.1121.00078,2,1612231,1616174,-,3943
334,BUMA.1121.00069,2,1499549,1503483,+,3934
334,BUMA.1121.00102,2,1577932,1581874,+,3942
334,BUMA.1121.00112,2,2861962,2865916,-,3954
334,BUMA.1121.00041,2,2467821,2471755,+,3934
334,BUMA.1121.00068,2,111499,115433,+,3934
334,BUMA.1121.00076,2,2486232,2490174,+,3942
334,BUMA.1121.00033,2,2291265,2295207,+,3942
334,BUMA.1121.00101,2,1883344,1887285,-,3941
334,BUMA.1121.00105,2,958615,962558,-,3943
334,BUMA.1121.00061,2,1510899,1514833,+,3934
334,BUMA.1121.00063,2,1521827,1525761,+,3934
334,BUMA.1121.00059,2,2130709,2134652,-,3943
334,BUMA.1121.00058,2,2073924,2077866,+,3942
334,BUMA.1121.00043,2,767968,771911,-,3943
334,BUMA.1121.00055,2,1141769,1145703,-,3934
334,BUMA.1121.00065,2,1571065,1575007,+,3942
334,BUMA.1121.00064,2,1439966,1443908,+,3942
334,BUMA.1121.00047,2,2458267,2462209,+,3942
334,BUMA.1121.00037,2,1885252,1889194,+,3942
334,BUMA.1121.00106,2,288225,292168,-,3943
334,BUMA.1121.00051,2,1527148,1531090,+,3942
334,BUMA.1121.00045,2,1420162,1424104,+,3942
334,BUMA.1121.00056,2,2476350,2480293,-,3943
334,BUMA.1121.00095,2,3046206,3050149,-,3943
334,BUMA.1121.00082,2,1566329,1570271,+,3942
334,BUMA.1121.00001,2,672885,676828,-,3943
334,BUMA.1121.00108,2,1751346,1755288,+,3942
334,BUMA.1121.00083,2,190219,194161,+,3942
334,BUMA.1121.00080,2,1528387,1532329,+,3942
334,BUMA.1121.00012,2,134739,138682,-,3943
335,BUMA.1121.00011,2,164517,180392,+,15875
335,BUMA.1121.00009,2,201382,217254,+,15872
335,BUMA.1121.00039,2,2405750,2421622,-,15872
335,BUMA.1121.00029,2,3029177,3045030,-,15853
335,BUMA.1121.00021,2,2063263,2079134,+,15871
335,BUMA.1121.00107,2,2256814,2272692,-,15878
335,BUMA.1121.00023,2,1675726,1691609,+,15883
335,BUMA.1121.00067,2,2426929,2442810,-,15881
335,BUMA.1121.00035,2,3046457,3062311,-,15854
335,BUMA.1121.00005,2,2969977,2985853,+,15876
335,BUMA.1121.00100,2,2677673,2693546,+,15873
335,BUMA.1121.00016,2,2154789,2170643,-,15854
335,BUMA.1121.00099,2,1793598,1809483,+,15885
335,BUMA.1121.00094,2,1578793,1594657,+,15864
335,BUMA.1121.00093,2,1380695,1396565,-,15870
335,BUMA.1121.00097,2,1382947,1398814,+,15867
335,BUMA.1121.00109,2,3189175,3205101,-,15926
335,BUMA.1121.00018,2,2249626,2265502,-,15876
335,BUMA.1121.00110,2,853689,869579,-,15890
335,BUMA.1121.00079,2,1538021,1553885,+,15864
335,BUMA.1121.00075,2,1865833,1881704,+,15871
335,BUMA.1121.00066,2,1517925,1533822,+,15897
335,BUMA.1121.00089,2,1523966,1539830,+,15864
335,BUMA.1121.00057,2,542284,558162,-,15878
335,BUMA.1121.00090,2,2523319,2539196,+,15877
335,BUMA.1121.00027,2,2592153,2608049,+,15896
335,BUMA.1121.00062,2,196275,212140,-,15865
335,BUMA.1121.00091,2,2075898,2091767,-,15869
335,BUMA.1121.00098,2,1804986,1820820,+,15834
335,BUMA.1121.00092,2,1547783,1563654,+,15871
335,BUMA.1121.00031,2,724062,739945,+,15883
335,BUMA.1121.00096,2,1750825,1766691,+,15866
335,BUMA.1121.00073,2,1533283,1549180,+,15897
335,BUMA.1121.00103,2,88403,104262,+,15859
335,BUMA.1121.00084,2,181044,196923,+,15879
335,BUMA.1121.00014,2,1657639,1673566,+,15927
335,BUMA.1121.00111,2,875464,891341,+,15877
335,BUMA.1121.00007,2,1614659,1630545,+,15886
335,BUMA.1121.00072,2,1512222,1528119,+,15897
335,BUMA.1121.00071,2,1532848,1548745,+,15897
335,BUMA.1121.00077,2,2147310,2163198,-,15888
335,BUMA.1121.00003,2,2361695,2377564,-,15869
335,BUMA.1121.00104,2,1627953,1643818,+,15865
335,BUMA.1121.00074,2,2812662,2828543,-,15881
335,BUMA.1121.00088,2,1477522,1493398,+,15876
335,BUMA.1121.00053,2,1827812,1843704,+,15892
335,BUMA.1121.00025,2,2583542,2599418,-,15876
335,BUMA.1121.00070,2,1512893,1528790,+,15897
335,BUMA.1121.00049,2,192074,207945,+,15871
335,BUMA.1121.00078,2,1590086,1605962,-,15876
335,BUMA.1121.00069,2,1509752,1525649,+,15897
335,BUMA.1121.00102,2,1588143,1604026,+,15883
335,BUMA.1121.00112,2,2839823,2855704,-,15881
335,BUMA.1121.00041,2,2478024,2493901,+,15877
335,BUMA.1121.00068,2,121702,137597,+,15895
335,BUMA.1121.00076,2,2496443,2512314,+,15871
335,BUMA.1121.00033,2,2301476,2317363,+,15887
335,BUMA.1121.00101,2,1861180,1877075,-,15895
335,BUMA.1121.00105,2,936480,952346,-,15866
335,BUMA.1121.00061,2,1521102,1536999,+,15897
335,BUMA.1121.00063,2,1532030,1547924,+,15894
335,BUMA.1121.00059,2,2108556,2124440,-,15884
335,BUMA.1121.00058,2,2084135,2100001,+,15866
335,BUMA.1121.00043,2,745779,761699,-,15920
335,BUMA.1121.00055,2,1119623,1135500,-,15877
335,BUMA.1121.00065,2,1581276,1597147,+,15871
335,BUMA.1121.00064,2,1450177,1466054,+,15877
335,BUMA.1121.00047,2,2468478,2484342,+,15864
335,BUMA.1121.00037,2,1895463,1911334,+,15871
335,BUMA.1121.00106,2,266090,281956,-,15866
335,BUMA.1121.00051,2,1537359,1553222,+,15863
335,BUMA.1121.00045,2,1430373,1446260,+,15887
335,BUMA.1121.00056,2,2454218,2470081,-,15863
335,BUMA.1121.00095,2,3024065,3039937,-,15872
335,BUMA.1121.00082,2,1576540,1592437,+,15897
335,BUMA.1121.00001,2,650773,666616,-,15843
335,BUMA.1121.00108,2,1761551,1777417,+,15866
335,BUMA.1121.00083,2,200430,216327,+,15897
335,BUMA.1121.00080,2,1538598,1554462,+,15864
335,BUMA.1121.00012,2,112599,128470,-,15871
336,BUMA.1121.00011,2,180470,213569,+,33099
336,BUMA.1121.00009,2,217795,250882,+,33087
336,BUMA.1121.00039,2,2372132,2405209,-,33077
336,BUMA.1121.00029,2,2995507,3028636,-,33129
336,BUMA.1121.00021,2,2079675,2112798,+,33123
336,BUMA.1121.00107,2,2223326,2256267,-,32941
336,BUMA.1121.00023,2,1692150,1725241,+,33091
336,BUMA.1121.00067,2,2393267,2426384,-,33117
336,BUMA.1121.00035,2,3012786,3045916,-,33130
336,BUMA.1121.00005,2,2985927,3018996,+,33069
336,BUMA.1121.00100,2,2694087,2727181,+,33094
336,BUMA.1121.00016,2,2121182,2154248,-,33066
336,BUMA.1121.00099,2,1810024,1843081,+,33057
336,BUMA.1121.00094,2,1594731,1627762,+,33031
336,BUMA.1121.00093,2,1347096,1380154,-,33058
336,BUMA.1121.00097,2,1399359,1432413,+,33054
336,BUMA.1121.00109,2,3086931,3119985,-,33054
336,BUMA.1121.00018,2,2216013,2249085,-,33072
336,BUMA.1121.00110,2,820039,853145,-,33106
336,BUMA.1121.00079,2,1553959,1587022,+,33063
336,BUMA.1121.00075,2,1881778,1914903,+,33125
336,BUMA.1121.00066,2,1534367,1567399,+,33032
336,BUMA.1121.00089,2,1539904,1572935,+,33031
336,BUMA.1121.00057,2,508709,541743,-,33034
336,BUMA.1121.00090,2,2539737,2572857,+,33120
336,BUMA.1121.00027,2,2608590,2641623,+,33033
336,BUMA.1121.00062,2,94597,127682,-,33085
336,BUMA.1121.00091,2,2042305,2075353,-,33048
336,BUMA.1121.00098,2,1820945,1854003,+,33058
336,BUMA.1121.00092,2,1564195,1597254,+,33059
336,BUMA.1121.00031,2,740486,773567,+,33081
336,BUMA.1121.00096,2,1767232,1800343,+,33111
336,BUMA.1121.00073,2,1549725,1582728,+,33003
336,BUMA.1121.00103,2,104807,137802,+,32995
336,BUMA.1121.00084,2,267175,300191,+,33016
336,BUMA.1121.00014,2,1674107,1707196,+,33089
336,BUMA.1121.00111,2,891882,925047,+,33165
336,BUMA.1121.00007,2,1631090,1664180,+,33090
336,BUMA.1121.00072,2,1528664,1561665,+,33001
336,BUMA.1121.00071,2,1549290,1582317,+,33027
336,BUMA.1121.00077,2,2113662,2146766,-,33104
336,BUMA.1121.00003,2,2328047,2361154,-,33107
336,BUMA.1121.00104,2,1644359,1677446,+,33087
336,BUMA.1121.00074,2,2779000,2812117,-,33117
336,BUMA.1121.00088,2,1563650,1596702,+,33052
336,BUMA.1121.00053,2,1844249,1877307,+,33058
336,BUMA.1121.00025,2,2549929,2583001,-,33072
336,BUMA.1121.00070,2,1529335,1562336,+,33001
336,BUMA.1121.00049,2,208490,241607,+,33117
336,BUMA.1121.00078,2,1556516,1589545,-,33029
336,BUMA.1121.00069,2,1526190,1559189,+,32999
336,BUMA.1121.00102,2,1604104,1637172,+,33068
336,BUMA.1121.00112,2,2806637,2839749,-,33112
336,BUMA.1121.00041,2,2494446,2527528,+,33082
336,BUMA.1121.00068,2,138138,171233,+,33095
336,BUMA.1121.00076,2,2512388,2545516,+,33128
336,BUMA.1121.00033,2,2317904,2350955,+,33051
336,BUMA.1121.00101,2,1827508,1860635,-,33127
336,BUMA.1121.00105,2,832924,865960,-,33036
336,BUMA.1121.00061,2,1537544,1570546,+,33002
336,BUMA.1121.00063,2,1548469,1581501,+,33032
336,BUMA.1121.00059,2,2007808,2040830,-,33022
336,BUMA.1121.00058,2,2168557,2201634,+,33077
336,BUMA.1121.00043,2,712093,745238,-,33145
336,BUMA.1121.00055,2,1085976,1119078,-,33102
336,BUMA.1121.00065,2,1597688,1630797,+,33109
336,BUMA.1121.00064,2,1466595,1499716,+,33121
336,BUMA.1121.00047,2,2484416,2517432,+,33016
336,BUMA.1121.00037,2,1911875,1944967,+,33092
336,BUMA.1121.00106,2,162466,195578,-,33112
336,BUMA.1121.00051,2,1553296,1586324,+,33028
336,BUMA.1121.00045,2,1446801,1479953,+,33152
336,BUMA.1121.00056,2,2421113,2454144,-,33031
336,BUMA.1121.00095,2,2990923,3023987,-,33064
336,BUMA.1121.00082,2,1592978,1626015,+,33037
336,BUMA.1121.00001,2,617120,650232,-,33112
336,BUMA.1121.00108,2,1777495,1810500,+,33005
336,BUMA.1121.00083,2,216868,249905,+,33037
336,BUMA.1121.00080,2,1554536,1587564,+,33028
336,BUMA.1121.00012,2,78927,112058,-,33131
337,BUMA.1121.00011,2,213859,217699,+,3840
337,BUMA.1121.00009,2,251157,255006,+,3849
337,BUMA.1121.00039,2,2367992,2371841,-,3849
337,BUMA.1121.00029,2,2991368,2995216,-,3848
337,BUMA.1121.00021,2,2113089,2116938,+,3849
337,BUMA.1121.00107,2,2219187,2223036,-,3849
337,BUMA.1121.00023,2,1725532,1729381,+,3849
337,BUMA.1121.00067,2,2389127,2392976,-,3849
337,BUMA.1121.00035,2,3008646,3012495,-,3849
337,BUMA.1121.00005,2,3019287,3023136,+,3849
337,BUMA.1121.00100,2,2727456,2731305,+,3849
337,BUMA.1121.00016,2,2117042,2120891,-,3849
337,BUMA.1121.00099,2,1843371,1847220,+,3849
337,BUMA.1121.00094,2,1628053,1631902,+,3849
337,BUMA.1121.00093,2,1342957,1346806,-,3849
337,BUMA.1121.00097,2,1432704,1436553,+,3849
337,BUMA.1121.00109,2,3082791,3086640,-,3849
337,BUMA.1121.00018,2,2211873,2215722,-,3849
337,BUMA.1121.00110,2,815899,819748,-,3849
337,BUMA.1121.00079,2,1587312,1591161,+,3849
337,BUMA.1121.00075,2,1915202,1919051,+,3849
337,BUMA.1121.00066,2,1567689,1571538,+,3849
337,BUMA.1121.00089,2,1573226,1577075,+,3849
337,BUMA.1121.00057,2,504570,508419,-,3849
337,BUMA.1121.00090,2,2573148,2576997,+,3849
337,BUMA.1121.00027,2,2641913,2645762,+,3849
337,BUMA.1121.00062,2,90457,94306,-,3849
337,BUMA.1121.00091,2,2038165,2042014,-,3849
337,BUMA.1121.00098,2,1854293,1858142,+,3849
337,BUMA.1121.00092,2,1597544,1601393,+,3849
337,BUMA.1121.00031,2,773858,777707,+,3849
337,BUMA.1121.00096,2,1800633,1804482,+,3849
337,BUMA.1121.00073,2,1583018,1586867,+,3849
337,BUMA.1121.00103,2,138093,141942,+,3849
337,BUMA.1121.00084,2,300482,304331,+,3849
337,BUMA.1121.00014,2,1707487,1711334,+,3847
337,BUMA.1121.00111,2,925338,929187,+,3849
337,BUMA.1121.00007,2,1664471,1668320,+,3849
337,BUMA.1121.00072,2,1561955,1565804,+,3849
337,BUMA.1121.00071,2,1582607,1586456,+,3849
337,BUMA.1121.00077,2,2109522,2113371,-,3849
337,BUMA.1121.00003,2,2323923,2327772,-,3849
337,BUMA.1121.00104,2,1677737,1681586,+,3849
337,BUMA.1121.00074,2,2774860,2778709,-,3849
337,BUMA.1121.00060,2,765756,769573,-,3817
337,BUMA.1121.00088,2,1596993,1600842,+,3849
337,BUMA.1121.00053,2,1877598,1881447,+,3849
337,BUMA.1121.00025,2,2545789,2549638,-,3849
337,BUMA.1121.00070,2,1562626,1566475,+,3849
337,BUMA.1121.00049,2,241897,245746,+,3849
337,BUMA.1121.00078,2,1552376,1556225,-,3849
337,BUMA.1121.00069,2,1559479,1563328,+,3849
337,BUMA.1121.00102,2,1637462,1641311,+,3849
337,BUMA.1121.00112,2,2802497,2806346,-,3849
337,BUMA.1121.00041,2,2527818,2531667,+,3849
337,BUMA.1121.00068,2,171524,175373,+,3849
337,BUMA.1121.00076,2,2545815,2549664,+,3849
337,BUMA.1121.00033,2,2351246,2355079,+,3833
337,BUMA.1121.00101,2,1823369,1827218,-,3849
337,BUMA.1121.00105,2,828760,832609,-,3849
337,BUMA.1121.00061,2,1570836,1574685,+,3849
337,BUMA.1121.00063,2,1581791,1585640,+,3849
337,BUMA.1121.00059,2,2003668,2007517,-,3849
337,BUMA.1121.00058,2,2201925,2205774,+,3849
337,BUMA.1121.00043,2,707953,711802,-,3849
337,BUMA.1121.00055,2,1081837,1085686,-,3849
337,BUMA.1121.00065,2,1631072,1634921,+,3849
337,BUMA.1121.00064,2,1500007,1503856,+,3849
337,BUMA.1121.00047,2,2517722,2521571,+,3849
337,BUMA.1121.00037,2,1945258,1949107,+,3849
337,BUMA.1121.00106,2,158327,162176,-,3849
337,BUMA.1121.00051,2,1586614,1590463,+,3849
337,BUMA.1121.00045,2,1480243,1484092,+,3849
337,BUMA.1121.00056,2,2416973,2420822,-,3849
337,BUMA.1121.00095,2,2986781,2990630,-,3849
337,BUMA.1121.00082,2,1626305,1630154,+,3849
337,BUMA.1121.00001,2,612980,616829,-,3849
337,BUMA.1121.00108,2,1810790,1814639,+,3849
337,BUMA.1121.00083,2,250195,254044,+,3849
337,BUMA.1121.00080,2,1587854,1591703,+,3849
337,BUMA.1121.00012,2,74787,78636,-,3849
338,BUMA.1121.00011,2,239479,247598,+,8119
338,BUMA.1121.00009,2,276735,284861,+,8126
338,BUMA.1121.00039,2,2336856,2344995,-,8139
338,BUMA.1121.00029,2,2953658,2961788,-,8130
338,BUMA.1121.00021,2,2138573,2146762,+,8189
338,BUMA.1121.00107,2,2189389,2197511,-,8122
338,BUMA.1121.00023,2,1759098,1767214,+,8116
338,BUMA.1121.00067,2,2359257,2367388,-,8131
338,BUMA.1121.00035,2,2972216,2980345,-,8129
338,BUMA.1121.00005,2,3063573,3071687,+,8114
338,BUMA.1121.00100,2,2754343,2762461,+,8118
338,BUMA.1121.00016,2,2087263,2095392,-,8129
338,BUMA.1121.00099,2,1868890,1877016,+,8126
338,BUMA.1121.00094,2,1660291,1668413,+,8122
338,BUMA.1121.00093,2,1313102,1321220,-,8118
338,BUMA.1121.00097,2,1458219,1466338,+,8119
338,BUMA.1121.00109,2,3047522,3055664,-,8142
338,BUMA.1121.00018,2,2181043,2189171,-,8128
338,BUMA.1121.00110,2,787373,795499,-,8126
338,BUMA.1121.00079,2,1618251,1626380,+,8129
338,BUMA.1121.00075,2,1942024,1950187,+,8163
338,BUMA.1121.00066,2,1592581,1600697,+,8116
338,BUMA.1121.00089,2,1605465,1613587,+,8122
338,BUMA.1121.00057,2,474758,482881,-,8123
338,BUMA.1121.00090,2,2598655,2606781,+,8126
338,BUMA.1121.00027,2,2667456,2675577,+,8121
338,BUMA.1121.00062,2,60624,68747,-,8123
338,BUMA.1121.00091,2,2008350,2016477,-,8127
338,BUMA.1121.00098,2,1879847,1887966,+,8119
338,BUMA.1121.00092,2,1623130,1631247,+,8117
338,BUMA.1121.00031,2,806064,814182,+,8118
338,BUMA.1121.00096,2,1824852,1832979,+,8127
338,BUMA.1121.00073,2,1607903,1616019,+,8116
338,BUMA.1121.00103,2,163634,171753,+,8119
338,BUMA.1121.00084,2,332680,340818,+,8138
338,BUMA.1121.00014,2,1739696,1747814,+,8118
338,BUMA.1121.00111,2,950825,958954,+,8129
338,BUMA.1121.00007,2,1690015,1698123,+,8108
338,BUMA.1121.00072,2,1583172,1591285,+,8113
338,BUMA.1121.00071,2,1608061,1616177,+,8116
338,BUMA.1121.00077,2,2080998,2089124,-,8126
338,BUMA.1121.00003,2,2286116,2294269,-,8153
338,BUMA.1121.00104,2,1709912,1718086,+,8174
338,BUMA.1121.00074,2,2744991,2753114,-,8123
338,BUMA.1121.00060,2,735914,744035,-,8121
338,BUMA.1121.00088,2,1629202,1637334,+,8132
338,BUMA.1121.00053,2,1903144,1911283,+,8139
338,BUMA.1121.00025,2,2514958,2523087,-,8129
338,BUMA.1121.00070,2,1587520,1595636,+,8116
338,BUMA.1121.00049,2,272865,281027,+,8162
338,BUMA.1121.00078,2,1522536,1530672,-,8136
338,BUMA.1121.00069,2,1580559,1588675,+,8116
338,BUMA.1121.00102,2,1664324,1672453,+,8129
338,BUMA.1121.00112,2,2752767,2760888,-,8121
338,BUMA.1121.00041,2,2571010,2579141,+,8131
338,BUMA.1121.00068,2,197097,205209,+,8112
338,BUMA.1121.00076,2,2572644,2580807,+,8163
338,BUMA.1121.00033,2,2407528,2415656,+,8128
338,BUMA.1121.00101,2,1793566,1801686,-,8120
338,BUMA.1121.00105,2,798945,807081,-,8136
338,BUMA.1121.00061,2,1595547,1603663,+,8116
338,BUMA.1121.00063,2,1606789,1614905,+,8116
338,BUMA.1121.00059,2,1971695,1979818,-,8123
338,BUMA.1121.00058,2,2234247,2242399,+,8152
338,BUMA.1121.00043,2,676848,684977,-,8129
338,BUMA.1121.00055,2,1046641,1054768,-,8127
338,BUMA.1121.00065,2,1656571,1664692,+,8121
338,BUMA.1121.00064,2,1528055,1536177,+,8122
338,BUMA.1121.00047,2,2549995,2558117,+,8122
338,BUMA.1121.00037,2,1977497,1985615,+,8118
338,BUMA.1121.00106,2,121810,129927,-,8117
338,BUMA.1121.00051,2,1618871,1626993,+,8122
338,BUMA.1121.00045,2,1505813,1513933,+,8120
338,BUMA.1121.00056,2,2380460,2388583,-,8123
338,BUMA.1121.00095,2,2957026,2965130,-,8104
338,BUMA.1121.00082,2,1651773,1659889,+,8116
338,BUMA.1121.00001,2,576587,584716,-,8129
338,BUMA.1121.00108,2,1843050,1851176,+,8126
338,BUMA.1121.00083,2,275657,283779,+,8122
338,BUMA.1121.00080,2,1620074,1628196,+,8122
338,BUMA.1121.00012,2,43600,51769,-,8169
339,BUMA.1121.00011,2,252058,263793,+,11735
339,BUMA.1121.00009,2,289285,301056,+,11771
339,BUMA.1121.00039,2,2320563,2332307,-,11744
339,BUMA.1121.00029,2,2937419,2949193,-,11774
339,BUMA.1121.00021,2,2151192,2162941,+,11749
339,BUMA.1121.00107,2,2173197,2184953,-,11756
339,BUMA.1121.00023,2,1771617,1783361,+,11744
339,BUMA.1121.00067,2,2343115,2354843,-,11728
339,BUMA.1121.00035,2,2955990,2967800,-,11810
339,BUMA.1121.00005,2,3076092,3087892,+,11800
339,BUMA.1121.00100,2,2766895,2778582,+,11687
339,BUMA.1121.00016,2,2071107,2082843,-,11736
339,BUMA.1121.00099,2,1881438,1893226,+,11788
339,BUMA.1121.00094,2,1672871,1684598,+,11727
339,BUMA.1121.00093,2,1296896,1308689,-,11793
339,BUMA.1121.00097,2,1470761,1482504,+,11743
339,BUMA.1121.00109,2,3029762,3041544,-,11782
339,BUMA.1121.00018,2,2164882,2176627,-,11745
339,BUMA.1121.00110,2,771133,782911,-,11778
339,BUMA.1121.00079,2,1630864,1642587,+,11723
339,BUMA.1121.00075,2,1954609,1966387,+,11778
339,BUMA.1121.00066,2,1605154,1616902,+,11748
339,BUMA.1121.00089,2,1618038,1629765,+,11727
339,BUMA.1121.00057,2,458533,470318,-,11785
339,BUMA.1121.00090,2,2611205,2622950,+,11745
339,BUMA.1121.00027,2,2679980,2691693,+,11713
339,BUMA.1121.00062,2,44425,56216,-,11791
339,BUMA.1121.00091,2,1992157,2003931,-,11774
339,BUMA.1121.00098,2,1892424,1904197,+,11773
339,BUMA.1121.00092,2,1635661,1647454,+,11793
339,BUMA.1121.00031,2,818582,830318,+,11736
339,BUMA.1121.00096,2,1837416,1849170,+,11754
339,BUMA.1121.00073,2,1620476,1632221,+,11745
339,BUMA.1121.00103,2,177491,189176,+,11685
339,BUMA.1121.00084,2,345226,356954,+,11728
339,BUMA.1121.00014,2,1752200,1763936,+,11736
339,BUMA.1121.00111,2,963343,975096,+,11753
339,BUMA.1121.00007,2,1702615,1714429,+,11814
339,BUMA.1121.00072,2,1595741,1607476,+,11735
339,BUMA.1121.00071,2,1620634,1632376,+,11742
339,BUMA.1121.00077,2,2064758,2076536,-,11778
339,BUMA.1121.00003,2,2269885,2281662,-,11777
339,BUMA.1121.00104,2,1722529,1734248,+,11719
339,BUMA.1121.00074,2,2728870,2740597,-,11727
339,BUMA.1121.00060,2,719739,731478,-,11739
339,BUMA.1121.00088,2,1641754,1653506,+,11752
339,BUMA.1121.00053,2,1915675,1927461,+,11786
339,BUMA.1121.00025,2,2498804,2510549,-,11745
339,BUMA.1121.00070,2,1600093,1611835,+,11742
339,BUMA.1121.00049,2,285478,297142,+,11664
339,BUMA.1121.00078,2,1506353,1518082,-,11729
339,BUMA.1121.00069,2,1593132,1604845,+,11713
339,BUMA.1121.00102,2,1677012,1688825,+,11813
339,BUMA.1121.00112,2,2736595,2748292,-,11697
339,BUMA.1121.00041,2,2583571,2595314,+,11743
339,BUMA.1121.00068,2,208751,220592,+,11841
339,BUMA.1121.00076,2,2585299,2597079,+,11780
339,BUMA.1121.00033,2,2420147,2431914,+,11767
339,BUMA.1121.00101,2,1777324,1789116,-,11792
339,BUMA.1121.00105,2,782806,794526,-,11720
339,BUMA.1121.00061,2,1608120,1619864,+,11744
339,BUMA.1121.00063,2,1619362,1631104,+,11742
339,BUMA.1121.00059,2,1955449,1967252,-,11803
339,BUMA.1121.00058,2,2246845,2258581,+,11736
339,BUMA.1121.00043,2,660639,672432,-,11793
339,BUMA.1121.00055,2,1030489,1042274,-,11785
339,BUMA.1121.00065,2,1669164,1680908,+,11744
339,BUMA.1121.00064,2,1540620,1552348,+,11728
339,BUMA.1121.00047,2,2562631,2574358,+,11727
339,BUMA.1121.00037,2,1989989,2001725,+,11736
339,BUMA.1121.00106,2,105613,117369,-,11756
339,BUMA.1121.00051,2,1631444,1643169,+,11725
339,BUMA.1121.00045,2,1518370,1530109,+,11739
339,BUMA.1121.00056,2,2364283,2376010,-,11727
339,BUMA.1121.00095,2,2940808,2952531,-,11723
339,BUMA.1121.00082,2,1664346,1676102,+,11756
339,BUMA.1121.00001,2,560355,572152,-,11797
339,BUMA.1121.00108,2,1855636,1867384,+,11748
339,BUMA.1121.00083,2,288236,299992,+,11756
339,BUMA.1121.00080,2,1632633,1644359,+,11726
339,BUMA.1121.00012,2,27479,39222,-,11743
340,BUMA.1121.00011,2,264744,277406,+,12662
340,BUMA.1121.00009,2,301961,314643,+,12682
340,BUMA.1121.00039,2,2306953,2319680,-,12727
340,BUMA.1121.00029,2,2923834,2936536,-,12702
340,BUMA.1121.00021,2,2163823,2176543,+,12720
340,BUMA.1121.00107,2,2159575,2172234,-,12659
340,BUMA.1121.00023,2,1784251,1796971,+,12720
340,BUMA.1121.00067,2,2329543,2342240,-,12697
340,BUMA.1121.00035,2,2942405,2955107,-,12702
340,BUMA.1121.00005,2,3088778,3101481,+,12703
340,BUMA.1121.00100,2,2779533,2792200,+,12667
340,BUMA.1121.00016,2,2057419,2070131,-,12712
340,BUMA.1121.00099,2,1894100,1906798,+,12698
340,BUMA.1121.00094,2,1685512,1698171,+,12659
340,BUMA.1121.00093,2,1283312,1296009,-,12697
340,BUMA.1121.00097,2,1483390,1496063,+,12673
340,BUMA.1121.00109,2,3016351,3028972,-,12621
340,BUMA.1121.00018,2,2151317,2163983,-,12666
340,BUMA.1121.00110,2,757682,770258,-,12576
340,BUMA.1121.00079,2,1643491,1656205,+,12714
340,BUMA.1121.00075,2,1967277,1979937,+,12660
340,BUMA.1121.00066,2,1617792,1630496,+,12704
340,BUMA.1121.00089,2,1630679,1643349,+,12670
340,BUMA.1121.00057,2,444905,457598,-,12693
340,BUMA.1121.00090,2,2643044,2655702,+,12658
340,BUMA.1121.00027,2,2692627,2705296,+,12669
340,BUMA.1121.00062,2,30829,43538,-,12709
340,BUMA.1121.00091,2,1978609,1991270,-,12661
340,BUMA.1121.00098,2,1905076,1917775,+,12699
340,BUMA.1121.00092,2,1648340,1661038,+,12698
340,BUMA.1121.00031,2,831227,843963,+,12736
340,BUMA.1121.00096,2,1850049,1862716,+,12667
340,BUMA.1121.00073,2,1633111,1645824,+,12713
340,BUMA.1121.00103,2,190079,202739,+,12660
340,BUMA.1121.00084,2,357860,370511,+,12651
340,BUMA.1121.00014,2,1764845,1777581,+,12736
340,BUMA.1121.00111,2,975986,988718,+,12732
340,BUMA.1121.00007,2,1715364,1728071,+,12707
340,BUMA.1121.00072,2,1608366,1621101,+,12735
340,BUMA.1121.00071,2,1633266,1645987,+,12721
340,BUMA.1121.00077,2,2051307,2063883,-,12576
340,BUMA.1121.00003,2,2256300,2268997,-,12697
340,BUMA.1121.00104,2,1735167,1747861,+,12694
340,BUMA.1121.00074,2,2715364,2727995,-,12631
340,BUMA.1121.00060,2,706465,719133,-,12668
340,BUMA.1121.00088,2,1654424,1667121,+,12697
340,BUMA.1121.00053,2,1928355,1941041,+,12686
340,BUMA.1121.00025,2,2485232,2497898,-,12666
340,BUMA.1121.00070,2,1612725,1625438,+,12713
340,BUMA.1121.00049,2,298052,310744,+,12692
340,BUMA.1121.00078,2,1492733,1505452,-,12719
340,BUMA.1121.00069,2,1605735,1618449,+,12714
340,BUMA.1121.00102,2,1689727,1702387,+,12660
340,BUMA.1121.00112,2,2723008,2735675,-,12667
340,BUMA.1121.00041,2,2596240,2608886,+,12646
340,BUMA.1121.00068,2,221471,234174,+,12703
340,BUMA.1121.00076,2,2597969,2610635,+,12666
340,BUMA.1121.00033,2,2432865,2445585,+,12720
340,BUMA.1121.00101,2,1763728,1776416,-,12688
340,BUMA.1121.00105,2,769224,781923,-,12699
340,BUMA.1121.00061,2,1620754,1633489,+,12735
340,BUMA.1121.00063,2,1631994,1644685,+,12691
340,BUMA.1121.00059,2,1941818,1954530,-,12712
340,BUMA.1121.00058,2,2259479,2272215,+,12736
340,BUMA.1121.00043,2,646975,659695,-,12720
340,BUMA.1121.00055,2,1016908,1029610,-,12702
340,BUMA.1121.00065,2,1681790,1694518,+,12728
340,BUMA.1121.00064,2,1553238,1565951,+,12713
340,BUMA.1121.00047,2,2575256,2587926,+,12670
340,BUMA.1121.00037,2,2002610,2015330,+,12720
340,BUMA.1121.00106,2,91984,104698,-,12714
340,BUMA.1121.00051,2,1644080,1656750,+,12670
340,BUMA.1121.00045,2,1530714,1543383,+,12669
340,BUMA.1121.00056,2,2350699,2363368,-,12669
340,BUMA.1121.00095,2,2926957,2939864,-,12907
340,BUMA.1121.00082,2,1676992,1689727,+,12735
340,BUMA.1121.00001,2,546770,559472,-,12702
340,BUMA.1121.00108,2,1868302,1881022,+,12720
340,BUMA.1121.00083,2,300882,313617,+,12735
340,BUMA.1121.00080,2,1645273,1657943,+,12670
340,BUMA.1121.00012,2,14184,26583,-,12399
341,BUMA.1121.00011,2,278442,291549,+,13107
341,BUMA.1121.00009,2,318656,331886,+,13230
341,BUMA.1121.00039,2,2292859,2305951,-,13092
341,BUMA.1121.00029,2,2909748,2922846,-,13098
341,BUMA.1121.00021,2,2177553,2190645,+,13092
341,BUMA.1121.00107,2,2142473,2155562,-,13089
341,BUMA.1121.00023,2,1797989,1811059,+,13070
341,BUMA.1121.00067,2,2315402,2328525,-,13123
341,BUMA.1121.00035,2,2928319,2941417,-,13098
341,BUMA.1121.00005,2,3102499,3115714,+,13215
341,BUMA.1121.00100,2,2793196,2806416,+,13220
341,BUMA.1121.00016,2,2043315,2056409,-,13094
341,BUMA.1121.00099,2,1907824,1920959,+,13135
341,BUMA.1121.00094,2,1699213,1712405,+,13192
341,BUMA.1121.00093,2,1269135,1282304,-,13169
341,BUMA.1121.00097,2,1497065,1510159,+,13094
341,BUMA.1121.00109,2,3002214,3015317,-,13103
341,BUMA.1121.00018,2,2137223,2150315,-,13092
341,BUMA.1121.00110,2,743585,756664,-,13079
341,BUMA.1121.00079,2,1657247,1670366,+,13119
341,BUMA.1121.00075,2,1980843,1993961,+,13118
341,BUMA.1121.00066,2,1631530,1644622,+,13092
341,BUMA.1121.00089,2,1644391,1657583,+,13192
341,BUMA.1121.00057,2,430757,443855,-,13098
341,BUMA.1121.00090,2,2656712,2669813,+,13101
341,BUMA.1121.00027,2,2706330,2719427,+,13097
341,BUMA.1121.00062,2,16679,29787,-,13108
341,BUMA.1121.00091,2,1964414,1977591,-,13177
341,BUMA.1121.00098,2,1918713,1931821,+,13108
341,BUMA.1121.00092,2,1662046,1675215,+,13169
341,BUMA.1121.00031,2,844965,858057,+,13092
341,BUMA.1121.00096,2,1866729,1879804,+,13075
341,BUMA.1121.00073,2,1646858,1659950,+,13092
341,BUMA.1121.00103,2,203707,216911,+,13204
341,BUMA.1121.00084,2,371569,384689,+,13120
341,BUMA.1121.00014,2,1778583,1791674,+,13091
341,BUMA.1121.00111,2,989728,1002833,+,13105
341,BUMA.1121.00007,2,1729039,1742214,+,13175
341,BUMA.1121.00072,2,1622135,1635245,+,13110
341,BUMA.1121.00071,2,1647021,1660113,+,13092
341,BUMA.1121.00077,2,2037211,2050289,-,13078
341,BUMA.1121.00003,2,2242173,2255266,-,13093
341,BUMA.1121.00104,2,1748967,1762147,+,13180
341,BUMA.1121.00074,2,2701226,2714346,-,13120
341,BUMA.1121.00060,2,692273,705437,-,13164
341,BUMA.1121.00088,2,1668171,1681293,+,13122
341,BUMA.1121.00053,2,1945054,1958184,+,13130
341,BUMA.1121.00025,2,2471138,2484230,-,13092
341,BUMA.1121.00070,2,1626472,1639564,+,13092
341,BUMA.1121.00049,2,314757,327907,+,13150
341,BUMA.1121.00078,2,1478571,1491819,-,13248
341,BUMA.1121.00069,2,1619483,1632574,+,13091
341,BUMA.1121.00102,2,1706399,1719489,+,13090
341,BUMA.1121.00112,2,2705768,2718995,-,13227
341,BUMA.1121.00041,2,2612899,2625995,+,13096
341,BUMA.1121.00068,2,235192,248337,+,13145
341,BUMA.1121.00076,2,2611541,2624661,+,13120
341,BUMA.1121.00033,2,2446603,2459695,+,13092
341,BUMA.1121.00101,2,1749607,1762700,-,13093
341,BUMA.1121.00105,2,755074,768182,-,13108
341,BUMA.1121.00061,2,1634523,1647614,+,13091
341,BUMA.1121.00063,2,1645615,1658697,+,13082
341,BUMA.1121.00059,2,1927620,1940808,-,13188
341,BUMA.1121.00058,2,2273247,2286367,+,13120
341,BUMA.1121.00043,2,632882,645973,-,13091
341,BUMA.1121.00055,2,1002755,1015874,-,13119
341,BUMA.1121.00065,2,1695554,1708649,+,13095
341,BUMA.1121.00064,2,1567009,1580162,+,13153
341,BUMA.1121.00047,2,2588968,2602119,+,13151
341,BUMA.1121.00037,2,2016332,2029433,+,13101
341,BUMA.1121.00106,2,77854,90974,-,13120
341,BUMA.1121.00051,2,1657792,1671014,+,13222
341,BUMA.1121.00045,2,1544411,1557595,+,13184
341,BUMA.1121.00056,2,2336465,2349657,-,13192
341,BUMA.1121.00095,2,2912796,2925955,-,13159
341,BUMA.1121.00082,2,1690761,1703871,+,13110
341,BUMA.1121.00001,2,532684,545782,-,13098
341,BUMA.1121.00108,2,1882052,1895200,+,13148
341,BUMA.1121.00083,2,314651,327761,+,13110
341,BUMA.1121.00080,2,1658985,1672127,+,13142
341,BUMA.1121.00012,2,64,13156,-,13092
342,BUMA.1121.00011,2,291646,307894,+,16248
342,BUMA.1121.00009,2,332010,348500,+,16490
342,BUMA.1121.00039,2,2276560,2292503,-,15943
342,BUMA.1121.00029,2,2892922,2909560,-,16638
342,BUMA.1121.00021,2,2191169,2207701,+,16532
342,BUMA.1121.00107,2,2125818,2142264,-,16446
342,BUMA.1121.00023,2,1811303,1827869,+,16566
342,BUMA.1121.00067,2,2298570,2315102,-,16532
342,BUMA.1121.00035,2,2911415,2927888,-,16473
342,BUMA.1121.00005,2,3115937,3132495,+,16558
342,BUMA.1121.00100,2,2806639,2823420,+,16781
342,BUMA.1121.00016,2,2026339,2042644,-,16305
342,BUMA.1121.00099,2,1921273,1938066,+,16793
342,BUMA.1121.00094,2,1712672,1729225,+,16553
342,BUMA.1121.00093,2,1252382,1268933,-,16551
342,BUMA.1121.00097,2,1510396,1526978,+,16582
342,BUMA.1121.00109,2,2985859,3002047,-,16188
342,BUMA.1121.00018,2,2120472,2136993,-,16521
342,BUMA.1121.00110,2,726895,743362,-,16467
342,BUMA.1121.00079,2,1670673,1687072,+,16399
342,BUMA.1121.00075,2,1994198,2010480,+,16282
342,BUMA.1121.00066,2,1644807,1661298,+,16491
342,BUMA.1121.00089,2,1657848,1674375,+,16527
342,BUMA.1121.00057,2,413951,430576,-,16625
342,BUMA.1121.00090,2,2670134,2686651,+,16517
342,BUMA.1121.00027,2,2719692,2736417,+,16725
342,BUMA.1121.00062,2,27,16267,-,16240
342,BUMA.1121.00091,2,1947796,1964191,-,16395
342,BUMA.1121.00098,2,1932303,1948360,+,16057
342,BUMA.1121.00092,2,1675501,1692051,+,16550
342,BUMA.1121.00031,2,858315,874802,+,16487
342,BUMA.1121.00096,2,1880307,1896895,+,16588
342,BUMA.1121.00073,2,1660179,1676670,+,16491
342,BUMA.1121.00103,2,217274,233766,+,16492
342,BUMA.1121.00084,2,384877,401134,+,16257
342,BUMA.1121.00014,2,1792065,1808587,+,16522
342,BUMA.1121.00111,2,1003140,1019191,+,16051
342,BUMA.1121.00007,2,1742409,1758909,+,16500
342,BUMA.1121.00072,2,1635475,1651978,+,16503
342,BUMA.1121.00071,2,1660339,1676845,+,16506
342,BUMA.1121.00077,2,2020488,2036955,-,16467
342,BUMA.1121.00003,2,2225437,2241923,-,16486
342,BUMA.1121.00104,2,1762188,1778777,+,16589
342,BUMA.1121.00074,2,2684219,2700786,-,16567
342,BUMA.1121.00060,2,675404,691952,-,16548
342,BUMA.1121.00088,2,1681677,1697642,+,15965
342,BUMA.1121.00053,2,1958449,1974939,+,16490
342,BUMA.1121.00025,2,2454355,2470901,-,16546
342,BUMA.1121.00070,2,1639758,1656250,+,16492
342,BUMA.1121.00049,2,328193,344706,+,16513
342,BUMA.1121.00078,2,1461834,1478362,-,16528
342,BUMA.1121.00069,2,1632800,1649260,+,16460
342,BUMA.1121.00102,2,1719845,1736579,+,16734
342,BUMA.1121.00112,2,2689085,2705489,-,16404
342,BUMA.1121.00041,2,2626330,2642836,+,16506
342,BUMA.1121.00068,2,248621,265110,+,16489
342,BUMA.1121.00076,2,2624912,2641213,+,16301
342,BUMA.1121.00033,2,2459981,2476476,+,16495
342,BUMA.1121.00101,2,1733093,1749370,-,16277
342,BUMA.1121.00105,2,738916,754900,-,15984
342,BUMA.1121.00061,2,1647844,1664305,+,16461
342,BUMA.1121.00063,2,1658927,1675401,+,16474
342,BUMA.1121.00059,2,1910730,1927348,-,16618
342,BUMA.1121.00058,2,2286534,2302823,+,16289
342,BUMA.1121.00043,2,615726,632246,-,16520
342,BUMA.1121.00055,2,985872,1002392,-,16520
342,BUMA.1121.00065,2,1708844,1725437,+,16593
342,BUMA.1121.00064,2,1580441,1596895,+,16454
342,BUMA.1121.00047,2,2602482,2619026,+,16544
342,BUMA.1121.00037,2,2029712,2046248,+,16536
342,BUMA.1121.00106,2,60962,77491,-,16529
342,BUMA.1121.00051,2,1671209,1687787,+,16578
342,BUMA.1121.00045,2,1557993,1574535,+,16542
342,BUMA.1121.00056,2,2319665,2336193,-,16528
342,BUMA.1121.00095,2,2896363,2912601,-,16238
342,BUMA.1121.00082,2,1704101,1720607,+,16506
342,BUMA.1121.00001,2,515857,532384,-,16527
342,BUMA.1121.00108,2,1895346,1911630,+,16284
342,BUMA.1121.00083,2,328054,344561,+,16507
342,BUMA.1121.00080,2,1672413,1688764,+,16351
342,BUMA.1121.00012,2,3270234,3286761,-,16527
343,BUMA.1121.00011,2,308375,334942,+,26567
343,BUMA.1121.00009,2,348981,375554,+,26573
343,BUMA.1121.00039,2,2249481,2276079,-,26598
343,BUMA.1121.00029,2,2865736,2892441,-,26705
343,BUMA.1121.00021,2,2208182,2234872,+,26690
343,BUMA.1121.00107,2,2098720,2125337,-,26617
343,BUMA.1121.00023,2,1828350,1855028,+,26678
343,BUMA.1121.00067,2,2271395,2298089,-,26694
343,BUMA.1121.00035,2,2884239,2910934,-,26695
343,BUMA.1121.00005,2,3132976,3159697,+,26721
343,BUMA.1121.00100,2,2823901,2850580,+,26679
343,BUMA.1121.00016,2,1999100,2025858,-,26758
343,BUMA.1121.00099,2,1938547,1965157,+,26610
343,BUMA.1121.00094,2,1729706,1756448,+,26742
343,BUMA.1121.00093,2,1225289,1251901,-,26612
343,BUMA.1121.00097,2,1527459,1554008,+,26549
343,BUMA.1121.00109,2,2958772,2985378,-,26606
343,BUMA.1121.00018,2,2093289,2119991,-,26702
343,BUMA.1121.00110,2,699846,726414,-,26568
343,BUMA.1121.00079,2,1687553,1714151,+,26598
343,BUMA.1121.00075,2,2010961,2037708,+,26747
343,BUMA.1121.00066,2,1661779,1688369,+,26590
343,BUMA.1121.00089,2,1674856,1701618,+,26762
343,BUMA.1121.00057,2,386653,413470,-,26817
343,BUMA.1121.00090,2,2687132,2713806,+,26674
343,BUMA.1121.00027,2,2736898,2763654,+,26756
343,BUMA.1121.00062,2,3198525,3225126,-,26601
343,BUMA.1121.00091,2,1920688,1947315,-,26627
343,BUMA.1121.00098,2,1948841,1975464,+,26623
343,BUMA.1121.00092,2,1692532,1719144,+,26612
343,BUMA.1121.00031,2,875283,901952,+,26669
343,BUMA.1121.00096,2,1897376,1923970,+,26594
343,BUMA.1121.00073,2,1677151,1703741,+,26590
343,BUMA.1121.00103,2,234247,260900,+,26653
343,BUMA.1121.00084,2,401615,428298,+,26683
343,BUMA.1121.00014,2,1809068,1835739,+,26671
343,BUMA.1121.00111,2,1019672,1046357,+,26685
343,BUMA.1121.00007,2,1759390,1785972,+,26582
343,BUMA.1121.00072,2,1652459,1679033,+,26574
343,BUMA.1121.00071,2,1677326,1703904,+,26578
343,BUMA.1121.00077,2,1993440,2020007,-,26567
343,BUMA.1121.00003,2,2198222,2224956,-,26734
343,BUMA.1121.00104,2,1779258,1805943,+,26685
343,BUMA.1121.00074,2,2657026,2683738,-,26712
343,BUMA.1121.00060,2,648343,674923,-,26580
343,BUMA.1121.00088,2,1698123,1724708,+,26585
343,BUMA.1121.00053,2,1975420,2001982,+,26562
343,BUMA.1121.00025,2,2427172,2453874,-,26702
343,BUMA.1121.00070,2,1656731,1683321,+,26590
343,BUMA.1121.00049,2,345187,371814,+,26627
343,BUMA.1121.00078,2,1434620,1461353,-,26733
343,BUMA.1121.00069,2,1649741,1676324,+,26583
343,BUMA.1121.00102,2,1737060,1763831,+,26771
343,BUMA.1121.00112,2,2661955,2688604,-,26649
343,BUMA.1121.00041,2,2643317,2670016,+,26699
343,BUMA.1121.00068,2,265591,292288,+,26697
343,BUMA.1121.00076,2,2641694,2668441,+,26747
343,BUMA.1121.00033,2,2476957,2503713,+,26756
343,BUMA.1121.00101,2,1706012,1732612,-,26600
343,BUMA.1121.00105,2,711867,738435,-,26568
343,BUMA.1121.00061,2,1664786,1691366,+,26580
343,BUMA.1121.00063,2,1675882,1702453,+,26571
343,BUMA.1121.00059,2,1883653,1910249,-,26596
343,BUMA.1121.00058,2,2303304,2330001,+,26697
343,BUMA.1121.00043,2,588558,615245,-,26687
343,BUMA.1121.00055,2,958685,985391,-,26706
343,BUMA.1121.00065,2,1725918,1752539,+,26621
343,BUMA.1121.00064,2,1597376,1624076,+,26700
343,BUMA.1121.00047,2,2619507,2646287,+,26780
343,BUMA.1121.00037,2,2046729,2073424,+,26695
343,BUMA.1121.00106,2,33719,60481,-,26762
343,BUMA.1121.00051,2,1688268,1715065,+,26797
343,BUMA.1121.00045,2,1575016,1601596,+,26580
343,BUMA.1121.00056,2,2292422,2319184,-,26762
343,BUMA.1121.00095,2,2869295,2895882,-,26587
343,BUMA.1121.00082,2,1721088,1747678,+,26590
343,BUMA.1121.00001,2,488655,515376,-,26721
343,BUMA.1121.00108,2,1912111,1938706,+,26595
343,BUMA.1121.00083,2,345042,371632,+,26590
343,BUMA.1121.00080,2,1689245,1716021,+,26776
343,BUMA.1121.00012,2,3243042,3269753,-,26711
344,BUMA.1121.00011,2,336300,368427,+,32127
344,BUMA.1121.00009,2,376912,409112,+,32200
344,BUMA.1121.00039,2,2216024,2248124,-,32100
344,BUMA.1121.00029,2,2832254,2864379,-,32125
344,BUMA.1121.00021,2,2236230,2268212,+,31982
344,BUMA.1121.00107,2,2065096,2097363,-,32267
344,BUMA.1121.00023,2,1856386,1888408,+,32022
344,BUMA.1121.00067,2,2237694,2270038,-,32344
344,BUMA.1121.00035,2,2850815,2882882,-,32067
344,BUMA.1121.00005,2,3161055,3193631,+,32576
344,BUMA.1121.00100,2,2851938,2884152,+,32214
344,BUMA.1121.00016,2,1965534,1997743,-,32209
344,BUMA.1121.00099,2,1966515,1998999,+,32484
344,BUMA.1121.00094,2,1757806,1790252,+,32446
344,BUMA.1121.00093,2,1191690,1223932,-,32242
344,BUMA.1121.00097,2,1555366,1587727,+,32361
344,BUMA.1121.00109,2,2924782,2957415,-,32633
344,BUMA.1121.00018,2,2059889,2091932,-,32043
344,BUMA.1121.00110,2,665923,698489,-,32566
344,BUMA.1121.00079,2,1715509,1748116,+,32607
344,BUMA.1121.00075,2,2039066,2071432,+,32366
344,BUMA.1121.00066,2,1689727,1722148,+,32421
344,BUMA.1121.00089,2,1702976,1735465,+,32489
344,BUMA.1121.00057,2,352909,385296,-,32387
344,BUMA.1121.00090,2,2715164,2747184,+,32020
344,BUMA.1121.00027,2,2765012,2797461,+,32449
344,BUMA.1121.00062,2,3164574,3197168,-,32594
344,BUMA.1121.00091,2,1886796,1919331,-,32535
344,BUMA.1121.00098,2,1976822,2008874,+,32052
344,BUMA.1121.00092,2,1720502,1752854,+,32352
344,BUMA.1121.00031,2,903310,935359,+,32049
344,BUMA.1121.00096,2,1925328,1957641,+,32313
344,BUMA.1121.00073,2,1704997,1737508,+,32511
344,BUMA.1121.00103,2,262258,294905,+,32647
344,BUMA.1121.00084,2,429656,462426,+,32770
344,BUMA.1121.00014,2,1837097,1869126,+,32029
344,BUMA.1121.00111,2,1047715,1079780,+,32065
344,BUMA.1121.00007,2,1787330,1819784,+,32454
344,BUMA.1121.00072,2,1680391,1712693,+,32302
344,BUMA.1121.00071,2,1705140,1737552,+,32412
344,BUMA.1121.00077,2,1959520,1992084,-,32564
344,BUMA.1121.00003,2,2164358,2196865,-,32507
344,BUMA.1121.00104,2,1807301,1839954,+,32653
344,BUMA.1121.00074,2,2623267,2655669,-,32402
344,BUMA.1121.00060,2,614518,646986,-,32468
344,BUMA.1121.00088,2,1726066,1758849,+,32783
344,BUMA.1121.00053,2,2003340,2035836,+,32496
344,BUMA.1121.00025,2,2393788,2425815,-,32027
344,BUMA.1121.00070,2,1684576,1717054,+,32478
344,BUMA.1121.00049,2,373172,405716,+,32544
344,BUMA.1121.00078,2,1400920,1433265,-,32345
344,BUMA.1121.00069,2,1677682,1710028,+,32346
344,BUMA.1121.00102,2,1765189,1797768,+,32579
344,BUMA.1121.00112,2,2628646,2660598,-,31952
344,BUMA.1121.00041,2,2671374,2704028,+,32654
344,BUMA.1121.00068,2,293646,326122,+,32476
344,BUMA.1121.00076,2,2669799,2702185,+,32386
344,BUMA.1121.00033,2,2505071,2537075,+,32004
344,BUMA.1121.00101,2,1672633,1704655,-,32022
344,BUMA.1121.00105,2,678234,710510,-,32276
344,BUMA.1121.00061,2,1692724,1725045,+,32321
344,BUMA.1121.00063,2,1703707,1736149,+,32442
344,BUMA.1121.00059,2,1849489,1882296,-,32807
344,BUMA.1121.00058,2,2331359,2363716,+,32357
344,BUMA.1121.00043,2,555219,587201,-,31982
344,BUMA.1121.00055,2,924982,957328,-,32346
344,BUMA.1121.00065,2,1753897,1786284,+,32387
344,BUMA.1121.00064,2,1625434,1657828,+,32394
344,BUMA.1121.00047,2,2647645,2680226,+,32581
344,BUMA.1121.00037,2,2074782,2106826,+,32044
344,BUMA.1121.00106,2,1,32362,-,32361
344,BUMA.1121.00051,2,1716423,1748848,+,32425
344,BUMA.1121.00045,2,1602954,1635422,+,32468
344,BUMA.1121.00056,2,2258574,2291065,-,32491
344,BUMA.1121.00095,2,2835501,2867938,-,32437
344,BUMA.1121.00082,2,1749036,1781692,+,32656
344,BUMA.1121.00001,2,453869,487298,-,33429
344,BUMA.1121.00108,2,1940065,1972515,+,32450
344,BUMA.1121.00083,2,372990,405599,+,32609
344,BUMA.1121.00080,2,1717379,1749876,+,32497
344,BUMA.1121.00012,2,3209437,3241685,-,32248
345,BUMA.1121.00011,2,369181,391762,+,22581
345,BUMA.1121.00009,2,409989,432800,+,22811
345,BUMA.1121.00039,2,2192604,2215173,-,22569
345,BUMA.1121.00029,2,2808857,2831413,-,22556
345,BUMA.1121.00021,2,2269026,2291578,+,22552
345,BUMA.1121.00107,2,2041332,2064233,-,22901
345,BUMA.1121.00023,2,1889248,1913098,+,23850
345,BUMA.1121.00067,2,2213953,2236842,-,22889
345,BUMA.1121.00035,2,2827430,2849987,-,22557
345,BUMA.1121.00005,2,3194474,3217087,+,22613
345,BUMA.1121.00100,2,2884843,2907795,+,22952
345,BUMA.1121.00016,2,1942043,1964671,-,22628
345,BUMA.1121.00099,2,1999876,2022756,+,22880
345,BUMA.1121.00094,2,1791153,1814144,+,22991
345,BUMA.1121.00093,2,1168011,1190825,-,22814
345,BUMA.1121.00097,2,1588546,1611388,+,22842
345,BUMA.1121.00109,2,2900239,2923898,-,23659
345,BUMA.1121.00018,2,2036372,2058977,-,22605
345,BUMA.1121.00110,2,642277,664858,-,22581
345,BUMA.1121.00079,2,1749040,1772030,+,22990
345,BUMA.1121.00075,2,2072264,2094909,+,22645
345,BUMA.1121.00066,2,1722849,1745536,+,22687
345,BUMA.1121.00089,2,1736359,1759351,+,22992
345,BUMA.1121.00057,2,329366,352062,-,22696
345,BUMA.1121.00090,2,2748030,2770671,+,22641
345,BUMA.1121.00027,2,2798291,2820950,+,22659
345,BUMA.1121.00062,2,3140823,3163576,-,22753
345,BUMA.1121.00091,2,1863301,1885973,-,22672
345,BUMA.1121.00098,2,2009734,2032673,+,22939
345,BUMA.1121.00092,2,1753719,1776533,+,22814
345,BUMA.1121.00031,2,936215,958874,+,22659
345,BUMA.1121.00096,2,1958508,1981343,+,22835
345,BUMA.1121.00073,2,1738396,1761128,+,22732
345,BUMA.1121.00103,2,295765,318545,+,22780
345,BUMA.1121.00084,2,463232,485963,+,22731
345,BUMA.1121.00014,2,1869960,1892632,+,22672
345,BUMA.1121.00111,2,1080671,1103224,+,22553
345,BUMA.1121.00007,2,1820714,1843531,+,22817
345,BUMA.1121.00072,2,1713425,1736102,+,22677
345,BUMA.1121.00071,2,1738440,1761190,+,22750
345,BUMA.1121.00077,2,1935897,1958479,-,22582
345,BUMA.1121.00003,2,2140935,2163497,-,22562
345,BUMA.1121.00104,2,1840650,1863390,+,22740
345,BUMA.1121.00074,2,2599460,2622264,-,22804
345,BUMA.1121.00060,2,591035,613712,-,22677
345,BUMA.1121.00088,2,1759669,1782518,+,22849
345,BUMA.1121.00053,2,2036679,2059509,+,22830
345,BUMA.1121.00025,2,2370271,2392876,-,22605
345,BUMA.1121.00070,2,1717942,1740670,+,22728
345,BUMA.1121.00049,2,406569,429205,+,22636
345,BUMA.1121.00078,2,1377424,1400045,-,22621
345,BUMA.1121.00069,2,1710806,1733491,+,22685
345,BUMA.1121.00102,2,1798568,1821357,+,22789
345,BUMA.1121.00112,2,2604986,2627853,-,22867
345,BUMA.1121.00041,2,2704849,2727665,+,22816
345,BUMA.1121.00068,2,326947,349865,+,22918
345,BUMA.1121.00076,2,2703017,2725663,+,22646
345,BUMA.1121.00033,2,2537895,2560519,+,22624
345,BUMA.1121.00101,2,1649129,1671861,-,22732
345,BUMA.1121.00105,2,654683,677329,-,22646
345,BUMA.1121.00061,2,1725911,1748646,+,22735
345,BUMA.1121.00063,2,1737037,1759766,+,22729
345,BUMA.1121.00059,2,1825987,1848641,-,22654
345,BUMA.1121.00058,2,2364551,2387226,+,22675
345,BUMA.1121.00043,2,531729,554329,-,22600
345,BUMA.1121.00055,2,901398,924279,-,22881
345,BUMA.1121.00065,2,1787177,1810026,+,22849
345,BUMA.1121.00064,2,1658782,1681563,+,22781
345,BUMA.1121.00047,2,2681133,2704223,+,23090
345,BUMA.1121.00037,2,2107710,2130342,+,22632
345,BUMA.1121.00106,2,3170518,3193248,-,22730
345,BUMA.1121.00051,2,1749754,1772867,+,23113
345,BUMA.1121.00045,2,1636228,1658889,+,22661
345,BUMA.1121.00056,2,2234958,2257680,-,22722
345,BUMA.1121.00095,2,2811622,2834577,-,22955
345,BUMA.1121.00082,2,1782580,1805335,+,22755
345,BUMA.1121.00001,2,430441,453013,-,22572
345,BUMA.1121.00108,2,1973368,1996004,+,22636
345,BUMA.1121.00083,2,406487,429242,+,22755
345,BUMA.1121.00080,2,1750748,1773840,+,23092
345,BUMA.1121.00012,2,3185972,3208560,-,22588
346,BUMA.1121.00011,2,392178,405395,+,13217
346,BUMA.1121.00009,2,433167,446457,+,13290
346,BUMA.1121.00039,2,2179122,2192394,-,13272
346,BUMA.1121.00029,2,2795273,2808507,-,13234
346,BUMA.1121.00021,2,2291767,2305039,+,13272
346,BUMA.1121.00107,2,2027779,2040977,-,13198
346,BUMA.1121.00023,2,1913294,1926566,+,13272
346,BUMA.1121.00067,2,2200395,2213681,-,13286
346,BUMA.1121.00035,2,2813836,2827069,-,13233
346,BUMA.1121.00005,2,3217439,3230696,+,13257
346,BUMA.1121.00100,2,2908136,2921354,+,13218
346,BUMA.1121.00016,2,1928454,1941700,-,13246
346,BUMA.1121.00099,2,2023081,2036316,+,13235
346,BUMA.1121.00094,2,1814485,1827756,+,13271
346,BUMA.1121.00093,2,1154465,1167718,-,13253
346,BUMA.1121.00097,2,1611750,1624933,+,13183
346,BUMA.1121.00109,2,2886588,2899842,-,13254
346,BUMA.1121.00018,2,2022940,2036183,-,13243
346,BUMA.1121.00110,2,628650,641910,-,13260
346,BUMA.1121.00079,2,1772371,1785640,+,13269
346,BUMA.1121.00075,2,2095251,2108550,+,13299
346,BUMA.1121.00066,2,1745857,1759070,+,13213
346,BUMA.1121.00089,2,1759692,1772964,+,13272
346,BUMA.1121.00057,2,315804,329051,-,13247
346,BUMA.1121.00090,2,2771014,2784284,+,13270
346,BUMA.1121.00027,2,2821265,2834517,+,13252
346,BUMA.1121.00062,2,3127264,3140537,-,13273
346,BUMA.1121.00091,2,1849661,1862920,-,13259
346,BUMA.1121.00098,2,2033026,2046261,+,13235
346,BUMA.1121.00092,2,1776826,1790078,+,13252
346,BUMA.1121.00031,2,959119,972391,+,13272
346,BUMA.1121.00096,2,1981668,1995141,+,13473
346,BUMA.1121.00073,2,1761432,1774675,+,13243
346,BUMA.1121.00103,2,318933,332178,+,13245
346,BUMA.1121.00084,2,486284,499536,+,13252
346,BUMA.1121.00014,2,1892863,1906162,+,13299
346,BUMA.1121.00111,2,1103427,1116726,+,13299
346,BUMA.1121.00007,2,1843891,1857193,+,13302
346,BUMA.1121.00072,2,1736378,1749621,+,13243
346,BUMA.1121.00071,2,1761511,1774754,+,13243
346,BUMA.1121.00077,2,1922267,1935530,-,13263
346,BUMA.1121.00003,2,2127308,2140582,-,13274
346,BUMA.1121.00104,2,1863718,1877006,+,13288
346,BUMA.1121.00074,2,2585896,2599160,-,13264
346,BUMA.1121.00060,2,577422,590647,-,13225
346,BUMA.1121.00088,2,1782804,1796056,+,13252
346,BUMA.1121.00053,2,2059952,2073210,+,13258
346,BUMA.1121.00025,2,2356838,2370082,-,13244
346,BUMA.1121.00070,2,1740960,1754203,+,13243
346,BUMA.1121.00049,2,429571,442841,+,13270
346,BUMA.1121.00078,2,1363778,1377047,-,13269
346,BUMA.1121.00069,2,1733812,1747051,+,13239
346,BUMA.1121.00102,2,1821734,1835029,+,13295
346,BUMA.1121.00112,2,2591279,2604549,-,13270
346,BUMA.1121.00041,2,2729385,2742621,+,13236
346,BUMA.1121.00068,2,350204,363490,+,13286
346,BUMA.1121.00076,2,2726012,2739311,+,13299
346,BUMA.1121.00033,2,2560715,2573957,+,13242
346,BUMA.1121.00101,2,1635541,1648790,-,13249
346,BUMA.1121.00105,2,641111,654390,-,13279
346,BUMA.1121.00061,2,1748967,1762210,+,13243
346,BUMA.1121.00063,2,1760087,1773330,+,13243
346,BUMA.1121.00059,2,1812437,1825708,-,13271
346,BUMA.1121.00058,2,2387498,2400781,+,13283
346,BUMA.1121.00043,2,518103,531386,-,13283
346,BUMA.1121.00055,2,887822,901063,-,13241
346,BUMA.1121.00065,2,1810372,1823667,+,13295
346,BUMA.1121.00064,2,1681842,1695127,+,13285
346,BUMA.1121.00047,2,2704564,2717847,+,13283
346,BUMA.1121.00037,2,2130545,2143834,+,13289
346,BUMA.1121.00106,2,3156912,3170176,-,13264
346,BUMA.1121.00051,2,1773208,1786488,+,13280
346,BUMA.1121.00045,2,1659284,1672508,+,13224
346,BUMA.1121.00056,2,2221344,2234617,-,13273
346,BUMA.1121.00095,2,2798009,2811249,-,13240
346,BUMA.1121.00082,2,1805656,1818899,+,13243
346,BUMA.1121.00001,2,416858,430091,-,13233
346,BUMA.1121.00108,2,1996336,2009579,+,13243
346,BUMA.1121.00083,2,429563,442806,+,13243
346,BUMA.1121.00080,2,1774181,1787452,+,13271
346,BUMA.1121.00012,2,3172484,3185755,-,13271
347,BUMA.1121.00011,2,412841,424770,+,11929
347,BUMA.1121.00009,2,454003,466015,+,12012
347,BUMA.1121.00039,2,2159611,2171569,-,11958
347,BUMA.1121.00029,2,2775711,2787721,-,12010
347,BUMA.1121.00021,2,2312592,2324551,+,11959
347,BUMA.1121.00107,2,2008231,2020237,-,12006
347,BUMA.1121.00023,2,1934111,1946070,+,11959
347,BUMA.1121.00067,2,2180830,2192850,-,12020
347,BUMA.1121.00035,2,2794273,2806283,-,12010
347,BUMA.1121.00005,2,3238240,3250253,+,12013
347,BUMA.1121.00100,2,2928901,2940915,+,12014
347,BUMA.1121.00016,2,1907570,1920902,-,13332
347,BUMA.1121.00099,2,2043863,2055827,+,11964
347,BUMA.1121.00094,2,1835298,1847317,+,12019
347,BUMA.1121.00093,2,1134922,1146921,-,11999
347,BUMA.1121.00097,2,1632474,1644505,+,12031
347,BUMA.1121.00109,2,2867037,2879042,-,12005
347,BUMA.1121.00018,2,2003430,2015387,-,11957
347,BUMA.1121.00110,2,609128,621103,-,11975
347,BUMA.1121.00079,2,1793184,1805205,+,12021
347,BUMA.1121.00075,2,2116092,2128054,+,11962
347,BUMA.1121.00066,2,1766581,1778532,+,11951
347,BUMA.1121.00089,2,1780506,1792525,+,12019
347,BUMA.1121.00057,2,296314,308259,-,11945
347,BUMA.1121.00090,2,2791837,2803796,+,11959
347,BUMA.1121.00027,2,2842059,2854005,+,11946
347,BUMA.1121.00062,2,3101505,3113479,-,11974
347,BUMA.1121.00091,2,1830183,1842115,-,11932
347,BUMA.1121.00098,2,2053815,2065803,+,11988
347,BUMA.1121.00092,2,1797622,1809622,+,12000
347,BUMA.1121.00031,2,979944,991903,+,11959
347,BUMA.1121.00096,2,2002686,2014714,+,12028
347,BUMA.1121.00073,2,1782217,1794168,+,11951
347,BUMA.1121.00103,2,339724,351671,+,11947
347,BUMA.1121.00084,2,507080,519034,+,11954
347,BUMA.1121.00014,2,1913715,1925665,+,11950
347,BUMA.1121.00111,2,1124279,1136238,+,11959
347,BUMA.1121.00007,2,1864745,1876741,+,11996
347,BUMA.1121.00072,2,1757163,1769104,+,11941
347,BUMA.1121.00071,2,1782233,1794180,+,11947
347,BUMA.1121.00077,2,1902744,1914720,-,11976
347,BUMA.1121.00003,2,2107734,2119752,-,12018
347,BUMA.1121.00104,2,1884550,1896512,+,11962
347,BUMA.1121.00074,2,2566393,2578351,-,11958
347,BUMA.1121.00060,2,557877,569879,-,12002
347,BUMA.1121.00088,2,1803600,1815562,+,11962
347,BUMA.1121.00053,2,2080756,2092746,+,11990
347,BUMA.1121.00025,2,2337326,2349285,-,11959
347,BUMA.1121.00070,2,1761745,1773692,+,11947
347,BUMA.1121.00049,2,450385,462347,+,11962
347,BUMA.1121.00078,2,1344235,1356234,-,11999
347,BUMA.1121.00069,2,1754535,1766479,+,11944
347,BUMA.1121.00102,2,1842575,1854565,+,11990
347,BUMA.1121.00112,2,2571777,2583803,-,12026
347,BUMA.1121.00041,2,2750165,2762154,+,11989
347,BUMA.1121.00068,2,371037,382984,+,11947
347,BUMA.1121.00076,2,2746855,2758817,+,11962
347,BUMA.1121.00033,2,2581509,2593529,+,12020
347,BUMA.1121.00101,2,1616002,1627997,-,11995
347,BUMA.1121.00105,2,621572,633566,-,11994
347,BUMA.1121.00061,2,1769751,1781691,+,11940
347,BUMA.1121.00063,2,1780872,1792819,+,11947
347,BUMA.1121.00059,2,1792847,1804886,-,12039
347,BUMA.1121.00058,2,2408325,2420305,+,11980
347,BUMA.1121.00043,2,498592,510550,-,11958
347,BUMA.1121.00055,2,868224,880268,-,12044
347,BUMA.1121.00065,2,1831221,1843180,+,11959
347,BUMA.1121.00064,2,1702671,1714671,+,12000
347,BUMA.1121.00047,2,2725389,2737390,+,12001
347,BUMA.1121.00037,2,2151387,2163337,+,11950
347,BUMA.1121.00106,2,3137407,3149368,-,11961
347,BUMA.1121.00051,2,1794028,1806029,+,12001
347,BUMA.1121.00045,2,1680051,1692054,+,12003
347,BUMA.1121.00056,2,2201784,2213802,-,12018
347,BUMA.1121.00095,2,2778466,2790463,-,11997
347,BUMA.1121.00082,2,1826441,1838403,+,11962
347,BUMA.1121.00001,2,397295,409305,-,12010
347,BUMA.1121.00108,2,2017132,2029179,+,12047
347,BUMA.1121.00083,2,450348,462310,+,11962
347,BUMA.1121.00080,2,1794992,1806993,+,12001
347,BUMA.1121.00012,2,3152921,3164940,-,12019
348,BUMA.1121.00011,2,425153,428836,+,3683
348,BUMA.1121.00011,2,2607062,2610714,-,3652
348,BUMA.1121.00009,2,466332,469972,+,3640
348,BUMA.1121.00009,2,2628375,2632015,-,3640
348,BUMA.1121.00039,2,89856,93323,+,3467
348,BUMA.1121.00039,2,2155550,2159203,-,3653
348,BUMA.1121.00029,2,648614,652060,+,3446
348,BUMA.1121.00029,2,2771931,2775377,-,3446
348,BUMA.1121.00021,2,1190001,1193654,-,3653
348,BUMA.1121.00021,2,2324975,2328628,+,3653
348,BUMA.1121.00107,2,2004470,2007889,-,3419
348,BUMA.1121.00107,2,3169646,3173041,+,3395
348,BUMA.1121.00023,2,766896,770549,-,3653
348,BUMA.1121.00023,2,1946446,1950123,+,3677
348,BUMA.1121.00067,2,88736,92143,+,3407
348,BUMA.1121.00067,2,2176800,2180465,-,3665
348,BUMA.1121.00035,2,695864,699298,+,3434
348,BUMA.1121.00035,2,2790515,2793949,-,3434
348,BUMA.1121.00005,2,85,3145,+,3060
348,BUMA.1121.00005,2,2114197,2117564,-,3367
348,BUMA.1121.00005,2,3250593,3253961,+,3368
348,BUMA.1121.00100,2,1834627,1838307,-,3680
348,BUMA.1121.00100,2,2941209,2944874,+,3665
348,BUMA.1121.00016,2,1903569,1907222,-,3653
348,BUMA.1121.00016,2,3104376,3108029,+,3653
348,BUMA.1121.00099,2,932962,936615,-,3653
348,BUMA.1121.00099,2,2056242,2059868,+,3626
348,BUMA.1121.00094,2,772217,775882,-,3665
348,BUMA.1121.00094,2,1847727,1851392,+,3665
348,BUMA.1121.00093,2,1131199,1134618,-,3419
348,BUMA.1121.00093,2,2200576,2204229,+,3653
348,BUMA.1121.00097,2,524829,528272,-,3443
348,BUMA.1121.00097,2,1644871,1648534,+,3663
348,BUMA.1121.00109,2,679717,683343,+,3626
348,BUMA.1121.00109,2,2861592,2865256,-,3664
348,BUMA.1121.00018,2,1999274,2002950,-,3676
348,BUMA.1121.00018,2,3075099,3078776,+,3677
348,BUMA.1121.00110,2,605068,608754,-,3686
348,BUMA.1121.00110,2,1713969,1717613,+,3644
348,BUMA.1121.00079,2,728977,732641,-,3664
348,BUMA.1121.00079,2,1805507,1809168,+,3661
348,BUMA.1121.00075,2,1019741,1023154,-,3413
348,BUMA.1121.00075,2,2128484,2131939,+,3455
348,BUMA.1121.00066,2,713302,716664,-,3362
348,BUMA.1121.00066,2,1778808,1782227,+,3419
348,BUMA.1121.00089,2,716896,720561,-,3665
348,BUMA.1121.00089,2,1792948,1796613,+,3665
348,BUMA.1121.00057,2,292602,296020,-,3418
348,BUMA.1121.00057,2,1357173,1360814,+,3641
348,BUMA.1121.00090,2,1661716,1665369,-,3653
348,BUMA.1121.00090,2,2804220,2807897,+,3677
348,BUMA.1121.00027,2,1787597,1791237,-,3640
348,BUMA.1121.00027,2,2854297,2857716,+,3419
348,BUMA.1121.00062,2,1049445,1052864,+,3419
348,BUMA.1121.00062,2,3097434,3101099,-,3665
348,BUMA.1121.00091,2,1826475,1829882,-,3407
348,BUMA.1121.00091,2,2950665,2954316,+,3651
348,BUMA.1121.00098,2,929481,933140,-,3659
348,BUMA.1121.00098,2,2066097,2069756,+,3659
348,BUMA.1121.00092,2,740670,744323,-,3653
348,BUMA.1121.00092,2,1809926,1813345,+,3419
348,BUMA.1121.00031,2,992253,995918,+,3665
348,BUMA.1121.00031,2,3128965,3132618,-,3653
348,BUMA.1121.00096,2,890159,893851,-,3692
348,BUMA.1121.00096,2,2015048,2018700,+,3652
348,BUMA.1121.00073,2,707647,711036,-,3389
348,BUMA.1121.00073,2,1794462,1797881,+,3419
348,BUMA.1121.00103,2,351984,355637,+,3653
348,BUMA.1121.00103,2,2587808,2591218,-,3410
348,BUMA.1121.00084,2,519431,522850,+,3419
348,BUMA.1121.00084,2,2555796,2559203,-,3407
348,BUMA.1121.00014,2,796602,800255,-,3653
348,BUMA.1121.00014,2,1926065,1929718,+,3653
348,BUMA.1121.00111,2,1136540,1140193,+,3653
348,BUMA.1121.00111,2,3160468,3164121,-,3653
348,BUMA.1121.00007,2,770818,774492,-,3674
348,BUMA.1121.00007,2,1877035,1880676,+,3641
348,BUMA.1121.00072,2,704063,707411,-,3348
348,BUMA.1121.00072,2,1769378,1772684,+,3306
348,BUMA.1121.00071,2,707030,710396,-,3366
348,BUMA.1121.00071,2,1794450,1797869,+,3419
348,BUMA.1121.00077,2,1898683,1902367,-,3684
348,BUMA.1121.00077,2,3007839,3011484,+,3645
348,BUMA.1121.00003,2,44142,47795,+,3653
348,BUMA.1121.00003,2,2103767,2107432,-,3665
348,BUMA.1121.00104,2,823145,826552,-,3407
348,BUMA.1121.00104,2,1896910,1900575,+,3665
348,BUMA.1121.00074,2,268095,271502,+,3407
348,BUMA.1121.00074,2,2562347,2566012,-,3665
348,BUMA.1121.00060,2,553871,557534,-,3663
348,BUMA.1121.00060,2,1524390,1528061,+,3671
348,BUMA.1121.00088,2,672626,676033,-,3407
348,BUMA.1121.00088,2,1815967,1819374,+,3407
348,BUMA.1121.00053,2,960090,963791,-,3701
348,BUMA.1121.00053,2,2093079,2096756,+,3677
348,BUMA.1121.00025,2,329968,333645,+,3677
348,BUMA.1121.00025,2,2333169,2336846,-,3677
348,BUMA.1121.00070,2,707733,711101,-,3368
348,BUMA.1121.00070,2,1773986,1777405,+,3419
348,BUMA.1121.00049,2,462777,466442,+,3665
348,BUMA.1121.00049,2,2542337,2545744,-,3407
348,BUMA.1121.00078,2,1340215,1343871,-,3656
348,BUMA.1121.00078,2,2493198,2496850,+,3652
348,BUMA.1121.00069,2,705587,708968,-,3381
348,BUMA.1121.00069,2,1766762,1770166,+,3404
348,BUMA.1121.00102,2,722815,726258,-,3443
348,BUMA.1121.00102,2,1854986,1858651,+,3665
348,BUMA.1121.00112,2,437337,440780,+,3443
348,BUMA.1121.00112,2,2567786,2571439,-,3653
348,BUMA.1121.00041,2,1616381,1619788,-,3407
348,BUMA.1121.00041,2,2762475,2765882,+,3407
348,BUMA.1121.00068,2,383320,386712,+,3392
348,BUMA.1121.00068,2,2435566,2439234,-,3668
348,BUMA.1121.00076,2,1613788,1617207,-,3419
348,BUMA.1121.00076,2,2759247,2762690,+,3443
348,BUMA.1121.00033,2,1409070,1412723,-,3653
348,BUMA.1121.00033,2,2593871,2597524,+,3653
348,BUMA.1121.00101,2,1611957,1615627,-,3670
348,BUMA.1121.00101,2,2676691,2680350,+,3659
348,BUMA.1121.00105,2,617859,621278,-,3419
348,BUMA.1121.00105,2,1789628,1793293,+,3665
348,BUMA.1121.00061,2,697587,701006,-,3419
348,BUMA.1121.00061,2,1781983,1785402,+,3419
348,BUMA.1121.00063,2,706986,710273,-,3287
348,BUMA.1121.00063,2,1793110,1796529,+,3419
348,BUMA.1121.00059,2,1789106,1792525,-,3419
348,BUMA.1121.00059,2,2926729,2930136,+,3407
348,BUMA.1121.00058,2,1279572,1282979,-,3407
348,BUMA.1121.00058,2,2420734,2424142,+,3408
348,BUMA.1121.00043,2,494467,498120,-,3653
348,BUMA.1121.00043,2,1693626,1697279,+,3653
348,BUMA.1121.00055,2,864270,867923,-,3653
348,BUMA.1121.00055,2,1941622,1945029,+,3407
348,BUMA.1121.00065,2,720769,724188,-,3419
348,BUMA.1121.00065,2,1843588,1847265,+,3677
348,BUMA.1121.00064,2,643621,647040,-,3419
348,BUMA.1121.00064,2,1714975,1718394,+,3419
348,BUMA.1121.00047,2,1659006,1662671,-,3665
348,BUMA.1121.00047,2,2737787,2741464,+,3677
348,BUMA.1121.00037,2,1033829,1037482,-,3653
348,BUMA.1121.00037,2,2163785,2167438,+,3653
348,BUMA.1121.00106,2,1087955,1091362,+,3407
348,BUMA.1121.00106,2,3133571,3136978,-,3407
348,BUMA.1121.00051,2,728548,732211,-,3663
348,BUMA.1121.00051,2,1806392,1810053,+,3661
348,BUMA.1121.00045,2,565764,569435,-,3671
348,BUMA.1121.00045,2,1692397,1696062,+,3665
348,BUMA.1121.00056,2,171283,174948,+,3665
348,BUMA.1121.00056,2,2197696,2201361,-,3665
348,BUMA.1121.00095,2,603169,606823,+,3654
348,BUMA.1121.00095,2,2774516,2778170,-,3654
348,BUMA.1121.00082,2,735841,739260,-,3419
348,BUMA.1121.00082,2,1838697,1842116,+,3419
348,BUMA.1121.00001,2,393537,396971,-,3434
348,BUMA.1121.00001,2,1533256,1536690,+,3434
348,BUMA.1121.00108,2,957379,961043,-,3664
348,BUMA.1121.00108,2,2029530,2033195,+,3665
348,BUMA.1121.00083,2,462604,466023,+,3419
348,BUMA.1121.00083,2,2532798,2536217,-,3419
348,BUMA.1121.00080,2,729755,733419,-,3664
348,BUMA.1121.00080,2,1807296,1810959,+,3663
348,BUMA.1121.00012,2,1032634,1036077,+,3443
348,BUMA.1121.00012,2,3149168,3152611,-,3443
349,BUMA.1121.00011,2,429474,434473,+,4999
349,BUMA.1121.00011,2,2601444,2606424,-,4980
349,BUMA.1121.00009,2,470609,475590,+,4981
349,BUMA.1121.00009,2,2622760,2627737,-,4977
349,BUMA.1121.00039,2,93960,99019,+,5059
349,BUMA.1121.00039,2,2149866,2154912,-,5046
349,BUMA.1121.00029,2,652697,657732,+,5035
349,BUMA.1121.00029,2,2766247,2771293,-,5046
349,BUMA.1121.00021,2,1184352,1189363,-,5011
349,BUMA.1121.00021,2,2329265,2334336,+,5071
349,BUMA.1121.00107,2,1998786,2003832,-,5046
349,BUMA.1121.00107,2,3173711,3178679,+,4968
349,BUMA.1121.00023,2,761257,766258,-,5001
349,BUMA.1121.00023,2,1950760,1955762,+,5002
349,BUMA.1121.00067,2,92780,97767,+,4987
349,BUMA.1121.00067,2,2171164,2176162,-,4998
349,BUMA.1121.00035,2,699935,705006,+,5071
349,BUMA.1121.00035,2,2784807,2789877,-,5070
349,BUMA.1121.00005,2,3782,8774,+,4992
349,BUMA.1121.00005,2,2108630,2113559,-,4929
349,BUMA.1121.00100,2,1828995,1833989,-,4994
349,BUMA.1121.00100,2,2945511,2950480,+,4969
349,BUMA.1121.00016,2,1897843,1902931,-,5088
349,BUMA.1121.00016,2,3108666,3113706,+,5040
349,BUMA.1121.00099,2,927331,932324,-,4993
349,BUMA.1121.00099,2,2060547,2065529,+,4982
349,BUMA.1121.00094,2,766560,771579,-,5019
349,BUMA.1121.00094,2,1852029,1857050,+,5021
349,BUMA.1121.00093,2,1125586,1130561,-,4975
349,BUMA.1121.00093,2,2204866,2209925,+,5059
349,BUMA.1121.00097,2,519169,524191,-,5022
349,BUMA.1121.00097,2,1649171,1654185,+,5014
349,BUMA.1121.00109,2,684022,689023,+,5001
349,BUMA.1121.00109,2,2855954,2860954,-,5000
349,BUMA.1121.00018,2,502,5531,+,5029
349,BUMA.1121.00018,2,1993602,1998636,-,5034
349,BUMA.1121.00018,2,3079413,3084440,+,5027
349,BUMA.1121.00110,2,599423,604430,-,5007
349,BUMA.1121.00110,2,1718292,1723300,+,5008
349,BUMA.1121.00079,2,723293,728339,-,5046
349,BUMA.1121.00079,2,1809805,1814849,+,5044
349,BUMA.1121.00075,2,1014117,1019103,-,4986
349,BUMA.1121.00075,2,2132576,2137568,+,4992
349,BUMA.1121.00066,2,707654,712664,-,5010
349,BUMA.1121.00066,2,1782864,1787804,+,4940
349,BUMA.1121.00089,2,711239,716258,-,5019
349,BUMA.1121.00089,2,1797250,1802270,+,5020
349,BUMA.1121.00057,2,286967,291964,-,4997
349,BUMA.1121.00057,2,1361451,1366447,+,4996
349,BUMA.1121.00090,2,1656002,1661078,-,5076
349,BUMA.1121.00090,2,2808534,2813616,+,5082
349,BUMA.1121.00027,2,1781966,1786959,-,4993
349,BUMA.1121.00027,2,2858353,2863362,+,5009
349,BUMA.1121.00062,2,1053501,1058524,+,5023
349,BUMA.1121.00062,2,3091768,3096796,-,5028
349,BUMA.1121.00091,2,1820759,1825839,-,5080
349,BUMA.1121.00091,2,2954953,2959972,+,5019
349,BUMA.1121.00098,2,923822,928843,-,5021
349,BUMA.1121.00098,2,2070393,2075416,+,5023
349,BUMA.1121.00092,2,734974,740032,-,5058
349,BUMA.1121.00092,2,1813982,1818958,+,4976
349,BUMA.1121.00031,2,996555,1001602,+,5047
349,BUMA.1121.00031,2,3123281,3128327,-,5046
349,BUMA.1121.00096,2,884577,889521,-,4944
349,BUMA.1121.00096,2,2019337,2024313,+,4976
349,BUMA.1121.00073,2,701999,707009,-,5010
349,BUMA.1121.00073,2,1798518,1803516,+,4998
349,BUMA.1121.00103,2,356274,361262,+,4988
349,BUMA.1121.00103,2,2582124,2587170,-,5046
349,BUMA.1121.00084,2,523487,528534,+,5047
349,BUMA.1121.00084,2,2550148,2555158,-,5010
349,BUMA.1121.00014,2,790906,795964,-,5058
349,BUMA.1121.00014,2,1930355,1935420,+,5065
349,BUMA.1121.00111,2,1140830,1145817,+,4987
349,BUMA.1121.00111,2,3154871,3159830,-,4959
349,BUMA.1121.00007,2,765109,770180,-,5071
349,BUMA.1121.00007,2,1881346,1885946,+,4600
349,BUMA.1121.00072,2,698415,703425,-,5010
349,BUMA.1121.00072,2,1773318,1778302,+,4984
349,BUMA.1121.00071,2,701382,706392,-,5010
349,BUMA.1121.00071,2,1798484,1803418,+,4934
349,BUMA.1121.00077,2,1893045,1898053,-,5008
349,BUMA.1121.00077,2,3012163,3017174,+,5011
349,BUMA.1121.00003,2,48432,53431,+,4999
349,BUMA.1121.00003,2,2098131,2103129,-,4998
349,BUMA.1121.00104,2,817461,822507,-,5046
349,BUMA.1121.00104,2,1901212,1906259,+,5047
349,BUMA.1121.00074,2,272139,277137,+,4998
349,BUMA.1121.00074,2,2556711,2561709,-,4998
349,BUMA.1121.00060,2,548204,553235,-,5031
349,BUMA.1121.00060,2,1528698,1533734,+,5036
349,BUMA.1121.00088,2,666990,671988,-,4998
349,BUMA.1121.00088,2,1820011,1825052,+,5041
349,BUMA.1121.00053,2,954427,959452,-,5025
349,BUMA.1121.00053,2,2097393,2102413,+,5020
349,BUMA.1121.00025,2,334282,339316,+,5034
349,BUMA.1121.00025,2,2327497,2332531,-,5034
349,BUMA.1121.00070,2,702085,707095,-,5010
349,BUMA.1121.00070,2,1778042,1782950,+,4908
349,BUMA.1121.00049,2,467079,472078,+,4999
349,BUMA.1121.00049,2,2536701,2541699,-,4998
349,BUMA.1121.00078,2,1334475,1339577,-,5102
349,BUMA.1121.00078,2,2497488,2502613,+,5125
349,BUMA.1121.00069,2,699939,704949,-,5010
349,BUMA.1121.00069,2,1770798,1775785,+,4987
349,BUMA.1121.00102,2,717188,722177,-,4989
349,BUMA.1121.00102,2,1859288,1864368,+,5080
349,BUMA.1121.00112,2,441417,446410,+,4993
349,BUMA.1121.00112,2,2562153,2567148,-,4995
349,BUMA.1121.00041,2,1610724,1615743,-,5019
349,BUMA.1121.00041,2,2766519,2771539,+,5020
349,BUMA.1121.00068,2,387391,392372,+,4981
349,BUMA.1121.00068,2,2429866,2434928,-,5062
349,BUMA.1121.00076,2,1608140,1613150,-,5010
349,BUMA.1121.00076,2,2763327,2768314,+,4987
349,BUMA.1121.00033,2,1403413,1408432,-,5019
349,BUMA.1121.00033,2,2598161,2603191,+,5030
349,BUMA.1121.00101,2,1606338,1611319,-,4981
349,BUMA.1121.00101,2,2680987,2685970,+,4983
349,BUMA.1121.00105,2,612211,617221,-,5010
349,BUMA.1121.00105,2,1793930,1798953,+,5023
349,BUMA.1121.00061,2,691939,696949,-,5010
349,BUMA.1121.00061,2,1786039,1790988,+,4949
349,BUMA.1121.00063,2,701338,706348,-,5010
349,BUMA.1121.00063,2,1797166,1802092,+,4926
349,BUMA.1121.00059,2,1783470,1788468,-,4998
349,BUMA.1121.00059,2,2930773,2935771,+,4998
349,BUMA.1121.00058,2,1273876,1278934,-,5058
349,BUMA.1121.00058,2,2424779,2429838,+,5059
349,BUMA.1121.00043,2,488836,493829,-,4993
349,BUMA.1121.00043,2,1697916,1702910,+,4994
349,BUMA.1121.00055,2,858607,863632,-,5025
349,BUMA.1121.00055,2,1945666,1950673,+,5007
349,BUMA.1121.00065,2,715145,720131,-,4986
349,BUMA.1121.00065,2,1847902,1852937,+,5035
349,BUMA.1121.00064,2,637986,642983,-,4997
349,BUMA.1121.00064,2,1719031,1724007,+,4976
349,BUMA.1121.00047,2,1653346,1658368,-,5022
349,BUMA.1121.00047,2,2742101,2747121,+,5020
349,BUMA.1121.00037,2,1028127,1033191,-,5064
349,BUMA.1121.00037,2,2168075,2173128,+,5053
349,BUMA.1121.00106,2,1091999,1096996,+,4997
349,BUMA.1121.00106,2,3127923,3132933,-,5010
349,BUMA.1121.00051,2,722894,727910,-,5016
349,BUMA.1121.00051,2,1810690,1815704,+,5014
349,BUMA.1121.00045,2,560091,565126,-,5035
349,BUMA.1121.00045,2,1696699,1701735,+,5036
349,BUMA.1121.00056,2,175585,180605,+,5020
349,BUMA.1121.00056,2,2192039,2197058,-,5019
349,BUMA.1121.00095,2,607458,612444,+,4986
349,BUMA.1121.00095,2,2768891,2773878,-,4987
349,BUMA.1121.00082,2,730193,735203,-,5010
349,BUMA.1121.00082,2,1842753,1847751,+,4998
349,BUMA.1121.00001,2,387836,392899,-,5063
349,BUMA.1121.00001,2,1537327,1542392,+,5065
349,BUMA.1121.00108,2,951733,956741,-,5008
349,BUMA.1121.00108,2,2033832,2038849,+,5017
349,BUMA.1121.00083,2,466660,471658,+,4998
349,BUMA.1121.00083,2,2527150,2532160,-,5010
349,BUMA.1121.00080,2,724096,729117,-,5021
349,BUMA.1121.00080,2,1811596,1816617,+,5021
349,BUMA.1121.00012,2,1036714,1041710,+,4996
349,BUMA.1121.00012,2,3143535,3148530,-,4995
350,BUMA.1121.00011,2,434474,439211,+,4737
350,BUMA.1121.00009,2,475591,480373,+,4782
350,BUMA.1121.00039,2,2145077,2149864,-,4787
350,BUMA.1121.00029,2,2761458,2766245,-,4787
350,BUMA.1121.00021,2,2334337,2339125,+,4788
350,BUMA.1121.00107,2,1994008,1998784,-,4776
350,BUMA.1121.00023,2,1955763,1960551,+,4788
350,BUMA.1121.00067,2,2166419,2171162,-,4743
350,BUMA.1121.00035,2,2780018,2784805,-,4787
350,BUMA.1121.00005,2,2103891,2108628,-,4737
350,BUMA.1121.00100,2,2950481,2955219,+,4738
350,BUMA.1121.00016,2,1893054,1897841,-,4787
350,BUMA.1121.00099,2,2065530,2070318,+,4788
350,BUMA.1121.00094,2,1857051,1861839,+,4788
350,BUMA.1121.00093,2,1120841,1125584,-,4743
350,BUMA.1121.00097,2,1654186,1658963,+,4777
350,BUMA.1121.00109,2,2851165,2855952,-,4787
350,BUMA.1121.00018,2,1988813,1993600,-,4787
350,BUMA.1121.00110,2,1723301,1728045,+,4744
350,BUMA.1121.00079,2,1814850,1819638,+,4788
350,BUMA.1121.00075,2,1009372,1014115,-,4743
350,BUMA.1121.00066,2,1787805,1792587,+,4782
350,BUMA.1121.00089,2,1802271,1807059,+,4788
350,BUMA.1121.00057,2,282178,286965,-,4787
350,BUMA.1121.00090,2,2813617,2818405,+,4788
350,BUMA.1121.00027,2,2863363,2868107,+,4744
350,BUMA.1121.00062,2,3087023,3091766,-,4743
350,BUMA.1121.00091,2,1816020,1820757,-,4737
350,BUMA.1121.00098,2,2075417,2080155,+,4738
350,BUMA.1121.00092,2,1818959,1823703,+,4744
350,BUMA.1121.00031,2,1001603,1006391,+,4788
350,BUMA.1121.00096,2,2024314,2029097,+,4783
350,BUMA.1121.00073,2,1803517,1808255,+,4738
350,BUMA.1121.00103,2,361263,366045,+,4782
350,BUMA.1121.00084,2,528535,533279,+,4744
350,BUMA.1121.00014,2,1935421,1940209,+,4788
350,BUMA.1121.00111,2,1145818,1150606,+,4788
350,BUMA.1121.00007,2,1885947,1890735,+,4788
350,BUMA.1121.00072,2,1778303,1783085,+,4782
350,BUMA.1121.00071,2,1803419,1808201,+,4782
350,BUMA.1121.00077,2,1888300,1893043,-,4743
350,BUMA.1121.00003,2,53432,58215,+,4783
350,BUMA.1121.00104,2,1906260,1911004,+,4744
350,BUMA.1121.00074,2,2551966,2556709,-,4743
350,BUMA.1121.00060,2,543415,548202,-,4787
350,BUMA.1121.00088,2,1825053,1829797,+,4744
350,BUMA.1121.00053,2,2102414,2107152,+,4738
350,BUMA.1121.00025,2,339317,344105,+,4788
350,BUMA.1121.00070,2,1782951,1787720,+,4769
350,BUMA.1121.00049,2,472079,476823,+,4744
350,BUMA.1121.00078,2,1329736,1334473,-,4737
350,BUMA.1121.00069,2,1775786,1780524,+,4738
350,BUMA.1121.00102,2,1864369,1869151,+,4782
350,BUMA.1121.00112,2,2557414,2562151,-,4737
350,BUMA.1121.00041,2,2771540,2776321,+,4781
350,BUMA.1121.00068,2,392373,397111,+,4738
350,BUMA.1121.00076,2,2768315,2773059,+,4744
350,BUMA.1121.00033,2,2603192,2607980,+,4788
350,BUMA.1121.00101,2,1601599,1606336,-,4737
350,BUMA.1121.00105,2,607466,612209,-,4743
350,BUMA.1121.00061,2,1790989,1795727,+,4738
350,BUMA.1121.00063,2,1802093,1806875,+,4782
350,BUMA.1121.00059,2,1778725,1783468,-,4743
350,BUMA.1121.00058,2,2429839,2434627,+,4788
350,BUMA.1121.00043,2,484047,488834,-,4787
350,BUMA.1121.00055,2,853818,858605,-,4787
350,BUMA.1121.00065,2,1852938,1857682,+,4744
350,BUMA.1121.00064,2,1724008,1728752,+,4744
350,BUMA.1121.00047,2,2747122,2751910,+,4788
350,BUMA.1121.00037,2,2173129,2177917,+,4788
350,BUMA.1121.00106,2,1096997,1101741,+,4744
350,BUMA.1121.00051,2,1815705,1820493,+,4788
350,BUMA.1121.00045,2,1701736,1706524,+,4788
350,BUMA.1121.00056,2,2187250,2192037,-,4787
350,BUMA.1121.00095,2,612445,617233,+,4788
350,BUMA.1121.00082,2,1847752,1852534,+,4782
350,BUMA.1121.00001,2,383047,387834,-,4787
350,BUMA.1121.00108,2,2038850,2043633,+,4783
350,BUMA.1121.00083,2,471659,476441,+,4782
350,BUMA.1121.00080,2,1816618,1821406,+,4788
350,BUMA.1121.00012,2,3138746,3143533,-,4787
351,BUMA.1121.00011,2,439243,444011,+,4768
351,BUMA.1121.00009,2,480404,485172,+,4768
351,BUMA.1121.00039,2,2140284,2145052,-,4768
351,BUMA.1121.00029,2,2756677,2761433,-,4756
351,BUMA.1121.00021,2,2339150,2343918,+,4768
351,BUMA.1121.00107,2,1989190,1993977,-,4787
351,BUMA.1121.00023,2,1960576,1965344,+,4768
351,BUMA.1121.00067,2,2161638,2166394,-,4756
351,BUMA.1121.00035,2,2775237,2779993,-,4756
351,BUMA.1121.00005,2,2099104,2103860,-,4756
351,BUMA.1121.00100,2,2955250,2960018,+,4768
351,BUMA.1121.00016,2,1888273,1893029,-,4756
351,BUMA.1121.00099,2,2070343,2075099,+,4756
351,BUMA.1121.00094,2,1861864,1866621,+,4757
351,BUMA.1121.00093,2,1116060,1120816,-,4756
351,BUMA.1121.00097,2,1658994,1663750,+,4756
351,BUMA.1121.00109,2,2845522,2850238,-,4716
351,BUMA.1121.00018,2,1984038,1988788,-,4750
351,BUMA.1121.00110,2,1728070,1732857,+,4787
351,BUMA.1121.00079,2,1819663,1824419,+,4756
351,BUMA.1121.00075,2,1004580,1009347,-,4767
351,BUMA.1121.00066,2,1792618,1797399,+,4781
351,BUMA.1121.00089,2,1807084,1811841,+,4757
351,BUMA.1121.00057,2,277366,282153,-,4787
351,BUMA.1121.00090,2,2818430,2823198,+,4768
351,BUMA.1121.00027,2,2868132,2872887,+,4755
351,BUMA.1121.00062,2,3082242,3086998,-,4756
351,BUMA.1121.00091,2,1811233,1815989,-,4756
351,BUMA.1121.00098,2,2080186,2084942,+,4756
351,BUMA.1121.00092,2,1823728,1828484,+,4756
351,BUMA.1121.00031,2,1006416,1011184,+,4768
351,BUMA.1121.00096,2,2029128,2033883,+,4755
351,BUMA.1121.00073,2,1808286,1813068,+,4782
351,BUMA.1121.00103,2,366076,370844,+,4768
351,BUMA.1121.00084,2,533304,538060,+,4756
351,BUMA.1121.00014,2,1940234,1945002,+,4768
351,BUMA.1121.00111,2,1150631,1155399,+,4768
351,BUMA.1121.00007,2,1890760,1895547,+,4787
351,BUMA.1121.00072,2,1783116,1787897,+,4781
351,BUMA.1121.00071,2,1808232,1813014,+,4782
351,BUMA.1121.00077,2,1883488,1888275,-,4787
351,BUMA.1121.00003,2,58240,63007,+,4767
351,BUMA.1121.00104,2,1911029,1915816,+,4787
351,BUMA.1121.00074,2,2547185,2551941,-,4756
351,BUMA.1121.00060,2,538622,543390,-,4768
351,BUMA.1121.00088,2,1829822,1834578,+,4756
351,BUMA.1121.00053,2,2107183,2111951,+,4768
351,BUMA.1121.00025,2,344130,348880,+,4750
351,BUMA.1121.00070,2,1787751,1792534,+,4783
351,BUMA.1121.00049,2,476848,481616,+,4768
351,BUMA.1121.00078,2,1324937,1329705,-,4768
351,BUMA.1121.00069,2,1780555,1785335,+,4780
351,BUMA.1121.00102,2,1869182,1873950,+,4768
351,BUMA.1121.00112,2,2552604,2557383,-,4779
351,BUMA.1121.00041,2,2776352,2781120,+,4768
351,BUMA.1121.00068,2,397142,401910,+,4768
351,BUMA.1121.00076,2,2773084,2777852,+,4768
351,BUMA.1121.00033,2,2608005,2612773,+,4768
351,BUMA.1121.00101,2,1596800,1601568,-,4768
351,BUMA.1121.00105,2,602673,607441,-,4768
351,BUMA.1121.00061,2,1795758,1800539,+,4781
351,BUMA.1121.00063,2,1806906,1811687,+,4781
351,BUMA.1121.00059,2,1773944,1778700,-,4756
351,BUMA.1121.00058,2,2434652,2439407,+,4755
351,BUMA.1121.00043,2,479254,484022,-,4768
351,BUMA.1121.00055,2,849006,853793,-,4787
351,BUMA.1121.00065,2,1857707,1862476,+,4769
351,BUMA.1121.00064,2,1728777,1733533,+,4756
351,BUMA.1121.00047,2,2751935,2756692,+,4757
351,BUMA.1121.00037,2,2177942,2182710,+,4768
351,BUMA.1121.00106,2,1101766,1106522,+,4756
351,BUMA.1121.00051,2,1820518,1825274,+,4756
351,BUMA.1121.00045,2,1706549,1711317,+,4768
351,BUMA.1121.00056,2,2182468,2187225,-,4757
351,BUMA.1121.00095,2,617258,622014,+,4756
351,BUMA.1121.00082,2,1852565,1857352,+,4787
351,BUMA.1121.00001,2,378266,383022,-,4756
351,BUMA.1121.00108,2,2043658,2048445,+,4787
351,BUMA.1121.00083,2,476472,481259,+,4787
351,BUMA.1121.00080,2,1821431,1826188,+,4757
351,BUMA.1121.00012,2,3133953,3138721,-,4768
352,BUMA.1121.00011,2,444033,476861,+,32828
352,BUMA.1121.00009,2,485194,517871,+,32677
352,BUMA.1121.00039,2,2107525,2140262,-,32737
352,BUMA.1121.00029,2,2723897,2756655,-,32758
352,BUMA.1121.00021,2,2343940,2376725,+,32785
352,BUMA.1121.00107,2,1956458,1989168,-,32710
352,BUMA.1121.00023,2,1965366,1997951,+,32585
352,BUMA.1121.00067,2,2128964,2161616,-,32652
352,BUMA.1121.00035,2,2742400,2775215,-,32815
352,BUMA.1121.00005,2,2066266,2099082,-,32816
352,BUMA.1121.00100,2,2960040,2992792,+,32752
352,BUMA.1121.00016,2,1855439,1888251,-,32812
352,BUMA.1121.00099,2,2075121,2107877,+,32756
352,BUMA.1121.00094,2,1866643,1899452,+,32809
352,BUMA.1121.00093,2,1083292,1116038,-,32746
352,BUMA.1121.00097,2,1663772,1696554,+,32782
352,BUMA.1121.00109,2,2812834,2845500,-,32666
352,BUMA.1121.00018,2,1951247,1984016,-,32769
352,BUMA.1121.00110,2,1732879,1765333,+,32454
352,BUMA.1121.00079,2,1824441,1857300,+,32859
352,BUMA.1121.00075,2,971775,1004558,-,32783
352,BUMA.1121.00066,2,1797421,1830081,+,32660
352,BUMA.1121.00089,2,1811863,1844661,+,32798
352,BUMA.1121.00057,2,244587,277344,-,32757
352,BUMA.1121.00090,2,2823220,2856004,+,32784
352,BUMA.1121.00027,2,2872909,2905616,+,32707
352,BUMA.1121.00062,2,3049556,3082220,-,32664
352,BUMA.1121.00091,2,1778427,1811211,-,32784
352,BUMA.1121.00098,2,2084964,2117678,+,32714
352,BUMA.1121.00092,2,1828506,1861252,+,32746
352,BUMA.1121.00031,2,1011206,1043919,+,32713
352,BUMA.1121.00096,2,2092630,2125169,+,32539
352,BUMA.1121.00073,2,1813090,1845768,+,32678
352,BUMA.1121.00103,2,370866,403646,+,32780
352,BUMA.1121.00084,2,538082,570336,+,32254
352,BUMA.1121.00014,2,1945024,1977762,+,32738
352,BUMA.1121.00111,2,1155421,1188201,+,32780
352,BUMA.1121.00007,2,1895569,1928358,+,32789
352,BUMA.1121.00072,2,1787919,1820609,+,32690
352,BUMA.1121.00071,2,1813036,1845707,+,32671
352,BUMA.1121.00077,2,1851012,1883466,-,32454
352,BUMA.1121.00003,2,63029,95647,+,32618
352,BUMA.1121.00104,2,1915838,1948053,+,32215
352,BUMA.1121.00074,2,2514475,2547163,-,32688
352,BUMA.1121.00060,2,505838,538600,-,32762
352,BUMA.1121.00088,2,1834600,1867075,+,32475
352,BUMA.1121.00053,2,2111973,2144460,+,32487
352,BUMA.1121.00025,2,348902,381678,+,32776
352,BUMA.1121.00070,2,1792556,1825232,+,32676
352,BUMA.1121.00049,2,481638,514441,+,32803
352,BUMA.1121.00078,2,1290900,1324915,-,34015
352,BUMA.1121.00069,2,1785357,1818052,+,32695
352,BUMA.1121.00102,2,1873972,1906756,+,32784
352,BUMA.1121.00112,2,2520019,2552582,-,32563
352,BUMA.1121.00041,2,2781142,2813820,+,32678
352,BUMA.1121.00068,2,401932,434492,+,32560
352,BUMA.1121.00076,2,2777874,2810659,+,32785
352,BUMA.1121.00033,2,2612795,2645571,+,32776
352,BUMA.1121.00101,2,1563973,1596778,-,32805
352,BUMA.1121.00105,2,569973,602651,-,32678
352,BUMA.1121.00061,2,1800561,1833241,+,32680
352,BUMA.1121.00063,2,1811709,1844394,+,32685
352,BUMA.1121.00059,2,1741183,1773922,-,32739
352,BUMA.1121.00058,2,2439429,2471726,+,32297
352,BUMA.1121.00043,2,446449,479232,-,32783
352,BUMA.1121.00055,2,816267,848984,-,32717
352,BUMA.1121.00065,2,1862498,1895214,+,32716
352,BUMA.1121.00064,2,1733555,1765843,+,32288
352,BUMA.1121.00047,2,2756714,2789550,+,32836
352,BUMA.1121.00037,2,2182732,2215529,+,32797
352,BUMA.1121.00106,2,1106544,1138857,+,32313
352,BUMA.1121.00051,2,1825296,1858123,+,32827
352,BUMA.1121.00045,2,1711339,1744101,+,32762
352,BUMA.1121.00056,2,2149648,2182446,-,32798
352,BUMA.1121.00095,2,622036,654787,+,32751
352,BUMA.1121.00082,2,1857374,1890113,+,32739
352,BUMA.1121.00001,2,345534,378244,-,32710
352,BUMA.1121.00108,2,2048467,2082278,+,33811
352,BUMA.1121.00083,2,481281,514020,+,32739
352,BUMA.1121.00080,2,1826210,1859020,+,32810
352,BUMA.1121.00012,2,3101134,3133931,-,32797
353,BUMA.1121.00011,2,476862,479943,+,3081
353,BUMA.1121.00009,2,517872,520953,+,3081
353,BUMA.1121.00039,2,2104444,2107523,-,3079
353,BUMA.1121.00029,2,2720816,2723895,-,3079
353,BUMA.1121.00021,2,2376726,2379807,+,3081
353,BUMA.1121.00107,2,1953377,1956456,-,3079
353,BUMA.1121.00023,2,1997952,2001032,+,3080
353,BUMA.1121.00067,2,2125883,2128962,-,3079
353,BUMA.1121.00035,2,2739319,2742398,-,3079
353,BUMA.1121.00005,2,2063185,2066264,-,3079
353,BUMA.1121.00100,2,2992793,2995861,+,3068
353,BUMA.1121.00016,2,1852358,1855437,-,3079
353,BUMA.1121.00099,2,2107878,2110965,+,3087
353,BUMA.1121.00094,2,1899453,1902523,+,3070
353,BUMA.1121.00093,2,1080211,1083290,-,3079
353,BUMA.1121.00097,2,1696555,1699636,+,3081
353,BUMA.1121.00109,2,2809753,2812832,-,3079
353,BUMA.1121.00018,2,1948166,1951245,-,3079
353,BUMA.1121.00110,2,1765334,1768414,+,3080
353,BUMA.1121.00079,2,1857301,1860371,+,3070
353,BUMA.1121.00075,2,968693,971773,-,3080
353,BUMA.1121.00066,2,1830082,1833162,+,3080
353,BUMA.1121.00089,2,1844662,1847732,+,3070
353,BUMA.1121.00057,2,241506,244585,-,3079
353,BUMA.1121.00090,2,2856005,2859086,+,3081
353,BUMA.1121.00027,2,2905617,2908697,+,3080
353,BUMA.1121.00062,2,3046474,3049554,-,3080
353,BUMA.1121.00091,2,1775345,1778425,-,3080
353,BUMA.1121.00098,2,2117679,2120759,+,3080
353,BUMA.1121.00092,2,1861253,1864333,+,3080
353,BUMA.1121.00031,2,1043920,1047001,+,3081
353,BUMA.1121.00096,2,2125170,2128251,+,3081
353,BUMA.1121.00073,2,1845769,1848849,+,3080
353,BUMA.1121.00103,2,403647,406728,+,3081
353,BUMA.1121.00084,2,570337,573418,+,3081
353,BUMA.1121.00014,2,1977763,1980844,+,3081
353,BUMA.1121.00111,2,1188202,1191282,+,3080
353,BUMA.1121.00007,2,1928359,1931439,+,3080
353,BUMA.1121.00072,2,1820610,1823690,+,3080
353,BUMA.1121.00071,2,1845708,1848788,+,3080
353,BUMA.1121.00077,2,1847934,1851010,-,3076
353,BUMA.1121.00003,2,95648,98723,+,3075
353,BUMA.1121.00104,2,1948054,1951135,+,3081
353,BUMA.1121.00074,2,2511393,2514473,-,3080
353,BUMA.1121.00060,2,502757,505836,-,3079
353,BUMA.1121.00088,2,1867076,1870157,+,3081
353,BUMA.1121.00053,2,2144461,2147542,+,3081
353,BUMA.1121.00025,2,381679,384759,+,3080
353,BUMA.1121.00070,2,1825233,1828313,+,3080
353,BUMA.1121.00049,2,514442,517524,+,3082
353,BUMA.1121.00078,2,1287819,1290898,-,3079
353,BUMA.1121.00069,2,1818053,1821133,+,3080
353,BUMA.1121.00102,2,1906757,1909838,+,3081
353,BUMA.1121.00112,2,2516925,2520017,-,3092
353,BUMA.1121.00041,2,2813821,2816901,+,3080
353,BUMA.1121.00076,2,2810660,2813741,+,3081
353,BUMA.1121.00033,2,2645572,2648652,+,3080
353,BUMA.1121.00101,2,1560892,1563971,-,3079
353,BUMA.1121.00105,2,566891,569971,-,3080
353,BUMA.1121.00059,2,1738101,1741181,-,3080
353,BUMA.1121.00058,2,2471727,2474797,+,3070
353,BUMA.1121.00043,2,443368,446447,-,3079
353,BUMA.1121.00055,2,813185,816265,-,3080
353,BUMA.1121.00065,2,1895215,1898296,+,3081
353,BUMA.1121.00064,2,1765844,1768924,+,3080
353,BUMA.1121.00047,2,2789551,2792621,+,3070
353,BUMA.1121.00037,2,2215530,2218610,+,3080
353,BUMA.1121.00106,2,1138858,1141939,+,3081
353,BUMA.1121.00051,2,1858124,1861194,+,3070
353,BUMA.1121.00045,2,1744102,1747182,+,3080
353,BUMA.1121.00056,2,2146577,2149646,-,3069
353,BUMA.1121.00095,2,654788,657869,+,3081
353,BUMA.1121.00082,2,1890114,1893194,+,3080
353,BUMA.1121.00001,2,342453,345532,-,3079
353,BUMA.1121.00108,2,2082279,2085359,+,3080
353,BUMA.1121.00083,2,514021,517101,+,3080
353,BUMA.1121.00080,2,1859021,1862091,+,3070
353,BUMA.1121.00012,2,3098053,3101132,-,3079
354,BUMA.1121.00011,2,482256,533811,+,51555
354,BUMA.1121.00009,2,523266,574770,+,51504
354,BUMA.1121.00039,2,2050905,2102131,-,51226
354,BUMA.1121.00029,2,2667339,2718503,-,51164
354,BUMA.1121.00021,2,2382120,2433791,+,51671
354,BUMA.1121.00107,2,1899859,1951064,-,51205
354,BUMA.1121.00023,2,2003345,2054974,+,51629
354,BUMA.1121.00067,2,2072396,2123570,-,51174
354,BUMA.1121.00035,2,2685842,2737006,-,51164
354,BUMA.1121.00005,2,2009624,2060872,-,51248
354,BUMA.1121.00100,2,2996593,3048261,+,51668
354,BUMA.1121.00016,2,1798886,1850046,-,51160
354,BUMA.1121.00099,2,2111698,2162832,+,51134
354,BUMA.1121.00094,2,1903256,1954229,+,50973
354,BUMA.1121.00093,2,1026744,1077898,-,51154
354,BUMA.1121.00097,2,1701949,1753020,+,51071
354,BUMA.1121.00109,2,2757233,2809020,-,51787
354,BUMA.1121.00018,2,1894283,1945852,-,51569
354,BUMA.1121.00110,2,1769147,1820792,+,51645
354,BUMA.1121.00079,2,1861104,1912097,+,50993
354,BUMA.1121.00075,2,914847,966380,-,51533
354,BUMA.1121.00066,2,1835475,1886563,+,51088
354,BUMA.1121.00089,2,1848465,1899435,+,50970
354,BUMA.1121.00057,2,188116,239193,-,51077
354,BUMA.1121.00090,2,2861399,2912960,+,51561
354,BUMA.1121.00027,2,2911008,2962135,+,51127
354,BUMA.1121.00062,2,2994590,3045741,-,51151
354,BUMA.1121.00091,2,1721750,1773032,-,51282
354,BUMA.1121.00098,2,2123072,2174174,+,51102
354,BUMA.1121.00092,2,1866646,1917799,+,51153
354,BUMA.1121.00031,2,1050632,1102296,+,51664
354,BUMA.1121.00096,2,2130564,2182144,+,51580
354,BUMA.1121.00073,2,1851162,1902266,+,51104
354,BUMA.1121.00103,2,407462,459098,+,51636
354,BUMA.1121.00084,2,575731,626899,+,51168
354,BUMA.1121.00014,2,1984476,2036148,+,51672
354,BUMA.1121.00111,2,1193595,1245072,+,51477
354,BUMA.1121.00007,2,1932172,1983776,+,51604
354,BUMA.1121.00072,2,1826003,1877105,+,51102
354,BUMA.1121.00071,2,1851101,1902213,+,51112
354,BUMA.1121.00077,2,1795554,1847201,-,51647
354,BUMA.1121.00003,2,99455,150897,+,51442
354,BUMA.1121.00104,2,1953448,2004541,+,51093
354,BUMA.1121.00074,2,2458007,2509080,-,51073
354,BUMA.1121.00060,2,448760,500444,-,51684
354,BUMA.1121.00088,2,1872470,1923588,+,51118
354,BUMA.1121.00053,2,2149855,2201072,+,51217
354,BUMA.1121.00025,2,387073,438640,+,51567
354,BUMA.1121.00070,2,1830626,1881727,+,51101
354,BUMA.1121.00049,2,521361,572467,+,51106
354,BUMA.1121.00078,2,1234294,1285506,-,51212
354,BUMA.1121.00069,2,1823446,1874540,+,51094
354,BUMA.1121.00102,2,1912151,1963395,+,51244
354,BUMA.1121.00112,2,2463118,2514612,-,51494
354,BUMA.1121.00041,2,2819214,2870858,+,51644
354,BUMA.1121.00068,2,444540,495484,+,50944
354,BUMA.1121.00076,2,2816054,2867589,+,51535
354,BUMA.1121.00033,2,2650965,2701826,+,50861
354,BUMA.1121.00101,2,1507194,1558579,-,51385
354,BUMA.1121.00105,2,515033,566158,-,51125
354,BUMA.1121.00061,2,1833337,1884440,+,51103
354,BUMA.1121.00063,2,1844490,1895594,+,51104
354,BUMA.1121.00059,2,1684721,1735788,-,51067
354,BUMA.1121.00058,2,2475530,2526629,+,51099
354,BUMA.1121.00043,2,389953,441054,-,51101
354,BUMA.1121.00055,2,759743,810872,-,51129
354,BUMA.1121.00065,2,1900609,1952116,+,51507
354,BUMA.1121.00064,2,1771237,1822385,+,51148
354,BUMA.1121.00047,2,2793354,2844368,+,51014
354,BUMA.1121.00037,2,2220924,2272087,+,51163
354,BUMA.1121.00106,2,1144252,1195377,+,51125
354,BUMA.1121.00051,2,1861927,1912952,+,51025
354,BUMA.1121.00045,2,1749495,1801139,+,51644
354,BUMA.1121.00056,2,2094873,2145844,-,50971
354,BUMA.1121.00095,2,658601,710027,+,51426
354,BUMA.1121.00082,2,1895507,1946619,+,51112
354,BUMA.1121.00001,2,288989,340140,-,51151
354,BUMA.1121.00108,2,2087672,2139207,+,51535
354,BUMA.1121.00083,2,519414,570526,+,51112
354,BUMA.1121.00080,2,1862824,1913826,+,51002
354,BUMA.1121.00012,2,3044125,3095741,-,51616
355,BUMA.1121.00011,2,551684,594644,+,42960
355,BUMA.1121.00009,2,592299,634817,+,42518
355,BUMA.1121.00039,2,1995157,2037699,-,42542
355,BUMA.1121.00029,2,2606050,2649968,-,43918
355,BUMA.1121.00021,2,2451750,2494484,+,42734
355,BUMA.1121.00107,2,1839813,1882229,-,42416
355,BUMA.1121.00023,2,2069454,2112292,+,42838
355,BUMA.1121.00067,2,2014883,2057446,-,42563
355,BUMA.1121.00035,2,2627389,2671405,-,44016
355,BUMA.1121.00005,2,1948725,1991714,-,42989
355,BUMA.1121.00100,2,3063896,3106606,+,42710
355,BUMA.1121.00016,2,1738763,1781272,-,42509
355,BUMA.1121.00099,2,2180171,2222613,+,42442
355,BUMA.1121.00094,2,1972203,2014831,+,42628
355,BUMA.1121.00093,2,966861,1009400,-,42539
355,BUMA.1121.00097,2,1772640,1815511,+,42871
355,BUMA.1121.00109,2,2696825,2739745,-,42920
355,BUMA.1121.00018,2,1833958,1876510,-,42552
355,BUMA.1121.00110,2,1837425,1880316,+,42891
355,BUMA.1121.00079,2,1930553,1973368,+,42815
355,BUMA.1121.00075,2,854078,896814,-,42736
355,BUMA.1121.00066,2,1903844,1946464,+,42620
355,BUMA.1121.00089,2,1917898,1960534,+,42636
355,BUMA.1121.00057,2,127659,170236,-,42577
355,BUMA.1121.00090,2,2930874,2973520,+,42646
355,BUMA.1121.00027,2,2979724,3022424,+,42700
355,BUMA.1121.00062,2,2933973,2976394,-,42421
355,BUMA.1121.00091,2,1662598,1705405,-,42807
355,BUMA.1121.00098,2,2192151,2234675,+,42524
355,BUMA.1121.00092,2,1935143,1977724,+,42581
355,BUMA.1121.00031,2,1116202,1158738,+,42536
355,BUMA.1121.00096,2,2199258,2242200,+,42942
355,BUMA.1121.00073,2,1920143,1962759,+,42616
355,BUMA.1121.00103,2,476083,518752,+,42669
355,BUMA.1121.00084,2,645377,687989,+,42612
355,BUMA.1121.00014,2,2050450,2093036,+,42586
355,BUMA.1121.00111,2,1262207,1306051,+,43844
355,BUMA.1121.00007,2,2001896,2044843,+,42947
355,BUMA.1121.00072,2,1894640,1937262,+,42622
355,BUMA.1121.00071,2,1920072,1962689,+,42617
355,BUMA.1121.00077,2,1735877,1778922,-,43045
355,BUMA.1121.00003,2,168792,211364,+,42572
355,BUMA.1121.00104,2,2022557,2065194,+,42637
355,BUMA.1121.00074,2,2398549,2441230,-,42681
355,BUMA.1121.00060,2,390329,432941,-,42612
355,BUMA.1121.00088,2,1942665,1985217,+,42552
355,BUMA.1121.00053,2,2218722,2261297,+,42575
355,BUMA.1121.00025,2,456413,498952,+,42539
355,BUMA.1121.00070,2,1899606,1942226,+,42620
355,BUMA.1121.00049,2,591139,633738,+,42599
355,BUMA.1121.00078,2,1174428,1217332,-,42904
355,BUMA.1121.00069,2,1892187,1934805,+,42618
355,BUMA.1121.00102,2,1977470,2020216,+,42746
355,BUMA.1121.00112,2,2402755,2445278,-,42523
355,BUMA.1121.00041,2,2888717,2931780,+,43063
355,BUMA.1121.00068,2,511751,554666,+,42915
355,BUMA.1121.00076,2,2885622,2928491,+,42869
355,BUMA.1121.00033,2,2719456,2761965,+,42509
355,BUMA.1121.00101,2,1446830,1489328,-,42498
355,BUMA.1121.00105,2,456190,498932,-,42742
355,BUMA.1121.00061,2,1902303,1944926,+,42623
355,BUMA.1121.00063,2,1913289,1955898,+,42609
355,BUMA.1121.00059,2,1624326,1667176,-,42850
355,BUMA.1121.00058,2,2542391,2585010,+,42619
355,BUMA.1121.00043,2,329483,372056,-,42573
355,BUMA.1121.00055,2,700167,742791,-,42624
355,BUMA.1121.00065,2,1967698,2010392,+,42694
355,BUMA.1121.00064,2,1839162,1881733,+,42571
355,BUMA.1121.00047,2,2862695,2905615,+,42920
355,BUMA.1121.00037,2,2285359,2328229,+,42870
355,BUMA.1121.00106,2,1213178,1255712,+,42534
355,BUMA.1121.00051,2,1931406,1974283,+,42877
355,BUMA.1121.00045,2,1816958,1859557,+,42599
355,BUMA.1121.00056,2,2034067,2076668,-,42601
355,BUMA.1121.00095,2,726522,769370,+,42848
355,BUMA.1121.00082,2,1964498,2007123,+,42625
355,BUMA.1121.00001,2,227561,271617,-,44056
355,BUMA.1121.00108,2,2155292,2198023,+,42731
355,BUMA.1121.00083,2,588405,631037,+,42632
355,BUMA.1121.00080,2,1932015,1975002,+,42987
355,BUMA.1121.00012,2,2984467,3028315,-,43848
356,BUMA.1121.00011,2,596531,619838,+,23307
356,BUMA.1121.00009,2,636687,660201,+,23514
356,BUMA.1121.00039,2,1969976,1993306,-,23330
356,BUMA.1121.00029,2,2580726,2604199,-,23473
356,BUMA.1121.00021,2,2496335,2519980,+,23645
356,BUMA.1121.00107,2,1814684,1837937,-,23253
356,BUMA.1121.00023,2,2114143,2137491,+,23348
356,BUMA.1121.00067,2,1989385,2013021,-,23636
356,BUMA.1121.00035,2,2602016,2625538,-,23522
356,BUMA.1121.00005,2,1923565,1946874,-,23309
356,BUMA.1121.00100,2,467,23920,+,23453
356,BUMA.1121.00016,2,1713280,1736912,-,23632
356,BUMA.1121.00099,2,2224480,2247781,+,23301
356,BUMA.1121.00094,2,2016682,2040092,+,23410
356,BUMA.1121.00093,2,941420,965010,-,23590
356,BUMA.1121.00097,2,1817376,1840635,+,23259
356,BUMA.1121.00109,2,2671640,2694974,-,23334
356,BUMA.1121.00018,2,1808697,1832107,-,23410
356,BUMA.1121.00110,2,1882164,1905527,+,23363
356,BUMA.1121.00079,2,1975219,1998787,+,23568
356,BUMA.1121.00075,2,828885,852233,-,23348
356,BUMA.1121.00066,2,1949777,1972868,+,23091
356,BUMA.1121.00089,2,1962385,1985803,+,23418
356,BUMA.1121.00057,2,100915,124346,-,23431
356,BUMA.1121.00090,2,2975371,2998813,+,23442
356,BUMA.1121.00027,2,3025737,3048972,+,23235
356,BUMA.1121.00062,2,2908471,2932122,-,23651
356,BUMA.1121.00091,2,1637439,1660747,-,23308
356,BUMA.1121.00098,2,2236520,2259853,+,23333
356,BUMA.1121.00092,2,1979575,2003166,+,23591
356,BUMA.1121.00031,2,1160589,1184054,+,23465
356,BUMA.1121.00096,2,2244050,2267374,+,23324
356,BUMA.1121.00073,2,1966072,1989192,+,23120
356,BUMA.1121.00103,2,520606,544050,+,23444
356,BUMA.1121.00084,2,689840,713307,+,23467
356,BUMA.1121.00014,2,2094887,2118464,+,23577
356,BUMA.1121.00111,2,1307902,1331396,+,23494
356,BUMA.1121.00007,2,2046708,2070051,+,23343
356,BUMA.1121.00072,2,1940575,1963705,+,23130
356,BUMA.1121.00071,2,1966002,1989126,+,23124
356,BUMA.1121.00077,2,1710635,1734029,-,23394
356,BUMA.1121.00003,2,213219,236550,+,23331
356,BUMA.1121.00104,2,2067048,2090474,+,23426
356,BUMA.1121.00074,2,2373297,2396687,-,23390
356,BUMA.1121.00060,2,365263,388464,-,23201
356,BUMA.1121.00088,2,1987093,2010836,+,23743
356,BUMA.1121.00053,2,2263173,2286685,+,23512
356,BUMA.1121.00025,2,500803,524222,+,23419
356,BUMA.1121.00070,2,1945539,1968689,+,23150
356,BUMA.1121.00049,2,635593,658879,+,23286
356,BUMA.1121.00078,2,1149209,1172574,-,23365
356,BUMA.1121.00069,2,1936669,1959824,+,23155
356,BUMA.1121.00102,2,2022092,2045581,+,23489
356,BUMA.1121.00112,2,2377556,2400904,-,23348
356,BUMA.1121.00041,2,2933656,2957006,+,23350
356,BUMA.1121.00068,2,556548,580251,+,23703
356,BUMA.1121.00076,2,2930336,2953651,+,23315
356,BUMA.1121.00033,2,2763816,2787203,+,23387
356,BUMA.1121.00101,2,1421447,1444979,-,23532
356,BUMA.1121.00105,2,430889,454339,-,23450
356,BUMA.1121.00061,2,1948239,1971385,+,23146
356,BUMA.1121.00063,2,1959211,1982289,+,23078
356,BUMA.1121.00059,2,1599114,1622461,-,23347
356,BUMA.1121.00058,2,2586864,2610260,+,23396
356,BUMA.1121.00043,2,304094,327632,-,23538
356,BUMA.1121.00055,2,674863,698313,-,23450
356,BUMA.1121.00065,2,2012246,2035605,+,23359
356,BUMA.1121.00064,2,1883595,1906962,+,23367
356,BUMA.1121.00047,2,2907466,2930864,+,23398
356,BUMA.1121.00037,2,2330080,2353513,+,23433
356,BUMA.1121.00106,2,1257561,1280971,+,23410
356,BUMA.1121.00051,2,1976134,1999535,+,23401
356,BUMA.1121.00045,2,1861422,1884624,+,23202
356,BUMA.1121.00056,2,2008904,2032216,-,23312
356,BUMA.1121.00095,2,771226,794607,+,23381
356,BUMA.1121.00082,2,2010436,2033615,+,23179
356,BUMA.1121.00001,2,202320,225710,-,23390
356,BUMA.1121.00108,2,2199885,2223339,+,23454
356,BUMA.1121.00083,2,634350,657529,+,23179
356,BUMA.1121.00080,2,1976853,2000293,+,23440
356,BUMA.1121.00012,2,2959196,2982616,-,23420
357,BUMA.1121.00011,2,621313,653306,+,31993
357,BUMA.1121.00009,2,661645,693936,+,32291
357,BUMA.1121.00039,2,1936425,1968516,-,32091
357,BUMA.1121.00029,2,2547079,2579281,-,32202
357,BUMA.1121.00021,2,2521440,2553547,+,32107
357,BUMA.1121.00107,2,1781157,1813209,-,32052
357,BUMA.1121.00023,2,2138936,2171021,+,32085
357,BUMA.1121.00067,2,1955905,1987925,-,32020
357,BUMA.1121.00035,2,2568343,2600556,-,32213
357,BUMA.1121.00005,2,1890069,1922111,-,32042
357,BUMA.1121.00100,2,25341,57454,+,32113
357,BUMA.1121.00016,2,1679586,1711835,-,32249
357,BUMA.1121.00099,2,2248773,2281055,+,32282
357,BUMA.1121.00094,2,2041552,2073600,+,32048
357,BUMA.1121.00093,2,907868,939960,-,32092
357,BUMA.1121.00097,2,1842095,1874110,+,32015
357,BUMA.1121.00109,2,2638097,2670234,-,32137
357,BUMA.1121.00018,2,1775082,1807238,-,32156
357,BUMA.1121.00110,2,1906987,1939061,+,32074
357,BUMA.1121.00079,2,2000247,2032108,+,31861
357,BUMA.1121.00075,2,795440,827464,-,32024
357,BUMA.1121.00066,2,1972966,2004961,+,31995
357,BUMA.1121.00089,2,1987263,2019262,+,31999
357,BUMA.1121.00057,2,67497,99455,-,31958
357,BUMA.1121.00090,2,3000258,3032412,+,32154
357,BUMA.1121.00027,2,3050446,3082480,+,32034
357,BUMA.1121.00062,2,2874967,2907011,-,32044
357,BUMA.1121.00091,2,1603832,1635964,-,32132
357,BUMA.1121.00098,2,2261313,2293323,+,32010
357,BUMA.1121.00092,2,2004626,2036699,+,32073
357,BUMA.1121.00031,2,1185513,1217569,+,32056
357,BUMA.1121.00096,2,2268384,2300712,+,32328
357,BUMA.1121.00073,2,1989290,2021290,+,32000
357,BUMA.1121.00103,2,545555,577611,+,32056
357,BUMA.1121.00084,2,714767,746845,+,32078
357,BUMA.1121.00014,2,2119924,2151954,+,32030
357,BUMA.1121.00111,2,1332856,1364915,+,32059
357,BUMA.1121.00007,2,2071526,2103609,+,32083
357,BUMA.1121.00072,2,1963802,1995811,+,32009
357,BUMA.1121.00071,2,1989223,2021173,+,31950
357,BUMA.1121.00077,2,1677103,1709175,-,32072
357,BUMA.1121.00003,2,237563,269500,+,31937
357,BUMA.1121.00104,2,2091934,2123952,+,32018
357,BUMA.1121.00074,2,2339880,2371837,-,31957
357,BUMA.1121.00060,2,331754,363788,-,32034
357,BUMA.1121.00088,2,2012296,2044376,+,32080
357,BUMA.1121.00053,2,2288130,2320070,+,31940
357,BUMA.1121.00025,2,525682,557874,+,32192
357,BUMA.1121.00070,2,1968787,2000739,+,31952
357,BUMA.1121.00049,2,660354,692430,+,32076
357,BUMA.1121.00078,2,1115575,1147788,-,32213
357,BUMA.1121.00069,2,1959921,1991858,+,31937
357,BUMA.1121.00102,2,2047056,2079412,+,32356
357,BUMA.1121.00112,2,2344104,2376081,-,31977
357,BUMA.1121.00041,2,2958442,2990708,+,32266
357,BUMA.1121.00068,2,581711,613881,+,32170
357,BUMA.1121.00076,2,2955072,2987038,+,31966
357,BUMA.1121.00033,2,2788661,2820635,+,31974
357,BUMA.1121.00101,2,1387848,1420002,-,32154
357,BUMA.1121.00105,2,397468,429429,-,31961
357,BUMA.1121.00061,2,1972842,2004717,+,31875
357,BUMA.1121.00063,2,1982386,2014388,+,32002
357,BUMA.1121.00059,2,1565713,1597654,-,31941
357,BUMA.1121.00058,2,2611720,2643706,+,31986
357,BUMA.1121.00043,2,270539,302634,-,32095
357,BUMA.1121.00055,2,641278,673388,-,32110
357,BUMA.1121.00065,2,2037050,2069064,+,32014
357,BUMA.1121.00064,2,1908422,1940414,+,31992
357,BUMA.1121.00047,2,2932324,2964240,+,31916
357,BUMA.1121.00037,2,2354958,2386964,+,32006
357,BUMA.1121.00106,2,1282431,1314443,+,32012
357,BUMA.1121.00051,2,2000995,2032999,+,32004
357,BUMA.1121.00045,2,1886099,1918167,+,32068
357,BUMA.1121.00056,2,1975444,2007444,-,32000
357,BUMA.1121.00095,2,796112,828101,+,31989
357,BUMA.1121.00082,2,2035075,2067090,+,32015
357,BUMA.1121.00001,2,168556,200860,-,32304
357,BUMA.1121.00108,2,2224829,2256807,+,31978
357,BUMA.1121.00083,2,658989,691004,+,32015
357,BUMA.1121.00080,2,2001753,2033787,+,32034
357,BUMA.1121.00012,2,2925632,2957751,-,32119
358,BUMA.1121.00011,2,658213,700850,+,42637
358,BUMA.1121.00009,2,698842,741554,+,42712
358,BUMA.1121.00039,2,1887363,1930164,-,42801
358,BUMA.1121.00029,2,2499416,2542174,-,42758
358,BUMA.1121.00021,2,2558454,2601349,+,42895
358,BUMA.1121.00107,2,1733606,1776251,-,42645
358,BUMA.1121.00023,2,2175929,2218656,+,42727
358,BUMA.1121.00067,2,1908204,1950999,-,42795
358,BUMA.1121.00035,2,2520733,2563436,-,42703
358,BUMA.1121.00005,2,1842499,1885161,-,42662
358,BUMA.1121.00100,2,58570,101439,+,42869
358,BUMA.1121.00016,2,1631928,1674679,-,42751
358,BUMA.1121.00099,2,2282165,2325045,+,42880
358,BUMA.1121.00094,2,2078507,2121235,+,42728
358,BUMA.1121.00093,2,860056,902960,-,42904
358,BUMA.1121.00097,2,1875197,1918174,+,42977
358,BUMA.1121.00109,2,2590588,2633190,-,42602
358,BUMA.1121.00018,2,1727499,1770174,-,42675
358,BUMA.1121.00110,2,1943969,1986643,+,42674
358,BUMA.1121.00079,2,2037016,2079730,+,42714
358,BUMA.1121.00075,2,747911,790532,-,42621
358,BUMA.1121.00066,2,2009861,2052423,+,42562
358,BUMA.1121.00089,2,2024170,2066979,+,42809
358,BUMA.1121.00057,2,19820,62591,-,42771
358,BUMA.1121.00090,2,3037320,3080001,+,42681
358,BUMA.1121.00027,2,3087387,3130110,+,42723
358,BUMA.1121.00062,2,2827241,2870032,-,42791
358,BUMA.1121.00091,2,1556143,1598926,-,42783
358,BUMA.1121.00098,2,2298229,2340847,+,42618
358,BUMA.1121.00092,2,2041608,2084673,+,43065
358,BUMA.1121.00031,2,1222476,1265051,+,42575
358,BUMA.1121.00096,2,2301822,2344683,+,42861
358,BUMA.1121.00073,2,2026191,2068771,+,42580
358,BUMA.1121.00103,2,582518,625264,+,42746
358,BUMA.1121.00084,2,751752,794419,+,42667
358,BUMA.1121.00014,2,2156861,2199604,+,42743
358,BUMA.1121.00111,2,1369822,1412558,+,42736
358,BUMA.1121.00007,2,2108516,2151074,+,42558
358,BUMA.1121.00072,2,2000719,2043331,+,42612
358,BUMA.1121.00071,2,2026069,2068646,+,42577
358,BUMA.1121.00077,2,1629507,1672196,-,42689
358,BUMA.1121.00003,2,270619,313429,+,42810
358,BUMA.1121.00104,2,2128859,2171588,+,42729
358,BUMA.1121.00074,2,2292141,2334974,-,42833
358,BUMA.1121.00060,2,284162,326848,-,42686
358,BUMA.1121.00088,2,2049283,2092048,+,42765
358,BUMA.1121.00053,2,2324977,2367679,+,42702
358,BUMA.1121.00025,2,562783,605458,+,42675
358,BUMA.1121.00070,2,2005638,2048220,+,42582
358,BUMA.1121.00049,2,697328,740085,+,42757
358,BUMA.1121.00078,2,1067880,1110668,-,42788
358,BUMA.1121.00069,2,1992563,2035178,+,42615
358,BUMA.1121.00102,2,2084318,2127328,+,43010
358,BUMA.1121.00112,2,2296534,2339199,-,42665
358,BUMA.1121.00041,2,2995599,3038265,+,42666
358,BUMA.1121.00068,2,618788,661453,+,42665
358,BUMA.1121.00076,2,2991947,3034534,+,42587
358,BUMA.1121.00033,2,2825542,2868203,+,42661
358,BUMA.1121.00101,2,1340316,1382942,-,42626
358,BUMA.1121.00105,2,349850,392562,-,42712
358,BUMA.1121.00061,2,2009616,2052248,+,42632
358,BUMA.1121.00063,2,2019287,2061842,+,42555
358,BUMA.1121.00059,2,1517888,1560807,-,42919
358,BUMA.1121.00058,2,2648614,2691223,+,42609
358,BUMA.1121.00043,2,222973,265632,-,42659
358,BUMA.1121.00055,2,593663,636368,-,42705
358,BUMA.1121.00065,2,2073972,2116655,+,42683
358,BUMA.1121.00064,2,1945321,1988086,+,42765
358,BUMA.1121.00047,2,2969148,3011838,+,42690
358,BUMA.1121.00037,2,2391874,2434509,+,42635
358,BUMA.1121.00106,2,1319350,1362133,+,42783
358,BUMA.1121.00051,2,2037907,2080638,+,42731
358,BUMA.1121.00045,2,1923074,1965765,+,42691
358,BUMA.1121.00056,2,1927811,1970537,-,42726
358,BUMA.1121.00095,2,829216,871997,+,42781
358,BUMA.1121.00082,2,2071998,2114661,+,42663
358,BUMA.1121.00001,2,120914,163650,-,42736
358,BUMA.1121.00108,2,2261714,2304192,+,42478
358,BUMA.1121.00083,2,695912,738575,+,42663
358,BUMA.1121.00080,2,2038695,2081524,+,42829
358,BUMA.1121.00012,2,2877979,2920725,-,42746
359,BUMA.1121.00011,2,700852,720648,+,19796
359,BUMA.1121.00009,2,741556,761405,+,19849
359,BUMA.1121.00039,2,1867351,1887362,-,20011
359,BUMA.1121.00029,2,2479380,2499415,-,20035
359,BUMA.1121.00021,2,2601351,2621276,+,19925
359,BUMA.1121.00107,2,1713754,1733605,-,19851
359,BUMA.1121.00023,2,2218658,2238542,+,19884
359,BUMA.1121.00067,2,1888218,1908203,-,19985
359,BUMA.1121.00035,2,2500772,2520732,-,19960
359,BUMA.1121.00005,2,1822625,1842498,-,19873
359,BUMA.1121.00100,2,101441,121262,+,19821
359,BUMA.1121.00016,2,1611928,1631927,-,19999
359,BUMA.1121.00099,2,2325047,2344879,+,19832
359,BUMA.1121.00094,2,2121237,2141164,+,19927
359,BUMA.1121.00093,2,840091,860055,-,19964
359,BUMA.1121.00097,2,1918176,1937997,+,19821
359,BUMA.1121.00109,2,2570697,2590587,-,19890
359,BUMA.1121.00018,2,1707599,1727498,-,19899
359,BUMA.1121.00110,2,1986645,2006423,+,19778
359,BUMA.1121.00079,2,2079732,2099534,+,19802
359,BUMA.1121.00075,2,728037,747910,-,19873
359,BUMA.1121.00066,2,2052425,2072318,+,19893
359,BUMA.1121.00089,2,2066981,2086920,+,19939
359,BUMA.1121.00057,2,1,19819,-,19818
359,BUMA.1121.00090,2,3080003,3099910,+,19907
359,BUMA.1121.00027,2,3130112,3149981,+,19869
359,BUMA.1121.00062,2,2807401,2827240,-,19839
359,BUMA.1121.00091,2,1536291,1556142,-,19851
359,BUMA.1121.00098,2,2340849,2360717,+,19868
359,BUMA.1121.00092,2,2084675,2104648,+,19973
359,BUMA.1121.00031,2,1265053,1284971,+,19918
359,BUMA.1121.00096,2,2344685,2364529,+,19844
359,BUMA.1121.00073,2,2068773,2088565,+,19792
359,BUMA.1121.00103,2,661189,681083,+,19894
359,BUMA.1121.00084,2,794421,814307,+,19886
359,BUMA.1121.00014,2,2199606,2219523,+,19917
359,BUMA.1121.00111,2,1412560,1432435,+,19875
359,BUMA.1121.00007,2,2151076,2170940,+,19864
359,BUMA.1121.00072,2,2043333,2063240,+,19907
359,BUMA.1121.00071,2,2068648,2088547,+,19899
359,BUMA.1121.00077,2,1609727,1629506,-,19779
359,BUMA.1121.00003,2,313431,333324,+,19893
359,BUMA.1121.00104,2,2171590,2191640,+,20050
359,BUMA.1121.00074,2,2272222,2292140,-,19918
359,BUMA.1121.00060,2,264390,284161,-,19771
359,BUMA.1121.00088,2,2092050,2111943,+,19893
359,BUMA.1121.00053,2,2367681,2387546,+,19865
359,BUMA.1121.00025,2,605460,625368,+,19908
359,BUMA.1121.00070,2,2048222,2068008,+,19786
359,BUMA.1121.00049,2,740087,759936,+,19849
359,BUMA.1121.00078,2,1047928,1067879,-,19951
359,BUMA.1121.00069,2,2035180,2055089,+,19909
359,BUMA.1121.00102,2,2127330,2147190,+,19860
359,BUMA.1121.00112,2,2276617,2296533,-,19916
359,BUMA.1121.00041,2,3038267,3058144,+,19877
359,BUMA.1121.00068,2,661455,681186,+,19731
359,BUMA.1121.00076,2,3034536,3054410,+,19874
359,BUMA.1121.00033,2,2868205,2888009,+,19804
359,BUMA.1121.00101,2,1320464,1340315,-,19851
359,BUMA.1121.00105,2,329963,349849,-,19886
359,BUMA.1121.00061,2,2052250,2072151,+,19901
359,BUMA.1121.00063,2,2061844,2081752,+,19908
359,BUMA.1121.00059,2,1497957,1517887,-,19930
359,BUMA.1121.00058,2,2691225,2711106,+,19881
359,BUMA.1121.00043,2,203092,222972,-,19880
359,BUMA.1121.00055,2,573797,593662,-,19865
359,BUMA.1121.00065,2,2116657,2136606,+,19949
359,BUMA.1121.00064,2,1988088,2008080,+,19992
359,BUMA.1121.00047,2,3011840,3031733,+,19893
359,BUMA.1121.00037,2,2434511,2454367,+,19856
359,BUMA.1121.00106,2,1362135,1382189,+,20054
359,BUMA.1121.00051,2,2080640,2100575,+,19935
359,BUMA.1121.00045,2,1965767,1985538,+,19771
359,BUMA.1121.00056,2,1907934,1927810,-,19876
359,BUMA.1121.00095,2,906629,926445,+,19816
359,BUMA.1121.00082,2,2114663,2134574,+,19911
359,BUMA.1121.00001,2,100983,120913,-,19930
359,BUMA.1121.00108,2,2304194,2324061,+,19867
359,BUMA.1121.00083,2,738577,758488,+,19911
359,BUMA.1121.00080,2,2081526,2101404,+,19878
359,BUMA.1121.00012,2,2858156,2877978,-,19822
360,BUMA.1121.00011,2,720668,732401,+,11733
360,BUMA.1121.00009,2,761425,773198,+,11773
360,BUMA.1121.00039,2,1855617,1867331,-,11714
360,BUMA.1121.00029,2,2467603,2479360,-,11757
360,BUMA.1121.00021,2,2621296,2633053,+,11757
360,BUMA.1121.00107,2,1701955,1713734,-,11779
360,BUMA.1121.00023,2,2238562,2250286,+,11724
360,BUMA.1121.00067,2,1876370,1888198,-,11828
360,BUMA.1121.00035,2,2488988,2500752,-,11764
360,BUMA.1121.00005,2,1810818,1822605,-,11787
360,BUMA.1121.00100,2,121282,133007,+,11725
360,BUMA.1121.00016,2,1600140,1611908,-,11768
360,BUMA.1121.00099,2,2344899,2356656,+,11757
360,BUMA.1121.00094,2,2141184,2152976,+,11792
360,BUMA.1121.00093,2,828321,840071,-,11750
360,BUMA.1121.00097,2,1938017,1949797,+,11780
360,BUMA.1121.00109,2,2559104,2570677,-,11573
360,BUMA.1121.00018,2,1695834,1707579,-,11745
360,BUMA.1121.00110,2,2006443,2018212,+,11769
360,BUMA.1121.00079,2,2099554,2111346,+,11792
360,BUMA.1121.00075,2,716266,728017,-,11751
360,BUMA.1121.00066,2,2072338,2084088,+,11750
360,BUMA.1121.00089,2,2086940,2098738,+,11798
360,BUMA.1121.00057,2,3127264,3139014,-,11750
360,BUMA.1121.00090,2,3099930,3111687,+,11757
360,BUMA.1121.00027,2,3150001,3161751,+,11750
360,BUMA.1121.00062,2,2795631,2807381,-,11750
360,BUMA.1121.00091,2,1524485,1536271,-,11786
360,BUMA.1121.00098,2,2360737,2372566,+,11829
360,BUMA.1121.00092,2,2104668,2116418,+,11750
360,BUMA.1121.00031,2,1284991,1296748,+,11757
360,BUMA.1121.00096,2,2364549,2376312,+,11763
360,BUMA.1121.00073,2,2088585,2100335,+,11750
360,BUMA.1121.00103,2,681103,692869,+,11766
360,BUMA.1121.00084,2,814327,826116,+,11789
360,BUMA.1121.00014,2,2219543,2231299,+,11756
360,BUMA.1121.00111,2,1432455,1444200,+,11745
360,BUMA.1121.00007,2,2170960,2182719,+,11759
360,BUMA.1121.00072,2,2063260,2075010,+,11750
360,BUMA.1121.00071,2,2088567,2100317,+,11750
360,BUMA.1121.00077,2,1597939,1609707,-,11768
360,BUMA.1121.00003,2,333344,345131,+,11787
360,BUMA.1121.00104,2,2191660,2203425,+,11765
360,BUMA.1121.00074,2,2260414,2272202,-,11788
360,BUMA.1121.00060,2,252623,264370,-,11747
360,BUMA.1121.00088,2,2111963,2123737,+,11774
360,BUMA.1121.00053,2,2387566,2399349,+,11783
360,BUMA.1121.00025,2,625388,637133,+,11745
360,BUMA.1121.00070,2,2068028,2079778,+,11750
360,BUMA.1121.00049,2,759956,771726,+,11770
360,BUMA.1121.00078,2,1036157,1047908,-,11751
360,BUMA.1121.00069,2,2055109,2066859,+,11750
360,BUMA.1121.00102,2,2147210,2158973,+,11763
360,BUMA.1121.00112,2,2264828,2276597,-,11769
360,BUMA.1121.00041,2,3058164,3069939,+,11775
360,BUMA.1121.00068,2,681206,693019,+,11813
360,BUMA.1121.00076,2,3054430,3066181,+,11751
360,BUMA.1121.00033,2,2888029,2899797,+,11768
360,BUMA.1121.00101,2,1308687,1320444,-,11757
360,BUMA.1121.00105,2,318186,329943,-,11757
360,BUMA.1121.00061,2,2072171,2083921,+,11750
360,BUMA.1121.00063,2,2081772,2093522,+,11750
360,BUMA.1121.00059,2,1486169,1497937,-,11768
360,BUMA.1121.00058,2,2711126,2722913,+,11787
360,BUMA.1121.00043,2,191304,203072,-,11768
360,BUMA.1121.00055,2,562002,573777,-,11775
360,BUMA.1121.00065,2,2136626,2148401,+,11775
360,BUMA.1121.00064,2,2008100,2019881,+,11781
360,BUMA.1121.00047,2,3031753,3043555,+,11802
360,BUMA.1121.00037,2,2454387,2466144,+,11757
360,BUMA.1121.00106,2,1382209,1393974,+,11765
360,BUMA.1121.00051,2,2100595,2112387,+,11792
360,BUMA.1121.00045,2,1985558,1997305,+,11747
360,BUMA.1121.00056,2,1896116,1907914,-,11798
360,BUMA.1121.00095,2,926465,938234,+,11769
360,BUMA.1121.00082,2,2134594,2146344,+,11750
360,BUMA.1121.00001,2,89206,100963,-,11757
360,BUMA.1121.00108,2,2324081,2335832,+,11751
360,BUMA.1121.00083,2,758508,770258,+,11750
360,BUMA.1121.00080,2,2101424,2113216,+,11792
360,BUMA.1121.00012,2,2846401,2858136,-,11735
361,BUMA.1121.00011,2,736117,748427,+,12310
361,BUMA.1121.00009,2,776914,789216,+,12302
361,BUMA.1121.00039,2,1839450,1851792,-,12342
361,BUMA.1121.00029,2,2451343,2463778,-,12435
361,BUMA.1121.00021,2,2636862,2649183,+,12321
361,BUMA.1121.00107,2,1685913,1698259,-,12346
361,BUMA.1121.00023,2,2254095,2266397,+,12302
361,BUMA.1121.00067,2,1860271,1872542,-,12271
361,BUMA.1121.00035,2,2472770,2485163,-,12393
361,BUMA.1121.00005,2,1794643,1807008,-,12365
361,BUMA.1121.00100,2,136890,149132,+,12242
361,BUMA.1121.00016,2,1583965,1596312,-,12347
361,BUMA.1121.00099,2,2360594,2372934,+,12340
361,BUMA.1121.00094,2,2156784,2169142,+,12358
361,BUMA.1121.00093,2,812294,824604,-,12310
361,BUMA.1121.00097,2,1953513,1965849,+,12336
361,BUMA.1121.00109,2,2543015,2555324,-,12309
361,BUMA.1121.00018,2,1679665,1692006,-,12341
361,BUMA.1121.00110,2,2021928,2034241,+,12313
361,BUMA.1121.00079,2,2115152,2127407,+,12255
361,BUMA.1121.00075,2,700207,712549,-,12342
361,BUMA.1121.00066,2,2087681,2100014,+,12333
361,BUMA.1121.00089,2,2102544,2114902,+,12358
361,BUMA.1121.00057,2,3111223,3123550,-,12327
361,BUMA.1121.00090,2,3115496,3127817,+,12321
361,BUMA.1121.00027,2,3165464,3177757,+,12293
361,BUMA.1121.00062,2,2779633,2792028,-,12395
361,BUMA.1121.00091,2,1508280,1520657,-,12377
361,BUMA.1121.00098,2,2376264,2388599,+,12335
361,BUMA.1121.00092,2,2120134,2132430,+,12296
361,BUMA.1121.00031,2,1300557,1312880,+,12323
361,BUMA.1121.00096,2,2379917,2392201,+,12284
361,BUMA.1121.00073,2,2103937,2116279,+,12342
361,BUMA.1121.00103,2,696459,708766,+,12307
361,BUMA.1121.00084,2,829832,842110,+,12278
361,BUMA.1121.00014,2,2235108,2247459,+,12351
361,BUMA.1121.00111,2,1448027,1460352,+,12325
361,BUMA.1121.00007,2,2186435,2198798,+,12363
361,BUMA.1121.00072,2,2078612,2090941,+,12329
361,BUMA.1121.00071,2,2103919,2116258,+,12339
361,BUMA.1121.00077,2,1581895,1594222,-,12327
361,BUMA.1121.00003,2,348847,361139,+,12292
361,BUMA.1121.00104,2,2207252,2219614,+,12362
361,BUMA.1121.00074,2,2244186,2256586,-,12400
361,BUMA.1121.00060,2,236511,248924,-,12413
361,BUMA.1121.00088,2,2127564,2139842,+,12278
361,BUMA.1121.00053,2,2402954,2415320,+,12366
361,BUMA.1121.00025,2,640960,653280,+,12320
361,BUMA.1121.00070,2,2083380,2095718,+,12338
361,BUMA.1121.00049,2,775553,787883,+,12330
361,BUMA.1121.00078,2,1020053,1032463,-,12410
361,BUMA.1121.00069,2,2070461,2082794,+,12333
361,BUMA.1121.00102,2,2162578,2174915,+,12337
361,BUMA.1121.00112,2,2248734,2261111,-,12377
361,BUMA.1121.00041,2,3073637,3085993,+,12356
361,BUMA.1121.00068,2,696735,709028,+,12293
361,BUMA.1121.00076,2,3069897,3082227,+,12330
361,BUMA.1121.00033,2,2903621,2915940,+,12319
361,BUMA.1121.00101,2,1292564,1304970,-,12406
361,BUMA.1121.00105,2,302170,314580,-,12410
361,BUMA.1121.00061,2,2087523,2099820,+,12297
361,BUMA.1121.00063,2,2097124,2109456,+,12332
361,BUMA.1121.00059,2,1470078,1482452,-,12374
361,BUMA.1121.00058,2,2726740,2739085,+,12345
361,BUMA.1121.00043,2,175135,187479,-,12344
361,BUMA.1121.00055,2,545963,558285,-,12322
361,BUMA.1121.00065,2,2152207,2164559,+,12352
361,BUMA.1121.00064,2,2023708,2036019,+,12311
361,BUMA.1121.00047,2,3047361,3059710,+,12349
361,BUMA.1121.00037,2,2469953,2482297,+,12344
361,BUMA.1121.00106,2,1397799,1410117,+,12318
361,BUMA.1121.00051,2,2116193,2128550,+,12357
361,BUMA.1121.00045,2,2001003,2013368,+,12365
361,BUMA.1121.00056,2,1879857,1892309,-,12452
361,BUMA.1121.00095,2,942172,954480,+,12308
361,BUMA.1121.00082,2,2149946,2162288,+,12342
361,BUMA.1121.00001,2,72962,85381,-,12419
361,BUMA.1121.00108,2,2339659,2352003,+,12344
361,BUMA.1121.00083,2,773860,786202,+,12342
361,BUMA.1121.00080,2,2116689,2129052,+,12363
361,BUMA.1121.00012,2,2830228,2842576,-,12348
362,BUMA.1121.00011,2,748961,759140,+,10179
362,BUMA.1121.00009,2,789701,799859,+,10158
362,BUMA.1121.00039,2,1828746,1838932,-,10186
362,BUMA.1121.00029,2,2440676,2450854,-,10178
362,BUMA.1121.00021,2,2649708,2659889,+,10181
362,BUMA.1121.00107,2,1675287,1685465,-,10178
362,BUMA.1121.00023,2,2266902,2277083,+,10181
362,BUMA.1121.00067,2,1849607,1859785,-,10178
362,BUMA.1121.00035,2,2462127,2472305,-,10178
362,BUMA.1121.00005,2,1784007,1794188,-,10181
362,BUMA.1121.00100,2,149642,159808,+,10166
362,BUMA.1121.00016,2,1573335,1583516,-,10181
362,BUMA.1121.00099,2,2373492,2383670,+,10178
362,BUMA.1121.00094,2,2169790,2179972,+,10182
362,BUMA.1121.00093,2,801657,811839,-,10182
362,BUMA.1121.00097,2,1966354,1976526,+,10172
362,BUMA.1121.00109,2,2532336,2542513,-,10177
362,BUMA.1121.00018,2,1668975,1679156,-,10181
362,BUMA.1121.00110,2,2034771,2044952,+,10181
362,BUMA.1121.00079,2,2128020,2138198,+,10178
362,BUMA.1121.00075,2,689521,699699,-,10178
362,BUMA.1121.00066,2,2100506,2110686,+,10180
362,BUMA.1121.00089,2,2115542,2125717,+,10175
362,BUMA.1121.00057,2,3100565,3110742,-,10177
362,BUMA.1121.00090,2,3128358,3138536,+,10178
362,BUMA.1121.00027,2,3178238,3188416,+,10178
362,BUMA.1121.00062,2,2768937,2779117,-,10180
362,BUMA.1121.00091,2,1497621,1507797,-,10176
362,BUMA.1121.00098,2,2389133,2399313,+,10180
362,BUMA.1121.00092,2,2132900,2143082,+,10182
362,BUMA.1121.00031,2,1313379,1323560,+,10181
362,BUMA.1121.00096,2,2392722,2402904,+,10182
362,BUMA.1121.00073,2,2116770,2126950,+,10180
362,BUMA.1121.00103,2,709265,719445,+,10180
362,BUMA.1121.00084,2,844114,854275,+,10161
362,BUMA.1121.00014,2,2247976,2258162,+,10186
362,BUMA.1121.00111,2,1460869,1471050,+,10181
362,BUMA.1121.00007,2,2199330,2209501,+,10171
362,BUMA.1121.00072,2,2091433,2101613,+,10180
362,BUMA.1121.00071,2,2116749,2126929,+,10180
362,BUMA.1121.00077,2,1571199,1581380,-,10181
362,BUMA.1121.00003,2,361676,371838,+,10162
362,BUMA.1121.00104,2,2221569,2231729,+,10160
362,BUMA.1121.00074,2,2233450,2243628,-,10178
362,BUMA.1121.00060,2,225911,236072,-,10161
362,BUMA.1121.00088,2,2140416,2150589,+,10173
362,BUMA.1121.00053,2,2415861,2426042,+,10181
362,BUMA.1121.00025,2,653820,664001,+,10181
362,BUMA.1121.00070,2,2096208,2106388,+,10180
362,BUMA.1121.00049,2,788447,798627,+,10180
362,BUMA.1121.00078,2,1009415,1019598,-,10183
362,BUMA.1121.00069,2,2083285,2093465,+,10180
362,BUMA.1121.00102,2,2175486,2185643,+,10157
362,BUMA.1121.00112,2,2238063,2248239,-,10176
362,BUMA.1121.00041,2,3086467,3096645,+,10178
362,BUMA.1121.00068,2,709554,719736,+,10182
362,BUMA.1121.00076,2,3082758,3092936,+,10178
362,BUMA.1121.00033,2,2916489,2926670,+,10181
362,BUMA.1121.00101,2,1281828,1292007,-,10179
362,BUMA.1121.00105,2,291508,301691,-,10183
362,BUMA.1121.00061,2,2100311,2110487,+,10176
362,BUMA.1121.00063,2,2109947,2120123,+,10176
362,BUMA.1121.00059,2,1459347,1469528,-,10181
362,BUMA.1121.00058,2,2739643,2749822,+,10179
362,BUMA.1121.00043,2,164447,174625,-,10178
362,BUMA.1121.00055,2,535282,545459,-,10177
362,BUMA.1121.00065,2,2165100,2175278,+,10178
362,BUMA.1121.00064,2,2036512,2046690,+,10178
362,BUMA.1121.00047,2,3061476,3071652,+,10176
362,BUMA.1121.00037,2,2482814,2493000,+,10186
362,BUMA.1121.00106,2,1410673,1420854,+,10181
362,BUMA.1121.00051,2,2129108,2139282,+,10174
362,BUMA.1121.00045,2,2013856,2024017,+,10161
362,BUMA.1121.00056,2,1869145,1879320,-,10175
362,BUMA.1121.00095,2,955003,965160,+,10157
362,BUMA.1121.00082,2,2162779,2172959,+,10180
362,BUMA.1121.00001,2,62295,72473,-,10178
362,BUMA.1121.00108,2,2352574,2362758,+,10184
362,BUMA.1121.00083,2,786693,796873,+,10180
362,BUMA.1121.00080,2,2129675,2139850,+,10175
362,BUMA.1121.00012,2,2819585,2829763,-,10178
363,BUMA.1121.00011,2,760418,785557,+,25139
363,BUMA.1121.00009,2,801156,826279,+,25123
363,BUMA.1121.00039,2,1802316,1827467,-,25151
363,BUMA.1121.00029,2,2414244,2439397,-,25153
363,BUMA.1121.00021,2,2661167,2686377,+,25210
363,BUMA.1121.00107,2,1648861,1674008,-,25147
363,BUMA.1121.00023,2,2278361,2303486,+,25125
363,BUMA.1121.00067,2,1823171,1848328,-,25157
363,BUMA.1121.00035,2,2435674,2460848,-,25174
363,BUMA.1121.00005,2,1757597,1782728,-,25131
363,BUMA.1121.00100,2,161086,186220,+,25134
363,BUMA.1121.00016,2,1546893,1572056,-,25163
363,BUMA.1121.00099,2,2384952,2410054,+,25102
363,BUMA.1121.00094,2,2181250,2206386,+,25136
363,BUMA.1121.00093,2,775251,800378,-,25127
363,BUMA.1121.00097,2,1977808,2002885,+,25077
363,BUMA.1121.00109,2,2505873,2531057,-,25184
363,BUMA.1121.00018,2,1642533,1667696,-,25163
363,BUMA.1121.00110,2,2046230,2071324,+,25094
363,BUMA.1121.00079,2,2139475,2164611,+,25136
363,BUMA.1121.00075,2,663030,688242,-,25212
363,BUMA.1121.00066,2,2111964,2137084,+,25120
363,BUMA.1121.00089,2,2126995,2152146,+,25151
363,BUMA.1121.00057,2,3074113,3099276,-,25163
363,BUMA.1121.00090,2,3139814,3164947,+,25133
363,BUMA.1121.00027,2,884,26040,+,25156
363,BUMA.1121.00062,2,2742522,2767658,-,25136
363,BUMA.1121.00091,2,1471221,1496342,-,25121
363,BUMA.1121.00098,2,2400591,2425634,+,25043
363,BUMA.1121.00092,2,2144360,2169489,+,25129
363,BUMA.1121.00031,2,1324838,1350004,+,25166
363,BUMA.1121.00096,2,2404182,2429324,+,25142
363,BUMA.1121.00073,2,2128228,2153329,+,25101
363,BUMA.1121.00103,2,720723,745817,+,25094
363,BUMA.1121.00084,2,855553,880731,+,25178
363,BUMA.1121.00014,2,2259440,2284636,+,25196
363,BUMA.1121.00111,2,1472328,1497555,+,25227
363,BUMA.1121.00007,2,2210779,2235849,+,25070
363,BUMA.1121.00072,2,2102891,2127989,+,25098
363,BUMA.1121.00071,2,2128207,2153325,+,25118
363,BUMA.1121.00077,2,1544817,1569920,-,25103
363,BUMA.1121.00003,2,373135,398232,+,25097
363,BUMA.1121.00104,2,2233007,2258108,+,25101
363,BUMA.1121.00074,2,2207007,2232171,-,25164
363,BUMA.1121.00060,2,199445,224613,-,25168
363,BUMA.1121.00088,2,2151867,2177013,+,25146
363,BUMA.1121.00053,2,2427320,2452440,+,25120
363,BUMA.1121.00025,2,665279,690443,+,25164
363,BUMA.1121.00070,2,2107666,2132767,+,25101
363,BUMA.1121.00049,2,799905,825022,+,25117
363,BUMA.1121.00078,2,983026,1008136,-,25110
363,BUMA.1121.00069,2,2094743,2119863,+,25120
363,BUMA.1121.00102,2,2186940,2212132,+,25192
363,BUMA.1121.00112,2,2211608,2236784,-,25176
363,BUMA.1121.00041,2,3097923,3123090,+,25167
363,BUMA.1121.00068,2,721014,746128,+,25114
363,BUMA.1121.00076,2,3094214,3119429,+,25215
363,BUMA.1121.00033,2,2927948,2953076,+,25128
363,BUMA.1121.00101,2,1255450,1280549,-,25099
363,BUMA.1121.00105,2,265142,290229,-,25087
363,BUMA.1121.00061,2,2111769,2136880,+,25111
363,BUMA.1121.00063,2,2121405,2146525,+,25120
363,BUMA.1121.00059,2,1432956,1458068,-,25112
363,BUMA.1121.00058,2,2751100,2776244,+,25144
363,BUMA.1121.00043,2,137969,163168,-,25199
363,BUMA.1121.00055,2,508869,534003,-,25134
363,BUMA.1121.00065,2,2176556,2201725,+,25169
363,BUMA.1121.00064,2,2047968,2073076,+,25108
363,BUMA.1121.00047,2,3072930,3098090,+,25160
363,BUMA.1121.00037,2,2494278,2519471,+,25193
363,BUMA.1121.00106,2,1422132,1447245,+,25113
363,BUMA.1121.00051,2,2140559,2165701,+,25142
363,BUMA.1121.00045,2,2025314,2050483,+,25169
363,BUMA.1121.00056,2,1842716,1867866,-,25150
363,BUMA.1121.00095,2,966457,991578,+,25121
363,BUMA.1121.00082,2,2174237,2199357,+,25120
363,BUMA.1121.00001,2,35849,61016,-,25167
363,BUMA.1121.00108,2,2364036,2389210,+,25174
363,BUMA.1121.00083,2,798151,823273,+,25122
363,BUMA.1121.00080,2,2141128,2166287,+,25159
363,BUMA.1121.00012,2,2793157,2818306,-,25149
364,BUMA.1121.00011,2,788832,800483,+,11651
364,BUMA.1121.00009,2,829526,841147,+,11621
364,BUMA.1121.00039,2,1787321,1799041,-,11720
364,BUMA.1121.00029,2,2399375,2410969,-,11594
364,BUMA.1121.00021,2,2689652,2701162,+,11510
364,BUMA.1121.00107,2,1633984,1645587,-,11603
364,BUMA.1121.00023,2,2306761,2318418,+,11657
364,BUMA.1121.00067,2,1808362,1819896,-,11534
364,BUMA.1121.00035,2,2420832,2432399,-,11567
364,BUMA.1121.00005,2,1742808,1754322,-,11514
364,BUMA.1121.00100,2,189495,201064,+,11569
364,BUMA.1121.00016,2,1532006,1543618,-,11612
364,BUMA.1121.00099,2,2413335,2425028,+,11693
364,BUMA.1121.00094,2,2209661,2221213,+,11552
364,BUMA.1121.00093,2,760444,771978,-,11534
364,BUMA.1121.00097,2,2006160,2017803,+,11643
364,BUMA.1121.00109,2,2490932,2502598,-,11666
364,BUMA.1121.00018,2,1627700,1639258,-,11558
364,BUMA.1121.00110,2,2074599,2086151,+,11552
364,BUMA.1121.00079,2,2167886,2179476,+,11590
364,BUMA.1121.00075,2,648198,659797,-,11599
364,BUMA.1121.00066,2,2140359,2151932,+,11573
364,BUMA.1121.00089,2,2155421,2166973,+,11552
364,BUMA.1121.00057,2,3059255,3070838,-,11583
364,BUMA.1121.00090,2,3168222,3179807,+,11585
364,BUMA.1121.00027,2,29315,40890,+,11575
364,BUMA.1121.00062,2,2727689,2739247,-,11558
364,BUMA.1121.00091,2,1456387,1467946,-,11559
364,BUMA.1121.00098,2,2428909,2440482,+,11573
364,BUMA.1121.00092,2,2172764,2184298,+,11534
364,BUMA.1121.00031,2,1353279,1364873,+,11594
364,BUMA.1121.00096,2,2432610,2444220,+,11610
364,BUMA.1121.00073,2,2156604,2168214,+,11610
364,BUMA.1121.00103,2,749095,760596,+,11501
364,BUMA.1121.00084,2,884006,895585,+,11579
364,BUMA.1121.00014,2,2287911,2299442,+,11531
364,BUMA.1121.00111,2,1500830,1512451,+,11621
364,BUMA.1121.00007,2,2239124,2250743,+,11619
364,BUMA.1121.00072,2,2131264,2142755,+,11491
364,BUMA.1121.00071,2,2156600,2168084,+,11484
364,BUMA.1121.00077,2,1529930,1541540,-,11610
364,BUMA.1121.00003,2,401507,413055,+,11548
364,BUMA.1121.00104,2,2261341,2272878,+,11537
364,BUMA.1121.00074,2,2192186,2203732,-,11546
364,BUMA.1121.00060,2,184477,196170,-,11693
364,BUMA.1121.00088,2,2180246,2191957,+,11711
364,BUMA.1121.00053,2,2455715,2467258,+,11543
364,BUMA.1121.00025,2,693718,705276,+,11558
364,BUMA.1121.00070,2,2136042,2147580,+,11538
364,BUMA.1121.00049,2,828255,839792,+,11537
364,BUMA.1121.00078,2,968162,979750,-,11588
364,BUMA.1121.00069,2,2123138,2134739,+,11601
364,BUMA.1121.00102,2,2215407,2226972,+,11565
364,BUMA.1121.00112,2,2196820,2208333,-,11513
364,BUMA.1121.00041,2,3126362,3137866,+,11504
364,BUMA.1121.00068,2,749403,760934,+,11531
364,BUMA.1121.00076,2,3122662,3134260,+,11598
364,BUMA.1121.00033,2,2956351,2968095,+,11744
364,BUMA.1121.00101,2,1240617,1252175,-,11558
364,BUMA.1121.00105,2,250330,261861,-,11531
364,BUMA.1121.00061,2,2140155,2151631,+,11476
364,BUMA.1121.00063,2,2149800,2161358,+,11558
364,BUMA.1121.00059,2,1418096,1429723,-,11627
364,BUMA.1121.00058,2,2779477,2790984,+,11507
364,BUMA.1121.00043,2,123038,134694,-,11656
364,BUMA.1121.00055,2,494069,505594,-,11525
364,BUMA.1121.00065,2,2205000,2216714,+,11714
364,BUMA.1121.00064,2,2076351,2087894,+,11543
364,BUMA.1121.00047,2,3101365,3113007,+,11642
364,BUMA.1121.00037,2,2522746,2534385,+,11639
364,BUMA.1121.00106,2,1450478,1461997,+,11519
364,BUMA.1121.00051,2,2168976,2180560,+,11584
364,BUMA.1121.00045,2,2053769,2065451,+,11682
364,BUMA.1121.00056,2,1827889,1839441,-,11552
364,BUMA.1121.00095,2,994853,1006432,+,11579
364,BUMA.1121.00082,2,2202632,2214242,+,11610
364,BUMA.1121.00001,2,20989,32574,-,11585
364,BUMA.1121.00108,2,2392485,2404007,+,11522
364,BUMA.1121.00083,2,826548,838158,+,11610
364,BUMA.1121.00080,2,2169562,2181179,+,11617
364,BUMA.1121.00012,2,2778216,2789882,-,11666
365,BUMA.1121.00011,2,834771,857731,+,22960
365,BUMA.1121.00009,2,875390,898353,+,22963
365,BUMA.1121.00039,2,1730063,1753023,-,22960
365,BUMA.1121.00029,2,2342062,2365023,-,22961
365,BUMA.1121.00021,2,2708711,2731643,+,22932
365,BUMA.1121.00107,2,1563272,1586178,-,22906
365,BUMA.1121.00023,2,2352785,2375716,+,22931
365,BUMA.1121.00067,2,1750974,1773938,-,22964
365,BUMA.1121.00035,2,2363519,2386480,-,22961
365,BUMA.1121.00005,2,1685574,1708523,-,22949
365,BUMA.1121.00100,2,235407,258352,+,22945
365,BUMA.1121.00016,2,1474736,1497699,-,22963
365,BUMA.1121.00099,2,2459314,2482299,+,22985
365,BUMA.1121.00094,2,2255616,2278558,+,22942
365,BUMA.1121.00093,2,696543,719497,-,22954
365,BUMA.1121.00097,2,2052047,2074993,+,22946
365,BUMA.1121.00109,2,2433724,2456703,-,22979
365,BUMA.1121.00018,2,1570402,1593349,-,22947
365,BUMA.1121.00110,2,2120353,2143310,+,22957
365,BUMA.1121.00079,2,2213819,2236771,+,22952
365,BUMA.1121.00075,2,614274,637268,-,22994
365,BUMA.1121.00066,2,2186123,2209064,+,22941
365,BUMA.1121.00089,2,2201376,2224318,+,22942
365,BUMA.1121.00057,2,3001967,3024909,-,22942
365,BUMA.1121.00090,2,3214171,3237116,+,22945
365,BUMA.1121.00027,2,75234,98172,+,22938
365,BUMA.1121.00062,2,2670457,2693394,-,22937
365,BUMA.1121.00091,2,1399154,1422111,-,22957
365,BUMA.1121.00098,2,2474705,2497664,+,22959
365,BUMA.1121.00092,2,2218479,2241417,+,22938
365,BUMA.1121.00031,2,1399211,1422143,+,22932
365,BUMA.1121.00096,2,2471972,2494933,+,22961
365,BUMA.1121.00073,2,2202486,2225428,+,22942
365,BUMA.1121.00103,2,804813,827758,+,22945
365,BUMA.1121.00084,2,929919,952862,+,22943
365,BUMA.1121.00014,2,2333784,2356717,+,22933
365,BUMA.1121.00111,2,1546749,1569482,+,22733
365,BUMA.1121.00007,2,2284915,2307876,+,22961
365,BUMA.1121.00072,2,2176993,2199935,+,22942
365,BUMA.1121.00071,2,2202281,2225222,+,22941
365,BUMA.1121.00077,2,1472756,1495729,-,22973
365,BUMA.1121.00003,2,423892,446837,+,22945
365,BUMA.1121.00104,2,2307233,2330179,+,22946
365,BUMA.1121.00074,2,2134841,2157774,-,22933
365,BUMA.1121.00060,2,133995,156973,-,22978
365,BUMA.1121.00088,2,2226291,2249257,+,22966
365,BUMA.1121.00053,2,2501476,2524421,+,22945
365,BUMA.1121.00025,2,739628,762559,+,22931
365,BUMA.1121.00070,2,2181855,2204797,+,22942
365,BUMA.1121.00049,2,860663,883609,+,22946
365,BUMA.1121.00078,2,910914,933887,-,22973
365,BUMA.1121.00069,2,2168999,2191941,+,22942
365,BUMA.1121.00102,2,2244445,2267377,+,22932
365,BUMA.1121.00112,2,2132930,2155774,-,22844
365,BUMA.1121.00041,2,3172215,3195175,+,22960
365,BUMA.1121.00068,2,795306,818263,+,22957
365,BUMA.1121.00076,2,3168612,3191591,+,22979
365,BUMA.1121.00033,2,3002496,3025283,+,22787
365,BUMA.1121.00101,2,1183397,1206345,-,22948
365,BUMA.1121.00105,2,196305,219239,-,22934
365,BUMA.1121.00061,2,2185601,2208543,+,22942
365,BUMA.1121.00063,2,2195481,2218423,+,22942
365,BUMA.1121.00059,2,1360610,1383543,-,22933
365,BUMA.1121.00058,2,2825352,2848282,+,22930
365,BUMA.1121.00043,2,65688,88635,-,22947
365,BUMA.1121.00055,2,436797,459747,-,22950
365,BUMA.1121.00065,2,2250976,2273922,+,22946
365,BUMA.1121.00064,2,2122342,2145275,+,22933
365,BUMA.1121.00047,2,27793,50745,+,22952
365,BUMA.1121.00037,2,2568728,2591659,+,22931
365,BUMA.1121.00106,2,1496352,1519298,+,22946
365,BUMA.1121.00051,2,2214939,2237891,+,22952
365,BUMA.1121.00045,2,2099751,2122729,+,22978
365,BUMA.1121.00056,2,1767306,1790264,-,22958
365,BUMA.1121.00095,2,1040668,1063640,+,22972
365,BUMA.1121.00082,2,2248642,2271584,+,22942
365,BUMA.1121.00001,2,3167320,3190235,-,22915
365,BUMA.1121.00108,2,2438349,2461311,+,22962
365,BUMA.1121.00083,2,872558,895500,+,22942
365,BUMA.1121.00080,2,2212243,2235195,+,22952
365,BUMA.1121.00012,2,2720888,2743837,-,22949
366,BUMA.1121.00011,2,859234,867546,+,8312
366,BUMA.1121.00009,2,899876,908182,+,8306
366,BUMA.1121.00039,2,1720586,1728561,-,7975
366,BUMA.1121.00029,2,2332621,2340560,-,7939
366,BUMA.1121.00021,2,2733161,2741124,+,7963
366,BUMA.1121.00107,2,1553398,1561723,-,8325
366,BUMA.1121.00023,2,2377234,2385185,+,7951
366,BUMA.1121.00067,2,1741490,1749472,-,7982
366,BUMA.1121.00035,2,2354090,2362017,-,7927
366,BUMA.1121.00005,2,1676099,1684071,-,7972
366,BUMA.1121.00100,2,259871,267845,+,7974
366,BUMA.1121.00016,2,1465258,1473233,-,7975
366,BUMA.1121.00099,2,2483818,2492160,+,8342
366,BUMA.1121.00094,2,2280076,2287971,+,7895
366,BUMA.1121.00093,2,687052,695040,-,7988
366,BUMA.1121.00097,2,2076512,2084836,+,8324
366,BUMA.1121.00109,2,2424245,2432221,-,7976
366,BUMA.1121.00018,2,1560907,1568900,-,7993
366,BUMA.1121.00110,2,2144828,2152792,+,7964
366,BUMA.1121.00079,2,2238289,2246242,+,7953
366,BUMA.1121.00075,2,604808,612772,-,7964
366,BUMA.1121.00066,2,2210567,2218536,+,7969
366,BUMA.1121.00089,2,2225836,2233731,+,7895
366,BUMA.1121.00057,2,2992497,3000464,-,7967
366,BUMA.1121.00090,2,3238634,3246615,+,7981
366,BUMA.1121.00027,2,99675,107660,+,7985
366,BUMA.1121.00062,2,2660985,2668954,-,7969
366,BUMA.1121.00091,2,1389699,1397651,-,7952
366,BUMA.1121.00098,2,2499168,2507484,+,8316
366,BUMA.1121.00092,2,2242936,2250924,+,7988
366,BUMA.1121.00031,2,1423662,1431637,+,7975
366,BUMA.1121.00096,2,2496452,2504759,+,8307
366,BUMA.1121.00073,2,2226931,2234900,+,7969
366,BUMA.1121.00103,2,829260,837584,+,8324
366,BUMA.1121.00084,2,954380,962355,+,7975
366,BUMA.1121.00014,2,2358236,2366211,+,7975
366,BUMA.1121.00111,2,1571001,1578970,+,7969
366,BUMA.1121.00007,2,2309395,2317371,+,7976
366,BUMA.1121.00072,2,2201438,2209407,+,7969
366,BUMA.1121.00071,2,2226725,2234694,+,7969
366,BUMA.1121.00077,2,1463290,1471254,-,7964
366,BUMA.1121.00003,2,448340,456638,+,8298
366,BUMA.1121.00104,2,2331697,2339656,+,7959
366,BUMA.1121.00074,2,2125359,2133339,-,7980
366,BUMA.1121.00060,2,124165,132492,-,8327
366,BUMA.1121.00088,2,2250775,2258757,+,7982
366,BUMA.1121.00053,2,2525924,2533894,+,7970
366,BUMA.1121.00025,2,764077,772064,+,7987
366,BUMA.1121.00070,2,2206300,2214269,+,7969
366,BUMA.1121.00049,2,885127,893086,+,7959
366,BUMA.1121.00078,2,901439,909411,-,7972
366,BUMA.1121.00069,2,2193444,2201413,+,7969
366,BUMA.1121.00102,2,2268880,2276873,+,7993
366,BUMA.1121.00112,2,2123447,2131427,-,7980
366,BUMA.1121.00041,2,3196678,3204660,+,7982
366,BUMA.1121.00068,2,819765,828112,+,8347
366,BUMA.1121.00076,2,3193109,3201073,+,7964
366,BUMA.1121.00033,2,3026801,3034794,+,7993
366,BUMA.1121.00101,2,1173588,1181894,-,8306
366,BUMA.1121.00105,2,186823,194803,-,7980
366,BUMA.1121.00061,2,2210046,2218015,+,7969
366,BUMA.1121.00063,2,2219926,2227893,+,7967
366,BUMA.1121.00059,2,1351133,1359108,-,7975
366,BUMA.1121.00058,2,2849800,2857787,+,7987
366,BUMA.1121.00043,2,56198,64185,-,7987
366,BUMA.1121.00055,2,427342,435295,-,7953
366,BUMA.1121.00065,2,2275440,2283410,+,7970
366,BUMA.1121.00064,2,2146777,2154740,+,7963
366,BUMA.1121.00047,2,52263,60158,+,7895
366,BUMA.1121.00037,2,2593177,2601152,+,7975
366,BUMA.1121.00106,2,1520816,1528772,+,7956
366,BUMA.1121.00051,2,2239409,2247304,+,7895
366,BUMA.1121.00045,2,2124232,2132559,+,8327
366,BUMA.1121.00056,2,1757909,1765804,-,7895
366,BUMA.1121.00095,2,1065143,1073468,+,8325
366,BUMA.1121.00082,2,2273087,2281056,+,7969
366,BUMA.1121.00001,2,3157885,3165818,-,7933
366,BUMA.1121.00108,2,2462830,2471182,+,8352
366,BUMA.1121.00083,2,897003,904972,+,7969
366,BUMA.1121.00080,2,2236713,2244608,+,7895
366,BUMA.1121.00012,2,2711410,2719385,-,7975
367,BUMA.1121.00011,2,868977,875132,+,6155
367,BUMA.1121.00009,2,909613,915768,+,6155
367,BUMA.1121.00039,2,1713137,1719293,-,6156
367,BUMA.1121.00029,2,2268860,2274977,-,6117
367,BUMA.1121.00021,2,2743752,2749908,+,6156
367,BUMA.1121.00107,2,1545811,1551967,-,6156
367,BUMA.1121.00023,2,2386478,2392634,+,6156
367,BUMA.1121.00067,2,1675726,1681881,-,6155
367,BUMA.1121.00035,2,2346641,2352797,-,6156
367,BUMA.1121.00005,2,1668652,1674806,-,6154
367,BUMA.1121.00100,2,269138,275294,+,6156
367,BUMA.1121.00016,2,1457809,1463965,-,6156
367,BUMA.1121.00099,2,2493591,2499746,+,6155
367,BUMA.1121.00094,2,2289264,2295419,+,6155
367,BUMA.1121.00093,2,679596,685751,-,6155
367,BUMA.1121.00097,2,2086267,2092422,+,6155
367,BUMA.1121.00109,2,2376451,2382572,-,6121
367,BUMA.1121.00018,2,1552542,1558698,-,6156
367,BUMA.1121.00110,2,2213415,2219571,+,6156
367,BUMA.1121.00079,2,2247535,2253690,+,6155
367,BUMA.1121.00075,2,597360,603515,-,6155
367,BUMA.1121.00066,2,2219829,2225985,+,6156
367,BUMA.1121.00089,2,2235024,2241179,+,6155
367,BUMA.1121.00057,2,2985048,2991204,-,6156
367,BUMA.1121.00090,2,3247908,3254064,+,6156
367,BUMA.1121.00027,2,167704,173860,+,6156
367,BUMA.1121.00062,2,2653537,2659692,-,6155
367,BUMA.1121.00091,2,1382242,1388406,-,6164
367,BUMA.1121.00098,2,2508915,2515069,+,6154
367,BUMA.1121.00092,2,2252225,2258380,+,6155
367,BUMA.1121.00031,2,1432938,1439094,+,6156
367,BUMA.1121.00096,2,2566021,2572176,+,6155
367,BUMA.1121.00073,2,2236193,2242349,+,6156
367,BUMA.1121.00103,2,839015,845171,+,6156
367,BUMA.1121.00084,2,963648,969803,+,6155
367,BUMA.1121.00014,2,2367512,2373668,+,6156
367,BUMA.1121.00111,2,1580271,1586418,+,6147
367,BUMA.1121.00007,2,2318672,2324827,+,6155
367,BUMA.1121.00072,2,2210700,2216856,+,6156
367,BUMA.1121.00071,2,2235987,2242143,+,6156
367,BUMA.1121.00077,2,1396510,1402666,-,6156
367,BUMA.1121.00003,2,497346,503510,+,6164
367,BUMA.1121.00104,2,2340949,2347104,+,6155
367,BUMA.1121.00074,2,2117911,2124066,-,6155
367,BUMA.1121.00060,2,116580,122734,-,6154
367,BUMA.1121.00088,2,2260050,2266205,+,6155
367,BUMA.1121.00053,2,2535187,2541343,+,6156
367,BUMA.1121.00025,2,774273,780429,+,6156
367,BUMA.1121.00070,2,2215562,2221718,+,6156
367,BUMA.1121.00049,2,894379,900534,+,6155
367,BUMA.1121.00078,2,893969,900146,-,6177
367,BUMA.1121.00069,2,2202706,2208862,+,6156
367,BUMA.1121.00102,2,2278166,2284322,+,6156
367,BUMA.1121.00112,2,2115999,2122154,-,6155
367,BUMA.1121.00041,2,3205953,3212109,+,6156
367,BUMA.1121.00068,2,829543,835699,+,6156
367,BUMA.1121.00076,2,3202366,3208521,+,6155
367,BUMA.1121.00033,2,3036087,3042243,+,6156
367,BUMA.1121.00101,2,1166002,1172157,-,6155
367,BUMA.1121.00105,2,179374,185530,-,6156
367,BUMA.1121.00061,2,2219308,2225464,+,6156
367,BUMA.1121.00063,2,2229186,2235342,+,6156
367,BUMA.1121.00059,2,1343685,1349840,-,6155
367,BUMA.1121.00058,2,2859080,2865243,+,6163
367,BUMA.1121.00043,2,48749,54905,-,6156
367,BUMA.1121.00055,2,419893,426049,-,6156
367,BUMA.1121.00065,2,2323406,2329562,+,6156
367,BUMA.1121.00064,2,2156033,2162188,+,6155
367,BUMA.1121.00047,2,61451,67606,+,6155
367,BUMA.1121.00037,2,2602445,2608601,+,6156
367,BUMA.1121.00106,2,1530065,1536220,+,6155
367,BUMA.1121.00051,2,2248597,2254752,+,6155
367,BUMA.1121.00045,2,2133990,2140144,+,6154
367,BUMA.1121.00056,2,1750461,1756616,-,6155
367,BUMA.1121.00095,2,1113812,1119967,+,6155
367,BUMA.1121.00082,2,2282349,2288505,+,6156
367,BUMA.1121.00001,2,3150436,3156592,-,6156
367,BUMA.1121.00108,2,2472613,2478768,+,6155
367,BUMA.1121.00083,2,906265,912421,+,6156
367,BUMA.1121.00080,2,2304826,2310981,+,6155
367,BUMA.1121.00012,2,2703954,2710109,-,6155
368,BUMA.1121.00011,2,875146,880687,+,5541
368,BUMA.1121.00009,2,915792,921352,+,5560
368,BUMA.1121.00039,2,1707490,1713123,-,5633
368,BUMA.1121.00029,2,2263191,2268846,-,5655
368,BUMA.1121.00021,2,2749922,2755521,+,5599
368,BUMA.1121.00107,2,1540162,1545797,-,5635
368,BUMA.1121.00023,2,2392648,2398231,+,5583
368,BUMA.1121.00067,2,1670167,1675712,-,5545
368,BUMA.1121.00035,2,2341014,2346627,-,5613
368,BUMA.1121.00005,2,1663086,1668638,-,5552
368,BUMA.1121.00100,2,275308,280928,+,5620
368,BUMA.1121.00016,2,1452154,1457795,-,5641
368,BUMA.1121.00099,2,2499760,2505316,+,5556
368,BUMA.1121.00094,2,2295433,2301065,+,5632
368,BUMA.1121.00093,2,673992,679582,-,5590
368,BUMA.1121.00097,2,2092437,2098050,+,5613
368,BUMA.1121.00109,2,2370810,2376437,-,5627
368,BUMA.1121.00018,2,1546970,1552528,-,5558
368,BUMA.1121.00110,2,2219585,2225135,+,5550
368,BUMA.1121.00079,2,2253704,2259231,+,5527
368,BUMA.1121.00075,2,591797,597346,-,5549
368,BUMA.1121.00066,2,2225999,2231537,+,5538
368,BUMA.1121.00089,2,2241193,2246867,+,5674
368,BUMA.1121.00057,2,2979506,2985034,-,5528
368,BUMA.1121.00090,2,3254078,3259682,+,5604
368,BUMA.1121.00027,2,173874,179443,+,5569
368,BUMA.1121.00062,2,2647939,2653505,-,5566
368,BUMA.1121.00091,2,1376670,1382228,-,5558
368,BUMA.1121.00098,2,2515083,2520695,+,5612
368,BUMA.1121.00092,2,2258394,2263984,+,5590
368,BUMA.1121.00031,2,1439108,1444707,+,5599
368,BUMA.1121.00096,2,2572190,2577765,+,5575
368,BUMA.1121.00073,2,2242373,2247911,+,5538
368,BUMA.1121.00103,2,845203,850783,+,5580
368,BUMA.1121.00084,2,969835,975358,+,5523
368,BUMA.1121.00014,2,2373682,2379323,+,5641
368,BUMA.1121.00111,2,1586432,1592010,+,5578
368,BUMA.1121.00007,2,2324841,2330414,+,5573
368,BUMA.1121.00072,2,2216870,2222418,+,5548
368,BUMA.1121.00071,2,2242157,2247692,+,5535
368,BUMA.1121.00077,2,1390945,1396496,-,5551
368,BUMA.1121.00003,2,503524,509136,+,5612
368,BUMA.1121.00104,2,2347136,2352724,+,5588
368,BUMA.1121.00074,2,2112306,2117879,-,5573
368,BUMA.1121.00060,2,111031,116566,-,5535
368,BUMA.1121.00088,2,2266219,2271788,+,5569
368,BUMA.1121.00053,2,2541357,2547021,+,5664
368,BUMA.1121.00025,2,780443,786000,+,5557
368,BUMA.1121.00070,2,2221742,2227280,+,5538
368,BUMA.1121.00049,2,900548,906075,+,5527
368,BUMA.1121.00078,2,888362,893955,-,5593
368,BUMA.1121.00069,2,2208886,2214424,+,5538
368,BUMA.1121.00102,2,2284336,2289948,+,5612
368,BUMA.1121.00112,2,2110415,2115967,-,5552
368,BUMA.1121.00041,2,3212141,3217694,+,5553
368,BUMA.1121.00068,2,835713,841276,+,5563
368,BUMA.1121.00076,2,2,5550,+,5548
368,BUMA.1121.00033,2,3042257,3047856,+,5599
368,BUMA.1121.00101,2,1160424,1165970,-,5546
368,BUMA.1121.00105,2,173825,179360,-,5535
368,BUMA.1121.00061,2,2225478,2231012,+,5534
368,BUMA.1121.00063,2,2235356,2240904,+,5548
368,BUMA.1121.00059,2,1338164,1343653,-,5489
368,BUMA.1121.00058,2,2865267,2870820,+,5553
368,BUMA.1121.00043,2,43095,48735,-,5640
368,BUMA.1121.00055,2,414306,419879,-,5573
368,BUMA.1121.00065,2,2329576,2335140,+,5564
368,BUMA.1121.00064,2,2162220,2167785,+,5565
368,BUMA.1121.00047,2,67620,73231,+,5611
368,BUMA.1121.00037,2,2608615,2614261,+,5646
368,BUMA.1121.00106,2,1536234,1541775,+,5541
368,BUMA.1121.00051,2,2254766,2260405,+,5639
368,BUMA.1121.00045,2,2140158,2145692,+,5534
368,BUMA.1121.00056,2,1744773,1750447,-,5674
368,BUMA.1121.00095,2,1119999,1125529,+,5530
368,BUMA.1121.00082,2,2288519,2294067,+,5548
368,BUMA.1121.00001,2,3144802,3150422,-,5620
368,BUMA.1121.00108,2,2478788,2484331,+,5543
368,BUMA.1121.00083,2,912435,917983,+,5548
368,BUMA.1121.00080,2,2310995,2316613,+,5618
368,BUMA.1121.00012,2,2698369,2703940,-,5571
369,BUMA.1121.00011,2,882823,888372,+,5549
369,BUMA.1121.00009,2,923524,929069,+,5545
369,BUMA.1121.00039,2,1699600,1705145,-,5545
369,BUMA.1121.00029,2,2255406,2260951,-,5545
369,BUMA.1121.00021,2,2757798,2763343,+,5545
369,BUMA.1121.00107,2,1532418,1537963,-,5545
369,BUMA.1121.00023,2,2401826,2407348,+,5522
369,BUMA.1121.00067,2,1659803,1665232,-,5429
369,BUMA.1121.00035,2,2333139,2338684,-,5545
369,BUMA.1121.00005,2,1655370,1660913,-,5543
369,BUMA.1121.00100,2,283130,288675,+,5545
369,BUMA.1121.00016,2,1444288,1449833,-,5545
369,BUMA.1121.00099,2,2507489,2513034,+,5545
369,BUMA.1121.00094,2,2303274,2308709,+,5435
369,BUMA.1121.00093,2,666237,671788,-,5551
369,BUMA.1121.00097,2,2100268,2105813,+,5545
369,BUMA.1121.00109,2,2362985,2368534,-,5549
369,BUMA.1121.00018,2,1539131,1544676,-,5545
369,BUMA.1121.00110,2,2227430,2232970,+,5540
369,BUMA.1121.00079,2,2261476,2266899,+,5423
369,BUMA.1121.00075,2,584037,589582,-,5545
369,BUMA.1121.00066,2,2233775,2239320,+,5545
369,BUMA.1121.00089,2,2249041,2254476,+,5435
369,BUMA.1121.00057,2,2971698,2977243,-,5545
369,BUMA.1121.00090,2,1751,7272,+,5521
369,BUMA.1121.00027,2,181645,187190,+,5545
369,BUMA.1121.00062,2,2640151,2645702,-,5551
369,BUMA.1121.00091,2,1368999,1374544,-,5545
369,BUMA.1121.00098,2,2522876,2528421,+,5545
369,BUMA.1121.00092,2,2266189,2271740,+,5551
369,BUMA.1121.00031,2,1446975,1452513,+,5538
369,BUMA.1121.00096,2,2579954,2585487,+,5533
369,BUMA.1121.00073,2,2250148,2255693,+,5545
369,BUMA.1121.00103,2,852979,858524,+,5545
369,BUMA.1121.00084,2,979030,984459,+,5429
369,BUMA.1121.00014,2,2381573,2387111,+,5538
369,BUMA.1121.00111,2,1594314,1599854,+,5540
369,BUMA.1121.00007,2,2332592,2338120,+,5528
369,BUMA.1121.00072,2,2224656,2230201,+,5545
369,BUMA.1121.00071,2,2249930,2255475,+,5545
369,BUMA.1121.00077,2,1383111,1388651,-,5540
369,BUMA.1121.00003,2,511365,516910,+,5545
369,BUMA.1121.00104,2,2354941,2360364,+,5423
369,BUMA.1121.00074,2,2104613,2110042,-,5429
369,BUMA.1121.00060,2,103263,108812,-,5549
369,BUMA.1121.00088,2,2274009,2279444,+,5435
369,BUMA.1121.00053,2,2549268,2554813,+,5545
369,BUMA.1121.00025,2,788304,793849,+,5545
369,BUMA.1121.00070,2,2229518,2235063,+,5545
369,BUMA.1121.00049,2,908285,913708,+,5423
369,BUMA.1121.00078,2,880633,886179,-,5546
369,BUMA.1121.00069,2,2216653,2222197,+,5544
369,BUMA.1121.00102,2,2292150,2297695,+,5545
369,BUMA.1121.00112,2,2102605,2108154,-,5549
369,BUMA.1121.00041,2,3219896,3225441,+,5545
369,BUMA.1121.00068,2,843523,849068,+,5545
369,BUMA.1121.00076,2,7758,13303,+,5545
369,BUMA.1121.00033,2,3050129,3055651,+,5522
369,BUMA.1121.00101,2,1152615,1158160,-,5545
369,BUMA.1121.00105,2,164630,170181,-,5551
369,BUMA.1121.00061,2,2233250,2238795,+,5545
369,BUMA.1121.00063,2,2243142,2248687,+,5545
369,BUMA.1121.00059,2,1330497,1335921,-,5424
369,BUMA.1121.00058,2,2873050,2878485,+,5435
369,BUMA.1121.00043,2,35255,40783,-,5528
369,BUMA.1121.00055,2,406563,412108,-,5545
369,BUMA.1121.00065,2,2337507,2343052,+,5545
369,BUMA.1121.00064,2,2170032,2175467,+,5435
369,BUMA.1121.00047,2,76762,82197,+,5435
369,BUMA.1121.00037,2,2616511,2622033,+,5522
369,BUMA.1121.00106,2,1543994,1549539,+,5545
369,BUMA.1121.00051,2,2262587,2268022,+,5435
369,BUMA.1121.00045,2,2147903,2153452,+,5549
369,BUMA.1121.00056,2,1737164,1742599,-,5435
369,BUMA.1121.00095,2,1127830,1133379,+,5549
369,BUMA.1121.00082,2,2296305,2301850,+,5545
369,BUMA.1121.00001,2,3136882,3142427,-,5545
369,BUMA.1121.00108,2,2486494,2492039,+,5545
369,BUMA.1121.00083,2,920221,925766,+,5545
369,BUMA.1121.00080,2,2318796,2324231,+,5435
369,BUMA.1121.00012,2,2690625,2696147,-,5522
370,BUMA.1121.00011,2,888957,895166,+,6209
370,BUMA.1121.00009,2,929895,936131,+,6236
370,BUMA.1121.00039,2,1692807,1698866,-,6059
370,BUMA.1121.00029,2,2248643,2254849,-,6206
370,BUMA.1121.00021,2,2763822,2770025,+,6203
370,BUMA.1121.00107,2,1525788,1531951,-,6163
370,BUMA.1121.00023,2,2407912,2414239,+,6327
370,BUMA.1121.00067,2,1652930,1659037,-,6107
370,BUMA.1121.00035,2,2326298,2332525,-,6227
370,BUMA.1121.00005,2,1648856,1654955,-,6099
370,BUMA.1121.00100,2,289305,295520,+,6215
370,BUMA.1121.00016,2,1437509,1443701,-,6192
370,BUMA.1121.00099,2,2513514,2519698,+,6184
370,BUMA.1121.00094,2,2309295,2315479,+,6184
370,BUMA.1121.00093,2,659350,665494,-,6144
370,BUMA.1121.00097,2,2106396,2112714,+,6318
370,BUMA.1121.00109,2,2356325,2362480,-,6155
370,BUMA.1121.00018,2,1532323,1538608,-,6285
370,BUMA.1121.00110,2,2233610,2239793,+,6183
370,BUMA.1121.00079,2,2267667,2273791,+,6124
370,BUMA.1121.00075,2,577454,583524,-,6070
370,BUMA.1121.00066,2,2239895,2246038,+,6143
370,BUMA.1121.00089,2,2255062,2261248,+,6186
370,BUMA.1121.00057,2,2964879,2971129,-,6250
370,BUMA.1121.00090,2,7755,13922,+,6167
370,BUMA.1121.00027,2,187849,193968,+,6119
370,BUMA.1121.00062,2,2633535,2639648,-,6113
370,BUMA.1121.00091,2,1360736,1366829,-,6093
370,BUMA.1121.00098,2,2528814,2534933,+,6119
370,BUMA.1121.00092,2,2272468,2278662,+,6194
370,BUMA.1121.00031,2,1453143,1459356,+,6213
370,BUMA.1121.00096,2,2586129,2592255,+,6126
370,BUMA.1121.00073,2,2256268,2262408,+,6140
370,BUMA.1121.00103,2,859015,865138,+,6123
370,BUMA.1121.00084,2,984996,991113,+,6117
370,BUMA.1121.00014,2,2387788,2393982,+,6194
370,BUMA.1121.00111,2,1600344,1606513,+,6169
370,BUMA.1121.00007,2,2338597,2344741,+,6144
370,BUMA.1121.00072,2,2230776,2236918,+,6142
370,BUMA.1121.00071,2,2256050,2262193,+,6143
370,BUMA.1121.00077,2,1376146,1382480,-,6334
370,BUMA.1121.00003,2,517476,523510,+,6034
370,BUMA.1121.00104,2,2361318,2367439,+,6121
370,BUMA.1121.00074,2,2097835,2104031,-,6196
370,BUMA.1121.00060,2,96828,102905,-,6077
370,BUMA.1121.00088,2,2280194,2286257,+,6063
370,BUMA.1121.00053,2,2555339,2561610,+,6271
370,BUMA.1121.00025,2,794324,800596,+,6272
370,BUMA.1121.00070,2,2235638,2241781,+,6143
370,BUMA.1121.00049,2,914269,920328,+,6059
370,BUMA.1121.00078,2,874030,880052,-,6022
370,BUMA.1121.00069,2,2222772,2228915,+,6143
370,BUMA.1121.00102,2,2298185,2304546,+,6361
370,BUMA.1121.00112,2,2096134,2102232,-,6098
370,BUMA.1121.00041,2,1246,7397,+,6151
370,BUMA.1121.00068,2,849691,855846,+,6155
370,BUMA.1121.00076,2,13815,20007,+,6192
370,BUMA.1121.00033,2,3056230,3062409,+,6179
370,BUMA.1121.00101,2,1146015,1152138,-,6123
370,BUMA.1121.00105,2,157971,164139,-,6168
370,BUMA.1121.00061,2,2239370,2245504,+,6134
370,BUMA.1121.00063,2,2249262,2255403,+,6141
370,BUMA.1121.00059,2,1323859,1329987,-,6128
370,BUMA.1121.00058,2,2879302,2885397,+,6095
370,BUMA.1121.00043,2,28512,34690,-,6178
370,BUMA.1121.00055,2,399958,406064,-,6106
370,BUMA.1121.00065,2,2343612,2349806,+,6194
370,BUMA.1121.00064,2,2176151,2182399,+,6248
370,BUMA.1121.00047,2,82815,89022,+,6207
370,BUMA.1121.00037,2,2622640,2628919,+,6279
370,BUMA.1121.00106,2,1550268,1556378,+,6110
370,BUMA.1121.00051,2,2268563,2274688,+,6125
370,BUMA.1121.00045,2,2153809,2159908,+,6099
370,BUMA.1121.00056,2,1730378,1736577,-,6199
370,BUMA.1121.00095,2,1133880,1139984,+,6104
370,BUMA.1121.00082,2,2302425,2308568,+,6143
370,BUMA.1121.00001,2,3130064,3136253,-,6189
370,BUMA.1121.00108,2,2492488,2498623,+,6135
370,BUMA.1121.00083,2,926341,932484,+,6143
370,BUMA.1121.00080,2,2324877,2331051,+,6174
370,BUMA.1121.00012,2,2683860,2690046,-,6186
371,BUMA.1121.00011,2,895511,923625,+,28114
371,BUMA.1121.00009,2,936462,964575,+,28113
371,BUMA.1121.00039,2,1664405,1692476,-,28071
371,BUMA.1121.00029,2,2220189,2248277,-,28088
371,BUMA.1121.00021,2,2771726,2799813,+,28087
371,BUMA.1121.00107,2,1497361,1525436,-,28075
371,BUMA.1121.00023,2,2414570,2442650,+,28080
371,BUMA.1121.00067,2,1624530,1652592,-,28062
371,BUMA.1121.00035,2,2297865,2325939,-,28074
371,BUMA.1121.00005,2,1620475,1648518,-,28043
371,BUMA.1121.00100,2,295858,323913,+,28055
371,BUMA.1121.00016,2,1409070,1437178,-,28108
371,BUMA.1121.00099,2,2520029,2548093,+,28064
371,BUMA.1121.00094,2,2315817,2343891,+,28074
371,BUMA.1121.00093,2,630888,658963,-,28075
371,BUMA.1121.00097,2,2113038,2141135,+,28097
371,BUMA.1121.00109,2,2327931,2356008,-,28077
371,BUMA.1121.00018,2,1503890,1531992,-,28102
371,BUMA.1121.00110,2,2240173,2268221,+,28048
371,BUMA.1121.00079,2,2275518,2303565,+,28047
371,BUMA.1121.00075,2,549022,577123,-,28101
371,BUMA.1121.00066,2,2246369,2274460,+,28091
371,BUMA.1121.00089,2,2261600,2289682,+,28082
371,BUMA.1121.00057,2,2936427,2964548,-,28121
371,BUMA.1121.00090,2,14253,42389,+,28136
371,BUMA.1121.00027,2,194299,222412,+,28113
371,BUMA.1121.00062,2,2605052,2633155,-,28103
371,BUMA.1121.00091,2,1331016,1360398,-,29382
371,BUMA.1121.00098,2,2535313,2563409,+,28096
371,BUMA.1121.00092,2,2279049,2307123,+,28074
371,BUMA.1121.00031,2,1459687,1487788,+,28101
371,BUMA.1121.00096,2,2592621,2620705,+,28084
371,BUMA.1121.00073,2,2262739,2290828,+,28089
371,BUMA.1121.00103,2,865483,893543,+,28060
371,BUMA.1121.00084,2,991444,1019512,+,28068
371,BUMA.1121.00014,2,2394313,2422434,+,28121
371,BUMA.1121.00111,2,1606844,1634952,+,28108
371,BUMA.1121.00007,2,2345100,2373259,+,28159
371,BUMA.1121.00072,2,2237249,2265345,+,28096
371,BUMA.1121.00071,2,2262524,2290606,+,28082
371,BUMA.1121.00077,2,1347724,1375766,-,28042
371,BUMA.1121.00003,2,523862,551984,+,28122
371,BUMA.1121.00104,2,2367805,2395882,+,28077
371,BUMA.1121.00074,2,2069374,2097441,-,28067
371,BUMA.1121.00060,2,68396,96504,-,28108
371,BUMA.1121.00088,2,2286616,2314704,+,28088
371,BUMA.1121.00053,2,2561955,2590025,+,28070
371,BUMA.1121.00025,2,800927,829028,+,28101
371,BUMA.1121.00070,2,2242112,2270201,+,28089
371,BUMA.1121.00049,2,920701,948781,+,28080
371,BUMA.1121.00078,2,845623,873678,-,28055
371,BUMA.1121.00069,2,2229246,2257339,+,28093
371,BUMA.1121.00102,2,2304905,2332972,+,28067
371,BUMA.1121.00112,2,2067664,2095782,-,28118
371,BUMA.1121.00041,2,7749,35874,+,28125
371,BUMA.1121.00068,2,856212,884288,+,28076
371,BUMA.1121.00076,2,20338,48441,+,28103
371,BUMA.1121.00033,2,3062740,3090857,+,28117
371,BUMA.1121.00101,2,1117575,1145656,-,28081
371,BUMA.1121.00105,2,129512,157591,-,28079
371,BUMA.1121.00061,2,2245835,2273938,+,28103
371,BUMA.1121.00063,2,2255734,2283823,+,28089
371,BUMA.1121.00059,2,1295417,1323493,-,28076
371,BUMA.1121.00058,2,2885735,2913893,+,28158
371,BUMA.1121.00043,2,22,28139,-,28117
371,BUMA.1121.00055,2,371451,399627,-,28176
371,BUMA.1121.00065,2,2350165,2378219,+,28054
371,BUMA.1121.00064,2,2182814,2210880,+,28066
371,BUMA.1121.00047,2,89374,117505,+,28131
371,BUMA.1121.00037,2,2629250,2657330,+,28080
371,BUMA.1121.00106,2,1556737,1584804,+,28067
371,BUMA.1121.00051,2,2275026,2303155,+,28129
371,BUMA.1121.00045,2,2160232,2188339,+,28107
371,BUMA.1121.00056,2,1701943,1730026,-,28083
371,BUMA.1121.00095,2,1140322,1168396,+,28074
371,BUMA.1121.00082,2,2308899,2337002,+,28103
371,BUMA.1121.00001,2,3101631,3129705,-,28074
371,BUMA.1121.00108,2,2498975,2527069,+,28094
371,BUMA.1121.00083,2,932815,960918,+,28103
371,BUMA.1121.00080,2,2331389,2359546,+,28157
371,BUMA.1121.00012,2,2655424,2683501,-,28077
372,BUMA.1121.00011,2,923627,937379,+,13752
372,BUMA.1121.00009,2,964577,978329,+,13752
372,BUMA.1121.00039,2,1650659,1664404,-,13745
372,BUMA.1121.00029,2,2206443,2220188,-,13745
372,BUMA.1121.00021,2,2799815,2813560,+,13745
372,BUMA.1121.00107,2,1483607,1497360,-,13753
372,BUMA.1121.00023,2,2442652,2456404,+,13752
372,BUMA.1121.00067,2,1610767,1624529,-,13762
372,BUMA.1121.00035,2,2284119,2297864,-,13745
372,BUMA.1121.00005,2,1606758,1620474,-,13716
372,BUMA.1121.00100,2,323915,337661,+,13746
372,BUMA.1121.00016,2,1395325,1409069,-,13744
372,BUMA.1121.00099,2,2548095,2561849,+,13754
372,BUMA.1121.00094,2,2343893,2357662,+,13769
372,BUMA.1121.00093,2,617144,630887,-,13743
372,BUMA.1121.00097,2,2141137,2154881,+,13744
372,BUMA.1121.00109,2,2314183,2327930,-,13747
372,BUMA.1121.00018,2,1490144,1503889,-,13745
372,BUMA.1121.00110,2,2268223,2282031,+,13808
372,BUMA.1121.00079,2,2303567,2317331,+,13764
372,BUMA.1121.00075,2,535347,549021,-,13674
372,BUMA.1121.00066,2,2274462,2288225,+,13763
372,BUMA.1121.00089,2,2289684,2303426,+,13742
372,BUMA.1121.00057,2,2922671,2936426,-,13755
372,BUMA.1121.00090,2,42391,56135,+,13744
372,BUMA.1121.00027,2,222414,236169,+,13755
372,BUMA.1121.00062,2,2591281,2605051,-,13770
372,BUMA.1121.00091,2,1317291,1331015,-,13724
372,BUMA.1121.00098,2,2563411,2577162,+,13751
372,BUMA.1121.00092,2,2307125,2320868,+,13743
372,BUMA.1121.00031,2,1487790,1501536,+,13746
372,BUMA.1121.00096,2,2620707,2634455,+,13748
372,BUMA.1121.00073,2,2290830,2304590,+,13760
372,BUMA.1121.00103,2,893545,907312,+,13767
372,BUMA.1121.00084,2,1019514,1033257,+,13743
372,BUMA.1121.00014,2,2422436,2436182,+,13746
372,BUMA.1121.00111,2,1634954,1648699,+,13745
372,BUMA.1121.00007,2,2373261,2387007,+,13746
372,BUMA.1121.00072,2,2265347,2279101,+,13754
372,BUMA.1121.00071,2,2290608,2304351,+,13743
372,BUMA.1121.00077,2,1333918,1347723,-,13805
372,BUMA.1121.00003,2,551986,565733,+,13747
372,BUMA.1121.00104,2,2395884,2409627,+,13743
372,BUMA.1121.00074,2,2055609,2069373,-,13764
372,BUMA.1121.00060,2,54644,68395,-,13751
372,BUMA.1121.00088,2,2314706,2328452,+,13746
372,BUMA.1121.00053,2,2590027,2603753,+,13726
372,BUMA.1121.00025,2,829030,842775,+,13745
372,BUMA.1121.00070,2,2270203,2283960,+,13757
372,BUMA.1121.00049,2,948783,962518,+,13735
372,BUMA.1121.00078,2,831905,845622,-,13717
372,BUMA.1121.00069,2,2257341,2271103,+,13762
372,BUMA.1121.00102,2,2332974,2346700,+,13726
372,BUMA.1121.00112,2,2053918,2067663,-,13745
372,BUMA.1121.00041,2,35876,49620,+,13744
372,BUMA.1121.00068,2,884290,898053,+,13763
372,BUMA.1121.00076,2,48443,62118,+,13675
372,BUMA.1121.00033,2,3090859,3104603,+,13744
372,BUMA.1121.00101,2,1103819,1117574,-,13755
372,BUMA.1121.00105,2,115765,129511,-,13746
372,BUMA.1121.00061,2,2273940,2287689,+,13749
372,BUMA.1121.00063,2,2283825,2297574,+,13749
372,BUMA.1121.00059,2,1281684,1295416,-,13732
372,BUMA.1121.00058,2,2913895,2927660,+,13765
372,BUMA.1121.00043,2,3255965,3269661,-,13696
372,BUMA.1121.00055,2,357726,371450,-,13724
372,BUMA.1121.00065,2,2378221,2391985,+,13764
372,BUMA.1121.00064,2,2210882,2224653,+,13771
372,BUMA.1121.00047,2,117507,131249,+,13742
372,BUMA.1121.00037,2,2657332,2671078,+,13746
372,BUMA.1121.00106,2,1584806,1598550,+,13744
372,BUMA.1121.00051,2,2303157,2316899,+,13742
372,BUMA.1121.00045,2,2188341,2202092,+,13751
372,BUMA.1121.00056,2,1688200,1701942,-,13742
372,BUMA.1121.00095,2,1168398,1182144,+,13746
372,BUMA.1121.00082,2,2337004,2350785,+,13781
372,BUMA.1121.00001,2,3087885,3101630,-,13745
372,BUMA.1121.00108,2,2527071,2540766,+,13695
372,BUMA.1121.00083,2,960920,974701,+,13781
372,BUMA.1121.00080,2,2359548,2373290,+,13742
372,BUMA.1121.00012,2,2641677,2655423,-,13746
373,BUMA.1121.00011,2,937380,954451,+,17071
373,BUMA.1121.00009,2,978330,995401,+,17071
373,BUMA.1121.00039,2,1633586,1650657,-,17071
373,BUMA.1121.00029,2,2189370,2206441,-,17071
373,BUMA.1121.00021,2,2813561,2830632,+,17071
373,BUMA.1121.00107,2,1466533,1483605,-,17072
373,BUMA.1121.00023,2,2456405,2473476,+,17071
373,BUMA.1121.00067,2,1593694,1610765,-,17071
373,BUMA.1121.00035,2,2267046,2284117,-,17071
373,BUMA.1121.00005,2,1589685,1606756,-,17071
373,BUMA.1121.00100,2,337662,354733,+,17071
373,BUMA.1121.00016,2,1378252,1395323,-,17071
373,BUMA.1121.00099,2,2561850,2578937,+,17087
373,BUMA.1121.00094,2,2357663,2374734,+,17071
373,BUMA.1121.00093,2,600071,617142,-,17071
373,BUMA.1121.00097,2,2154882,2171952,+,17070
373,BUMA.1121.00109,2,2297110,2314181,-,17071
373,BUMA.1121.00018,2,1473071,1490142,-,17071
373,BUMA.1121.00110,2,2282032,2299103,+,17071
373,BUMA.1121.00079,2,2317332,2334403,+,17071
373,BUMA.1121.00075,2,518275,535345,-,17070
373,BUMA.1121.00066,2,2288226,2305297,+,17071
373,BUMA.1121.00089,2,2303427,2320498,+,17071
373,BUMA.1121.00057,2,2905598,2922669,-,17071
373,BUMA.1121.00090,2,56136,73207,+,17071
373,BUMA.1121.00027,2,236170,253241,+,17071
373,BUMA.1121.00062,2,2574208,2591279,-,17071
373,BUMA.1121.00091,2,1300219,1317289,-,17070
373,BUMA.1121.00098,2,2577163,2594234,+,17071
373,BUMA.1121.00092,2,2320869,2337940,+,17071
373,BUMA.1121.00031,2,1501537,1518608,+,17071
373,BUMA.1121.00096,2,2634456,2651539,+,17083
373,BUMA.1121.00073,2,2304591,2321662,+,17071
373,BUMA.1121.00103,2,907313,924395,+,17082
373,BUMA.1121.00084,2,1033258,1050329,+,17071
373,BUMA.1121.00014,2,2436183,2453254,+,17071
373,BUMA.1121.00111,2,1648700,1665771,+,17071
373,BUMA.1121.00007,2,2387008,2404079,+,17071
373,BUMA.1121.00072,2,2279102,2296173,+,17071
373,BUMA.1121.00071,2,2304352,2321423,+,17071
373,BUMA.1121.00077,2,1316845,1333916,-,17071
373,BUMA.1121.00003,2,565734,582805,+,17071
373,BUMA.1121.00104,2,2409628,2426699,+,17071
373,BUMA.1121.00074,2,2038536,2055607,-,17071
373,BUMA.1121.00060,2,37571,54642,-,17071
373,BUMA.1121.00088,2,2328453,2345524,+,17071
373,BUMA.1121.00053,2,2603754,2620824,+,17070
373,BUMA.1121.00025,2,842776,859847,+,17071
373,BUMA.1121.00070,2,2283961,2301032,+,17071
373,BUMA.1121.00049,2,962519,979590,+,17071
373,BUMA.1121.00078,2,814833,831903,-,17070
373,BUMA.1121.00069,2,2271104,2288175,+,17071
373,BUMA.1121.00102,2,2346701,2363771,+,17070
373,BUMA.1121.00112,2,2036845,2053916,-,17071
373,BUMA.1121.00041,2,49621,66692,+,17071
373,BUMA.1121.00068,2,898054,915125,+,17071
373,BUMA.1121.00076,2,62119,79190,+,17071
373,BUMA.1121.00033,2,3104604,3121675,+,17071
373,BUMA.1121.00101,2,1086746,1103817,-,17071
373,BUMA.1121.00105,2,98692,115763,-,17071
373,BUMA.1121.00061,2,2287690,2304761,+,17071
373,BUMA.1121.00063,2,2297575,2314646,+,17071
373,BUMA.1121.00059,2,1264611,1281682,-,17071
373,BUMA.1121.00058,2,2927661,2944732,+,17071
373,BUMA.1121.00043,2,3238892,3255963,-,17071
373,BUMA.1121.00055,2,340654,357724,-,17070
373,BUMA.1121.00065,2,2391986,2409056,+,17070
373,BUMA.1121.00064,2,2224654,2241725,+,17071
373,BUMA.1121.00047,2,131250,148321,+,17071
373,BUMA.1121.00037,2,2671079,2688150,+,17071
373,BUMA.1121.00106,2,1598551,1615622,+,17071
373,BUMA.1121.00051,2,2316900,2333971,+,17071
373,BUMA.1121.00045,2,2202093,2219164,+,17071
373,BUMA.1121.00056,2,1671127,1688198,-,17071
373,BUMA.1121.00095,2,1182145,1199216,+,17071
373,BUMA.1121.00082,2,2350786,2367857,+,17071
373,BUMA.1121.00001,2,3070812,3087883,-,17071
373,BUMA.1121.00108,2,2542242,2559328,+,17086
373,BUMA.1121.00083,2,974702,991773,+,17071
373,BUMA.1121.00080,2,2373291,2390362,+,17071
373,BUMA.1121.00012,2,2624604,2641675,-,17071
374,BUMA.1121.00011,2,954453,990060,+,35607
374,BUMA.1121.00009,2,995403,1031013,+,35610
374,BUMA.1121.00039,2,1598000,1633585,-,35585
374,BUMA.1121.00029,2,2153792,2189369,-,35577
374,BUMA.1121.00021,2,2830634,2866228,+,35594
374,BUMA.1121.00107,2,1430916,1466532,-,35616
374,BUMA.1121.00023,2,2473478,2509063,+,35585
374,BUMA.1121.00067,2,1558067,1593693,-,35626
374,BUMA.1121.00035,2,2231469,2267045,-,35576
374,BUMA.1121.00005,2,1554110,1589684,-,35574
374,BUMA.1121.00100,2,354735,390360,+,35625
374,BUMA.1121.00016,2,1342784,1378251,-,35467
374,BUMA.1121.00099,2,2580518,2616107,+,35589
374,BUMA.1121.00094,2,2374736,2410343,+,35607
374,BUMA.1121.00093,2,564463,600070,-,35607
374,BUMA.1121.00097,2,2171954,2207562,+,35608
374,BUMA.1121.00109,2,2261477,2297109,-,35632
374,BUMA.1121.00018,2,1437484,1473070,-,35586
374,BUMA.1121.00110,2,2299105,2334706,+,35601
374,BUMA.1121.00079,2,2334405,2370033,+,35628
374,BUMA.1121.00075,2,482671,518274,-,35603
374,BUMA.1121.00066,2,2305299,2340909,+,35610
374,BUMA.1121.00089,2,2320500,2356107,+,35607
374,BUMA.1121.00057,2,2869968,2905597,-,35629
374,BUMA.1121.00090,2,73209,108803,+,35594
374,BUMA.1121.00027,2,253243,288880,+,35637
374,BUMA.1121.00062,2,2538578,2574207,-,35629
374,BUMA.1121.00091,2,1264606,1300218,-,35612
374,BUMA.1121.00098,2,2594236,2629854,+,35618
374,BUMA.1121.00092,2,2337942,2373549,+,35607
374,BUMA.1121.00031,2,1518610,1554214,+,35604
374,BUMA.1121.00096,2,2651541,2687128,+,35587
374,BUMA.1121.00073,2,2321664,2357274,+,35610
374,BUMA.1121.00103,2,925716,961283,+,35567
374,BUMA.1121.00084,2,1050331,1085978,+,35647
374,BUMA.1121.00014,2,2453256,2488860,+,35604
374,BUMA.1121.00111,2,1665773,1701355,+,35582
374,BUMA.1121.00007,2,2404081,2439598,+,35517
374,BUMA.1121.00072,2,2296175,2331783,+,35608
374,BUMA.1121.00071,2,2321425,2357035,+,35610
374,BUMA.1121.00077,2,1281245,1316844,-,35599
374,BUMA.1121.00003,2,582807,618416,+,35609
374,BUMA.1121.00104,2,2426701,2462307,+,35606
374,BUMA.1121.00074,2,2002918,2038535,-,35617
374,BUMA.1121.00060,2,1914,37570,-,35656
374,BUMA.1121.00088,2,2345526,2381132,+,35606
374,BUMA.1121.00053,2,2620826,2656520,+,35694
374,BUMA.1121.00025,2,859849,895434,+,35585
374,BUMA.1121.00070,2,2301034,2336644,+,35610
374,BUMA.1121.00049,2,979592,1015288,+,35696
374,BUMA.1121.00078,2,778922,814832,-,35910
374,BUMA.1121.00069,2,2288177,2323787,+,35610
374,BUMA.1121.00102,2,2363773,2399372,+,35599
374,BUMA.1121.00112,2,2001272,2036844,-,35572
374,BUMA.1121.00041,2,66694,102356,+,35662
374,BUMA.1121.00068,2,915127,950689,+,35562
374,BUMA.1121.00076,2,79192,114797,+,35605
374,BUMA.1121.00033,2,3121677,3157234,+,35557
374,BUMA.1121.00101,2,1051141,1086745,-,35604
374,BUMA.1121.00105,2,63076,98691,-,35615
374,BUMA.1121.00061,2,2304763,2340373,+,35610
374,BUMA.1121.00063,2,2314648,2350258,+,35610
374,BUMA.1121.00059,2,1228983,1264610,-,35627
374,BUMA.1121.00058,2,2944734,2980352,+,35618
374,BUMA.1121.00043,2,3203425,3238891,-,35466
374,BUMA.1121.00055,2,305036,340653,-,35617
374,BUMA.1121.00065,2,2409058,2444724,+,35666
374,BUMA.1121.00064,2,2241727,2277356,+,35629
374,BUMA.1121.00047,2,148323,183943,+,35620
374,BUMA.1121.00037,2,2688152,2723743,+,35591
374,BUMA.1121.00106,2,1615624,1651227,+,35603
374,BUMA.1121.00051,2,2333973,2369589,+,35616
374,BUMA.1121.00045,2,2219166,2254822,+,35656
374,BUMA.1121.00056,2,1635519,1671126,-,35607
374,BUMA.1121.00095,2,1199218,1234808,+,35590
374,BUMA.1121.00082,2,2367859,2403469,+,35610
374,BUMA.1121.00001,2,3035245,3070811,-,35566
374,BUMA.1121.00108,2,2559330,2594893,+,35563
374,BUMA.1121.00083,2,991775,1027385,+,35610
374,BUMA.1121.00080,2,2390364,2425980,+,35616
374,BUMA.1121.00012,2,2589015,2624603,-,35588
375,BUMA.1121.00011,2,993139,1001481,+,8342
375,BUMA.1121.00009,2,1035719,1044059,+,8340
375,BUMA.1121.00039,2,1586449,1594754,-,8305
375,BUMA.1121.00029,2,2142235,2150546,-,8311
375,BUMA.1121.00021,2,2870809,2879119,+,8310
375,BUMA.1121.00107,2,1411592,1419925,-,8333
375,BUMA.1121.00023,2,2512309,2520619,+,8310
375,BUMA.1121.00067,2,1546513,1554822,-,8309
375,BUMA.1121.00035,2,2219913,2228223,-,8310
375,BUMA.1121.00005,2,1541252,1549561,-,8309
375,BUMA.1121.00100,2,404225,412566,+,8341
375,BUMA.1121.00016,2,1331227,1339537,-,8310
375,BUMA.1121.00099,2,2619188,2627527,+,8339
375,BUMA.1121.00094,2,2413588,2421898,+,8310
375,BUMA.1121.00093,2,552909,561218,-,8309
375,BUMA.1121.00097,2,2210642,2218960,+,8318
375,BUMA.1121.00109,2,2244683,2253024,-,8341
375,BUMA.1121.00018,2,1425955,1434238,-,8283
375,BUMA.1121.00110,2,2337951,2346292,+,8341
375,BUMA.1121.00079,2,2373277,2381587,+,8310
375,BUMA.1121.00075,2,459149,467432,+,8283
375,BUMA.1121.00066,2,2344155,2352493,+,8338
375,BUMA.1121.00089,2,2359353,2367663,+,8310
375,BUMA.1121.00057,2,2858412,2866723,-,8311
375,BUMA.1121.00090,2,112049,120359,+,8310
375,BUMA.1121.00027,2,292124,300434,+,8310
375,BUMA.1121.00062,2,2526992,2535332,-,8340
375,BUMA.1121.00091,2,1253071,1261362,-,8291
375,BUMA.1121.00098,2,2632935,2641252,+,8317
375,BUMA.1121.00092,2,2376794,2385103,+,8309
375,BUMA.1121.00031,2,1557460,1565770,+,8310
375,BUMA.1121.00096,2,2690373,2698713,+,8340
375,BUMA.1121.00073,2,2360520,2368859,+,8339
375,BUMA.1121.00103,2,1016371,1024692,+,8321
375,BUMA.1121.00084,2,1089224,1097564,+,8340
375,BUMA.1121.00014,2,2492106,2500416,+,8310
375,BUMA.1121.00111,2,1704601,1712918,+,8317
375,BUMA.1121.00007,2,2497891,2506214,+,8323
375,BUMA.1121.00072,2,2335028,2343361,+,8333
375,BUMA.1121.00071,2,2360281,2368618,+,8337
375,BUMA.1121.00077,2,1269660,1278001,-,8341
375,BUMA.1121.00003,2,621660,630008,+,8348
375,BUMA.1121.00104,2,2465535,2473883,+,8348
375,BUMA.1121.00074,2,1991333,1999673,-,8340
375,BUMA.1121.00060,2,2998921,3007237,-,8316
375,BUMA.1121.00088,2,2384379,2392719,+,8340
375,BUMA.1121.00053,2,2659765,2668111,+,8346
375,BUMA.1121.00025,2,898680,906963,+,8283
375,BUMA.1121.00070,2,2339890,2348229,+,8339
375,BUMA.1121.00049,2,1018533,1026873,+,8340
375,BUMA.1121.00078,2,755118,763458,-,8340
375,BUMA.1121.00069,2,2326397,2334736,+,8339
375,BUMA.1121.00102,2,2402617,2410957,+,8340
375,BUMA.1121.00112,2,1989855,1998195,-,8340
375,BUMA.1121.00041,2,105601,113947,+,8346
375,BUMA.1121.00068,2,966158,974504,+,8346
375,BUMA.1121.00076,2,130036,138319,-,8283
375,BUMA.1121.00033,2,3172691,3181001,+,8310
375,BUMA.1121.00101,2,1031845,1040156,-,8311
375,BUMA.1121.00105,2,51490,59830,-,8340
375,BUMA.1121.00061,2,2343619,2351958,+,8339
375,BUMA.1121.00063,2,2353504,2361842,+,8338
375,BUMA.1121.00059,2,1217396,1225736,-,8340
375,BUMA.1121.00058,2,2983601,2991941,+,8340
375,BUMA.1121.00043,2,3178837,3187147,-,8310
375,BUMA.1121.00055,2,293482,301791,-,8309
375,BUMA.1121.00065,2,2447969,2456279,+,8310
375,BUMA.1121.00064,2,2280601,2288910,+,8309
375,BUMA.1121.00047,2,187190,195500,+,8310
375,BUMA.1121.00037,2,2726989,2735299,+,8310
375,BUMA.1121.00106,2,1654472,1662782,+,8310
375,BUMA.1121.00051,2,2372835,2381145,+,8310
375,BUMA.1121.00045,2,2257903,2266219,+,8316
375,BUMA.1121.00056,2,1623963,1632273,-,8310
375,BUMA.1121.00095,2,1238051,1246393,+,8342
375,BUMA.1121.00082,2,2406715,2415054,+,8339
375,BUMA.1121.00001,2,3023689,3031999,-,8310
375,BUMA.1121.00108,2,2622348,2630689,+,8341
375,BUMA.1121.00083,2,1030631,1038970,+,8339
375,BUMA.1121.00080,2,2429226,2437536,+,8310
375,BUMA.1121.00012,2,2549342,2557640,-,8298
376,BUMA.1121.00011,2,1001908,1007086,+,5178
376,BUMA.1121.00009,2,1044486,1049664,+,5178
376,BUMA.1121.00039,2,1580844,1586021,-,5177
376,BUMA.1121.00029,2,2136630,2141807,-,5177
376,BUMA.1121.00021,2,2879546,2884724,+,5178
376,BUMA.1121.00107,2,1405987,1411164,-,5177
376,BUMA.1121.00023,2,2521046,2526224,+,5178
376,BUMA.1121.00067,2,1540907,1546085,-,5178
376,BUMA.1121.00035,2,2214308,2219485,-,5177
376,BUMA.1121.00005,2,1535647,1540824,-,5177
376,BUMA.1121.00100,2,412993,418171,+,5178
376,BUMA.1121.00016,2,1325622,1330799,-,5177
376,BUMA.1121.00099,2,2627954,2633133,+,5179
376,BUMA.1121.00094,2,2422325,2427503,+,5178
376,BUMA.1121.00093,2,547303,552481,-,5178
376,BUMA.1121.00097,2,2219387,2224565,+,5178
376,BUMA.1121.00109,2,2239076,2244255,-,5179
376,BUMA.1121.00018,2,1418727,1423904,-,5177
376,BUMA.1121.00110,2,2346719,2351898,+,5179
376,BUMA.1121.00079,2,2382014,2387192,+,5178
376,BUMA.1121.00075,2,451705,456882,-,5177
376,BUMA.1121.00066,2,2352920,2358098,+,5178
376,BUMA.1121.00089,2,2368090,2373268,+,5178
376,BUMA.1121.00057,2,2851183,2856360,-,5177
376,BUMA.1121.00090,2,120786,125964,+,5178
376,BUMA.1121.00027,2,302486,307663,+,5177
376,BUMA.1121.00062,2,2521387,2526564,-,5177
376,BUMA.1121.00091,2,1247466,1252643,-,5177
376,BUMA.1121.00098,2,2641679,2646857,+,5178
376,BUMA.1121.00092,2,2385530,2390709,+,5179
376,BUMA.1121.00031,2,1566197,1571375,+,5178
376,BUMA.1121.00096,2,2699140,2704318,+,5178
376,BUMA.1121.00073,2,2369286,2374464,+,5178
376,BUMA.1121.00103,2,1025119,1030297,+,5178
376,BUMA.1121.00084,2,1097991,1103169,+,5178
376,BUMA.1121.00014,2,2500843,2506021,+,5178
376,BUMA.1121.00111,2,1713345,1718523,+,5178
376,BUMA.1121.00007,2,2506641,2511819,+,5178
376,BUMA.1121.00072,2,2343788,2348966,+,5178
376,BUMA.1121.00071,2,2369045,2374223,+,5178
376,BUMA.1121.00077,2,1264054,1269232,-,5178
376,BUMA.1121.00003,2,630435,635613,+,5178
376,BUMA.1121.00104,2,2474310,2479488,+,5178
376,BUMA.1121.00074,2,1985728,1990905,-,5177
376,BUMA.1121.00060,2,2993316,2998493,-,5177
376,BUMA.1121.00088,2,2393146,2398324,+,5178
376,BUMA.1121.00053,2,2668538,2673716,+,5178
376,BUMA.1121.00025,2,909013,914191,+,5178
376,BUMA.1121.00070,2,2348656,2353834,+,5178
376,BUMA.1121.00049,2,1027300,1032478,+,5178
376,BUMA.1121.00078,2,749513,754690,-,5177
376,BUMA.1121.00069,2,2335163,2340341,+,5178
376,BUMA.1121.00102,2,2411384,2416562,+,5178
376,BUMA.1121.00112,2,1984249,1989427,-,5178
376,BUMA.1121.00041,2,114374,119552,+,5178
376,BUMA.1121.00068,2,974931,980109,+,5178
376,BUMA.1121.00076,2,140585,145763,+,5178
376,BUMA.1121.00033,2,3181428,3186606,+,5178
376,BUMA.1121.00101,2,1026239,1031417,-,5178
376,BUMA.1121.00105,2,45885,51062,-,5177
376,BUMA.1121.00061,2,2352385,2357563,+,5178
376,BUMA.1121.00063,2,2362269,2367447,+,5178
376,BUMA.1121.00059,2,1211791,1216968,-,5177
376,BUMA.1121.00058,2,2992368,2997546,+,5178
376,BUMA.1121.00043,2,3173232,3178409,-,5177
376,BUMA.1121.00055,2,287877,293054,-,5177
376,BUMA.1121.00065,2,2456706,2461884,+,5178
376,BUMA.1121.00064,2,2289337,2294516,+,5179
376,BUMA.1121.00047,2,195927,201105,+,5178
376,BUMA.1121.00037,2,2735726,2740904,+,5178
376,BUMA.1121.00106,2,1663209,1668387,+,5178
376,BUMA.1121.00051,2,2381572,2386750,+,5178
376,BUMA.1121.00045,2,2266646,2271824,+,5178
376,BUMA.1121.00056,2,1618358,1623535,-,5177
376,BUMA.1121.00095,2,1246820,1252000,+,5180
376,BUMA.1121.00082,2,2415481,2420659,+,5178
376,BUMA.1121.00001,2,3018084,3023261,-,5177
376,BUMA.1121.00108,2,2631116,2636294,+,5178
376,BUMA.1121.00083,2,1039397,1044575,+,5178
376,BUMA.1121.00080,2,2437963,2443141,+,5178
376,BUMA.1121.00012,2,2543737,2548914,-,5177
377,BUMA.1121.00011,2,1007087,1018462,+,11375
377,BUMA.1121.00009,2,1049665,1061184,+,11519
377,BUMA.1121.00039,2,1567784,1579260,-,11476
377,BUMA.1121.00029,2,2123541,2135035,-,11494
377,BUMA.1121.00021,2,2886319,2897798,+,11479
377,BUMA.1121.00107,2,1394532,1405985,-,11453
377,BUMA.1121.00023,2,2527809,2539291,+,11482
377,BUMA.1121.00067,2,1527813,1539323,-,11510
377,BUMA.1121.00035,2,2201233,2212713,-,11480
377,BUMA.1121.00005,2,1524192,1535645,-,11453
377,BUMA.1121.00100,2,419754,431195,+,11441
377,BUMA.1121.00016,2,1312611,1324038,-,11427
377,BUMA.1121.00099,2,2634716,2646217,+,11501
377,BUMA.1121.00094,2,2429087,2440533,+,11446
377,BUMA.1121.00093,2,535928,547301,-,11373
377,BUMA.1121.00097,2,2224566,2236005,+,11439
377,BUMA.1121.00109,2,2227619,2239074,-,11455
377,BUMA.1121.00018,2,1405695,1417143,-,11448
377,BUMA.1121.00110,2,2351899,2363352,+,11453
377,BUMA.1121.00079,2,2388776,2400278,+,11502
377,BUMA.1121.00075,2,440225,451703,-,11478
377,BUMA.1121.00066,2,2358099,2369490,+,11391
377,BUMA.1121.00089,2,2374852,2386326,+,11474
377,BUMA.1121.00057,2,2839681,2851181,-,11500
377,BUMA.1121.00090,2,127548,139058,+,11510
377,BUMA.1121.00027,2,307664,319055,+,11391
377,BUMA.1121.00062,2,2508292,2519803,-,11511
377,BUMA.1121.00091,2,1234392,1245882,-,11490
377,BUMA.1121.00098,2,2648441,2659818,+,11377
377,BUMA.1121.00092,2,2390710,2402104,+,11394
377,BUMA.1121.00031,2,1572959,1584469,+,11510
377,BUMA.1121.00096,2,2704319,2715772,+,11453
377,BUMA.1121.00073,2,2374465,2385856,+,11391
377,BUMA.1121.00103,2,1030298,1041681,+,11383
377,BUMA.1121.00084,2,1104753,1116144,+,11391
377,BUMA.1121.00014,2,2507605,2519101,+,11496
377,BUMA.1121.00111,2,1720107,1731624,+,11517
377,BUMA.1121.00007,2,2513401,2524797,+,11396
377,BUMA.1121.00072,2,2348967,2360358,+,11391
377,BUMA.1121.00071,2,2374224,2385615,+,11391
377,BUMA.1121.00077,2,1252600,1264052,-,11452
377,BUMA.1121.00003,2,637195,648629,+,11434
377,BUMA.1121.00104,2,2479489,2490915,+,11426
377,BUMA.1121.00074,2,1972676,1984144,-,11468
377,BUMA.1121.00060,2,2981867,2993314,-,11447
377,BUMA.1121.00088,2,2399909,2411300,+,11391
377,BUMA.1121.00053,2,2675300,2686775,+,11475
377,BUMA.1121.00025,2,915775,927222,+,11447
377,BUMA.1121.00070,2,2353835,2365226,+,11391
377,BUMA.1121.00049,2,1032479,1043953,+,11474
377,BUMA.1121.00078,2,738016,749511,-,11495
377,BUMA.1121.00069,2,2340342,2351733,+,11391
377,BUMA.1121.00102,2,2418146,2429635,+,11489
377,BUMA.1121.00112,2,1971223,1982665,-,11442
377,BUMA.1121.00041,2,121136,132589,+,11453
377,BUMA.1121.00068,2,980110,991558,+,11448
377,BUMA.1121.00076,2,145764,157243,+,11479
377,BUMA.1121.00033,2,3188190,3199692,+,11502
377,BUMA.1121.00101,2,1014784,1026237,-,11453
377,BUMA.1121.00105,2,32823,44299,-,11476
377,BUMA.1121.00061,2,2357564,2368955,+,11391
377,BUMA.1121.00063,2,2367448,2378839,+,11391
377,BUMA.1121.00059,2,1200308,1211789,-,11481
377,BUMA.1121.00058,2,2997547,3009018,+,11471
377,BUMA.1121.00043,2,3160158,3171648,-,11490
377,BUMA.1121.00055,2,276436,287875,-,11439
377,BUMA.1121.00065,2,2463469,2474937,+,11468
377,BUMA.1121.00064,2,2296100,2307588,+,11488
377,BUMA.1121.00047,2,202689,214156,+,11467
377,BUMA.1121.00037,2,2742488,2753964,+,11476
377,BUMA.1121.00106,2,1668388,1679883,+,11495
377,BUMA.1121.00051,2,2388334,2399765,+,11431
377,BUMA.1121.00045,2,2271825,2283272,+,11447
377,BUMA.1121.00056,2,1605271,1616774,-,11503
377,BUMA.1121.00095,2,1252001,1263401,+,11400
377,BUMA.1121.00082,2,2420660,2432051,+,11391
377,BUMA.1121.00001,2,3005002,3016489,-,11487
377,BUMA.1121.00108,2,2636295,2647757,+,11462
377,BUMA.1121.00083,2,1044576,1055967,+,11391
377,BUMA.1121.00080,2,2444725,2456178,+,11453
377,BUMA.1121.00012,2,2530719,2542153,-,11434
378,BUMA.1121.00011,2,1022886,1051275,+,28389
378,BUMA.1121.00009,2,1065608,1094007,+,28399
378,BUMA.1121.00039,2,1535009,1563357,-,28348
378,BUMA.1121.00029,2,2090708,2119115,-,28407
378,BUMA.1121.00021,2,2902225,2930553,+,28328
378,BUMA.1121.00107,2,1361815,1390108,-,28293
378,BUMA.1121.00023,2,2543718,2572081,+,28363
378,BUMA.1121.00067,2,1495053,1523391,-,28338
378,BUMA.1121.00035,2,2168455,2196807,-,28352
378,BUMA.1121.00005,2,1491424,1519769,-,28345
378,BUMA.1121.00100,2,435620,463955,+,28335
378,BUMA.1121.00016,2,1279817,1308185,-,28368
378,BUMA.1121.00099,2,2650644,2679002,+,28358
378,BUMA.1121.00094,2,2444956,2473310,+,28354
378,BUMA.1121.00093,2,503130,531506,-,28376
378,BUMA.1121.00097,2,2241744,2270102,+,28358
378,BUMA.1121.00109,2,2194905,2223192,-,28287
378,BUMA.1121.00018,2,1372010,1400352,-,28342
378,BUMA.1121.00110,2,2367774,2396162,+,28388
378,BUMA.1121.00079,2,2404701,2433040,+,28339
378,BUMA.1121.00075,2,407418,435803,-,28385
378,BUMA.1121.00066,2,2373913,2402319,+,28406
378,BUMA.1121.00089,2,2390751,2419100,+,28349
378,BUMA.1121.00057,2,2806873,2835258,-,28385
378,BUMA.1121.00090,2,143485,171857,+,28372
378,BUMA.1121.00027,2,323478,351875,+,28397
378,BUMA.1121.00062,2,2475427,2503869,-,28442
378,BUMA.1121.00091,2,1201605,1229965,-,28360
378,BUMA.1121.00098,2,2664241,2692623,+,28382
378,BUMA.1121.00092,2,2406527,2434903,+,28376
378,BUMA.1121.00031,2,1588897,1617245,+,28348
378,BUMA.1121.00096,2,2720197,2748514,+,28317
378,BUMA.1121.00073,2,2390279,2418596,+,28317
378,BUMA.1121.00103,2,1046106,1074561,+,28455
378,BUMA.1121.00084,2,1120568,1148974,+,28406
378,BUMA.1121.00014,2,2523531,2551872,+,28341
378,BUMA.1121.00111,2,1736051,1764412,+,28361
378,BUMA.1121.00007,2,2529224,2557718,+,28494
378,BUMA.1121.00072,2,2364781,2393127,+,28346
378,BUMA.1121.00071,2,2390038,2418444,+,28406
378,BUMA.1121.00077,2,1219794,1248178,-,28384
378,BUMA.1121.00003,2,649110,677543,+,28433
378,BUMA.1121.00104,2,2495339,2523713,+,28374
378,BUMA.1121.00074,2,1939908,1968254,-,28346
378,BUMA.1121.00060,2,2949009,2977442,-,28433
378,BUMA.1121.00088,2,2415727,2444087,+,28360
378,BUMA.1121.00053,2,2692654,2721039,+,28385
378,BUMA.1121.00025,2,932567,960909,+,28342
378,BUMA.1121.00070,2,2369649,2397955,+,28306
378,BUMA.1121.00049,2,1048380,1076768,+,28388
378,BUMA.1121.00078,2,705339,733592,-,28253
378,BUMA.1121.00069,2,2356156,2384452,+,28296
378,BUMA.1121.00102,2,2435514,2463920,+,28406
378,BUMA.1121.00112,2,1938390,1966795,-,28405
378,BUMA.1121.00041,2,137015,165316,+,28301
378,BUMA.1121.00068,2,995985,1024459,+,28474
378,BUMA.1121.00076,2,161666,190046,+,28380
378,BUMA.1121.00033,2,3204119,3232482,+,28363
378,BUMA.1121.00101,2,981917,1010358,-,28441
378,BUMA.1121.00105,2,60,28399,-,28339
378,BUMA.1121.00061,2,2373378,2401674,+,28296
378,BUMA.1121.00063,2,2383262,2411648,+,28386
378,BUMA.1121.00059,2,1167522,1195885,-,28363
378,BUMA.1121.00058,2,3013442,3041867,+,28425
378,BUMA.1121.00043,2,3127396,3155733,-,28337
378,BUMA.1121.00055,2,243659,272015,-,28356
378,BUMA.1121.00065,2,2479359,2507656,+,28297
378,BUMA.1121.00064,2,2312011,2340290,+,28279
378,BUMA.1121.00047,2,218581,246930,+,28349
378,BUMA.1121.00037,2,2758391,2786742,+,28351
378,BUMA.1121.00106,2,1684306,1712702,+,28396
378,BUMA.1121.00051,2,2404189,2432527,+,28338
378,BUMA.1121.00045,2,2287698,2316131,+,28433
378,BUMA.1121.00056,2,1572498,1600847,-,28349
378,BUMA.1121.00095,2,1267827,1296206,+,28379
378,BUMA.1121.00082,2,2436474,2464880,+,28406
378,BUMA.1121.00001,2,2972200,3000576,-,28376
378,BUMA.1121.00108,2,2652184,2680506,+,28322
378,BUMA.1121.00083,2,1060390,1088796,+,28406
378,BUMA.1121.00080,2,2460603,2488934,+,28331
378,BUMA.1121.00012,2,2497945,2526294,-,28349
379,BUMA.1121.00011,2,1051297,1063385,+,12088
379,BUMA.1121.00009,2,1094029,1106147,+,12118
379,BUMA.1121.00039,2,1522867,1534987,-,12120
379,BUMA.1121.00029,2,2078596,2090686,-,12090
379,BUMA.1121.00021,2,2930575,2942694,+,12119
379,BUMA.1121.00107,2,1349679,1361793,-,12114
379,BUMA.1121.00023,2,2572103,2584188,+,12085
379,BUMA.1121.00067,2,1482953,1495031,-,12078
379,BUMA.1121.00035,2,2156343,2168433,-,12090
379,BUMA.1121.00005,2,1479283,1491402,-,12119
379,BUMA.1121.00100,2,463977,476065,+,12088
379,BUMA.1121.00016,2,1267675,1279795,-,12120
379,BUMA.1121.00099,2,2679024,2691116,+,12092
379,BUMA.1121.00094,2,2473332,2485401,+,12069
379,BUMA.1121.00093,2,490989,503108,-,12119
379,BUMA.1121.00097,2,2270124,2282242,+,12118
379,BUMA.1121.00109,2,2182802,2194883,-,12081
379,BUMA.1121.00018,2,1359868,1371988,-,12120
379,BUMA.1121.00110,2,2396184,2408302,+,12118
379,BUMA.1121.00079,2,2433062,2445181,+,12119
379,BUMA.1121.00075,2,395307,407396,-,12089
379,BUMA.1121.00066,2,2402341,2414429,+,12088
379,BUMA.1121.00089,2,2419122,2431241,+,12119
379,BUMA.1121.00057,2,2794732,2806851,-,12119
379,BUMA.1121.00090,2,171879,183998,+,12119
379,BUMA.1121.00027,2,351897,364015,+,12118
379,BUMA.1121.00062,2,2463329,2475405,-,12076
379,BUMA.1121.00091,2,1189502,1201583,-,12081
379,BUMA.1121.00098,2,2692645,2704769,+,12124
379,BUMA.1121.00092,2,2434925,2447043,+,12118
379,BUMA.1121.00031,2,1617267,1629386,+,12119
379,BUMA.1121.00096,2,2748536,2760624,+,12088
379,BUMA.1121.00073,2,2418618,2430707,+,12089
379,BUMA.1121.00103,2,1074583,1086651,+,12068
379,BUMA.1121.00084,2,1148996,1161084,+,12088
379,BUMA.1121.00014,2,2551894,2564013,+,12119
379,BUMA.1121.00111,2,1764434,1776553,+,12119
379,BUMA.1121.00007,2,2557740,2569820,+,12080
379,BUMA.1121.00072,2,2393149,2405236,+,12087
379,BUMA.1121.00071,2,2418466,2430554,+,12088
379,BUMA.1121.00077,2,1207653,1219772,-,12119
379,BUMA.1121.00003,2,677565,689677,+,12112
379,BUMA.1121.00104,2,2523735,2535854,+,12119
379,BUMA.1121.00074,2,1927808,1939886,-,12078
379,BUMA.1121.00060,2,2936857,2948987,-,12130
379,BUMA.1121.00088,2,2444109,2456197,+,12088
379,BUMA.1121.00053,2,2721061,2733111,+,12050
379,BUMA.1121.00025,2,960931,973050,+,12119
379,BUMA.1121.00070,2,2397977,2410064,+,12087
379,BUMA.1121.00049,2,1076790,1088867,+,12077
379,BUMA.1121.00078,2,693184,705311,-,12127
379,BUMA.1121.00069,2,2384474,2396574,+,12100
379,BUMA.1121.00102,2,2463942,2476022,+,12080
379,BUMA.1121.00112,2,1926254,1938368,-,12114
379,BUMA.1121.00041,2,165338,177418,+,12080
379,BUMA.1121.00068,2,1024481,1036593,+,12112
379,BUMA.1121.00076,2,190068,202156,+,12088
379,BUMA.1121.00033,2,3232504,3244618,+,12114
379,BUMA.1121.00101,2,969776,981895,-,12119
379,BUMA.1121.00105,2,3188654,3200711,-,12057
379,BUMA.1121.00061,2,2401696,2413784,+,12088
379,BUMA.1121.00063,2,2411670,2423741,+,12071
379,BUMA.1121.00059,2,1155419,1167500,-,12081
379,BUMA.1121.00058,2,3041889,3054008,+,12119
379,BUMA.1121.00043,2,3115259,3127374,-,12115
379,BUMA.1121.00055,2,231518,243637,-,12119
379,BUMA.1121.00065,2,2507678,2519796,+,12118
379,BUMA.1121.00064,2,2340312,2352389,+,12077
379,BUMA.1121.00047,2,246952,259071,+,12119
379,BUMA.1121.00037,2,2786764,2798883,+,12119
379,BUMA.1121.00106,2,1712724,1724801,+,12077
379,BUMA.1121.00051,2,2432549,2444668,+,12119
379,BUMA.1121.00045,2,2316153,2328282,+,12129
379,BUMA.1121.00056,2,1560356,1572476,-,12120
379,BUMA.1121.00095,2,1296228,1308316,+,12088
379,BUMA.1121.00082,2,2464902,2477020,+,12118
379,BUMA.1121.00001,2,2960088,2972178,-,12090
379,BUMA.1121.00108,2,2680528,2692657,+,12129
379,BUMA.1121.00083,2,1088818,1100936,+,12118
379,BUMA.1121.00080,2,2488956,2501075,+,12119
379,BUMA.1121.00012,2,2485803,2497923,-,12120
380,BUMA.1121.00011,2,1063978,1097999,+,34021
380,BUMA.1121.00009,2,1106740,1140700,+,33960
380,BUMA.1121.00039,2,1488246,1522274,-,34028
380,BUMA.1121.00029,2,2043992,2078003,-,34011
380,BUMA.1121.00021,2,2943287,2977249,+,33962
380,BUMA.1121.00107,2,1315053,1349086,-,34033
380,BUMA.1121.00023,2,2584781,2618815,+,34034
380,BUMA.1121.00067,2,1448323,1482360,-,34037
380,BUMA.1121.00035,2,2121745,2155750,-,34005
380,BUMA.1121.00005,2,1444726,1478690,-,33964
380,BUMA.1121.00100,2,476658,510662,+,34004
380,BUMA.1121.00016,2,1233031,1267082,-,34051
380,BUMA.1121.00099,2,2691709,2725722,+,34013
380,BUMA.1121.00094,2,2485994,2520008,+,34014
380,BUMA.1121.00093,2,456412,490396,-,33984
380,BUMA.1121.00097,2,2282835,2316737,+,33902
380,BUMA.1121.00109,2,2148197,2182209,-,34012
380,BUMA.1121.00018,2,1325292,1359275,-,33983
380,BUMA.1121.00110,2,2408895,2442909,+,34014
380,BUMA.1121.00079,2,2445774,2479734,+,33960
380,BUMA.1121.00075,2,360683,394714,-,34031
380,BUMA.1121.00066,2,2415022,2449026,+,34004
380,BUMA.1121.00089,2,2431834,2465796,+,33962
380,BUMA.1121.00057,2,2760121,2794139,-,34018
380,BUMA.1121.00090,2,184591,218637,+,34046
380,BUMA.1121.00027,2,364608,398604,+,33996
380,BUMA.1121.00062,2,2428710,2462736,-,34026
380,BUMA.1121.00091,2,1154917,1188909,-,33992
380,BUMA.1121.00098,2,2705362,2739337,+,33975
380,BUMA.1121.00092,2,2447636,2481621,+,33985
380,BUMA.1121.00031,2,1629979,1663978,+,33999
380,BUMA.1121.00096,2,2761217,2795244,+,34027
380,BUMA.1121.00073,2,2431300,2465304,+,34004
380,BUMA.1121.00103,2,1087244,1121281,+,34037
380,BUMA.1121.00084,2,1161677,1195680,+,34003
380,BUMA.1121.00014,2,2564606,2598583,+,33977
380,BUMA.1121.00111,2,1777146,1811193,+,34047
380,BUMA.1121.00007,2,2570413,2604434,+,34021
380,BUMA.1121.00072,2,2405829,2439833,+,34004
380,BUMA.1121.00071,2,2431147,2465146,+,33999
380,BUMA.1121.00077,2,1173043,1207060,-,34017
380,BUMA.1121.00003,2,690270,724240,+,33970
380,BUMA.1121.00104,2,2536447,2570463,+,34016
380,BUMA.1121.00074,2,1893249,1927215,-,33966
380,BUMA.1121.00060,2,2902284,2936264,-,33980
380,BUMA.1121.00088,2,2456790,2490806,+,34016
380,BUMA.1121.00053,2,2733704,2767682,+,33978
380,BUMA.1121.00025,2,973643,1007627,+,33984
380,BUMA.1121.00070,2,2410657,2444661,+,34004
380,BUMA.1121.00049,2,1089460,1123487,+,34027
380,BUMA.1121.00078,2,658613,692591,-,33978
380,BUMA.1121.00069,2,2397167,2431171,+,34004
380,BUMA.1121.00102,2,2476615,2510586,+,33971
380,BUMA.1121.00112,2,1891714,1925661,-,33947
380,BUMA.1121.00041,2,178011,212074,+,34063
380,BUMA.1121.00068,2,1037186,1071238,+,34052
380,BUMA.1121.00076,2,202749,236790,+,34041
380,BUMA.1121.00033,2,117,34160,+,34043
380,BUMA.1121.00101,2,935151,969183,-,34032
380,BUMA.1121.00105,2,3154045,3188061,-,34016
380,BUMA.1121.00061,2,2414377,2448381,+,34004
380,BUMA.1121.00063,2,2424334,2458338,+,34004
380,BUMA.1121.00059,2,1120871,1154826,-,33955
380,BUMA.1121.00058,2,3054601,3088598,+,33997
380,BUMA.1121.00043,2,3080644,3114666,-,34022
380,BUMA.1121.00055,2,196956,230925,-,33969
380,BUMA.1121.00065,2,2520389,2554359,+,33970
380,BUMA.1121.00064,2,2352982,2386949,+,33967
380,BUMA.1121.00047,2,259664,293626,+,33962
380,BUMA.1121.00037,2,2799476,2833502,+,34026
380,BUMA.1121.00106,2,1725394,1759389,+,33995
380,BUMA.1121.00051,2,2445261,2479223,+,33962
380,BUMA.1121.00045,2,2328875,2362856,+,33981
380,BUMA.1121.00056,2,1525802,1559763,-,33961
380,BUMA.1121.00095,2,1308909,1342903,+,33994
380,BUMA.1121.00082,2,2477613,2511617,+,34004
380,BUMA.1121.00001,2,2925490,2959495,-,34005
380,BUMA.1121.00108,2,2693250,2727289,+,34039
380,BUMA.1121.00083,2,1101529,1135533,+,34004
380,BUMA.1121.00080,2,2501668,2535628,+,33960
380,BUMA.1121.00012,2,2451218,2485210,-,33992
381,BUMA.1121.00011,2,1098018,1141254,+,43236
381,BUMA.1121.00009,2,1140719,1183814,+,43095
381,BUMA.1121.00039,2,1445024,1488227,-,43203
381,BUMA.1121.00029,2,2000811,2043973,-,43162
381,BUMA.1121.00021,2,2977268,3020325,+,43057
381,BUMA.1121.00107,2,1271682,1315034,-,43352
381,BUMA.1121.00023,2,2618834,2662173,+,43339
381,BUMA.1121.00067,2,1405408,1448304,-,42896
381,BUMA.1121.00035,2,2078500,2121726,-,43226
381,BUMA.1121.00005,2,1401640,1444707,-,43067
381,BUMA.1121.00100,2,510681,553716,+,43035
381,BUMA.1121.00016,2,1188615,1233012,-,44397
381,BUMA.1121.00099,2,2725741,2768952,+,43211
381,BUMA.1121.00094,2,2520027,2563315,+,43288
381,BUMA.1121.00093,2,413074,456393,-,43319
381,BUMA.1121.00097,2,2316756,2359988,+,43232
381,BUMA.1121.00109,2,2105090,2148166,-,43076
381,BUMA.1121.00018,2,1282168,1325273,-,43105
381,BUMA.1121.00110,2,2442928,2486230,+,43302
381,BUMA.1121.00079,2,2479753,2522802,+,43049
381,BUMA.1121.00075,2,317548,360664,-,43116
381,BUMA.1121.00066,2,2449045,2492251,+,43206
381,BUMA.1121.00089,2,2465815,2509108,+,43293
381,BUMA.1121.00057,2,2716967,2760102,-,43135
381,BUMA.1121.00090,2,218656,261719,+,43063
381,BUMA.1121.00027,2,398623,441913,+,43290
381,BUMA.1121.00062,2,2385574,2428691,-,43117
381,BUMA.1121.00091,2,1111624,1154898,-,43274
381,BUMA.1121.00098,2,2739356,2782747,+,43391
381,BUMA.1121.00092,2,2481640,2524889,+,43249
381,BUMA.1121.00031,2,1663997,1707183,+,43186
381,BUMA.1121.00096,2,2795263,2838316,+,43053
381,BUMA.1121.00073,2,2465323,2508481,+,43158
381,BUMA.1121.00103,2,1121300,1164388,+,43088
381,BUMA.1121.00084,2,1195699,1238792,+,43093
381,BUMA.1121.00014,2,2598602,2641841,+,43239
381,BUMA.1121.00111,2,1811212,1854400,+,43188
381,BUMA.1121.00007,2,2604453,2647610,+,43157
381,BUMA.1121.00072,2,2439852,2482946,+,43094
381,BUMA.1121.00071,2,2465165,2508372,+,43207
381,BUMA.1121.00077,2,1129724,1173024,-,43300
381,BUMA.1121.00003,2,724270,767054,+,42784
381,BUMA.1121.00104,2,2570482,2613540,+,43058
381,BUMA.1121.00074,2,1850183,1893230,-,43047
381,BUMA.1121.00060,2,2859144,2902265,-,43121
381,BUMA.1121.00088,2,2490825,2533801,+,42976
381,BUMA.1121.00053,2,2767701,2810797,+,43096
381,BUMA.1121.00025,2,1007646,1050765,+,43119
381,BUMA.1121.00070,2,2444680,2487819,+,43139
381,BUMA.1121.00049,2,1123506,1166519,+,43013
381,BUMA.1121.00078,2,613865,656993,-,43128
381,BUMA.1121.00069,2,2431190,2474378,+,43188
381,BUMA.1121.00102,2,2510605,2553990,+,43385
381,BUMA.1121.00112,2,1848638,1891695,-,43057
381,BUMA.1121.00041,2,212093,255160,+,43067
381,BUMA.1121.00068,2,1071257,1114448,+,43191
381,BUMA.1121.00076,2,236809,279895,+,43086
381,BUMA.1121.00033,2,34179,77398,+,43219
381,BUMA.1121.00101,2,890463,933530,-,43067
381,BUMA.1121.00105,2,3111077,3154026,-,42949
381,BUMA.1121.00061,2,2448400,2491588,+,43188
381,BUMA.1121.00063,2,2458357,2501546,+,43189
381,BUMA.1121.00059,2,1077814,1120852,-,43038
381,BUMA.1121.00058,2,3088617,3131589,+,42972
381,BUMA.1121.00043,2,3037632,3080625,-,42993
381,BUMA.1121.00055,2,153897,196937,-,43040
381,BUMA.1121.00065,2,2554378,2597475,+,43097
381,BUMA.1121.00064,2,2386968,2430075,+,43107
381,BUMA.1121.00047,2,293645,336990,+,43345
381,BUMA.1121.00037,2,2833521,2876532,+,43011
381,BUMA.1121.00106,2,1761011,1804004,+,42993
381,BUMA.1121.00051,2,2479242,2522385,+,43143
381,BUMA.1121.00045,2,2362875,2405961,+,43086
381,BUMA.1121.00056,2,1482590,1525783,-,43193
381,BUMA.1121.00095,2,1344530,1387787,+,43257
381,BUMA.1121.00082,2,2511636,2554847,+,43211
381,BUMA.1121.00001,2,2882325,2925471,-,43146
381,BUMA.1121.00108,2,2727308,2770439,+,43131
381,BUMA.1121.00083,2,1135552,1178763,+,43211
381,BUMA.1121.00080,2,2535647,2578836,+,43189
381,BUMA.1121.00012,2,2408141,2451199,-,43058
382,BUMA.1121.00011,2,1141627,1155129,+,13502
382,BUMA.1121.00009,2,1184186,1197651,+,13465
382,BUMA.1121.00039,2,1431161,1444651,-,13490
382,BUMA.1121.00029,2,1986951,2000438,-,13487
382,BUMA.1121.00021,2,3020698,3034184,+,13486
382,BUMA.1121.00107,2,1257820,1271309,-,13489
382,BUMA.1121.00023,2,2662546,2676035,+,13489
382,BUMA.1121.00067,2,1390211,1403721,-,13510
382,BUMA.1121.00035,2,2064640,2078127,-,13487
382,BUMA.1121.00005,2,1387744,1401267,-,13523
382,BUMA.1121.00100,2,554079,567590,+,13511
382,BUMA.1121.00016,2,1174755,1188242,-,13487
382,BUMA.1121.00099,2,2769325,2782837,+,13512
382,BUMA.1121.00094,2,2563687,2577194,+,13507
382,BUMA.1121.00093,2,399187,412690,-,13503
382,BUMA.1121.00097,2,2360381,2373853,+,13472
382,BUMA.1121.00109,2,2091216,2104707,-,13491
382,BUMA.1121.00018,2,1268308,1281795,-,13487
382,BUMA.1121.00110,2,2486603,2500106,+,13503
382,BUMA.1121.00079,2,2523175,2536699,+,13524
382,BUMA.1121.00075,2,303688,317175,-,13487
382,BUMA.1121.00066,2,2492623,2505940,+,13317
382,BUMA.1121.00089,2,2509481,2523006,+,13525
382,BUMA.1121.00057,2,2703131,2716595,-,13464
382,BUMA.1121.00090,2,262092,275578,+,13486
382,BUMA.1121.00027,2,442286,455749,+,13463
382,BUMA.1121.00062,2,2371675,2385201,-,13526
382,BUMA.1121.00091,2,1097727,1111251,-,13524
382,BUMA.1121.00098,2,2783120,2796608,+,13488
382,BUMA.1121.00092,2,2525272,2538775,+,13503
382,BUMA.1121.00031,2,1707556,1721054,+,13498
382,BUMA.1121.00096,2,2838709,2852196,+,13487
382,BUMA.1121.00073,2,2508853,2522315,+,13462
382,BUMA.1121.00103,2,1164761,1178248,+,13487
382,BUMA.1121.00084,2,1239164,1252647,+,13483
382,BUMA.1121.00014,2,2642214,2655700,+,13486
382,BUMA.1121.00111,2,1854773,1868271,+,13498
382,BUMA.1121.00007,2,2647973,2661428,+,13455
382,BUMA.1121.00072,2,2483318,2496781,+,13463
382,BUMA.1121.00071,2,2508744,2522194,+,13450
382,BUMA.1121.00077,2,1115848,1129352,-,13504
382,BUMA.1121.00003,2,767427,780912,+,13485
382,BUMA.1121.00104,2,2613912,2627402,+,13490
382,BUMA.1121.00074,2,1834986,1848496,-,13510
382,BUMA.1121.00060,2,2845244,2858750,-,13506
382,BUMA.1121.00088,2,2534173,2547659,+,13486
382,BUMA.1121.00053,2,2811170,2824680,+,13510
382,BUMA.1121.00025,2,1051138,1064624,+,13486
382,BUMA.1121.00070,2,2488191,2501654,+,13463
382,BUMA.1121.00049,2,1166891,1180380,+,13489
382,BUMA.1121.00078,2,599989,613492,-,13503
382,BUMA.1121.00069,2,2474750,2488212,+,13462
382,BUMA.1121.00102,2,2554363,2567873,+,13510
382,BUMA.1121.00112,2,1834753,1848265,-,13512
382,BUMA.1121.00041,2,255533,269044,+,13511
382,BUMA.1121.00068,2,1114831,1128320,+,13489
382,BUMA.1121.00076,2,280268,293754,+,13486
382,BUMA.1121.00033,2,77771,91287,+,13516
382,BUMA.1121.00101,2,876612,890090,-,13478
382,BUMA.1121.00105,2,3097178,3110704,-,13526
382,BUMA.1121.00061,2,2491960,2505421,+,13461
382,BUMA.1121.00063,2,2501918,2515380,+,13462
382,BUMA.1121.00059,2,1062617,1076127,-,13510
382,BUMA.1121.00058,2,3131962,3145484,+,13522
382,BUMA.1121.00043,2,3023773,3037259,-,13486
382,BUMA.1121.00055,2,139971,153524,-,13553
382,BUMA.1121.00065,2,2597848,2611372,+,13524
382,BUMA.1121.00064,2,2431762,2445271,+,13509
382,BUMA.1121.00047,2,337363,350888,+,13525
382,BUMA.1121.00037,2,2876905,2890391,+,13486
382,BUMA.1121.00106,2,1804376,1817884,+,13508
382,BUMA.1121.00051,2,2522758,2536283,+,13525
382,BUMA.1121.00045,2,2406354,2419860,+,13506
382,BUMA.1121.00056,2,1468691,1482217,-,13526
382,BUMA.1121.00095,2,1388150,1401656,+,13506
382,BUMA.1121.00082,2,2555219,2568682,+,13463
382,BUMA.1121.00001,2,2868465,2881952,-,13487
382,BUMA.1121.00108,2,2770802,2784313,+,13511
382,BUMA.1121.00083,2,1179135,1192598,+,13463
382,BUMA.1121.00080,2,2579209,2592734,+,13525
382,BUMA.1121.00012,2,2394294,2407768,-,13474
383,BUMA.1121.00011,2,1159498,1178507,+,19009
383,BUMA.1121.00009,2,1202020,1221068,+,19048
383,BUMA.1121.00039,2,1407749,1426787,-,19038
383,BUMA.1121.00029,2,1963544,1982577,-,19033
383,BUMA.1121.00021,2,3038558,3058925,+,20367
383,BUMA.1121.00107,2,1234313,1253451,-,19138
383,BUMA.1121.00023,2,2680409,2699429,+,19020
383,BUMA.1121.00067,2,1366794,1385837,-,19043
383,BUMA.1121.00035,2,2041233,2060266,-,19033
383,BUMA.1121.00005,2,1364316,1383371,-,19055
383,BUMA.1121.00100,2,571965,591018,+,19053
383,BUMA.1121.00016,2,1151339,1170381,-,19042
383,BUMA.1121.00099,2,2787212,2806228,+,19016
383,BUMA.1121.00094,2,2581567,2600649,+,19082
383,BUMA.1121.00093,2,375800,394813,-,19013
383,BUMA.1121.00097,2,2378228,2398419,+,20191
383,BUMA.1121.00109,2,2067894,2086847,-,18953
383,BUMA.1121.00018,2,1244907,1263934,-,19027
383,BUMA.1121.00110,2,2504481,2523530,+,19049
383,BUMA.1121.00079,2,2541074,2560151,+,19077
383,BUMA.1121.00075,2,278973,299313,-,20340
383,BUMA.1121.00066,2,2510314,2530658,+,20344
383,BUMA.1121.00089,2,2527381,2546459,+,19078
383,BUMA.1121.00057,2,2678400,2698757,-,20357
383,BUMA.1121.00090,2,279952,299008,+,19056
383,BUMA.1121.00027,2,460123,479143,+,19020
383,BUMA.1121.00062,2,2348279,2367301,-,19022
383,BUMA.1121.00091,2,1074316,1093352,-,19036
383,BUMA.1121.00098,2,2800977,2820021,+,19044
383,BUMA.1121.00092,2,2543149,2562162,+,19013
383,BUMA.1121.00031,2,1725422,1744449,+,19027
383,BUMA.1121.00096,2,2856565,2875583,+,19018
383,BUMA.1121.00073,2,2526689,2547037,+,20348
383,BUMA.1121.00103,2,1182623,1201642,+,19019
383,BUMA.1121.00084,2,1257016,1276061,+,19045
383,BUMA.1121.00014,2,2660074,2679093,+,19019
383,BUMA.1121.00111,2,1872639,1891680,+,19041
383,BUMA.1121.00007,2,2665803,2684810,+,19007
383,BUMA.1121.00072,2,2501155,2521493,+,20338
383,BUMA.1121.00071,2,2526568,2546896,+,20328
383,BUMA.1121.00077,2,1092422,1111473,-,19051
383,BUMA.1121.00003,2,785281,804314,+,19033
383,BUMA.1121.00104,2,2631771,2650792,+,19021
383,BUMA.1121.00074,2,1810277,1830612,-,20335
383,BUMA.1121.00060,2,2821837,2840875,-,19038
383,BUMA.1121.00088,2,2552028,2571089,+,19061
383,BUMA.1121.00053,2,2829054,2848048,+,18994
383,BUMA.1121.00025,2,1068998,1088025,+,19027
383,BUMA.1121.00070,2,2506028,2526368,+,20340
383,BUMA.1121.00049,2,1184749,1203770,+,19021
383,BUMA.1121.00078,2,576614,595615,-,19001
383,BUMA.1121.00069,2,2492586,2512904,+,20318
383,BUMA.1121.00102,2,2572248,2591313,+,19065
383,BUMA.1121.00112,2,1811308,1830379,-,19071
383,BUMA.1121.00041,2,273418,292462,+,19044
383,BUMA.1121.00068,2,1132689,1151733,+,19044
383,BUMA.1121.00076,2,298129,318472,+,20343
383,BUMA.1121.00033,2,95661,114681,+,19020
383,BUMA.1121.00101,2,853184,872244,-,19060
383,BUMA.1121.00105,2,3073776,3092809,-,19033
383,BUMA.1121.00061,2,2509795,2530143,+,20348
383,BUMA.1121.00063,2,2519754,2540069,+,20315
383,BUMA.1121.00059,2,1039194,1058243,-,19049
383,BUMA.1121.00058,2,3149853,3168909,+,19056
383,BUMA.1121.00043,2,3000349,3019405,-,19056
383,BUMA.1121.00055,2,116588,135602,-,19014
383,BUMA.1121.00065,2,2615747,2636095,+,20348
383,BUMA.1121.00064,2,2449646,2468686,+,19040
383,BUMA.1121.00047,2,355263,374348,+,19085
383,BUMA.1121.00037,2,2894765,2913809,+,19044
383,BUMA.1121.00106,2,1822253,1841310,+,19057
383,BUMA.1121.00051,2,2540658,2559736,+,19078
383,BUMA.1121.00045,2,2424229,2443267,+,19038
383,BUMA.1121.00056,2,1445238,1464316,-,19078
383,BUMA.1121.00095,2,1406025,1425107,+,19082
383,BUMA.1121.00082,2,2573056,2593412,+,20356
383,BUMA.1121.00001,2,2845060,2864091,-,19031
383,BUMA.1121.00108,2,2788682,2807754,+,19072
383,BUMA.1121.00083,2,1196972,1217328,+,20356
383,BUMA.1121.00080,2,2597109,2616173,+,19064
383,BUMA.1121.00012,2,2370880,2389920,-,19040
384,BUMA.1121.00011,2,1178509,1223954,+,45445
384,BUMA.1121.00009,2,1221070,1266464,+,45394
384,BUMA.1121.00039,2,1362349,1407748,-,45399
384,BUMA.1121.00029,2,1918028,1963543,-,45515
384,BUMA.1121.00021,2,3058927,3104404,+,45477
384,BUMA.1121.00107,2,1188802,1234312,-,45510
384,BUMA.1121.00023,2,2699431,2744914,+,45483
384,BUMA.1121.00067,2,1321385,1366793,-,45408
384,BUMA.1121.00035,2,1995722,2041232,-,45510
384,BUMA.1121.00005,2,1318927,1364315,-,45388
384,BUMA.1121.00100,2,592606,638142,+,45536
384,BUMA.1121.00016,2,1105829,1151338,-,45509
384,BUMA.1121.00099,2,2806230,2851506,+,45276
384,BUMA.1121.00094,2,2600651,2646054,+,45403
384,BUMA.1121.00093,2,330341,375799,-,45458
384,BUMA.1121.00097,2,2398421,2443932,+,45511
384,BUMA.1121.00109,2,2022434,2067893,-,45459
384,BUMA.1121.00018,2,1199387,1244906,-,45519
384,BUMA.1121.00110,2,2523532,2568857,+,45325
384,BUMA.1121.00079,2,2560153,2605550,+,45397
384,BUMA.1121.00075,2,232019,277383,-,45364
384,BUMA.1121.00066,2,2530660,2576005,+,45345
384,BUMA.1121.00089,2,2546461,2591930,+,45469
384,BUMA.1121.00057,2,2633093,2678399,-,45306
384,BUMA.1121.00090,2,300596,346193,+,45597
384,BUMA.1121.00027,2,479145,524446,+,45301
384,BUMA.1121.00062,2,2302901,2348278,-,45377
384,BUMA.1121.00091,2,1028948,1074315,-,45367
384,BUMA.1121.00098,2,2820023,2865453,+,45430
384,BUMA.1121.00092,2,2562164,2607624,+,45460
384,BUMA.1121.00031,2,1744451,1789846,+,45395
384,BUMA.1121.00096,2,2875585,2921031,+,45446
384,BUMA.1121.00073,2,2547039,2592369,+,45330
384,BUMA.1121.00103,2,1201644,1247116,+,45472
384,BUMA.1121.00084,2,1276063,1321400,+,45337
384,BUMA.1121.00014,2,2679095,2724550,+,45455
384,BUMA.1121.00111,2,1891682,1937185,+,45503
384,BUMA.1121.00007,2,2684812,2730325,+,45513
384,BUMA.1121.00072,2,2521495,2566848,+,45353
384,BUMA.1121.00071,2,2546898,2592240,+,45342
384,BUMA.1121.00077,2,1047096,1092421,-,45325
384,BUMA.1121.00003,2,804316,849820,+,45504
384,BUMA.1121.00104,2,2650794,2696252,+,45458
384,BUMA.1121.00074,2,1764814,1810276,-,45462
384,BUMA.1121.00060,2,2776425,2821836,-,45411
384,BUMA.1121.00088,2,2572675,2618197,+,45522
384,BUMA.1121.00053,2,2848050,2893406,+,45356
384,BUMA.1121.00025,2,1088027,1133483,+,45456
384,BUMA.1121.00070,2,2526370,2571699,+,45329
384,BUMA.1121.00049,2,1203772,1249147,+,45375
384,BUMA.1121.00078,2,531187,576613,-,45426
384,BUMA.1121.00069,2,2512906,2558254,+,45348
384,BUMA.1121.00102,2,2592901,2638381,+,45480
384,BUMA.1121.00112,2,1765864,1811307,-,45443
384,BUMA.1121.00041,2,292464,337853,+,45389
384,BUMA.1121.00068,2,1151735,1197031,+,45296
384,BUMA.1121.00076,2,320061,365426,+,45365
384,BUMA.1121.00033,2,114683,160130,+,45447
384,BUMA.1121.00101,2,807731,853156,-,45425
384,BUMA.1121.00105,2,3028357,3073775,-,45418
384,BUMA.1121.00061,2,2530145,2575476,+,45331
384,BUMA.1121.00063,2,2540071,2585429,+,45358
384,BUMA.1121.00059,2,993808,1039193,-,45385
384,BUMA.1121.00058,2,3168911,3214293,+,45382
384,BUMA.1121.00043,2,2954876,3000348,-,45472
384,BUMA.1121.00055,2,71046,116587,-,45541
384,BUMA.1121.00065,2,2636097,2681551,+,45454
384,BUMA.1121.00064,2,2468688,2514139,+,45451
384,BUMA.1121.00047,2,374350,419773,+,45423
384,BUMA.1121.00037,2,2913811,2959253,+,45442
384,BUMA.1121.00106,2,1841312,1886819,+,45507
384,BUMA.1121.00051,2,2559738,2605145,+,45407
384,BUMA.1121.00045,2,2443269,2488680,+,45411
384,BUMA.1121.00056,2,1399770,1445237,-,45467
384,BUMA.1121.00095,2,1425109,1470567,+,45458
384,BUMA.1121.00082,2,2593414,2638788,+,45374
384,BUMA.1121.00001,2,2799568,2845059,-,45491
384,BUMA.1121.00108,2,2807756,2853221,+,45465
384,BUMA.1121.00083,2,1217330,1262704,+,45374
384,BUMA.1121.00080,2,2616175,2661578,+,45403
384,BUMA.1121.00012,2,2325480,2370879,-,45399
385,BUMA.1121.00011,2,1223955,1229637,+,5682
385,BUMA.1121.00009,2,1266465,1272148,+,5683
385,BUMA.1121.00039,2,1356651,1362347,-,5696
385,BUMA.1121.00029,2,1912312,1918026,-,5714
385,BUMA.1121.00021,2,3104405,3110120,+,5715
385,BUMA.1121.00107,2,1183068,1188800,-,5732
385,BUMA.1121.00023,2,2744915,2750612,+,5697
385,BUMA.1121.00067,2,1315687,1321383,-,5696
385,BUMA.1121.00035,2,1990006,1995720,-,5714
385,BUMA.1121.00005,2,1313220,1318925,-,5705
385,BUMA.1121.00100,2,638143,643840,+,5697
385,BUMA.1121.00016,2,1100113,1105827,-,5714
385,BUMA.1121.00099,2,2851507,2857202,+,5695
385,BUMA.1121.00094,2,2646055,2651720,+,5665
385,BUMA.1121.00093,2,324643,330339,-,5696
385,BUMA.1121.00097,2,2443933,2449648,+,5715
385,BUMA.1121.00109,2,2016750,2022432,-,5682
385,BUMA.1121.00018,2,1193689,1199385,-,5696
385,BUMA.1121.00110,2,2568858,2574523,+,5665
385,BUMA.1121.00079,2,2605551,2611248,+,5697
385,BUMA.1121.00075,2,226322,232017,-,5695
385,BUMA.1121.00066,2,2576006,2581712,+,5706
385,BUMA.1121.00089,2,2591931,2597628,+,5697
385,BUMA.1121.00057,2,2627377,2633091,-,5714
385,BUMA.1121.00090,2,346194,351891,+,5697
385,BUMA.1121.00027,2,524447,530162,+,5715
385,BUMA.1121.00062,2,2297203,2302899,-,5696
385,BUMA.1121.00091,2,1023264,1028946,-,5682
385,BUMA.1121.00098,2,2865454,2871169,+,5715
385,BUMA.1121.00092,2,2607625,2613322,+,5697
385,BUMA.1121.00031,2,1789847,1795562,+,5715
385,BUMA.1121.00096,2,2921032,2926715,+,5683
385,BUMA.1121.00073,2,2592370,2598085,+,5715
385,BUMA.1121.00103,2,1247117,1252814,+,5697
385,BUMA.1121.00084,2,1321401,1327098,+,5697
385,BUMA.1121.00014,2,2724551,2730266,+,5715
385,BUMA.1121.00111,2,1937186,1942883,+,5697
385,BUMA.1121.00007,2,2730326,2736041,+,5715
385,BUMA.1121.00072,2,2566849,2572564,+,5715
385,BUMA.1121.00071,2,2592241,2597941,+,5700
385,BUMA.1121.00077,2,1041430,1047094,-,5664
385,BUMA.1121.00003,2,849821,855504,+,5683
385,BUMA.1121.00104,2,2696253,2701950,+,5697
385,BUMA.1121.00074,2,1759116,1764812,-,5696
385,BUMA.1121.00060,2,2770709,2776423,-,5714
385,BUMA.1121.00088,2,2618198,2623895,+,5697
385,BUMA.1121.00053,2,2893407,2899104,+,5697
385,BUMA.1121.00025,2,1133484,1139181,+,5697
385,BUMA.1121.00070,2,2571700,2577407,+,5707
385,BUMA.1121.00049,2,1249148,1254863,+,5715
385,BUMA.1121.00078,2,525489,531185,-,5696
385,BUMA.1121.00069,2,2558255,2563966,+,5711
385,BUMA.1121.00102,2,2638382,2644079,+,5697
385,BUMA.1121.00112,2,1760186,1765862,-,5676
385,BUMA.1121.00041,2,337854,343569,+,5715
385,BUMA.1121.00068,2,1197032,1202697,+,5665
385,BUMA.1121.00076,2,365427,371124,+,5697
385,BUMA.1121.00033,2,160131,165828,+,5697
385,BUMA.1121.00101,2,802047,807729,-,5682
385,BUMA.1121.00105,2,3022659,3028355,-,5696
385,BUMA.1121.00061,2,2575477,2581192,+,5715
385,BUMA.1121.00063,2,2585430,2591145,+,5715
385,BUMA.1121.00059,2,988110,993806,-,5696
385,BUMA.1121.00058,2,26,5706,+,5680
385,BUMA.1121.00043,2,2949160,2954874,-,5714
385,BUMA.1121.00055,2,65380,71044,-,5664
385,BUMA.1121.00065,2,2681552,2687267,+,5715
385,BUMA.1121.00064,2,2514140,2519837,+,5697
385,BUMA.1121.00047,2,419774,425471,+,5697
385,BUMA.1121.00037,2,2959254,2964969,+,5715
385,BUMA.1121.00106,2,1886820,1892517,+,5697
385,BUMA.1121.00051,2,2605146,2610843,+,5697
385,BUMA.1121.00045,2,2488681,2494396,+,5715
385,BUMA.1121.00056,2,1394072,1399768,-,5696
385,BUMA.1121.00095,2,1470568,1476251,+,5683
385,BUMA.1121.00082,2,2638789,2644504,+,5715
385,BUMA.1121.00001,2,2793852,2799566,-,5714
385,BUMA.1121.00108,2,2853222,2858937,+,5715
385,BUMA.1121.00083,2,1262705,1268420,+,5715
385,BUMA.1121.00080,2,2661579,2667276,+,5697
385,BUMA.1121.00012,2,2319764,2325478,-,5714
386,BUMA.1121.00011,2,1230942,1258533,+,27591
386,BUMA.1121.00009,2,1273352,1300817,+,27465
386,BUMA.1121.00039,2,1327870,1355357,-,27487
386,BUMA.1121.00029,2,1883665,1911018,-,27353
386,BUMA.1121.00021,2,3111414,3138690,+,27276
386,BUMA.1121.00107,2,1154278,1181770,-,27492
386,BUMA.1121.00023,2,2751901,2779292,+,27391
386,BUMA.1121.00067,2,1285691,1314393,-,28702
386,BUMA.1121.00035,2,1961346,1988712,-,27366
386,BUMA.1121.00005,2,1284576,1311928,-,27352
386,BUMA.1121.00100,2,645136,672769,+,27633
386,BUMA.1121.00016,2,1071270,1098824,-,27554
386,BUMA.1121.00099,2,2858480,2886038,+,27558
386,BUMA.1121.00094,2,2653026,2680321,+,27295
386,BUMA.1121.00093,2,296065,323351,-,27286
386,BUMA.1121.00097,2,2450930,2478551,+,27621
386,BUMA.1121.00109,2,1987666,2015162,-,27496
386,BUMA.1121.00018,2,1164974,1192395,-,27421
386,BUMA.1121.00110,2,2575921,2603321,+,27400
386,BUMA.1121.00079,2,2612539,2639904,+,27365
386,BUMA.1121.00075,2,197792,225028,-,27236
386,BUMA.1121.00066,2,2582738,2610056,+,27318
386,BUMA.1121.00089,2,2598920,2626193,+,27273
386,BUMA.1121.00057,2,2598703,2626081,-,27378
386,BUMA.1121.00090,2,353185,380471,+,27286
386,BUMA.1121.00027,2,531458,558650,+,27192
386,BUMA.1121.00062,2,2268633,2295909,-,27276
386,BUMA.1121.00091,2,994601,1021958,-,27357
386,BUMA.1121.00098,2,2872456,2900051,+,27595
386,BUMA.1121.00092,2,2614614,2641899,+,27285
386,BUMA.1121.00031,2,1796856,1824241,+,27385
386,BUMA.1121.00096,2,2927534,2954867,+,27333
386,BUMA.1121.00073,2,2599381,2626720,+,27339
386,BUMA.1121.00103,2,1254109,1281500,+,27391
386,BUMA.1121.00084,2,1328392,1355761,+,27369
386,BUMA.1121.00014,2,2731560,2759075,+,27515
386,BUMA.1121.00111,2,1944172,1971504,+,27332
386,BUMA.1121.00007,2,2737334,2764768,+,27434
386,BUMA.1121.00072,2,2573860,2601212,+,27352
386,BUMA.1121.00071,2,2599237,2626579,+,27342
386,BUMA.1121.00077,2,1012587,1040032,-,27445
386,BUMA.1121.00003,2,856903,884610,+,27707
386,BUMA.1121.00104,2,2703244,2730382,+,27138
386,BUMA.1121.00074,2,1730436,1757822,-,27386
386,BUMA.1121.00060,2,2742113,2769608,-,27495
386,BUMA.1121.00088,2,2625189,2652389,+,27200
386,BUMA.1121.00053,2,2900396,2927729,+,27333
386,BUMA.1121.00025,2,1140475,1167912,+,27437
386,BUMA.1121.00070,2,2578703,2606055,+,27352
386,BUMA.1121.00049,2,1255961,1283340,+,27379
386,BUMA.1121.00078,2,496481,523806,-,27325
386,BUMA.1121.00069,2,2565262,2592600,+,27338
386,BUMA.1121.00102,2,2645373,2672920,+,27547
386,BUMA.1121.00112,2,1731677,1758908,-,27231
386,BUMA.1121.00041,2,344863,372092,+,27229
386,BUMA.1121.00068,2,1203908,1231398,+,27490
386,BUMA.1121.00076,2,372418,399619,+,27201
386,BUMA.1121.00033,2,167122,194311,+,27189
386,BUMA.1121.00101,2,773245,800649,-,27404
386,BUMA.1121.00105,2,2994182,3021365,-,27183
386,BUMA.1121.00061,2,2582488,2609822,+,27334
386,BUMA.1121.00063,2,2592439,2619774,+,27335
386,BUMA.1121.00059,2,959682,986816,-,27134
386,BUMA.1121.00058,2,7012,34278,+,27266
386,BUMA.1121.00043,2,2920314,2947872,-,27558
386,BUMA.1121.00055,2,36902,64074,-,27172
386,BUMA.1121.00065,2,2688561,2715950,+,27389
386,BUMA.1121.00064,2,2521131,2548343,+,27212
386,BUMA.1121.00047,2,426763,454167,+,27404
386,BUMA.1121.00037,2,2966263,2994972,+,28709
386,BUMA.1121.00106,2,1893811,1921164,+,27353
386,BUMA.1121.00051,2,2612135,2639624,+,27489
386,BUMA.1121.00045,2,2495497,2522981,+,27484
386,BUMA.1121.00056,2,1365556,1392780,-,27224
386,BUMA.1121.00095,2,1477650,1505010,+,27360
386,BUMA.1121.00082,2,2645800,2673178,+,27378
386,BUMA.1121.00001,2,2765139,2792558,-,27419
386,BUMA.1121.00108,2,2860039,2887353,+,27314
386,BUMA.1121.00083,2,1269716,1297094,+,27378
386,BUMA.1121.00080,2,2668568,2695716,+,27148
386,BUMA.1121.00012,2,2290906,2318470,-,27564
387,BUMA.1121.00011,2,1262394,1277186,+,14792
387,BUMA.1121.00009,2,1304678,1319474,+,14796
387,BUMA.1121.00039,2,1309243,1324010,-,14767
387,BUMA.1121.00029,2,1863440,1878206,-,14766
387,BUMA.1121.00021,2,3635,18401,+,14766
387,BUMA.1121.00107,2,1135631,1150409,-,14778
387,BUMA.1121.00023,2,2783153,2797909,+,14756
387,BUMA.1121.00067,2,1267045,1281831,-,14786
387,BUMA.1121.00035,2,1942718,1957486,-,14768
387,BUMA.1121.00005,2,1265930,1280716,-,14786
387,BUMA.1121.00100,2,676635,691415,+,14780
387,BUMA.1121.00016,2,1052631,1067410,-,14779
387,BUMA.1121.00099,2,2889899,2904685,+,14786
387,BUMA.1121.00094,2,2684182,2698968,+,14786
387,BUMA.1121.00093,2,277419,292205,-,14786
387,BUMA.1121.00097,2,2482412,2497198,+,14786
387,BUMA.1121.00109,2,1969020,1983806,-,14786
387,BUMA.1121.00018,2,1146346,1161114,-,14768
387,BUMA.1121.00110,2,2607182,2621968,+,14786
387,BUMA.1121.00079,2,2643765,2658551,+,14786
387,BUMA.1121.00075,2,179146,193932,-,14786
387,BUMA.1121.00066,2,2613917,2628702,+,14785
387,BUMA.1121.00089,2,2630054,2644840,+,14786
387,BUMA.1121.00057,2,2580067,2594843,-,14776
387,BUMA.1121.00090,2,384332,399100,+,14768
387,BUMA.1121.00027,2,562511,577284,+,14773
387,BUMA.1121.00062,2,2249987,2264773,-,14786
387,BUMA.1121.00091,2,975955,990741,-,14786
387,BUMA.1121.00098,2,2903912,2918710,+,14798
387,BUMA.1121.00092,2,2645760,2660546,+,14786
387,BUMA.1121.00031,2,1828102,1842870,+,14768
387,BUMA.1121.00096,2,2958737,2973515,+,14778
387,BUMA.1121.00073,2,2630581,2645366,+,14785
387,BUMA.1121.00103,2,1286963,1302983,+,16020
387,BUMA.1121.00084,2,1359622,1374408,+,14786
387,BUMA.1121.00014,2,2762936,2777703,+,14767
387,BUMA.1121.00111,2,1975365,1990151,+,14786
387,BUMA.1121.00007,2,2768629,2783415,+,14786
387,BUMA.1121.00072,2,2605073,2619858,+,14785
387,BUMA.1121.00071,2,2630440,2645225,+,14785
387,BUMA.1121.00077,2,993941,1008727,-,14786
387,BUMA.1121.00003,2,888471,903253,+,14782
387,BUMA.1121.00104,2,2734243,2749029,+,14786
387,BUMA.1121.00074,2,1711790,1726576,-,14786
387,BUMA.1121.00060,2,2723467,2738253,-,14786
387,BUMA.1121.00088,2,2656250,2671036,+,14786
387,BUMA.1121.00053,2,2931590,2946376,+,14786
387,BUMA.1121.00025,2,1171773,1186541,+,14768
387,BUMA.1121.00070,2,2609916,2624701,+,14785
387,BUMA.1121.00049,2,1287201,1301987,+,14786
387,BUMA.1121.00078,2,477835,492621,-,14786
387,BUMA.1121.00069,2,2596461,2611246,+,14785
387,BUMA.1121.00102,2,2676781,2691524,+,14743
387,BUMA.1121.00112,2,1713025,1727817,-,14792
387,BUMA.1121.00041,2,375953,390737,+,14784
387,BUMA.1121.00068,2,1235259,1250043,+,14784
387,BUMA.1121.00076,2,403480,418266,+,14786
387,BUMA.1121.00033,2,198172,212934,+,14762
387,BUMA.1121.00101,2,754610,769396,-,14786
387,BUMA.1121.00105,2,2975536,2990322,-,14786
387,BUMA.1121.00061,2,2613683,2628468,+,14785
387,BUMA.1121.00063,2,2623635,2638420,+,14785
387,BUMA.1121.00059,2,941036,955822,-,14786
387,BUMA.1121.00058,2,38139,52925,+,14786
387,BUMA.1121.00043,2,2901700,2916454,-,14754
387,BUMA.1121.00055,2,17020,33042,-,16022
387,BUMA.1121.00065,2,2719811,2734604,+,14793
387,BUMA.1121.00064,2,2552204,2566990,+,14786
387,BUMA.1121.00047,2,458028,472814,+,14786
387,BUMA.1121.00037,2,2998833,3013598,+,14765
387,BUMA.1121.00106,2,1925025,1939811,+,14786
387,BUMA.1121.00051,2,2643485,2658271,+,14786
387,BUMA.1121.00045,2,2526842,2541628,+,14786
387,BUMA.1121.00056,2,1346910,1361696,-,14786
387,BUMA.1121.00095,2,1508871,1523656,+,14785
387,BUMA.1121.00082,2,2677039,2691824,+,14785
387,BUMA.1121.00001,2,2746511,2761279,-,14768
387,BUMA.1121.00108,2,2891222,2906000,+,14778
387,BUMA.1121.00083,2,1300955,1315740,+,14785
387,BUMA.1121.00080,2,2701173,2715959,+,14786
387,BUMA.1121.00012,2,2270681,2285447,-,14766
388,BUMA.1121.00011,2,1277187,1284072,+,6885
388,BUMA.1121.00009,2,1319475,1326360,+,6885
388,BUMA.1121.00039,2,1302374,1309241,-,6867
388,BUMA.1121.00029,2,1856572,1863438,-,6866
388,BUMA.1121.00021,2,18402,25269,+,6867
388,BUMA.1121.00107,2,1128699,1135629,-,6930
388,BUMA.1121.00023,2,2797910,2804777,+,6867
388,BUMA.1121.00067,2,1260158,1267043,-,6885
388,BUMA.1121.00035,2,1935849,1942716,-,6867
388,BUMA.1121.00005,2,1259043,1265928,-,6885
388,BUMA.1121.00100,2,691416,698292,+,6876
388,BUMA.1121.00016,2,1045762,1052629,-,6867
388,BUMA.1121.00099,2,2904686,2911571,+,6885
388,BUMA.1121.00094,2,2698969,2705854,+,6885
388,BUMA.1121.00093,2,270550,277417,-,6867
388,BUMA.1121.00097,2,2497199,2504066,+,6867
388,BUMA.1121.00109,2,1962141,1969018,-,6877
388,BUMA.1121.00018,2,1139469,1146344,-,6875
388,BUMA.1121.00110,2,2621969,2628862,+,6893
388,BUMA.1121.00079,2,2658552,2665427,+,6875
388,BUMA.1121.00075,2,172286,179144,-,6858
388,BUMA.1121.00066,2,2628703,2635570,+,6867
388,BUMA.1121.00089,2,2644841,2651708,+,6867
388,BUMA.1121.00057,2,2573198,2580065,-,6867
388,BUMA.1121.00090,2,399101,405968,+,6867
388,BUMA.1121.00027,2,577285,584151,+,6866
388,BUMA.1121.00062,2,2243118,2249985,-,6867
388,BUMA.1121.00091,2,969068,975953,-,6885
388,BUMA.1121.00098,2,2918711,2925596,+,6885
388,BUMA.1121.00092,2,2660547,2667414,+,6867
388,BUMA.1121.00031,2,1842871,1849748,+,6877
388,BUMA.1121.00096,2,2973516,2980384,+,6868
388,BUMA.1121.00073,2,2645367,2652234,+,6867
388,BUMA.1121.00103,2,1302984,1309853,+,6869
388,BUMA.1121.00084,2,1374409,1381234,+,6825
388,BUMA.1121.00014,2,2777704,2784581,+,6877
388,BUMA.1121.00111,2,1990152,1997019,+,6867
388,BUMA.1121.00007,2,2783416,2790292,+,6876
388,BUMA.1121.00072,2,2619859,2626726,+,6867
388,BUMA.1121.00071,2,2645226,2652093,+,6867
388,BUMA.1121.00077,2,987046,993939,-,6893
388,BUMA.1121.00003,2,903254,910130,+,6876
388,BUMA.1121.00104,2,2749030,2755897,+,6867
388,BUMA.1121.00074,2,1704912,1711788,-,6876
388,BUMA.1121.00060,2,2716562,2723465,-,6903
388,BUMA.1121.00088,2,2671037,2677913,+,6876
388,BUMA.1121.00053,2,2946377,2953262,+,6885
388,BUMA.1121.00025,2,1186542,1193417,+,6875
388,BUMA.1121.00070,2,2624702,2631569,+,6867
388,BUMA.1121.00049,2,1301988,1308864,+,6876
388,BUMA.1121.00078,2,470948,477833,-,6885
388,BUMA.1121.00069,2,2611247,2618114,+,6867
388,BUMA.1121.00102,2,2692828,2699737,+,6909
388,BUMA.1121.00112,2,1706155,1713023,-,6868
388,BUMA.1121.00041,2,390738,397632,+,6894
388,BUMA.1121.00068,2,1250044,1256920,+,6876
388,BUMA.1121.00076,2,418267,425125,+,6858
388,BUMA.1121.00033,2,212935,219802,+,6867
388,BUMA.1121.00101,2,747741,754608,-,6867
388,BUMA.1121.00105,2,2968640,2975534,-,6894
388,BUMA.1121.00061,2,2628469,2635336,+,6867
388,BUMA.1121.00063,2,2638421,2645288,+,6867
388,BUMA.1121.00059,2,934149,941034,-,6885
388,BUMA.1121.00058,2,52926,59784,+,6858
388,BUMA.1121.00043,2,2894831,2901698,-,6867
388,BUMA.1121.00055,2,10133,17018,-,6885
388,BUMA.1121.00065,2,2734605,2741481,+,6876
388,BUMA.1121.00064,2,2566991,2573867,+,6876
388,BUMA.1121.00047,2,472815,479682,+,6867
388,BUMA.1121.00037,2,3013599,3020476,+,6877
388,BUMA.1121.00106,2,1939812,1946697,+,6885
388,BUMA.1121.00051,2,2658272,2665139,+,6867
388,BUMA.1121.00045,2,2541629,2548532,+,6903
388,BUMA.1121.00056,2,1340041,1346908,-,6867
388,BUMA.1121.00095,2,1523657,1530544,+,6887
388,BUMA.1121.00082,2,2691825,2698692,+,6867
388,BUMA.1121.00001,2,2739642,2746509,-,6867
388,BUMA.1121.00108,2,2906001,2912877,+,6876
388,BUMA.1121.00083,2,1315741,1322608,+,6867
388,BUMA.1121.00080,2,2715960,2722827,+,6867
388,BUMA.1121.00012,2,2263812,2270679,-,6867
389,BUMA.1121.00011,2,1284635,1288194,+,3559
389,BUMA.1121.00009,2,1326923,1330484,+,3561
389,BUMA.1121.00039,2,1298250,1301811,-,3561
389,BUMA.1121.00029,2,1852448,1856009,-,3561
389,BUMA.1121.00021,2,25832,29394,+,3562
389,BUMA.1121.00107,2,1124605,1128136,-,3531
389,BUMA.1121.00023,2,2805340,2808901,+,3561
389,BUMA.1121.00067,2,1256034,1259595,-,3561
389,BUMA.1121.00035,2,1931725,1935286,-,3561
389,BUMA.1121.00005,2,1254919,1258480,-,3561
389,BUMA.1121.00100,2,698855,702416,+,3561
389,BUMA.1121.00016,2,1041638,1045199,-,3561
389,BUMA.1121.00099,2,2912134,2915695,+,3561
389,BUMA.1121.00094,2,2706417,2709978,+,3561
389,BUMA.1121.00093,2,266434,269987,-,3553
389,BUMA.1121.00097,2,2504629,2508190,+,3561
389,BUMA.1121.00109,2,1958019,1961578,-,3559
389,BUMA.1121.00018,2,1135347,1138906,-,3559
389,BUMA.1121.00110,2,2629425,2632986,+,3561
389,BUMA.1121.00079,2,2665990,2669551,+,3561
389,BUMA.1121.00075,2,168162,171730,-,3568
389,BUMA.1121.00066,2,2636133,2639694,+,3561
389,BUMA.1121.00089,2,2652271,2655832,+,3561
389,BUMA.1121.00057,2,2569074,2572635,-,3561
389,BUMA.1121.00090,2,406531,410092,+,3561
389,BUMA.1121.00027,2,584714,588275,+,3561
389,BUMA.1121.00062,2,2238994,2242555,-,3561
389,BUMA.1121.00091,2,964944,968505,-,3561
389,BUMA.1121.00098,2,2926159,2929720,+,3561
389,BUMA.1121.00092,2,2667977,2671530,+,3553
389,BUMA.1121.00031,2,1850311,1853872,+,3561
389,BUMA.1121.00096,2,2980947,2984508,+,3561
389,BUMA.1121.00073,2,2652797,2656358,+,3561
389,BUMA.1121.00103,2,1310416,1313991,+,3575
389,BUMA.1121.00084,2,1381797,1385358,+,3561
389,BUMA.1121.00014,2,2785144,2788705,+,3561
389,BUMA.1121.00111,2,1997582,2001143,+,3561
389,BUMA.1121.00007,2,2790855,2794416,+,3561
389,BUMA.1121.00072,2,2627289,2630850,+,3561
389,BUMA.1121.00071,2,2652656,2656217,+,3561
389,BUMA.1121.00077,2,982922,986483,-,3561
389,BUMA.1121.00003,2,910693,914254,+,3561
389,BUMA.1121.00104,2,2756454,2760021,+,3567
389,BUMA.1121.00074,2,1700790,1704349,-,3559
389,BUMA.1121.00060,2,2712438,2715999,-,3561
389,BUMA.1121.00088,2,2678476,2682037,+,3561
389,BUMA.1121.00053,2,2953825,2957386,+,3561
389,BUMA.1121.00025,2,1193980,1197539,+,3559
389,BUMA.1121.00070,2,2632132,2635693,+,3561
389,BUMA.1121.00049,2,1309427,1312986,+,3559
389,BUMA.1121.00078,2,466824,470385,-,3561
389,BUMA.1121.00069,2,2618677,2622238,+,3561
389,BUMA.1121.00102,2,2700300,2703861,+,3561
389,BUMA.1121.00112,2,1702033,1705592,-,3559
389,BUMA.1121.00041,2,398195,401756,+,3561
389,BUMA.1121.00068,2,1257483,1261044,+,3561
389,BUMA.1121.00076,2,425682,429249,+,3567
389,BUMA.1121.00033,2,220365,223926,+,3561
389,BUMA.1121.00101,2,743604,747178,-,3574
389,BUMA.1121.00105,2,2964518,2968077,-,3559
389,BUMA.1121.00061,2,2635899,2639460,+,3561
389,BUMA.1121.00063,2,2645851,2649412,+,3561
389,BUMA.1121.00059,2,930025,933586,-,3561
389,BUMA.1121.00058,2,60347,63908,+,3561
389,BUMA.1121.00043,2,2890707,2894268,-,3561
389,BUMA.1121.00055,2,6039,9570,-,3531
389,BUMA.1121.00065,2,2742044,2745605,+,3561
389,BUMA.1121.00064,2,2574430,2577989,+,3559
389,BUMA.1121.00047,2,480245,483806,+,3561
389,BUMA.1121.00037,2,3021039,3024600,+,3561
389,BUMA.1121.00106,2,1947260,1950821,+,3561
389,BUMA.1121.00051,2,2665702,2669263,+,3561
389,BUMA.1121.00045,2,2549095,2552656,+,3561
389,BUMA.1121.00056,2,1335917,1339478,-,3561
389,BUMA.1121.00095,2,1531107,1534638,+,3531
389,BUMA.1121.00082,2,2699255,2702816,+,3561
389,BUMA.1121.00001,2,2735518,2739079,-,3561
389,BUMA.1121.00108,2,2913440,2917001,+,3561
389,BUMA.1121.00083,2,1323171,1326732,+,3561
389,BUMA.1121.00080,2,2723390,2726951,+,3561
389,BUMA.1121.00012,2,2259688,2263249,-,3561
390,BUMA.1121.00011,2,1288196,1294326,+,6130
390,BUMA.1121.00009,2,1330486,1336552,+,6066
390,BUMA.1121.00039,2,1292177,1298249,-,6072
390,BUMA.1121.00029,2,1846375,1852447,-,6072
390,BUMA.1121.00021,2,29396,35468,+,6072
390,BUMA.1121.00107,2,1118513,1124604,-,6091
390,BUMA.1121.00023,2,2808903,2814975,+,6072
390,BUMA.1121.00067,2,1249936,1256033,-,6097
390,BUMA.1121.00035,2,1925652,1931724,-,6072
390,BUMA.1121.00005,2,1248846,1254918,-,6072
390,BUMA.1121.00100,2,702418,708515,+,6097
390,BUMA.1121.00016,2,1035571,1041637,-,6066
390,BUMA.1121.00099,2,2915697,2921763,+,6066
390,BUMA.1121.00094,2,2709980,2716052,+,6072
390,BUMA.1121.00093,2,260361,266433,-,6072
390,BUMA.1121.00097,2,2508192,2514264,+,6072
390,BUMA.1121.00109,2,1951952,1958018,-,6066
390,BUMA.1121.00018,2,1129274,1135346,-,6072
390,BUMA.1121.00110,2,2632988,2639054,+,6066
390,BUMA.1121.00079,2,2669553,2675625,+,6072
390,BUMA.1121.00075,2,162089,168161,-,6072
390,BUMA.1121.00066,2,2639696,2645798,+,6102
390,BUMA.1121.00089,2,2655834,2661931,+,6097
390,BUMA.1121.00057,2,2562970,2569073,-,6103
390,BUMA.1121.00090,2,410094,416166,+,6072
390,BUMA.1121.00027,2,588277,594380,+,6103
390,BUMA.1121.00062,2,2232915,2238993,-,6078
390,BUMA.1121.00091,2,958871,964943,-,6072
390,BUMA.1121.00098,2,2929722,2935788,+,6066
390,BUMA.1121.00092,2,2671532,2677604,+,6072
390,BUMA.1121.00031,2,1853874,1859946,+,6072
390,BUMA.1121.00096,2,2984510,2990582,+,6072
390,BUMA.1121.00073,2,2656360,2662462,+,6102
390,BUMA.1121.00103,2,1315587,1321640,+,6053
390,BUMA.1121.00084,2,1385360,1391432,+,6072
390,BUMA.1121.00014,2,2788707,2794779,+,6072
390,BUMA.1121.00111,2,2001145,2007217,+,6072
390,BUMA.1121.00007,2,2794418,2800562,+,6144
390,BUMA.1121.00072,2,2630852,2636955,+,6103
390,BUMA.1121.00071,2,2656219,2662322,+,6103
390,BUMA.1121.00077,2,976855,982921,-,6066
390,BUMA.1121.00003,2,914256,920353,+,6097
390,BUMA.1121.00104,2,2760023,2766095,+,6072
390,BUMA.1121.00074,2,1694692,1700789,-,6097
390,BUMA.1121.00060,2,2706340,2712437,-,6097
390,BUMA.1121.00088,2,2682039,2688117,+,6078
390,BUMA.1121.00053,2,2957388,2963460,+,6072
390,BUMA.1121.00025,2,1197541,1203613,+,6072
390,BUMA.1121.00070,2,2635695,2641798,+,6103
390,BUMA.1121.00049,2,1312988,1319085,+,6097
390,BUMA.1121.00078,2,460751,466823,-,6072
390,BUMA.1121.00069,2,2622240,2628341,+,6101
390,BUMA.1121.00102,2,2703863,2709928,+,6065
390,BUMA.1121.00112,2,1695966,1702032,-,6066
390,BUMA.1121.00041,2,401758,407824,+,6066
390,BUMA.1121.00068,2,1261046,1267137,+,6091
390,BUMA.1121.00076,2,429251,435323,+,6072
390,BUMA.1121.00033,2,223928,230000,+,6072
390,BUMA.1121.00101,2,735905,742007,-,6102
390,BUMA.1121.00105,2,2958420,2964517,-,6097
390,BUMA.1121.00061,2,2639462,2645565,+,6103
390,BUMA.1121.00063,2,2649414,2655516,+,6102
390,BUMA.1121.00059,2,923952,930024,-,6072
390,BUMA.1121.00058,2,63910,70007,+,6097
390,BUMA.1121.00043,2,2884634,2890706,-,6072
390,BUMA.1121.00055,2,1,6038,-,6037
390,BUMA.1121.00065,2,2745607,2751678,+,6071
390,BUMA.1121.00064,2,2577991,2584088,+,6097
390,BUMA.1121.00047,2,483808,489905,+,6097
390,BUMA.1121.00037,2,3024602,3030674,+,6072
390,BUMA.1121.00106,2,1950823,1956895,+,6072
390,BUMA.1121.00051,2,2669265,2675362,+,6097
390,BUMA.1121.00045,2,2552658,2558755,+,6097
390,BUMA.1121.00056,2,1329819,1335916,-,6097
390,BUMA.1121.00095,2,1534640,1540712,+,6072
390,BUMA.1121.00082,2,2702818,2708921,+,6103
390,BUMA.1121.00001,2,2729445,2735517,-,6072
390,BUMA.1121.00108,2,2917003,2923110,+,6107
390,BUMA.1121.00083,2,1326734,1332837,+,6103
390,BUMA.1121.00080,2,2726953,2733050,+,6097
390,BUMA.1121.00012,2,2253615,2259687,-,6072
391,BUMA.1121.00011,2,1310647,1323329,+,12682
391,BUMA.1121.00009,2,1352872,1365555,+,12683
391,BUMA.1121.00039,2,1263208,1275856,-,12648
391,BUMA.1121.00029,2,1817374,1830054,-,12680
391,BUMA.1121.00021,2,51787,64453,+,12666
391,BUMA.1121.00107,2,1089454,1102206,-,12752
391,BUMA.1121.00023,2,2831294,2843973,+,12679
391,BUMA.1121.00067,2,1227408,1240122,-,12714
391,BUMA.1121.00035,2,1896639,1909331,-,12692
391,BUMA.1121.00005,2,1219818,1232535,-,12717
391,BUMA.1121.00100,2,724832,737538,+,12706
391,BUMA.1121.00016,2,1006570,1019250,-,12680
391,BUMA.1121.00099,2,2938069,2950788,+,12719
391,BUMA.1121.00094,2,2732374,2745123,+,12749
391,BUMA.1121.00093,2,237871,250547,-,12676
391,BUMA.1121.00097,2,2530583,2543299,+,12716
391,BUMA.1121.00109,2,1922883,1935631,-,12748
391,BUMA.1121.00018,2,1100237,1112954,-,12717
391,BUMA.1121.00110,2,2655374,2668144,+,12770
391,BUMA.1121.00079,2,2691945,2704639,+,12694
391,BUMA.1121.00075,2,133063,145769,-,12706
391,BUMA.1121.00066,2,2655611,2668313,+,12702
391,BUMA.1121.00089,2,2678253,2691003,+,12750
391,BUMA.1121.00057,2,2540458,2553156,-,12698
391,BUMA.1121.00090,2,432486,445188,+,12702
391,BUMA.1121.00027,2,604193,616897,+,12704
391,BUMA.1121.00062,2,2203895,2216594,-,12699
391,BUMA.1121.00091,2,929849,942550,-,12701
391,BUMA.1121.00098,2,2952108,2964824,+,12716
391,BUMA.1121.00092,2,2687417,2700094,+,12677
391,BUMA.1121.00031,2,1876266,1888992,+,12726
391,BUMA.1121.00096,2,3006902,3019584,+,12682
391,BUMA.1121.00073,2,2672275,2684977,+,12702
391,BUMA.1121.00103,2,1337959,1350658,+,12699
391,BUMA.1121.00084,2,1407752,1420429,+,12677
391,BUMA.1121.00014,2,2811099,2823808,+,12709
391,BUMA.1121.00111,2,2027400,2040096,+,12696
391,BUMA.1121.00007,2,2816882,2829609,+,12727
391,BUMA.1121.00072,2,2646768,2659466,+,12698
391,BUMA.1121.00071,2,2672135,2684833,+,12698
391,BUMA.1121.00077,2,947764,960533,-,12769
391,BUMA.1121.00003,2,936650,949319,+,12669
391,BUMA.1121.00104,2,2782414,2795127,+,12713
391,BUMA.1121.00074,2,1665660,1678364,-,12704
391,BUMA.1121.00060,2,2677309,2690026,-,12717
391,BUMA.1121.00088,2,2697930,2710593,+,12663
391,BUMA.1121.00053,2,2979780,2992456,+,12676
391,BUMA.1121.00025,2,1219932,1232651,+,12719
391,BUMA.1121.00070,2,2651611,2664313,+,12702
391,BUMA.1121.00049,2,1335404,1348123,+,12719
391,BUMA.1121.00078,2,431714,444430,-,12716
391,BUMA.1121.00069,2,2638154,2650852,+,12698
391,BUMA.1121.00102,2,2726248,2738929,+,12681
391,BUMA.1121.00112,2,1666982,1679646,-,12664
391,BUMA.1121.00041,2,424144,436835,+,12691
391,BUMA.1121.00068,2,1283452,1296155,+,12703
391,BUMA.1121.00076,2,451642,464350,+,12708
391,BUMA.1121.00033,2,246316,259018,+,12702
391,BUMA.1121.00101,2,706934,719583,-,12649
391,BUMA.1121.00105,2,2929391,2942099,-,12708
391,BUMA.1121.00061,2,2655378,2668061,+,12683
391,BUMA.1121.00063,2,2665329,2678027,+,12698
391,BUMA.1121.00059,2,901462,914138,-,12676
391,BUMA.1121.00058,2,86327,99030,+,12703
391,BUMA.1121.00043,2,2855623,2868313,-,12690
391,BUMA.1121.00055,2,3128152,3140849,-,12697
391,BUMA.1121.00065,2,2767996,2780692,+,12696
391,BUMA.1121.00064,2,2600470,2613185,+,12715
391,BUMA.1121.00047,2,506227,518950,+,12723
391,BUMA.1121.00037,2,3046994,3059669,+,12675
391,BUMA.1121.00106,2,1973215,1985878,+,12663
391,BUMA.1121.00051,2,2691684,2704421,+,12737
391,BUMA.1121.00045,2,2575068,2587786,+,12718
391,BUMA.1121.00056,2,1300747,1313496,-,12749
391,BUMA.1121.00095,2,1557031,1569692,+,12661
391,BUMA.1121.00082,2,2718734,2731436,+,12702
391,BUMA.1121.00001,2,2700434,2713126,-,12692
391,BUMA.1121.00108,2,2939430,2952079,+,12649
391,BUMA.1121.00083,2,1342650,1355352,+,12702
391,BUMA.1121.00080,2,2749372,2762130,+,12758
391,BUMA.1121.00012,2,2224623,2237295,-,12672
392,BUMA.1121.00011,2,1324272,1328192,+,3920
392,BUMA.1121.00009,2,1366498,1370419,+,3921
392,BUMA.1121.00039,2,1258306,1262264,-,3958
392,BUMA.1121.00029,2,1812518,1816430,-,3912
392,BUMA.1121.00021,2,65404,69357,+,3953
392,BUMA.1121.00107,2,1084580,1088510,-,3930
392,BUMA.1121.00023,2,2844916,2848861,+,3945
392,BUMA.1121.00067,2,1222537,1226464,-,3927
392,BUMA.1121.00035,2,1891783,1895695,-,3912
392,BUMA.1121.00005,2,1214883,1218874,-,3991
392,BUMA.1121.00100,2,738481,742403,+,3922
392,BUMA.1121.00016,2,1001698,1005626,-,3928
392,BUMA.1121.00099,2,2951731,2955685,+,3954
392,BUMA.1121.00094,2,2746066,2749957,+,3891
392,BUMA.1121.00093,2,232982,236927,-,3945
392,BUMA.1121.00097,2,2544242,2548161,+,3919
392,BUMA.1121.00109,2,1917999,1921939,-,3940
392,BUMA.1121.00018,2,1095381,1099293,-,3912
392,BUMA.1121.00110,2,2669087,2673031,+,3944
392,BUMA.1121.00079,2,2705582,2709473,+,3891
392,BUMA.1121.00075,2,128208,132119,-,3911
392,BUMA.1121.00066,2,2669256,2673162,+,3906
392,BUMA.1121.00089,2,2691946,2695837,+,3891
392,BUMA.1121.00057,2,2535609,2539514,-,3905
392,BUMA.1121.00090,2,446131,450076,+,3945
392,BUMA.1121.00027,2,617840,621777,+,3937
392,BUMA.1121.00062,2,2199008,2202951,-,3943
392,BUMA.1121.00091,2,924983,928905,-,3922
392,BUMA.1121.00098,2,2965767,2969701,+,3934
392,BUMA.1121.00092,2,2701037,2704983,+,3946
392,BUMA.1121.00031,2,1889935,1893872,+,3937
392,BUMA.1121.00096,2,3020527,3024493,+,3966
392,BUMA.1121.00073,2,2685920,2689826,+,3906
392,BUMA.1121.00103,2,1351601,1355559,+,3958
392,BUMA.1121.00084,2,1421375,1425345,+,3970
392,BUMA.1121.00014,2,2824751,2828672,+,3921
392,BUMA.1121.00111,2,2041039,2044931,+,3892
392,BUMA.1121.00007,2,2830552,2834518,+,3966
392,BUMA.1121.00072,2,2660409,2664315,+,3906
392,BUMA.1121.00071,2,2685776,2689682,+,3906
392,BUMA.1121.00077,2,942877,946820,-,3943
392,BUMA.1121.00003,2,950262,954191,+,3929
392,BUMA.1121.00104,2,2796070,2800016,+,3946
392,BUMA.1121.00074,2,1660772,1664716,-,3944
392,BUMA.1121.00060,2,2672443,2676365,-,3922
392,BUMA.1121.00088,2,2711539,2715468,+,3929
392,BUMA.1121.00088,2,2716406,2720331,+,3925
392,BUMA.1121.00053,2,2993399,2997333,+,3934
392,BUMA.1121.00025,2,1233594,1237507,+,3913
392,BUMA.1121.00070,2,2665256,2669162,+,3906
392,BUMA.1121.00049,2,1349066,1353012,+,3946
392,BUMA.1121.00078,2,426807,430770,-,3963
392,BUMA.1121.00069,2,2651795,2655701,+,3906
392,BUMA.1121.00102,2,2739872,2743808,+,3936
392,BUMA.1121.00112,2,1662095,1666038,-,3943
392,BUMA.1121.00041,2,437778,441707,+,3929
392,BUMA.1121.00068,2,1297098,1301064,+,3966
392,BUMA.1121.00076,2,465293,469206,+,3913
392,BUMA.1121.00033,2,259961,263882,+,3921
392,BUMA.1121.00101,2,702064,705990,-,3926
392,BUMA.1121.00105,2,2924549,2928447,-,3898
392,BUMA.1121.00061,2,2669004,2672910,+,3906
392,BUMA.1121.00063,2,2678970,2682876,+,3906
392,BUMA.1121.00059,2,896591,900518,-,3927
392,BUMA.1121.00058,2,99973,103925,+,3952
392,BUMA.1121.00043,2,2850735,2854679,-,3944
392,BUMA.1121.00055,2,3123274,3127208,-,3934
392,BUMA.1121.00065,2,2781635,2785607,+,3972
392,BUMA.1121.00064,2,2614128,2618074,+,3946
392,BUMA.1121.00047,2,519893,523839,+,3946
392,BUMA.1121.00037,2,3060612,3064541,+,3929
392,BUMA.1121.00106,2,1986824,1990777,+,3953
392,BUMA.1121.00051,2,2705364,2709255,+,3891
392,BUMA.1121.00045,2,2588729,2592652,+,3923
392,BUMA.1121.00056,2,1295913,1299803,-,3890
392,BUMA.1121.00095,2,1570633,1574528,+,3895
392,BUMA.1121.00082,2,2732379,2736285,+,3906
392,BUMA.1121.00001,2,2695538,2699490,-,3952
392,BUMA.1121.00108,2,2953022,2956955,+,3933
392,BUMA.1121.00083,2,1356295,1360201,+,3906
392,BUMA.1121.00080,2,2763073,2766964,+,3891
392,BUMA.1121.00012,2,2219775,2223679,-,3904
393,BUMA.1121.00011,2,1329128,1344400,+,15272
393,BUMA.1121.00009,2,1371355,1386627,+,15272
393,BUMA.1121.00039,2,1240724,1257369,-,16645
393,BUMA.1121.00029,2,1796292,1811581,-,15289
393,BUMA.1121.00021,2,70293,86938,+,16645
393,BUMA.1121.00107,2,1068371,1083643,-,15272
393,BUMA.1121.00023,2,2849797,2866452,+,16655
393,BUMA.1121.00067,2,1206314,1221600,-,15286
393,BUMA.1121.00035,2,1875557,1890846,-,15289
393,BUMA.1121.00005,2,1198640,1213946,-,15306
393,BUMA.1121.00100,2,743339,758605,+,15266
393,BUMA.1121.00016,2,984132,1000761,-,16629
393,BUMA.1121.00099,2,2956621,2971899,+,15278
393,BUMA.1121.00094,2,2750893,2767516,+,16623
393,BUMA.1121.00093,2,216745,232045,-,15300
393,BUMA.1121.00097,2,2549097,2564384,+,15287
393,BUMA.1121.00109,2,1901790,1917062,-,15272
393,BUMA.1121.00018,2,1079160,1094444,-,15284
393,BUMA.1121.00110,2,2673967,2689239,+,15272
393,BUMA.1121.00079,2,2710409,2727032,+,16623
393,BUMA.1121.00075,2,112007,127271,-,15264
393,BUMA.1121.00066,2,2674098,2689368,+,15270
393,BUMA.1121.00089,2,2696773,2713396,+,16623
393,BUMA.1121.00057,2,2519402,2534672,-,15270
393,BUMA.1121.00090,2,451012,466308,+,15296
393,BUMA.1121.00027,2,622712,638007,+,15295
393,BUMA.1121.00062,2,2182801,2198071,-,15270
393,BUMA.1121.00091,2,908769,924046,-,15277
393,BUMA.1121.00098,2,2970637,2985909,+,15272
393,BUMA.1121.00092,2,2705919,2721219,+,15300
393,BUMA.1121.00031,2,1894808,1910097,+,15289
393,BUMA.1121.00096,2,3025429,3040701,+,15272
393,BUMA.1121.00073,2,2690762,2706032,+,15270
393,BUMA.1121.00103,2,1356495,1371674,+,15179
393,BUMA.1121.00084,2,1426281,1441571,+,15290
393,BUMA.1121.00014,2,2829608,2844892,+,15284
393,BUMA.1121.00111,2,2045867,2061151,+,15284
393,BUMA.1121.00007,2,2835454,2850732,+,15278
393,BUMA.1121.00072,2,2665251,2680521,+,15270
393,BUMA.1121.00071,2,2690618,2705888,+,15270
393,BUMA.1121.00077,2,926670,941940,-,15270
393,BUMA.1121.00003,2,955127,970429,+,15302
393,BUMA.1121.00104,2,2800952,2816234,+,15282
393,BUMA.1121.00074,2,1644545,1659835,-,15290
393,BUMA.1121.00060,2,2656233,2671506,-,15273
393,BUMA.1121.00088,2,2721267,2736557,+,15290
393,BUMA.1121.00053,2,2998269,3013554,+,15285
393,BUMA.1121.00025,2,1238443,1253727,+,15284
393,BUMA.1121.00070,2,2670098,2685368,+,15270
393,BUMA.1121.00049,2,1353948,1369233,+,15285
393,BUMA.1121.00078,2,410593,425870,-,15277
393,BUMA.1121.00069,2,2656637,2671907,+,15270
393,BUMA.1121.00102,2,2744744,2760016,+,15272
393,BUMA.1121.00112,2,1645886,1661158,-,15272
393,BUMA.1121.00041,2,442643,457926,+,15283
393,BUMA.1121.00068,2,1302000,1317293,+,15293
393,BUMA.1121.00076,2,470142,485406,+,15264
393,BUMA.1121.00033,2,264818,280108,+,15290
393,BUMA.1121.00101,2,685855,701127,-,15272
393,BUMA.1121.00105,2,2908342,2923612,-,15270
393,BUMA.1121.00061,2,2673846,2689116,+,15270
393,BUMA.1121.00063,2,2683812,2699082,+,15270
393,BUMA.1121.00059,2,880384,895654,-,15270
393,BUMA.1121.00058,2,104861,120146,+,15285
393,BUMA.1121.00043,2,2833334,2849798,-,16464
393,BUMA.1121.00055,2,3107035,3122337,-,15302
393,BUMA.1121.00065,2,2786543,2801812,+,15269
393,BUMA.1121.00064,2,2619010,2634300,+,15290
393,BUMA.1121.00047,2,524775,541398,+,16623
393,BUMA.1121.00037,2,3065477,3080756,+,15279
393,BUMA.1121.00106,2,1991713,2008365,+,16652
393,BUMA.1121.00051,2,2710191,2726814,+,16623
393,BUMA.1121.00045,2,2593588,2608861,+,15273
393,BUMA.1121.00056,2,1278353,1294976,-,16623
393,BUMA.1121.00095,2,1575464,1590736,+,15272
393,BUMA.1121.00082,2,2737221,2752491,+,15270
393,BUMA.1121.00001,2,2677958,2694601,-,16643
393,BUMA.1121.00108,2,2957891,2973163,+,15272
393,BUMA.1121.00083,2,1361137,1376407,+,15270
393,BUMA.1121.00080,2,2767900,2784523,+,16623
393,BUMA.1121.00012,2,2202195,2218838,-,16643
394,BUMA.1121.00011,2,1344853,1353023,+,8170
394,BUMA.1121.00009,2,1387072,1395242,+,8170
394,BUMA.1121.00039,2,1232104,1240271,-,8167
394,BUMA.1121.00029,2,1787670,1795839,-,8169
394,BUMA.1121.00021,2,87391,95561,+,8170
394,BUMA.1121.00107,2,1059758,1067927,-,8169
394,BUMA.1121.00023,2,2866894,2875075,+,8181
394,BUMA.1121.00067,2,1197697,1205866,-,8169
394,BUMA.1121.00035,2,1866934,1875104,-,8170
394,BUMA.1121.00005,2,1190018,1198187,-,8169
394,BUMA.1121.00100,2,759056,767226,+,8170
394,BUMA.1121.00016,2,975509,983679,-,8170
394,BUMA.1121.00099,2,2972346,2980516,+,8170
394,BUMA.1121.00094,2,2767964,2776134,+,8170
394,BUMA.1121.00093,2,208129,216298,-,8169
394,BUMA.1121.00097,2,2564837,2573007,+,8170
394,BUMA.1121.00109,2,1893170,1901339,-,8169
394,BUMA.1121.00018,2,1070547,1078707,-,8160
394,BUMA.1121.00110,2,2689686,2697856,+,8170
394,BUMA.1121.00079,2,2727479,2735647,+,8168
394,BUMA.1121.00075,2,103385,111555,-,8170
394,BUMA.1121.00066,2,2689821,2697991,+,8170
394,BUMA.1121.00089,2,2713844,2722014,+,8170
394,BUMA.1121.00057,2,2510780,2518949,-,8169
394,BUMA.1121.00090,2,466746,474914,+,8168
394,BUMA.1121.00027,2,638460,646630,+,8170
394,BUMA.1121.00062,2,2174179,2182348,-,8169
394,BUMA.1121.00091,2,900152,908321,-,8169
394,BUMA.1121.00098,2,2986362,2994532,+,8170
394,BUMA.1121.00092,2,2721666,2729836,+,8170
394,BUMA.1121.00031,2,1910550,1918721,+,8171
394,BUMA.1121.00096,2,3041154,3049324,+,8170
394,BUMA.1121.00073,2,2706484,2714654,+,8170
394,BUMA.1121.00103,2,1372127,1380297,+,8170
394,BUMA.1121.00084,2,1442019,1450189,+,8170
394,BUMA.1121.00014,2,2845345,2853516,+,8171
394,BUMA.1121.00111,2,2061604,2069774,+,8170
394,BUMA.1121.00007,2,2851185,2859355,+,8170
394,BUMA.1121.00072,2,2680973,2689144,+,8171
394,BUMA.1121.00071,2,2706339,2714509,+,8170
394,BUMA.1121.00077,2,918054,926223,-,8169
394,BUMA.1121.00003,2,970876,979046,+,8170
394,BUMA.1121.00104,2,2816681,2824851,+,8170
394,BUMA.1121.00074,2,1635929,1644098,-,8169
394,BUMA.1121.00060,2,2647618,2655787,-,8169
394,BUMA.1121.00088,2,2737004,2745174,+,8170
394,BUMA.1121.00053,2,3014007,3022177,+,8170
394,BUMA.1121.00025,2,1254180,1262341,+,8161
394,BUMA.1121.00070,2,2685820,2693990,+,8170
394,BUMA.1121.00049,2,1369680,1377850,+,8170
394,BUMA.1121.00078,2,401971,410141,-,8170
394,BUMA.1121.00069,2,2672360,2680530,+,8170
394,BUMA.1121.00102,2,2760469,2768639,+,8170
394,BUMA.1121.00112,2,1637264,1645433,-,8169
394,BUMA.1121.00041,2,458377,466547,+,8170
394,BUMA.1121.00068,2,1317739,1325918,+,8179
394,BUMA.1121.00076,2,485858,494029,+,8171
394,BUMA.1121.00033,2,280546,288713,+,8167
394,BUMA.1121.00101,2,677233,685402,-,8169
394,BUMA.1121.00105,2,2899720,2907889,-,8169
394,BUMA.1121.00061,2,2689569,2697739,+,8170
394,BUMA.1121.00063,2,2699534,2707704,+,8170
394,BUMA.1121.00059,2,871768,879937,-,8169
394,BUMA.1121.00058,2,120593,128763,+,8170
394,BUMA.1121.00043,2,2824712,2832881,-,8169
394,BUMA.1121.00055,2,3098418,3106587,-,8169
394,BUMA.1121.00065,2,2802265,2810435,+,8170
394,BUMA.1121.00064,2,2634747,2642917,+,8170
394,BUMA.1121.00047,2,541845,550015,+,8170
394,BUMA.1121.00037,2,3081209,3089379,+,8170
394,BUMA.1121.00106,2,2008812,2016982,+,8170
394,BUMA.1121.00051,2,2728602,2736788,+,8186
394,BUMA.1121.00045,2,2609307,2617477,+,8170
394,BUMA.1121.00056,2,1269736,1277905,-,8169
394,BUMA.1121.00095,2,1591189,1599359,+,8170
394,BUMA.1121.00082,2,2752944,2761114,+,8170
394,BUMA.1121.00001,2,2669335,2677505,-,8170
394,BUMA.1121.00108,2,2973609,2981775,+,8166
394,BUMA.1121.00083,2,1376860,1385030,+,8170
394,BUMA.1121.00080,2,2784971,2793141,+,8170
394,BUMA.1121.00012,2,2193573,2201742,-,8169
395,BUMA.1121.00011,2,1388534,1403919,+,15385
395,BUMA.1121.00009,2,1424695,1440499,+,15804
395,BUMA.1121.00039,2,1165565,1182707,-,17142
395,BUMA.1121.00029,2,1732417,1748224,-,15807
395,BUMA.1121.00107,2,1013284,1028671,-,15387
395,BUMA.1121.00023,2,2925445,2941251,+,15806
395,BUMA.1121.00067,2,1153366,1168752,-,15386
395,BUMA.1121.00035,2,1813035,1828842,-,15807
395,BUMA.1121.00005,2,1125967,1141355,-,15388
395,BUMA.1121.00100,2,802294,817682,+,15388
395,BUMA.1121.00099,2,3036357,3051741,+,15384
395,BUMA.1121.00094,2,2805080,2820465,+,15385
395,BUMA.1121.00093,2,156606,171981,-,15375
395,BUMA.1121.00097,2,2621138,2636522,+,15384
395,BUMA.1121.00109,2,1846373,1861760,-,15387
395,BUMA.1121.00110,2,2750472,2765854,+,15382
395,BUMA.1121.00079,2,2762469,2777854,+,15385
395,BUMA.1121.00075,2,54532,69918,-,15386
395,BUMA.1121.00066,2,2745594,2760977,+,15383
395,BUMA.1121.00089,2,2750960,2766345,+,15385
395,BUMA.1121.00057,2,2442606,2457989,-,15383
395,BUMA.1121.00090,2,530443,546249,+,15806
395,BUMA.1121.00027,2,693350,708730,+,15380
395,BUMA.1121.00062,2,2123510,2138897,-,15387
395,BUMA.1121.00091,2,835712,851099,-,15387
395,BUMA.1121.00098,2,3041647,3057034,+,15387
395,BUMA.1121.00092,2,2765984,2781359,+,15375
395,BUMA.1121.00031,2,1971601,1987407,+,15806
395,BUMA.1121.00096,2,3102072,3117457,+,15385
395,BUMA.1121.00073,2,2762130,2777513,+,15383
395,BUMA.1121.00103,2,1451170,1466556,+,15386
395,BUMA.1121.00084,2,1479135,1494520,+,15385
395,BUMA.1121.00014,2,2908875,2926016,+,17141
395,BUMA.1121.00007,2,2891124,2906511,+,15387
395,BUMA.1121.00072,2,2739010,2754393,+,15383
395,BUMA.1121.00071,2,2761481,2776864,+,15383
395,BUMA.1121.00077,2,850060,865440,-,15380
395,BUMA.1121.00104,2,2848068,2863873,+,15805
395,BUMA.1121.00074,2,1598124,1613511,-,15387
395,BUMA.1121.00060,2,2577617,2593005,-,15388
395,BUMA.1121.00088,2,2775332,2790717,+,15385
395,BUMA.1121.00053,2,3070120,3085507,+,15387
395,BUMA.1121.00070,2,2741457,2756840,+,15383
395,BUMA.1121.00049,2,1402280,1417667,+,15387
395,BUMA.1121.00078,2,334196,349584,-,15388
395,BUMA.1121.00069,2,2710992,2726375,+,15383
395,BUMA.1121.00102,2,2818483,2834288,+,15805
395,BUMA.1121.00112,2,1562789,1578174,-,15385
395,BUMA.1121.00041,2,516534,531918,+,15384
395,BUMA.1121.00068,2,1359660,1375049,+,15389
395,BUMA.1121.00076,2,527496,542881,+,15385
395,BUMA.1121.00101,2,626401,641788,-,15387
395,BUMA.1121.00105,2,2849947,2865334,-,15387
395,BUMA.1121.00061,2,2744681,2760064,+,15383
395,BUMA.1121.00063,2,2754675,2770058,+,15383
395,BUMA.1121.00059,2,828226,843603,-,15377
395,BUMA.1121.00058,2,163828,179633,+,15805
395,BUMA.1121.00055,2,3048970,3064777,-,15807
395,BUMA.1121.00065,2,2864748,2880134,+,15386
395,BUMA.1121.00064,2,2666547,2681933,+,15386
395,BUMA.1121.00047,2,578962,594344,+,15382
395,BUMA.1121.00106,2,2040200,2056005,+,15805
395,BUMA.1121.00051,2,2765733,2781118,+,15385
395,BUMA.1121.00045,2,2672090,2687477,+,15387
395,BUMA.1121.00056,2,1225404,1240790,-,15386
395,BUMA.1121.00095,2,1654454,1669829,+,15375
395,BUMA.1121.00082,2,2813905,2829288,+,15383
395,BUMA.1121.00001,2,2619086,2634893,-,15807
395,BUMA.1121.00108,2,3014064,3029448,+,15384
395,BUMA.1121.00083,2,1437821,1453204,+,15383
395,BUMA.1121.00080,2,2822086,2837471,+,15385
396,BUMA.1121.00011,2,1410731,1415896,+,5165
396,BUMA.1121.00009,2,1447312,1452480,+,5168
396,BUMA.1121.00039,2,1153587,1158752,-,5165
396,BUMA.1121.00029,2,1720440,1725605,-,5165
396,BUMA.1121.00107,2,1001319,1006487,-,5168
396,BUMA.1121.00023,2,2948065,2953228,+,5163
396,BUMA.1121.00035,2,1801058,1806223,-,5165
396,BUMA.1121.00005,2,1112856,1118022,-,5166
396,BUMA.1121.00100,2,824494,829660,+,5166
396,BUMA.1121.00099,2,3058542,3063708,+,5166
396,BUMA.1121.00093,2,143402,148573,-,5171
396,BUMA.1121.00097,2,2643323,2648490,+,5167
396,BUMA.1121.00109,2,1834406,1839573,-,5167
396,BUMA.1121.00110,2,2772666,2777832,+,5166
396,BUMA.1121.00090,2,553062,558226,+,5164
396,BUMA.1121.00091,2,823734,828899,-,5165
396,BUMA.1121.00098,2,3063833,3069001,+,5168
396,BUMA.1121.00092,2,2789392,2794562,+,5170
396,BUMA.1121.00031,2,1994221,1999385,+,5164
396,BUMA.1121.00096,2,3124273,3129439,+,5166
396,BUMA.1121.00103,2,1473368,1478453,+,5085
396,BUMA.1121.00014,2,2932830,2937994,+,5164
396,BUMA.1121.00077,2,838082,843249,-,5167
396,BUMA.1121.00104,2,2870686,2875855,+,5169
396,BUMA.1121.00074,2,1586140,1591311,-,5171
396,BUMA.1121.00060,2,2565646,2570818,-,5172
396,BUMA.1121.00053,2,3092122,3097288,+,5166
396,BUMA.1121.00049,2,1426703,1431871,+,5168
396,BUMA.1121.00078,2,322217,327383,-,5166
396,BUMA.1121.00102,2,2842381,2847547,+,5166
396,BUMA.1121.00112,2,1550822,1555989,-,5167
396,BUMA.1121.00041,2,538732,543897,+,5165
396,BUMA.1121.00068,2,1381860,1387029,+,5169
396,BUMA.1121.00101,2,614419,619588,-,5169
396,BUMA.1121.00059,2,815022,820192,-,5170
396,BUMA.1121.00055,2,3036990,3042160,-,5170
396,BUMA.1121.00065,2,2886865,2892034,+,5169
396,BUMA.1121.00064,2,2688746,2693915,+,5169
396,BUMA.1121.00106,2,2062818,2067987,+,5169
396,BUMA.1121.00045,2,2694277,2699448,+,5171
396,BUMA.1121.00001,2,2607109,2612274,-,5165
396,BUMA.1121.00108,2,3036256,3041424,+,5168
397,BUMA.1121.00011,2,1419446,1451628,+,32182
397,BUMA.1121.00009,2,1456028,1488260,+,32232
397,BUMA.1121.00039,2,1117912,1150040,-,32128
397,BUMA.1121.00029,2,1684724,1716893,-,32169
397,BUMA.1121.00021,2,123773,156023,+,32250
397,BUMA.1121.00107,2,965514,997772,-,32258
397,BUMA.1121.00023,2,2956776,2988957,+,32181
397,BUMA.1121.00067,2,1116828,1149141,-,32313
397,BUMA.1121.00035,2,1765379,1797511,-,32132
397,BUMA.1121.00005,2,1077190,1109309,-,32119
397,BUMA.1121.00100,2,833179,865270,+,32091
397,BUMA.1121.00016,2,918946,951158,-,32212
397,BUMA.1121.00099,2,3067256,3099406,+,32150
397,BUMA.1121.00094,2,2824689,2856836,+,32147
397,BUMA.1121.00093,2,107735,139855,-,32120
397,BUMA.1121.00097,2,2652038,2685607,+,33569
397,BUMA.1121.00109,2,1797241,1830859,-,33618
397,BUMA.1121.00018,2,1011316,1043546,-,32230
397,BUMA.1121.00110,2,2781380,2813635,+,32255
397,BUMA.1121.00079,2,2782078,2814216,+,32138
397,BUMA.1121.00075,2,18202,50309,-,32107
397,BUMA.1121.00066,2,2765200,2797441,+,32241
397,BUMA.1121.00089,2,2770569,2802729,+,32160
397,BUMA.1121.00057,2,2406305,2438384,-,32079
397,BUMA.1121.00090,2,561774,594029,+,32255
397,BUMA.1121.00027,2,712953,745046,+,32093
397,BUMA.1121.00062,2,2085874,2119285,-,33411
397,BUMA.1121.00091,2,788034,820187,-,32153
397,BUMA.1121.00098,2,3072549,3104732,+,32183
397,BUMA.1121.00092,2,2798110,2830229,+,32119
397,BUMA.1121.00031,2,2002933,2035195,+,32262
397,BUMA.1121.00096,2,3132987,3165267,+,32280
397,BUMA.1121.00073,2,2781736,2813921,+,32185
397,BUMA.1121.00103,2,1482001,1514206,+,32205
397,BUMA.1121.00084,2,1498744,1530953,+,32209
397,BUMA.1121.00014,2,2941542,2973772,+,32230
397,BUMA.1121.00111,2,2090220,2122493,+,32273
397,BUMA.1121.00007,2,2911256,2943164,+,31908
397,BUMA.1121.00072,2,2758616,2790847,+,32231
397,BUMA.1121.00071,2,2781087,2813316,+,32229
397,BUMA.1121.00077,2,802326,834535,-,32209
397,BUMA.1121.00003,2,989975,1022261,+,32286
397,BUMA.1121.00104,2,2879403,2911499,+,32096
397,BUMA.1121.00074,2,1550370,1582593,-,32223
397,BUMA.1121.00060,2,2529887,2562086,-,32199
397,BUMA.1121.00088,2,2794941,2827083,+,32142
397,BUMA.1121.00053,2,3100838,3133076,+,32238
397,BUMA.1121.00025,2,1289342,1321592,+,32250
397,BUMA.1121.00070,2,2761063,2793229,+,32166
397,BUMA.1121.00049,2,1435419,1467475,+,32056
397,BUMA.1121.00078,2,286559,318668,-,32109
397,BUMA.1121.00069,2,2730598,2762732,+,32134
397,BUMA.1121.00102,2,2851097,2883211,+,32114
397,BUMA.1121.00112,2,1515075,1547275,-,32200
397,BUMA.1121.00041,2,547447,579654,+,32207
397,BUMA.1121.00068,2,1390577,1422739,+,32162
397,BUMA.1121.00076,2,547105,579212,+,32107
397,BUMA.1121.00033,2,313062,345148,+,32086
397,BUMA.1121.00101,2,578742,610872,-,32130
397,BUMA.1121.00105,2,2812345,2845724,-,33379
397,BUMA.1121.00061,2,2764287,2796455,+,32168
397,BUMA.1121.00063,2,2774281,2806422,+,32141
397,BUMA.1121.00059,2,779382,811475,-,32093
397,BUMA.1121.00058,2,183855,216079,+,32224
397,BUMA.1121.00043,2,2769234,2801393,-,32159
397,BUMA.1121.00055,2,2997599,3030995,-,33396
397,BUMA.1121.00065,2,2895582,2927780,+,32198
397,BUMA.1121.00064,2,2697463,2729645,+,32182
397,BUMA.1121.00047,2,598568,630662,+,32094
397,BUMA.1121.00037,2,3113731,3145979,+,32248
397,BUMA.1121.00106,2,2071535,2103637,+,32102
397,BUMA.1121.00051,2,2785342,2817433,+,32091
397,BUMA.1121.00045,2,2703009,2735207,+,32198
397,BUMA.1121.00056,2,1189020,1221181,-,32161
397,BUMA.1121.00095,2,1674574,1706682,+,32108
397,BUMA.1121.00082,2,2833511,2865752,+,32241
397,BUMA.1121.00001,2,2571392,2603562,-,32170
397,BUMA.1121.00108,2,3044974,3078419,+,33445
397,BUMA.1121.00083,2,1457427,1489668,+,32241
397,BUMA.1121.00080,2,2841695,2873864,+,32169
397,BUMA.1121.00012,2,2137069,2169219,-,32150
398,BUMA.1121.00011,2,1457833,1468531,+,10698
398,BUMA.1121.00009,2,1494487,1505216,+,10729
398,BUMA.1121.00039,2,1100996,1111696,-,10700
398,BUMA.1121.00029,2,1667780,1678508,-,10728
398,BUMA.1121.00021,2,162240,172990,+,10750
398,BUMA.1121.00107,2,948501,959296,-,10795
398,BUMA.1121.00023,2,2997782,3008550,+,10768
398,BUMA.1121.00067,2,1099881,1110610,-,10729
398,BUMA.1121.00035,2,1748476,1759163,-,10687
398,BUMA.1121.00005,2,1060216,1070974,-,10758
398,BUMA.1121.00100,2,871488,882333,+,10845
398,BUMA.1121.00016,2,902014,912729,-,10715
398,BUMA.1121.00099,2,3105614,3116307,+,10693
398,BUMA.1121.00094,2,2863067,2873800,+,10733
398,BUMA.1121.00093,2,90769,101517,-,10748
398,BUMA.1121.00097,2,2691825,2702537,+,10712
398,BUMA.1121.00109,2,1780216,1791023,-,10807
398,BUMA.1121.00018,2,994374,1005100,-,10726
398,BUMA.1121.00110,2,2819851,2830603,+,10752
398,BUMA.1121.00079,2,2820434,2831109,+,10675
398,BUMA.1121.00075,2,1,10746,-,10745
398,BUMA.1121.00066,2,2803672,2814352,+,10680
398,BUMA.1121.00089,2,2808960,2819693,+,10733
398,BUMA.1121.00057,2,2389423,2400089,-,10666
398,BUMA.1121.00090,2,600246,610954,+,10708
398,BUMA.1121.00027,2,751265,761959,+,10694
398,BUMA.1121.00062,2,2068885,2079645,-,10760
398,BUMA.1121.00091,2,771056,781818,-,10762
398,BUMA.1121.00098,2,3110955,3121789,+,10834
398,BUMA.1121.00092,2,2836448,2847195,+,10747
398,BUMA.1121.00031,2,2041414,2052177,+,10763
398,BUMA.1121.00096,2,3171486,3182261,+,10775
398,BUMA.1121.00073,2,2820152,2830805,+,10653
398,BUMA.1121.00103,2,1520405,1531178,+,10773
398,BUMA.1121.00084,2,1537170,1547920,+,10750
398,BUMA.1121.00014,2,2979991,2990730,+,10739
398,BUMA.1121.00111,2,2128677,2139376,+,10699
398,BUMA.1121.00007,2,2949383,2960085,+,10702
398,BUMA.1121.00072,2,2797078,2807705,+,10627
398,BUMA.1121.00071,2,2819547,2830202,+,10655
398,BUMA.1121.00077,2,785359,796112,-,10753
398,BUMA.1121.00003,2,1025582,1036354,+,10772
398,BUMA.1121.00104,2,2917716,2928404,+,10688
398,BUMA.1121.00074,2,1533469,1544154,-,10685
398,BUMA.1121.00060,2,2512905,2523672,-,10767
398,BUMA.1121.00088,2,2833300,2843974,+,10674
398,BUMA.1121.00053,2,3139295,3149956,+,10661
398,BUMA.1121.00025,2,1327809,1338539,+,10730
398,BUMA.1121.00070,2,2799460,2810114,+,10654
398,BUMA.1121.00049,2,1473693,1484366,+,10673
398,BUMA.1121.00078,2,269609,280340,-,10731
398,BUMA.1121.00069,2,2768963,2779637,+,10674
398,BUMA.1121.00102,2,2889415,2900043,+,10628
398,BUMA.1121.00112,2,1498163,1508859,-,10696
398,BUMA.1121.00041,2,585871,596603,+,10732
398,BUMA.1121.00068,2,1428957,1439637,+,10680
398,BUMA.1121.00076,2,586669,597406,+,10737
398,BUMA.1121.00033,2,351367,362092,+,10725
398,BUMA.1121.00101,2,561844,572515,-,10671
398,BUMA.1121.00105,2,2795397,2806114,-,10717
398,BUMA.1121.00061,2,2802686,2813334,+,10648
398,BUMA.1121.00063,2,2812653,2823312,+,10659
398,BUMA.1121.00059,2,762454,773163,-,10709
398,BUMA.1121.00058,2,222311,233035,+,10724
398,BUMA.1121.00043,2,2752345,2763015,-,10670
398,BUMA.1121.00055,2,2980682,2991381,-,10699
398,BUMA.1121.00065,2,2933997,2944715,+,10718
398,BUMA.1121.00064,2,2735864,2746617,+,10753
398,BUMA.1121.00047,2,636893,647617,+,10724
398,BUMA.1121.00037,2,3152196,3162887,+,10691
398,BUMA.1121.00106,2,2109854,2120556,+,10702
398,BUMA.1121.00051,2,2823664,2834364,+,10700
398,BUMA.1121.00045,2,2741423,2752157,+,10734
398,BUMA.1121.00056,2,1172056,1182790,-,10734
398,BUMA.1121.00095,2,1712914,1723750,+,10836
398,BUMA.1121.00082,2,2871983,2882665,+,10682
398,BUMA.1121.00001,2,2554457,2565176,-,10719
398,BUMA.1121.00108,2,3084639,3095438,+,10799
398,BUMA.1121.00083,2,1495899,1506581,+,10682
398,BUMA.1121.00080,2,2880095,2890803,+,10708
398,BUMA.1121.00012,2,2120157,2130852,-,10695
399,BUMA.1121.00011,2,1468533,1492731,+,24198
399,BUMA.1121.00009,2,1505218,1529448,+,24230
399,BUMA.1121.00039,2,1076672,1100995,-,24323
399,BUMA.1121.00029,2,1643472,1667779,-,24307
399,BUMA.1121.00021,2,172992,197321,+,24329
399,BUMA.1121.00107,2,924283,948500,-,24217
399,BUMA.1121.00023,2,3008552,3032846,+,24294
399,BUMA.1121.00067,2,1075655,1099880,-,24225
399,BUMA.1121.00035,2,1724184,1748475,-,24291
399,BUMA.1121.00005,2,1036013,1060215,-,24202
399,BUMA.1121.00100,2,882335,906517,+,24182
399,BUMA.1121.00016,2,877717,902013,-,24296
399,BUMA.1121.00099,2,3116309,3140525,+,24216
399,BUMA.1121.00094,2,2873802,2898059,+,24257
399,BUMA.1121.00093,2,66531,90768,-,24237
399,BUMA.1121.00097,2,2702539,2726788,+,24249
399,BUMA.1121.00109,2,1755998,1780215,-,24217
399,BUMA.1121.00018,2,970044,994373,-,24329
399,BUMA.1121.00110,2,2830605,2854797,+,24192
399,BUMA.1121.00079,2,2831111,2855374,+,24263
399,BUMA.1121.00075,2,3123663,3147867,-,24204
399,BUMA.1121.00066,2,2814354,2838564,+,24210
399,BUMA.1121.00089,2,2819695,2843945,+,24250
399,BUMA.1121.00057,2,2365149,2389422,-,24273
399,BUMA.1121.00090,2,610956,635283,+,24327
399,BUMA.1121.00027,2,761961,786168,+,24207
399,BUMA.1121.00062,2,2044640,2068884,-,24244
399,BUMA.1121.00091,2,746866,771055,-,24189
399,BUMA.1121.00098,2,3121791,3146026,+,24235
399,BUMA.1121.00092,2,2847197,2871434,+,24237
399,BUMA.1121.00031,2,2052179,2076489,+,24310
399,BUMA.1121.00096,2,3182263,3206492,+,24229
399,BUMA.1121.00073,2,2830807,2855035,+,24228
399,BUMA.1121.00103,2,1531180,1555437,+,24257
399,BUMA.1121.00084,2,1547922,1572143,+,24221
399,BUMA.1121.00014,2,2990732,3015062,+,24330
399,BUMA.1121.00111,2,2139378,2163707,+,24329
399,BUMA.1121.00007,2,2960087,2984315,+,24228
399,BUMA.1121.00072,2,2807707,2831938,+,24231
399,BUMA.1121.00071,2,2830204,2854426,+,24222
399,BUMA.1121.00077,2,761167,785358,-,24191
399,BUMA.1121.00003,2,1036356,1060629,+,24273
399,BUMA.1121.00104,2,2928406,2952700,+,24294
399,BUMA.1121.00074,2,1509186,1533468,-,24282
399,BUMA.1121.00060,2,2488610,2512904,-,24294
399,BUMA.1121.00088,2,2843976,2868169,+,24193
399,BUMA.1121.00053,2,3149958,3174229,+,24271
399,BUMA.1121.00025,2,1338541,1362871,+,24330
399,BUMA.1121.00070,2,2810116,2834340,+,24224
399,BUMA.1121.00049,2,1484368,1508585,+,24217
399,BUMA.1121.00078,2,245392,269608,-,24216
399,BUMA.1121.00069,2,2779639,2803888,+,24249
399,BUMA.1121.00102,2,2900045,2924323,+,24278
399,BUMA.1121.00112,2,1473985,1498162,-,24177
399,BUMA.1121.00041,2,596605,620817,+,24212
399,BUMA.1121.00068,2,1439639,1463922,+,24283
399,BUMA.1121.00076,2,597408,621629,+,24221
399,BUMA.1121.00033,2,362094,386383,+,24289
399,BUMA.1121.00101,2,537582,561843,-,24261
399,BUMA.1121.00105,2,2771044,2795396,-,24352
399,BUMA.1121.00061,2,2813336,2837545,+,24209
399,BUMA.1121.00063,2,2823314,2847535,+,24221
399,BUMA.1121.00059,2,738189,762453,-,24264
399,BUMA.1121.00058,2,233037,257334,+,24297
399,BUMA.1121.00043,2,2728058,2752344,-,24286
399,BUMA.1121.00055,2,2956461,2980681,-,24220
399,BUMA.1121.00065,2,2944717,2968939,+,24222
399,BUMA.1121.00064,2,2746619,2770849,+,24230
399,BUMA.1121.00047,2,647619,671830,+,24211
399,BUMA.1121.00037,2,3162889,3187176,+,24287
399,BUMA.1121.00106,2,2120558,2144782,+,24224
399,BUMA.1121.00051,2,2834366,2858610,+,24244
399,BUMA.1121.00045,2,2752159,2776453,+,24294
399,BUMA.1121.00056,2,1147805,1172055,-,24250
399,BUMA.1121.00095,2,1723752,1747964,+,24212
399,BUMA.1121.00082,2,2882667,2906916,+,24249
399,BUMA.1121.00001,2,2530117,2554456,-,24339
399,BUMA.1121.00108,2,3095440,3119663,+,24223
399,BUMA.1121.00083,2,1506583,1530832,+,24249
399,BUMA.1121.00080,2,2890805,2915066,+,24261
399,BUMA.1121.00012,2,2095829,2120156,-,24327
400,BUMA.1121.00011,2,1496433,1501205,+,4772
400,BUMA.1121.00009,2,1531913,1536685,+,4772
400,BUMA.1121.00107,2,917060,921833,-,4773
400,BUMA.1121.00067,2,1068416,1073189,-,4773
400,BUMA.1121.00005,2,1028763,1033536,-,4773
400,BUMA.1121.00016,2,870478,875251,-,4773
400,BUMA.1121.00099,2,3143002,3147774,+,4772
400,BUMA.1121.00093,2,59292,64065,-,4773
400,BUMA.1121.00097,2,2729254,2734026,+,4772
400,BUMA.1121.00110,2,2857274,2862046,+,4772
400,BUMA.1121.00066,2,2840775,2845547,+,4772
400,BUMA.1121.00057,2,2357370,2362142,-,4772
400,BUMA.1121.00027,2,788633,793405,+,4772
400,BUMA.1121.00062,2,2037402,2042174,-,4772
400,BUMA.1121.00091,2,739627,744400,-,4773
400,BUMA.1121.00098,2,3148492,3153263,+,4771
400,BUMA.1121.00092,2,2873900,2878672,+,4772
400,BUMA.1121.00096,2,3208957,3213728,+,4771
400,BUMA.1121.00073,2,2857262,2862034,+,4772
400,BUMA.1121.00103,2,1558562,1563334,+,4772
400,BUMA.1121.00084,2,1574609,1579380,+,4771
400,BUMA.1121.00111,2,2166173,2170960,+,4787
400,BUMA.1121.00072,2,2834945,2839717,+,4772
400,BUMA.1121.00071,2,2856649,2861421,+,4772
400,BUMA.1121.00077,2,753917,758690,-,4773
400,BUMA.1121.00003,2,1063095,1067867,+,4772
400,BUMA.1121.00104,2,2955166,2959937,+,4771
400,BUMA.1121.00060,2,2481385,2486144,-,4759
400,BUMA.1121.00088,2,2870635,2875406,+,4771
400,BUMA.1121.00053,2,3176706,3181478,+,4772
400,BUMA.1121.00070,2,2836563,2841335,+,4772
400,BUMA.1121.00049,2,1511062,1515833,+,4771
400,BUMA.1121.00078,2,238153,242926,-,4773
400,BUMA.1121.00069,2,2806895,2811667,+,4772
400,BUMA.1121.00102,2,2926789,2931561,+,4772
400,BUMA.1121.00112,2,1466746,1471519,-,4773
400,BUMA.1121.00068,2,1467624,1472413,+,4789
400,BUMA.1121.00033,2,388847,393619,+,4772
400,BUMA.1121.00101,2,530343,535116,-,4773
400,BUMA.1121.00061,2,2839768,2844540,+,4772
400,BUMA.1121.00063,2,2850542,2855314,+,4772
400,BUMA.1121.00043,2,2720819,2725592,-,4773
400,BUMA.1121.00055,2,2948681,2953454,-,4773
400,BUMA.1121.00064,2,2773315,2778087,+,4772
400,BUMA.1121.00037,2,3192114,3196886,+,4772
400,BUMA.1121.00106,2,2147248,2152019,+,4771
400,BUMA.1121.00045,2,2778919,2783677,+,4758
400,BUMA.1121.00095,2,1751666,1756444,+,4778
400,BUMA.1121.00082,2,2909923,2914695,+,4772
400,BUMA.1121.00108,2,3122129,3126901,+,4772
400,BUMA.1121.00083,2,1533839,1538611,+,4772
401,BUMA.1121.00011,2,1505660,1512264,+,6604
401,BUMA.1121.00009,2,1541153,1547757,+,6604
401,BUMA.1121.00039,2,1068472,1075076,-,6604
401,BUMA.1121.00029,2,1635273,1641876,-,6603
401,BUMA.1121.00021,2,198916,205519,+,6603
401,BUMA.1121.00107,2,906000,912605,-,6605
401,BUMA.1121.00023,2,3034403,3040988,+,6585
401,BUMA.1121.00067,2,1057359,1063962,-,6603
401,BUMA.1121.00035,2,1715985,1722588,-,6603
401,BUMA.1121.00005,2,1017715,1024318,-,6603
401,BUMA.1121.00100,2,908112,914714,+,6602
401,BUMA.1121.00016,2,859458,866061,-,6603
401,BUMA.1121.00099,2,3152229,3158833,+,6604
401,BUMA.1121.00094,2,2899654,2906270,+,6616
401,BUMA.1121.00093,2,48236,54838,-,6602
401,BUMA.1121.00097,2,2738481,2745083,+,6602
401,BUMA.1121.00109,2,1746564,1753166,-,6602
401,BUMA.1121.00018,2,961844,968448,-,6604
401,BUMA.1121.00110,2,2866501,2873109,+,6608
401,BUMA.1121.00079,2,2856968,2863571,+,6603
401,BUMA.1121.00075,2,3113014,3119620,-,6606
401,BUMA.1121.00066,2,2850002,2856608,+,6606
401,BUMA.1121.00089,2,2845540,2852155,+,6615
401,BUMA.1121.00057,2,2346310,2352915,-,6605
401,BUMA.1121.00090,2,636878,643483,+,6605
401,BUMA.1121.00027,2,797858,804413,+,6555
401,BUMA.1121.00062,2,2026342,2032947,-,6605
401,BUMA.1121.00091,2,728568,735172,-,6604
401,BUMA.1121.00098,2,3157721,3164326,+,6605
401,BUMA.1121.00092,2,2883126,2889729,+,6603
401,BUMA.1121.00031,2,2079320,2085925,+,6605
401,BUMA.1121.00096,2,3218188,3224792,+,6604
401,BUMA.1121.00073,2,2866481,2873087,+,6606
401,BUMA.1121.00103,2,1567789,1574393,+,6604
401,BUMA.1121.00084,2,1583835,1590442,+,6607
401,BUMA.1121.00014,2,3017893,3024478,+,6585
401,BUMA.1121.00111,2,2175415,2182018,+,6603
401,BUMA.1121.00007,2,2985910,2992513,+,6603
401,BUMA.1121.00072,2,2844172,2850778,+,6606
401,BUMA.1121.00071,2,2865749,2872355,+,6606
401,BUMA.1121.00077,2,742854,749461,-,6607
401,BUMA.1121.00003,2,1072322,1078930,+,6608
401,BUMA.1121.00104,2,2964392,2970998,+,6606
401,BUMA.1121.00074,2,1500987,1507590,-,6603
401,BUMA.1121.00060,2,2470334,2476930,-,6596
401,BUMA.1121.00088,2,2879861,2886467,+,6606
401,BUMA.1121.00053,2,3185933,3192535,+,6602
401,BUMA.1121.00025,2,1364466,1371071,+,6605
401,BUMA.1121.00070,2,2845790,2852396,+,6606
401,BUMA.1121.00049,2,1520288,1526894,+,6606
401,BUMA.1121.00078,2,227099,233700,-,6601
401,BUMA.1121.00069,2,2816066,2822672,+,6606
401,BUMA.1121.00102,2,2936016,2942618,+,6602
401,BUMA.1121.00112,2,1455708,1462291,-,6583
401,BUMA.1121.00041,2,622411,629021,+,6610
401,BUMA.1121.00068,2,1476856,1483448,+,6592
401,BUMA.1121.00076,2,625672,632280,+,6608
401,BUMA.1121.00033,2,398036,404640,+,6604
401,BUMA.1121.00101,2,519286,525888,-,6602
401,BUMA.1121.00105,2,2762843,2769448,-,6605
401,BUMA.1121.00061,2,2848995,2855601,+,6606
401,BUMA.1121.00063,2,2859759,2866365,+,6606
401,BUMA.1121.00059,2,729988,736593,-,6605
401,BUMA.1121.00058,2,258929,265536,+,6607
401,BUMA.1121.00043,2,2709799,2716402,-,6603
401,BUMA.1121.00055,2,2937626,2944226,-,6600
401,BUMA.1121.00065,2,2970545,2977148,+,6603
401,BUMA.1121.00064,2,2782541,2789147,+,6606
401,BUMA.1121.00047,2,673425,680028,+,6603
401,BUMA.1121.00037,2,3201341,3207929,+,6588
401,BUMA.1121.00106,2,2156474,2163075,+,6601
401,BUMA.1121.00051,2,2860205,2866808,+,6603
401,BUMA.1121.00045,2,2788132,2794729,+,6597
401,BUMA.1121.00056,2,1139595,1146209,-,6614
401,BUMA.1121.00095,2,1760894,1767496,+,6602
401,BUMA.1121.00082,2,2919150,2925756,+,6606
401,BUMA.1121.00001,2,2521918,2528521,-,6603
401,BUMA.1121.00108,2,3131361,3137964,+,6603
401,BUMA.1121.00083,2,1543066,1549672,+,6606
401,BUMA.1121.00080,2,2916661,2923264,+,6603
401,BUMA.1121.00012,2,2087668,2094271,-,6603
402,BUMA.1121.00011,2,1516639,1537648,+,21009
402,BUMA.1121.00009,2,1552132,1573203,+,21071
402,BUMA.1121.00039,2,1043489,1064352,-,20863
402,BUMA.1121.00029,2,1610156,1631153,-,20997
402,BUMA.1121.00021,2,209639,230683,+,21044
402,BUMA.1121.00107,2,880546,901655,-,21109
402,BUMA.1121.00023,2,3045108,3065966,+,20858
402,BUMA.1121.00067,2,1031864,1052984,-,21120
402,BUMA.1121.00035,2,1690858,1711865,-,21007
402,BUMA.1121.00005,2,992487,1013469,-,20982
402,BUMA.1121.00100,2,919089,939996,+,20907
402,BUMA.1121.00016,2,834383,855407,-,21024
402,BUMA.1121.00099,2,3163208,3184301,+,21093
402,BUMA.1121.00094,2,2910645,2931668,+,21023
402,BUMA.1121.00093,2,22762,43861,-,21099
402,BUMA.1121.00097,2,2749425,2770466,+,21041
402,BUMA.1121.00109,2,1721175,1742189,-,21014
402,BUMA.1121.00018,2,936745,957724,-,20979
402,BUMA.1121.00110,2,2877484,2898555,+,21071
402,BUMA.1121.00079,2,2867946,2889095,+,21149
402,BUMA.1121.00075,2,3087630,3108639,-,21009
402,BUMA.1121.00066,2,2860983,2881995,+,21012
402,BUMA.1121.00089,2,2856530,2877574,+,21044
402,BUMA.1121.00057,2,2320852,2341935,-,21083
402,BUMA.1121.00090,2,647603,668638,+,21035
402,BUMA.1121.00027,2,808788,829845,+,21057
402,BUMA.1121.00062,2,2000908,2021967,-,21059
402,BUMA.1121.00091,2,703334,724322,-,20988
402,BUMA.1121.00098,2,3169159,3190226,+,21067
402,BUMA.1121.00092,2,2894104,2915203,+,21099
402,BUMA.1121.00031,2,2090045,2110979,+,20934
402,BUMA.1121.00096,2,3229166,3250264,+,21098
402,BUMA.1121.00073,2,2877462,2898503,+,21041
402,BUMA.1121.00103,2,1578684,1599769,+,21085
402,BUMA.1121.00084,2,1594817,1615841,+,21024
402,BUMA.1121.00014,2,3028853,3049691,+,20838
402,BUMA.1121.00111,2,2186393,2207427,+,21034
402,BUMA.1121.00007,2,2996831,3017860,+,21029
402,BUMA.1121.00072,2,2855153,2876183,+,21030
402,BUMA.1121.00071,2,2876730,2897758,+,21028
402,BUMA.1121.00077,2,717408,738466,-,21058
402,BUMA.1121.00003,2,1083305,1104355,+,21050
402,BUMA.1121.00104,2,2975373,2996363,+,20990
402,BUMA.1121.00074,2,1475474,1496612,-,21138
402,BUMA.1121.00060,2,2444867,2465959,-,21092
402,BUMA.1121.00088,2,2890842,2911872,+,21030
402,BUMA.1121.00053,2,3196910,3217986,+,21076
402,BUMA.1121.00025,2,1375191,1396170,+,20979
402,BUMA.1121.00070,2,2856771,2877803,+,21032
402,BUMA.1121.00049,2,1531269,1552386,+,21117
402,BUMA.1121.00078,2,201713,222723,-,21010
402,BUMA.1121.00069,2,2827047,2848077,+,21030
402,BUMA.1121.00102,2,2946993,2968167,+,21174
402,BUMA.1121.00112,2,1430432,1451462,-,21030
402,BUMA.1121.00041,2,633397,654496,+,21099
402,BUMA.1121.00068,2,1487823,1508842,+,21019
402,BUMA.1121.00076,2,636655,657664,+,21009
402,BUMA.1121.00033,2,409015,429908,+,20893
402,BUMA.1121.00101,2,493918,515037,-,21119
402,BUMA.1121.00105,2,2737415,2758468,-,21053
402,BUMA.1121.00061,2,2859976,2881010,+,21034
402,BUMA.1121.00063,2,2870740,2891776,+,21036
402,BUMA.1121.00059,2,704486,725613,-,21127
402,BUMA.1121.00058,2,269911,291077,+,21166
402,BUMA.1121.00043,2,2683321,2705748,-,22427
402,BUMA.1121.00055,2,2912392,2933251,-,20859
402,BUMA.1121.00065,2,2981523,3002605,+,21082
402,BUMA.1121.00064,2,2793522,2814641,+,21119
402,BUMA.1121.00047,2,684403,705502,+,21099
402,BUMA.1121.00037,2,4137,25051,+,20914
402,BUMA.1121.00106,2,2167450,2188545,+,21095
402,BUMA.1121.00051,2,2871183,2892314,+,21131
402,BUMA.1121.00045,2,2799104,2820196,+,21092
402,BUMA.1121.00056,2,1114176,1135220,-,21044
402,BUMA.1121.00095,2,1771871,1792849,+,20978
402,BUMA.1121.00082,2,2930131,2951173,+,21042
402,BUMA.1121.00001,2,2496783,2517798,-,21015
402,BUMA.1121.00108,2,3142345,3163342,+,20997
402,BUMA.1121.00083,2,1554047,1575089,+,21042
402,BUMA.1121.00080,2,2927639,2948811,+,21172
402,BUMA.1121.00012,2,2062545,2083548,-,21003
403,BUMA.1121.00011,2,1537650,1553401,+,15751
403,BUMA.1121.00009,2,1573205,1588921,+,15716
403,BUMA.1121.00039,2,1027774,1043487,-,15713
403,BUMA.1121.00029,2,1594423,1610154,-,15731
403,BUMA.1121.00021,2,230685,246396,+,15711
403,BUMA.1121.00107,2,864807,880544,-,15737
403,BUMA.1121.00023,2,3065968,3081698,+,15730
403,BUMA.1121.00067,2,1016168,1031862,-,15694
403,BUMA.1121.00035,2,1675132,1690856,-,15724
403,BUMA.1121.00005,2,976757,992485,-,15728
403,BUMA.1121.00100,2,939998,955721,+,15723
403,BUMA.1121.00016,2,818680,834381,-,15701
403,BUMA.1121.00099,2,3184303,3200007,+,15704
403,BUMA.1121.00094,2,2931670,2947373,+,15703
403,BUMA.1121.00093,2,7019,22760,-,15741
403,BUMA.1121.00097,2,2770468,2786192,+,15724
403,BUMA.1121.00109,2,1705521,1721173,-,15652
403,BUMA.1121.00018,2,921010,936743,-,15733
403,BUMA.1121.00110,2,2898557,2914242,+,15685
403,BUMA.1121.00079,2,2889097,2904815,+,15718
403,BUMA.1121.00075,2,3071888,3087628,-,15740
403,BUMA.1121.00066,2,2881997,2897707,+,15710
403,BUMA.1121.00089,2,2877576,2893279,+,15703
403,BUMA.1121.00057,2,2305138,2320850,-,15712
403,BUMA.1121.00090,2,668640,684374,+,15734
403,BUMA.1121.00027,2,829847,845573,+,15726
403,BUMA.1121.00062,2,1985172,2000906,-,15734
403,BUMA.1121.00091,2,687664,703332,-,15668
403,BUMA.1121.00098,2,3190228,3205965,+,15737
403,BUMA.1121.00092,2,2915205,2930946,+,15741
403,BUMA.1121.00031,2,2110981,2126714,+,15733
403,BUMA.1121.00096,2,3250266,3265990,+,15724
403,BUMA.1121.00073,2,2898505,2914231,+,15726
403,BUMA.1121.00103,2,1599771,1615493,+,15722
403,BUMA.1121.00084,2,1615843,1631593,+,15750
403,BUMA.1121.00014,2,3049693,3065418,+,15725
403,BUMA.1121.00111,2,2207429,2223120,+,15691
403,BUMA.1121.00007,2,3017862,3033592,+,15730
403,BUMA.1121.00072,2,2876185,2891911,+,15726
403,BUMA.1121.00071,2,2897760,2913486,+,15726
403,BUMA.1121.00077,2,701718,717406,-,15688
403,BUMA.1121.00003,2,1104357,1120080,+,15723
403,BUMA.1121.00104,2,2996365,3012106,+,15741
403,BUMA.1121.00074,2,1459759,1475472,-,15713
403,BUMA.1121.00060,2,2429113,2444865,-,15752
403,BUMA.1121.00088,2,2911874,2927593,+,15719
403,BUMA.1121.00053,2,31,15767,+,15736
403,BUMA.1121.00025,2,1396172,1411905,+,15733
403,BUMA.1121.00070,2,2877805,2893530,+,15725
403,BUMA.1121.00049,2,1552388,1568127,+,15739
403,BUMA.1121.00078,2,186004,201711,-,15707
403,BUMA.1121.00069,2,2848079,2863795,+,15716
403,BUMA.1121.00102,2,2968169,2983898,+,15729
403,BUMA.1121.00112,2,1414687,1430430,-,15743
403,BUMA.1121.00041,2,654498,670264,+,15766
403,BUMA.1121.00068,2,1508844,1524615,+,15771
403,BUMA.1121.00076,2,657666,673407,+,15741
403,BUMA.1121.00033,2,429910,445642,+,15732
403,BUMA.1121.00101,2,478189,493916,-,15727
403,BUMA.1121.00105,2,2721678,2737413,-,15735
403,BUMA.1121.00061,2,2881012,2896737,+,15725
403,BUMA.1121.00063,2,2891778,2907504,+,15726
403,BUMA.1121.00059,2,688771,704484,-,15713
403,BUMA.1121.00058,2,291079,306805,+,15726
403,BUMA.1121.00043,2,2667587,2683319,-,15732
403,BUMA.1121.00055,2,2896672,2912390,-,15718
403,BUMA.1121.00065,2,3002607,3018334,+,15727
403,BUMA.1121.00064,2,2814643,2830356,+,15713
403,BUMA.1121.00047,2,705504,721241,+,15737
403,BUMA.1121.00037,2,25053,40790,+,15737
403,BUMA.1121.00106,2,2188547,2204267,+,15720
403,BUMA.1121.00051,2,2892316,2908051,+,15735
403,BUMA.1121.00045,2,2820198,2835950,+,15752
403,BUMA.1121.00056,2,1098471,1114174,-,15703
403,BUMA.1121.00095,2,1792851,1808591,+,15740
403,BUMA.1121.00082,2,2951175,2966901,+,15726
403,BUMA.1121.00001,2,2481048,2496781,-,15733
403,BUMA.1121.00108,2,3163344,3179053,+,15709
403,BUMA.1121.00083,2,1575091,1590817,+,15726
403,BUMA.1121.00080,2,2948813,2964549,+,15736
403,BUMA.1121.00012,2,2046817,2062543,-,15726
404,BUMA.1121.00011,2,1553402,1557116,+,3714
404,BUMA.1121.00009,2,1588922,1592636,+,3714
404,BUMA.1121.00039,2,1024054,1027772,-,3718
404,BUMA.1121.00029,2,1590703,1594421,-,3718
404,BUMA.1121.00021,2,246397,250116,+,3719
404,BUMA.1121.00107,2,861091,864805,-,3714
404,BUMA.1121.00023,2,3081699,3085418,+,3719
404,BUMA.1121.00067,2,1012448,1016166,-,3718
404,BUMA.1121.00035,2,1671412,1675130,-,3718
404,BUMA.1121.00005,2,973037,976755,-,3718
404,BUMA.1121.00100,2,955722,959436,+,3714
404,BUMA.1121.00099,2,3200008,3203727,+,3719
404,BUMA.1121.00094,2,2947374,2951088,+,3714
404,BUMA.1121.00093,2,3299,7017,-,3718
404,BUMA.1121.00097,2,2786193,2789907,+,3714
404,BUMA.1121.00109,2,1701805,1705519,-,3714
404,BUMA.1121.00110,2,2914243,2917957,+,3714
404,BUMA.1121.00079,2,2904816,2908528,+,3712
404,BUMA.1121.00075,2,3068168,3071886,-,3718
404,BUMA.1121.00066,2,2897708,2901422,+,3714
404,BUMA.1121.00089,2,2893280,2896994,+,3714
404,BUMA.1121.00057,2,2301418,2305136,-,3718
404,BUMA.1121.00090,2,684375,688094,+,3719
404,BUMA.1121.00027,2,845574,849293,+,3719
404,BUMA.1121.00062,2,1981456,1985170,-,3714
404,BUMA.1121.00091,2,683948,687662,-,3714
404,BUMA.1121.00098,2,23,3752,+,3729
404,BUMA.1121.00092,2,2930947,2934666,+,3719
404,BUMA.1121.00096,2,3265991,3269705,+,3714
404,BUMA.1121.00073,2,2914232,2917946,+,3714
404,BUMA.1121.00103,2,1615494,1619208,+,3714
404,BUMA.1121.00084,2,1631594,1635308,+,3714
404,BUMA.1121.00111,2,2223121,2226840,+,3719
404,BUMA.1121.00007,2,3033593,3037295,+,3702
404,BUMA.1121.00072,2,2891912,2895626,+,3714
404,BUMA.1121.00071,2,2913487,2917201,+,3714
404,BUMA.1121.00077,2,698001,701716,-,3715
404,BUMA.1121.00003,2,1120081,1123795,+,3714
404,BUMA.1121.00104,2,3012107,3015826,+,3719
404,BUMA.1121.00074,2,1456039,1459757,-,3718
404,BUMA.1121.00060,2,2425397,2429111,-,3714
404,BUMA.1121.00088,2,2927594,2931313,+,3719
404,BUMA.1121.00053,2,15768,19487,+,3719
404,BUMA.1121.00070,2,2893531,2897245,+,3714
404,BUMA.1121.00049,2,1568128,1571847,+,3719
404,BUMA.1121.00078,2,182290,186002,-,3712
404,BUMA.1121.00069,2,2863796,2867510,+,3714
404,BUMA.1121.00102,2,2983899,2987613,+,3714
404,BUMA.1121.00112,2,1410971,1414685,-,3714
404,BUMA.1121.00041,2,670265,673979,+,3714
404,BUMA.1121.00068,2,1524616,1528330,+,3714
404,BUMA.1121.00076,2,673408,677127,+,3719
404,BUMA.1121.00033,2,445643,449362,+,3719
404,BUMA.1121.00101,2,474473,478187,-,3714
404,BUMA.1121.00105,2,2717958,2721676,-,3718
404,BUMA.1121.00061,2,2896738,2900452,+,3714
404,BUMA.1121.00063,2,2907505,2911219,+,3714
404,BUMA.1121.00059,2,685055,688769,-,3714
404,BUMA.1121.00058,2,306806,310525,+,3719
404,BUMA.1121.00043,2,2663867,2667585,-,3718
404,BUMA.1121.00055,2,2892952,2896670,-,3718
404,BUMA.1121.00065,2,3018335,3022049,+,3714
404,BUMA.1121.00064,2,2830357,2834076,+,3719
404,BUMA.1121.00047,2,721242,724956,+,3714
404,BUMA.1121.00106,2,2204268,2207987,+,3719
404,BUMA.1121.00051,2,2908052,2911765,+,3713
404,BUMA.1121.00045,2,2835951,2839665,+,3714
404,BUMA.1121.00056,2,1094755,1098469,-,3714
404,BUMA.1121.00095,2,1808592,1812306,+,3714
404,BUMA.1121.00082,2,2966902,2970621,+,3719
404,BUMA.1121.00001,2,2477328,2481046,-,3718
404,BUMA.1121.00108,2,3179054,3182768,+,3714
404,BUMA.1121.00083,2,1590818,1594537,+,3719
404,BUMA.1121.00080,2,2964550,2968264,+,3714
404,BUMA.1121.00012,2,2043097,2046815,-,3718
405,BUMA.1121.00011,2,1561386,1568717,+,7331
405,BUMA.1121.00009,2,1596906,1604236,+,7330
405,BUMA.1121.00039,2,1012472,1019788,-,7316
405,BUMA.1121.00029,2,1579121,1586437,-,7316
405,BUMA.1121.00021,2,254381,261698,+,7317
405,BUMA.1121.00107,2,849490,856821,-,7331
405,BUMA.1121.00023,2,3089683,3097000,+,7317
405,BUMA.1121.00067,2,1000852,1008182,-,7330
405,BUMA.1121.00035,2,1659830,1667146,-,7316
405,BUMA.1121.00005,2,961492,968772,-,7280
405,BUMA.1121.00100,2,963706,971036,+,7330
405,BUMA.1121.00016,2,807739,815055,-,7316
405,BUMA.1121.00099,2,3207992,3215323,+,7331
405,BUMA.1121.00094,2,2955358,2962691,+,7333
405,BUMA.1121.00093,2,3137158,3144488,-,7330
405,BUMA.1121.00097,2,2794177,2801508,+,7331
405,BUMA.1121.00109,2,1690207,1697535,-,7328
405,BUMA.1121.00018,2,910069,917385,-,7316
405,BUMA.1121.00110,2,2922227,2929554,+,7327
405,BUMA.1121.00079,2,2912798,2920128,+,7330
405,BUMA.1121.00075,2,3056587,3063902,-,7315
405,BUMA.1121.00066,2,2905692,2913021,+,7329
405,BUMA.1121.00089,2,2901264,2908596,+,7332
405,BUMA.1121.00057,2,2289821,2297152,-,7331
405,BUMA.1121.00090,2,692359,699676,+,7317
405,BUMA.1121.00027,2,853558,860886,+,7328
405,BUMA.1121.00062,2,1969855,1977186,-,7331
405,BUMA.1121.00091,2,672351,679678,-,7327
405,BUMA.1121.00098,2,8022,15339,+,7317
405,BUMA.1121.00092,2,2938931,2946262,+,7331
405,BUMA.1121.00031,2,2130338,2137655,+,7317
405,BUMA.1121.00096,2,3273975,3281287,+,7312
405,BUMA.1121.00073,2,2922216,2929545,+,7329
405,BUMA.1121.00103,2,1623478,1630810,+,7332
405,BUMA.1121.00084,2,1639578,1646910,+,7332
405,BUMA.1121.00014,2,3069042,3076359,+,7317
405,BUMA.1121.00111,2,2231105,2238422,+,7317
405,BUMA.1121.00007,2,3041565,3048883,+,7318
405,BUMA.1121.00072,2,2899896,2907225,+,7329
405,BUMA.1121.00071,2,2921471,2928800,+,7329
405,BUMA.1121.00077,2,686402,693731,-,7329
405,BUMA.1121.00003,2,1128030,1135362,+,7332
405,BUMA.1121.00104,2,3020091,3027408,+,7317
405,BUMA.1121.00074,2,1444442,1451773,-,7331
405,BUMA.1121.00060,2,2413798,2421127,-,7329
405,BUMA.1121.00088,2,2935578,2942910,+,7332
405,BUMA.1121.00053,2,23752,31071,+,7319
405,BUMA.1121.00025,2,1415529,1422846,+,7317
405,BUMA.1121.00070,2,2901515,2908844,+,7329
405,BUMA.1121.00049,2,1576112,1583430,+,7318
405,BUMA.1121.00078,2,170690,178020,-,7330
405,BUMA.1121.00069,2,2871780,2879109,+,7329
405,BUMA.1121.00102,2,2991883,2999214,+,7331
405,BUMA.1121.00112,2,1399371,1406701,-,7330
405,BUMA.1121.00041,2,678249,685578,+,7329
405,BUMA.1121.00068,2,1532600,1539917,+,7317
405,BUMA.1121.00076,2,681392,688709,+,7317
405,BUMA.1121.00033,2,453627,460943,+,7316
405,BUMA.1121.00101,2,462873,470203,-,7330
405,BUMA.1121.00105,2,2706361,2713692,-,7331
405,BUMA.1121.00061,2,2904722,2912051,+,7329
405,BUMA.1121.00063,2,2915489,2922818,+,7329
405,BUMA.1121.00059,2,673458,680785,-,7327
405,BUMA.1121.00058,2,314790,322121,+,7331
405,BUMA.1121.00043,2,2652285,2659601,-,7316
405,BUMA.1121.00055,2,2881358,2888686,-,7328
405,BUMA.1121.00065,2,3026319,3033636,+,7317
405,BUMA.1121.00064,2,2838341,2845673,+,7332
405,BUMA.1121.00047,2,729226,736557,+,7331
405,BUMA.1121.00037,2,44414,51731,+,7317
405,BUMA.1121.00106,2,2212252,2219583,+,7331
405,BUMA.1121.00051,2,2916035,2923366,+,7331
405,BUMA.1121.00045,2,2843935,2851265,+,7330
405,BUMA.1121.00056,2,1083154,1090485,-,7331
405,BUMA.1121.00095,2,1816563,1823880,+,7317
405,BUMA.1121.00082,2,2974886,2982215,+,7329
405,BUMA.1121.00001,2,2465746,2473062,-,7316
405,BUMA.1121.00108,2,3187038,3194326,+,7288
405,BUMA.1121.00083,2,1598802,1606131,+,7329
405,BUMA.1121.00080,2,2972534,2979865,+,7331
405,BUMA.1121.00012,2,2031515,2038831,-,7316
406,BUMA.1121.00011,2,1568724,1583535,+,14811
406,BUMA.1121.00009,2,1604243,1618836,+,14593
406,BUMA.1121.00039,2,997696,1012465,-,14769
406,BUMA.1121.00029,2,1564506,1579114,-,14608
406,BUMA.1121.00021,2,261705,276439,+,14734
406,BUMA.1121.00107,2,834682,849483,-,14801
406,BUMA.1121.00023,2,3097007,3111717,+,14710
406,BUMA.1121.00067,2,986125,1000845,-,14720
406,BUMA.1121.00035,2,1645226,1659823,-,14597
406,BUMA.1121.00005,2,946489,961485,-,14996
406,BUMA.1121.00100,2,971043,985893,+,14850
406,BUMA.1121.00016,2,793099,807732,-,14633
406,BUMA.1121.00099,2,3215330,3230159,+,14829
406,BUMA.1121.00094,2,2962698,2977577,+,14879
406,BUMA.1121.00093,2,3122379,3137151,-,14772
406,BUMA.1121.00097,2,2801515,2816290,+,14775
406,BUMA.1121.00109,2,1675341,1690200,-,14859
406,BUMA.1121.00018,2,895414,910062,-,14648
406,BUMA.1121.00110,2,2929561,2944320,+,14759
406,BUMA.1121.00079,2,2920135,2934993,+,14858
406,BUMA.1121.00075,2,3041709,3056580,-,14871
406,BUMA.1121.00066,2,2913028,2927629,+,14601
406,BUMA.1121.00089,2,2908603,2923522,+,14919
406,BUMA.1121.00057,2,2274894,2289814,-,14920
406,BUMA.1121.00090,2,699683,714533,+,14850
406,BUMA.1121.00027,2,860893,875638,+,14745
406,BUMA.1121.00062,2,1955175,1969848,-,14673
406,BUMA.1121.00091,2,657536,672344,-,14808
406,BUMA.1121.00098,2,15346,30293,+,14947
406,BUMA.1121.00092,2,2946269,2961041,+,14772
406,BUMA.1121.00031,2,2137662,2152323,+,14661
406,BUMA.1121.00096,2,3281294,3296071,+,14777
406,BUMA.1121.00073,2,2929552,2944154,+,14602
406,BUMA.1121.00103,2,1630817,1645788,+,14971
406,BUMA.1121.00084,2,1646917,1661951,+,15034
406,BUMA.1121.00014,2,3076366,3091134,+,14768
406,BUMA.1121.00111,2,2238429,2253303,+,14874
406,BUMA.1121.00007,2,3048890,3063665,+,14775
406,BUMA.1121.00072,2,2907232,2921833,+,14601
406,BUMA.1121.00071,2,2928807,2943393,+,14586
406,BUMA.1121.00077,2,671540,686395,-,14855
406,BUMA.1121.00003,2,1135369,1150171,+,14802
406,BUMA.1121.00104,2,3027415,3042215,+,14800
406,BUMA.1121.00074,2,1429650,1444435,-,14785
406,BUMA.1121.00060,2,2399186,2413791,-,14605
406,BUMA.1121.00088,2,2942917,2957753,+,14836
406,BUMA.1121.00053,2,31078,45909,+,14831
406,BUMA.1121.00025,2,1422853,1437509,+,14656
406,BUMA.1121.00070,2,2908851,2923445,+,14594
406,BUMA.1121.00049,2,1583437,1598469,+,15032
406,BUMA.1121.00078,2,155898,170683,-,14785
406,BUMA.1121.00069,2,2879116,2893701,+,14585
406,BUMA.1121.00102,2,2999221,3014250,+,15029
406,BUMA.1121.00112,2,1384518,1399364,-,14846
406,BUMA.1121.00041,2,685585,700384,+,14799
406,BUMA.1121.00068,2,1539924,1554579,+,14655
406,BUMA.1121.00076,2,688716,703508,+,14792
406,BUMA.1121.00033,2,460950,475900,+,14950
406,BUMA.1121.00101,2,447988,462866,-,14878
406,BUMA.1121.00105,2,2691418,2706354,-,14936
406,BUMA.1121.00061,2,2912058,2926620,+,14562
406,BUMA.1121.00063,2,2922825,2937440,+,14615
406,BUMA.1121.00059,2,658455,673451,-,14996
406,BUMA.1121.00058,2,322128,336894,+,14766
406,BUMA.1121.00043,2,2637517,2652278,-,14761
406,BUMA.1121.00055,2,2866607,2881351,-,14744
406,BUMA.1121.00065,2,3033643,3048371,+,14728
406,BUMA.1121.00064,2,2845680,2860547,+,14867
406,BUMA.1121.00047,2,736564,751644,+,15080
406,BUMA.1121.00037,2,51738,66608,+,14870
406,BUMA.1121.00106,2,2219590,2234507,+,14917
406,BUMA.1121.00051,2,2923373,2938225,+,14852
406,BUMA.1121.00045,2,2851272,2865890,+,14618
406,BUMA.1121.00056,2,1068228,1083147,-,14919
406,BUMA.1121.00095,2,1823887,1838707,+,14820
406,BUMA.1121.00082,2,2982222,2996850,+,14628
406,BUMA.1121.00001,2,2451100,2465739,-,14639
406,BUMA.1121.00108,2,47,14777,+,14730
406,BUMA.1121.00083,2,1606138,1620766,+,14628
406,BUMA.1121.00080,2,2979872,2994847,+,14975
406,BUMA.1121.00012,2,2016808,2031508,-,14700
407,BUMA.1121.00011,2,1585603,1591651,+,6048
407,BUMA.1121.00009,2,1620904,1626934,+,6030
407,BUMA.1121.00039,2,989581,995628,-,6047
407,BUMA.1121.00029,2,1556388,1562438,-,6050
407,BUMA.1121.00021,2,278507,284539,+,6032
407,BUMA.1121.00107,2,826591,832624,-,6033
407,BUMA.1121.00023,2,3113785,3119862,+,6077
407,BUMA.1121.00067,2,979654,985674,-,6020
407,BUMA.1121.00035,2,1637108,1643158,-,6050
407,BUMA.1121.00005,2,938371,944420,-,6049
407,BUMA.1121.00100,2,986347,992384,+,6037
407,BUMA.1121.00016,2,784980,791031,-,6051
407,BUMA.1121.00099,2,3232227,3238312,+,6085
407,BUMA.1121.00094,2,2978028,2984103,+,6075
407,BUMA.1121.00093,2,3114289,3120310,-,6021
407,BUMA.1121.00097,2,2818356,2824391,+,6035
407,BUMA.1121.00109,2,1666333,1672412,-,6079
407,BUMA.1121.00018,2,887322,893346,-,6024
407,BUMA.1121.00110,2,2946389,2952441,+,6052
407,BUMA.1121.00079,2,2935444,2941520,+,6076
407,BUMA.1121.00075,2,3033546,3039639,-,6093
407,BUMA.1121.00066,2,2928080,2934134,+,6054
407,BUMA.1121.00089,2,2923973,2930049,+,6076
407,BUMA.1121.00057,2,2268358,2274443,-,6085
407,BUMA.1121.00090,2,716601,722657,+,6056
407,BUMA.1121.00027,2,876089,882177,+,6088
407,BUMA.1121.00062,2,1948683,1954724,-,6041
407,BUMA.1121.00091,2,650986,657085,-,6099
407,BUMA.1121.00098,2,32362,38438,+,6076
407,BUMA.1121.00092,2,2963110,2969131,+,6021
407,BUMA.1121.00031,2,2154391,2160453,+,6062
407,BUMA.1121.00096,2,3298138,3304219,+,6081
407,BUMA.1121.00073,2,2944605,2950677,+,6072
407,BUMA.1121.00103,2,1647857,1653952,+,6095
407,BUMA.1121.00084,2,1662402,1668430,+,6028
407,BUMA.1121.00014,2,3093202,3099264,+,6062
407,BUMA.1121.00111,2,2255371,2261409,+,6038
407,BUMA.1121.00007,2,3065734,3071613,+,5879
407,BUMA.1121.00072,2,2922284,2928356,+,6072
407,BUMA.1121.00071,2,2943844,2949917,+,6073
407,BUMA.1121.00077,2,663420,669473,-,6053
407,BUMA.1121.00003,2,1150625,1156679,+,6054
407,BUMA.1121.00104,2,3044285,3050328,+,6043
407,BUMA.1121.00074,2,1421529,1427582,-,6053
407,BUMA.1121.00060,2,2391059,2397119,-,6060
407,BUMA.1121.00088,2,2958204,2964232,+,6028
407,BUMA.1121.00053,2,47978,54044,+,6066
407,BUMA.1121.00025,2,1439577,1445601,+,6024
407,BUMA.1121.00070,2,2923896,2929967,+,6071
407,BUMA.1121.00049,2,1600537,1606618,+,6081
407,BUMA.1121.00078,2,147801,153829,-,6028
407,BUMA.1121.00069,2,2894152,2900241,+,6089
407,BUMA.1121.00102,2,3016320,3022357,+,6037
407,BUMA.1121.00112,2,1376415,1382450,-,6035
407,BUMA.1121.00041,2,700835,706898,+,6063
407,BUMA.1121.00068,2,1555033,1561082,+,6049
407,BUMA.1121.00076,2,705578,711678,+,6100
407,BUMA.1121.00033,2,477968,484018,+,6050
407,BUMA.1121.00101,2,439872,445919,-,6047
407,BUMA.1121.00105,2,2684876,2690967,-,6091
407,BUMA.1121.00061,2,2927071,2933142,+,6071
407,BUMA.1121.00063,2,2937891,2943971,+,6080
407,BUMA.1121.00059,2,651978,658004,-,6026
407,BUMA.1121.00058,2,337345,343394,+,6049
407,BUMA.1121.00043,2,2629393,2635449,-,6056
407,BUMA.1121.00055,2,2860107,2866156,-,6049
407,BUMA.1121.00065,2,3050441,3056498,+,6057
407,BUMA.1121.00064,2,2862615,2868668,+,6053
407,BUMA.1121.00047,2,752095,758170,+,6075
407,BUMA.1121.00037,2,68676,74726,+,6050
407,BUMA.1121.00106,2,2236575,2242662,+,6087
407,BUMA.1121.00051,2,2938676,2944750,+,6074
407,BUMA.1121.00045,2,2867957,2874017,+,6060
407,BUMA.1121.00056,2,1061701,1067777,-,6076
407,BUMA.1121.00095,2,1840775,1846796,+,6021
407,BUMA.1121.00082,2,2997301,3003393,+,6092
407,BUMA.1121.00001,2,2442982,2449032,-,6050
407,BUMA.1121.00108,2,16845,22932,+,6087
407,BUMA.1121.00083,2,1621217,1627309,+,6092
407,BUMA.1121.00080,2,2995298,3001372,+,6074
407,BUMA.1121.00012,2,2008684,2014740,-,6056
408,BUMA.1121.00011,2,1591853,1620801,+,28948
408,BUMA.1121.00009,2,1627166,1656120,+,28954
408,BUMA.1121.00039,2,959098,988025,-,28927
408,BUMA.1121.00029,2,1525852,1554832,-,28980
408,BUMA.1121.00021,2,284741,313684,+,28943
408,BUMA.1121.00107,2,797501,826400,-,28899
408,BUMA.1121.00023,2,3120064,3149050,+,28986
408,BUMA.1121.00067,2,950464,979452,-,28988
408,BUMA.1121.00035,2,1607917,1636906,-,28989
408,BUMA.1121.00005,2,909251,938159,-,28908
408,BUMA.1121.00100,2,992586,1021574,+,28988
408,BUMA.1121.00016,2,754488,783424,-,28936
408,BUMA.1121.00099,2,3238503,3267445,+,28942
408,BUMA.1121.00094,2,2984305,3013234,+,28929
408,BUMA.1121.00093,2,3085103,3114087,-,28984
408,BUMA.1121.00097,2,2824593,2853568,+,28975
408,BUMA.1121.00109,2,1637148,1666121,-,28973
408,BUMA.1121.00018,2,858170,887120,-,28950
408,BUMA.1121.00110,2,2952653,2981593,+,28940
408,BUMA.1121.00079,2,2941742,2970678,+,28936
408,BUMA.1121.00075,2,3004405,3033344,-,28939
408,BUMA.1121.00066,2,2934345,2963320,+,28975
408,BUMA.1121.00089,2,2930251,2959190,+,28939
408,BUMA.1121.00057,2,2239190,2268146,-,28956
408,BUMA.1121.00090,2,722859,751813,+,28954
408,BUMA.1121.00027,2,882389,911350,+,28961
408,BUMA.1121.00062,2,1919511,1948481,-,28970
408,BUMA.1121.00091,2,621821,650764,-,28943
408,BUMA.1121.00098,2,38650,67562,+,28912
408,BUMA.1121.00092,2,2969333,2998320,+,28987
408,BUMA.1121.00031,2,2160655,2189582,+,28927
408,BUMA.1121.00096,2,3304421,3333396,+,28975
408,BUMA.1121.00073,2,2950889,2979867,+,28978
408,BUMA.1121.00103,2,1654161,1683031,+,28870
408,BUMA.1121.00084,2,1668632,1697684,+,29052
408,BUMA.1121.00014,2,3099466,3128403,+,28937
408,BUMA.1121.00111,2,2261611,2290512,+,28901
408,BUMA.1121.00007,2,3071815,3100799,+,28984
408,BUMA.1121.00072,2,2928568,2957545,+,28977
408,BUMA.1121.00071,2,2950128,2979099,+,28971
408,BUMA.1121.00077,2,634269,663190,-,28921
408,BUMA.1121.00003,2,1156881,1185870,+,28989
408,BUMA.1121.00104,2,3050560,3079533,+,28973
408,BUMA.1121.00074,2,1392241,1421327,-,29086
408,BUMA.1121.00060,2,2361926,2390857,-,28931
408,BUMA.1121.00088,2,2964434,2993366,+,28932
408,BUMA.1121.00053,2,54256,83181,+,28925
408,BUMA.1121.00025,2,1445803,1474754,+,28951
408,BUMA.1121.00070,2,2930179,2959155,+,28976
408,BUMA.1121.00049,2,1606820,1635823,+,29003
408,BUMA.1121.00078,2,118653,147589,-,28936
408,BUMA.1121.00069,2,2900453,2929433,+,28980
408,BUMA.1121.00102,2,3022569,3051484,+,28915
408,BUMA.1121.00112,2,1347142,1376173,-,29031
408,BUMA.1121.00041,2,707100,736037,+,28937
408,BUMA.1121.00068,2,1561284,1590320,+,29036
408,BUMA.1121.00076,2,711880,740824,+,28944
408,BUMA.1121.00033,2,484220,513164,+,28944
408,BUMA.1121.00101,2,410628,439635,-,29007
408,BUMA.1121.00105,2,2655671,2684674,-,29003
408,BUMA.1121.00061,2,2933354,2962330,+,28976
408,BUMA.1121.00063,2,2944183,2973158,+,28975
408,BUMA.1121.00059,2,622730,651776,-,29046
408,BUMA.1121.00058,2,343636,372570,+,28934
408,BUMA.1121.00043,2,2598867,2627837,-,28970
408,BUMA.1121.00055,2,2830886,2859867,-,28981
408,BUMA.1121.00065,2,3056710,3085663,+,28953
408,BUMA.1121.00064,2,2868870,2897876,+,29006
408,BUMA.1121.00047,2,758372,787303,+,28931
408,BUMA.1121.00037,2,76282,105226,+,28944
408,BUMA.1121.00106,2,2242864,2271796,+,28932
408,BUMA.1121.00051,2,2944952,2973862,+,28910
408,BUMA.1121.00045,2,2874219,2903150,+,28931
408,BUMA.1121.00056,2,1032560,1061499,-,28939
408,BUMA.1121.00095,2,1847005,1875937,+,28932
408,BUMA.1121.00082,2,3003605,3032586,+,28981
408,BUMA.1121.00001,2,2412456,2441426,-,28970
408,BUMA.1121.00108,2,23135,52123,+,28988
408,BUMA.1121.00083,2,1627521,1656502,+,28981
408,BUMA.1121.00080,2,3001574,3030494,+,28920
408,BUMA.1121.00012,2,1979496,2008482,-,28986
409,BUMA.1121.00011,2,1620802,1649564,+,28762
409,BUMA.1121.00009,2,1656121,1684854,+,28733
409,BUMA.1121.00039,2,930542,959096,-,28554
409,BUMA.1121.00029,2,1497098,1525850,-,28752
409,BUMA.1121.00021,2,313685,342397,+,28712
409,BUMA.1121.00107,2,769068,797499,-,28431
409,BUMA.1121.00023,2,3149051,3177821,+,28770
409,BUMA.1121.00067,2,921603,950462,-,28859
409,BUMA.1121.00035,2,1579186,1607915,-,28729
409,BUMA.1121.00005,2,880570,909249,-,28679
409,BUMA.1121.00100,2,1021575,1050344,+,28769
409,BUMA.1121.00016,2,725727,754486,-,28759
409,BUMA.1121.00099,2,31,28695,+,28664
409,BUMA.1121.00094,2,3013235,3041901,+,28666
409,BUMA.1121.00093,2,3056261,3085101,-,28840
409,BUMA.1121.00097,2,2853569,2882314,+,28745
409,BUMA.1121.00109,2,1608408,1637146,-,28738
409,BUMA.1121.00018,2,829720,858168,-,28448
409,BUMA.1121.00110,2,2981594,3010158,+,28564
409,BUMA.1121.00079,2,2970679,3000687,+,30008
409,BUMA.1121.00075,2,2975621,3004403,-,28782
409,BUMA.1121.00066,2,2963321,2992061,+,28740
409,BUMA.1121.00089,2,2959191,2989152,+,29961
409,BUMA.1121.00057,2,2210370,2239188,-,28818
409,BUMA.1121.00090,2,751814,780595,+,28781
409,BUMA.1121.00027,2,911351,940058,+,28707
409,BUMA.1121.00062,2,1890675,1919509,-,28834
409,BUMA.1121.00091,2,593144,621819,-,28675
409,BUMA.1121.00098,2,67563,96342,+,28779
409,BUMA.1121.00092,2,2998321,3027162,+,28841
409,BUMA.1121.00031,2,2189583,2218293,+,28710
409,BUMA.1121.00096,2,3333397,3361913,+,28516
409,BUMA.1121.00073,2,2979868,3008613,+,28745
409,BUMA.1121.00103,2,1683032,1711756,+,28724
409,BUMA.1121.00084,2,1697685,1726473,+,28788
409,BUMA.1121.00014,2,3128404,3156964,+,28560
409,BUMA.1121.00111,2,2290513,2319264,+,28751
409,BUMA.1121.00007,2,3100800,3129536,+,28736
409,BUMA.1121.00072,2,2957546,2986283,+,28737
409,BUMA.1121.00071,2,2979100,3007843,+,28743
409,BUMA.1121.00077,2,605706,634267,-,28561
409,BUMA.1121.00003,2,1185871,1214485,+,28614
409,BUMA.1121.00104,2,3079534,3108345,+,28811
409,BUMA.1121.00074,2,1363403,1392239,-,28836
409,BUMA.1121.00060,2,2333306,2361924,-,28618
409,BUMA.1121.00088,2,2993367,3022110,+,28743
409,BUMA.1121.00053,2,83182,111778,+,28596
409,BUMA.1121.00025,2,1474755,1503204,+,28449
409,BUMA.1121.00070,2,2959156,2987900,+,28744
409,BUMA.1121.00049,2,1635824,1664643,+,28819
409,BUMA.1121.00078,2,89998,118651,-,28653
409,BUMA.1121.00069,2,2929434,2958177,+,28743
409,BUMA.1121.00102,2,3051485,3080360,+,28875
409,BUMA.1121.00112,2,1318263,1347140,-,28877
409,BUMA.1121.00041,2,736038,764739,+,28701
409,BUMA.1121.00068,2,1590321,1619042,+,28721
409,BUMA.1121.00076,2,740825,769610,+,28785
409,BUMA.1121.00033,2,513165,541893,+,28728
409,BUMA.1121.00101,2,381915,410626,-,28711
409,BUMA.1121.00105,2,2626923,2655669,-,28746
409,BUMA.1121.00061,2,2962331,2991079,+,28748
409,BUMA.1121.00063,2,2973159,3001909,+,28750
409,BUMA.1121.00059,2,593958,622728,-,28770
409,BUMA.1121.00058,2,372571,401174,+,28603
409,BUMA.1121.00043,2,2570093,2598865,-,28772
409,BUMA.1121.00055,2,2802144,2830884,-,28740
409,BUMA.1121.00065,2,3085664,3114330,+,28666
409,BUMA.1121.00064,2,2897877,2926681,+,28804
409,BUMA.1121.00047,2,787304,817211,+,29907
409,BUMA.1121.00037,2,105227,133791,+,28564
409,BUMA.1121.00106,2,2271797,2300490,+,28693
409,BUMA.1121.00051,2,2973863,3003895,+,30032
409,BUMA.1121.00045,2,2903151,2931770,+,28619
409,BUMA.1121.00056,2,1002598,1032558,-,29960
409,BUMA.1121.00095,2,1875938,1904486,+,28548
409,BUMA.1121.00082,2,3032587,3061347,+,28760
409,BUMA.1121.00001,2,2383702,2412454,-,28752
409,BUMA.1121.00108,2,52124,80710,+,28586
409,BUMA.1121.00083,2,1656503,1685263,+,28760
409,BUMA.1121.00080,2,3030495,3060536,+,30041
409,BUMA.1121.00012,2,1950669,1979494,-,28825
410,BUMA.1121.00011,2,1649565,1661991,+,12426
410,BUMA.1121.00009,2,1684855,1697289,+,12434
410,BUMA.1121.00039,2,918123,930540,-,12417
410,BUMA.1121.00029,2,1484678,1497096,-,12418
410,BUMA.1121.00021,2,342398,354823,+,12425
410,BUMA.1121.00107,2,756739,769066,-,12327
410,BUMA.1121.00023,2,3177822,3190278,+,12456
410,BUMA.1121.00067,2,909235,921601,-,12366
410,BUMA.1121.00035,2,1566776,1579184,-,12408
410,BUMA.1121.00005,2,868221,880568,-,12347
410,BUMA.1121.00100,2,1050345,1062686,+,12341
410,BUMA.1121.00016,2,713323,725725,-,12402
410,BUMA.1121.00099,2,28696,41138,+,12442
410,BUMA.1121.00094,2,3041902,3054256,+,12354
410,BUMA.1121.00093,2,3043944,3056259,-,12315
410,BUMA.1121.00097,2,2882315,2894674,+,12359
410,BUMA.1121.00109,2,1596065,1608406,-,12341
410,BUMA.1121.00018,2,817310,829718,-,12408
410,BUMA.1121.00110,2,3010159,3022517,+,12358
410,BUMA.1121.00079,2,3000688,3013004,+,12316
410,BUMA.1121.00075,2,2963205,2975619,-,12414
410,BUMA.1121.00066,2,2992062,3004395,+,12333
410,BUMA.1121.00089,2,2989153,3001470,+,12317
410,BUMA.1121.00057,2,2198042,2210368,-,12326
410,BUMA.1121.00090,2,780596,793016,+,12420
410,BUMA.1121.00027,2,940059,952437,+,12378
410,BUMA.1121.00062,2,1878306,1890673,-,12367
410,BUMA.1121.00091,2,580808,593142,-,12334
410,BUMA.1121.00098,2,96343,108727,+,12384
410,BUMA.1121.00092,2,3027163,3039484,+,12321
410,BUMA.1121.00031,2,2218294,2230710,+,12416
410,BUMA.1121.00096,2,26,12393,+,12367
410,BUMA.1121.00073,2,3008614,3020917,+,12303
410,BUMA.1121.00103,2,1711757,1724116,+,12359
410,BUMA.1121.00084,2,1726474,1738791,+,12317
410,BUMA.1121.00014,2,3156965,3169387,+,12422
410,BUMA.1121.00111,2,2319265,2331716,+,12451
410,BUMA.1121.00007,2,3129537,3141992,+,12455
410,BUMA.1121.00072,2,2986284,2998534,+,12250
410,BUMA.1121.00071,2,3007844,3020164,+,12320
410,BUMA.1121.00077,2,593343,605704,-,12361
410,BUMA.1121.00003,2,1214486,1226825,+,12339
410,BUMA.1121.00104,2,3108346,3120689,+,12343
410,BUMA.1121.00074,2,1351040,1363401,-,12361
410,BUMA.1121.00060,2,2320898,2333304,-,12406
410,BUMA.1121.00088,2,3022111,3034441,+,12330
410,BUMA.1121.00053,2,111779,124118,+,12339
410,BUMA.1121.00025,2,1503205,1515608,+,12403
410,BUMA.1121.00070,2,2987901,3000204,+,12303
410,BUMA.1121.00049,2,1664644,1676987,+,12343
410,BUMA.1121.00078,2,77639,89996,-,12357
410,BUMA.1121.00069,2,2958178,2970496,+,12318
410,BUMA.1121.00102,2,3080361,3092787,+,12426
410,BUMA.1121.00112,2,1305820,1318261,-,12441
410,BUMA.1121.00041,2,764740,776981,+,12241
410,BUMA.1121.00068,2,1619043,1631405,+,12362
410,BUMA.1121.00076,2,769611,782025,+,12414
410,BUMA.1121.00033,2,541894,554275,+,12381
410,BUMA.1121.00101,2,369690,381913,-,12223
410,BUMA.1121.00105,2,2614537,2626921,-,12384
410,BUMA.1121.00061,2,2991080,3003413,+,12333
410,BUMA.1121.00063,2,3001910,3014228,+,12318
410,BUMA.1121.00059,2,581592,593956,-,12364
410,BUMA.1121.00058,2,401175,413555,+,12380
410,BUMA.1121.00043,2,2557704,2570091,-,12387
410,BUMA.1121.00055,2,2789771,2802142,-,12371
410,BUMA.1121.00065,2,3114331,3126674,+,12343
410,BUMA.1121.00064,2,2926682,2939034,+,12352
410,BUMA.1121.00047,2,817212,829541,+,12329
410,BUMA.1121.00037,2,133792,146242,+,12450
410,BUMA.1121.00106,2,2300491,2312802,+,12311
410,BUMA.1121.00051,2,3003896,3016201,+,12305
410,BUMA.1121.00045,2,2931771,2944177,+,12406
410,BUMA.1121.00056,2,990279,1002596,-,12317
410,BUMA.1121.00095,2,1904487,1916829,+,12342
410,BUMA.1121.00082,2,3061348,3073682,+,12334
410,BUMA.1121.00001,2,2371282,2383700,-,12418
410,BUMA.1121.00108,2,80711,93099,+,12388
410,BUMA.1121.00083,2,1685264,1697598,+,12334
410,BUMA.1121.00080,2,3060537,3072854,+,12317
410,BUMA.1121.00012,2,1938233,1950667,-,12434
411,BUMA.1121.00011,2,1679870,1684946,+,5076
411,BUMA.1121.00009,2,1715108,1720158,+,5050
411,BUMA.1121.00039,2,895188,900256,-,5068
411,BUMA.1121.00029,2,1461755,1466823,-,5068
411,BUMA.1121.00021,2,372680,377745,+,5065
411,BUMA.1121.00107,2,733840,738884,-,5044
411,BUMA.1121.00023,2,3208171,3213238,+,5067
411,BUMA.1121.00067,2,886314,891351,-,5037
411,BUMA.1121.00035,2,1543843,1548911,-,5068
411,BUMA.1121.00005,2,844024,849061,-,5037
411,BUMA.1121.00100,2,1080533,1085568,+,5035
411,BUMA.1121.00016,2,690362,695413,-,5051
411,BUMA.1121.00099,2,60308,65366,+,5058
411,BUMA.1121.00094,2,3072082,3077132,+,5050
411,BUMA.1121.00093,2,3021004,3026072,-,5068
411,BUMA.1121.00097,2,2912556,2917648,+,5092
411,BUMA.1121.00109,2,1573208,1578259,-,5051
411,BUMA.1121.00018,2,794333,799400,-,5067
411,BUMA.1121.00110,2,3041619,3046678,+,5059
411,BUMA.1121.00079,2,3030821,3035871,+,5050
411,BUMA.1121.00075,2,2940212,2945270,-,5058
411,BUMA.1121.00066,2,3022280,3027347,+,5067
411,BUMA.1121.00089,2,3019290,3024340,+,5050
411,BUMA.1121.00057,2,2175103,2180175,-,5072
411,BUMA.1121.00090,2,810910,815977,+,5067
411,BUMA.1121.00027,2,970329,975385,+,5056
411,BUMA.1121.00062,2,1855352,1860420,-,5068
411,BUMA.1121.00091,2,557913,562950,-,5037
411,BUMA.1121.00098,2,127890,132948,+,5058
411,BUMA.1121.00092,2,3057359,3062424,+,5065
411,BUMA.1121.00031,2,2248608,2253675,+,5067
411,BUMA.1121.00096,2,30244,35293,+,5049
411,BUMA.1121.00073,2,3038806,3043856,+,5050
411,BUMA.1121.00103,2,1741992,1747087,+,5095
411,BUMA.1121.00084,2,1756639,1761675,+,5036
411,BUMA.1121.00014,2,3188564,3193630,+,5066
411,BUMA.1121.00111,2,2349596,2354660,+,5064
411,BUMA.1121.00007,2,3159816,3164860,+,5044
411,BUMA.1121.00072,2,3016423,3021490,+,5067
411,BUMA.1121.00071,2,3038053,3043103,+,5050
411,BUMA.1121.00077,2,569181,574239,-,5058
411,BUMA.1121.00003,2,1231517,1236554,+,5037
411,BUMA.1121.00104,2,3138571,3143607,+,5036
411,BUMA.1121.00074,2,1328119,1333156,-,5037
411,BUMA.1121.00060,2,2297960,2303041,-,5081
411,BUMA.1121.00088,2,3052271,3057298,+,5027
411,BUMA.1121.00053,2,141992,147067,+,5075
411,BUMA.1121.00025,2,1533493,1538558,+,5065
411,BUMA.1121.00070,2,3018065,3023115,+,5050
411,BUMA.1121.00049,2,1694866,1699902,+,5036
411,BUMA.1121.00078,2,54755,59827,-,5072
411,BUMA.1121.00069,2,2988377,2993442,+,5065
411,BUMA.1121.00102,2,3110628,3115695,+,5067
411,BUMA.1121.00112,2,1282983,1288034,-,5051
411,BUMA.1121.00041,2,794862,799920,+,5058
411,BUMA.1121.00068,2,1636074,1641104,+,5030
411,BUMA.1121.00076,2,799975,805032,+,5057
411,BUMA.1121.00033,2,572137,577202,+,5065
411,BUMA.1121.00101,2,346792,351842,-,5050
411,BUMA.1121.00105,2,2591633,2596701,-,5068
411,BUMA.1121.00061,2,3021291,3026358,+,5067
411,BUMA.1121.00063,2,3032127,3037184,+,5057
411,BUMA.1121.00059,2,558672,563740,-,5068
411,BUMA.1121.00058,2,431444,436480,+,5036
411,BUMA.1121.00043,2,2534744,2539810,-,5066
411,BUMA.1121.00055,2,2766747,2771836,-,5089
411,BUMA.1121.00065,2,3144489,3149526,+,5037
411,BUMA.1121.00064,2,2956904,2961940,+,5036
411,BUMA.1121.00047,2,847382,852418,+,5036
411,BUMA.1121.00037,2,164124,169189,+,5065
411,BUMA.1121.00106,2,2330681,2335708,+,5027
411,BUMA.1121.00051,2,3034015,3039065,+,5050
411,BUMA.1121.00045,2,2962035,2967115,+,5080
411,BUMA.1121.00056,2,967409,972460,-,5051
411,BUMA.1121.00095,2,1934672,1939720,+,5048
411,BUMA.1121.00082,2,3091577,3096638,+,5061
411,BUMA.1121.00001,2,2348337,2353405,-,5068
411,BUMA.1121.00108,2,110864,115919,+,5055
411,BUMA.1121.00083,2,1715493,1720554,+,5061
411,BUMA.1121.00080,2,3090678,3095727,+,5049
411,BUMA.1121.00012,2,1915264,1920330,-,5066
412,BUMA.1121.00011,2,1687907,1695116,+,7209
412,BUMA.1121.00009,2,1723201,1730391,+,7190
412,BUMA.1121.00039,2,884848,892204,-,7356
412,BUMA.1121.00029,2,1451505,1458904,-,7399
412,BUMA.1121.00021,2,380604,387864,+,7260
412,BUMA.1121.00107,2,723594,730819,-,7225
412,BUMA.1121.00023,2,3216131,3223378,+,7247
412,BUMA.1121.00067,2,874685,882037,-,7352
412,BUMA.1121.00035,2,1533702,1540963,-,7261
412,BUMA.1121.00005,2,833788,841137,-,7349
412,BUMA.1121.00100,2,1088567,1095894,+,7327
412,BUMA.1121.00016,2,680250,687429,-,7179
412,BUMA.1121.00099,2,69769,76978,+,7209
412,BUMA.1121.00094,2,3080002,3087394,+,7392
412,BUMA.1121.00093,2,3010627,3018026,-,7399
412,BUMA.1121.00097,2,2920645,2927834,+,7189
412,BUMA.1121.00109,2,1562962,1570050,-,7088
412,BUMA.1121.00018,2,784170,791479,-,7309
412,BUMA.1121.00110,2,3049741,3056872,+,7131
412,BUMA.1121.00079,2,3038835,3046148,+,7313
412,BUMA.1121.00075,2,2929854,2937233,-,7379
412,BUMA.1121.00066,2,3030393,3037904,+,7511
412,BUMA.1121.00089,2,3027186,3034587,+,7401
412,BUMA.1121.00057,2,2164532,2172053,-,7521
412,BUMA.1121.00090,2,818890,826288,+,7398
412,BUMA.1121.00027,2,978301,985413,+,7112
412,BUMA.1121.00062,2,1844570,1852133,-,7563
412,BUMA.1121.00091,2,547644,554927,-,7283
412,BUMA.1121.00098,2,136038,143263,+,7225
412,BUMA.1121.00092,2,3065403,3072891,+,7488
412,BUMA.1121.00031,2,2256557,2263849,+,7292
412,BUMA.1121.00096,2,38328,45627,+,7299
412,BUMA.1121.00073,2,3046902,3054262,+,7360
412,BUMA.1121.00103,2,1750074,1757392,+,7318
412,BUMA.1121.00084,2,1764572,1771957,+,7385
412,BUMA.1121.00014,2,3196532,3203822,+,7290
412,BUMA.1121.00111,2,2357596,2365030,+,7434
412,BUMA.1121.00007,2,3167846,3174935,+,7089
412,BUMA.1121.00072,2,3024536,3032039,+,7503
412,BUMA.1121.00071,2,3046147,3053632,+,7485
412,BUMA.1121.00077,2,558898,566038,-,7140
412,BUMA.1121.00003,2,1239596,1246825,+,7229
412,BUMA.1121.00104,2,7,7378,+,7371
412,BUMA.1121.00074,2,1316577,1323897,-,7320
412,BUMA.1121.00060,2,2287996,2295083,-,7087
412,BUMA.1121.00088,2,3060219,3067570,+,7351
412,BUMA.1121.00053,2,150099,157406,+,7307
412,BUMA.1121.00025,2,1541431,1548739,+,7308
412,BUMA.1121.00070,2,3026161,3033646,+,7485
412,BUMA.1121.00049,2,1702804,1709919,+,7115
412,BUMA.1121.00078,2,44252,51611,-,7359
412,BUMA.1121.00069,2,2996488,3003796,+,7308
412,BUMA.1121.00102,2,3118717,3126016,+,7299
412,BUMA.1121.00112,2,1272971,1280131,-,7160
412,BUMA.1121.00041,2,802914,810046,+,7132
412,BUMA.1121.00068,2,1643926,1651119,+,7193
412,BUMA.1121.00076,2,808004,815447,+,7443
412,BUMA.1121.00033,2,580202,587671,+,7469
412,BUMA.1121.00101,2,336704,343881,-,7177
412,BUMA.1121.00105,2,2581363,2588469,-,7106
412,BUMA.1121.00061,2,3029404,3036915,+,7511
412,BUMA.1121.00063,2,3040230,3047724,+,7494
412,BUMA.1121.00059,2,548312,555606,-,7294
412,BUMA.1121.00058,2,439582,446861,+,7279
412,BUMA.1121.00043,2,2524500,2531734,-,7234
412,BUMA.1121.00055,2,2756351,2763665,-,7314
412,BUMA.1121.00065,2,3152546,3159849,+,7303
412,BUMA.1121.00064,2,2964823,2972224,+,7401
412,BUMA.1121.00047,2,855412,862767,+,7355
412,BUMA.1121.00037,2,172153,179464,+,7311
412,BUMA.1121.00106,2,2338670,2346059,+,7389
412,BUMA.1121.00051,2,3041973,3049320,+,7347
412,BUMA.1121.00045,2,2970009,2977127,+,7118
412,BUMA.1121.00056,2,957418,964564,-,7146
412,BUMA.1121.00095,2,1942851,1950238,+,7387
412,BUMA.1121.00082,2,3099684,3107195,+,7511
412,BUMA.1121.00001,2,2338089,2345460,-,7371
412,BUMA.1121.00108,2,118891,126049,+,7158
412,BUMA.1121.00083,2,1723600,1731095,+,7495
412,BUMA.1121.00080,2,3098708,3106061,+,7353
412,BUMA.1121.00012,2,1904861,1912188,-,7327
413,BUMA.1121.00011,2,1695549,1703154,+,7605
413,BUMA.1121.00009,2,1730824,1738291,+,7467
413,BUMA.1121.00039,2,876934,884416,-,7482
413,BUMA.1121.00029,2,1443337,1451073,-,7736
413,BUMA.1121.00021,2,388297,395919,+,7622
413,BUMA.1121.00107,2,715629,723162,-,7533
413,BUMA.1121.00023,2,3223811,3231323,+,7512
413,BUMA.1121.00067,2,866733,874253,-,7520
413,BUMA.1121.00035,2,1525638,1533270,-,7632
413,BUMA.1121.00005,2,825789,833356,-,7567
413,BUMA.1121.00100,2,1096327,1103858,+,7531
413,BUMA.1121.00016,2,672160,679818,-,7658
413,BUMA.1121.00099,2,77411,84872,+,7461
413,BUMA.1121.00094,2,3087827,3095424,+,7597
413,BUMA.1121.00093,2,3002690,3010195,-,7505
413,BUMA.1121.00097,2,2928267,2935756,+,7489
413,BUMA.1121.00109,2,1555063,1562530,-,7467
413,BUMA.1121.00018,2,776036,783738,-,7702
413,BUMA.1121.00110,2,3057305,3064761,+,7456
413,BUMA.1121.00079,2,3046581,3054349,+,7768
413,BUMA.1121.00075,2,2921731,2929422,-,7691
413,BUMA.1121.00066,2,3038337,3045854,+,7517
413,BUMA.1121.00089,2,3035020,3042617,+,7597
413,BUMA.1121.00057,2,2156603,2164100,-,7497
413,BUMA.1121.00090,2,826721,834283,+,7562
413,BUMA.1121.00027,2,985846,993413,+,7567
413,BUMA.1121.00062,2,1836644,1844138,-,7494
413,BUMA.1121.00091,2,539660,547212,-,7552
413,BUMA.1121.00098,2,143696,151202,+,7506
413,BUMA.1121.00092,2,3073324,3080829,+,7505
413,BUMA.1121.00031,2,2264282,2271894,+,7612
413,BUMA.1121.00096,2,46060,53541,+,7481
413,BUMA.1121.00073,2,3054695,3062212,+,7517
413,BUMA.1121.00103,2,1757825,1765393,+,7568
413,BUMA.1121.00084,2,1772390,1779840,+,7450
413,BUMA.1121.00014,2,3204255,3211816,+,7561
413,BUMA.1121.00111,2,2365463,2373073,+,7610
413,BUMA.1121.00007,2,3175368,3182883,+,7515
413,BUMA.1121.00072,2,3032472,3039988,+,7516
413,BUMA.1121.00071,2,3054065,3061582,+,7517
413,BUMA.1121.00077,2,550884,558466,-,7582
413,BUMA.1121.00003,2,1247258,1254764,+,7506
413,BUMA.1121.00104,2,7811,15347,+,7536
413,BUMA.1121.00074,2,1308515,1316145,-,7630
413,BUMA.1121.00060,2,2279966,2287564,-,7598
413,BUMA.1121.00088,2,3068003,3075573,+,7570
413,BUMA.1121.00053,2,157839,165391,+,7552
413,BUMA.1121.00025,2,1549172,1556774,+,7602
413,BUMA.1121.00070,2,3034079,3041595,+,7516
413,BUMA.1121.00049,2,1710352,1717960,+,7608
413,BUMA.1121.00078,2,36250,43820,-,7570
413,BUMA.1121.00078,2,3295708,3303256,-,7548
413,BUMA.1121.00069,2,3004229,3011746,+,7517
413,BUMA.1121.00102,2,3126449,3134199,+,7750
413,BUMA.1121.00112,2,1265042,1272539,-,7497
413,BUMA.1121.00041,2,810479,818006,+,7527
413,BUMA.1121.00068,2,1651552,1659036,+,7484
413,BUMA.1121.00076,2,815880,823601,+,7721
413,BUMA.1121.00033,2,588104,595623,+,7519
413,BUMA.1121.00101,2,328787,336272,-,7485
413,BUMA.1121.00105,2,2573476,2580931,-,7455
413,BUMA.1121.00061,2,3037348,3044864,+,7516
413,BUMA.1121.00063,2,3048157,3055674,+,7517
413,BUMA.1121.00059,2,540415,547880,-,7465
413,BUMA.1121.00058,2,447294,454911,+,7617
413,BUMA.1121.00043,2,2516416,2524068,-,7652
413,BUMA.1121.00055,2,2748345,2755919,-,7574
413,BUMA.1121.00065,2,3160282,3167861,+,7579
413,BUMA.1121.00064,2,2972657,2980131,+,7474
413,BUMA.1121.00047,2,863200,871007,+,7807
413,BUMA.1121.00037,2,179897,187459,+,7562
413,BUMA.1121.00106,2,2346492,2353952,+,7460
413,BUMA.1121.00051,2,3049753,3057223,+,7470
413,BUMA.1121.00045,2,2977560,2985138,+,7578
413,BUMA.1121.00056,2,949429,956986,-,7557
413,BUMA.1121.00095,2,1950671,1958095,+,7424
413,BUMA.1121.00082,2,3107628,3115145,+,7517
413,BUMA.1121.00001,2,2330103,2337657,-,7554
413,BUMA.1121.00108,2,126482,133987,+,7505
413,BUMA.1121.00083,2,1731528,1739045,+,7517
413,BUMA.1121.00080,2,3106494,3114173,+,7679
413,BUMA.1121.00012,2,1896902,1904429,-,7527
414,BUMA.1121.00011,2,1705937,1717632,+,11695
414,BUMA.1121.00009,2,1741045,1752738,+,11693
414,BUMA.1121.00039,2,862456,874162,-,11706
414,BUMA.1121.00029,2,1428859,1440565,-,11706
414,BUMA.1121.00021,2,398702,410409,+,11707
414,BUMA.1121.00107,2,699548,711229,-,11681
414,BUMA.1121.00023,2,3234106,3245772,+,11666
414,BUMA.1121.00067,2,852246,863950,-,11704
414,BUMA.1121.00035,2,1511160,1522866,-,11706
414,BUMA.1121.00005,2,811300,823006,-,11706
414,BUMA.1121.00100,2,1106641,1118332,+,11691
414,BUMA.1121.00016,2,657671,669377,-,11706
414,BUMA.1121.00099,2,87626,99313,+,11687
414,BUMA.1121.00094,2,3098207,3109913,+,11706
414,BUMA.1121.00093,2,2988201,2999907,-,11706
414,BUMA.1121.00097,2,2938539,2950245,+,11706
414,BUMA.1121.00109,2,1539122,1550837,-,11715
414,BUMA.1121.00018,2,761580,773253,-,11673
414,BUMA.1121.00110,2,3067533,3079230,+,11697
414,BUMA.1121.00079,2,3057132,3068846,+,11714
414,BUMA.1121.00075,2,2907233,2918948,-,11715
414,BUMA.1121.00066,2,3048637,3060343,+,11706
414,BUMA.1121.00089,2,3045400,3057106,+,11706
414,BUMA.1121.00057,2,2142114,2153820,-,11706
414,BUMA.1121.00090,2,837066,848772,+,11706
414,BUMA.1121.00027,2,996196,1007902,+,11706
414,BUMA.1121.00062,2,1822164,1833861,-,11697
414,BUMA.1121.00091,2,525171,536877,-,11706
414,BUMA.1121.00098,2,153985,165691,+,11706
414,BUMA.1121.00092,2,3083612,3095318,+,11706
414,BUMA.1121.00031,2,2274677,2286386,+,11709
414,BUMA.1121.00096,2,56324,68030,+,11706
414,BUMA.1121.00073,2,3064995,3076701,+,11706
414,BUMA.1121.00103,2,1768176,1779882,+,11706
414,BUMA.1121.00084,2,1783940,1795646,+,11706
414,BUMA.1121.00014,2,3214599,3226308,+,11709
414,BUMA.1121.00111,2,2377169,2388875,+,11706
414,BUMA.1121.00007,2,3185666,3197387,+,11721
414,BUMA.1121.00072,2,3042771,3054477,+,11706
414,BUMA.1121.00071,2,3064365,3076071,+,11706
414,BUMA.1121.00077,2,536415,548112,-,11697
414,BUMA.1121.00003,2,1257547,1269254,+,11707
414,BUMA.1121.00104,2,19448,31154,+,11706
414,BUMA.1121.00074,2,1292717,1304414,-,11697
414,BUMA.1121.00060,2,2265477,2277183,-,11706
414,BUMA.1121.00088,2,3079674,3091371,+,11697
414,BUMA.1121.00053,2,168174,179878,+,11704
414,BUMA.1121.00025,2,1559557,1571231,+,11674
414,BUMA.1121.00070,2,3044378,3056084,+,11706
414,BUMA.1121.00049,2,1722061,1733776,+,11715
414,BUMA.1121.00078,2,20178,31852,-,11674
414,BUMA.1121.00078,2,3279692,3291330,-,11638
414,BUMA.1121.00069,2,3014529,3026235,+,11706
414,BUMA.1121.00102,2,3136982,3148686,+,11704
414,BUMA.1121.00112,2,1250568,1262259,-,11691
414,BUMA.1121.00041,2,820789,832495,+,11706
414,BUMA.1121.00068,2,1661819,1673525,+,11706
414,BUMA.1121.00076,2,826384,838099,+,11715
414,BUMA.1121.00033,2,598407,610113,+,11706
414,BUMA.1121.00101,2,314297,326003,-,11706
414,BUMA.1121.00105,2,2558978,2570693,-,11715
414,BUMA.1121.00061,2,3047647,3059353,+,11706
414,BUMA.1121.00063,2,3058457,3070163,+,11706
414,BUMA.1121.00059,2,525926,537632,-,11706
414,BUMA.1121.00058,2,457694,469391,+,11697
414,BUMA.1121.00043,2,2501927,2513633,-,11706
414,BUMA.1121.00055,2,2733847,2745562,-,11715
414,BUMA.1121.00065,2,3170644,3182350,+,11706
414,BUMA.1121.00064,2,2984232,2995929,+,11697
414,BUMA.1121.00047,2,873790,885496,+,11706
414,BUMA.1121.00037,2,190242,201951,+,11709
414,BUMA.1121.00106,2,2358053,2369768,+,11715
414,BUMA.1121.00051,2,3060006,3071710,+,11704
414,BUMA.1121.00045,2,2987921,2999627,+,11706
414,BUMA.1121.00056,2,934940,946646,-,11706
414,BUMA.1121.00095,2,1960878,1972574,+,11696
414,BUMA.1121.00082,2,3117928,3129634,+,11706
414,BUMA.1121.00001,2,2315613,2327331,-,11718
414,BUMA.1121.00108,2,136741,148423,+,11682
414,BUMA.1121.00083,2,1741828,1753534,+,11706
414,BUMA.1121.00080,2,3118573,3130251,+,11678
414,BUMA.1121.00012,2,1882424,1894130,-,11706
415,BUMA.1121.00011,2,1717633,1738278,+,20645
415,BUMA.1121.00009,2,1752739,1773289,+,20550
415,BUMA.1121.00039,2,842018,862454,-,20436
415,BUMA.1121.00029,2,1408334,1428857,-,20523
415,BUMA.1121.00021,2,410410,430954,+,20544
415,BUMA.1121.00107,2,679003,699546,-,20543
415,BUMA.1121.00023,2,26,20537,+,20511
415,BUMA.1121.00067,2,831634,852244,-,20610
415,BUMA.1121.00035,2,1490591,1511158,-,20567
415,BUMA.1121.00005,2,790692,811298,-,20606
415,BUMA.1121.00100,2,1118333,1138932,+,20599
415,BUMA.1121.00016,2,637240,657669,-,20429
415,BUMA.1121.00099,2,99314,119952,+,20638
415,BUMA.1121.00094,2,3109914,3130361,+,20447
415,BUMA.1121.00093,2,2967713,2988199,-,20486
415,BUMA.1121.00097,2,2950246,2970767,+,20521
415,BUMA.1121.00109,2,1518586,1539120,-,20534
415,BUMA.1121.00018,2,741118,761578,-,20460
415,BUMA.1121.00110,2,3079231,3099796,+,20565
415,BUMA.1121.00079,2,3068847,3089375,+,20528
415,BUMA.1121.00075,2,2886666,2907231,-,20565
415,BUMA.1121.00066,2,3060344,3080761,+,20417
415,BUMA.1121.00089,2,3057107,3077555,+,20448
415,BUMA.1121.00057,2,2121493,2142112,-,20619
415,BUMA.1121.00090,2,848773,869284,+,20511
415,BUMA.1121.00027,2,1007903,1028556,+,20653
415,BUMA.1121.00062,2,1801698,1822162,-,20464
415,BUMA.1121.00091,2,504658,525169,-,20511
415,BUMA.1121.00098,2,165692,186328,+,20636
415,BUMA.1121.00092,2,3095319,3115806,+,20487
415,BUMA.1121.00031,2,2286387,2306873,+,20486
415,BUMA.1121.00096,2,68031,88647,+,20616
415,BUMA.1121.00073,2,3076702,3097138,+,20436
415,BUMA.1121.00103,2,1779883,1800445,+,20562
415,BUMA.1121.00084,2,1795647,1816154,+,20507
415,BUMA.1121.00014,2,3226309,3246826,+,20517
415,BUMA.1121.00111,2,2388876,2409383,+,20507
415,BUMA.1121.00007,2,3197388,3217995,+,20607
415,BUMA.1121.00072,2,3054478,3074900,+,20422
415,BUMA.1121.00071,2,3076072,3096487,+,20415
415,BUMA.1121.00077,2,515850,536413,-,20563
415,BUMA.1121.00003,2,1269255,1289831,+,20576
415,BUMA.1121.00104,2,31155,51736,+,20581
415,BUMA.1121.00074,2,1272064,1292715,-,20651
415,BUMA.1121.00060,2,2244768,2265475,-,20707
415,BUMA.1121.00088,2,3091372,3111909,+,20537
415,BUMA.1121.00053,2,179879,200339,+,20460
415,BUMA.1121.00025,2,1571232,1591693,+,20461
415,BUMA.1121.00070,2,3056085,3076521,+,20436
415,BUMA.1121.00049,2,1733777,1754334,+,20557
415,BUMA.1121.00078,2,1,20176,-,20175
415,BUMA.1121.00078,2,3259183,3279690,-,20507
415,BUMA.1121.00069,2,3026236,3046649,+,20413
415,BUMA.1121.00102,2,3148687,3169204,+,20517
415,BUMA.1121.00112,2,1230029,1250566,-,20537
415,BUMA.1121.00041,2,832496,853040,+,20544
415,BUMA.1121.00068,2,1673526,1694068,+,20542
415,BUMA.1121.00076,2,838100,858666,+,20566
415,BUMA.1121.00033,2,610114,630657,+,20543
415,BUMA.1121.00101,2,293665,314295,-,20630
415,BUMA.1121.00105,2,2538474,2558976,-,20502
415,BUMA.1121.00061,2,3059354,3079754,+,20400
415,BUMA.1121.00063,2,3070164,3090600,+,20436
415,BUMA.1121.00059,2,505385,525924,-,20539
415,BUMA.1121.00058,2,469392,489943,+,20551
415,BUMA.1121.00043,2,2481411,2501925,-,20514
415,BUMA.1121.00055,2,2713148,2733845,-,20697
415,BUMA.1121.00065,2,3182351,3202985,+,20634
415,BUMA.1121.00064,2,2995930,3016485,+,20555
415,BUMA.1121.00047,2,885497,906050,+,20553
415,BUMA.1121.00037,2,201952,222409,+,20457
415,BUMA.1121.00106,2,2369769,2390286,+,20517
415,BUMA.1121.00051,2,3071711,3092220,+,20509
415,BUMA.1121.00045,2,2999628,3020336,+,20708
415,BUMA.1121.00056,2,914491,934938,-,20447
415,BUMA.1121.00095,2,1972575,1993147,+,20572
415,BUMA.1121.00082,2,3129635,3150071,+,20436
415,BUMA.1121.00001,2,2295128,2315611,-,20483
415,BUMA.1121.00108,2,148424,169092,+,20668
415,BUMA.1121.00083,2,1753535,1774045,+,20510
415,BUMA.1121.00080,2,3130252,3150787,+,20535
415,BUMA.1121.00012,2,1861930,1882422,-,20492
416,BUMA.1121.00011,2,1738279,1754429,+,16150
416,BUMA.1121.00009,2,1773290,1789456,+,16166
416,BUMA.1121.00039,2,825882,842016,-,16134
416,BUMA.1121.00029,2,1392159,1408332,-,16173
416,BUMA.1121.00021,2,430955,447201,+,16246
416,BUMA.1121.00107,2,662820,679001,-,16181
416,BUMA.1121.00023,2,20538,36862,+,16324
416,BUMA.1121.00067,2,815482,831632,-,16150
416,BUMA.1121.00035,2,1474371,1490589,-,16218
416,BUMA.1121.00005,2,774595,790690,-,16095
416,BUMA.1121.00100,2,1138933,1155292,+,16359
416,BUMA.1121.00016,2,621049,637238,-,16189
416,BUMA.1121.00099,2,119953,136084,+,16131
416,BUMA.1121.00094,2,3130362,3146587,+,16225
416,BUMA.1121.00093,2,2951603,2967711,-,16108
416,BUMA.1121.00097,2,2970768,2986994,+,16226
416,BUMA.1121.00109,2,1502344,1518584,-,16240
416,BUMA.1121.00018,2,724891,741116,-,16225
416,BUMA.1121.00110,2,3099797,3116010,+,16213
416,BUMA.1121.00079,2,3089376,3105657,+,16281
416,BUMA.1121.00075,2,2870539,2886664,-,16125
416,BUMA.1121.00066,2,3080762,3096940,+,16178
416,BUMA.1121.00089,2,3077556,3093791,+,16235
416,BUMA.1121.00057,2,2105383,2121491,-,16108
416,BUMA.1121.00090,2,869285,885553,+,16268
416,BUMA.1121.00027,2,1028557,1044637,+,16080
416,BUMA.1121.00062,2,1785472,1801696,-,16224
416,BUMA.1121.00091,2,488445,504656,-,16211
416,BUMA.1121.00098,2,186329,202575,+,16246
416,BUMA.1121.00092,2,3115807,3131916,+,16109
416,BUMA.1121.00031,2,2306874,2323261,+,16387
416,BUMA.1121.00096,2,88648,104817,+,16169
416,BUMA.1121.00073,2,3097139,3113317,+,16178
416,BUMA.1121.00103,2,1800446,1816644,+,16198
416,BUMA.1121.00084,2,1816155,1832403,+,16248
416,BUMA.1121.00014,2,3246827,3263214,+,16387
416,BUMA.1121.00111,2,2409384,2425605,+,16221
416,BUMA.1121.00007,2,3217996,3234214,+,16218
416,BUMA.1121.00072,2,3074901,3091079,+,16178
416,BUMA.1121.00071,2,3096488,3112665,+,16177
416,BUMA.1121.00077,2,499627,515848,-,16221
416,BUMA.1121.00003,2,1289832,1305935,+,16103
416,BUMA.1121.00104,2,51737,68021,+,16284
416,BUMA.1121.00074,2,1255856,1272062,-,16206
416,BUMA.1121.00060,2,2228614,2244766,-,16152
416,BUMA.1121.00088,2,3111910,3128089,+,16179
416,BUMA.1121.00053,2,200340,216498,+,16158
416,BUMA.1121.00025,2,1591694,1607941,+,16247
416,BUMA.1121.00070,2,3076522,3092700,+,16178
416,BUMA.1121.00049,2,1754335,1770670,+,16335
416,BUMA.1121.00078,2,3242989,3259181,-,16192
416,BUMA.1121.00069,2,3046650,3062828,+,16178
416,BUMA.1121.00102,2,3169205,3185312,+,16107
416,BUMA.1121.00112,2,1213803,1230027,-,16224
416,BUMA.1121.00041,2,853041,869364,+,16323
416,BUMA.1121.00068,2,1694069,1710252,+,16183
416,BUMA.1121.00076,2,858667,874796,+,16129
416,BUMA.1121.00033,2,630658,646966,+,16308
416,BUMA.1121.00101,2,277535,293663,-,16128
416,BUMA.1121.00105,2,2522289,2538472,-,16183
416,BUMA.1121.00061,2,3079755,3095933,+,16178
416,BUMA.1121.00063,2,3090601,3106772,+,16171
416,BUMA.1121.00059,2,489119,505383,-,16264
416,BUMA.1121.00058,2,489944,506193,+,16249
416,BUMA.1121.00043,2,2465268,2481409,-,16141
416,BUMA.1121.00055,2,2696949,2713146,-,16197
416,BUMA.1121.00065,2,3202986,3219129,+,16143
416,BUMA.1121.00064,2,3016486,3032658,+,16172
416,BUMA.1121.00047,2,906051,922265,+,16214
416,BUMA.1121.00037,2,222410,238706,+,16296
416,BUMA.1121.00106,2,2390287,2406515,+,16228
416,BUMA.1121.00051,2,3092221,3108426,+,16205
416,BUMA.1121.00045,2,3020337,3036490,+,16153
416,BUMA.1121.00056,2,898255,914489,-,16234
416,BUMA.1121.00095,2,1993148,2009290,+,16142
416,BUMA.1121.00082,2,3150072,3166250,+,16178
416,BUMA.1121.00001,2,2278908,2295126,-,16218
416,BUMA.1121.00108,2,169093,185449,+,16356
416,BUMA.1121.00083,2,1774046,1790224,+,16178
416,BUMA.1121.00080,2,3150788,3167008,+,16220
416,BUMA.1121.00012,2,1845773,1861928,-,16155
417,BUMA.1121.00011,2,1763086,1777769,+,14683
417,BUMA.1121.00009,2,1797791,1812275,+,14484
417,BUMA.1121.00039,2,801306,815873,-,14567
417,BUMA.1121.00029,2,1366260,1380852,-,14592
417,BUMA.1121.00021,2,457630,472204,+,14574
417,BUMA.1121.00107,2,639856,654409,-,14553
417,BUMA.1121.00023,2,47264,61894,+,14630
417,BUMA.1121.00067,2,792272,806855,-,14583
417,BUMA.1121.00035,2,1449831,1464465,-,14634
417,BUMA.1121.00005,2,749822,764370,-,14548
417,BUMA.1121.00100,2,1165619,1180309,+,14690
417,BUMA.1121.00016,2,596512,611071,-,14559
417,BUMA.1121.00099,2,144718,159290,+,14572
417,BUMA.1121.00094,2,1679,16347,+,14668
417,BUMA.1121.00093,2,2928746,2943291,-,14545
417,BUMA.1121.00097,2,2996667,3011278,+,14611
417,BUMA.1121.00109,2,1479379,1493897,-,14518
417,BUMA.1121.00018,2,701792,716331,-,14539
417,BUMA.1121.00110,2,3124800,3139438,+,14638
417,BUMA.1121.00079,2,1679,16355,+,14676
417,BUMA.1121.00075,2,2847507,2862108,-,14601
417,BUMA.1121.00066,2,1679,16348,+,14669
417,BUMA.1121.00089,2,1679,16326,+,14647
417,BUMA.1121.00057,2,2082180,2096764,-,14584
417,BUMA.1121.00090,2,896115,910633,+,14518
417,BUMA.1121.00027,2,1053140,1067731,+,14591
417,BUMA.1121.00062,2,1762054,1776668,-,14614
417,BUMA.1121.00091,2,463985,478513,-,14528
417,BUMA.1121.00098,2,210916,225538,+,14622
417,BUMA.1121.00092,2,1679,16224,+,14545
417,BUMA.1121.00031,2,2333370,2347937,+,14567
417,BUMA.1121.00096,2,113200,127754,+,14554
417,BUMA.1121.00073,2,1679,16323,+,14644
417,BUMA.1121.00103,2,1825057,1839575,+,14518
417,BUMA.1121.00084,2,1840756,1855367,+,14611
417,BUMA.1121.00014,2,16,14571,+,14555
417,BUMA.1121.00111,2,2435810,2450405,+,14595
417,BUMA.1121.00007,2,6081,20676,+,14595
417,BUMA.1121.00072,2,1679,16298,+,14619
417,BUMA.1121.00071,2,1679,16309,+,14630
417,BUMA.1121.00077,2,476200,490838,-,14638
417,BUMA.1121.00003,2,1314228,1328868,+,14640
417,BUMA.1121.00104,2,76531,91132,+,14601
417,BUMA.1121.00074,2,1232801,1247303,-,14502
417,BUMA.1121.00060,2,2205690,2220244,-,14554
417,BUMA.1121.00088,2,3136492,3151139,+,14647
417,BUMA.1121.00053,2,225440,239979,+,14539
417,BUMA.1121.00025,2,1616705,1631244,+,14539
417,BUMA.1121.00070,2,1679,16319,+,14640
417,BUMA.1121.00049,2,1779075,1793693,+,14618
417,BUMA.1121.00078,2,3219877,3234432,-,14555
417,BUMA.1121.00069,2,1679,16348,+,14669
417,BUMA.1121.00102,2,3942,18520,+,14578
417,BUMA.1121.00112,2,1190950,1205505,-,14555
417,BUMA.1121.00041,2,878053,892665,+,14612
417,BUMA.1121.00068,2,1718795,1733301,+,14506
417,BUMA.1121.00076,2,883503,898104,+,14601
417,BUMA.1121.00033,2,655309,669861,+,14552
417,BUMA.1121.00101,2,254695,269203,-,14508
417,BUMA.1121.00105,2,2497667,2512240,-,14573
417,BUMA.1121.00061,2,1679,16347,+,14668
417,BUMA.1121.00063,2,1679,16334,+,14655
417,BUMA.1121.00059,2,465980,480557,-,14577
417,BUMA.1121.00058,2,515986,530633,+,14647
417,BUMA.1121.00043,2,2440801,2455388,-,14587
417,BUMA.1121.00055,2,2673925,2688530,-,14605
417,BUMA.1121.00065,2,1679,16250,+,14571
417,BUMA.1121.00064,2,1679,16322,+,14643
417,BUMA.1121.00047,2,930824,945423,+,14599
417,BUMA.1121.00037,2,247323,261897,+,14574
417,BUMA.1121.00106,2,2416597,2431203,+,14606
417,BUMA.1121.00051,2,1679,16354,+,14675
417,BUMA.1121.00045,2,3044878,3059432,+,14554
417,BUMA.1121.00056,2,875274,889921,-,14647
417,BUMA.1121.00095,2,2017725,2032353,+,14628
417,BUMA.1121.00082,2,1679,16352,+,14673
417,BUMA.1121.00001,2,2254456,2269013,-,14557
417,BUMA.1121.00108,2,193814,208345,+,14531
417,BUMA.1121.00083,2,1798622,1813295,+,14673
417,BUMA.1121.00080,2,1679,16305,+,14626
417,BUMA.1121.00012,2,1821271,1835831,-,14560
418,BUMA.1121.00011,2,1778416,1783008,+,4592
418,BUMA.1121.00009,2,1812922,1817515,+,4593
418,BUMA.1121.00039,2,796064,800658,-,4594
418,BUMA.1121.00029,2,1361018,1365612,-,4594
418,BUMA.1121.00021,2,472851,477445,+,4594
418,BUMA.1121.00107,2,634615,639208,-,4593
418,BUMA.1121.00023,2,62541,67135,+,4594
418,BUMA.1121.00067,2,787030,791624,-,4594
418,BUMA.1121.00035,2,1444589,1449183,-,4594
418,BUMA.1121.00005,2,744573,749174,-,4601
418,BUMA.1121.00100,2,1180956,1185559,+,4603
418,BUMA.1121.00016,2,591270,595864,-,4594
418,BUMA.1121.00099,2,159937,164531,+,4594
418,BUMA.1121.00094,2,16994,21582,+,4588
418,BUMA.1121.00093,2,2923502,2928098,-,4596
418,BUMA.1121.00097,2,3011925,3016521,+,4596
418,BUMA.1121.00109,2,1474127,1478731,-,4604
418,BUMA.1121.00018,2,696550,701144,-,4594
418,BUMA.1121.00110,2,3140085,3144689,+,4604
418,BUMA.1121.00079,2,17002,21590,+,4588
418,BUMA.1121.00075,2,2842263,2846859,-,4596
418,BUMA.1121.00066,2,16995,21589,+,4594
418,BUMA.1121.00089,2,16973,21561,+,4588
418,BUMA.1121.00057,2,2076936,2081532,-,4596
418,BUMA.1121.00090,2,911280,915874,+,4594
418,BUMA.1121.00027,2,1068378,1072973,+,4595
418,BUMA.1121.00062,2,1756810,1761406,-,4596
418,BUMA.1121.00091,2,458741,463337,-,4596
418,BUMA.1121.00098,2,226185,230781,+,4596
418,BUMA.1121.00092,2,16871,21467,+,4596
418,BUMA.1121.00031,2,2348584,2353178,+,4594
418,BUMA.1121.00096,2,128401,132995,+,4594
418,BUMA.1121.00073,2,16970,21564,+,4594
418,BUMA.1121.00103,2,1840222,1844821,+,4599
418,BUMA.1121.00084,2,1856014,1860608,+,4594
418,BUMA.1121.00014,2,15218,19812,+,4594
418,BUMA.1121.00111,2,2451052,2455646,+,4594
418,BUMA.1121.00007,2,21323,25924,+,4601
418,BUMA.1121.00072,2,16945,21539,+,4594
418,BUMA.1121.00071,2,16956,21550,+,4594
418,BUMA.1121.00077,2,470948,475552,-,4604
418,BUMA.1121.00003,2,1329515,1334124,+,4609
418,BUMA.1121.00104,2,91779,96375,+,4596
418,BUMA.1121.00074,2,1227559,1232153,-,4594
418,BUMA.1121.00060,2,2200446,2205042,-,4596
418,BUMA.1121.00088,2,3151786,3156380,+,4594
418,BUMA.1121.00053,2,240626,245220,+,4594
418,BUMA.1121.00025,2,1631891,1636485,+,4594
418,BUMA.1121.00070,2,16966,21560,+,4594
418,BUMA.1121.00049,2,1794340,1798934,+,4594
418,BUMA.1121.00078,2,3214633,3219229,-,4596
418,BUMA.1121.00069,2,16995,21589,+,4594
418,BUMA.1121.00102,2,19167,23761,+,4594
418,BUMA.1121.00112,2,1185708,1190302,-,4594
418,BUMA.1121.00041,2,893312,897922,+,4610
418,BUMA.1121.00068,2,1733948,1738547,+,4599
418,BUMA.1121.00076,2,898751,903347,+,4596
418,BUMA.1121.00033,2,670508,675102,+,4594
418,BUMA.1121.00101,2,249464,254047,-,4583
418,BUMA.1121.00105,2,2492425,2497019,-,4594
418,BUMA.1121.00061,2,16994,21588,+,4594
418,BUMA.1121.00063,2,16981,21575,+,4594
418,BUMA.1121.00059,2,460738,465332,-,4594
418,BUMA.1121.00058,2,531280,535874,+,4594
418,BUMA.1121.00043,2,2435559,2440153,-,4594
418,BUMA.1121.00055,2,2668683,2673277,-,4594
418,BUMA.1121.00065,2,16897,21491,+,4594
418,BUMA.1121.00064,2,16969,21572,+,4603
418,BUMA.1121.00047,2,946070,950658,+,4588
418,BUMA.1121.00037,2,262544,267138,+,4594
418,BUMA.1121.00106,2,2431850,2436451,+,4601
418,BUMA.1121.00051,2,17001,21589,+,4588
418,BUMA.1121.00045,2,3060079,3064675,+,4596
418,BUMA.1121.00056,2,870038,874626,-,4588
418,BUMA.1121.00095,2,2033000,2037578,+,4578
418,BUMA.1121.00082,2,16999,21593,+,4594
418,BUMA.1121.00001,2,2249214,2253808,-,4594
418,BUMA.1121.00108,2,208992,213586,+,4594
418,BUMA.1121.00083,2,1813942,1818536,+,4594
418,BUMA.1121.00080,2,16952,21546,+,4594
418,BUMA.1121.00012,2,1816029,1820623,-,4594
419,BUMA.1121.00011,2,1783010,1805711,+,22701
419,BUMA.1121.00009,2,1817517,1840202,+,22685
419,BUMA.1121.00039,2,773294,796063,-,22769
419,BUMA.1121.00029,2,1338265,1361017,-,22752
419,BUMA.1121.00021,2,477447,500187,+,22740
419,BUMA.1121.00107,2,611921,634614,-,22693
419,BUMA.1121.00023,2,67137,89815,+,22678
419,BUMA.1121.00067,2,764292,787029,-,22737
419,BUMA.1121.00035,2,1421815,1444588,-,22773
419,BUMA.1121.00005,2,721903,744572,-,22669
419,BUMA.1121.00100,2,1185561,1208346,+,22785
419,BUMA.1121.00016,2,568563,591269,-,22706
419,BUMA.1121.00099,2,164533,187231,+,22698
419,BUMA.1121.00094,2,21584,44306,+,22722
419,BUMA.1121.00093,2,2900821,2923501,-,22680
419,BUMA.1121.00097,2,3016523,3039387,+,22864
419,BUMA.1121.00109,2,1451561,1474126,-,22565
419,BUMA.1121.00018,2,673746,696549,-,22803
419,BUMA.1121.00110,2,3144691,3167350,+,22659
419,BUMA.1121.00079,2,21592,44335,+,22743
419,BUMA.1121.00075,2,2819432,2842262,-,22830
419,BUMA.1121.00066,2,21591,44298,+,22707
419,BUMA.1121.00089,2,21563,44293,+,22730
419,BUMA.1121.00057,2,2054184,2076935,-,22751
419,BUMA.1121.00090,2,915876,938564,+,22688
419,BUMA.1121.00027,2,1072975,1095678,+,22703
419,BUMA.1121.00062,2,1734092,1756809,-,22717
419,BUMA.1121.00091,2,435960,458740,-,22780
419,BUMA.1121.00098,2,230783,253555,+,22772
419,BUMA.1121.00092,2,21469,44093,+,22624
419,BUMA.1121.00031,2,2353180,2376037,+,22857
419,BUMA.1121.00096,2,132997,155817,+,22820
419,BUMA.1121.00073,2,21566,44282,+,22716
419,BUMA.1121.00103,2,1844823,1867572,+,22749
419,BUMA.1121.00084,2,1860610,1883351,+,22741
419,BUMA.1121.00014,2,19814,42570,+,22756
419,BUMA.1121.00111,2,2455648,2478391,+,22743
419,BUMA.1121.00007,2,25926,48542,+,22616
419,BUMA.1121.00072,2,21541,44257,+,22716
419,BUMA.1121.00071,2,21552,44268,+,22716
419,BUMA.1121.00077,2,448290,470947,-,22657
419,BUMA.1121.00003,2,1347891,1370812,+,22921
419,BUMA.1121.00104,2,96377,119150,+,22773
419,BUMA.1121.00074,2,1204880,1227558,-,22678
419,BUMA.1121.00060,2,2177737,2200445,-,22708
419,BUMA.1121.00088,2,3156382,3179122,+,22740
419,BUMA.1121.00053,2,245222,267985,+,22763
419,BUMA.1121.00025,2,1636487,1659295,+,22808
419,BUMA.1121.00070,2,21562,44278,+,22716
419,BUMA.1121.00049,2,1798936,1821774,+,22838
419,BUMA.1121.00078,2,3191889,3214632,-,22743
419,BUMA.1121.00069,2,21591,44300,+,22709
419,BUMA.1121.00102,2,23763,46601,+,22838
419,BUMA.1121.00112,2,1162910,1185707,-,22797
419,BUMA.1121.00041,2,908945,931733,+,22788
419,BUMA.1121.00068,2,1738549,1761053,+,22504
419,BUMA.1121.00076,2,903349,926186,+,22837
419,BUMA.1121.00033,2,675104,697704,+,22600
419,BUMA.1121.00101,2,226811,249463,-,22652
419,BUMA.1121.00105,2,2469739,2492424,-,22685
419,BUMA.1121.00061,2,21590,44306,+,22716
419,BUMA.1121.00063,2,21577,44293,+,22716
419,BUMA.1121.00059,2,437918,460737,-,22819
419,BUMA.1121.00058,2,535876,558652,+,22776
419,BUMA.1121.00043,2,2412827,2435558,-,22731
419,BUMA.1121.00055,2,2646001,2668682,-,22681
419,BUMA.1121.00065,2,21493,44189,+,22696
419,BUMA.1121.00064,2,21574,44325,+,22751
419,BUMA.1121.00047,2,950660,973439,+,22779
419,BUMA.1121.00037,2,267140,289918,+,22778
419,BUMA.1121.00106,2,2436453,2459276,+,22823
419,BUMA.1121.00051,2,21591,44432,+,22841
419,BUMA.1121.00045,2,3064677,3087392,+,22715
419,BUMA.1121.00056,2,847259,870037,-,22778
419,BUMA.1121.00095,2,2037580,2060285,+,22705
419,BUMA.1121.00082,2,21595,44311,+,22716
419,BUMA.1121.00001,2,2226289,2249213,-,22924
419,BUMA.1121.00108,2,213588,236248,+,22660
419,BUMA.1121.00083,2,1818538,1841254,+,22716
419,BUMA.1121.00080,2,21548,44336,+,22788
419,BUMA.1121.00012,2,1793330,1816028,-,22698
420,BUMA.1121.00011,2,1807476,1810926,+,3450
420,BUMA.1121.00009,2,1841982,1845408,+,3426
420,BUMA.1121.00039,2,768068,771513,-,3445
420,BUMA.1121.00029,2,1333039,1336484,-,3445
420,BUMA.1121.00021,2,501967,505413,+,3446
420,BUMA.1121.00107,2,606706,610156,-,3450
420,BUMA.1121.00023,2,91595,95041,+,3446
420,BUMA.1121.00067,2,759066,762511,-,3445
420,BUMA.1121.00035,2,1416589,1420034,-,3445
420,BUMA.1121.00005,2,716677,720122,-,3445
420,BUMA.1121.00100,2,1210126,1213572,+,3446
420,BUMA.1121.00016,2,563337,566782,-,3445
420,BUMA.1121.00099,2,189011,192457,+,3446
420,BUMA.1121.00094,2,46086,49532,+,3446
420,BUMA.1121.00093,2,2895595,2899040,-,3445
420,BUMA.1121.00097,2,3041167,3044613,+,3446
420,BUMA.1121.00109,2,1446335,1449780,-,3445
420,BUMA.1121.00018,2,668520,671965,-,3445
420,BUMA.1121.00110,2,3169115,3172565,+,3450
420,BUMA.1121.00079,2,46115,49561,+,3446
420,BUMA.1121.00075,2,2814185,2817651,-,3466
420,BUMA.1121.00066,2,46078,49524,+,3446
420,BUMA.1121.00089,2,46073,49519,+,3446
420,BUMA.1121.00057,2,2048958,2052403,-,3445
420,BUMA.1121.00090,2,940344,943790,+,3446
420,BUMA.1121.00027,2,1097458,1100904,+,3446
420,BUMA.1121.00062,2,1728866,1732311,-,3445
420,BUMA.1121.00091,2,430734,434179,-,3445
420,BUMA.1121.00098,2,255320,258790,+,3470
420,BUMA.1121.00092,2,45873,49319,+,3446
420,BUMA.1121.00031,2,2377817,2381263,+,3446
420,BUMA.1121.00096,2,157597,161043,+,3446
420,BUMA.1121.00073,2,46062,49508,+,3446
420,BUMA.1121.00103,2,1869352,1872798,+,3446
420,BUMA.1121.00084,2,1885131,1888577,+,3446
420,BUMA.1121.00014,2,44350,47796,+,3446
420,BUMA.1121.00111,2,2480171,2483617,+,3446
420,BUMA.1121.00007,2,50322,53748,+,3426
420,BUMA.1121.00072,2,46037,49483,+,3446
420,BUMA.1121.00071,2,46048,49494,+,3446
420,BUMA.1121.00077,2,443075,446525,-,3450
420,BUMA.1121.00003,2,1372592,1376027,+,3435
420,BUMA.1121.00104,2,120930,124376,+,3446
420,BUMA.1121.00074,2,1199654,1203099,-,3445
420,BUMA.1121.00060,2,2172511,2175956,-,3445
420,BUMA.1121.00088,2,3180902,3184348,+,3446
420,BUMA.1121.00053,2,269765,273211,+,3446
420,BUMA.1121.00025,2,1661075,1664521,+,3446
420,BUMA.1121.00070,2,46058,49504,+,3446
420,BUMA.1121.00049,2,1823554,1827000,+,3446
420,BUMA.1121.00078,2,3186663,3190108,-,3445
420,BUMA.1121.00069,2,46080,49526,+,3446
420,BUMA.1121.00102,2,48381,51827,+,3446
420,BUMA.1121.00112,2,1157684,1161129,-,3445
420,BUMA.1121.00041,2,933513,936959,+,3446
420,BUMA.1121.00068,2,1762833,1766268,+,3435
420,BUMA.1121.00076,2,927966,931433,+,3467
420,BUMA.1121.00033,2,699484,702930,+,3446
420,BUMA.1121.00101,2,221585,225030,-,3445
420,BUMA.1121.00105,2,2464524,2467958,-,3434
420,BUMA.1121.00061,2,46086,49532,+,3446
420,BUMA.1121.00063,2,46073,49519,+,3446
420,BUMA.1121.00059,2,432692,436137,-,3445
420,BUMA.1121.00058,2,560432,563867,+,3435
420,BUMA.1121.00043,2,2407601,2411046,-,3445
420,BUMA.1121.00055,2,2640775,2644220,-,3445
420,BUMA.1121.00065,2,45969,49415,+,3446
420,BUMA.1121.00064,2,46105,49551,+,3446
420,BUMA.1121.00047,2,975219,978676,+,3457
420,BUMA.1121.00037,2,291698,295144,+,3446
420,BUMA.1121.00106,2,2461056,2464491,+,3435
420,BUMA.1121.00051,2,46212,49658,+,3446
420,BUMA.1121.00045,2,3089172,3092618,+,3446
420,BUMA.1121.00056,2,842033,845478,-,3445
420,BUMA.1121.00095,2,2062065,2065491,+,3426
420,BUMA.1121.00082,2,46091,49537,+,3446
420,BUMA.1121.00001,2,2221063,2224508,-,3445
420,BUMA.1121.00108,2,238028,241474,+,3446
420,BUMA.1121.00083,2,1843034,1846480,+,3446
420,BUMA.1121.00080,2,46116,49562,+,3446
420,BUMA.1121.00012,2,1788104,1791549,-,3445
421,BUMA.1121.00011,2,1810927,1815443,+,4516
421,BUMA.1121.00039,2,763551,768066,-,4515
421,BUMA.1121.00029,2,1328523,1333037,-,4514
421,BUMA.1121.00021,2,505414,509930,+,4516
421,BUMA.1121.00023,2,95042,99558,+,4516
421,BUMA.1121.00035,2,1412072,1416587,-,4515
421,BUMA.1121.00005,2,712160,716675,-,4515
421,BUMA.1121.00016,2,558822,563335,-,4513
421,BUMA.1121.00018,2,664004,668518,-,4514
421,BUMA.1121.00090,2,943791,948307,+,4516
421,BUMA.1121.00031,2,2381264,2385780,+,4516
421,BUMA.1121.00014,2,47797,52312,+,4515
421,BUMA.1121.00111,2,2483618,2488134,+,4516
421,BUMA.1121.00007,2,53749,58265,+,4516
421,BUMA.1121.00025,2,1664522,1669038,+,4516
421,BUMA.1121.00078,2,3182146,3186661,-,4515
421,BUMA.1121.00033,2,702931,707445,+,4514
421,BUMA.1121.00101,2,217068,221583,-,4515
421,BUMA.1121.00105,2,2460007,2464522,-,4515
421,BUMA.1121.00043,2,2403090,2407599,-,4509
421,BUMA.1121.00055,2,2636258,2640773,-,4515
421,BUMA.1121.00037,2,295145,299655,+,4510
421,BUMA.1121.00001,2,2216547,2221061,-,4514
421,BUMA.1121.00012,2,1783587,1788102,-,4515
422,BUMA.1121.00011,2,1817862,1825085,+,7223
422,BUMA.1121.00009,2,1847598,1854770,+,7172
422,BUMA.1121.00039,2,753971,761132,-,7161
422,BUMA.1121.00029,2,1318935,1326104,-,7169
422,BUMA.1121.00021,2,512349,519504,+,7155
422,BUMA.1121.00023,2,101977,109147,+,7170
422,BUMA.1121.00067,2,749741,756875,-,7134
422,BUMA.1121.00035,2,1402495,1409653,-,7158
422,BUMA.1121.00005,2,702556,709741,-,7185
422,BUMA.1121.00100,2,1215762,1222943,+,7181
422,BUMA.1121.00016,2,549221,556403,-,7182
422,BUMA.1121.00099,2,192460,199640,+,7180
422,BUMA.1121.00094,2,51722,58855,+,7133
422,BUMA.1121.00093,2,2886205,2893404,-,7199
422,BUMA.1121.00097,2,3044616,3051769,+,7153
422,BUMA.1121.00109,2,1409438,1416611,-,7173
422,BUMA.1121.00018,2,654428,661586,-,7158
422,BUMA.1121.00110,2,3174756,3181925,+,7169
422,BUMA.1121.00079,2,51752,58887,+,7135
422,BUMA.1121.00075,2,2804821,2811994,-,7173
422,BUMA.1121.00066,2,49525,56660,+,7135
422,BUMA.1121.00089,2,51709,58842,+,7133
422,BUMA.1121.00057,2,2041786,2048955,-,7169
422,BUMA.1121.00090,2,950726,957919,+,7193
422,BUMA.1121.00027,2,1100907,1108075,+,7168
422,BUMA.1121.00062,2,1719540,1726676,-,7136
422,BUMA.1121.00091,2,421370,428543,-,7173
422,BUMA.1121.00098,2,258793,265952,+,7159
422,BUMA.1121.00092,2,51510,58708,+,7198
422,BUMA.1121.00031,2,2388198,2395370,+,7172
422,BUMA.1121.00096,2,163234,170394,+,7160
422,BUMA.1121.00073,2,49511,56646,+,7135
422,BUMA.1121.00103,2,1874989,1882136,+,7147
422,BUMA.1121.00084,2,1890767,1897951,+,7184
422,BUMA.1121.00014,2,54731,61903,+,7172
422,BUMA.1121.00111,2,2490553,2497710,+,7157
422,BUMA.1121.00007,2,60684,67881,+,7197
422,BUMA.1121.00072,2,49485,56617,+,7132
422,BUMA.1121.00071,2,49497,56631,+,7134
422,BUMA.1121.00077,2,433714,440884,-,7170
422,BUMA.1121.00003,2,1381401,1388561,+,7160
422,BUMA.1121.00104,2,156946,164121,+,7175
422,BUMA.1121.00074,2,1190291,1197463,-,7172
422,BUMA.1121.00060,2,2163123,2170320,-,7197
422,BUMA.1121.00088,2,1793,8967,+,7174
422,BUMA.1121.00053,2,275402,282576,+,7174
422,BUMA.1121.00025,2,1671457,1678614,+,7157
422,BUMA.1121.00070,2,49505,56640,+,7135
422,BUMA.1121.00049,2,1861915,1869087,+,7172
422,BUMA.1121.00078,2,3172580,3179727,-,7147
422,BUMA.1121.00069,2,49529,56664,+,7135
422,BUMA.1121.00102,2,51830,58965,+,7135
422,BUMA.1121.00112,2,1148301,1155498,-,7197
422,BUMA.1121.00041,2,939150,946310,+,7160
422,BUMA.1121.00068,2,1768459,1775619,+,7160
422,BUMA.1121.00076,2,933624,940796,+,7172
422,BUMA.1121.00033,2,709864,717048,+,7184
422,BUMA.1121.00101,2,207492,214649,-,7157
422,BUMA.1121.00105,2,2450407,2457589,-,7182
422,BUMA.1121.00061,2,49535,56670,+,7135
422,BUMA.1121.00063,2,49522,56654,+,7132
422,BUMA.1121.00059,2,423305,430502,-,7197
422,BUMA.1121.00058,2,566058,573218,+,7160
422,BUMA.1121.00043,2,2393501,2400671,-,7170
422,BUMA.1121.00055,2,2626621,2633839,-,7218
422,BUMA.1121.00065,2,49418,56549,+,7131
422,BUMA.1121.00064,2,51741,58925,+,7184
422,BUMA.1121.00047,2,980867,988036,+,7169
422,BUMA.1121.00037,2,302074,309234,+,7160
422,BUMA.1121.00106,2,2466682,2473843,+,7161
422,BUMA.1121.00051,2,51848,58981,+,7133
422,BUMA.1121.00045,2,3094809,3102005,+,7196
422,BUMA.1121.00056,2,832709,839843,-,7134
422,BUMA.1121.00082,2,49540,56675,+,7135
422,BUMA.1121.00001,2,2206958,2214128,-,7170
422,BUMA.1121.00108,2,241477,248668,+,7191
422,BUMA.1121.00083,2,1846483,1853618,+,7135
422,BUMA.1121.00080,2,51753,58888,+,7135
422,BUMA.1121.00012,2,1773986,1781168,-,7182
423,BUMA.1121.00011,2,1825087,1832073,+,6986
423,BUMA.1121.00009,2,1854772,1861757,+,6985
423,BUMA.1121.00039,2,746984,753970,-,6986
423,BUMA.1121.00029,2,1311948,1318934,-,6986
423,BUMA.1121.00021,2,519506,526491,+,6985
423,BUMA.1121.00107,2,599274,606241,-,6967
423,BUMA.1121.00023,2,109149,116134,+,6985
423,BUMA.1121.00067,2,742836,749740,-,6904
423,BUMA.1121.00035,2,1395508,1402494,-,6986
423,BUMA.1121.00005,2,695562,702555,-,6993
423,BUMA.1121.00100,2,1222945,1229930,+,6985
423,BUMA.1121.00016,2,542234,549220,-,6986
423,BUMA.1121.00099,2,199642,206627,+,6985
423,BUMA.1121.00094,2,58857,65767,+,6910
423,BUMA.1121.00093,2,2879217,2886204,-,6987
423,BUMA.1121.00097,2,3051771,3058751,+,6980
423,BUMA.1121.00109,2,1402527,1409437,-,6910
423,BUMA.1121.00018,2,647441,654427,-,6986
423,BUMA.1121.00110,2,3181927,3188913,+,6986
423,BUMA.1121.00079,2,58889,65799,+,6910
423,BUMA.1121.00075,2,2797833,2804820,-,6987
423,BUMA.1121.00066,2,56662,63647,+,6985
423,BUMA.1121.00089,2,58844,65754,+,6910
423,BUMA.1121.00057,2,2034799,2041785,-,6986
423,BUMA.1121.00090,2,957921,964906,+,6985
423,BUMA.1121.00027,2,1108077,1115062,+,6985
423,BUMA.1121.00062,2,1712545,1719539,-,6994
423,BUMA.1121.00091,2,414383,421369,-,6986
423,BUMA.1121.00098,2,265954,272939,+,6985
423,BUMA.1121.00092,2,58710,65696,+,6986
423,BUMA.1121.00031,2,2395372,2402357,+,6985
423,BUMA.1121.00096,2,170396,177381,+,6985
423,BUMA.1121.00073,2,56648,63633,+,6985
423,BUMA.1121.00103,2,1882138,1889129,+,6991
423,BUMA.1121.00084,2,1897953,1904938,+,6985
423,BUMA.1121.00014,2,61905,68890,+,6985
423,BUMA.1121.00111,2,2497712,2504697,+,6985
423,BUMA.1121.00007,2,67883,74862,+,6979
423,BUMA.1121.00072,2,56619,63604,+,6985
423,BUMA.1121.00071,2,56633,63618,+,6985
423,BUMA.1121.00077,2,426727,433713,-,6986
423,BUMA.1121.00003,2,1388563,1395548,+,6985
423,BUMA.1121.00104,2,164123,171109,+,6986
423,BUMA.1121.00074,2,1183304,1190290,-,6986
423,BUMA.1121.00060,2,2156136,2163122,-,6986
423,BUMA.1121.00088,2,8969,15961,+,6992
423,BUMA.1121.00053,2,282578,289563,+,6985
423,BUMA.1121.00025,2,1678616,1685601,+,6985
423,BUMA.1121.00070,2,56642,63627,+,6985
423,BUMA.1121.00049,2,1869089,1876075,+,6986
423,BUMA.1121.00078,2,3165593,3172579,-,6986
423,BUMA.1121.00069,2,56666,63651,+,6985
423,BUMA.1121.00102,2,58967,65960,+,6993
423,BUMA.1121.00112,2,1141314,1148300,-,6986
423,BUMA.1121.00041,2,946312,953305,+,6993
423,BUMA.1121.00068,2,1775621,1782602,+,6981
423,BUMA.1121.00076,2,940798,947784,+,6986
423,BUMA.1121.00033,2,717050,724035,+,6985
423,BUMA.1121.00101,2,200505,207491,-,6986
423,BUMA.1121.00105,2,2443420,2450406,-,6986
423,BUMA.1121.00061,2,56672,63657,+,6985
423,BUMA.1121.00063,2,56656,63641,+,6985
423,BUMA.1121.00059,2,416303,423304,-,7001
423,BUMA.1121.00058,2,573220,580205,+,6985
423,BUMA.1121.00043,2,2386514,2393500,-,6986
423,BUMA.1121.00055,2,2619716,2626620,-,6904
423,BUMA.1121.00065,2,56551,63536,+,6985
423,BUMA.1121.00064,2,58927,65830,+,6903
423,BUMA.1121.00047,2,988038,994948,+,6910
423,BUMA.1121.00037,2,309236,316221,+,6985
423,BUMA.1121.00106,2,2473845,2480781,+,6936
423,BUMA.1121.00051,2,58983,65893,+,6910
423,BUMA.1121.00045,2,3102007,3108992,+,6985
423,BUMA.1121.00056,2,825797,832708,-,6911
423,BUMA.1121.00095,2,2065956,2072922,+,6966
423,BUMA.1121.00082,2,56677,63662,+,6985
423,BUMA.1121.00001,2,2199971,2206957,-,6986
423,BUMA.1121.00108,2,248670,255655,+,6985
423,BUMA.1121.00083,2,1853620,1860605,+,6985
423,BUMA.1121.00080,2,58890,65875,+,6985
423,BUMA.1121.00012,2,1766999,1773985,-,6986
424,BUMA.1121.00011,2,1833182,1847207,+,14025
424,BUMA.1121.00009,2,1862873,1876893,+,14020
424,BUMA.1121.00039,2,730475,744500,-,14025
424,BUMA.1121.00029,2,1296776,1310809,-,14033
424,BUMA.1121.00021,2,527607,541655,+,14048
424,BUMA.1121.00107,2,584142,598173,-,14031
424,BUMA.1121.00023,2,117250,131259,+,14009
424,BUMA.1121.00067,2,727685,741721,-,14036
424,BUMA.1121.00035,2,1380329,1394369,-,14040
424,BUMA.1121.00005,2,680464,694463,-,13999
424,BUMA.1121.00100,2,1231039,1243741,+,12702
424,BUMA.1121.00016,2,527095,541118,-,14023
424,BUMA.1121.00099,2,207736,221756,+,14020
424,BUMA.1121.00094,2,66877,80884,+,14007
424,BUMA.1121.00093,2,2864061,2878103,-,14042
424,BUMA.1121.00097,2,3059851,3073887,+,14036
424,BUMA.1121.00109,2,1386110,1401418,-,15308
424,BUMA.1121.00018,2,632303,646326,-,14023
424,BUMA.1121.00110,2,3190030,3204023,+,13993
424,BUMA.1121.00079,2,66909,80915,+,14006
424,BUMA.1121.00075,2,2782689,2796726,-,14037
424,BUMA.1121.00066,2,64763,78779,+,14016
424,BUMA.1121.00089,2,66864,80871,+,14007
424,BUMA.1121.00057,2,2019666,2033684,-,14018
424,BUMA.1121.00090,2,966030,980056,+,14026
424,BUMA.1121.00027,2,1116178,1130211,+,14033
424,BUMA.1121.00062,2,1697414,1711444,-,14030
424,BUMA.1121.00091,2,399252,413260,-,14008
424,BUMA.1121.00098,2,274049,288080,+,14031
424,BUMA.1121.00092,2,66811,80853,+,14042
424,BUMA.1121.00031,2,2403481,2417487,+,14006
424,BUMA.1121.00096,2,178488,192459,+,13971
424,BUMA.1121.00073,2,64748,78766,+,14018
424,BUMA.1121.00103,2,1890236,1904250,+,14014
424,BUMA.1121.00084,2,1906054,1920091,+,14037
424,BUMA.1121.00014,2,70014,84028,+,14014
424,BUMA.1121.00111,2,2505821,2519837,+,14016
424,BUMA.1121.00007,2,75972,89975,+,14003
424,BUMA.1121.00072,2,64720,78736,+,14016
424,BUMA.1121.00071,2,64734,78750,+,14016
424,BUMA.1121.00077,2,411618,425611,-,13993
424,BUMA.1121.00003,2,1396664,1410656,+,13992
424,BUMA.1121.00104,2,172224,186260,+,14036
424,BUMA.1121.00074,2,1168163,1182199,-,14036
424,BUMA.1121.00060,2,2126817,2140810,-,13993
424,BUMA.1121.00088,2,17071,31108,+,14037
424,BUMA.1121.00053,2,290681,304697,+,14016
424,BUMA.1121.00025,2,1686717,1700740,+,14023
424,BUMA.1121.00070,2,64741,78759,+,14018
424,BUMA.1121.00049,2,1877190,1891235,+,14045
424,BUMA.1121.00078,2,3150497,3164493,-,13996
424,BUMA.1121.00069,2,64766,78782,+,14016
424,BUMA.1121.00102,2,67093,81107,+,14014
424,BUMA.1121.00112,2,1112004,1125996,-,13992
424,BUMA.1121.00041,2,954406,968410,+,14004
424,BUMA.1121.00068,2,1783711,1797678,+,13967
424,BUMA.1121.00076,2,948892,962929,+,14037
424,BUMA.1121.00033,2,725143,739112,+,13969
424,BUMA.1121.00101,2,185393,199392,-,13999
424,BUMA.1121.00105,2,2428273,2442305,-,14032
424,BUMA.1121.00061,2,64773,78790,+,14017
424,BUMA.1121.00063,2,64757,78772,+,14015
424,BUMA.1121.00059,2,399714,413750,-,14036
424,BUMA.1121.00058,2,581321,595350,+,14029
424,BUMA.1121.00043,2,2371415,2385383,-,13968
424,BUMA.1121.00055,2,2604576,2618591,-,14015
424,BUMA.1121.00065,2,64669,78674,+,14005
424,BUMA.1121.00064,2,66940,80976,+,14036
424,BUMA.1121.00047,2,996058,1010064,+,14006
424,BUMA.1121.00037,2,317337,331369,+,14032
424,BUMA.1121.00106,2,2481896,2495940,+,14044
424,BUMA.1121.00051,2,67003,81010,+,14007
424,BUMA.1121.00045,2,3124319,3138312,+,13993
424,BUMA.1121.00056,2,810681,824688,-,14007
424,BUMA.1121.00095,2,2074030,2088028,+,13998
424,BUMA.1121.00082,2,64778,78796,+,14018
424,BUMA.1121.00001,2,2184807,2198840,-,14033
424,BUMA.1121.00108,2,256765,270767,+,14002
424,BUMA.1121.00083,2,1861721,1875739,+,14018
424,BUMA.1121.00080,2,66981,80988,+,14007
424,BUMA.1121.00012,2,1751844,1765876,-,14032
425,BUMA.1121.00011,2,1868979,1873910,+,4931
425,BUMA.1121.00009,2,1898684,1903616,+,4932
425,BUMA.1121.00039,2,703687,708619,-,4932
425,BUMA.1121.00029,2,1270083,1275014,-,4931
425,BUMA.1121.00021,2,560773,565707,+,4934
425,BUMA.1121.00107,2,560577,565511,-,4934
425,BUMA.1121.00023,2,154310,159243,+,4933
425,BUMA.1121.00067,2,703603,708534,-,4931
425,BUMA.1121.00035,2,1353635,1358567,-,4932
425,BUMA.1121.00005,2,652454,657385,-,4931
425,BUMA.1121.00100,2,1265530,1271775,+,6245
425,BUMA.1121.00016,2,503039,507971,-,4932
425,BUMA.1121.00099,2,240871,245808,+,4937
425,BUMA.1121.00094,2,100033,104964,+,4931
425,BUMA.1121.00093,2,2839963,2844898,-,4935
425,BUMA.1121.00097,2,3093017,3097950,+,4933
425,BUMA.1121.00109,2,1361979,1366910,-,4931
425,BUMA.1121.00018,2,608252,613184,-,4932
425,BUMA.1121.00110,2,3225786,3230718,+,4932
425,BUMA.1121.00079,2,100071,105001,+,4930
425,BUMA.1121.00075,2,2757366,2762295,-,4929
425,BUMA.1121.00066,2,98421,103353,+,4932
425,BUMA.1121.00089,2,100021,104952,+,4931
425,BUMA.1121.00057,2,1992976,1997908,-,4932
425,BUMA.1121.00090,2,1001817,1006751,+,4934
425,BUMA.1121.00027,2,1151964,1156895,+,4931
425,BUMA.1121.00062,2,1673375,1678306,-,4931
425,BUMA.1121.00091,2,375192,380122,-,4930
425,BUMA.1121.00098,2,307206,312142,+,4936
425,BUMA.1121.00092,2,100015,104951,+,4936
425,BUMA.1121.00031,2,2436604,2441539,+,4935
425,BUMA.1121.00096,2,211577,216509,+,4932
425,BUMA.1121.00073,2,99931,104858,+,4927
425,BUMA.1121.00103,2,1923394,1928325,+,4931
425,BUMA.1121.00084,2,1939093,1944024,+,4931
425,BUMA.1121.00014,2,103148,109319,+,6171
425,BUMA.1121.00111,2,2538951,2543884,+,4933
425,BUMA.1121.00007,2,110345,115274,+,4929
425,BUMA.1121.00072,2,91075,96008,+,4933
425,BUMA.1121.00071,2,92277,97210,+,4933
425,BUMA.1121.00077,2,384926,389857,-,4931
425,BUMA.1121.00003,2,1432470,1437380,+,4910
425,BUMA.1121.00104,2,205452,210383,+,4931
425,BUMA.1121.00074,2,1144108,1149039,-,4931
425,BUMA.1121.00060,2,2102781,2107692,-,4911
425,BUMA.1121.00088,2,51464,56395,+,4931
425,BUMA.1121.00053,2,326458,331390,+,4932
425,BUMA.1121.00025,2,1719858,1724791,+,4933
425,BUMA.1121.00070,2,99956,104883,+,4927
425,BUMA.1121.00049,2,1910439,1915371,+,4932
425,BUMA.1121.00078,2,3123786,3128718,-,4932
425,BUMA.1121.00069,2,99498,104431,+,4933
425,BUMA.1121.00102,2,100242,105172,+,4930
425,BUMA.1121.00112,2,1087952,1092880,-,4928
425,BUMA.1121.00041,2,990183,995115,+,4932
425,BUMA.1121.00068,2,1819435,1824368,+,4933
425,BUMA.1121.00076,2,983324,988254,+,4930
425,BUMA.1121.00033,2,767816,772748,+,4932
425,BUMA.1121.00101,2,158700,163630,-,4930
425,BUMA.1121.00105,2,2404156,2409086,-,4930
425,BUMA.1121.00061,2,90850,95783,+,4933
425,BUMA.1121.00063,2,91590,96523,+,4933
425,BUMA.1121.00059,2,375655,380590,-,4935
425,BUMA.1121.00058,2,614542,619475,+,4933
425,BUMA.1121.00043,2,2344776,2349708,-,4932
425,BUMA.1121.00055,2,2580531,2585461,-,4930
425,BUMA.1121.00065,2,100455,105367,+,4912
425,BUMA.1121.00064,2,100099,105031,+,4932
425,BUMA.1121.00047,2,1029220,1034150,+,4930
425,BUMA.1121.00037,2,350487,356735,+,6248
425,BUMA.1121.00106,2,2515069,2520000,+,4931
425,BUMA.1121.00051,2,100166,105096,+,4930
425,BUMA.1121.00045,2,3157436,3162347,+,4911
425,BUMA.1121.00056,2,786600,791530,-,4930
425,BUMA.1121.00095,2,2109792,2114723,+,4931
425,BUMA.1121.00082,2,100553,105486,+,4933
425,BUMA.1121.00001,2,2158114,2163045,-,4931
425,BUMA.1121.00108,2,289909,294842,+,4933
425,BUMA.1121.00083,2,1897502,1902435,+,4933
425,BUMA.1121.00080,2,100144,105073,+,4929
425,BUMA.1121.00012,2,1723818,1728749,-,4931
426,BUMA.1121.00011,2,1875304,1883232,+,7928
426,BUMA.1121.00009,2,1904968,1912895,+,7927
426,BUMA.1121.00039,2,694366,702293,-,7927
426,BUMA.1121.00029,2,1261393,1269320,-,7927
426,BUMA.1121.00021,2,567101,575027,+,7926
426,BUMA.1121.00107,2,551345,559273,-,7928
426,BUMA.1121.00023,2,160595,168521,+,7926
426,BUMA.1121.00067,2,694618,702545,-,7927
426,BUMA.1121.00035,2,1344944,1352871,-,7927
426,BUMA.1121.00005,2,643132,651060,-,7928
426,BUMA.1121.00016,2,493719,501645,-,7926
426,BUMA.1121.00099,2,247113,255040,+,7927
426,BUMA.1121.00094,2,105348,113274,+,7926
426,BUMA.1121.00093,2,2830647,2838574,-,7927
426,BUMA.1121.00097,2,3099388,3107271,+,7883
426,BUMA.1121.00109,2,1352740,1360669,-,7929
426,BUMA.1121.00018,2,598931,606858,-,7927
426,BUMA.1121.00110,2,3231608,3239541,+,7933
426,BUMA.1121.00079,2,106605,114531,+,7926
426,BUMA.1121.00075,2,2748213,2756140,-,7927
426,BUMA.1121.00066,2,104411,112337,+,7926
426,BUMA.1121.00089,2,106514,114440,+,7926
426,BUMA.1121.00057,2,1983991,1991918,-,7927
426,BUMA.1121.00090,2,1008109,1016035,+,7926
426,BUMA.1121.00027,2,1157953,1165879,+,7926
426,BUMA.1121.00062,2,1664810,1672737,-,7927
426,BUMA.1121.00091,2,365954,373882,-,7928
426,BUMA.1121.00098,2,313447,321375,+,7928
426,BUMA.1121.00092,2,106340,114266,+,7926
426,BUMA.1121.00031,2,2442933,2450859,+,7926
426,BUMA.1121.00096,2,217735,225663,+,7928
426,BUMA.1121.00073,2,105922,113848,+,7926
426,BUMA.1121.00103,2,1929215,1937143,+,7928
426,BUMA.1121.00084,2,1944998,1952924,+,7926
426,BUMA.1121.00014,2,110713,118639,+,7926
426,BUMA.1121.00111,2,2545278,2553205,+,7927
426,BUMA.1121.00007,2,116584,124511,+,7927
426,BUMA.1121.00072,2,97066,104992,+,7926
426,BUMA.1121.00071,2,98268,106194,+,7926
426,BUMA.1121.00077,2,375938,383868,-,7930
426,BUMA.1121.00003,2,1438921,1446848,+,7927
426,BUMA.1121.00104,2,211693,219620,+,7927
426,BUMA.1121.00074,2,1135123,1143050,-,7927
426,BUMA.1121.00060,2,2093313,2101241,-,7928
426,BUMA.1121.00088,2,57621,65547,+,7926
426,BUMA.1121.00053,2,332700,340626,+,7926
426,BUMA.1121.00025,2,1726185,1734111,+,7926
426,BUMA.1121.00070,2,105947,113873,+,7926
426,BUMA.1121.00049,2,1916261,1924187,+,7926
426,BUMA.1121.00078,2,3114717,3122644,-,7927
426,BUMA.1121.00069,2,105489,113415,+,7926
426,BUMA.1121.00102,2,106566,114492,+,7926
426,BUMA.1121.00112,2,1078631,1086558,-,7927
426,BUMA.1121.00041,2,996593,1004520,+,7927
426,BUMA.1121.00068,2,1825594,1833518,+,7924
426,BUMA.1121.00076,2,989480,997406,+,7926
426,BUMA.1121.00033,2,774142,782067,+,7925
426,BUMA.1121.00101,2,149378,157306,-,7928
426,BUMA.1121.00105,2,2395675,2403602,-,7927
426,BUMA.1121.00061,2,96841,104767,+,7926
426,BUMA.1121.00063,2,97581,105507,+,7926
426,BUMA.1121.00059,2,366670,374597,-,7927
426,BUMA.1121.00058,2,620785,628711,+,7926
426,BUMA.1121.00043,2,2335455,2343382,-,7927
426,BUMA.1121.00055,2,2571546,2579473,-,7927
426,BUMA.1121.00065,2,106992,114919,+,7927
426,BUMA.1121.00064,2,106089,114015,+,7926
426,BUMA.1121.00047,2,1035712,1043638,+,7926
426,BUMA.1121.00037,2,358045,365971,+,7926
426,BUMA.1121.00106,2,2521058,2528984,+,7926
426,BUMA.1121.00051,2,106658,114584,+,7926
426,BUMA.1121.00045,2,3163888,3171815,+,7927
426,BUMA.1121.00056,2,777195,785122,-,7927
426,BUMA.1121.00095,2,2116201,2124129,+,7928
426,BUMA.1121.00082,2,106544,114470,+,7926
426,BUMA.1121.00001,2,2149423,2157350,-,7927
426,BUMA.1121.00108,2,296152,304080,+,7928
426,BUMA.1121.00083,2,1903493,1911419,+,7926
426,BUMA.1121.00080,2,106635,114561,+,7926
426,BUMA.1121.00012,2,1714747,1722665,-,7918
427,BUMA.1121.00011,2,1883396,1886597,+,3201
427,BUMA.1121.00009,2,1913059,1916263,+,3204
427,BUMA.1121.00039,2,691001,694202,-,3201
427,BUMA.1121.00029,2,1258028,1261229,-,3201
427,BUMA.1121.00021,2,575191,578392,+,3201
427,BUMA.1121.00107,2,547968,551181,-,3213
427,BUMA.1121.00023,2,168685,171886,+,3201
427,BUMA.1121.00067,2,691241,694454,-,3213
427,BUMA.1121.00035,2,1341579,1344780,-,3201
427,BUMA.1121.00005,2,639755,642968,-,3213
427,BUMA.1121.00016,2,490354,493555,-,3201
427,BUMA.1121.00099,2,255204,258405,+,3201
427,BUMA.1121.00094,2,113438,116651,+,3213
427,BUMA.1121.00093,2,2827270,2830483,-,3213
427,BUMA.1121.00097,2,3107435,3110659,+,3224
427,BUMA.1121.00109,2,1349364,1352576,-,3212
427,BUMA.1121.00018,2,595566,598767,-,3201
427,BUMA.1121.00110,2,3239699,3242900,+,3201
427,BUMA.1121.00079,2,114695,117908,+,3213
427,BUMA.1121.00075,2,2744836,2748049,-,3213
427,BUMA.1121.00066,2,112501,115702,+,3201
427,BUMA.1121.00089,2,114604,117817,+,3213
427,BUMA.1121.00057,2,1980614,1983827,-,3213
427,BUMA.1121.00090,2,1016199,1019400,+,3201
427,BUMA.1121.00027,2,1166043,1169255,+,3212
427,BUMA.1121.00062,2,1661433,1664646,-,3213
427,BUMA.1121.00091,2,362578,365790,-,3212
427,BUMA.1121.00098,2,321539,324751,+,3212
427,BUMA.1121.00092,2,114430,117643,+,3213
427,BUMA.1121.00031,2,2451023,2454224,+,3201
427,BUMA.1121.00096,2,225827,229038,+,3211
427,BUMA.1121.00073,2,114012,117213,+,3201
427,BUMA.1121.00103,2,1937307,1940520,+,3213
427,BUMA.1121.00084,2,1953088,1956301,+,3213
427,BUMA.1121.00014,2,118803,122004,+,3201
427,BUMA.1121.00111,2,2553369,2556570,+,3201
427,BUMA.1121.00007,2,124675,127876,+,3201
427,BUMA.1121.00072,2,105156,108357,+,3201
427,BUMA.1121.00071,2,106358,109559,+,3201
427,BUMA.1121.00077,2,372578,375779,-,3201
427,BUMA.1121.00003,2,1447012,1450224,+,3212
427,BUMA.1121.00104,2,219784,222961,+,3177
427,BUMA.1121.00074,2,1131746,1134959,-,3213
427,BUMA.1121.00060,2,2089937,2093149,-,3212
427,BUMA.1121.00088,2,65711,68924,+,3213
427,BUMA.1121.00053,2,340790,343991,+,3201
427,BUMA.1121.00025,2,1734275,1737476,+,3201
427,BUMA.1121.00070,2,114037,117238,+,3201
427,BUMA.1121.00049,2,1924351,1927528,+,3177
427,BUMA.1121.00078,2,3111341,3114553,-,3212
427,BUMA.1121.00069,2,113579,116780,+,3201
427,BUMA.1121.00102,2,114656,117868,+,3212
427,BUMA.1121.00112,2,1075244,1078467,-,3223
427,BUMA.1121.00041,2,1004684,1007907,+,3223
427,BUMA.1121.00068,2,1833682,1836881,+,3199
427,BUMA.1121.00076,2,997570,1000783,+,3213
427,BUMA.1121.00033,2,782231,785432,+,3201
427,BUMA.1121.00101,2,146013,149214,-,3201
427,BUMA.1121.00105,2,2392298,2395511,-,3213
427,BUMA.1121.00061,2,104931,108132,+,3201
427,BUMA.1121.00063,2,105671,108872,+,3201
427,BUMA.1121.00059,2,363293,366506,-,3213
427,BUMA.1121.00058,2,628875,632088,+,3213
427,BUMA.1121.00043,2,2332090,2335291,-,3201
427,BUMA.1121.00055,2,2568157,2571382,-,3225
427,BUMA.1121.00065,2,115083,118284,+,3201
427,BUMA.1121.00064,2,114179,117356,+,3177
427,BUMA.1121.00047,2,1043802,1047015,+,3213
427,BUMA.1121.00037,2,366135,369336,+,3201
427,BUMA.1121.00106,2,2529148,2532361,+,3213
427,BUMA.1121.00051,2,114748,117961,+,3213
427,BUMA.1121.00045,2,3171979,3175191,+,3212
427,BUMA.1121.00056,2,773818,777031,-,3213
427,BUMA.1121.00095,2,2124293,2127494,+,3201
427,BUMA.1121.00082,2,114634,117835,+,3201
427,BUMA.1121.00001,2,2146058,2149259,-,3201
427,BUMA.1121.00108,2,304244,307456,+,3212
427,BUMA.1121.00083,2,1911583,1914784,+,3201
427,BUMA.1121.00080,2,114725,117938,+,3213
427,BUMA.1121.00012,2,1711382,1714583,-,3201
428,BUMA.1121.00011,2,1888297,1899557,+,11260
428,BUMA.1121.00009,2,1917960,1929214,+,11254
428,BUMA.1121.00039,2,677990,689301,-,11311
428,BUMA.1121.00029,2,1245018,1256328,-,11310
428,BUMA.1121.00021,2,580092,591356,+,11264
428,BUMA.1121.00107,2,534951,546268,-,11317
428,BUMA.1121.00023,2,173586,184850,+,11264
428,BUMA.1121.00067,2,678260,689541,-,11281
428,BUMA.1121.00035,2,1328568,1339879,-,11311
428,BUMA.1121.00005,2,626789,638055,-,11266
428,BUMA.1121.00016,2,477380,488654,-,11274
428,BUMA.1121.00099,2,260105,271387,+,11282
428,BUMA.1121.00094,2,118351,129615,+,11264
428,BUMA.1121.00093,2,2814307,2825570,-,11263
428,BUMA.1121.00097,2,3112359,3123626,+,11267
428,BUMA.1121.00109,2,1336405,1347664,-,11259
428,BUMA.1121.00018,2,582561,593866,-,11305
428,BUMA.1121.00110,2,3244600,3255833,+,11233
428,BUMA.1121.00079,2,119608,130876,+,11268
428,BUMA.1121.00075,2,2731804,2743136,-,11332
428,BUMA.1121.00066,2,117402,128666,+,11264
428,BUMA.1121.00089,2,119517,130781,+,11264
428,BUMA.1121.00057,2,1967567,1978914,-,11347
428,BUMA.1121.00090,2,1021100,1032364,+,11264
428,BUMA.1121.00027,2,1170955,1182237,+,11282
428,BUMA.1121.00062,2,1648474,1659733,-,11259
428,BUMA.1121.00091,2,349501,360878,-,11377
428,BUMA.1121.00098,2,326451,337715,+,11264
428,BUMA.1121.00092,2,119343,130607,+,11264
428,BUMA.1121.00031,2,2455924,2467187,+,11263
428,BUMA.1121.00096,2,230738,242020,+,11282
428,BUMA.1121.00073,2,118913,130177,+,11264
428,BUMA.1121.00103,2,1942220,1953508,+,11288
428,BUMA.1121.00084,2,1958001,1969261,+,11260
428,BUMA.1121.00014,2,123704,134968,+,11264
428,BUMA.1121.00111,2,2558270,2569534,+,11264
428,BUMA.1121.00007,2,129576,140863,+,11287
428,BUMA.1121.00072,2,110057,121423,+,11366
428,BUMA.1121.00071,2,111259,122523,+,11264
428,BUMA.1121.00077,2,359635,370878,-,11243
428,BUMA.1121.00003,2,1451924,1463184,+,11260
428,BUMA.1121.00104,2,224661,235921,+,11260
428,BUMA.1121.00074,2,1118765,1130046,-,11281
428,BUMA.1121.00060,2,2076977,2088237,-,11260
428,BUMA.1121.00088,2,70624,81888,+,11264
428,BUMA.1121.00053,2,345691,356967,+,11276
428,BUMA.1121.00025,2,1739176,1750440,+,11264
428,BUMA.1121.00070,2,118938,130202,+,11264
428,BUMA.1121.00049,2,1929228,1940488,+,11260
428,BUMA.1121.00078,2,3098222,3109641,-,11419
428,BUMA.1121.00069,2,118480,129744,+,11264
428,BUMA.1121.00102,2,119568,130813,+,11245
428,BUMA.1121.00112,2,1062291,1073544,-,11253
428,BUMA.1121.00041,2,1009607,1020861,+,11254
428,BUMA.1121.00068,2,1838581,1849834,+,11253
428,BUMA.1121.00076,2,1002483,1013819,+,11336
428,BUMA.1121.00033,2,787132,798395,+,11263
428,BUMA.1121.00101,2,133020,144313,-,11293
428,BUMA.1121.00105,2,2379339,2390598,-,11259
428,BUMA.1121.00061,2,109832,121083,+,11251
428,BUMA.1121.00063,2,110572,121902,+,11330
428,BUMA.1121.00059,2,350330,361593,-,11263
428,BUMA.1121.00058,2,633788,645052,+,11264
428,BUMA.1121.00043,2,2319055,2330390,-,11335
428,BUMA.1121.00055,2,2555116,2566457,-,11341
428,BUMA.1121.00065,2,119984,131260,+,11276
428,BUMA.1121.00064,2,119056,130320,+,11264
428,BUMA.1121.00047,2,1048715,1059979,+,11264
428,BUMA.1121.00037,2,371036,382300,+,11264
428,BUMA.1121.00106,2,2534061,2545325,+,11264
428,BUMA.1121.00051,2,119661,130931,+,11270
428,BUMA.1121.00045,2,3176891,3188155,+,11264
428,BUMA.1121.00056,2,760759,772118,-,11359
428,BUMA.1121.00095,2,2129194,2140500,+,11306
428,BUMA.1121.00082,2,119535,130817,+,11282
428,BUMA.1121.00001,2,2133047,2144358,-,11311
428,BUMA.1121.00108,2,309156,320420,+,11264
428,BUMA.1121.00083,2,1916484,1927766,+,11282
428,BUMA.1121.00080,2,119638,130908,+,11270
428,BUMA.1121.00012,2,1698392,1709682,-,11290
429,BUMA.1121.00011,2,1900066,1919174,+,19108
429,BUMA.1121.00009,2,1929639,1948762,+,19123
429,BUMA.1121.00039,2,658578,677689,-,19111
429,BUMA.1121.00029,2,1225516,1244627,-,19111
429,BUMA.1121.00021,2,591609,610720,+,19111
429,BUMA.1121.00107,2,515527,534638,-,19111
429,BUMA.1121.00023,2,185217,204328,+,19111
429,BUMA.1121.00067,2,658734,677845,-,19111
429,BUMA.1121.00035,2,1309060,1328171,-,19111
429,BUMA.1121.00005,2,607258,626365,-,19107
429,BUMA.1121.00016,2,458005,477115,-,19110
429,BUMA.1121.00099,2,271730,290841,+,19111
429,BUMA.1121.00094,2,130072,149236,+,19164
429,BUMA.1121.00093,2,2794823,2813934,-,19111
429,BUMA.1121.00097,2,3124059,3143170,+,19111
429,BUMA.1121.00109,2,1316797,1335908,-,19111
429,BUMA.1121.00018,2,562975,582086,-,19111
429,BUMA.1121.00110,2,29,19140,+,19111
429,BUMA.1121.00079,2,131513,150624,+,19111
429,BUMA.1121.00075,2,2712383,2731494,-,19111
429,BUMA.1121.00066,2,129052,148163,+,19111
429,BUMA.1121.00089,2,131238,150349,+,19111
429,BUMA.1121.00057,2,1948137,1967248,-,19111
429,BUMA.1121.00090,2,1032803,1051914,+,19111
429,BUMA.1121.00027,2,1182628,1201739,+,19111
429,BUMA.1121.00062,2,1629016,1648127,-,19111
429,BUMA.1121.00091,2,330119,349230,-,19111
429,BUMA.1121.00098,2,338166,357277,+,19111
429,BUMA.1121.00092,2,130980,150091,+,19111
429,BUMA.1121.00031,2,2467596,2486707,+,19111
429,BUMA.1121.00096,2,242171,261282,+,19111
429,BUMA.1121.00073,2,130610,149721,+,19111
429,BUMA.1121.00103,2,1953647,1972755,+,19108
429,BUMA.1121.00084,2,1969608,1988719,+,19111
429,BUMA.1121.00014,2,135449,154557,+,19108
429,BUMA.1121.00111,2,2569973,2589085,+,19112
429,BUMA.1121.00007,2,141176,160287,+,19111
429,BUMA.1121.00072,2,121692,140803,+,19111
429,BUMA.1121.00071,2,122956,142067,+,19111
429,BUMA.1121.00077,2,340132,359244,-,19112
429,BUMA.1121.00003,2,1463746,1482857,+,19111
429,BUMA.1121.00104,2,236208,255319,+,19111
429,BUMA.1121.00074,2,1099239,1118350,-,19111
429,BUMA.1121.00060,2,2057592,2076703,-,19111
429,BUMA.1121.00088,2,82411,101522,+,19111
429,BUMA.1121.00053,2,357436,376556,+,19120
429,BUMA.1121.00025,2,1750951,1770063,+,19112
429,BUMA.1121.00070,2,130635,149746,+,19111
429,BUMA.1121.00049,2,1940841,1959952,+,19111
429,BUMA.1121.00078,2,3078786,3097891,-,19105
429,BUMA.1121.00069,2,130177,149288,+,19111
429,BUMA.1121.00102,2,131292,150403,+,19111
429,BUMA.1121.00112,2,1042810,1061921,-,19111
429,BUMA.1121.00041,2,1021346,1040451,+,19105
429,BUMA.1121.00068,2,1850247,1869357,+,19110
429,BUMA.1121.00076,2,1014126,1033237,+,19111
429,BUMA.1121.00033,2,798714,817821,+,19107
429,BUMA.1121.00101,2,113524,132635,-,19111
429,BUMA.1121.00105,2,2359845,2378956,-,19111
429,BUMA.1121.00061,2,121520,140631,+,19111
429,BUMA.1121.00063,2,122222,141333,+,19111
429,BUMA.1121.00059,2,330744,349855,-,19111
429,BUMA.1121.00058,2,645437,664548,+,19111
429,BUMA.1121.00043,2,2299817,2318928,-,19111
429,BUMA.1121.00055,2,2535645,2554756,-,19111
429,BUMA.1121.00065,2,131639,150752,+,19113
429,BUMA.1121.00064,2,130705,149816,+,19111
429,BUMA.1121.00047,2,1060430,1080898,+,20468
429,BUMA.1121.00037,2,382733,403199,+,20466
429,BUMA.1121.00106,2,2545752,2564863,+,19111
429,BUMA.1121.00051,2,131567,150678,+,19111
429,BUMA.1121.00045,2,3188552,3207663,+,19111
429,BUMA.1121.00056,2,741329,760440,-,19111
429,BUMA.1121.00095,2,2140939,2160044,+,19105
429,BUMA.1121.00082,2,131232,150343,+,19111
429,BUMA.1121.00001,2,2113557,2132668,-,19111
429,BUMA.1121.00108,2,320817,339928,+,19111
429,BUMA.1121.00083,2,1928181,1947292,+,19111
429,BUMA.1121.00080,2,131501,150612,+,19111
429,BUMA.1121.00012,2,1678896,1698007,-,19111
430,BUMA.1121.00011,2,1919175,1970297,+,51122
430,BUMA.1121.00009,2,1948763,1999867,+,51104
430,BUMA.1121.00097,2,3143171,3194269,+,51098
430,BUMA.1121.00096,2,261283,312387,+,51104
430,BUMA.1121.00103,2,1972756,2023867,+,51111
430,BUMA.1121.00003,2,1482858,1533952,+,51094
430,BUMA.1121.00060,2,2006480,2057590,-,51110
430,BUMA.1121.00101,2,62420,113522,-,51102
430,BUMA.1121.00058,2,664549,715639,+,51090
430,BUMA.1121.00045,2,3207664,3258775,+,51111
430,BUMA.1121.00095,2,2160045,2211138,+,51093
430,BUMA.1121.00108,2,339929,391038,+,51109
431,BUMA.1121.00011,2,1970299,1976945,+,6646
431,BUMA.1121.00009,2,1999869,2006516,+,6647
431,BUMA.1121.00097,2,3194271,3200918,+,6647
431,BUMA.1121.00096,2,312389,319037,+,6648
431,BUMA.1121.00103,2,2023869,2030517,+,6648
431,BUMA.1121.00003,2,1533954,1540599,+,6645
431,BUMA.1121.00060,2,1999831,2006479,-,6648
431,BUMA.1121.00101,2,55772,62419,-,6647
431,BUMA.1121.00058,2,715641,722287,+,6646
431,BUMA.1121.00045,2,1,6648,+,6647
431,BUMA.1121.00095,2,2211140,2217786,+,6646
431,BUMA.1121.00108,2,391040,397686,+,6646
432,BUMA.1121.00011,2,1976947,2013398,+,36451
432,BUMA.1121.00009,2,2006518,2042977,+,36459
432,BUMA.1121.00039,2,612730,649280,-,36550
432,BUMA.1121.00029,2,1178285,1216222,-,37937
432,BUMA.1121.00021,2,620013,656377,+,36364
432,BUMA.1121.00107,2,469808,506217,-,36409
432,BUMA.1121.00023,2,213622,249995,+,36373
432,BUMA.1121.00067,2,613125,649427,-,36302
432,BUMA.1121.00035,2,1263176,1299766,-,36590
432,BUMA.1121.00005,2,561714,597953,-,36239
432,BUMA.1121.00100,2,1272866,1309040,+,36174
432,BUMA.1121.00016,2,412162,448712,-,36550
432,BUMA.1121.00099,2,300149,336540,+,36391
432,BUMA.1121.00094,2,158546,194646,+,36100
432,BUMA.1121.00093,2,2749145,2785535,-,36390
432,BUMA.1121.00097,2,3200920,3237263,+,36343
432,BUMA.1121.00109,2,1271034,1307476,-,36442
432,BUMA.1121.00018,2,517074,553683,-,36609
432,BUMA.1121.00110,2,28435,64772,+,36337
432,BUMA.1121.00079,2,159934,196066,+,36132
432,BUMA.1121.00075,2,2665227,2701637,-,36410
432,BUMA.1121.00066,2,157460,193615,+,36155
432,BUMA.1121.00089,2,159658,195758,+,36100
432,BUMA.1121.00057,2,1902476,1938837,-,36361
432,BUMA.1121.00090,2,1061208,1097588,+,36380
432,BUMA.1121.00027,2,1211046,1247549,+,36503
432,BUMA.1121.00062,2,1583249,1619705,-,36456
432,BUMA.1121.00091,2,284525,320813,-,36288
432,BUMA.1121.00098,2,366576,402761,+,36185
432,BUMA.1121.00092,2,159379,195769,+,36390
432,BUMA.1121.00031,2,2495999,2532581,+,36582
432,BUMA.1121.00096,2,319039,355585,+,36546
432,BUMA.1121.00073,2,150435,186794,+,36359
432,BUMA.1121.00103,2,2030519,2066796,+,36277
432,BUMA.1121.00084,2,1998026,2034451,+,36425
432,BUMA.1121.00014,2,163855,200423,+,36568
432,BUMA.1121.00111,2,2598384,2634864,+,36480
432,BUMA.1121.00007,2,169595,205997,+,36402
432,BUMA.1121.00072,2,150100,186200,+,36100
432,BUMA.1121.00071,2,151364,187700,+,36336
432,BUMA.1121.00077,2,294566,330839,-,36273
432,BUMA.1121.00003,2,1540601,1577259,+,36658
432,BUMA.1121.00104,2,264616,301212,+,36596
432,BUMA.1121.00074,2,1053479,1089932,-,36453
432,BUMA.1121.00060,2,1963559,1999830,-,36271
432,BUMA.1121.00088,2,110829,147106,+,36277
432,BUMA.1121.00053,2,385867,422362,+,36495
432,BUMA.1121.00025,2,1779355,1815965,+,36610
432,BUMA.1121.00070,2,150465,186824,+,36359
432,BUMA.1121.00049,2,1969249,2005946,+,36697
432,BUMA.1121.00078,2,3033057,3069492,-,36435
432,BUMA.1121.00069,2,150007,186237,+,36230
432,BUMA.1121.00102,2,159725,196181,+,36456
432,BUMA.1121.00112,2,997151,1033497,-,36346
432,BUMA.1121.00041,2,1049759,1086211,+,36452
432,BUMA.1121.00068,2,1878670,1915037,+,36367
432,BUMA.1121.00076,2,1043983,1080393,+,36410
432,BUMA.1121.00033,2,827109,863603,+,36494
432,BUMA.1121.00101,2,19570,55771,-,36201
432,BUMA.1121.00105,2,2314153,2350549,-,36396
432,BUMA.1121.00061,2,141343,177563,+,36220
432,BUMA.1121.00063,2,150630,186757,+,36127
432,BUMA.1121.00059,2,285108,321433,-,36325
432,BUMA.1121.00058,2,722289,758584,+,36295
432,BUMA.1121.00043,2,2253985,2290525,-,36540
432,BUMA.1121.00055,2,2490029,2526348,-,36319
432,BUMA.1121.00065,2,160048,196695,+,36647
432,BUMA.1121.00064,2,159127,195462,+,36335
432,BUMA.1121.00047,2,1090194,1126363,+,36169
432,BUMA.1121.00037,2,412492,449016,+,36524
432,BUMA.1121.00106,2,2574174,2610627,+,36453
432,BUMA.1121.00051,2,159988,196107,+,36119
432,BUMA.1121.00045,2,6650,42921,+,36271
432,BUMA.1121.00056,2,695920,732020,-,36100
432,BUMA.1121.00095,2,2217788,2254125,+,36337
432,BUMA.1121.00082,2,159640,196055,+,36415
432,BUMA.1121.00001,2,2067680,2104263,-,36583
432,BUMA.1121.00108,2,397688,433850,+,36162
432,BUMA.1121.00083,2,1956589,1993004,+,36415
432,BUMA.1121.00080,2,159922,196042,+,36120
432,BUMA.1121.00012,2,1633048,1669598,-,36550
433,BUMA.1121.00011,2,2013440,2017307,+,3867
433,BUMA.1121.00009,2,2043019,2046872,+,3853
433,BUMA.1121.00039,2,606573,610408,-,3835
433,BUMA.1121.00029,2,1174399,1178236,-,3837
433,BUMA.1121.00021,2,656419,660233,+,3814
433,BUMA.1121.00107,2,465896,469766,-,3870
433,BUMA.1121.00023,2,250037,253954,+,3917
433,BUMA.1121.00067,2,609253,613083,-,3830
433,BUMA.1121.00035,2,1259290,1263127,-,3837
433,BUMA.1121.00005,2,557809,561658,-,3849
433,BUMA.1121.00100,2,1309082,1312975,+,3893
433,BUMA.1121.00016,2,405935,409808,-,3873
433,BUMA.1121.00099,2,336582,340484,+,3902
433,BUMA.1121.00094,2,194688,198565,+,3877
433,BUMA.1121.00093,2,2745251,2749103,-,3852
433,BUMA.1121.00097,2,3237307,3241108,+,3801
433,BUMA.1121.00109,2,1267110,1270978,-,3868
433,BUMA.1121.00018,2,513165,517032,-,3867
433,BUMA.1121.00110,2,64814,68727,+,3913
433,BUMA.1121.00079,2,196108,199962,+,3854
433,BUMA.1121.00075,2,2661350,2665185,-,3835
433,BUMA.1121.00066,2,193657,197461,+,3804
433,BUMA.1121.00089,2,195800,199661,+,3861
433,BUMA.1121.00057,2,1898561,1902420,-,3859
433,BUMA.1121.00090,2,1097630,1101591,+,3961
433,BUMA.1121.00027,2,1247591,1251452,+,3861
433,BUMA.1121.00062,2,1579359,1583193,-,3834
433,BUMA.1121.00091,2,280581,284483,-,3902
433,BUMA.1121.00098,2,402803,406590,+,3787
433,BUMA.1121.00092,2,195811,199657,+,3846
433,BUMA.1121.00031,2,2533549,2537389,+,3840
433,BUMA.1121.00096,2,355627,359487,+,3860
433,BUMA.1121.00073,2,186836,190640,+,3804
433,BUMA.1121.00103,2,2066838,2070675,+,3837
433,BUMA.1121.00084,2,2034493,2038362,+,3869
433,BUMA.1121.00014,2,201391,205258,+,3867
433,BUMA.1121.00111,2,2635832,2639650,+,3818
433,BUMA.1121.00007,2,206039,209854,+,3815
433,BUMA.1121.00072,2,186242,190046,+,3804
433,BUMA.1121.00071,2,187742,191546,+,3804
433,BUMA.1121.00077,2,290611,294510,-,3899
433,BUMA.1121.00003,2,1577301,1581169,+,3868
433,BUMA.1121.00104,2,301254,305113,+,3859
433,BUMA.1121.00074,2,1049583,1053437,-,3854
433,BUMA.1121.00060,2,1959674,1963517,-,3843
433,BUMA.1121.00088,2,147148,151048,+,3900
433,BUMA.1121.00053,2,422404,426282,+,3878
433,BUMA.1121.00025,2,1816007,1819867,+,3860
433,BUMA.1121.00070,2,186866,190670,+,3804
433,BUMA.1121.00049,2,2005988,2009895,+,3907
433,BUMA.1121.00078,2,3029155,3033015,-,3860
433,BUMA.1121.00069,2,186279,190083,+,3804
433,BUMA.1121.00102,2,196223,200096,+,3873
433,BUMA.1121.00112,2,993261,997109,-,3848
433,BUMA.1121.00041,2,1086253,1090127,+,3874
433,BUMA.1121.00068,2,1915086,1918957,+,3871
433,BUMA.1121.00076,2,1080435,1084277,+,3842
433,BUMA.1121.00033,2,864571,868424,+,3853
433,BUMA.1121.00101,2,15669,19514,-,3845
433,BUMA.1121.00105,2,2310258,2314097,-,3839
433,BUMA.1121.00061,2,177605,181409,+,3804
433,BUMA.1121.00063,2,186799,190603,+,3804
433,BUMA.1121.00059,2,281198,285052,-,3854
433,BUMA.1121.00058,2,758626,762512,+,3886
433,BUMA.1121.00043,2,2250046,2253943,-,3897
433,BUMA.1121.00055,2,2486143,2489973,-,3830
433,BUMA.1121.00065,2,196737,200617,+,3880
433,BUMA.1121.00064,2,195504,199326,+,3822
433,BUMA.1121.00047,2,1126405,1130286,+,3881
433,BUMA.1121.00037,2,449984,453790,+,3806
433,BUMA.1121.00106,2,2610669,2614503,+,3834
433,BUMA.1121.00051,2,196149,199988,+,3839
433,BUMA.1121.00045,2,42963,46806,+,3843
433,BUMA.1121.00056,2,692017,695864,-,3847
433,BUMA.1121.00095,2,2254167,2258009,+,3842
433,BUMA.1121.00082,2,196097,199901,+,3804
433,BUMA.1121.00001,2,2063801,2067631,-,3830
433,BUMA.1121.00108,2,433892,437716,+,3824
433,BUMA.1121.00083,2,1993046,1996850,+,3804
433,BUMA.1121.00080,2,196084,199925,+,3841
433,BUMA.1121.00012,2,1627795,1631641,-,3846
434,BUMA.1121.00011,2,2017994,2021400,+,3406
434,BUMA.1121.00009,2,2047559,2050937,+,3378
434,BUMA.1121.00039,2,602525,605885,-,3360
434,BUMA.1121.00029,2,1170319,1173711,-,3392
434,BUMA.1121.00021,2,660920,664281,+,3361
434,BUMA.1121.00107,2,461849,465208,-,3359
434,BUMA.1121.00023,2,254641,258002,+,3361
434,BUMA.1121.00067,2,605192,608565,-,3373
434,BUMA.1121.00035,2,1255210,1258602,-,3392
434,BUMA.1121.00005,2,553747,557121,-,3374
434,BUMA.1121.00100,2,1313662,1317035,+,3373
434,BUMA.1121.00016,2,401845,405247,-,3402
434,BUMA.1121.00099,2,341171,344518,+,3347
434,BUMA.1121.00094,2,199252,202626,+,3374
434,BUMA.1121.00093,2,2741189,2744563,-,3374
434,BUMA.1121.00097,2,3241795,3245118,+,3323
434,BUMA.1121.00109,2,1263050,1266422,-,3372
434,BUMA.1121.00018,2,509117,512477,-,3360
434,BUMA.1121.00110,2,69414,72805,+,3391
434,BUMA.1121.00079,2,200649,204022,+,3373
434,BUMA.1121.00075,2,2657292,2660662,-,3370
434,BUMA.1121.00066,2,198148,201522,+,3374
434,BUMA.1121.00089,2,200348,203722,+,3374
434,BUMA.1121.00057,2,1894500,1897873,-,3373
434,BUMA.1121.00090,2,1102278,1105639,+,3361
434,BUMA.1121.00027,2,1252139,1255513,+,3374
434,BUMA.1121.00062,2,1575297,1578671,-,3374
434,BUMA.1121.00091,2,276536,279893,-,3357
434,BUMA.1121.00098,2,407277,410631,+,3354
434,BUMA.1121.00092,2,200344,203719,+,3375
434,BUMA.1121.00031,2,2538076,2541450,+,3374
434,BUMA.1121.00096,2,360174,363554,+,3380
434,BUMA.1121.00073,2,191327,194701,+,3374
434,BUMA.1121.00103,2,2071400,2074773,+,3373
434,BUMA.1121.00084,2,2039049,2042423,+,3374
434,BUMA.1121.00014,2,205945,209331,+,3386
434,BUMA.1121.00111,2,2640337,2643685,+,3348
434,BUMA.1121.00007,2,210541,213905,+,3364
434,BUMA.1121.00072,2,190733,194107,+,3374
434,BUMA.1121.00071,2,192233,195606,+,3373
434,BUMA.1121.00077,2,286533,289923,-,3390
434,BUMA.1121.00003,2,1581856,1585223,+,3367
434,BUMA.1121.00104,2,305800,309175,+,3375
434,BUMA.1121.00074,2,1045522,1048895,-,3373
434,BUMA.1121.00060,2,1954026,1957392,-,3366
434,BUMA.1121.00088,2,151735,155110,+,3375
434,BUMA.1121.00053,2,426969,430350,+,3381
434,BUMA.1121.00025,2,1820554,1823915,+,3361
434,BUMA.1121.00070,2,191357,194731,+,3374
434,BUMA.1121.00049,2,2010582,2013943,+,3361
434,BUMA.1121.00078,2,3025093,3028467,-,3374
434,BUMA.1121.00069,2,190770,194128,+,3358
434,BUMA.1121.00102,2,200783,204157,+,3374
434,BUMA.1121.00112,2,989187,992573,-,3386
434,BUMA.1121.00041,2,1090814,1094189,+,3375
434,BUMA.1121.00068,2,1919644,1923056,+,3412
434,BUMA.1121.00076,2,1084964,1088338,+,3374
434,BUMA.1121.00033,2,869111,872471,+,3360
434,BUMA.1121.00101,2,11609,14981,-,3372
434,BUMA.1121.00105,2,2306210,2309570,-,3360
434,BUMA.1121.00061,2,182096,185470,+,3374
434,BUMA.1121.00063,2,191290,194630,+,3340
434,BUMA.1121.00059,2,277138,280510,-,3372
434,BUMA.1121.00058,2,763199,766573,+,3374
434,BUMA.1121.00043,2,2245998,2249358,-,3360
434,BUMA.1121.00055,2,2482082,2485456,-,3374
434,BUMA.1121.00065,2,201304,204688,+,3384
434,BUMA.1121.00064,2,200013,203387,+,3374
434,BUMA.1121.00047,2,1130973,1134347,+,3374
434,BUMA.1121.00037,2,454477,457881,+,3404
434,BUMA.1121.00106,2,2615190,2618563,+,3373
434,BUMA.1121.00051,2,200675,204050,+,3375
434,BUMA.1121.00045,2,49087,52454,+,3367
434,BUMA.1121.00056,2,687956,691329,-,3373
434,BUMA.1121.00095,2,2258696,2262071,+,3375
434,BUMA.1121.00082,2,200588,203962,+,3374
434,BUMA.1121.00001,2,2059721,2063113,-,3392
434,BUMA.1121.00108,2,438403,441773,+,3370
434,BUMA.1121.00083,2,1997537,2000911,+,3374
434,BUMA.1121.00080,2,200612,203987,+,3375
434,BUMA.1121.00012,2,1623747,1627107,-,3360
435,BUMA.1121.00011,2,2022245,2033074,+,10829
435,BUMA.1121.00009,2,2051780,2062589,+,10809
435,BUMA.1121.00039,2,590906,601729,-,10823
435,BUMA.1121.00029,2,1158698,1169523,-,10825
435,BUMA.1121.00021,2,665077,675902,+,10825
435,BUMA.1121.00107,2,450221,461053,-,10832
435,BUMA.1121.00023,2,258798,269623,+,10825
435,BUMA.1121.00067,2,593514,604349,-,10835
435,BUMA.1121.00035,2,1243578,1254414,-,10836
435,BUMA.1121.00005,2,542127,552951,-,10824
435,BUMA.1121.00100,2,1317878,1328710,+,10832
435,BUMA.1121.00016,2,390177,401002,-,10825
435,BUMA.1121.00099,2,345361,356188,+,10827
435,BUMA.1121.00094,2,203469,214300,+,10831
435,BUMA.1121.00093,2,2729521,2740346,-,10825
435,BUMA.1121.00097,2,880,11706,+,10826
435,BUMA.1121.00109,2,1251363,1262207,-,10844
435,BUMA.1121.00018,2,497511,508321,-,10810
435,BUMA.1121.00110,2,73648,84402,+,10754
435,BUMA.1121.00079,2,204865,215690,+,10825
435,BUMA.1121.00075,2,2645616,2656449,-,10833
435,BUMA.1121.00066,2,202365,213192,+,10827
435,BUMA.1121.00089,2,204565,215403,+,10838
435,BUMA.1121.00057,2,1882830,1893657,-,10827
435,BUMA.1121.00090,2,1106435,1117260,+,10825
435,BUMA.1121.00027,2,1256356,1267182,+,10826
435,BUMA.1121.00062,2,1563621,1574454,-,10833
435,BUMA.1121.00091,2,264868,275693,-,10825
435,BUMA.1121.00098,2,411427,422260,+,10833
435,BUMA.1121.00092,2,204562,215387,+,10825
435,BUMA.1121.00031,2,2542293,2553103,+,10810
435,BUMA.1121.00096,2,364397,375221,+,10824
435,BUMA.1121.00073,2,195511,206335,+,10824
435,BUMA.1121.00103,2,2075616,2086441,+,10825
435,BUMA.1121.00084,2,2043266,2054091,+,10825
435,BUMA.1121.00014,2,210127,220952,+,10825
435,BUMA.1121.00111,2,2644528,2655338,+,10810
435,BUMA.1121.00007,2,214748,225587,+,10839
435,BUMA.1121.00072,2,194879,205704,+,10825
435,BUMA.1121.00071,2,196449,207276,+,10827
435,BUMA.1121.00077,2,274937,285690,-,10753
435,BUMA.1121.00003,2,1586066,1596889,+,10823
435,BUMA.1121.00104,2,310018,320850,+,10832
435,BUMA.1121.00074,2,1033900,1044679,-,10779
435,BUMA.1121.00060,2,1942361,1953183,-,10822
435,BUMA.1121.00088,2,155906,166713,+,10807
435,BUMA.1121.00053,2,431193,442019,+,10826
435,BUMA.1121.00025,2,1824711,1835521,+,10810
435,BUMA.1121.00070,2,195545,206371,+,10826
435,BUMA.1121.00049,2,2014786,2025524,+,10738
435,BUMA.1121.00078,2,3013473,3024297,-,10824
435,BUMA.1121.00069,2,194971,205798,+,10827
435,BUMA.1121.00102,2,205000,215823,+,10823
435,BUMA.1121.00112,2,977538,988344,-,10806
435,BUMA.1121.00041,2,1095032,1105855,+,10823
435,BUMA.1121.00068,2,1923899,1934740,+,10841
435,BUMA.1121.00076,2,1089181,1100014,+,10833
435,BUMA.1121.00033,2,873267,884091,+,10824
435,BUMA.1121.00101,2,1,10766,-,10765
435,BUMA.1121.00105,2,2294544,2305367,-,10823
435,BUMA.1121.00061,2,186313,197140,+,10827
435,BUMA.1121.00063,2,195473,206300,+,10827
435,BUMA.1121.00059,2,265470,276295,-,10825
435,BUMA.1121.00058,2,767416,778242,+,10826
435,BUMA.1121.00043,2,2234377,2245202,-,10825
435,BUMA.1121.00055,2,2470415,2481239,-,10824
435,BUMA.1121.00065,2,205531,216355,+,10824
435,BUMA.1121.00064,2,204230,215054,+,10824
435,BUMA.1121.00047,2,1135190,1146028,+,10838
435,BUMA.1121.00037,2,458724,469552,+,10828
435,BUMA.1121.00106,2,2619406,2630231,+,10825
435,BUMA.1121.00051,2,204893,215717,+,10824
435,BUMA.1121.00045,2,53297,64119,+,10822
435,BUMA.1121.00056,2,676275,687113,-,10838
435,BUMA.1121.00095,2,2262912,2273722,+,10810
435,BUMA.1121.00082,2,204805,215632,+,10827
435,BUMA.1121.00001,2,2048100,2058925,-,10825
435,BUMA.1121.00108,2,442616,453426,+,10810
435,BUMA.1121.00083,2,2001754,2012581,+,10827
435,BUMA.1121.00080,2,204830,215655,+,10825
435,BUMA.1121.00012,2,1612078,1622904,-,10826
436,BUMA.1121.00011,2,2033091,2047103,+,14012
436,BUMA.1121.00009,2,2062614,2076614,+,14000
436,BUMA.1121.00039,2,576881,590889,-,14008
436,BUMA.1121.00029,2,1144671,1158681,-,14010
436,BUMA.1121.00021,2,675919,689929,+,14010
436,BUMA.1121.00107,2,436195,450204,-,14009
436,BUMA.1121.00023,2,269640,283650,+,14010
436,BUMA.1121.00067,2,579486,593497,-,14011
436,BUMA.1121.00035,2,1229551,1243561,-,14010
436,BUMA.1121.00005,2,528104,542110,-,14006
436,BUMA.1121.00100,2,1328727,1342744,+,14017
436,BUMA.1121.00016,2,376144,390160,-,14016
436,BUMA.1121.00099,2,356205,370215,+,14010
436,BUMA.1121.00094,2,214317,228328,+,14011
436,BUMA.1121.00093,2,2715493,2729504,-,14011
436,BUMA.1121.00097,2,11723,25734,+,14011
436,BUMA.1121.00109,2,1237392,1251346,-,13954
436,BUMA.1121.00018,2,483484,497494,-,14010
436,BUMA.1121.00110,2,84427,98412,+,13985
436,BUMA.1121.00079,2,215707,229717,+,14010
436,BUMA.1121.00075,2,2631589,2645599,-,14010
436,BUMA.1121.00066,2,213209,227219,+,14010
436,BUMA.1121.00089,2,215420,229431,+,14011
436,BUMA.1121.00057,2,1868802,1882813,-,14011
436,BUMA.1121.00090,2,1117277,1131287,+,14010
436,BUMA.1121.00027,2,1267199,1281210,+,14011
436,BUMA.1121.00062,2,1549596,1563604,-,14008
436,BUMA.1121.00091,2,250846,264851,-,14005
436,BUMA.1121.00098,2,422277,436295,+,14018
436,BUMA.1121.00092,2,215404,229415,+,14011
436,BUMA.1121.00031,2,2553120,2567133,+,14013
436,BUMA.1121.00096,2,375246,389249,+,14003
436,BUMA.1121.00073,2,206352,220362,+,14010
436,BUMA.1121.00103,2,2086458,2100470,+,14012
436,BUMA.1121.00084,2,2054108,2068119,+,14011
436,BUMA.1121.00014,2,220969,234979,+,14010
436,BUMA.1121.00111,2,2655355,2669364,+,14009
436,BUMA.1121.00007,2,225604,239615,+,14011
436,BUMA.1121.00072,2,205721,219729,+,14008
436,BUMA.1121.00071,2,207293,221304,+,14011
436,BUMA.1121.00077,2,260928,274912,-,13984
436,BUMA.1121.00003,2,1596906,1610916,+,14010
436,BUMA.1121.00104,2,320867,334877,+,14010
436,BUMA.1121.00074,2,1019872,1033883,-,14011
436,BUMA.1121.00060,2,1928333,1942344,-,14011
436,BUMA.1121.00088,2,166730,180741,+,14011
436,BUMA.1121.00053,2,442036,456046,+,14010
436,BUMA.1121.00025,2,1835538,1849548,+,14010
436,BUMA.1121.00070,2,206388,220398,+,14010
436,BUMA.1121.00049,2,2025541,2039549,+,14008
436,BUMA.1121.00078,2,2999449,3013456,-,14007
436,BUMA.1121.00069,2,205815,219824,+,14009
436,BUMA.1121.00102,2,215840,229848,+,14008
436,BUMA.1121.00112,2,963510,977521,-,14011
436,BUMA.1121.00041,2,1105872,1119862,+,13990
436,BUMA.1121.00068,2,1934757,1948765,+,14008
436,BUMA.1121.00076,2,1100031,1114042,+,14011
436,BUMA.1121.00033,2,884108,898118,+,14010
436,BUMA.1121.00101,2,3234879,3248889,-,14010
436,BUMA.1121.00105,2,2280516,2294527,-,14011
436,BUMA.1121.00061,2,197157,211167,+,14010
436,BUMA.1121.00063,2,206317,220328,+,14011
436,BUMA.1121.00059,2,251442,265453,-,14011
436,BUMA.1121.00058,2,778259,792270,+,14011
436,BUMA.1121.00043,2,2220350,2234360,-,14010
436,BUMA.1121.00055,2,2456391,2470398,-,14007
436,BUMA.1121.00065,2,216372,230383,+,14011
436,BUMA.1121.00064,2,215071,229082,+,14011
436,BUMA.1121.00047,2,1146045,1160056,+,14011
436,BUMA.1121.00037,2,469569,483579,+,14010
436,BUMA.1121.00106,2,2630248,2644259,+,14011
436,BUMA.1121.00051,2,215734,229745,+,14011
436,BUMA.1121.00045,2,64136,78147,+,14011
436,BUMA.1121.00056,2,662247,676258,-,14011
436,BUMA.1121.00095,2,2273739,2287751,+,14012
436,BUMA.1121.00082,2,215649,229660,+,14011
436,BUMA.1121.00001,2,2034073,2048083,-,14010
436,BUMA.1121.00108,2,453451,467453,+,14002
436,BUMA.1121.00083,2,2012598,2026609,+,14011
436,BUMA.1121.00080,2,215672,229683,+,14011
436,BUMA.1121.00012,2,1598053,1612061,-,14008
437,BUMA.1121.00011,2,2049476,2131432,+,81956
437,BUMA.1121.00009,2,2078987,2161221,+,82234
437,BUMA.1121.00039,2,492571,574508,-,81937
437,BUMA.1121.00029,2,1059961,1142298,-,82337
437,BUMA.1121.00021,2,692302,774014,+,81712
437,BUMA.1121.00107,2,352039,433822,-,81783
437,BUMA.1121.00023,2,286023,368040,+,82017
437,BUMA.1121.00067,2,495427,577113,-,81686
437,BUMA.1121.00035,2,1144789,1227178,-,82389
437,BUMA.1121.00005,2,442827,525731,-,82904
437,BUMA.1121.00100,2,1345117,1427262,+,82145
437,BUMA.1121.00016,2,291712,373771,-,82059
437,BUMA.1121.00099,2,372588,454376,+,81788
437,BUMA.1121.00094,2,230701,312535,+,81834
437,BUMA.1121.00093,2,2631276,2713120,-,81844
437,BUMA.1121.00097,2,28107,109880,+,81773
437,BUMA.1121.00109,2,1153052,1235019,-,81967
437,BUMA.1121.00018,2,399187,481111,-,81924
437,BUMA.1121.00110,2,100785,182476,+,81691
437,BUMA.1121.00079,2,232090,313865,+,81775
437,BUMA.1121.00075,2,2547611,2629216,-,81605
437,BUMA.1121.00066,2,229592,311376,+,81784
437,BUMA.1121.00089,2,231804,313634,+,81830
437,BUMA.1121.00057,2,1784679,1866429,-,81750
437,BUMA.1121.00090,2,1133660,1215581,+,81921
437,BUMA.1121.00027,2,1283583,1365286,+,81703
437,BUMA.1121.00062,2,1465318,1547223,-,81905
437,BUMA.1121.00091,2,166759,248473,-,81714
437,BUMA.1121.00098,2,438668,520834,+,82166
437,BUMA.1121.00092,2,231788,313632,+,81844
437,BUMA.1121.00031,2,2569506,2651367,+,81861
437,BUMA.1121.00096,2,391622,473626,+,82004
437,BUMA.1121.00073,2,222735,304449,+,81714
437,BUMA.1121.00103,2,2102843,2184458,+,81615
437,BUMA.1121.00084,2,2070492,2152343,+,81851
437,BUMA.1121.00014,2,237352,319161,+,81809
437,BUMA.1121.00111,2,2671737,2753287,+,81550
437,BUMA.1121.00007,2,241988,323655,+,81667
437,BUMA.1121.00072,2,222102,303759,+,81657
437,BUMA.1121.00071,2,223677,305412,+,81735
437,BUMA.1121.00077,2,176853,258553,-,81700
437,BUMA.1121.00003,2,1613289,1695093,+,81804
437,BUMA.1121.00104,2,337250,419253,+,82003
437,BUMA.1121.00074,2,935508,1017499,-,81991
437,BUMA.1121.00060,2,1843859,1925960,-,82101
437,BUMA.1121.00088,2,183114,265174,+,82060
437,BUMA.1121.00053,2,458419,540630,+,82211
437,BUMA.1121.00025,2,1851921,1933844,+,81923
437,BUMA.1121.00070,2,222771,304446,+,81675
437,BUMA.1121.00049,2,2041922,2123928,+,82006
437,BUMA.1121.00078,2,2915523,2997076,-,81553
437,BUMA.1121.00069,2,222197,303912,+,81715
437,BUMA.1121.00102,2,232221,314609,+,82388
437,BUMA.1121.00112,2,879310,961137,-,81827
437,BUMA.1121.00041,2,1122235,1204131,+,81896
437,BUMA.1121.00068,2,1951138,2033071,+,81933
437,BUMA.1121.00076,2,1116415,1198056,+,81641
437,BUMA.1121.00033,2,900491,982544,+,82053
437,BUMA.1121.00101,2,3150762,3232506,-,81744
437,BUMA.1121.00105,2,2196382,2278143,-,81761
437,BUMA.1121.00061,2,213540,295305,+,81765
437,BUMA.1121.00063,2,222701,304491,+,81790
437,BUMA.1121.00059,2,167085,249069,-,81984
437,BUMA.1121.00058,2,794643,876558,+,81915
437,BUMA.1121.00043,2,2135855,2217977,-,82122
437,BUMA.1121.00055,2,2372311,2454018,-,81707
437,BUMA.1121.00065,2,232756,314683,+,81927
437,BUMA.1121.00064,2,231455,313387,+,81932
437,BUMA.1121.00047,2,1162429,1244383,+,81954
437,BUMA.1121.00037,2,485952,568075,+,82123
437,BUMA.1121.00106,2,2646632,2728519,+,81887
437,BUMA.1121.00051,2,232118,313903,+,81785
437,BUMA.1121.00045,2,80520,162628,+,82108
437,BUMA.1121.00056,2,578031,659874,-,81843
437,BUMA.1121.00095,2,2290124,2371894,+,81770
437,BUMA.1121.00082,2,232033,313971,+,81938
437,BUMA.1121.00001,2,1949285,2031700,-,82415
437,BUMA.1121.00108,2,469826,551464,+,81638
437,BUMA.1121.00083,2,2028982,2110928,+,81946
437,BUMA.1121.00080,2,232056,313702,+,81646
437,BUMA.1121.00012,2,1513830,1595680,-,81850
438,BUMA.1121.00011,2,2131434,2134547,+,3113
438,BUMA.1121.00009,2,2161232,2164346,+,3114
438,BUMA.1121.00039,2,489455,492570,-,3115
438,BUMA.1121.00029,2,1056845,1059960,-,3115
438,BUMA.1121.00021,2,774016,777131,+,3115
438,BUMA.1121.00107,2,348905,352028,-,3123
438,BUMA.1121.00023,2,368042,371157,+,3115
438,BUMA.1121.00067,2,492303,495416,-,3113
438,BUMA.1121.00035,2,1141673,1144788,-,3115
438,BUMA.1121.00005,2,439713,442825,-,3112
438,BUMA.1121.00100,2,1427273,1430427,+,3154
438,BUMA.1121.00016,2,288590,291711,-,3121
438,BUMA.1121.00099,2,454378,458816,+,4438
438,BUMA.1121.00094,2,312546,315642,+,3096
438,BUMA.1121.00093,2,2628152,2631265,-,3113
438,BUMA.1121.00097,2,109891,113016,+,3125
438,BUMA.1121.00109,2,1149940,1153051,-,3111
438,BUMA.1121.00018,2,396071,399186,-,3115
438,BUMA.1121.00110,2,182487,185536,+,3049
438,BUMA.1121.00079,2,313876,316991,+,3115
438,BUMA.1121.00075,2,2544488,2547600,-,3112
438,BUMA.1121.00066,2,311378,314489,+,3111
438,BUMA.1121.00089,2,313645,316773,+,3128
438,BUMA.1121.00057,2,1781553,1784668,-,3115
438,BUMA.1121.00090,2,1215583,1218698,+,3115
438,BUMA.1121.00027,2,1365297,1368411,+,3114
438,BUMA.1121.00062,2,1462203,1465307,-,3104
438,BUMA.1121.00091,2,163644,166757,-,3113
438,BUMA.1121.00098,2,520836,523959,+,3123
438,BUMA.1121.00092,2,313643,316756,+,3113
438,BUMA.1121.00031,2,2651369,2654484,+,3115
438,BUMA.1121.00096,2,473637,476759,+,3122
438,BUMA.1121.00073,2,304451,307562,+,3111
438,BUMA.1121.00103,2,2184469,2187582,+,3113
438,BUMA.1121.00084,2,2152345,2155455,+,3110
438,BUMA.1121.00014,2,319163,322278,+,3115
438,BUMA.1121.00111,2,2753289,2756404,+,3115
438,BUMA.1121.00007,2,323657,326780,+,3123
438,BUMA.1121.00072,2,303761,306856,+,3095
438,BUMA.1121.00071,2,305414,308525,+,3111
438,BUMA.1121.00077,2,173794,176842,-,3048
438,BUMA.1121.00003,2,1695095,1698645,+,3550
438,BUMA.1121.00104,2,419264,422378,+,3114
438,BUMA.1121.00074,2,932384,935497,-,3113
438,BUMA.1121.00060,2,1840735,1843848,-,3113
438,BUMA.1121.00088,2,265176,268286,+,3110
438,BUMA.1121.00053,2,542142,545205,+,3063
438,BUMA.1121.00025,2,1933846,1936961,+,3115
438,BUMA.1121.00070,2,304448,307559,+,3111
438,BUMA.1121.00049,2,2123939,2127067,+,3128
438,BUMA.1121.00078,2,2912408,2915522,-,3114
438,BUMA.1121.00069,2,303914,307009,+,3095
438,BUMA.1121.00102,2,314611,317723,+,3112
438,BUMA.1121.00112,2,876176,879299,-,3123
438,BUMA.1121.00041,2,1204142,1207257,+,3115
438,BUMA.1121.00068,2,2033082,2036194,+,3112
438,BUMA.1121.00076,2,1198067,1201180,+,3113
438,BUMA.1121.00033,2,982546,985661,+,3115
438,BUMA.1121.00101,2,3147207,3150751,-,3544
438,BUMA.1121.00105,2,2193269,2196380,-,3111
438,BUMA.1121.00061,2,295307,298418,+,3111
438,BUMA.1121.00063,2,304493,307604,+,3111
438,BUMA.1121.00059,2,163973,167083,-,3110
438,BUMA.1121.00058,2,876560,879670,+,3110
438,BUMA.1121.00043,2,2132739,2135854,-,3115
438,BUMA.1121.00055,2,2369196,2372309,-,3113
438,BUMA.1121.00065,2,314685,317797,+,3112
438,BUMA.1121.00064,2,313398,316519,+,3121
438,BUMA.1121.00047,2,1244394,1247509,+,3115
438,BUMA.1121.00037,2,568077,571192,+,3115
438,BUMA.1121.00106,2,2728530,2731643,+,3113
438,BUMA.1121.00051,2,313914,317028,+,3114
438,BUMA.1121.00045,2,162639,165752,+,3113
438,BUMA.1121.00056,2,574892,578020,-,3128
438,BUMA.1121.00095,2,2371905,2375031,+,3126
438,BUMA.1121.00082,2,313973,317083,+,3110
438,BUMA.1121.00001,2,1946170,1949284,-,3114
438,BUMA.1121.00108,2,551475,554589,+,3114
438,BUMA.1121.00083,2,2110930,2114040,+,3110
438,BUMA.1121.00080,2,313713,316828,+,3115
438,BUMA.1121.00012,2,1510706,1513820,-,3114
439,BUMA.1121.00011,2,2134581,2144775,+,10194
439,BUMA.1121.00009,2,2164380,2174522,+,10142
439,BUMA.1121.00039,2,479170,489421,-,10251
439,BUMA.1121.00029,2,1046479,1056811,-,10332
439,BUMA.1121.00021,2,778543,788769,+,10226
439,BUMA.1121.00107,2,338735,348871,-,10136
439,BUMA.1121.00023,2,371191,381496,+,10305
439,BUMA.1121.00067,2,482051,492269,-,10218
439,BUMA.1121.00035,2,1131325,1141639,-,10314
439,BUMA.1121.00005,2,429391,439679,-,10288
439,BUMA.1121.00100,2,1430461,1440785,+,10324
439,BUMA.1121.00016,2,278223,288556,-,10333
439,BUMA.1121.00099,2,458850,469017,+,10167
439,BUMA.1121.00094,2,315676,325873,+,10197
439,BUMA.1121.00093,2,2617837,2628118,-,10281
439,BUMA.1121.00097,2,113050,123222,+,10172
439,BUMA.1121.00109,2,1139709,1149906,-,10197
439,BUMA.1121.00018,2,385774,396037,-,10263
439,BUMA.1121.00110,2,185570,195736,+,10166
439,BUMA.1121.00079,2,317025,327216,+,10191
439,BUMA.1121.00075,2,2534266,2544454,-,10188
439,BUMA.1121.00066,2,314523,324754,+,10231
439,BUMA.1121.00089,2,316807,327009,+,10202
439,BUMA.1121.00057,2,1771242,1781519,-,10277
439,BUMA.1121.00090,2,1218732,1229085,+,10353
439,BUMA.1121.00027,2,1368445,1378734,+,10289
439,BUMA.1121.00062,2,1451987,1462169,-,10182
439,BUMA.1121.00091,2,153413,163610,-,10197
439,BUMA.1121.00098,2,523993,534143,+,10150
439,BUMA.1121.00092,2,316790,327070,+,10280
439,BUMA.1121.00031,2,2654518,2664796,+,10278
439,BUMA.1121.00096,2,476793,486947,+,10154
439,BUMA.1121.00073,2,307596,317843,+,10247
439,BUMA.1121.00103,2,2187616,2197842,+,10226
439,BUMA.1121.00084,2,2155489,2165753,+,10264
439,BUMA.1121.00014,2,322312,332608,+,10296
439,BUMA.1121.00111,2,2756438,2766715,+,10277
439,BUMA.1121.00007,2,326814,336973,+,10159
439,BUMA.1121.00072,2,306890,317114,+,10224
439,BUMA.1121.00071,2,308559,318807,+,10248
439,BUMA.1121.00077,2,163593,173760,-,10167
439,BUMA.1121.00003,2,1702483,1712687,+,10204
439,BUMA.1121.00104,2,422412,432608,+,10196
439,BUMA.1121.00074,2,922171,932350,-,10179
439,BUMA.1121.00060,2,1830489,1840701,-,10212
439,BUMA.1121.00088,2,268320,278560,+,10240
439,BUMA.1121.00053,2,545239,555434,+,10195
439,BUMA.1121.00025,2,1936995,1947257,+,10262
439,BUMA.1121.00070,2,307593,317841,+,10248
439,BUMA.1121.00049,2,2127101,2137297,+,10196
439,BUMA.1121.00078,2,2902104,2912374,-,10270
439,BUMA.1121.00069,2,307043,317307,+,10264
439,BUMA.1121.00102,2,317757,327911,+,10154
439,BUMA.1121.00112,2,865955,876142,-,10187
439,BUMA.1121.00041,2,1207291,1217406,+,10115
439,BUMA.1121.00068,2,2036228,2046436,+,10208
439,BUMA.1121.00076,2,1201214,1211401,+,10187
439,BUMA.1121.00033,2,985695,995980,+,10285
439,BUMA.1121.00101,2,3133254,3143371,-,10117
439,BUMA.1121.00105,2,2183035,2193235,-,10200
439,BUMA.1121.00061,2,298452,308716,+,10264
439,BUMA.1121.00063,2,307638,317901,+,10263
439,BUMA.1121.00059,2,153710,163939,-,10229
439,BUMA.1121.00058,2,879704,889909,+,10205
439,BUMA.1121.00043,2,2122358,2132705,-,10347
439,BUMA.1121.00055,2,2358977,2369162,-,10185
439,BUMA.1121.00065,2,317831,328006,+,10175
439,BUMA.1121.00064,2,316553,326749,+,10196
439,BUMA.1121.00047,2,1247543,1257754,+,10211
439,BUMA.1121.00037,2,571226,581482,+,10256
439,BUMA.1121.00106,2,2731677,2741863,+,10186
439,BUMA.1121.00051,2,317062,327272,+,10210
439,BUMA.1121.00045,2,165786,175988,+,10202
439,BUMA.1121.00056,2,564873,574858,-,9985
439,BUMA.1121.00095,2,2375065,2385182,+,10117
439,BUMA.1121.00082,2,317117,327381,+,10264
439,BUMA.1121.00001,2,1935870,1946136,-,10266
439,BUMA.1121.00108,2,554623,564772,+,10149
439,BUMA.1121.00083,2,2114074,2124338,+,10264
439,BUMA.1121.00080,2,316862,327064,+,10202
439,BUMA.1121.00012,2,1500447,1510672,-,10225
440,BUMA.1121.00011,2,2145932,2150928,+,4996
440,BUMA.1121.00009,2,2176080,2180996,+,4916
440,BUMA.1121.00039,2,473111,477892,-,4781
440,BUMA.1121.00029,2,1040498,1045273,-,4775
440,BUMA.1121.00021,2,789931,794712,+,4781
440,BUMA.1121.00107,2,332703,337484,-,4781
440,BUMA.1121.00023,2,382658,387457,+,4799
440,BUMA.1121.00067,2,476016,480791,-,4775
440,BUMA.1121.00035,2,1125347,1130137,-,4790
440,BUMA.1121.00005,2,423380,428167,-,4787
440,BUMA.1121.00100,2,1441974,1446794,+,4820
440,BUMA.1121.00016,2,272263,277053,-,4790
440,BUMA.1121.00099,2,470174,475113,+,4939
440,BUMA.1121.00094,2,327035,331825,+,4790
440,BUMA.1121.00093,2,2611859,2616649,-,4790
440,BUMA.1121.00097,2,124379,129318,+,4939
440,BUMA.1121.00109,2,1133623,1138404,-,4781
440,BUMA.1121.00018,2,379841,384613,-,4772
440,BUMA.1121.00110,2,196868,201667,+,4799
440,BUMA.1121.00079,2,328371,333184,+,4813
440,BUMA.1121.00075,2,2528321,2533092,-,4771
440,BUMA.1121.00066,2,325907,330761,+,4854
440,BUMA.1121.00089,2,328189,332963,+,4774
440,BUMA.1121.00057,2,1765216,1769991,-,4775
440,BUMA.1121.00090,2,1230247,1235082,+,4835
440,BUMA.1121.00027,2,1379905,1384716,+,4811
440,BUMA.1121.00062,2,1446036,1450826,-,4790
440,BUMA.1121.00091,2,147450,152225,-,4775
440,BUMA.1121.00098,2,535296,540089,+,4793
440,BUMA.1121.00092,2,328241,333049,+,4808
440,BUMA.1121.00031,2,2665958,2670847,+,4889
440,BUMA.1121.00096,2,488113,493051,+,4938
440,BUMA.1121.00073,2,318960,323768,+,4808
440,BUMA.1121.00103,2,2199013,2203788,+,4775
440,BUMA.1121.00084,2,2166919,2171732,+,4813
440,BUMA.1121.00014,2,333770,338623,+,4853
440,BUMA.1121.00111,2,2767877,2772712,+,4835
440,BUMA.1121.00007,2,338508,343319,+,4811
440,BUMA.1121.00072,2,318231,323150,+,4919
440,BUMA.1121.00071,2,319942,324775,+,4833
440,BUMA.1121.00077,2,157663,162453,-,4790
440,BUMA.1121.00003,2,1713853,1718756,+,4903
440,BUMA.1121.00104,2,433783,438554,+,4771
440,BUMA.1121.00074,2,916199,920974,-,4775
440,BUMA.1121.00060,2,1824610,1829376,-,4766
440,BUMA.1121.00088,2,279722,284521,+,4799
440,BUMA.1121.00053,2,556600,561412,+,4812
440,BUMA.1121.00025,2,1948419,1953191,+,4772
440,BUMA.1121.00070,2,318958,323765,+,4807
440,BUMA.1121.00049,2,2138472,2143243,+,4771
440,BUMA.1121.00078,2,2896159,2900934,-,4775
440,BUMA.1121.00069,2,318442,323260,+,4818
440,BUMA.1121.00102,2,329073,333848,+,4775
440,BUMA.1121.00112,2,860050,864808,-,4758
440,BUMA.1121.00041,2,1218584,1223352,+,4768
440,BUMA.1121.00068,2,2047616,2052445,+,4829
440,BUMA.1121.00076,2,1212576,1217347,+,4771
440,BUMA.1121.00033,2,997140,1001925,+,4785
440,BUMA.1121.00101,2,3127231,3132021,-,4790
440,BUMA.1121.00105,2,2177099,2181874,-,4775
440,BUMA.1121.00061,2,309856,314631,+,4775
440,BUMA.1121.00063,2,319027,323845,+,4818
440,BUMA.1121.00059,2,147723,152513,-,4790
440,BUMA.1121.00058,2,891084,895855,+,4771
440,BUMA.1121.00043,2,2116407,2121197,-,4790
440,BUMA.1121.00055,2,2352996,2357771,-,4775
440,BUMA.1121.00065,2,329181,333979,+,4798
440,BUMA.1121.00064,2,327924,332713,+,4789
440,BUMA.1121.00047,2,1258934,1263724,+,4790
440,BUMA.1121.00037,2,582644,587443,+,4799
440,BUMA.1121.00106,2,2743027,2747825,+,4798
440,BUMA.1121.00051,2,328452,333226,+,4774
440,BUMA.1121.00045,2,177102,181868,+,4766
440,BUMA.1121.00056,2,558920,563694,-,4774
440,BUMA.1121.00095,2,2386339,2391278,+,4939
440,BUMA.1121.00082,2,328606,333417,+,4811
440,BUMA.1121.00001,2,1929892,1934682,-,4790
440,BUMA.1121.00108,2,565941,570724,+,4783
440,BUMA.1121.00083,2,2125563,2130374,+,4811
440,BUMA.1121.00080,2,328244,333018,+,4774
440,BUMA.1121.00012,2,1494488,1499269,-,4781
441,BUMA.1121.00011,2,2150929,2156053,+,5124
441,BUMA.1121.00009,2,2180997,2186118,+,5121
441,BUMA.1121.00039,2,467986,473109,-,5123
441,BUMA.1121.00029,2,1035372,1040496,-,5124
441,BUMA.1121.00021,2,794713,799837,+,5124
441,BUMA.1121.00107,2,327578,332701,-,5123
441,BUMA.1121.00023,2,387458,392582,+,5124
441,BUMA.1121.00067,2,470892,476014,-,5122
441,BUMA.1121.00035,2,1120222,1125345,-,5123
441,BUMA.1121.00005,2,418256,423378,-,5122
441,BUMA.1121.00100,2,1446795,1451919,+,5124
441,BUMA.1121.00016,2,267138,272261,-,5123
441,BUMA.1121.00099,2,475114,480238,+,5124
441,BUMA.1121.00094,2,331826,336950,+,5124
441,BUMA.1121.00093,2,2606735,2611857,-,5122
441,BUMA.1121.00097,2,129319,134443,+,5124
441,BUMA.1121.00109,2,1128498,1133621,-,5123
441,BUMA.1121.00018,2,374727,379839,-,5112
441,BUMA.1121.00110,2,201668,206792,+,5124
441,BUMA.1121.00079,2,333185,338309,+,5124
441,BUMA.1121.00075,2,2523197,2528319,-,5122
441,BUMA.1121.00066,2,330762,335885,+,5123
441,BUMA.1121.00089,2,332964,338087,+,5123
441,BUMA.1121.00057,2,1760097,1765214,-,5117
441,BUMA.1121.00090,2,1235083,1240207,+,5124
441,BUMA.1121.00027,2,1384717,1389834,+,5117
441,BUMA.1121.00062,2,1440912,1446034,-,5122
441,BUMA.1121.00091,2,142326,147448,-,5122
441,BUMA.1121.00098,2,540090,545213,+,5123
441,BUMA.1121.00092,2,333050,338173,+,5123
441,BUMA.1121.00031,2,2670848,2675972,+,5124
441,BUMA.1121.00096,2,493052,498176,+,5124
441,BUMA.1121.00073,2,323769,328892,+,5123
441,BUMA.1121.00103,2,2203789,2208909,+,5120
441,BUMA.1121.00084,2,2171733,2176857,+,5124
441,BUMA.1121.00014,2,338624,343748,+,5124
441,BUMA.1121.00111,2,2772713,2777837,+,5124
441,BUMA.1121.00007,2,343320,348443,+,5123
441,BUMA.1121.00072,2,323151,328274,+,5123
441,BUMA.1121.00071,2,324776,329899,+,5123
441,BUMA.1121.00077,2,152538,157661,-,5123
441,BUMA.1121.00003,2,1718757,1723878,+,5121
441,BUMA.1121.00104,2,438555,443678,+,5123
441,BUMA.1121.00074,2,911075,916197,-,5122
441,BUMA.1121.00060,2,1819485,1824608,-,5123
441,BUMA.1121.00088,2,284522,289646,+,5124
441,BUMA.1121.00053,2,561413,566537,+,5124
441,BUMA.1121.00025,2,1953192,1958305,+,5113
441,BUMA.1121.00070,2,323766,328889,+,5123
441,BUMA.1121.00049,2,2143244,2148367,+,5123
441,BUMA.1121.00078,2,2891035,2896157,-,5122
441,BUMA.1121.00069,2,323261,328384,+,5123
441,BUMA.1121.00102,2,333849,338972,+,5123
441,BUMA.1121.00112,2,819479,824613,-,5134
441,BUMA.1121.00041,2,1223353,1228476,+,5123
441,BUMA.1121.00068,2,2052446,2057570,+,5124
441,BUMA.1121.00076,2,1217348,1222471,+,5123
441,BUMA.1121.00033,2,1001926,1007039,+,5113
441,BUMA.1121.00101,2,3122109,3127229,-,5120
441,BUMA.1121.00105,2,2171975,2177097,-,5122
441,BUMA.1121.00061,2,314632,319755,+,5123
441,BUMA.1121.00063,2,323846,328969,+,5123
441,BUMA.1121.00059,2,142599,147721,-,5122
441,BUMA.1121.00058,2,895856,900980,+,5124
441,BUMA.1121.00043,2,2111282,2116405,-,5123
441,BUMA.1121.00055,2,2347871,2352994,-,5123
441,BUMA.1121.00065,2,333980,339103,+,5123
441,BUMA.1121.00064,2,332714,337837,+,5123
441,BUMA.1121.00047,2,1263725,1268849,+,5124
441,BUMA.1121.00037,2,587444,592568,+,5124
441,BUMA.1121.00106,2,2747826,2752950,+,5124
441,BUMA.1121.00051,2,333227,338350,+,5123
441,BUMA.1121.00045,2,181869,186993,+,5124
441,BUMA.1121.00056,2,553796,558918,-,5122
441,BUMA.1121.00095,2,2391279,2396412,+,5133
441,BUMA.1121.00082,2,333418,338541,+,5123
441,BUMA.1121.00001,2,1924767,1929890,-,5123
441,BUMA.1121.00108,2,570725,575849,+,5124
441,BUMA.1121.00083,2,2130375,2135498,+,5123
441,BUMA.1121.00080,2,333019,338142,+,5123
441,BUMA.1121.00012,2,1489363,1494486,-,5123
442,BUMA.1121.00011,2,2156054,2169082,+,13028
442,BUMA.1121.00009,2,2186119,2199142,+,13023
442,BUMA.1121.00039,2,454951,467984,-,13033
442,BUMA.1121.00029,2,1022338,1035370,-,13032
442,BUMA.1121.00021,2,799838,812870,+,13032
442,BUMA.1121.00107,2,314534,327576,-,13042
442,BUMA.1121.00023,2,392583,405618,+,13035
442,BUMA.1121.00067,2,457858,470890,-,13032
442,BUMA.1121.00035,2,1107188,1120220,-,13032
442,BUMA.1121.00005,2,405223,418254,-,13031
442,BUMA.1121.00100,2,1451920,1464932,+,13012
442,BUMA.1121.00016,2,254103,267136,-,13033
442,BUMA.1121.00099,2,480239,493273,+,13034
442,BUMA.1121.00094,2,336951,349988,+,13037
442,BUMA.1121.00093,2,2593724,2606733,-,13009
442,BUMA.1121.00097,2,134444,147488,+,13044
442,BUMA.1121.00109,2,1115480,1128496,-,13016
442,BUMA.1121.00018,2,360811,373812,-,13001
442,BUMA.1121.00110,2,206793,219836,+,13043
442,BUMA.1121.00079,2,338310,351329,+,13019
442,BUMA.1121.00075,2,2510164,2523195,-,13031
442,BUMA.1121.00066,2,335886,348922,+,13036
442,BUMA.1121.00089,2,338088,351110,+,13022
442,BUMA.1121.00057,2,1747075,1760095,-,13020
442,BUMA.1121.00090,2,1240208,1253234,+,13026
442,BUMA.1121.00027,2,1389835,1402872,+,13037
442,BUMA.1121.00062,2,1427452,1440910,-,13458
442,BUMA.1121.00091,2,129288,142324,-,13036
442,BUMA.1121.00098,2,545214,558232,+,13018
442,BUMA.1121.00092,2,338174,351184,+,13010
442,BUMA.1121.00031,2,2675973,2689006,+,13033
442,BUMA.1121.00096,2,498177,511191,+,13014
442,BUMA.1121.00073,2,328893,341930,+,13037
442,BUMA.1121.00103,2,2208910,2221955,+,13045
442,BUMA.1121.00084,2,2176858,2189880,+,13022
442,BUMA.1121.00014,2,343749,356783,+,13034
442,BUMA.1121.00111,2,2777838,2790871,+,13033
442,BUMA.1121.00007,2,348444,361470,+,13026
442,BUMA.1121.00072,2,328275,341310,+,13035
442,BUMA.1121.00071,2,329900,342937,+,13037
442,BUMA.1121.00077,2,139494,152536,-,13042
442,BUMA.1121.00003,2,1723879,1736911,+,13032
442,BUMA.1121.00104,2,443679,456698,+,13019
442,BUMA.1121.00074,2,898050,911073,-,13023
442,BUMA.1121.00060,2,1806439,1819483,-,13044
442,BUMA.1121.00088,2,289647,302673,+,13026
442,BUMA.1121.00053,2,566538,579571,+,13033
442,BUMA.1121.00025,2,1959221,1972222,+,13001
442,BUMA.1121.00070,2,328890,341927,+,13037
442,BUMA.1121.00049,2,2148368,2161387,+,13019
442,BUMA.1121.00078,2,2877996,2891033,-,13037
442,BUMA.1121.00069,2,328385,341422,+,13037
442,BUMA.1121.00102,2,338973,352010,+,13037
442,BUMA.1121.00112,2,806445,819477,-,13032
442,BUMA.1121.00041,2,1228477,1241510,+,13033
442,BUMA.1121.00068,2,2057571,2070594,+,13023
442,BUMA.1121.00076,2,1222472,1235504,+,13032
442,BUMA.1121.00033,2,1007952,1021000,+,13048
442,BUMA.1121.00101,2,3109075,3122107,-,13032
442,BUMA.1121.00105,2,2158941,2171973,-,13032
442,BUMA.1121.00061,2,319756,332793,+,13037
442,BUMA.1121.00063,2,328970,342007,+,13037
442,BUMA.1121.00059,2,129570,142597,-,13027
442,BUMA.1121.00058,2,900981,914000,+,13019
442,BUMA.1121.00043,2,2098247,2111280,-,13033
442,BUMA.1121.00055,2,2334832,2347869,-,13037
442,BUMA.1121.00065,2,339104,352150,+,13046
442,BUMA.1121.00064,2,337838,350862,+,13024
442,BUMA.1121.00047,2,1268850,1281872,+,13022
442,BUMA.1121.00037,2,592569,605602,+,13033
442,BUMA.1121.00106,2,2752951,2765970,+,13019
442,BUMA.1121.00051,2,338351,351373,+,13022
442,BUMA.1121.00045,2,186994,200039,+,13045
442,BUMA.1121.00056,2,540773,553794,-,13021
442,BUMA.1121.00095,2,2396413,2409445,+,13032
442,BUMA.1121.00082,2,338542,351579,+,13037
442,BUMA.1121.00001,2,1911733,1924765,-,13032
442,BUMA.1121.00108,2,575850,588883,+,13033
442,BUMA.1121.00083,2,2135499,2148536,+,13037
442,BUMA.1121.00080,2,338143,351165,+,13022
442,BUMA.1121.00012,2,1476345,1489361,-,13016
443,BUMA.1121.00011,2,2169083,2175095,+,6012
443,BUMA.1121.00009,2,2199143,2205144,+,6001
443,BUMA.1121.00039,2,448974,454949,-,5975
443,BUMA.1121.00029,2,1016320,1022336,-,6016
443,BUMA.1121.00021,2,812871,818871,+,6000
443,BUMA.1121.00107,2,308509,314532,-,6023
443,BUMA.1121.00023,2,405619,411627,+,6008
443,BUMA.1121.00067,2,451872,457856,-,5984
443,BUMA.1121.00035,2,1101178,1107186,-,6008
443,BUMA.1121.00005,2,399212,405221,-,6009
443,BUMA.1121.00100,2,1464933,1470927,+,5994
443,BUMA.1121.00016,2,248091,254101,-,6010
443,BUMA.1121.00099,2,493274,499285,+,6011
443,BUMA.1121.00094,2,349989,355990,+,6001
443,BUMA.1121.00093,2,2587721,2593722,-,6001
443,BUMA.1121.00097,2,147489,153511,+,6022
443,BUMA.1121.00109,2,1109474,1115478,-,6004
443,BUMA.1121.00018,2,354834,360809,-,5975
443,BUMA.1121.00110,2,219837,225818,+,5981
443,BUMA.1121.00079,2,351330,357334,+,6004
443,BUMA.1121.00075,2,2504150,2510162,-,6012
443,BUMA.1121.00066,2,348923,354924,+,6001
443,BUMA.1121.00089,2,351111,357113,+,6002
443,BUMA.1121.00057,2,1739462,1745478,-,6016
443,BUMA.1121.00090,2,1253235,1259209,+,5974
443,BUMA.1121.00027,2,1402873,1408874,+,6001
443,BUMA.1121.00062,2,1421417,1427450,-,6033
443,BUMA.1121.00091,2,123273,129286,-,6013
443,BUMA.1121.00098,2,559831,565869,+,6038
443,BUMA.1121.00092,2,351185,357186,+,6001
443,BUMA.1121.00031,2,2689007,2695020,+,6013
443,BUMA.1121.00096,2,511192,517203,+,6011
443,BUMA.1121.00073,2,341931,347932,+,6001
443,BUMA.1121.00103,2,2221956,2227936,+,5980
443,BUMA.1121.00084,2,2189881,2195886,+,6005
443,BUMA.1121.00014,2,356784,362797,+,6013
443,BUMA.1121.00111,2,2790872,2796860,+,5988
443,BUMA.1121.00007,2,361471,367482,+,6011
443,BUMA.1121.00072,2,341311,347312,+,6001
443,BUMA.1121.00071,2,342938,348939,+,6001
443,BUMA.1121.00077,2,133512,139492,-,5980
443,BUMA.1121.00003,2,1736912,1742912,+,6000
443,BUMA.1121.00104,2,456699,462703,+,6004
443,BUMA.1121.00074,2,892046,898048,-,6002
443,BUMA.1121.00060,2,1800424,1806437,-,6013
443,BUMA.1121.00088,2,302674,308689,+,6015
443,BUMA.1121.00053,2,579572,585595,+,6023
443,BUMA.1121.00025,2,1972223,1978198,+,5975
443,BUMA.1121.00070,2,341928,347929,+,6001
443,BUMA.1121.00049,2,2161388,2167377,+,5989
443,BUMA.1121.00078,2,2871993,2877994,-,6001
443,BUMA.1121.00069,2,341423,347424,+,6001
443,BUMA.1121.00102,2,352011,358020,+,6009
443,BUMA.1121.00112,2,800478,806443,-,5965
443,BUMA.1121.00041,2,1241511,1247523,+,6012
443,BUMA.1121.00068,2,2070595,2076604,+,6009
443,BUMA.1121.00076,2,1235505,1241517,+,6012
443,BUMA.1121.00033,2,1021001,1027010,+,6009
443,BUMA.1121.00101,2,3103072,3109073,-,6001
443,BUMA.1121.00105,2,2152938,2158939,-,6001
443,BUMA.1121.00061,2,332794,338795,+,6001
443,BUMA.1121.00063,2,342008,348009,+,6001
443,BUMA.1121.00059,2,123569,129568,-,5999
443,BUMA.1121.00058,2,914001,920005,+,6004
443,BUMA.1121.00043,2,2092244,2098245,-,6001
443,BUMA.1121.00055,2,2328828,2334830,-,6002
443,BUMA.1121.00065,2,352151,358131,+,5980
443,BUMA.1121.00064,2,350863,356867,+,6004
443,BUMA.1121.00047,2,1281873,1287874,+,6001
443,BUMA.1121.00037,2,605603,611608,+,6005
443,BUMA.1121.00106,2,2765971,2771975,+,6004
443,BUMA.1121.00051,2,351374,357375,+,6001
443,BUMA.1121.00045,2,200040,206053,+,6013
443,BUMA.1121.00056,2,534769,540771,-,6002
443,BUMA.1121.00095,2,2409446,2415447,+,6001
443,BUMA.1121.00082,2,351580,357581,+,6001
443,BUMA.1121.00001,2,1905723,1911731,-,6008
443,BUMA.1121.00108,2,588884,594886,+,6002
443,BUMA.1121.00083,2,2148537,2154538,+,6001
443,BUMA.1121.00080,2,351166,357166,+,6000
443,BUMA.1121.00012,2,1468723,1474748,-,6025
444,BUMA.1121.00011,2,2175726,2179621,+,3895
444,BUMA.1121.00009,2,2205775,2209656,+,3881
444,BUMA.1121.00039,2,442872,446753,-,3881
444,BUMA.1121.00029,2,1011792,1015687,-,3895
444,BUMA.1121.00021,2,819493,823374,+,3881
444,BUMA.1121.00107,2,303998,307879,-,3881
444,BUMA.1121.00023,2,412258,416139,+,3881
444,BUMA.1121.00067,2,447190,451071,-,3881
444,BUMA.1121.00035,2,1096636,1100545,-,3909
444,BUMA.1121.00005,2,394543,398438,-,3895
444,BUMA.1121.00100,2,1471549,1475444,+,3895
444,BUMA.1121.00016,2,243508,247431,-,3923
444,BUMA.1121.00099,2,499943,503824,+,3881
444,BUMA.1121.00094,2,356747,360628,+,3881
444,BUMA.1121.00093,2,2583165,2587046,-,3881
444,BUMA.1121.00097,2,154187,158082,+,3895
444,BUMA.1121.00109,2,1104972,1108853,-,3881
444,BUMA.1121.00018,2,350320,354178,-,3858
444,BUMA.1121.00110,2,226584,230465,+,3881
444,BUMA.1121.00079,2,358118,361998,+,3880
444,BUMA.1121.00075,2,2499562,2503457,-,3895
444,BUMA.1121.00066,2,355546,359441,+,3895
444,BUMA.1121.00089,2,357870,361751,+,3881
444,BUMA.1121.00057,2,1734883,1738778,-,3895
444,BUMA.1121.00090,2,1259843,1263766,+,3923
444,BUMA.1121.00027,2,1409577,1413472,+,3895
444,BUMA.1121.00062,2,1416891,1420787,-,3896
444,BUMA.1121.00091,2,118681,122562,-,3881
444,BUMA.1121.00098,2,566572,570467,+,3895
444,BUMA.1121.00092,2,357862,361743,+,3881
444,BUMA.1121.00031,2,2695642,2699523,+,3881
444,BUMA.1121.00096,2,517861,521743,+,3882
444,BUMA.1121.00073,2,348554,352449,+,3895
444,BUMA.1121.00103,2,2228621,2232530,+,3909
444,BUMA.1121.00084,2,2196580,2200475,+,3895
444,BUMA.1121.00014,2,363419,367300,+,3881
444,BUMA.1121.00111,2,2797494,2801403,+,3909
444,BUMA.1121.00007,2,368131,371940,+,3809
444,BUMA.1121.00072,2,347934,351829,+,3895
444,BUMA.1121.00071,2,349561,353456,+,3895
444,BUMA.1121.00077,2,128866,132747,-,3881
444,BUMA.1121.00003,2,1743543,1747438,+,3895
444,BUMA.1121.00104,2,463388,467269,+,3881
444,BUMA.1121.00074,2,887485,891380,-,3895
444,BUMA.1121.00088,2,309374,313269,+,3895
444,BUMA.1121.00053,2,586388,590269,+,3881
444,BUMA.1121.00025,2,1978854,1982713,+,3859
444,BUMA.1121.00070,2,348551,352446,+,3895
444,BUMA.1121.00049,2,2168008,2171889,+,3881
444,BUMA.1121.00078,2,2867396,2871291,-,3895
444,BUMA.1121.00069,2,348046,351941,+,3895
444,BUMA.1121.00102,2,358642,362523,+,3881
444,BUMA.1121.00112,2,795908,799803,-,3895
444,BUMA.1121.00041,2,1248343,1252238,+,3895
444,BUMA.1121.00076,2,1242220,1246115,+,3895
444,BUMA.1121.00033,2,1027635,1031516,+,3881
444,BUMA.1121.00101,2,3098565,3102460,-,3895
444,BUMA.1121.00105,2,2148436,2152317,-,3881
444,BUMA.1121.00061,2,339417,343312,+,3895
444,BUMA.1121.00063,2,348631,352526,+,3895
444,BUMA.1121.00059,2,118977,122858,-,3881
444,BUMA.1121.00058,2,920681,924562,+,3881
444,BUMA.1121.00043,2,2087723,2091623,-,3900
444,BUMA.1121.00055,2,2324312,2328207,-,3895
444,BUMA.1121.00065,2,358807,362688,+,3881
444,BUMA.1121.00064,2,357489,361384,+,3895
444,BUMA.1121.00047,2,1288640,1292535,+,3895
444,BUMA.1121.00037,2,612230,616111,+,3881
444,BUMA.1121.00106,2,2772678,2776559,+,3881
444,BUMA.1121.00051,2,358132,362013,+,3881
444,BUMA.1121.00045,2,206711,210607,+,3896
444,BUMA.1121.00056,2,530132,534013,-,3881
444,BUMA.1121.00095,2,2416186,2420080,+,3894
444,BUMA.1121.00082,2,358203,362098,+,3895
444,BUMA.1121.00001,2,1901172,1905081,-,3909
444,BUMA.1121.00108,2,595535,599430,+,3895
444,BUMA.1121.00083,2,2155160,2159055,+,3895
444,BUMA.1121.00080,2,357905,361786,+,3881
444,BUMA.1121.00012,2,1464167,1468090,-,3923
445,BUMA.1121.00011,2,2179753,2183169,+,3416
445,BUMA.1121.00009,2,2209788,2213373,+,3585
445,BUMA.1121.00039,2,439321,442739,-,3418
445,BUMA.1121.00029,2,1008149,1011659,-,3510
445,BUMA.1121.00021,2,823506,826938,+,3432
445,BUMA.1121.00107,2,300411,303865,-,3454
445,BUMA.1121.00023,2,416271,419752,+,3481
445,BUMA.1121.00067,2,443569,447057,-,3488
445,BUMA.1121.00035,2,1092994,1096503,-,3509
445,BUMA.1121.00005,2,362881,366308,-,3427
445,BUMA.1121.00100,2,1475576,1478974,+,3398
445,BUMA.1121.00016,2,239820,243375,-,3555
445,BUMA.1121.00099,2,503956,507406,+,3450
445,BUMA.1121.00094,2,360760,364193,+,3433
445,BUMA.1121.00093,2,2579559,2583032,-,3473
445,BUMA.1121.00097,2,158214,161668,+,3454
445,BUMA.1121.00109,2,1101435,1104839,-,3404
445,BUMA.1121.00018,2,346784,350187,-,3403
445,BUMA.1121.00110,2,230597,233918,+,3321
445,BUMA.1121.00079,2,362130,365683,+,3553
445,BUMA.1121.00075,2,2496014,2499429,-,3415
445,BUMA.1121.00066,2,359573,362970,+,3397
445,BUMA.1121.00089,2,361883,365315,+,3432
445,BUMA.1121.00057,2,1731342,1734750,-,3408
445,BUMA.1121.00090,2,1263898,1267386,+,3488
445,BUMA.1121.00027,2,1413604,1417005,+,3401
445,BUMA.1121.00062,2,1413350,1416758,-,3408
445,BUMA.1121.00091,2,80853,84316,-,3463
445,BUMA.1121.00098,2,570599,574039,+,3440
445,BUMA.1121.00092,2,361875,365349,+,3474
445,BUMA.1121.00031,2,2699655,2703086,+,3431
445,BUMA.1121.00096,2,521875,525336,+,3461
445,BUMA.1121.00073,2,352581,355982,+,3401
445,BUMA.1121.00103,2,2232662,2236096,+,3434
445,BUMA.1121.00084,2,2200607,2204046,+,3439
445,BUMA.1121.00014,2,367432,370849,+,3417
445,BUMA.1121.00111,2,2801535,2804981,+,3446
445,BUMA.1121.00007,2,372072,375556,+,3484
445,BUMA.1121.00072,2,351961,355362,+,3401
445,BUMA.1121.00071,2,353588,356989,+,3401
445,BUMA.1121.00077,2,125412,128733,-,3321
445,BUMA.1121.00003,2,1747570,1750971,+,3401
445,BUMA.1121.00104,2,467401,470813,+,3412
445,BUMA.1121.00074,2,883947,887352,-,3405
445,BUMA.1121.00088,2,313401,316848,+,3447
445,BUMA.1121.00053,2,590401,593848,+,3447
445,BUMA.1121.00025,2,1982845,1986248,+,3403
445,BUMA.1121.00070,2,352578,355979,+,3401
445,BUMA.1121.00049,2,2172021,2175449,+,3428
445,BUMA.1121.00078,2,2863782,2867263,-,3481
445,BUMA.1121.00069,2,352073,355474,+,3401
445,BUMA.1121.00102,2,362655,366122,+,3467
445,BUMA.1121.00112,2,792298,795775,-,3477
445,BUMA.1121.00041,2,1252370,1255851,+,3481
445,BUMA.1121.00076,2,1246247,1249665,+,3418
445,BUMA.1121.00033,2,1031648,1035056,+,3408
445,BUMA.1121.00101,2,3094942,3098431,-,3489
445,BUMA.1121.00105,2,2144853,2148303,-,3450
445,BUMA.1121.00061,2,343444,346845,+,3401
445,BUMA.1121.00063,2,352658,356059,+,3401
445,BUMA.1121.00059,2,115418,118844,-,3426
445,BUMA.1121.00058,2,924694,928162,+,3468
445,BUMA.1121.00043,2,2084061,2087590,-,3529
445,BUMA.1121.00055,2,2320711,2324179,-,3468
445,BUMA.1121.00065,2,362820,366348,+,3528
445,BUMA.1121.00064,2,361516,365019,+,3503
445,BUMA.1121.00047,2,1292667,1296179,+,3512
445,BUMA.1121.00037,2,616243,619660,+,3417
445,BUMA.1121.00106,2,2776691,2780166,+,3475
445,BUMA.1121.00051,2,362145,365693,+,3548
445,BUMA.1121.00045,2,210739,214223,+,3484
445,BUMA.1121.00056,2,526567,529999,-,3432
445,BUMA.1121.00095,2,2420212,2423624,+,3412
445,BUMA.1121.00082,2,362230,365631,+,3401
445,BUMA.1121.00001,2,1897488,1901039,-,3551
445,BUMA.1121.00108,2,599562,603000,+,3438
445,BUMA.1121.00083,2,2159187,2162588,+,3401
445,BUMA.1121.00080,2,361918,365399,+,3481
445,BUMA.1121.00012,2,1460581,1464034,-,3453
446,BUMA.1121.00011,2,2184466,2188229,+,3763
446,BUMA.1121.00009,2,2214670,2218406,+,3736
446,BUMA.1121.00039,2,434291,438025,-,3734
446,BUMA.1121.00029,2,1003114,1006853,-,3739
446,BUMA.1121.00021,2,828235,831968,+,3733
446,BUMA.1121.00107,2,295391,299115,-,3724
446,BUMA.1121.00023,2,421049,424787,+,3738
446,BUMA.1121.00067,2,438542,442273,-,3731
446,BUMA.1121.00035,2,1087954,1091698,-,3744
446,BUMA.1121.00005,2,357846,361585,-,3739
446,BUMA.1121.00100,2,1480272,1483989,+,3717
446,BUMA.1121.00016,2,234790,238524,-,3734
446,BUMA.1121.00099,2,508703,512452,+,3749
446,BUMA.1121.00094,2,365490,369230,+,3740
446,BUMA.1121.00093,2,2574522,2578263,-,3741
446,BUMA.1121.00097,2,162965,166711,+,3746
446,BUMA.1121.00109,2,1096413,1100139,-,3726
446,BUMA.1121.00018,2,341754,345488,-,3734
446,BUMA.1121.00110,2,235215,238943,+,3728
446,BUMA.1121.00079,2,366980,370720,+,3740
446,BUMA.1121.00075,2,2490977,2494718,-,3741
446,BUMA.1121.00066,2,364267,368000,+,3733
446,BUMA.1121.00089,2,366612,370352,+,3740
446,BUMA.1121.00057,2,1726317,1730046,-,3729
446,BUMA.1121.00090,2,1268683,1272416,+,3733
446,BUMA.1121.00027,2,1418302,1422030,+,3728
446,BUMA.1121.00062,2,1408303,1412002,-,3699
446,BUMA.1121.00091,2,75808,79557,-,3749
446,BUMA.1121.00098,2,575336,579071,+,3735
446,BUMA.1121.00092,2,366646,370386,+,3740
446,BUMA.1121.00031,2,2704383,2708121,+,3738
446,BUMA.1121.00096,2,526635,530363,+,3728
446,BUMA.1121.00073,2,357279,361012,+,3733
446,BUMA.1121.00103,2,2237393,2241128,+,3735
446,BUMA.1121.00084,2,2205343,2209083,+,3740
446,BUMA.1121.00014,2,372146,375884,+,3738
446,BUMA.1121.00111,2,2806278,2810006,+,3728
446,BUMA.1121.00007,2,376853,380576,+,3723
446,BUMA.1121.00072,2,356659,360392,+,3733
446,BUMA.1121.00071,2,358286,362019,+,3733
446,BUMA.1121.00077,2,120387,124116,-,3729
446,BUMA.1121.00003,2,1752268,1756007,+,3739
446,BUMA.1121.00104,2,472110,475850,+,3740
446,BUMA.1121.00074,2,878927,882651,-,3724
446,BUMA.1121.00088,2,318145,321885,+,3740
446,BUMA.1121.00053,2,595145,598883,+,3738
446,BUMA.1121.00025,2,1987545,1991278,+,3733
446,BUMA.1121.00070,2,357276,361009,+,3733
446,BUMA.1121.00049,2,2176746,2180469,+,3723
446,BUMA.1121.00078,2,2858745,2862486,-,3741
446,BUMA.1121.00069,2,356771,360504,+,3733
446,BUMA.1121.00102,2,367419,371159,+,3740
446,BUMA.1121.00112,2,787278,791002,-,3724
446,BUMA.1121.00041,2,1257148,1260927,+,3779
446,BUMA.1121.00068,2,2077229,2080950,+,3721
446,BUMA.1121.00076,2,1250962,1254702,+,3740
446,BUMA.1121.00033,2,1036353,1040091,+,3738
446,BUMA.1121.00101,2,3089930,3093646,-,3716
446,BUMA.1121.00105,2,2139833,2143557,-,3724
446,BUMA.1121.00061,2,348142,351875,+,3733
446,BUMA.1121.00063,2,357356,361089,+,3733
446,BUMA.1121.00059,2,110398,114122,-,3724
446,BUMA.1121.00058,2,929459,933182,+,3723
446,BUMA.1121.00043,2,2079021,2082765,-,3744
446,BUMA.1121.00055,2,2315656,2319415,-,3759
446,BUMA.1121.00065,2,367645,371355,+,3710
446,BUMA.1121.00064,2,366316,370056,+,3740
446,BUMA.1121.00047,2,1297476,1301214,+,3738
446,BUMA.1121.00037,2,620957,624695,+,3738
446,BUMA.1121.00106,2,2781463,2785203,+,3740
446,BUMA.1121.00051,2,366990,370720,+,3730
446,BUMA.1121.00045,2,215520,219292,+,3772
446,BUMA.1121.00056,2,521530,525271,-,3741
446,BUMA.1121.00095,2,2424923,2428640,+,3717
446,BUMA.1121.00082,2,366928,370661,+,3733
446,BUMA.1121.00001,2,1892448,1896192,-,3744
446,BUMA.1121.00108,2,604297,608018,+,3721
446,BUMA.1121.00083,2,2163885,2167618,+,3733
446,BUMA.1121.00080,2,366696,370419,+,3723
446,BUMA.1121.00012,2,1455551,1459285,-,3734
447,BUMA.1121.00011,2,2188903,2192639,+,3736
447,BUMA.1121.00009,2,2219093,2222825,+,3732
447,BUMA.1121.00039,2,429884,433618,-,3734
447,BUMA.1121.00029,2,998707,1002440,-,3733
447,BUMA.1121.00021,2,832642,836376,+,3734
447,BUMA.1121.00107,2,290975,294717,-,3742
447,BUMA.1121.00023,2,425461,429196,+,3735
447,BUMA.1121.00067,2,434455,437868,-,3413
447,BUMA.1121.00035,2,1083547,1087280,-,3733
447,BUMA.1121.00005,2,353427,357172,-,3745
447,BUMA.1121.00100,2,1484663,1488370,+,3707
447,BUMA.1121.00016,2,230395,234116,-,3721
447,BUMA.1121.00099,2,513126,516869,+,3743
447,BUMA.1121.00094,2,369904,373628,+,3724
447,BUMA.1121.00093,2,2570435,2573848,-,3413
447,BUMA.1121.00097,2,167385,171129,+,3744
447,BUMA.1121.00109,2,1091997,1095739,-,3742
447,BUMA.1121.00018,2,337347,341080,-,3733
447,BUMA.1121.00110,2,239617,243329,+,3712
447,BUMA.1121.00079,2,371394,375115,+,3721
447,BUMA.1121.00075,2,2486888,2490304,-,3416
447,BUMA.1121.00066,2,368674,372088,+,3414
447,BUMA.1121.00089,2,371026,374750,+,3724
447,BUMA.1121.00057,2,1721923,1725643,-,3720
447,BUMA.1121.00090,2,1273090,1276811,+,3721
447,BUMA.1121.00027,2,1422704,1426424,+,3720
447,BUMA.1121.00062,2,1404216,1407630,-,3414
447,BUMA.1121.00091,2,71721,75135,-,3414
447,BUMA.1121.00098,2,579745,583488,+,3743
447,BUMA.1121.00092,2,371060,374474,+,3414
447,BUMA.1121.00031,2,2708795,2712528,+,3733
447,BUMA.1121.00096,2,531037,534780,+,3743
447,BUMA.1121.00073,2,361686,365100,+,3414
447,BUMA.1121.00103,2,2241802,2245545,+,3743
447,BUMA.1121.00084,2,2209757,2213469,+,3712
447,BUMA.1121.00014,2,376558,380292,+,3734
447,BUMA.1121.00111,2,2810680,2814414,+,3734
447,BUMA.1121.00007,2,381250,384993,+,3743
447,BUMA.1121.00072,2,361066,364480,+,3414
447,BUMA.1121.00071,2,362693,366107,+,3414
447,BUMA.1121.00077,2,116002,119713,-,3711
447,BUMA.1121.00003,2,1756681,1760402,+,3721
447,BUMA.1121.00104,2,476524,480248,+,3724
447,BUMA.1121.00074,2,874520,878254,-,3734
447,BUMA.1121.00088,2,322559,326271,+,3712
447,BUMA.1121.00053,2,599557,602971,+,3414
447,BUMA.1121.00025,2,1991952,1995686,+,3734
447,BUMA.1121.00070,2,361683,365097,+,3414
447,BUMA.1121.00049,2,2181143,2184886,+,3743
447,BUMA.1121.00078,2,2854360,2858072,-,3712
447,BUMA.1121.00069,2,361178,364592,+,3414
447,BUMA.1121.00102,2,371833,375554,+,3721
447,BUMA.1121.00112,2,782870,786605,-,3735
447,BUMA.1121.00041,2,1261601,1265015,+,3414
447,BUMA.1121.00068,2,2081624,2085359,+,3735
447,BUMA.1121.00076,2,1255376,1258793,+,3417
447,BUMA.1121.00033,2,1040765,1044484,+,3719
447,BUMA.1121.00101,2,3085522,3089257,-,3735
447,BUMA.1121.00105,2,2135448,2139160,-,3712
447,BUMA.1121.00061,2,352549,355963,+,3414
447,BUMA.1121.00063,2,361763,365177,+,3414
447,BUMA.1121.00059,2,106004,109724,-,3720
447,BUMA.1121.00058,2,933856,937577,+,3721
447,BUMA.1121.00043,2,2074601,2078347,-,3746
447,BUMA.1121.00055,2,2311568,2314983,-,3415
447,BUMA.1121.00065,2,372029,375452,+,3423
447,BUMA.1121.00064,2,370730,374444,+,3714
447,BUMA.1121.00047,2,1301888,1305311,+,3423
447,BUMA.1121.00037,2,625369,629090,+,3721
447,BUMA.1121.00106,2,2785877,2789598,+,3721
447,BUMA.1121.00051,2,371394,374808,+,3414
447,BUMA.1121.00045,2,219966,223713,+,3747
447,BUMA.1121.00056,2,517133,520856,-,3723
447,BUMA.1121.00095,2,2429314,2433035,+,3721
447,BUMA.1121.00082,2,371335,374749,+,3414
447,BUMA.1121.00001,2,1888041,1891774,-,3733
447,BUMA.1121.00108,2,608692,612413,+,3721
447,BUMA.1121.00083,2,2168292,2171706,+,3414
447,BUMA.1121.00080,2,371093,374827,+,3734
447,BUMA.1121.00012,2,1451166,1454878,-,3712
448,BUMA.1121.00011,2,2200764,2263694,+,62930
448,BUMA.1121.00009,2,2230947,2293749,+,62802
448,BUMA.1121.00039,2,360142,421756,-,61614
448,BUMA.1121.00029,2,928928,990577,-,61649
448,BUMA.1121.00021,2,844515,906164,+,61649
448,BUMA.1121.00107,2,219869,282837,-,62968
448,BUMA.1121.00023,2,437309,498934,+,61625
448,BUMA.1121.00067,2,364755,426327,-,61572
448,BUMA.1121.00035,2,1013818,1075417,-,61599
448,BUMA.1121.00005,2,283634,345305,-,61671
448,BUMA.1121.00100,2,1496254,1559184,+,62930
448,BUMA.1121.00016,2,160683,222265,-,61582
448,BUMA.1121.00099,2,525010,586850,+,61840
448,BUMA.1121.00094,2,381793,443327,+,61534
448,BUMA.1121.00093,2,2500652,2562295,-,61643
448,BUMA.1121.00097,2,179288,242104,+,62816
448,BUMA.1121.00109,2,1021240,1083917,-,62677
448,BUMA.1121.00018,2,267494,329209,-,61715
448,BUMA.1121.00110,2,251424,313148,+,61724
448,BUMA.1121.00079,2,383279,445030,+,61751
448,BUMA.1121.00075,2,2415883,2478733,-,62850
448,BUMA.1121.00066,2,380253,441946,+,61693
448,BUMA.1121.00089,2,382905,444456,+,61551
448,BUMA.1121.00057,2,1652113,1713794,-,61681
448,BUMA.1121.00090,2,1284959,1346637,+,61678
448,BUMA.1121.00027,2,1434553,1496270,+,61717
448,BUMA.1121.00062,2,1334459,1396041,-,61582
448,BUMA.1121.00091,2,1959,63599,-,61640
448,BUMA.1121.00098,2,591628,653245,+,61617
448,BUMA.1121.00092,2,382614,444265,+,61651
448,BUMA.1121.00031,2,2720656,2782247,+,61591
448,BUMA.1121.00096,2,542919,605759,+,62840
448,BUMA.1121.00073,2,373265,434977,+,61712
448,BUMA.1121.00103,2,2253677,2315404,+,61727
448,BUMA.1121.00084,2,2221642,2283224,+,61582
448,BUMA.1121.00014,2,388420,450038,+,61618
448,BUMA.1121.00111,2,2822544,2884265,+,61721
448,BUMA.1121.00007,2,393139,454994,+,61855
448,BUMA.1121.00072,2,372635,434357,+,61722
448,BUMA.1121.00071,2,374272,435892,+,61620
448,BUMA.1121.00077,2,46220,107907,-,61687
448,BUMA.1121.00003,2,1768533,1830254,+,61721
448,BUMA.1121.00104,2,488370,550020,+,61650
448,BUMA.1121.00074,2,804830,866365,-,61535
448,BUMA.1121.00088,2,334435,396077,+,61642
448,BUMA.1121.00053,2,611135,674010,+,62875
448,BUMA.1121.00025,2,2003824,2065532,+,61708
448,BUMA.1121.00070,2,373262,434977,+,61715
448,BUMA.1121.00049,2,2193059,2254737,+,61678
448,BUMA.1121.00078,2,2783258,2846241,-,62983
448,BUMA.1121.00069,2,372757,434447,+,61690
448,BUMA.1121.00102,2,383677,446478,+,62801
448,BUMA.1121.00112,2,713113,774715,-,61602
448,BUMA.1121.00041,2,1273188,1335022,+,61834
448,BUMA.1121.00068,2,2093475,2155143,+,61668
448,BUMA.1121.00076,2,1266948,1329801,+,62853
448,BUMA.1121.00033,2,1052613,1114276,+,61663
448,BUMA.1121.00101,2,3015828,3077373,-,61545
448,BUMA.1121.00105,2,2065656,2127302,-,61646
448,BUMA.1121.00061,2,364124,425754,+,61630
448,BUMA.1121.00063,2,373342,435052,+,61710
448,BUMA.1121.00059,2,36214,97876,-,61662
448,BUMA.1121.00058,2,945690,1007216,+,61526
448,BUMA.1121.00043,2,2004941,2066462,-,61521
448,BUMA.1121.00055,2,2241615,2303383,-,61768
448,BUMA.1121.00065,2,383604,446531,+,62927
448,BUMA.1121.00047,2,1313431,1375156,+,61725
448,BUMA.1121.00037,2,647873,709529,+,61656
448,BUMA.1121.00106,2,2797753,2859352,+,61599
448,BUMA.1121.00051,2,382953,444659,+,61706
448,BUMA.1121.00045,2,231842,293440,+,61598
448,BUMA.1121.00056,2,447427,508978,-,61551
448,BUMA.1121.00095,2,2441173,2502800,+,61627
448,BUMA.1121.00082,2,382914,444629,+,61715
448,BUMA.1121.00001,2,1818305,1879911,-,61606
448,BUMA.1121.00108,2,620568,682334,+,61766
448,BUMA.1121.00083,2,2179871,2241586,+,61715
448,BUMA.1121.00080,2,382952,444712,+,61760
448,BUMA.1121.00012,2,1381496,1443027,-,61531
449,BUMA.1121.00011,2,2267189,2272813,+,5624
449,BUMA.1121.00009,2,2297250,2302913,+,5663
449,BUMA.1121.00039,2,351020,356654,-,5634
449,BUMA.1121.00029,2,919798,925433,-,5635
449,BUMA.1121.00021,2,909659,915283,+,5624
449,BUMA.1121.00107,2,210737,216372,-,5635
449,BUMA.1121.00023,2,502407,508031,+,5624
449,BUMA.1121.00067,2,355630,361254,-,5624
449,BUMA.1121.00035,2,1004699,1010323,-,5624
449,BUMA.1121.00005,2,274507,280131,-,5624
449,BUMA.1121.00100,2,1562685,1568320,+,5635
449,BUMA.1121.00016,2,151564,157188,-,5624
449,BUMA.1121.00099,2,590346,595970,+,5624
449,BUMA.1121.00094,2,446812,452436,+,5624
449,BUMA.1121.00093,2,2491468,2497151,-,5683
449,BUMA.1121.00097,2,245605,251229,+,5624
449,BUMA.1121.00109,2,1012085,1017739,-,5654
449,BUMA.1121.00018,2,258376,263999,-,5623
449,BUMA.1121.00110,2,316649,322344,+,5695
449,BUMA.1121.00079,2,448531,454154,+,5623
449,BUMA.1121.00075,2,2406758,2412381,-,5623
449,BUMA.1121.00066,2,445447,451137,+,5690
449,BUMA.1121.00089,2,447941,453565,+,5624
449,BUMA.1121.00057,2,1642922,1648612,-,5690
449,BUMA.1121.00090,2,1350132,1355756,+,5624
449,BUMA.1121.00027,2,1499771,1505490,+,5719
449,BUMA.1121.00062,2,1325294,1330964,-,5670
449,BUMA.1121.00091,2,3237631,3243274,-,5643
449,BUMA.1121.00098,2,656735,662358,+,5623
449,BUMA.1121.00092,2,447766,453469,+,5703
449,BUMA.1121.00031,2,2785740,2791364,+,5624
449,BUMA.1121.00096,2,609260,614883,+,5623
449,BUMA.1121.00073,2,438478,444165,+,5687
449,BUMA.1121.00103,2,2318905,2324529,+,5624
449,BUMA.1121.00084,2,2286721,2292375,+,5654
449,BUMA.1121.00014,2,453533,459157,+,5624
449,BUMA.1121.00111,2,2887767,2893402,+,5635
449,BUMA.1121.00007,2,458490,464102,+,5612
449,BUMA.1121.00072,2,437858,443548,+,5690
449,BUMA.1121.00071,2,439393,445083,+,5690
449,BUMA.1121.00077,2,37024,42719,-,5695
449,BUMA.1121.00003,2,1833755,1839395,+,5640
449,BUMA.1121.00104,2,553522,559186,+,5664
449,BUMA.1121.00074,2,795695,801329,-,5634
449,BUMA.1121.00060,2,1791260,1796884,-,5624
449,BUMA.1121.00088,2,399573,405217,+,5644
449,BUMA.1121.00053,2,677496,683130,+,5634
449,BUMA.1121.00025,2,2069027,2074651,+,5624
449,BUMA.1121.00070,2,438478,444168,+,5690
449,BUMA.1121.00049,2,2258233,2263897,+,5664
449,BUMA.1121.00078,2,2774138,2779762,-,5624
449,BUMA.1121.00069,2,437948,443638,+,5690
449,BUMA.1121.00102,2,449979,455639,+,5660
449,BUMA.1121.00112,2,704074,709698,-,5624
449,BUMA.1121.00041,2,1338523,1344176,+,5653
449,BUMA.1121.00068,2,2158644,2164257,+,5613
449,BUMA.1121.00076,2,1333303,1338927,+,5624
449,BUMA.1121.00033,2,1117771,1123395,+,5624
449,BUMA.1121.00101,2,3006698,3012327,-,5629
449,BUMA.1121.00105,2,2056536,2062160,-,5624
449,BUMA.1121.00061,2,429247,434935,+,5688
449,BUMA.1121.00063,2,438553,444240,+,5687
449,BUMA.1121.00059,2,27106,32718,-,5612
449,BUMA.1121.00058,2,1010717,1016351,+,5634
449,BUMA.1121.00043,2,1995822,2001446,-,5624
449,BUMA.1121.00055,2,2232434,2238114,-,5680
449,BUMA.1121.00065,2,450029,455653,+,5624
449,BUMA.1121.00064,2,374490,380134,+,5644
449,BUMA.1121.00047,2,1378641,1384265,+,5624
449,BUMA.1121.00037,2,713024,718657,+,5633
449,BUMA.1121.00106,2,2862853,2868477,+,5624
449,BUMA.1121.00051,2,448144,453767,+,5623
449,BUMA.1121.00045,2,296941,302565,+,5624
449,BUMA.1121.00056,2,438318,443942,-,5624
449,BUMA.1121.00095,2,2506301,2511925,+,5624
449,BUMA.1121.00082,2,448130,453820,+,5690
449,BUMA.1121.00001,2,1809186,1814810,-,5624
449,BUMA.1121.00108,2,685829,691502,+,5673
449,BUMA.1121.00083,2,2245087,2250777,+,5690
449,BUMA.1121.00080,2,448197,453820,+,5623
449,BUMA.1121.00012,2,1372370,1377994,-,5624
450,BUMA.1121.00011,2,2279117,2288391,+,9274
450,BUMA.1121.00009,2,2309198,2318486,+,9288
450,BUMA.1121.00039,2,335520,344783,-,9263
450,BUMA.1121.00029,2,904223,913434,-,9211
450,BUMA.1121.00021,2,921660,930924,+,9264
450,BUMA.1121.00107,2,195196,204453,-,9257
450,BUMA.1121.00023,2,514275,523530,+,9255
450,BUMA.1121.00067,2,340148,349369,-,9221
450,BUMA.1121.00035,2,989136,998347,-,9211
450,BUMA.1121.00005,2,259010,268258,-,9248
450,BUMA.1121.00100,2,1574590,1583846,+,9256
450,BUMA.1121.00016,2,135910,145173,-,9263
450,BUMA.1121.00099,2,602270,611476,+,9206
450,BUMA.1121.00094,2,458672,467936,+,9264
450,BUMA.1121.00093,2,2475879,2485090,-,9211
450,BUMA.1121.00097,2,257498,266697,+,9199
450,BUMA.1121.00109,2,996493,1005750,-,9257
450,BUMA.1121.00018,2,242749,252003,-,9254
450,BUMA.1121.00110,2,328603,337865,+,9262
450,BUMA.1121.00079,2,460400,469622,+,9222
450,BUMA.1121.00075,2,2391229,2400454,-,9225
450,BUMA.1121.00066,2,457402,466599,+,9197
450,BUMA.1121.00089,2,459801,469065,+,9264
450,BUMA.1121.00057,2,1627422,1636627,-,9205
450,BUMA.1121.00090,2,1362110,1371374,+,9264
450,BUMA.1121.00027,2,1511781,1520985,+,9204
450,BUMA.1121.00062,2,1309742,1319005,-,9263
450,BUMA.1121.00091,2,3222107,3231322,-,9215
450,BUMA.1121.00098,2,668703,677957,+,9254
450,BUMA.1121.00092,2,459846,469058,+,9212
450,BUMA.1121.00031,2,2797610,2806874,+,9264
450,BUMA.1121.00096,2,621238,630509,+,9271
450,BUMA.1121.00073,2,450430,459628,+,9198
450,BUMA.1121.00103,2,2330828,2340084,+,9256
450,BUMA.1121.00084,2,2298607,2307841,+,9234
450,BUMA.1121.00014,2,465404,474668,+,9264
450,BUMA.1121.00111,2,2899713,2908977,+,9264
450,BUMA.1121.00007,2,470381,479642,+,9261
450,BUMA.1121.00072,2,449813,459018,+,9205
450,BUMA.1121.00071,2,451341,460546,+,9205
450,BUMA.1121.00077,2,21501,30763,-,9262
450,BUMA.1121.00003,2,1845646,1854910,+,9264
450,BUMA.1121.00104,2,565447,574723,+,9276
450,BUMA.1121.00074,2,780218,789438,-,9220
450,BUMA.1121.00060,2,1775722,1784996,-,9274
450,BUMA.1121.00088,2,411487,420721,+,9234
450,BUMA.1121.00053,2,689321,698520,+,9199
450,BUMA.1121.00025,2,2081023,2090277,+,9254
450,BUMA.1121.00070,2,450433,459638,+,9205
450,BUMA.1121.00049,2,2270158,2279380,+,9222
450,BUMA.1121.00078,2,2758485,2767746,-,9261
450,BUMA.1121.00069,2,449903,459101,+,9198
450,BUMA.1121.00102,2,462003,471202,+,9199
450,BUMA.1121.00112,2,688519,697777,-,9258
450,BUMA.1121.00041,2,1350486,1359749,+,9263
450,BUMA.1121.00068,2,2170578,2179849,+,9271
450,BUMA.1121.00076,2,1345235,1354460,+,9225
450,BUMA.1121.00033,2,1135425,1144681,+,9256
450,BUMA.1121.00101,2,2991188,3000444,-,9256
450,BUMA.1121.00105,2,2041026,2050289,-,9263
450,BUMA.1121.00061,2,441200,450405,+,9205
450,BUMA.1121.00063,2,450505,459702,+,9197
450,BUMA.1121.00059,2,11609,20842,-,9233
450,BUMA.1121.00058,2,1022605,1031869,+,9264
450,BUMA.1121.00043,2,1974509,1983770,-,9261
450,BUMA.1121.00055,2,2171237,2180494,-,9257
450,BUMA.1121.00065,2,461950,471147,+,9197
450,BUMA.1121.00064,2,386380,395644,+,9264
450,BUMA.1121.00047,2,1390532,1399796,+,9264
450,BUMA.1121.00037,2,730668,739919,+,9251
450,BUMA.1121.00106,2,2874745,2884009,+,9264
450,BUMA.1121.00051,2,460060,469282,+,9222
450,BUMA.1121.00045,2,308828,318102,+,9274
450,BUMA.1121.00056,2,422818,432081,-,9263
450,BUMA.1121.00095,2,2518189,2527455,+,9266
450,BUMA.1121.00082,2,460085,469290,+,9205
450,BUMA.1121.00001,2,1793620,1802831,-,9211
450,BUMA.1121.00108,2,697784,707041,+,9257
450,BUMA.1121.00083,2,2257042,2266247,+,9205
450,BUMA.1121.00080,2,460122,469344,+,9222
450,BUMA.1121.00012,2,1356723,1365986,-,9263
451,BUMA.1121.00011,2,2291020,2299599,+,8579
451,BUMA.1121.00009,2,2321096,2329685,+,8589
451,BUMA.1121.00039,2,324341,332923,-,8582
451,BUMA.1121.00029,2,893045,901626,-,8581
451,BUMA.1121.00021,2,933521,942103,+,8582
451,BUMA.1121.00107,2,184021,192603,-,8582
451,BUMA.1121.00023,2,526134,534707,+,8573
451,BUMA.1121.00067,2,328966,337549,-,8583
451,BUMA.1121.00035,2,977958,986539,-,8581
451,BUMA.1121.00005,2,247761,256342,-,8581
451,BUMA.1121.00100,2,1586449,1595028,+,8579
451,BUMA.1121.00016,2,124731,133313,-,8582
451,BUMA.1121.00099,2,614110,622630,+,8520
451,BUMA.1121.00094,2,470541,479123,+,8582
451,BUMA.1121.00093,2,2464711,2473291,-,8580
451,BUMA.1121.00097,2,269319,277901,+,8582
451,BUMA.1121.00109,2,985331,993912,-,8581
451,BUMA.1121.00018,2,231571,240144,-,8573
451,BUMA.1121.00110,2,340456,349035,+,8579
451,BUMA.1121.00079,2,472227,480808,+,8581
451,BUMA.1121.00075,2,2379998,2388577,-,8579
451,BUMA.1121.00066,2,469205,477787,+,8582
451,BUMA.1121.00089,2,471670,480252,+,8582
451,BUMA.1121.00057,2,1616236,1624817,-,8581
451,BUMA.1121.00090,2,1373971,1382553,+,8582
451,BUMA.1121.00027,2,1523583,1532165,+,8582
451,BUMA.1121.00062,2,1298538,1307120,-,8582
451,BUMA.1121.00091,2,3210889,3219464,-,8575
451,BUMA.1121.00098,2,680587,689166,+,8579
451,BUMA.1121.00092,2,471646,480226,+,8580
451,BUMA.1121.00031,2,2809471,2818053,+,8582
451,BUMA.1121.00096,2,633133,641711,+,8578
451,BUMA.1121.00073,2,462234,470816,+,8582
451,BUMA.1121.00103,2,2342673,2351253,+,8580
451,BUMA.1121.00084,2,2310440,2319022,+,8582
451,BUMA.1121.00014,2,477250,485832,+,8582
451,BUMA.1121.00111,2,2911574,2920156,+,8582
451,BUMA.1121.00007,2,482264,490845,+,8581
451,BUMA.1121.00072,2,461617,470199,+,8582
451,BUMA.1121.00071,2,463152,471734,+,8582
451,BUMA.1121.00077,2,10333,18911,-,8578
451,BUMA.1121.00003,2,1857607,1866038,+,8431
451,BUMA.1121.00104,2,577322,585904,+,8582
451,BUMA.1121.00074,2,769036,777619,-,8583
451,BUMA.1121.00060,2,1764541,1773123,-,8582
451,BUMA.1121.00088,2,423320,431901,+,8581
451,BUMA.1121.00053,2,701146,709711,+,8565
451,BUMA.1121.00025,2,2092883,2101456,+,8573
451,BUMA.1121.00070,2,462236,470818,+,8582
451,BUMA.1121.00049,2,2281967,2290550,+,8583
451,BUMA.1121.00078,2,2747283,2755865,-,8582
451,BUMA.1121.00069,2,461705,470287,+,8582
451,BUMA.1121.00102,2,473828,482408,+,8580
451,BUMA.1121.00112,2,677321,685896,-,8575
451,BUMA.1121.00041,2,1362343,1370925,+,8582
451,BUMA.1121.00068,2,2182523,2191083,+,8560
451,BUMA.1121.00076,2,1357113,1365692,+,8579
451,BUMA.1121.00033,2,1147287,1155868,+,8581
451,BUMA.1121.00101,2,2980009,2988589,-,8580
451,BUMA.1121.00105,2,2029845,2038427,-,8582
451,BUMA.1121.00061,2,453004,461586,+,8582
451,BUMA.1121.00063,2,462308,470890,+,8582
451,BUMA.1121.00059,2,441,9023,-,8582
451,BUMA.1121.00058,2,1034472,1043055,+,8583
451,BUMA.1121.00043,2,1963340,1971912,-,8572
451,BUMA.1121.00055,2,2160040,2168622,-,8582
451,BUMA.1121.00065,2,473772,482353,+,8581
451,BUMA.1121.00064,2,398243,406824,+,8581
451,BUMA.1121.00047,2,1402401,1410984,+,8583
451,BUMA.1121.00037,2,750632,759185,+,8553
451,BUMA.1121.00106,2,2886615,2895197,+,8582
451,BUMA.1121.00051,2,471887,480468,+,8581
451,BUMA.1121.00045,2,320702,329284,+,8582
451,BUMA.1121.00056,2,411631,420213,-,8582
451,BUMA.1121.00095,2,2530070,2538660,+,8590
451,BUMA.1121.00082,2,471889,480471,+,8582
451,BUMA.1121.00001,2,1782442,1791023,-,8581
451,BUMA.1121.00108,2,709660,718242,+,8582
451,BUMA.1121.00083,2,2268846,2277428,+,8582
451,BUMA.1121.00080,2,471949,480529,+,8580
451,BUMA.1121.00012,2,1345545,1354126,-,8581
452,BUMA.1121.00011,2,2300041,2304053,+,4012
452,BUMA.1121.00009,2,2330127,2334126,+,3999
452,BUMA.1121.00039,2,319887,323899,-,4012
452,BUMA.1121.00029,2,888590,892603,-,4013
452,BUMA.1121.00021,2,942545,946558,+,4013
452,BUMA.1121.00107,2,179567,183579,-,4012
452,BUMA.1121.00023,2,535149,539162,+,4013
452,BUMA.1121.00067,2,324512,328524,-,4012
452,BUMA.1121.00035,2,973503,977516,-,4013
452,BUMA.1121.00005,2,243306,247319,-,4013
452,BUMA.1121.00100,2,1595470,1599478,+,4008
452,BUMA.1121.00016,2,120276,124289,-,4013
452,BUMA.1121.00099,2,623133,627145,+,4012
452,BUMA.1121.00094,2,479565,483577,+,4012
452,BUMA.1121.00093,2,2460257,2464269,-,4012
452,BUMA.1121.00097,2,278343,282355,+,4012
452,BUMA.1121.00109,2,980875,984889,-,4014
452,BUMA.1121.00018,2,227116,231129,-,4013
452,BUMA.1121.00110,2,349477,353489,+,4012
452,BUMA.1121.00079,2,481250,485262,+,4012
452,BUMA.1121.00075,2,2375539,2379556,-,4017
452,BUMA.1121.00066,2,478229,482242,+,4013
452,BUMA.1121.00089,2,480694,484706,+,4012
452,BUMA.1121.00057,2,1611782,1615794,-,4012
452,BUMA.1121.00090,2,1382995,1387008,+,4013
452,BUMA.1121.00027,2,1532607,1536619,+,4012
452,BUMA.1121.00062,2,1294084,1298096,-,4012
452,BUMA.1121.00091,2,3206435,3210443,-,4008
452,BUMA.1121.00098,2,689608,693620,+,4012
452,BUMA.1121.00092,2,480668,484680,+,4012
452,BUMA.1121.00031,2,2818495,2822508,+,4013
452,BUMA.1121.00096,2,642153,646152,+,3999
452,BUMA.1121.00073,2,471258,475271,+,4013
452,BUMA.1121.00103,2,2351695,2355708,+,4013
452,BUMA.1121.00084,2,2319464,2323481,+,4017
452,BUMA.1121.00014,2,486274,490287,+,4013
452,BUMA.1121.00111,2,2920598,2924611,+,4013
452,BUMA.1121.00007,2,491287,495299,+,4012
452,BUMA.1121.00072,2,470641,474654,+,4013
452,BUMA.1121.00071,2,472176,476189,+,4013
452,BUMA.1121.00077,2,5879,9891,-,4012
452,BUMA.1121.00003,2,1866480,1870488,+,4008
452,BUMA.1121.00104,2,586346,590363,+,4017
452,BUMA.1121.00074,2,764582,768594,-,4012
452,BUMA.1121.00060,2,1760087,1764099,-,4012
452,BUMA.1121.00088,2,432343,436360,+,4017
452,BUMA.1121.00053,2,710153,714165,+,4012
452,BUMA.1121.00025,2,2101898,2105911,+,4013
452,BUMA.1121.00070,2,471260,475273,+,4013
452,BUMA.1121.00049,2,2290992,2295004,+,4012
452,BUMA.1121.00078,2,2742824,2746841,-,4017
452,BUMA.1121.00069,2,470729,474741,+,4012
452,BUMA.1121.00102,2,482850,486862,+,4012
452,BUMA.1121.00112,2,672867,676879,-,4012
452,BUMA.1121.00041,2,1371367,1375379,+,4012
452,BUMA.1121.00068,2,2191525,2195537,+,4012
452,BUMA.1121.00076,2,1366134,1370151,+,4017
452,BUMA.1121.00033,2,1156310,1160322,+,4012
452,BUMA.1121.00101,2,2975554,2979567,-,4013
452,BUMA.1121.00105,2,2025391,2029403,-,4012
452,BUMA.1121.00061,2,462028,466041,+,4013
452,BUMA.1121.00063,2,471332,475345,+,4013
452,BUMA.1121.00059,2,3172422,3176439,-,4017
452,BUMA.1121.00058,2,1043497,1047509,+,4012
452,BUMA.1121.00043,2,1958885,1962898,-,4013
452,BUMA.1121.00055,2,2155586,2159598,-,4012
452,BUMA.1121.00065,2,482795,486807,+,4012
452,BUMA.1121.00064,2,407266,411278,+,4012
452,BUMA.1121.00047,2,1411426,1415438,+,4012
452,BUMA.1121.00037,2,759663,763627,+,3964
452,BUMA.1121.00106,2,2895639,2899656,+,4017
452,BUMA.1121.00051,2,480910,484922,+,4012
452,BUMA.1121.00045,2,329726,333738,+,4012
452,BUMA.1121.00056,2,407177,411189,-,4012
452,BUMA.1121.00095,2,2539102,2543114,+,4012
452,BUMA.1121.00082,2,480913,484926,+,4013
452,BUMA.1121.00001,2,1777987,1782000,-,4013
452,BUMA.1121.00108,2,718684,722698,+,4014
452,BUMA.1121.00083,2,2277870,2281883,+,4013
452,BUMA.1121.00080,2,480971,484983,+,4012
452,BUMA.1121.00012,2,1341090,1345103,-,4013
453,BUMA.1121.00011,2,2315730,2326962,+,11232
453,BUMA.1121.00009,2,2345810,2357047,+,11237
453,BUMA.1121.00039,2,298247,309476,-,11229
453,BUMA.1121.00029,2,866945,878180,-,11235
453,BUMA.1121.00021,2,956999,968233,+,11234
453,BUMA.1121.00107,2,156244,167484,-,11240
453,BUMA.1121.00023,2,549603,560837,+,11234
453,BUMA.1121.00067,2,302785,314021,-,11236
453,BUMA.1121.00035,2,951828,963063,-,11235
453,BUMA.1121.00005,2,221622,232857,-,11235
453,BUMA.1121.00100,2,1609969,1621206,+,11237
453,BUMA.1121.00016,2,98606,109834,-,11228
453,BUMA.1121.00099,2,637597,648839,+,11242
453,BUMA.1121.00094,2,494006,505252,+,11246
453,BUMA.1121.00093,2,2438532,2449768,-,11236
453,BUMA.1121.00097,2,292845,304079,+,11234
453,BUMA.1121.00018,2,205472,216707,-,11235
453,BUMA.1121.00110,2,363984,375225,+,11241
453,BUMA.1121.00079,2,495691,506931,+,11240
453,BUMA.1121.00075,2,2353822,2365053,-,11231
453,BUMA.1121.00066,2,492691,503918,+,11227
453,BUMA.1121.00089,2,495135,506376,+,11241
453,BUMA.1121.00057,2,1590112,1601354,-,11242
453,BUMA.1121.00090,2,1397448,1408682,+,11234
453,BUMA.1121.00027,2,1547063,1558293,+,11230
453,BUMA.1121.00062,2,1272359,1283595,-,11236
453,BUMA.1121.00091,2,3184767,3195986,-,11219
453,BUMA.1121.00098,2,704112,715339,+,11227
453,BUMA.1121.00092,2,495130,506365,+,11235
453,BUMA.1121.00031,2,2832947,2844181,+,11234
453,BUMA.1121.00096,2,657881,669117,+,11236
453,BUMA.1121.00073,2,485720,496957,+,11237
453,BUMA.1121.00103,2,2366194,2377431,+,11237
453,BUMA.1121.00084,2,2333970,2345206,+,11236
453,BUMA.1121.00014,2,500729,511963,+,11234
453,BUMA.1121.00111,2,2935052,2946286,+,11234
453,BUMA.1121.00007,2,507342,518620,+,11278
453,BUMA.1121.00072,2,485103,496330,+,11227
453,BUMA.1121.00071,2,486637,497863,+,11226
453,BUMA.1121.00077,2,3241368,3252606,-,11238
453,BUMA.1121.00003,2,1880976,1892209,+,11233
453,BUMA.1121.00104,2,602463,613677,+,11214
453,BUMA.1121.00074,2,524881,536117,-,11236
453,BUMA.1121.00060,2,1738393,1749636,-,11243
453,BUMA.1121.00088,2,446849,458083,+,11234
453,BUMA.1121.00053,2,724605,735825,+,11220
453,BUMA.1121.00025,2,2116321,2127555,+,11234
453,BUMA.1121.00070,2,485722,496959,+,11237
453,BUMA.1121.00049,2,2305492,2316728,+,11236
453,BUMA.1121.00078,2,2721154,2732385,-,11231
453,BUMA.1121.00069,2,485190,496416,+,11226
453,BUMA.1121.00102,2,498655,509872,+,11217
453,BUMA.1121.00112,2,651186,662417,-,11231
453,BUMA.1121.00041,2,1385829,1397050,+,11221
453,BUMA.1121.00068,2,2206026,2217268,+,11242
453,BUMA.1121.00076,2,1380640,1391870,+,11230
453,BUMA.1121.00033,2,1170762,1181995,+,11233
453,BUMA.1121.00101,2,2953863,2965104,-,11241
453,BUMA.1121.00105,2,2003679,2014922,-,11243
453,BUMA.1121.00061,2,476490,487727,+,11237
453,BUMA.1121.00063,2,485794,497031,+,11237
453,BUMA.1121.00059,2,3149524,3160760,-,11236
453,BUMA.1121.00058,2,1057998,1069233,+,11235
453,BUMA.1121.00043,2,1937244,1948474,-,11230
453,BUMA.1121.00055,2,2133904,2145138,-,11234
453,BUMA.1121.00065,2,497259,508507,+,11248
453,BUMA.1121.00064,2,421769,433004,+,11235
453,BUMA.1121.00047,2,1425867,1437108,+,11241
453,BUMA.1121.00037,2,774068,785302,+,11234
453,BUMA.1121.00106,2,2911756,2922975,+,11219
453,BUMA.1121.00051,2,495390,506631,+,11241
453,BUMA.1121.00045,2,344189,355431,+,11242
453,BUMA.1121.00056,2,385467,396709,-,11242
453,BUMA.1121.00095,2,2553553,2564788,+,11235
453,BUMA.1121.00082,2,495375,506612,+,11237
453,BUMA.1121.00001,2,1756342,1767577,-,11235
453,BUMA.1121.00108,2,735975,747207,+,11232
453,BUMA.1121.00109,1,545307,556549,-,11242
453,BUMA.1121.00083,2,2292332,2303569,+,11237
453,BUMA.1121.00080,2,495412,506653,+,11241
453,BUMA.1121.00012,2,1318039,1329267,-,11228
454,BUMA.1121.00011,2,2328019,2339337,+,11318
454,BUMA.1121.00009,2,2358106,2369420,+,11314
454,BUMA.1121.00039,2,285872,297188,-,11316
454,BUMA.1121.00029,2,854570,865886,-,11316
454,BUMA.1121.00021,2,969292,980609,+,11317
454,BUMA.1121.00107,2,143868,155185,-,11317
454,BUMA.1121.00023,2,561896,573213,+,11317
454,BUMA.1121.00067,2,290409,301726,-,11317
454,BUMA.1121.00035,2,939453,950769,-,11316
454,BUMA.1121.00005,2,209253,220563,-,11310
454,BUMA.1121.00100,2,1622266,1633584,+,11318
454,BUMA.1121.00016,2,86230,97547,-,11317
454,BUMA.1121.00099,2,649898,661209,+,11311
454,BUMA.1121.00094,2,506311,517621,+,11310
454,BUMA.1121.00093,2,2426156,2437473,-,11317
454,BUMA.1121.00097,2,305138,316446,+,11308
454,BUMA.1121.00018,2,193097,204413,-,11316
454,BUMA.1121.00110,2,376284,387602,+,11318
454,BUMA.1121.00079,2,507990,519301,+,11311
454,BUMA.1121.00075,2,2341447,2352763,-,11316
454,BUMA.1121.00066,2,504977,516288,+,11311
454,BUMA.1121.00089,2,507435,518753,+,11318
454,BUMA.1121.00057,2,1577736,1589053,-,11317
454,BUMA.1121.00090,2,1409741,1421058,+,11317
454,BUMA.1121.00027,2,1559352,1570668,+,11316
454,BUMA.1121.00062,2,1259983,1271300,-,11317
454,BUMA.1121.00091,2,3172391,3183708,-,11317
454,BUMA.1121.00098,2,716398,727716,+,11318
454,BUMA.1121.00092,2,507424,518742,+,11318
454,BUMA.1121.00031,2,2845240,2856557,+,11317
454,BUMA.1121.00096,2,670176,681488,+,11312
454,BUMA.1121.00073,2,498016,509334,+,11318
454,BUMA.1121.00103,2,2378490,2389807,+,11317
454,BUMA.1121.00084,2,2346265,2357577,+,11312
454,BUMA.1121.00014,2,513022,524339,+,11317
454,BUMA.1121.00111,2,2947345,2958663,+,11318
454,BUMA.1121.00007,2,519679,530990,+,11311
454,BUMA.1121.00072,2,497389,508707,+,11318
454,BUMA.1121.00071,2,498922,510233,+,11311
454,BUMA.1121.00077,2,3228994,3240309,-,11315
454,BUMA.1121.00003,2,1893269,1904598,+,11329
454,BUMA.1121.00104,2,614736,626054,+,11318
454,BUMA.1121.00074,2,512512,523822,-,11310
454,BUMA.1121.00060,2,1726018,1737334,-,11316
454,BUMA.1121.00088,2,459142,470459,+,11317
454,BUMA.1121.00053,2,736884,748202,+,11318
454,BUMA.1121.00025,2,2128614,2139931,+,11317
454,BUMA.1121.00070,2,498018,509336,+,11318
454,BUMA.1121.00049,2,2317787,2329105,+,11318
454,BUMA.1121.00078,2,2708769,2720095,-,11326
454,BUMA.1121.00069,2,497475,508793,+,11318
454,BUMA.1121.00102,2,510931,522258,+,11327
454,BUMA.1121.00112,2,638810,650127,-,11317
454,BUMA.1121.00041,2,1398109,1409427,+,11318
454,BUMA.1121.00068,2,2218328,2229646,+,11318
454,BUMA.1121.00076,2,1392929,1404246,+,11317
454,BUMA.1121.00033,2,1183054,1194369,+,11315
454,BUMA.1121.00101,2,2941489,2952804,-,11315
454,BUMA.1121.00105,2,1991303,2002620,-,11317
454,BUMA.1121.00061,2,488786,500104,+,11318
454,BUMA.1121.00063,2,498090,509408,+,11318
454,BUMA.1121.00059,2,3137148,3148465,-,11317
454,BUMA.1121.00058,2,1070292,1081610,+,11318
454,BUMA.1121.00043,2,1924868,1936185,-,11317
454,BUMA.1121.00055,2,2121528,2132845,-,11317
454,BUMA.1121.00065,2,509566,520883,+,11317
454,BUMA.1121.00064,2,434063,445381,+,11318
454,BUMA.1121.00047,2,1438167,1449479,+,11312
454,BUMA.1121.00037,2,786361,797678,+,11317
454,BUMA.1121.00106,2,2924034,2935352,+,11318
454,BUMA.1121.00051,2,507690,519001,+,11311
454,BUMA.1121.00045,2,356490,367807,+,11317
454,BUMA.1121.00056,2,373091,384408,-,11317
454,BUMA.1121.00095,2,2565847,2577165,+,11318
454,BUMA.1121.00082,2,507671,518989,+,11318
454,BUMA.1121.00001,2,1743967,1755283,-,11316
454,BUMA.1121.00108,2,748266,759578,+,11312
454,BUMA.1121.00109,1,532932,544248,-,11316
454,BUMA.1121.00083,2,2304628,2315946,+,11318
454,BUMA.1121.00080,2,507712,519024,+,11312
454,BUMA.1121.00012,2,1305665,1316980,-,11315
455,BUMA.1121.00011,2,2350834,2354524,+,3690
455,BUMA.1121.00009,2,2380457,2384147,+,3690
455,BUMA.1121.00092,1,2373461,2377151,-,3690
455,BUMA.1121.00093,1,2249168,2252858,+,3690
455,BUMA.1121.00096,2,2079330,2083020,-,3690
455,BUMA.1121.00007,1,2613540,2617230,-,3690
455,BUMA.1121.00101,2,2925601,2929291,-,3690
455,BUMA.1121.00084,1,1776353,1780043,+,3690
455,BUMA.1121.00098,1,37626,41316,+,3690
455,BUMA.1121.00097,1,2507783,2511473,-,3690
456,BUMA.1121.00011,2,2396504,2399643,+,3139
456,BUMA.1121.00009,2,2426946,2430085,+,3139
457,BUMA.1121.00011,2,2420873,2441642,+,20769
457,BUMA.1121.00009,2,2442278,2463046,+,20768
457,BUMA.1121.00039,2,258819,279587,-,20768
457,BUMA.1121.00029,2,817676,838444,-,20768
457,BUMA.1121.00021,2,1003747,1024528,+,20781
457,BUMA.1121.00107,2,111267,132035,-,20768
457,BUMA.1121.00023,2,580683,601451,+,20768
457,BUMA.1121.00067,2,257630,278397,-,20767
457,BUMA.1121.00035,2,900211,920979,-,20768
457,BUMA.1121.00005,2,168543,189310,-,20767
457,BUMA.1121.00100,2,1648559,1669328,+,20769
457,BUMA.1121.00016,2,31647,52414,-,20767
457,BUMA.1121.00099,2,746672,767441,+,20769
457,BUMA.1121.00094,2,586164,606932,+,20768
457,BUMA.1121.00093,2,2369579,2390346,-,20767
457,BUMA.1121.00097,2,338778,359547,+,20769
457,BUMA.1121.00109,2,848831,869598,-,20767
457,BUMA.1121.00018,2,165488,186256,-,20768
457,BUMA.1121.00110,2,419031,439799,+,20768
457,BUMA.1121.00079,2,542794,563562,+,20768
457,BUMA.1121.00075,2,2297434,2318202,-,20768
457,BUMA.1121.00066,2,527273,548042,+,20769
457,BUMA.1121.00089,2,530885,551653,+,20768
457,BUMA.1121.00057,2,1526155,1546923,-,20768
457,BUMA.1121.00090,2,1440130,1460899,+,20769
457,BUMA.1121.00027,2,1601469,1622237,+,20768
457,BUMA.1121.00062,2,1218352,1239120,-,20768
457,BUMA.1121.00091,2,3119750,3140518,-,20768
457,BUMA.1121.00098,2,743424,764193,+,20769
457,BUMA.1121.00092,2,554552,575320,+,20768
457,BUMA.1121.00031,2,2907458,2928227,+,20769
457,BUMA.1121.00096,2,703984,724752,+,20768
457,BUMA.1121.00073,2,521644,542413,+,20769
457,BUMA.1121.00103,2,2401639,2422408,+,20769
457,BUMA.1121.00084,2,2369709,2390478,+,20769
457,BUMA.1121.00014,2,575092,595869,+,20777
457,BUMA.1121.00111,2,2972624,2993393,+,20769
457,BUMA.1121.00007,2,584672,605441,+,20769
457,BUMA.1121.00072,2,518039,538808,+,20769
457,BUMA.1121.00071,2,521083,541852,+,20769
457,BUMA.1121.00077,2,3176799,3197566,-,20767
457,BUMA.1121.00003,2,1917633,1938379,+,20746
457,BUMA.1121.00104,2,638188,658957,+,20769
457,BUMA.1121.00074,2,436836,457603,-,20767
457,BUMA.1121.00060,2,1693435,1714203,-,20768
457,BUMA.1121.00088,2,486405,507173,+,20768
457,BUMA.1121.00053,2,773820,794589,+,20769
457,BUMA.1121.00025,2,2146771,2167540,+,20769
457,BUMA.1121.00070,2,521735,542504,+,20769
457,BUMA.1121.00049,2,2356259,2377028,+,20769
457,BUMA.1121.00078,2,2662379,2683147,-,20768
457,BUMA.1121.00069,2,519586,540355,+,20769
457,BUMA.1121.00102,2,536663,557432,+,20769
457,BUMA.1121.00112,2,606229,626996,-,20767
457,BUMA.1121.00041,2,1450386,1471147,+,20761
457,BUMA.1121.00068,2,2249242,2270010,+,20768
457,BUMA.1121.00076,2,1427490,1448259,+,20769
457,BUMA.1121.00033,2,1221386,1242151,+,20765
457,BUMA.1121.00101,2,2845725,2866492,-,20767
457,BUMA.1121.00105,2,1958718,1979485,-,20767
457,BUMA.1121.00061,2,511562,532331,+,20769
457,BUMA.1121.00063,2,520958,541727,+,20769
457,BUMA.1121.00059,2,3095284,3116051,-,20767
457,BUMA.1121.00058,2,1093424,1114193,+,20769
457,BUMA.1121.00043,2,1862746,1883513,-,20767
457,BUMA.1121.00055,2,2090142,2110896,-,20754
457,BUMA.1121.00065,2,534578,555347,+,20769
457,BUMA.1121.00064,2,457411,478179,+,20768
457,BUMA.1121.00047,2,1472944,1493712,+,20768
457,BUMA.1121.00037,2,847506,868274,+,20768
457,BUMA.1121.00106,2,2947486,2968255,+,20769
457,BUMA.1121.00051,2,542473,563241,+,20768
457,BUMA.1121.00045,2,379621,400390,+,20769
457,BUMA.1121.00056,2,340191,360958,-,20767
457,BUMA.1121.00095,2,2588442,2609211,+,20769
457,BUMA.1121.00082,2,549799,570568,+,20769
457,BUMA.1121.00001,2,1702430,1723198,-,20768
457,BUMA.1121.00108,2,771431,792199,+,20768
457,BUMA.1121.00083,2,2346756,2367525,+,20769
457,BUMA.1121.00080,2,543708,564476,+,20768
457,BUMA.1121.00012,2,1202525,1223293,-,20768
458,BUMA.1121.00011,2,2462079,2473299,+,11220
458,BUMA.1121.00009,2,2483490,2494656,+,11166
458,BUMA.1121.00039,2,227094,238382,-,11288
458,BUMA.1121.00029,2,785904,797239,-,11335
458,BUMA.1121.00021,2,1044965,1056280,+,11315
458,BUMA.1121.00107,2,79554,90841,-,11287
458,BUMA.1121.00023,2,621888,633236,+,11348
458,BUMA.1121.00067,2,225900,237182,-,11282
458,BUMA.1121.00035,2,868459,879774,-,11315
458,BUMA.1121.00005,2,136923,148105,-,11182
458,BUMA.1121.00100,2,1689772,1700965,+,11193
458,BUMA.1121.00016,2,1,11221,-,11220
458,BUMA.1121.00099,2,787884,799154,+,11270
458,BUMA.1121.00094,2,627370,638521,+,11151
458,BUMA.1121.00093,2,2337958,2349150,-,11192
458,BUMA.1121.00097,2,379991,391214,+,11223
458,BUMA.1121.00109,2,817119,828397,-,11278
458,BUMA.1121.00018,2,133688,145056,-,11368
458,BUMA.1121.00110,2,460227,471404,+,11177
458,BUMA.1121.00079,2,583998,595230,+,11232
458,BUMA.1121.00075,2,2265717,2276995,-,11278
458,BUMA.1121.00066,2,568480,579731,+,11251
458,BUMA.1121.00089,2,572091,583242,+,11151
458,BUMA.1121.00057,2,1494559,1505711,-,11152
458,BUMA.1121.00090,2,1481336,1492643,+,11307
458,BUMA.1121.00027,2,1642681,1653832,+,11151
458,BUMA.1121.00062,2,1186676,1197914,-,11238
458,BUMA.1121.00091,2,3088092,3099312,-,11220
458,BUMA.1121.00098,2,784631,795906,+,11275
458,BUMA.1121.00092,2,595749,606940,+,11191
458,BUMA.1121.00031,2,2948664,2959981,+,11317
458,BUMA.1121.00096,2,745194,756497,+,11303
458,BUMA.1121.00073,2,562851,574102,+,11251
458,BUMA.1121.00103,2,2442846,2454100,+,11254
458,BUMA.1121.00084,2,2410916,2422104,+,11188
458,BUMA.1121.00014,2,616306,627613,+,11307
458,BUMA.1121.00111,2,3013848,3025165,+,11317
458,BUMA.1121.00007,2,625840,637111,+,11271
458,BUMA.1121.00072,2,559245,570496,+,11251
458,BUMA.1121.00071,2,562290,573493,+,11203
458,BUMA.1121.00077,2,3145194,3156371,-,11177
458,BUMA.1121.00003,2,1958814,1970104,+,11290
458,BUMA.1121.00104,2,678105,689345,+,11240
458,BUMA.1121.00074,2,405214,416388,-,11174
458,BUMA.1121.00060,2,1661752,1673000,-,11248
458,BUMA.1121.00088,2,527611,538931,+,11320
458,BUMA.1121.00053,2,815027,826345,+,11318
458,BUMA.1121.00025,2,2187972,2199339,+,11367
458,BUMA.1121.00070,2,562942,574193,+,11251
458,BUMA.1121.00049,2,2397471,2408658,+,11187
458,BUMA.1121.00078,2,2630769,2641936,-,11167
458,BUMA.1121.00069,2,560793,572044,+,11251
458,BUMA.1121.00102,2,577870,589101,+,11231
458,BUMA.1121.00112,2,574546,585792,-,11246
458,BUMA.1121.00041,2,1471391,1482642,+,11251
458,BUMA.1121.00068,2,2290448,2301790,+,11342
458,BUMA.1121.00076,2,1468698,1479976,+,11278
458,BUMA.1121.00033,2,1262582,1273853,+,11271
458,BUMA.1121.00101,2,2814036,2825290,-,11254
458,BUMA.1121.00105,2,1927106,1938280,-,11174
458,BUMA.1121.00061,2,552769,564019,+,11250
458,BUMA.1121.00063,2,562165,573416,+,11251
458,BUMA.1121.00059,2,3063688,3074840,-,11152
458,BUMA.1121.00058,2,1134643,1145826,+,11183
458,BUMA.1121.00043,2,1831044,1842315,-,11271
458,BUMA.1121.00055,2,2078680,2089914,-,11234
458,BUMA.1121.00065,2,575785,587130,+,11345
458,BUMA.1121.00064,2,498627,509800,+,11173
458,BUMA.1121.00047,2,1514150,1525301,+,11151
458,BUMA.1121.00037,2,888712,900009,+,11297
458,BUMA.1121.00106,2,2988694,2999872,+,11178
458,BUMA.1121.00051,2,583677,594828,+,11151
458,BUMA.1121.00045,2,420825,432072,+,11247
458,BUMA.1121.00056,2,308601,319753,-,11152
458,BUMA.1121.00095,2,2629655,2640858,+,11203
458,BUMA.1121.00082,2,591006,602257,+,11251
458,BUMA.1121.00001,2,1670648,1681993,-,11345
458,BUMA.1121.00108,2,812637,823793,+,11156
458,BUMA.1121.00083,2,2387963,2399214,+,11251
458,BUMA.1121.00080,2,584914,596073,+,11159
458,BUMA.1121.00012,2,1170750,1182088,-,11338
459,BUMA.1121.00011,2,2476444,2480226,+,3782
459,BUMA.1121.00009,2,2497778,2501537,+,3759
459,BUMA.1121.00039,2,220185,223950,-,3765
459,BUMA.1121.00029,2,779006,782759,-,3753
459,BUMA.1121.00021,2,1059425,1063191,+,3766
459,BUMA.1121.00107,2,72654,76416,-,3762
459,BUMA.1121.00023,2,636381,640147,+,3766
459,BUMA.1121.00067,2,218985,222751,-,3766
459,BUMA.1121.00035,2,861561,865314,-,3753
459,BUMA.1121.00005,2,130021,133783,-,3762
459,BUMA.1121.00100,2,1704115,1707825,+,3710
459,BUMA.1121.00016,2,3236270,3240035,-,3765
459,BUMA.1121.00099,2,802303,806042,+,3739
459,BUMA.1121.00094,2,641666,645445,+,3779
459,BUMA.1121.00093,2,2331031,2334814,-,3783
459,BUMA.1121.00097,2,394363,398136,+,3773
459,BUMA.1121.00109,2,810218,813968,-,3750
459,BUMA.1121.00018,2,126778,130543,-,3765
459,BUMA.1121.00110,2,474555,478321,+,3766
459,BUMA.1121.00079,2,598377,602156,+,3779
459,BUMA.1121.00075,2,2258774,2262573,-,3799
459,BUMA.1121.00066,2,582725,586459,+,3734
459,BUMA.1121.00089,2,586387,590166,+,3779
459,BUMA.1121.00057,2,1487682,1491415,-,3733
459,BUMA.1121.00090,2,1495788,1499554,+,3766
459,BUMA.1121.00027,2,1656976,1660710,+,3734
459,BUMA.1121.00062,2,1179780,1183531,-,3751
459,BUMA.1121.00091,2,3081199,3084947,-,3748
459,BUMA.1121.00098,2,799054,802827,+,3773
459,BUMA.1121.00092,2,610084,613868,+,3784
459,BUMA.1121.00031,2,2963126,2966892,+,3766
459,BUMA.1121.00096,2,759635,763392,+,3757
459,BUMA.1121.00073,2,577097,580831,+,3734
459,BUMA.1121.00103,2,2457248,2460987,+,3739
459,BUMA.1121.00084,2,2425248,2429015,+,3767
459,BUMA.1121.00014,2,630758,634524,+,3766
459,BUMA.1121.00111,2,3028301,3032076,+,3775
459,BUMA.1121.00007,2,640217,643999,+,3782
459,BUMA.1121.00072,2,573490,577224,+,3734
459,BUMA.1121.00071,2,576488,580222,+,3734
459,BUMA.1121.00077,2,3138278,3142043,-,3765
459,BUMA.1121.00003,2,1973242,1976979,+,3737
459,BUMA.1121.00104,2,692485,696252,+,3767
459,BUMA.1121.00074,2,398290,402065,-,3775
459,BUMA.1121.00060,2,1654842,1658621,-,3779
459,BUMA.1121.00088,2,542075,545842,+,3767
459,BUMA.1121.00053,2,829490,833256,+,3766
459,BUMA.1121.00025,2,2202484,2206250,+,3766
459,BUMA.1121.00070,2,577188,580922,+,3734
459,BUMA.1121.00049,2,2411803,2415551,+,3748
459,BUMA.1121.00078,2,2623841,2627624,-,3783
459,BUMA.1121.00069,2,575039,578773,+,3734
459,BUMA.1121.00102,2,592250,596007,+,3757
459,BUMA.1121.00112,2,567666,571410,-,3744
459,BUMA.1121.00041,2,1485790,1489544,+,3754
459,BUMA.1121.00068,2,2304934,2308691,+,3757
459,BUMA.1121.00076,2,1483120,1486920,+,3800
459,BUMA.1121.00033,2,1276998,1280764,+,3766
459,BUMA.1121.00101,2,2807127,2810892,-,3765
459,BUMA.1121.00105,2,1920195,1923961,-,3766
459,BUMA.1121.00061,2,567014,570748,+,3734
459,BUMA.1121.00063,2,576410,580144,+,3734
459,BUMA.1121.00059,2,3056793,3060544,-,3751
459,BUMA.1121.00058,2,1148970,1152770,+,3800
459,BUMA.1121.00043,2,1824134,1827899,-,3765
459,BUMA.1121.00055,2,2071784,2075540,-,3756
459,BUMA.1121.00065,2,590275,594041,+,3766
459,BUMA.1121.00064,2,512949,516725,+,3776
459,BUMA.1121.00047,2,1528446,1532225,+,3779
459,BUMA.1121.00037,2,903154,906920,+,3766
459,BUMA.1121.00106,2,3003016,3006783,+,3767
459,BUMA.1121.00051,2,597973,601752,+,3779
459,BUMA.1121.00045,2,435203,438983,+,3780
459,BUMA.1121.00056,2,301678,305456,-,3778
459,BUMA.1121.00095,2,2643995,2647759,+,3764
459,BUMA.1121.00082,2,605252,608986,+,3734
459,BUMA.1121.00001,2,1663738,1667503,-,3765
459,BUMA.1121.00108,2,826921,830695,+,3774
459,BUMA.1121.00083,2,2402209,2405943,+,3734
459,BUMA.1121.00080,2,599218,602997,+,3779
459,BUMA.1121.00012,2,1163871,1167605,-,3734
460,BUMA.1121.00011,2,2480227,2504780,+,24553
460,BUMA.1121.00009,2,2501538,2526205,+,24667
460,BUMA.1121.00039,2,195581,220183,-,24602
460,BUMA.1121.00029,2,754385,779004,-,24619
460,BUMA.1121.00021,2,1063192,1087753,+,24561
460,BUMA.1121.00107,2,48113,72652,-,24539
460,BUMA.1121.00023,2,640148,664767,+,24619
460,BUMA.1121.00067,2,194407,218983,-,24576
460,BUMA.1121.00035,2,836977,861559,-,24582
460,BUMA.1121.00005,2,105386,130019,-,24633
460,BUMA.1121.00100,2,1707826,1732367,+,24541
460,BUMA.1121.00016,2,3211659,3236268,-,24609
460,BUMA.1121.00099,2,806043,830740,+,24697
460,BUMA.1121.00094,2,645446,670048,+,24602
460,BUMA.1121.00093,2,2306458,2331029,-,24571
460,BUMA.1121.00097,2,398137,422621,+,24484
460,BUMA.1121.00109,2,785651,810216,-,24565
460,BUMA.1121.00018,2,102141,126776,-,24635
460,BUMA.1121.00110,2,478322,502867,+,24545
460,BUMA.1121.00079,2,602157,626792,+,24635
460,BUMA.1121.00075,2,2234194,2258772,-,24578
460,BUMA.1121.00066,2,586460,611063,+,24603
460,BUMA.1121.00089,2,590167,614727,+,24560
460,BUMA.1121.00057,2,1463125,1487680,-,24555
460,BUMA.1121.00090,2,1499555,1524168,+,24613
460,BUMA.1121.00027,2,1660711,1685293,+,24582
460,BUMA.1121.00062,2,1155209,1179778,-,24569
460,BUMA.1121.00091,2,3056631,3081197,-,24566
460,BUMA.1121.00098,2,802828,827226,+,24398
460,BUMA.1121.00092,2,613869,638440,+,24571
460,BUMA.1121.00031,2,2966893,2991445,+,24552
460,BUMA.1121.00096,2,763393,787906,+,24513
460,BUMA.1121.00073,2,580832,605410,+,24578
460,BUMA.1121.00103,2,2460988,2485542,+,24554
460,BUMA.1121.00084,2,2429016,2453609,+,24593
460,BUMA.1121.00014,2,634525,659070,+,24545
460,BUMA.1121.00111,2,3032077,3056702,+,24625
460,BUMA.1121.00007,2,644000,668493,+,24493
460,BUMA.1121.00072,2,577225,601826,+,24601
460,BUMA.1121.00071,2,580223,604820,+,24597
460,BUMA.1121.00077,2,3113733,3138276,-,24543
460,BUMA.1121.00003,2,1976980,2001447,+,24467
460,BUMA.1121.00104,2,696253,720817,+,24564
460,BUMA.1121.00074,2,373777,398288,-,24511
460,BUMA.1121.00060,2,1630319,1654840,-,24521
460,BUMA.1121.00088,2,545843,570438,+,24595
460,BUMA.1121.00053,2,833257,857845,+,24588
460,BUMA.1121.00025,2,2206251,2230886,+,24635
460,BUMA.1121.00070,2,580923,605507,+,24584
460,BUMA.1121.00049,2,2415552,2440140,+,24588
460,BUMA.1121.00078,2,2599231,2623839,-,24608
460,BUMA.1121.00069,2,578774,603360,+,24586
460,BUMA.1121.00102,2,596008,620657,+,24649
460,BUMA.1121.00112,2,543070,567664,-,24594
460,BUMA.1121.00041,2,1489545,1514134,+,24589
460,BUMA.1121.00068,2,2308692,2333295,+,24603
460,BUMA.1121.00076,2,1486921,1511512,+,24591
460,BUMA.1121.00033,2,1280765,1305407,+,24642
460,BUMA.1121.00101,2,2782563,2807125,-,24562
460,BUMA.1121.00105,2,1895547,1920193,-,24646
460,BUMA.1121.00061,2,570749,595348,+,24599
460,BUMA.1121.00063,2,580145,604737,+,24592
460,BUMA.1121.00059,2,3032379,3056791,-,24412
460,BUMA.1121.00058,2,1152771,1177324,+,24553
460,BUMA.1121.00043,2,1799404,1824132,-,24728
460,BUMA.1121.00055,2,2047290,2071782,-,24492
460,BUMA.1121.00065,2,594042,618569,+,24527
460,BUMA.1121.00064,2,516726,541350,+,24624
460,BUMA.1121.00047,2,1532226,1556801,+,24575
460,BUMA.1121.00037,2,906921,931519,+,24598
460,BUMA.1121.00106,2,3006784,3031369,+,24585
460,BUMA.1121.00051,2,601753,626338,+,24585
460,BUMA.1121.00045,2,438984,463505,+,24521
460,BUMA.1121.00056,2,277116,301676,-,24560
460,BUMA.1121.00095,2,2647760,2672315,+,24555
460,BUMA.1121.00082,2,608987,633590,+,24603
460,BUMA.1121.00001,2,1639139,1663736,-,24597
460,BUMA.1121.00108,2,830696,855173,+,24477
460,BUMA.1121.00083,2,2405944,2430547,+,24603
460,BUMA.1121.00080,2,602998,627570,+,24572
460,BUMA.1121.00012,2,1138277,1162938,-,24661
461,BUMA.1121.00011,2,2512406,2517926,+,5520
461,BUMA.1121.00009,2,2533831,2539345,+,5514
461,BUMA.1121.00039,2,182470,187955,-,5485
461,BUMA.1121.00029,2,741240,746760,-,5520
461,BUMA.1121.00021,2,1095379,1100899,+,5520
461,BUMA.1121.00107,2,34980,40493,-,5513
461,BUMA.1121.00023,2,672393,677913,+,5520
461,BUMA.1121.00067,2,181257,186781,-,5524
461,BUMA.1121.00035,2,823831,829351,-,5520
461,BUMA.1121.00005,2,92232,97760,-,5528
461,BUMA.1121.00100,2,1739987,1745503,+,5516
461,BUMA.1121.00016,2,3198513,3204033,-,5520
461,BUMA.1121.00099,2,838366,843862,+,5496
461,BUMA.1121.00094,2,677674,683134,+,5460
461,BUMA.1121.00093,2,2293308,2298832,-,5524
461,BUMA.1121.00097,2,430241,435755,+,5514
461,BUMA.1121.00109,2,772481,778025,-,5544
461,BUMA.1121.00018,2,88995,94515,-,5520
461,BUMA.1121.00110,2,510493,516007,+,5514
461,BUMA.1121.00079,2,634418,639877,+,5459
461,BUMA.1121.00075,2,2221060,2226583,-,5523
461,BUMA.1121.00066,2,618683,624207,+,5524
461,BUMA.1121.00089,2,622353,627813,+,5460
461,BUMA.1121.00057,2,1449988,1455499,-,5511
461,BUMA.1121.00090,2,1531779,1537299,+,5520
461,BUMA.1121.00027,2,1692919,1698447,+,5528
461,BUMA.1121.00062,2,1142059,1147583,-,5524
461,BUMA.1121.00091,2,3043481,3049005,-,5524
461,BUMA.1121.00098,2,834846,840353,+,5507
461,BUMA.1121.00092,2,646066,651590,+,5524
461,BUMA.1121.00031,2,2999071,3004591,+,5520
461,BUMA.1121.00096,2,795526,801044,+,5518
461,BUMA.1121.00073,2,613036,618560,+,5524
461,BUMA.1121.00103,2,2493168,2498683,+,5515
461,BUMA.1121.00084,2,2461235,2466763,+,5528
461,BUMA.1121.00014,2,666696,672216,+,5520
461,BUMA.1121.00111,2,3064328,3069844,+,5516
461,BUMA.1121.00007,2,676119,681624,+,5505
461,BUMA.1121.00072,2,609449,614973,+,5524
461,BUMA.1121.00071,2,612446,617951,+,5505
461,BUMA.1121.00077,2,3100590,3106104,-,5514
461,BUMA.1121.00003,2,2009073,2014591,+,5518
461,BUMA.1121.00104,2,728437,733965,+,5528
461,BUMA.1121.00074,2,360627,366151,-,5524
461,BUMA.1121.00060,2,1617181,1622693,-,5512
461,BUMA.1121.00088,2,578064,583592,+,5528
461,BUMA.1121.00053,2,865456,870980,+,5524
461,BUMA.1121.00025,2,2238512,2244032,+,5520
461,BUMA.1121.00070,2,613133,618647,+,5514
461,BUMA.1121.00049,2,2447760,2453288,+,5528
461,BUMA.1121.00078,2,2586092,2591608,-,5516
461,BUMA.1121.00069,2,610986,616510,+,5524
461,BUMA.1121.00102,2,628277,633797,+,5520
461,BUMA.1121.00112,2,529939,535444,-,5505
461,BUMA.1121.00041,2,1521745,1527265,+,5520
461,BUMA.1121.00068,2,2340915,2346423,+,5508
461,BUMA.1121.00076,2,1519123,1524647,+,5524
461,BUMA.1121.00033,2,1313032,1318556,+,5524
461,BUMA.1121.00101,2,2769430,2774937,-,5507
461,BUMA.1121.00105,2,1882397,1887921,-,5524
461,BUMA.1121.00061,2,602974,608498,+,5524
461,BUMA.1121.00063,2,612363,617887,+,5524
461,BUMA.1121.00059,2,3019229,3024753,-,5524
461,BUMA.1121.00058,2,1184950,1190426,+,5476
461,BUMA.1121.00043,2,1786281,1791784,-,5503
461,BUMA.1121.00055,2,2034140,2039664,-,5524
461,BUMA.1121.00065,2,626180,631704,+,5524
461,BUMA.1121.00064,2,548976,554500,+,5524
461,BUMA.1121.00047,2,1564427,1569887,+,5460
461,BUMA.1121.00037,2,939145,944665,+,5520
461,BUMA.1121.00106,2,3038989,3044517,+,5528
461,BUMA.1121.00051,2,633964,639424,+,5460
461,BUMA.1121.00045,2,471131,476643,+,5512
461,BUMA.1121.00056,2,264030,269490,-,5460
461,BUMA.1121.00095,2,2679935,2685431,+,5496
461,BUMA.1121.00082,2,641216,646740,+,5524
461,BUMA.1121.00001,2,1625993,1631513,-,5520
461,BUMA.1121.00108,2,862799,868323,+,5524
461,BUMA.1121.00083,2,2438173,2443697,+,5524
461,BUMA.1121.00080,2,635196,640656,+,5460
461,BUMA.1121.00012,2,1125135,1130653,-,5518
462,BUMA.1121.00011,2,2519446,2536737,+,17291
462,BUMA.1121.00009,2,2540865,2558138,+,17273
462,BUMA.1121.00039,2,163671,180950,-,17279
462,BUMA.1121.00029,2,722426,739720,-,17294
462,BUMA.1121.00021,2,1102419,1119699,+,17280
462,BUMA.1121.00107,2,16188,33466,-,17278
462,BUMA.1121.00023,2,679433,696707,+,17274
462,BUMA.1121.00067,2,162458,179737,-,17279
462,BUMA.1121.00035,2,805014,822311,-,17297
462,BUMA.1121.00005,2,73445,90712,-,17267
462,BUMA.1121.00100,2,1747036,1764292,+,17256
462,BUMA.1121.00016,2,3179711,3196993,-,17282
462,BUMA.1121.00099,2,845383,862656,+,17273
462,BUMA.1121.00094,2,684655,701908,+,17253
462,BUMA.1121.00093,2,2274568,2291788,-,17220
462,BUMA.1121.00097,2,437270,454533,+,17263
462,BUMA.1121.00109,2,753689,770961,-,17272
462,BUMA.1121.00018,2,70196,87475,-,17279
462,BUMA.1121.00110,2,517528,534800,+,17272
462,BUMA.1121.00079,2,641397,658683,+,17286
462,BUMA.1121.00075,2,2202272,2219540,-,17268
462,BUMA.1121.00066,2,625727,642987,+,17260
462,BUMA.1121.00089,2,629334,646587,+,17253
462,BUMA.1121.00057,2,1431226,1448468,-,17242
462,BUMA.1121.00090,2,1538819,1556099,+,17280
462,BUMA.1121.00027,2,1699967,1717207,+,17240
462,BUMA.1121.00062,2,1123260,1140539,-,17279
462,BUMA.1121.00091,2,3024696,3041961,-,17265
462,BUMA.1121.00098,2,841874,859146,+,17272
462,BUMA.1121.00092,2,653110,670330,+,17220
462,BUMA.1121.00031,2,3006111,3023386,+,17275
462,BUMA.1121.00096,2,802564,819839,+,17275
462,BUMA.1121.00073,2,620080,637346,+,17266
462,BUMA.1121.00103,2,2500203,2517435,+,17232
462,BUMA.1121.00084,2,2468283,2485535,+,17252
462,BUMA.1121.00014,2,673736,691011,+,17275
462,BUMA.1121.00111,2,3071364,3088644,+,17280
462,BUMA.1121.00007,2,683145,700405,+,17260
462,BUMA.1121.00072,2,616493,633754,+,17261
462,BUMA.1121.00071,2,619471,636732,+,17261
462,BUMA.1121.00077,2,3081798,3099070,-,17272
462,BUMA.1121.00003,2,2016112,2033350,+,17238
462,BUMA.1121.00104,2,735485,752777,+,17292
462,BUMA.1121.00074,2,341828,359107,-,17279
462,BUMA.1121.00060,2,1598425,1615661,-,17236
462,BUMA.1121.00088,2,585112,602370,+,17258
462,BUMA.1121.00053,2,872500,889767,+,17267
462,BUMA.1121.00025,2,2245552,2262832,+,17280
462,BUMA.1121.00070,2,620167,637428,+,17261
462,BUMA.1121.00049,2,2454808,2472088,+,17280
462,BUMA.1121.00078,2,2567311,2584572,-,17261
462,BUMA.1121.00069,2,618030,635291,+,17261
462,BUMA.1121.00102,2,635317,652575,+,17258
462,BUMA.1121.00112,2,511158,528419,-,17261
462,BUMA.1121.00041,2,1528785,1546028,+,17243
462,BUMA.1121.00068,2,2347943,2365220,+,17277
462,BUMA.1121.00076,2,1526167,1543436,+,17269
462,BUMA.1121.00033,2,1320076,1337355,+,17279
462,BUMA.1121.00101,2,2750677,2767914,-,17237
462,BUMA.1121.00105,2,1863613,1880877,-,17264
462,BUMA.1121.00061,2,610018,627284,+,17266
462,BUMA.1121.00063,2,619401,636673,+,17272
462,BUMA.1121.00059,2,3000461,3017709,-,17248
462,BUMA.1121.00058,2,1191946,1209219,+,17273
462,BUMA.1121.00043,2,1767477,1784761,-,17284
462,BUMA.1121.00055,2,2015352,2032620,-,17268
462,BUMA.1121.00065,2,633219,650498,+,17279
462,BUMA.1121.00064,2,556020,573299,+,17279
462,BUMA.1121.00047,2,1571408,1588694,+,17286
462,BUMA.1121.00037,2,946185,963475,+,17290
462,BUMA.1121.00106,2,3046037,3063300,+,17263
462,BUMA.1121.00051,2,640945,658222,+,17277
462,BUMA.1121.00045,2,478163,495399,+,17236
462,BUMA.1121.00056,2,245257,262510,-,17253
462,BUMA.1121.00095,2,2686951,2704217,+,17266
462,BUMA.1121.00082,2,648260,665526,+,17266
462,BUMA.1121.00001,2,1607176,1624473,-,17297
462,BUMA.1121.00108,2,869843,887111,+,17268
462,BUMA.1121.00083,2,2445217,2462483,+,17266
462,BUMA.1121.00080,2,642176,659460,+,17284
462,BUMA.1121.00012,2,1106356,1123615,-,17259
463,BUMA.1121.00011,2,2538980,2544155,+,5175
463,BUMA.1121.00009,2,2560337,2565523,+,5186
463,BUMA.1121.00039,2,156242,161426,-,5184
463,BUMA.1121.00029,2,714997,720181,-,5184
463,BUMA.1121.00021,2,1121945,1127129,+,5184
463,BUMA.1121.00107,2,8803,13989,-,5186
463,BUMA.1121.00023,2,698886,704070,+,5184
463,BUMA.1121.00067,2,155010,160202,-,5192
463,BUMA.1121.00035,2,797585,802769,-,5184
463,BUMA.1121.00005,2,66059,71245,-,5186
463,BUMA.1121.00100,2,1766490,1771746,+,5256
463,BUMA.1121.00016,2,3170928,3176112,-,5184
463,BUMA.1121.00099,2,864902,870088,+,5186
463,BUMA.1121.00094,2,704105,709291,+,5186
463,BUMA.1121.00093,2,2267171,2272357,-,5186
463,BUMA.1121.00097,2,456731,461917,+,5186
463,BUMA.1121.00109,2,746254,751493,-,5239
463,BUMA.1121.00018,2,62766,67951,-,5185
463,BUMA.1121.00110,2,537001,542185,+,5184
463,BUMA.1121.00079,2,660880,666064,+,5184
463,BUMA.1121.00075,2,2194831,2200074,-,5243
463,BUMA.1121.00066,2,645200,650386,+,5186
463,BUMA.1121.00089,2,648784,653970,+,5186
463,BUMA.1121.00057,2,1423772,1429014,-,5242
463,BUMA.1121.00090,2,1558344,1563528,+,5184
463,BUMA.1121.00027,2,1719420,1724661,+,5241
463,BUMA.1121.00062,2,1115761,1121004,-,5243
463,BUMA.1121.00091,2,3017309,3022496,-,5187
463,BUMA.1121.00098,2,861349,866535,+,5186
463,BUMA.1121.00092,2,672542,677728,+,5186
463,BUMA.1121.00031,2,3025631,3030815,+,5184
463,BUMA.1121.00096,2,822080,827272,+,5192
463,BUMA.1121.00073,2,639559,644736,+,5177
463,BUMA.1121.00103,2,2519696,2524882,+,5186
463,BUMA.1121.00084,2,2487730,2492916,+,5186
463,BUMA.1121.00014,2,693256,698440,+,5184
463,BUMA.1121.00111,2,3092514,3097698,+,5184
463,BUMA.1121.00007,2,702649,707834,+,5185
463,BUMA.1121.00072,2,635966,641152,+,5186
463,BUMA.1121.00071,2,638945,644120,+,5175
463,BUMA.1121.00077,2,3074414,3079598,-,5184
463,BUMA.1121.00003,2,2035603,2040788,+,5185
463,BUMA.1121.00104,2,754975,760224,+,5249
463,BUMA.1121.00074,2,334380,339572,-,5192
463,BUMA.1121.00060,2,1590980,1596166,-,5186
463,BUMA.1121.00088,2,604565,609751,+,5186
463,BUMA.1121.00053,2,891967,897153,+,5186
463,BUMA.1121.00025,2,2265077,2270262,+,5185
463,BUMA.1121.00070,2,639641,644820,+,5179
463,BUMA.1121.00049,2,2474284,2479470,+,5186
463,BUMA.1121.00078,2,2559926,2565112,-,5186
463,BUMA.1121.00069,2,637504,642677,+,5173
463,BUMA.1121.00102,2,654773,659959,+,5186
463,BUMA.1121.00112,2,503715,508899,-,5184
463,BUMA.1121.00041,2,1548240,1553426,+,5186
463,BUMA.1121.00068,2,2367434,2372618,+,5184
463,BUMA.1121.00076,2,1545634,1550877,+,5243
463,BUMA.1121.00033,2,1340953,1346137,+,5184
463,BUMA.1121.00101,2,2743215,2748412,-,5197
463,BUMA.1121.00105,2,1856215,1861401,-,5186
463,BUMA.1121.00061,2,629497,634676,+,5179
463,BUMA.1121.00063,2,638884,644070,+,5186
463,BUMA.1121.00059,2,2993013,2998216,-,5203
463,BUMA.1121.00058,2,1211417,1216654,+,5237
463,BUMA.1121.00043,2,1760082,1765265,-,5183
463,BUMA.1121.00055,2,2007980,2013142,-,5162
463,BUMA.1121.00065,2,652711,657897,+,5186
463,BUMA.1121.00064,2,575556,580748,+,5192
463,BUMA.1121.00047,2,1590891,1596077,+,5186
463,BUMA.1121.00037,2,965720,970904,+,5184
463,BUMA.1121.00106,2,3065498,3070684,+,5186
463,BUMA.1121.00051,2,660419,665605,+,5186
463,BUMA.1121.00045,2,497659,502845,+,5186
463,BUMA.1121.00056,2,237874,243060,-,5186
463,BUMA.1121.00095,2,2706475,2711660,+,5185
463,BUMA.1121.00082,2,667739,672925,+,5186
463,BUMA.1121.00001,2,1599748,1604932,-,5184
463,BUMA.1121.00108,2,889310,894496,+,5186
463,BUMA.1121.00083,2,2464696,2469882,+,5186
463,BUMA.1121.00080,2,661657,666843,+,5186
463,BUMA.1121.00012,2,1099008,1104192,-,5184
464,BUMA.1121.00011,2,2544391,2552483,+,8092
464,BUMA.1121.00009,2,2565759,2573851,+,8092
464,BUMA.1121.00039,2,147913,156005,-,8092
464,BUMA.1121.00029,2,706668,714760,-,8092
464,BUMA.1121.00021,2,1127365,1135458,+,8093
464,BUMA.1121.00107,2,475,8566,-,8091
464,BUMA.1121.00023,2,704306,712399,+,8093
464,BUMA.1121.00067,2,146682,154773,-,8091
464,BUMA.1121.00035,2,754005,762113,-,8108
464,BUMA.1121.00005,2,57731,65822,-,8091
464,BUMA.1121.00100,2,1771982,1780074,+,8092
464,BUMA.1121.00016,2,3162600,3170691,-,8091
464,BUMA.1121.00099,2,870324,878426,+,8102
464,BUMA.1121.00094,2,709527,717620,+,8093
464,BUMA.1121.00093,2,2258847,2266934,-,8087
464,BUMA.1121.00097,2,462153,470226,+,8073
464,BUMA.1121.00109,2,737926,746017,-,8091
464,BUMA.1121.00018,2,54437,62529,-,8092
464,BUMA.1121.00110,2,542421,550523,+,8102
464,BUMA.1121.00079,2,666300,674393,+,8093
464,BUMA.1121.00075,2,2186500,2194594,-,8094
464,BUMA.1121.00066,2,650622,658714,+,8092
464,BUMA.1121.00089,2,654206,662299,+,8093
464,BUMA.1121.00057,2,1415452,1423535,-,8083
464,BUMA.1121.00090,2,1599016,1607108,+,8092
464,BUMA.1121.00027,2,1724897,1732981,+,8084
464,BUMA.1121.00062,2,1107433,1115524,-,8091
464,BUMA.1121.00091,2,3008980,3017072,-,8092
464,BUMA.1121.00098,2,866771,874864,+,8093
464,BUMA.1121.00092,2,677964,686052,+,8088
464,BUMA.1121.00031,2,3066302,3074395,+,8093
464,BUMA.1121.00096,2,827508,835601,+,8093
464,BUMA.1121.00073,2,644972,653064,+,8092
464,BUMA.1121.00103,2,2525118,2533218,+,8100
464,BUMA.1121.00084,2,2493152,2501244,+,8092
464,BUMA.1121.00014,2,733927,742020,+,8093
464,BUMA.1121.00111,2,3097934,3106027,+,8093
464,BUMA.1121.00007,2,708070,716162,+,8092
464,BUMA.1121.00072,2,641388,649480,+,8092
464,BUMA.1121.00071,2,644356,652448,+,8092
464,BUMA.1121.00077,2,3066076,3074177,-,8101
464,BUMA.1121.00003,2,2041024,2049117,+,8093
464,BUMA.1121.00104,2,760460,768546,+,8086
464,BUMA.1121.00074,2,326052,334143,-,8091
464,BUMA.1121.00060,2,1582651,1590743,-,8092
464,BUMA.1121.00088,2,609987,618079,+,8092
464,BUMA.1121.00053,2,897389,905484,+,8095
464,BUMA.1121.00025,2,2270498,2278591,+,8093
464,BUMA.1121.00070,2,645056,653148,+,8092
464,BUMA.1121.00049,2,2479706,2487799,+,8093
464,BUMA.1121.00078,2,2551596,2559689,-,8093
464,BUMA.1121.00069,2,642913,651005,+,8092
464,BUMA.1121.00102,2,660195,668290,+,8095
464,BUMA.1121.00112,2,495386,503478,-,8092
464,BUMA.1121.00041,2,1553662,1561755,+,8093
464,BUMA.1121.00068,2,2372854,2380948,+,8094
464,BUMA.1121.00076,2,1551113,1559208,+,8095
464,BUMA.1121.00033,2,1346373,1354465,+,8092
464,BUMA.1121.00101,2,2734887,2742978,-,8091
464,BUMA.1121.00105,2,1847887,1855978,-,8091
464,BUMA.1121.00061,2,634912,643004,+,8092
464,BUMA.1121.00063,2,644306,652398,+,8092
464,BUMA.1121.00059,2,2984685,2992776,-,8091
464,BUMA.1121.00058,2,1216890,1224976,+,8086
464,BUMA.1121.00043,2,1751753,1759845,-,8092
464,BUMA.1121.00055,2,1999652,2007743,-,8091
464,BUMA.1121.00065,2,658133,666226,+,8093
464,BUMA.1121.00064,2,580984,589076,+,8092
464,BUMA.1121.00047,2,1596313,1604406,+,8093
464,BUMA.1121.00037,2,971140,979233,+,8093
464,BUMA.1121.00106,2,3070920,3079005,+,8085
464,BUMA.1121.00051,2,665841,673933,+,8092
464,BUMA.1121.00045,2,503081,511174,+,8093
464,BUMA.1121.00056,2,229545,237637,-,8092
464,BUMA.1121.00095,2,2711896,2719973,+,8077
464,BUMA.1121.00082,2,673161,681253,+,8092
464,BUMA.1121.00001,2,1591419,1599511,-,8092
464,BUMA.1121.00108,2,894732,902824,+,8092
464,BUMA.1121.00083,2,2470118,2478210,+,8092
464,BUMA.1121.00080,2,667079,675172,+,8093
464,BUMA.1121.00012,2,1090680,1098771,-,8091
465,BUMA.1121.00011,2,2552916,2583298,+,30382
465,BUMA.1121.00009,2,2574284,2604611,+,30327
465,BUMA.1121.00039,2,117158,147480,-,30322
465,BUMA.1121.00029,2,675871,706235,-,30364
465,BUMA.1121.00021,2,1135891,1166212,+,30321
465,BUMA.1121.00107,2,3196827,3227179,-,30352
465,BUMA.1121.00023,2,712832,743170,+,30338
465,BUMA.1121.00067,2,115909,146249,-,30340
465,BUMA.1121.00035,2,723145,753572,-,30427
465,BUMA.1121.00005,2,26922,57298,-,30376
465,BUMA.1121.00100,2,1780507,1810846,+,30339
465,BUMA.1121.00016,2,3131845,3162167,-,30322
465,BUMA.1121.00099,2,878852,909182,+,30330
465,BUMA.1121.00094,2,718053,748417,+,30364
465,BUMA.1121.00093,2,2228064,2258414,-,30350
465,BUMA.1121.00097,2,470659,501026,+,30367
465,BUMA.1121.00109,2,707168,737493,-,30325
465,BUMA.1121.00018,2,23676,54004,-,30328
465,BUMA.1121.00110,2,550949,581284,+,30335
465,BUMA.1121.00079,2,674826,705150,+,30324
465,BUMA.1121.00075,2,2155710,2186067,-,30357
465,BUMA.1121.00066,2,659147,689511,+,30364
465,BUMA.1121.00089,2,662732,693096,+,30364
465,BUMA.1121.00057,2,1384595,1415019,-,30424
465,BUMA.1121.00090,2,1607541,1637862,+,30321
465,BUMA.1121.00027,2,1733414,1763819,+,30405
465,BUMA.1121.00062,2,1076666,1107000,-,30334
465,BUMA.1121.00091,2,2978120,3008547,-,30427
465,BUMA.1121.00098,2,875297,905679,+,30382
465,BUMA.1121.00092,2,686485,716834,+,30349
465,BUMA.1121.00031,2,3074828,3105141,+,30313
465,BUMA.1121.00096,2,836034,866428,+,30394
465,BUMA.1121.00073,2,653497,683856,+,30359
465,BUMA.1121.00103,2,2533644,2563981,+,30337
465,BUMA.1121.00084,2,2501677,2532005,+,30328
465,BUMA.1121.00014,2,742453,772766,+,30313
465,BUMA.1121.00111,2,3106460,3136781,+,30321
465,BUMA.1121.00007,2,716595,746960,+,30365
465,BUMA.1121.00072,2,649913,680272,+,30359
465,BUMA.1121.00071,2,652881,683239,+,30358
465,BUMA.1121.00077,2,3035312,3065650,-,30338
465,BUMA.1121.00003,2,2049550,2079982,+,30432
465,BUMA.1121.00104,2,768979,799312,+,30333
465,BUMA.1121.00074,2,295279,325619,-,30340
465,BUMA.1121.00060,2,1551876,1582218,-,30342
465,BUMA.1121.00088,2,618512,648850,+,30338
465,BUMA.1121.00053,2,905917,936287,+,30370
465,BUMA.1121.00025,2,2279024,2309351,+,30327
465,BUMA.1121.00070,2,653581,683942,+,30361
465,BUMA.1121.00049,2,2488232,2518558,+,30326
465,BUMA.1121.00078,2,2520752,2551163,-,30411
465,BUMA.1121.00069,2,651438,681796,+,30358
465,BUMA.1121.00102,2,668723,699048,+,30325
465,BUMA.1121.00112,2,464552,494953,-,30401
465,BUMA.1121.00041,2,1562188,1592575,+,30387
465,BUMA.1121.00068,2,2381381,2411726,+,30345
465,BUMA.1121.00076,2,1559641,1589997,+,30356
465,BUMA.1121.00033,2,1354898,1385317,+,30419
465,BUMA.1121.00101,2,2704118,2734454,-,30336
465,BUMA.1121.00105,2,1817095,1847454,-,30359
465,BUMA.1121.00061,2,643437,673796,+,30359
465,BUMA.1121.00063,2,652831,683195,+,30364
465,BUMA.1121.00059,2,2953913,2984252,-,30339
465,BUMA.1121.00058,2,1225409,1255732,+,30323
465,BUMA.1121.00043,2,1720999,1751320,-,30321
465,BUMA.1121.00055,2,1968815,1999219,-,30404
465,BUMA.1121.00065,2,666659,697005,+,30346
465,BUMA.1121.00064,2,589509,619843,+,30334
465,BUMA.1121.00047,2,1604839,1635203,+,30364
465,BUMA.1121.00037,2,979666,1009987,+,30321
465,BUMA.1121.00106,2,3079438,3109780,+,30342
465,BUMA.1121.00051,2,674366,704751,+,30385
465,BUMA.1121.00045,2,511607,541948,+,30341
465,BUMA.1121.00056,2,198747,229112,-,30365
465,BUMA.1121.00095,2,2720397,2750752,+,30355
465,BUMA.1121.00082,2,681686,712050,+,30364
465,BUMA.1121.00001,2,1560531,1590986,-,30455
465,BUMA.1121.00108,2,903257,933591,+,30334
465,BUMA.1121.00083,2,2478643,2509007,+,30364
465,BUMA.1121.00080,2,675605,705953,+,30348
465,BUMA.1121.00012,2,1059855,1090247,-,30392
466,BUMA.1121.00011,2,2587869,2601059,+,13190
466,BUMA.1121.00009,2,2609182,2622375,+,13193
466,BUMA.1121.00039,2,99403,112545,-,13142
466,BUMA.1121.00029,2,658116,671258,-,13142
466,BUMA.1121.00021,2,1170783,1183967,+,13184
466,BUMA.1121.00107,2,3179063,3192214,-,13151
466,BUMA.1121.00023,2,747741,760872,+,13131
466,BUMA.1121.00067,2,98151,111296,-,13145
466,BUMA.1121.00035,2,705390,718532,-,13142
466,BUMA.1121.00005,2,9158,22309,-,13151
466,BUMA.1121.00100,2,1815417,1828610,+,13193
466,BUMA.1121.00016,2,3114090,3127232,-,13142
466,BUMA.1121.00099,2,913753,926946,+,13193
466,BUMA.1121.00094,2,752988,766175,+,13187
466,BUMA.1121.00093,2,2210309,2223454,-,13145
466,BUMA.1121.00097,2,505597,518784,+,13187
466,BUMA.1121.00109,2,689407,702552,-,13145
466,BUMA.1121.00018,2,5915,19063,-,13148
466,BUMA.1121.00110,2,585854,599038,+,13184
466,BUMA.1121.00079,2,709721,722908,+,13187
466,BUMA.1121.00075,2,2137952,2151097,-,13145
466,BUMA.1121.00066,2,694082,707269,+,13187
466,BUMA.1121.00089,2,697667,710854,+,13187
466,BUMA.1121.00057,2,1366831,1379982,-,13151
466,BUMA.1121.00090,2,1642433,1655617,+,13184
466,BUMA.1121.00027,2,1768389,1781581,+,13192
466,BUMA.1121.00062,2,1058908,1072053,-,13145
466,BUMA.1121.00091,2,2960356,2973507,-,13151
466,BUMA.1121.00098,2,910250,923437,+,13187
466,BUMA.1121.00092,2,721402,734589,+,13187
466,BUMA.1121.00031,2,3109712,3122896,+,13184
466,BUMA.1121.00096,2,870999,884192,+,13193
466,BUMA.1121.00073,2,688427,701614,+,13187
466,BUMA.1121.00103,2,2568552,2581739,+,13187
466,BUMA.1121.00084,2,2536576,2549763,+,13187
466,BUMA.1121.00014,2,777337,790521,+,13184
466,BUMA.1121.00111,2,3141352,3154486,+,13134
466,BUMA.1121.00007,2,751531,764724,+,13193
466,BUMA.1121.00072,2,684843,698030,+,13187
466,BUMA.1121.00071,2,687810,700997,+,13187
466,BUMA.1121.00077,2,3017557,3030699,-,13142
466,BUMA.1121.00003,2,2084553,2097746,+,13193
466,BUMA.1121.00104,2,803883,817076,+,13193
466,BUMA.1121.00074,2,277521,290666,-,13145
466,BUMA.1121.00060,2,1534118,1547263,-,13145
466,BUMA.1121.00088,2,653421,666605,+,13184
466,BUMA.1121.00053,2,940858,954042,+,13184
466,BUMA.1121.00025,2,2313922,2327112,+,13190
466,BUMA.1121.00070,2,688513,701700,+,13187
466,BUMA.1121.00049,2,2523129,2536316,+,13187
466,BUMA.1121.00078,2,2502997,2516139,-,13142
466,BUMA.1121.00069,2,686367,699554,+,13187
466,BUMA.1121.00102,2,703619,716803,+,13184
466,BUMA.1121.00112,2,446794,459939,-,13145
466,BUMA.1121.00041,2,1597146,1610339,+,13193
466,BUMA.1121.00068,2,2416297,2429481,+,13184
466,BUMA.1121.00076,2,1594568,1607755,+,13187
466,BUMA.1121.00033,2,1389888,1403028,+,13140
466,BUMA.1121.00101,2,2686354,2699505,-,13151
466,BUMA.1121.00105,2,1799337,1812482,-,13145
466,BUMA.1121.00061,2,678367,691554,+,13187
466,BUMA.1121.00063,2,687766,700953,+,13187
466,BUMA.1121.00059,2,2936155,2949300,-,13145
466,BUMA.1121.00058,2,1260304,1273491,+,13187
466,BUMA.1121.00043,2,1703294,1716386,-,13092
466,BUMA.1121.00055,2,1951057,1964202,-,13145
466,BUMA.1121.00065,2,701576,714760,+,13184
466,BUMA.1121.00064,2,624414,637601,+,13187
466,BUMA.1121.00047,2,1639774,1652961,+,13187
466,BUMA.1121.00037,2,1014558,1027742,+,13184
466,BUMA.1121.00106,2,3114351,3127538,+,13187
466,BUMA.1121.00051,2,709322,722509,+,13187
466,BUMA.1121.00045,2,546519,559706,+,13187
466,BUMA.1121.00056,2,180989,194134,-,13145
466,BUMA.1121.00095,2,2755323,2768506,+,13183
466,BUMA.1121.00082,2,716621,729808,+,13187
466,BUMA.1121.00001,2,1542776,1555918,-,13142
466,BUMA.1121.00108,2,938161,951348,+,13187
466,BUMA.1121.00083,2,2513578,2526765,+,13187
466,BUMA.1121.00080,2,710524,723711,+,13187
466,BUMA.1121.00012,2,1042094,1055242,-,13148
467,BUMA.1121.00011,2,2611111,2619761,+,8650
467,BUMA.1121.00009,2,2632347,2640959,+,8612
467,BUMA.1121.00039,2,81040,89514,-,8474
467,BUMA.1121.00029,2,639873,648240,-,8367
467,BUMA.1121.00021,2,1193996,1202644,+,8648
467,BUMA.1121.00107,2,3160879,3169264,-,8385
467,BUMA.1121.00023,2,770891,779539,+,8648
467,BUMA.1121.00067,2,80034,88403,-,8369
467,BUMA.1121.00035,2,687093,695482,-,8389
467,BUMA.1121.00005,2,2117889,2126585,+,8696
467,BUMA.1121.00100,2,1838665,1847347,+,8682
467,BUMA.1121.00016,2,3095620,3103988,-,8368
467,BUMA.1121.00099,2,936957,945621,+,8664
467,BUMA.1121.00094,2,776215,784824,+,8609
467,BUMA.1121.00093,2,2191860,2200232,-,8372
467,BUMA.1121.00097,2,528605,537259,+,8654
467,BUMA.1121.00109,2,670900,679319,-,8419
467,BUMA.1121.00018,2,3066142,3074563,-,8421
467,BUMA.1121.00110,2,1705164,1713596,-,8432
467,BUMA.1121.00079,2,732984,741609,+,8625
467,BUMA.1121.00075,2,1023487,1032218,+,8731
467,BUMA.1121.00066,2,716997,725644,+,8647
467,BUMA.1121.00089,2,720904,729523,+,8619
467,BUMA.1121.00057,2,1348435,1356831,-,8396
467,BUMA.1121.00090,2,1665711,1674352,+,8641
467,BUMA.1121.00027,2,1791579,1800211,+,8632
467,BUMA.1121.00062,2,1040753,1049111,-,8358
467,BUMA.1121.00091,2,2941816,2950331,-,8515
467,BUMA.1121.00098,2,933522,942178,+,8656
467,BUMA.1121.00092,2,744667,753297,+,8630
467,BUMA.1121.00031,2,3133058,3141678,+,8620
467,BUMA.1121.00096,2,894214,902834,+,8620
467,BUMA.1121.00073,2,711355,720002,+,8647
467,BUMA.1121.00103,2,2591571,2600192,+,8621
467,BUMA.1121.00084,2,2559537,2568227,+,8690
467,BUMA.1121.00014,2,800597,809224,+,8627
467,BUMA.1121.00111,2,3164463,3173111,+,8648
467,BUMA.1121.00007,2,774826,783096,+,8270
467,BUMA.1121.00072,2,707713,716389,+,8676
467,BUMA.1121.00071,2,710729,719376,+,8647
467,BUMA.1121.00077,2,2999034,3007466,-,8432
467,BUMA.1121.00003,2,35389,43800,-,8411
467,BUMA.1121.00104,2,826894,835478,+,8584
467,BUMA.1121.00074,2,259386,267762,-,8376
467,BUMA.1121.00060,2,1515667,1524038,-,8371
467,BUMA.1121.00088,2,676366,685014,+,8648
467,BUMA.1121.00053,2,964157,972791,+,8634
467,BUMA.1121.00025,2,321003,329424,-,8421
467,BUMA.1121.00070,2,711434,720088,+,8654
467,BUMA.1121.00049,2,2546088,2554728,+,8640
467,BUMA.1121.00078,2,2484335,2492832,-,8497
467,BUMA.1121.00069,2,709230,717906,+,8676
467,BUMA.1121.00102,2,726624,735265,+,8641
467,BUMA.1121.00112,2,428522,436976,-,8454
467,BUMA.1121.00041,2,1620163,1628813,+,8650
467,BUMA.1121.00068,2,2439576,2448195,+,8619
467,BUMA.1121.00076,2,1617541,1626286,+,8745
467,BUMA.1121.00033,2,1413065,1421710,+,8645
467,BUMA.1121.00101,2,2667966,2676341,-,8375
467,BUMA.1121.00105,2,1780901,1789294,-,8393
467,BUMA.1121.00061,2,701312,709988,+,8676
467,BUMA.1121.00063,2,710563,719238,+,8675
467,BUMA.1121.00059,2,2917981,2926385,-,8404
467,BUMA.1121.00058,2,1283322,1291949,+,8627
467,BUMA.1121.00043,2,1684842,1693274,-,8432
467,BUMA.1121.00055,2,1932918,1941281,-,8363
467,BUMA.1121.00065,2,724532,733174,+,8642
467,BUMA.1121.00064,2,647384,655997,+,8613
467,BUMA.1121.00047,2,1663004,1671693,+,8689
467,BUMA.1121.00037,2,1037872,1046505,+,8633
467,BUMA.1121.00106,2,1079253,1087621,-,8368
467,BUMA.1121.00051,2,732553,741172,+,8619
467,BUMA.1121.00045,2,569787,578416,+,8629
467,BUMA.1121.00056,2,162579,170940,-,8361
467,BUMA.1121.00095,2,594430,602835,-,8405
467,BUMA.1121.00082,2,739593,748269,+,8676
467,BUMA.1121.00001,2,1524513,1532874,-,8361
467,BUMA.1121.00108,2,961385,970005,+,8620
467,BUMA.1121.00083,2,2536550,2545226,+,8676
467,BUMA.1121.00080,2,733762,742367,+,8605
467,BUMA.1121.00012,2,1023936,1032284,-,8348
468,BUMA.1121.00011,2,2620392,2654891,+,34499
468,BUMA.1121.00009,2,2641590,2676084,+,34494
468,BUMA.1121.00039,2,45697,80150,-,34453
468,BUMA.1121.00029,2,604523,638983,-,34460
468,BUMA.1121.00021,2,1203275,1237735,+,34460
468,BUMA.1121.00107,2,3125530,3159989,-,34459
468,BUMA.1121.00023,2,780170,814614,+,34444
468,BUMA.1121.00067,2,44669,79144,-,34475
468,BUMA.1121.00035,2,651743,686203,-,34460
468,BUMA.1121.00005,2,2127216,2161655,+,34439
468,BUMA.1121.00100,2,1847978,1882385,+,34407
468,BUMA.1121.00016,2,3060276,3094730,-,34454
468,BUMA.1121.00099,2,946252,980720,+,34468
468,BUMA.1121.00094,2,785455,819973,+,34518
468,BUMA.1121.00093,2,2156533,2190970,-,34437
468,BUMA.1121.00097,2,537890,572350,+,34460
468,BUMA.1121.00109,2,635550,670010,-,34460
468,BUMA.1121.00018,2,3030792,3065252,-,34460
468,BUMA.1121.00110,2,1669841,1704274,-,34433
468,BUMA.1121.00079,2,742240,776753,+,34513
468,BUMA.1121.00075,2,1032849,1067301,+,34452
468,BUMA.1121.00066,2,726275,760727,+,34452
468,BUMA.1121.00089,2,730154,764691,+,34537
468,BUMA.1121.00057,2,1313092,1347545,-,34453
468,BUMA.1121.00090,2,1674983,1709436,+,34453
468,BUMA.1121.00027,2,1800842,1835294,+,34452
468,BUMA.1121.00062,2,1005411,1039863,-,34452
468,BUMA.1121.00091,2,2906474,2940926,-,34452
468,BUMA.1121.00098,2,942809,977316,+,34507
468,BUMA.1121.00092,2,753928,788365,+,34437
468,BUMA.1121.00031,2,3142309,3176762,+,34453
468,BUMA.1121.00096,2,903465,937932,+,34467
468,BUMA.1121.00073,2,720633,755085,+,34452
468,BUMA.1121.00103,2,2600823,2635246,+,34423
468,BUMA.1121.00084,2,2568858,2603318,+,34460
468,BUMA.1121.00014,2,809855,844309,+,34454
468,BUMA.1121.00111,2,3173742,3208202,+,34460
468,BUMA.1121.00007,2,783727,818195,+,34468
468,BUMA.1121.00072,2,717020,751473,+,34453
468,BUMA.1121.00071,2,720007,754459,+,34452
468,BUMA.1121.00077,2,2963711,2998144,-,34433
468,BUMA.1121.00003,2,11,34499,-,34488
468,BUMA.1121.00104,2,836109,870561,+,34452
468,BUMA.1121.00074,2,224021,258496,-,34475
468,BUMA.1121.00060,2,1480309,1514777,-,34468
468,BUMA.1121.00088,2,685645,720105,+,34460
468,BUMA.1121.00053,2,973422,1007898,+,34476
468,BUMA.1121.00025,2,285653,320113,-,34460
468,BUMA.1121.00070,2,720719,755172,+,34453
468,BUMA.1121.00049,2,2555359,2589812,+,34453
468,BUMA.1121.00078,2,2448988,2483445,-,34457
468,BUMA.1121.00069,2,718537,752989,+,34452
468,BUMA.1121.00102,2,735896,770443,+,34547
468,BUMA.1121.00112,2,393131,427632,-,34501
468,BUMA.1121.00041,2,1629444,1663887,+,34443
468,BUMA.1121.00068,2,2448826,2483278,+,34452
468,BUMA.1121.00076,2,1626917,1661369,+,34452
468,BUMA.1121.00033,2,1422341,1456793,+,34452
468,BUMA.1121.00101,2,2632620,2667076,-,34456
468,BUMA.1121.00105,2,1745553,1780011,-,34458
468,BUMA.1121.00061,2,710619,745071,+,34452
468,BUMA.1121.00063,2,719869,754321,+,34452
468,BUMA.1121.00059,2,2882616,2917091,-,34475
468,BUMA.1121.00058,2,1292580,1327045,+,34465
468,BUMA.1121.00043,2,1649492,1683952,-,34460
468,BUMA.1121.00055,2,1897570,1932028,-,34458
468,BUMA.1121.00065,2,733805,768265,+,34460
468,BUMA.1121.00064,2,656628,691071,+,34443
468,BUMA.1121.00047,2,1672324,1706838,+,34514
468,BUMA.1121.00037,2,1047136,1081279,+,34143
468,BUMA.1121.00106,2,1043910,1078363,-,34453
468,BUMA.1121.00051,2,741803,776316,+,34513
468,BUMA.1121.00045,2,579047,613515,+,34468
468,BUMA.1121.00056,2,127160,161689,-,34529
468,BUMA.1121.00095,2,559096,593540,-,34444
468,BUMA.1121.00082,2,748900,783353,+,34453
468,BUMA.1121.00001,2,1489163,1523623,-,34460
468,BUMA.1121.00108,2,970636,1005127,+,34491
468,BUMA.1121.00083,2,2545857,2580310,+,34453
468,BUMA.1121.00080,2,742998,777511,+,34513
468,BUMA.1121.00012,2,988586,1023046,-,34460
469,BUMA.1121.00011,2,2654893,2658896,+,4003
469,BUMA.1121.00009,2,2676086,2680089,+,4003
469,BUMA.1121.00039,2,41692,45696,-,4004
469,BUMA.1121.00029,2,600518,604522,-,4004
469,BUMA.1121.00021,2,1237737,1241740,+,4003
469,BUMA.1121.00107,2,3121525,3125529,-,4004
469,BUMA.1121.00023,2,814616,818619,+,4003
469,BUMA.1121.00067,2,40664,44668,-,4004
469,BUMA.1121.00035,2,647738,651742,-,4004
469,BUMA.1121.00005,2,2161657,2165660,+,4003
469,BUMA.1121.00100,2,1882387,1886390,+,4003
469,BUMA.1121.00016,2,3056272,3060275,-,4003
469,BUMA.1121.00099,2,980722,984725,+,4003
469,BUMA.1121.00094,2,819975,823978,+,4003
469,BUMA.1121.00093,2,2152528,2156532,-,4004
469,BUMA.1121.00097,2,572352,576355,+,4003
469,BUMA.1121.00109,2,631545,635549,-,4004
469,BUMA.1121.00018,2,3026787,3030791,-,4004
469,BUMA.1121.00110,2,1665836,1669840,-,4004
469,BUMA.1121.00079,2,776755,780758,+,4003
469,BUMA.1121.00075,2,1067303,1071306,+,4003
469,BUMA.1121.00066,2,760729,764732,+,4003
469,BUMA.1121.00089,2,764693,768696,+,4003
469,BUMA.1121.00057,2,1309087,1313091,-,4004
469,BUMA.1121.00090,2,1709438,1713441,+,4003
469,BUMA.1121.00027,2,1835296,1839299,+,4003
469,BUMA.1121.00062,2,1001406,1005410,-,4004
469,BUMA.1121.00091,2,2902469,2906473,-,4004
469,BUMA.1121.00098,2,977318,981321,+,4003
469,BUMA.1121.00092,2,788367,792370,+,4003
469,BUMA.1121.00031,2,3176764,3180767,+,4003
469,BUMA.1121.00096,2,937934,941936,+,4002
469,BUMA.1121.00073,2,755087,759090,+,4003
469,BUMA.1121.00103,2,2635248,2639251,+,4003
469,BUMA.1121.00084,2,2603320,2607323,+,4003
469,BUMA.1121.00014,2,844311,848314,+,4003
469,BUMA.1121.00111,2,3208204,3212183,+,3979
469,BUMA.1121.00007,2,818197,822200,+,4003
469,BUMA.1121.00072,2,751475,755478,+,4003
469,BUMA.1121.00071,2,754461,758464,+,4003
469,BUMA.1121.00077,2,2959706,2963710,-,4004
469,BUMA.1121.00003,2,3123479,3127457,-,3978
469,BUMA.1121.00104,2,870563,874566,+,4003
469,BUMA.1121.00074,2,220016,224020,-,4004
469,BUMA.1121.00060,2,1476304,1480308,-,4004
469,BUMA.1121.00088,2,720107,724110,+,4003
469,BUMA.1121.00053,2,1007900,1011903,+,4003
469,BUMA.1121.00025,2,281648,285652,-,4004
469,BUMA.1121.00070,2,755174,759177,+,4003
469,BUMA.1121.00049,2,2589814,2593817,+,4003
469,BUMA.1121.00078,2,2444983,2448987,-,4004
469,BUMA.1121.00069,2,752991,756994,+,4003
469,BUMA.1121.00102,2,770445,774448,+,4003
469,BUMA.1121.00112,2,389126,393130,-,4004
469,BUMA.1121.00041,2,1663889,1667892,+,4003
469,BUMA.1121.00068,2,2483280,2487283,+,4003
469,BUMA.1121.00076,2,1661371,1665374,+,4003
469,BUMA.1121.00033,2,1456795,1460797,+,4002
469,BUMA.1121.00101,2,2628615,2632619,-,4004
469,BUMA.1121.00105,2,1741548,1745552,-,4004
469,BUMA.1121.00061,2,745073,749076,+,4003
469,BUMA.1121.00063,2,754323,758326,+,4003
469,BUMA.1121.00059,2,2878611,2882615,-,4004
469,BUMA.1121.00058,2,1327047,1331050,+,4003
469,BUMA.1121.00043,2,1645487,1649491,-,4004
469,BUMA.1121.00055,2,1893565,1897569,-,4004
469,BUMA.1121.00065,2,768267,772270,+,4003
469,BUMA.1121.00064,2,691073,695076,+,4003
469,BUMA.1121.00047,2,1706840,1710843,+,4003
469,BUMA.1121.00037,2,1081281,1085284,+,4003
469,BUMA.1121.00106,2,1039905,1043909,-,4004
469,BUMA.1121.00051,2,776318,780321,+,4003
469,BUMA.1121.00045,2,613517,617520,+,4003
469,BUMA.1121.00056,2,123155,127159,-,4004
469,BUMA.1121.00095,2,555091,559095,-,4004
469,BUMA.1121.00082,2,783355,787358,+,4003
469,BUMA.1121.00001,2,1485158,1489162,-,4004
469,BUMA.1121.00108,2,1005129,1009132,+,4003
469,BUMA.1121.00083,2,2580312,2584315,+,4003
469,BUMA.1121.00080,2,777513,781516,+,4003
469,BUMA.1121.00012,2,984581,988585,-,4004
470,BUMA.1121.00011,2,2662836,2675313,+,12477
470,BUMA.1121.00009,2,2684029,2696404,+,12375
470,BUMA.1121.00039,2,25370,37762,-,12392
470,BUMA.1121.00029,2,584160,596579,-,12419
470,BUMA.1121.00021,2,1245670,1258066,+,12396
470,BUMA.1121.00107,2,3105178,3117585,-,12407
470,BUMA.1121.00023,2,822552,834906,+,12354
470,BUMA.1121.00067,2,24219,36725,-,12506
470,BUMA.1121.00035,2,631386,643799,-,12413
470,BUMA.1121.00005,2,2169590,2181965,+,12375
470,BUMA.1121.00100,2,1891665,1904139,+,12474
470,BUMA.1121.00016,2,3039974,3052342,-,12368
470,BUMA.1121.00099,2,988664,1001033,+,12369
470,BUMA.1121.00094,2,827908,840265,+,12357
470,BUMA.1121.00093,2,2136109,2148600,-,12491
470,BUMA.1121.00097,2,580295,592685,+,12390
470,BUMA.1121.00109,2,615153,627614,-,12461
470,BUMA.1121.00018,2,3010413,3022857,-,12444
470,BUMA.1121.00110,2,1649426,1661915,-,12489
470,BUMA.1121.00079,2,784698,797096,+,12398
470,BUMA.1121.00075,2,1075236,1087693,+,12457
470,BUMA.1121.00066,2,768672,781129,+,12457
470,BUMA.1121.00089,2,772626,785031,+,12405
470,BUMA.1121.00057,2,1292668,1305147,-,12479
470,BUMA.1121.00090,2,1717380,1729740,+,12360
470,BUMA.1121.00027,2,1843239,1855689,+,12450
470,BUMA.1121.00062,2,984894,997466,-,12572
470,BUMA.1121.00091,2,2885999,2898529,-,12530
470,BUMA.1121.00098,2,985251,997716,+,12465
470,BUMA.1121.00092,2,796298,808772,+,12474
470,BUMA.1121.00031,2,3184697,3197051,+,12354
470,BUMA.1121.00096,2,945866,958313,+,12447
470,BUMA.1121.00073,2,763030,775478,+,12448
470,BUMA.1121.00103,2,2643190,2655637,+,12447
470,BUMA.1121.00084,2,2611262,2623706,+,12444
470,BUMA.1121.00014,2,852244,864598,+,12354
470,BUMA.1121.00111,2,3954,16302,+,12348
470,BUMA.1121.00007,2,826140,838557,+,12417
470,BUMA.1121.00072,2,759418,771888,+,12470
470,BUMA.1121.00071,2,762404,774862,+,12458
470,BUMA.1121.00077,2,2943296,2955785,-,12489
470,BUMA.1121.00003,2,3106950,3119540,-,12590
470,BUMA.1121.00104,2,878506,890851,+,12345
470,BUMA.1121.00074,2,203559,216077,-,12518
470,BUMA.1121.00060,2,1459790,1472374,-,12584
470,BUMA.1121.00088,2,728040,740499,+,12459
470,BUMA.1121.00053,2,1015833,1028238,+,12405
470,BUMA.1121.00025,2,265273,277717,-,12444
470,BUMA.1121.00070,2,763117,775552,+,12435
470,BUMA.1121.00049,2,2597756,2610128,+,12372
470,BUMA.1121.00078,2,2428534,2441043,-,12509
470,BUMA.1121.00069,2,760934,773379,+,12445
470,BUMA.1121.00102,2,778378,790825,+,12447
470,BUMA.1121.00112,2,372612,385196,-,12584
470,BUMA.1121.00041,2,1671832,1684245,+,12413
470,BUMA.1121.00068,2,2491222,2503600,+,12378
470,BUMA.1121.00076,2,1669304,1681763,+,12459
470,BUMA.1121.00033,2,1464727,1477106,+,12379
470,BUMA.1121.00101,2,2612281,2624685,-,12404
470,BUMA.1121.00105,2,1725133,1737609,-,12476
470,BUMA.1121.00061,2,753016,765461,+,12445
470,BUMA.1121.00063,2,762266,774724,+,12458
470,BUMA.1121.00059,2,2862226,2874672,-,12446
470,BUMA.1121.00058,2,1334989,1347351,+,12362
470,BUMA.1121.00043,2,1629132,1641557,-,12425
470,BUMA.1121.00055,2,1877074,1889625,-,12551
470,BUMA.1121.00065,2,776200,788569,+,12369
470,BUMA.1121.00064,2,699004,711385,+,12381
470,BUMA.1121.00047,2,1714783,1727176,+,12393
470,BUMA.1121.00037,2,1089214,1101592,+,12378
470,BUMA.1121.00106,2,1023553,1035966,-,12413
470,BUMA.1121.00051,2,784251,796650,+,12399
470,BUMA.1121.00045,2,621450,633891,+,12441
470,BUMA.1121.00056,2,106722,119225,-,12503
470,BUMA.1121.00095,2,538625,551157,-,12532
470,BUMA.1121.00082,2,791298,803709,+,12411
470,BUMA.1121.00001,2,1468800,1481219,-,12419
470,BUMA.1121.00108,2,1013071,1025464,+,12393
470,BUMA.1121.00083,2,2588255,2600666,+,12411
470,BUMA.1121.00080,2,785446,797839,+,12393
470,BUMA.1121.00012,2,968289,980651,-,12362
471,BUMA.1121.00011,2,2675712,2692429,+,16717
471,BUMA.1121.00009,2,2696686,2713097,+,16411
471,BUMA.1121.00039,2,8576,25178,-,16602
471,BUMA.1121.00029,2,567333,583959,-,16626
471,BUMA.1121.00021,2,1258276,1274907,+,16631
471,BUMA.1121.00107,2,3088136,3104842,-,16706
471,BUMA.1121.00023,2,835125,851778,+,16653
471,BUMA.1121.00067,2,7325,23982,-,16657
471,BUMA.1121.00035,2,614521,631185,-,16664
471,BUMA.1121.00005,2,2182220,2198911,+,16691
471,BUMA.1121.00100,2,1904349,1921282,+,16933
471,BUMA.1121.00016,2,3023131,3039782,-,16651
471,BUMA.1121.00099,2,1001468,1018377,+,16909
471,BUMA.1121.00094,2,840727,857343,+,16616
471,BUMA.1121.00093,2,2119023,2135593,-,16570
471,BUMA.1121.00097,2,592949,609655,+,16706
471,BUMA.1121.00109,2,598375,614952,-,16577
471,BUMA.1121.00018,2,2993620,3010221,-,16601
471,BUMA.1121.00110,2,1632503,1649108,-,16605
471,BUMA.1121.00079,2,797576,814186,+,16610
471,BUMA.1121.00075,2,1089640,1106177,+,16537
471,BUMA.1121.00066,2,781537,798146,+,16609
471,BUMA.1121.00089,2,785493,802109,+,16616
471,BUMA.1121.00057,2,1275705,1292341,-,16636
471,BUMA.1121.00090,2,1730022,1746628,+,16606
471,BUMA.1121.00027,2,1856070,1872709,+,16639
471,BUMA.1121.00062,2,967964,984639,-,16675
471,BUMA.1121.00091,2,2869022,2885771,-,16749
471,BUMA.1121.00098,2,998133,1014799,+,16666
471,BUMA.1121.00092,2,809279,825850,+,16571
471,BUMA.1121.00031,2,3197296,3213932,+,16636
471,BUMA.1121.00096,2,958550,974981,+,16431
471,BUMA.1121.00073,2,775877,792485,+,16608
471,BUMA.1121.00103,2,2656027,2672725,+,16698
471,BUMA.1121.00084,2,2624150,2640794,+,16644
471,BUMA.1121.00014,2,864799,881441,+,16642
471,BUMA.1121.00111,2,16539,33167,+,16628
471,BUMA.1121.00007,2,838983,855935,+,16952
471,BUMA.1121.00072,2,772296,788844,+,16548
471,BUMA.1121.00071,2,775270,791904,+,16634
471,BUMA.1121.00077,2,2926376,2942978,-,16602
471,BUMA.1121.00003,2,3089612,3106533,-,16921
471,BUMA.1121.00104,2,891349,908110,+,16761
471,BUMA.1121.00074,2,186663,203313,-,16650
471,BUMA.1121.00060,2,1442841,1459490,-,16649
471,BUMA.1121.00088,2,740997,757646,+,16649
471,BUMA.1121.00053,2,1029907,1046595,+,16688
471,BUMA.1121.00025,2,248480,265081,-,16601
471,BUMA.1121.00070,2,775951,792560,+,16609
471,BUMA.1121.00049,2,2610356,2626952,+,16596
471,BUMA.1121.00078,2,2411902,2428333,-,16431
471,BUMA.1121.00069,2,773787,790422,+,16635
471,BUMA.1121.00102,2,791332,807981,+,16649
471,BUMA.1121.00112,2,355639,372393,-,16754
471,BUMA.1121.00041,2,1684590,1701364,+,16774
471,BUMA.1121.00068,2,2503837,2520628,+,16791
471,BUMA.1121.00076,2,1683720,1700258,+,16538
471,BUMA.1121.00033,2,1477388,1494020,+,16632
471,BUMA.1121.00101,2,2595310,2612044,-,16734
471,BUMA.1121.00105,2,1708197,1724896,-,16699
471,BUMA.1121.00061,2,765869,782502,+,16633
471,BUMA.1121.00063,2,775132,791768,+,16636
471,BUMA.1121.00059,2,2845354,2861989,-,16635
471,BUMA.1121.00058,2,1347705,1364343,+,16638
471,BUMA.1121.00043,2,1612315,1628940,-,16625
471,BUMA.1121.00055,2,1860180,1876819,-,16639
471,BUMA.1121.00065,2,788995,805768,+,16773
471,BUMA.1121.00064,2,711595,728186,+,16591
471,BUMA.1121.00047,2,1727647,1744301,+,16654
471,BUMA.1121.00037,2,1101793,1118492,+,16699
471,BUMA.1121.00106,2,1006693,1023343,-,16650
471,BUMA.1121.00051,2,797103,813750,+,16647
471,BUMA.1121.00045,2,634362,651011,+,16649
471,BUMA.1121.00056,2,89752,106368,-,16616
471,BUMA.1121.00095,2,521982,538406,-,16424
471,BUMA.1121.00082,2,804180,820816,+,16636
471,BUMA.1121.00001,2,1451957,1468581,-,16624
471,BUMA.1121.00108,2,1025719,1042370,+,16651
471,BUMA.1121.00083,2,2601137,2617773,+,16636
471,BUMA.1121.00080,2,798303,814971,+,16668
471,BUMA.1121.00012,2,951470,968079,-,16609
472,BUMA.1121.00011,2,2693288,2699670,+,6382
472,BUMA.1121.00009,2,2713413,2719795,+,6382
472,BUMA.1121.00039,2,531,6843,-,6312
472,BUMA.1121.00029,2,559982,566295,-,6313
472,BUMA.1121.00021,2,1275876,1282271,+,6395
472,BUMA.1121.00107,2,3080828,3087200,-,6372
472,BUMA.1121.00023,2,852733,859112,+,6379
472,BUMA.1121.00067,2,14,6321,-,6307
472,BUMA.1121.00035,2,607147,613476,-,6329
472,BUMA.1121.00005,2,2199874,2206244,+,6370
472,BUMA.1121.00100,2,1921599,1928036,+,6437
472,BUMA.1121.00016,2,3015778,3022079,-,6301
472,BUMA.1121.00099,2,1019236,1025640,+,6404
472,BUMA.1121.00094,2,858196,864532,+,6336
472,BUMA.1121.00093,2,2110487,2116786,-,6299
472,BUMA.1121.00097,2,609971,616374,+,6403
472,BUMA.1121.00109,2,591077,597302,-,6225
472,BUMA.1121.00018,2,2986214,2992526,-,6312
472,BUMA.1121.00110,2,1625836,1632186,-,6350
472,BUMA.1121.00079,2,815039,821375,+,6336
472,BUMA.1121.00075,2,1106493,1112872,+,6379
472,BUMA.1121.00066,2,799046,805382,+,6336
472,BUMA.1121.00089,2,802962,809298,+,6336
472,BUMA.1121.00057,2,1268455,1274715,-,6260
472,BUMA.1121.00090,2,1747660,1754031,+,6371
472,BUMA.1121.00027,2,1873616,1879949,+,6333
472,BUMA.1121.00062,2,960673,966967,-,6294
472,BUMA.1121.00091,2,2861803,2868081,-,6278
472,BUMA.1121.00098,2,1015115,1021502,+,6387
472,BUMA.1121.00092,2,828011,834385,+,6374
472,BUMA.1121.00031,2,3214916,3221312,+,6396
472,BUMA.1121.00096,2,975917,982274,+,6357
472,BUMA.1121.00073,2,793385,799726,+,6341
472,BUMA.1121.00103,2,2673041,2679347,+,6306
472,BUMA.1121.00084,2,2641706,2648019,+,6313
472,BUMA.1121.00014,2,882390,888778,+,6388
472,BUMA.1121.00111,2,34053,40432,+,6379
472,BUMA.1121.00007,2,856252,862642,+,6390
472,BUMA.1121.00072,2,789744,796028,+,6284
472,BUMA.1121.00071,2,792804,799143,+,6339
472,BUMA.1121.00077,2,2919709,2926059,-,6350
472,BUMA.1121.00003,2,3082261,3088545,-,6284
472,BUMA.1121.00104,2,909059,915438,+,6379
472,BUMA.1121.00074,2,179350,185666,-,6316
472,BUMA.1121.00060,2,1436108,1442449,-,6341
472,BUMA.1121.00088,2,758553,764871,+,6318
472,BUMA.1121.00053,2,1047487,1053812,+,6325
472,BUMA.1121.00025,2,241074,247386,-,6312
472,BUMA.1121.00070,2,793460,799801,+,6341
472,BUMA.1121.00049,2,2627908,2634224,+,6316
472,BUMA.1121.00078,2,2404603,2410891,-,6288
472,BUMA.1121.00069,2,791322,797621,+,6299
472,BUMA.1121.00102,2,808950,815367,+,6417
472,BUMA.1121.00112,2,348364,354683,-,6319
472,BUMA.1121.00041,2,1702286,1708649,+,6363
472,BUMA.1121.00068,2,2521620,2527990,+,6370
472,BUMA.1121.00076,2,1700574,1706953,+,6379
472,BUMA.1121.00033,2,1494996,1501405,+,6409
472,BUMA.1121.00101,2,2587992,2594328,-,6336
472,BUMA.1121.00105,2,1701550,1707804,-,6254
472,BUMA.1121.00061,2,783402,789736,+,6334
472,BUMA.1121.00063,2,792668,798967,+,6299
472,BUMA.1121.00059,2,2838712,2844961,-,6249
472,BUMA.1121.00058,2,1365285,1371687,+,6402
472,BUMA.1121.00043,2,1604913,1611234,-,6321
472,BUMA.1121.00055,2,1852887,1859205,-,6318
472,BUMA.1121.00065,2,806716,813095,+,6379
472,BUMA.1121.00064,2,729149,735473,+,6324
472,BUMA.1121.00047,2,1745154,1751482,+,6328
472,BUMA.1121.00037,2,1120163,1126574,+,6411
472,BUMA.1121.00106,2,999455,1005696,-,6241
472,BUMA.1121.00051,2,814603,820954,+,6351
472,BUMA.1121.00045,2,651327,657743,+,6416
472,BUMA.1121.00056,2,82562,88823,-,6261
472,BUMA.1121.00095,2,515286,521590,-,6304
472,BUMA.1121.00082,2,821716,828057,+,6341
472,BUMA.1121.00001,2,1444621,1450926,-,6305
472,BUMA.1121.00108,2,1042686,1049072,+,6386
472,BUMA.1121.00083,2,2618673,2625014,+,6341
472,BUMA.1121.00080,2,815824,822160,+,6336
472,BUMA.1121.00012,2,944094,950390,-,6296
473,BUMA.1121.00011,2,2700162,2732585,+,32423
473,BUMA.1121.00009,2,2720287,2752987,+,32700
473,BUMA.1121.00039,2,3111906,3144330,-,32424
473,BUMA.1121.00029,2,527117,559491,-,32374
473,BUMA.1121.00021,2,1282763,1315201,+,32438
473,BUMA.1121.00107,2,3047896,3080337,-,32441
473,BUMA.1121.00023,2,859604,891940,+,32336
473,BUMA.1121.00067,2,3123701,3156183,-,32482
473,BUMA.1121.00035,2,574344,606656,-,32312
473,BUMA.1121.00005,2,2206736,2238967,+,32231
473,BUMA.1121.00100,2,1928528,1960856,+,32328
473,BUMA.1121.00016,2,2982898,3015287,-,32389
473,BUMA.1121.00099,2,1026132,1058423,+,32291
473,BUMA.1121.00094,2,865024,897412,+,32388
473,BUMA.1121.00093,2,2077803,2109996,-,32193
473,BUMA.1121.00097,2,616866,649336,+,32470
473,BUMA.1121.00109,2,558001,590586,-,32585
473,BUMA.1121.00018,2,2953265,2985723,-,32458
473,BUMA.1121.00110,2,1592844,1625345,-,32501
473,BUMA.1121.00079,2,821867,854264,+,32397
473,BUMA.1121.00075,2,1113364,1145783,+,32419
473,BUMA.1121.00066,2,805874,838333,+,32459
473,BUMA.1121.00089,2,809790,842178,+,32388
473,BUMA.1121.00057,2,1235475,1267964,-,32489
473,BUMA.1121.00090,2,1754523,1786845,+,32322
473,BUMA.1121.00027,2,1880441,1912734,+,32293
473,BUMA.1121.00062,2,928001,960182,-,32181
473,BUMA.1121.00091,2,2829066,2861312,-,32246
473,BUMA.1121.00098,2,1021994,1054571,+,32577
473,BUMA.1121.00092,2,834877,867268,+,32391
473,BUMA.1121.00031,2,3221804,3254194,+,32390
473,BUMA.1121.00096,2,982766,1015175,+,32409
473,BUMA.1121.00073,2,800218,832667,+,32449
473,BUMA.1121.00103,2,2679839,2712350,+,32511
473,BUMA.1121.00084,2,2648511,2680772,+,32261
473,BUMA.1121.00014,2,889270,921644,+,32374
473,BUMA.1121.00111,2,40924,73421,+,32497
473,BUMA.1121.00007,2,863134,895573,+,32439
473,BUMA.1121.00072,2,796520,828980,+,32460
473,BUMA.1121.00071,2,799635,832101,+,32466
473,BUMA.1121.00077,2,2886717,2919218,-,32501
473,BUMA.1121.00003,2,3049169,3081770,-,32601
473,BUMA.1121.00104,2,915930,948249,+,32319
473,BUMA.1121.00074,2,146328,178859,-,32531
473,BUMA.1121.00060,2,1403220,1435617,-,32397
473,BUMA.1121.00088,2,765363,797653,+,32290
473,BUMA.1121.00053,2,1054304,1086620,+,32316
473,BUMA.1121.00025,2,208125,240583,-,32458
473,BUMA.1121.00070,2,800293,832719,+,32426
473,BUMA.1121.00049,2,2634716,2667004,+,32288
473,BUMA.1121.00078,2,2371856,2404112,-,32256
473,BUMA.1121.00069,2,798113,830576,+,32463
473,BUMA.1121.00102,2,815859,848166,+,32307
473,BUMA.1121.00112,2,315379,347873,-,32494
473,BUMA.1121.00041,2,1709141,1741419,+,32278
473,BUMA.1121.00068,2,2528482,2560876,+,32394
473,BUMA.1121.00076,2,1707445,1739870,+,32425
473,BUMA.1121.00033,2,1501897,1534239,+,32342
473,BUMA.1121.00101,2,2554976,2587501,-,32525
473,BUMA.1121.00105,2,1668727,1701059,-,32332
473,BUMA.1121.00061,2,790228,822694,+,32466
473,BUMA.1121.00063,2,799459,831770,+,32311
473,BUMA.1121.00059,2,2805715,2838221,-,32506
473,BUMA.1121.00058,2,1372179,1404565,+,32386
473,BUMA.1121.00043,2,1571953,1604422,-,32469
473,BUMA.1121.00055,2,1819800,1852396,-,32596
473,BUMA.1121.00065,2,813587,845986,+,32399
473,BUMA.1121.00064,2,735965,768102,+,32137
473,BUMA.1121.00047,2,1751974,1784362,+,32388
473,BUMA.1121.00037,2,1127066,1159538,+,32472
473,BUMA.1121.00106,2,966676,998964,-,32288
473,BUMA.1121.00051,2,821446,853833,+,32387
473,BUMA.1121.00045,2,658235,690632,+,32397
473,BUMA.1121.00056,2,49683,82071,-,32388
473,BUMA.1121.00095,2,482569,514795,-,32226
473,BUMA.1121.00082,2,828549,861022,+,32473
473,BUMA.1121.00001,2,1411845,1444130,-,32285
473,BUMA.1121.00108,2,1049564,1082022,+,32458
473,BUMA.1121.00083,2,2625506,2657979,+,32473
473,BUMA.1121.00080,2,822652,855031,+,32379
473,BUMA.1121.00012,2,910940,943603,-,32663
474,BUMA.1121.00011,2,2735367,2743923,+,8556
474,BUMA.1121.00009,2,2755817,2764258,+,8441
474,BUMA.1121.00039,2,3100613,3109076,-,8463
474,BUMA.1121.00029,2,515808,524287,-,8479
474,BUMA.1121.00021,2,1318031,1326566,+,8535
474,BUMA.1121.00107,2,3036602,3045035,-,8433
474,BUMA.1121.00023,2,894770,903288,+,8518
474,BUMA.1121.00067,2,3112344,3120871,-,8527
474,BUMA.1121.00035,2,563059,571514,-,8455
474,BUMA.1121.00005,2,2241699,2250101,+,8402
474,BUMA.1121.00100,2,1963674,1972213,+,8539
474,BUMA.1121.00016,2,2971476,2980054,-,8578
474,BUMA.1121.00099,2,1061205,1069655,+,8450
474,BUMA.1121.00094,2,900242,908860,+,8618
474,BUMA.1121.00093,2,2066467,2074925,-,8458
474,BUMA.1121.00097,2,652149,660576,+,8427
474,BUMA.1121.00109,2,546602,555101,-,8499
474,BUMA.1121.00018,2,2941815,2950435,-,8620
474,BUMA.1121.00110,2,1581551,1589954,-,8403
474,BUMA.1121.00079,2,857093,865696,+,8603
474,BUMA.1121.00075,2,1148610,1157159,+,8549
474,BUMA.1121.00066,2,841155,849714,+,8559
474,BUMA.1121.00089,2,845008,853619,+,8611
474,BUMA.1121.00057,2,1224024,1232549,-,8525
474,BUMA.1121.00090,2,1789675,1798201,+,8526
474,BUMA.1121.00027,2,1915564,1924164,+,8600
474,BUMA.1121.00062,2,916675,925177,-,8502
474,BUMA.1121.00091,2,2817769,2826260,-,8491
474,BUMA.1121.00098,2,1057365,1065904,+,8539
474,BUMA.1121.00092,2,870098,878603,+,8505
474,BUMA.1121.00031,2,3257024,3265543,+,8519
474,BUMA.1121.00096,2,1017969,1026478,+,8509
474,BUMA.1121.00073,2,835461,844072,+,8611
474,BUMA.1121.00103,2,2715171,2723679,+,8508
474,BUMA.1121.00084,2,2683596,2692058,+,8462
474,BUMA.1121.00014,2,924474,932976,+,8502
474,BUMA.1121.00111,2,76251,84761,+,8510
474,BUMA.1121.00007,2,898402,906966,+,8564
474,BUMA.1121.00072,2,831802,840320,+,8518
474,BUMA.1121.00071,2,834895,843487,+,8592
474,BUMA.1121.00077,2,2875423,2883827,-,8404
474,BUMA.1121.00003,2,3037865,3046288,-,8423
474,BUMA.1121.00104,2,951079,959568,+,8489
474,BUMA.1121.00074,2,134955,143498,-,8543
474,BUMA.1121.00060,2,1391921,1400350,-,8429
474,BUMA.1121.00088,2,800483,808994,+,8511
474,BUMA.1121.00053,2,1089414,1097854,+,8440
474,BUMA.1121.00025,2,196675,205295,-,8620
474,BUMA.1121.00070,2,835513,844114,+,8601
474,BUMA.1121.00049,2,2669834,2678371,+,8537
474,BUMA.1121.00078,2,2360544,2368992,-,8448
474,BUMA.1121.00069,2,833370,841990,+,8620
474,BUMA.1121.00102,2,850960,859415,+,8455
474,BUMA.1121.00112,2,304061,312501,-,8440
474,BUMA.1121.00041,2,1744249,1752752,+,8503
474,BUMA.1121.00068,2,2563706,2572191,+,8485
474,BUMA.1121.00076,2,1742699,1751248,+,8549
474,BUMA.1121.00033,2,1537069,1545509,+,8440
474,BUMA.1121.00101,2,2543651,2552146,-,8495
474,BUMA.1121.00105,2,1657440,1665903,-,8463
474,BUMA.1121.00061,2,825488,834117,+,8629
474,BUMA.1121.00063,2,834559,843185,+,8626
474,BUMA.1121.00059,2,2794498,2802941,-,8443
474,BUMA.1121.00058,2,1407395,1415936,+,8541
474,BUMA.1121.00043,2,1560595,1569123,-,8528
474,BUMA.1121.00055,2,1808394,1816898,-,8504
474,BUMA.1121.00065,2,848816,857285,+,8469
474,BUMA.1121.00064,2,770932,779439,+,8507
474,BUMA.1121.00047,2,1787192,1795828,+,8636
474,BUMA.1121.00037,2,1162368,1170859,+,8491
474,BUMA.1121.00106,2,955343,963848,-,8505
474,BUMA.1121.00051,2,856661,865277,+,8616
474,BUMA.1121.00045,2,693426,701930,+,8504
474,BUMA.1121.00056,2,38242,46841,-,8599
474,BUMA.1121.00095,2,471316,479775,-,8459
474,BUMA.1121.00082,2,863816,872449,+,8633
474,BUMA.1121.00001,2,1400510,1409015,-,8505
474,BUMA.1121.00108,2,1084807,1093378,+,8571
474,BUMA.1121.00083,2,2660773,2669406,+,8633
474,BUMA.1121.00080,2,857860,866486,+,8626
474,BUMA.1121.00012,2,899517,908110,-,8593
475,BUMA.1121.00011,2,2744275,2762487,+,18212
475,BUMA.1121.00009,2,2764617,2783020,+,18403
475,BUMA.1121.00039,2,3081912,3100261,-,18349
475,BUMA.1121.00029,2,497105,515456,-,18351
475,BUMA.1121.00021,2,1326918,1345281,+,18363
475,BUMA.1121.00107,2,3017904,3036250,-,18346
475,BUMA.1121.00023,2,903640,922015,+,18375
475,BUMA.1121.00067,2,3093568,3111986,-,18418
475,BUMA.1121.00035,2,544356,562707,-,18351
475,BUMA.1121.00005,2,2250460,2268634,+,18174
475,BUMA.1121.00100,2,1972572,1991005,+,18433
475,BUMA.1121.00016,2,2952823,2971124,-,18301
475,BUMA.1121.00099,2,1070014,1088425,+,18411
475,BUMA.1121.00094,2,909212,927590,+,18378
475,BUMA.1121.00093,2,2047768,2066109,-,18341
475,BUMA.1121.00097,2,660935,679121,+,18186
475,BUMA.1121.00109,2,527819,546244,-,18425
475,BUMA.1121.00018,2,2923053,2941463,-,18410
475,BUMA.1121.00110,2,1562807,1581193,-,18386
475,BUMA.1121.00079,2,866048,884467,+,18419
475,BUMA.1121.00075,2,1157518,1175898,+,18380
475,BUMA.1121.00066,2,850073,868451,+,18378
475,BUMA.1121.00089,2,853971,872341,+,18370
475,BUMA.1121.00057,2,1205330,1223666,-,18336
475,BUMA.1121.00090,2,1798553,1816909,+,18356
475,BUMA.1121.00027,2,1924523,1942859,+,18336
475,BUMA.1121.00062,2,897917,916317,-,18400
475,BUMA.1121.00091,2,2799070,2817411,-,18341
475,BUMA.1121.00098,2,1066263,1084598,+,18335
475,BUMA.1121.00092,2,878962,897303,+,18341
475,BUMA.1121.00031,2,1,18324,+,18323
475,BUMA.1121.00096,2,1026837,1045152,+,18315
475,BUMA.1121.00073,2,844431,862795,+,18364
475,BUMA.1121.00103,2,2724038,2742311,+,18273
475,BUMA.1121.00084,2,2692417,2710807,+,18390
475,BUMA.1121.00014,2,933328,951684,+,18356
475,BUMA.1121.00111,2,85113,103480,+,18367
475,BUMA.1121.00007,2,907325,925665,+,18340
475,BUMA.1121.00072,2,840679,859064,+,18385
475,BUMA.1121.00071,2,843846,862232,+,18386
475,BUMA.1121.00077,2,2856682,2875065,-,18383
475,BUMA.1121.00003,2,3019150,3037507,-,18357
475,BUMA.1121.00104,2,959927,978300,+,18373
475,BUMA.1121.00074,2,116223,134597,-,18374
475,BUMA.1121.00060,2,1373139,1391563,-,18424
475,BUMA.1121.00088,2,809353,827743,+,18390
475,BUMA.1121.00053,2,1098213,1116559,+,18346
475,BUMA.1121.00025,2,177913,196323,-,18410
475,BUMA.1121.00070,2,844473,862836,+,18363
475,BUMA.1121.00049,2,2678730,2697116,+,18386
475,BUMA.1121.00078,2,2341775,2360186,-,18411
475,BUMA.1121.00069,2,842349,860725,+,18376
475,BUMA.1121.00102,2,859774,878151,+,18377
475,BUMA.1121.00112,2,285337,303703,-,18366
475,BUMA.1121.00041,2,1753111,1770542,+,17431
475,BUMA.1121.00068,2,2572550,2590891,+,18341
475,BUMA.1121.00076,2,1751607,1769987,+,18380
475,BUMA.1121.00033,2,1545875,1564231,+,18356
475,BUMA.1121.00101,2,2524945,2543293,-,18348
475,BUMA.1121.00105,2,1638708,1657082,-,18374
475,BUMA.1121.00061,2,834476,852840,+,18364
475,BUMA.1121.00063,2,843544,861919,+,18375
475,BUMA.1121.00059,2,2775763,2794140,-,18377
475,BUMA.1121.00058,2,1416295,1434658,+,18363
475,BUMA.1121.00043,2,1541897,1560243,-,18346
475,BUMA.1121.00055,2,1789696,1808036,-,18340
475,BUMA.1121.00065,2,857644,876013,+,18369
475,BUMA.1121.00064,2,779798,798199,+,18401
475,BUMA.1121.00047,2,1796180,1814589,+,18409
475,BUMA.1121.00037,2,1171211,1189574,+,18363
475,BUMA.1121.00106,2,936619,954985,-,18366
475,BUMA.1121.00051,2,865629,884038,+,18409
475,BUMA.1121.00045,2,702289,720713,+,18424
475,BUMA.1121.00056,2,19520,37890,-,18370
475,BUMA.1121.00095,2,452550,470958,-,18408
475,BUMA.1121.00082,2,872808,891205,+,18397
475,BUMA.1121.00001,2,1381807,1400158,-,18351
475,BUMA.1121.00108,2,1093737,1112144,+,18407
475,BUMA.1121.00083,2,2669765,2688162,+,18397
475,BUMA.1121.00080,2,866838,885261,+,18423
475,BUMA.1121.00012,2,880838,899165,-,18327
476,BUMA.1121.00011,2,2768320,2771965,+,3645
476,BUMA.1121.00009,2,2788866,2792508,+,3642
476,BUMA.1121.00039,2,3071088,3076066,-,4978
476,BUMA.1121.00029,2,487641,491283,-,3642
476,BUMA.1121.00021,2,1351114,1354758,+,3644
476,BUMA.1121.00107,2,3008458,3012070,-,3612
476,BUMA.1121.00023,2,927860,931504,+,3644
476,BUMA.1121.00067,2,3084231,3087846,-,3615
476,BUMA.1121.00035,2,534880,538522,-,3642
476,BUMA.1121.00005,2,2274467,2278095,+,3628
476,BUMA.1121.00100,2,1995991,1999622,+,3631
476,BUMA.1121.00016,2,2939723,2943364,-,3641
476,BUMA.1121.00099,2,1095463,1100343,+,4880
476,BUMA.1121.00094,2,933423,937038,+,3615
476,BUMA.1121.00093,2,2038420,2042047,-,3627
476,BUMA.1121.00097,2,684965,688592,+,3627
476,BUMA.1121.00109,2,518337,521981,-,3644
476,BUMA.1121.00018,2,2913563,2917206,-,3643
476,BUMA.1121.00110,2,1553314,1556954,-,3640
476,BUMA.1121.00079,2,890300,893915,+,3615
476,BUMA.1121.00075,2,1181621,1185237,+,3616
476,BUMA.1121.00066,2,874284,877926,+,3642
476,BUMA.1121.00089,2,878174,881789,+,3615
476,BUMA.1121.00057,2,1195866,1199496,-,3630
476,BUMA.1121.00090,2,1822754,1826398,+,3644
476,BUMA.1121.00027,2,1948691,1952322,+,3631
476,BUMA.1121.00062,2,888453,892083,-,3630
476,BUMA.1121.00091,2,2788261,2791888,-,3627
476,BUMA.1121.00098,2,1091753,1095394,+,3641
476,BUMA.1121.00092,2,903023,906651,+,3628
476,BUMA.1121.00031,2,24169,27813,+,3644
476,BUMA.1121.00096,2,1050985,1054615,+,3630
476,BUMA.1121.00073,2,868628,872256,+,3628
476,BUMA.1121.00103,2,2748157,2751801,+,3644
476,BUMA.1121.00084,2,2716528,2720144,+,3616
476,BUMA.1121.00014,2,957529,961173,+,3644
476,BUMA.1121.00111,2,109325,112969,+,3644
476,BUMA.1121.00007,2,931498,935112,+,3614
476,BUMA.1121.00072,2,864897,868539,+,3642
476,BUMA.1121.00071,2,868065,871706,+,3641
476,BUMA.1121.00077,2,2847189,2850829,-,3640
476,BUMA.1121.00003,2,3010540,3014169,-,3629
476,BUMA.1121.00104,2,984023,987666,+,3643
476,BUMA.1121.00074,2,106858,110488,-,3630
476,BUMA.1121.00060,2,1363666,1367307,-,3641
476,BUMA.1121.00088,2,833464,837080,+,3616
476,BUMA.1121.00053,2,1122410,1126040,+,3630
476,BUMA.1121.00025,2,168424,172067,-,3643
476,BUMA.1121.00070,2,868669,872297,+,3628
476,BUMA.1121.00049,2,2704051,2707667,+,3616
476,BUMA.1121.00078,2,2332304,2335934,-,3630
476,BUMA.1121.00069,2,866558,870200,+,3642
476,BUMA.1121.00102,2,883996,887626,+,3630
476,BUMA.1121.00112,2,275873,279503,-,3630
476,BUMA.1121.00041,2,1776395,1780023,+,3628
476,BUMA.1121.00068,2,2596724,2601591,+,4867
476,BUMA.1121.00076,2,1775710,1779326,+,3616
476,BUMA.1121.00033,2,1573696,1577322,+,3626
476,BUMA.1121.00101,2,2515484,2519111,-,3627
476,BUMA.1121.00105,2,1629259,1632874,-,3615
476,BUMA.1121.00061,2,858672,862301,+,3629
476,BUMA.1121.00063,2,867751,871380,+,3629
476,BUMA.1121.00059,2,2766426,2770041,-,3615
476,BUMA.1121.00058,2,1440378,1443994,+,3616
476,BUMA.1121.00043,2,1530187,1533812,-,3625
476,BUMA.1121.00055,2,1779023,1782650,-,3627
476,BUMA.1121.00065,2,881846,885490,+,3644
476,BUMA.1121.00064,2,803920,807536,+,3616
476,BUMA.1121.00047,2,1820422,1824037,+,3615
476,BUMA.1121.00037,2,1195419,1199063,+,3644
476,BUMA.1121.00106,2,927281,930895,-,3614
476,BUMA.1121.00051,2,889871,893486,+,3615
476,BUMA.1121.00045,2,726544,730186,+,3642
476,BUMA.1121.00056,2,10072,13686,-,3614
476,BUMA.1121.00095,2,443199,446828,-,3629
476,BUMA.1121.00082,2,897038,900666,+,3628
476,BUMA.1121.00001,2,1372331,1375973,-,3642
476,BUMA.1121.00108,2,1117977,1121605,+,3628
476,BUMA.1121.00083,2,2693995,2697623,+,3628
476,BUMA.1121.00080,2,891094,894709,+,3615
476,BUMA.1121.00012,2,866662,870305,-,3643
477,BUMA.1121.00011,2,2774630,2782060,+,7430
477,BUMA.1121.00009,2,2795180,2802610,+,7430
477,BUMA.1121.00039,2,3059684,3068423,-,8739
477,BUMA.1121.00029,2,476237,484976,-,8739
477,BUMA.1121.00021,2,1357422,1366183,+,8761
477,BUMA.1121.00107,2,2998300,3005763,-,7463
477,BUMA.1121.00023,2,934168,942908,+,8740
477,BUMA.1121.00067,2,3074109,3081528,-,7419
477,BUMA.1121.00035,2,523476,532215,-,8739
477,BUMA.1121.00005,2,2280774,2288193,+,7419
477,BUMA.1121.00100,2,2002301,2009717,+,7416
477,BUMA.1121.00016,2,2929625,2937058,-,7433
477,BUMA.1121.00099,2,1103008,1110419,+,7411
477,BUMA.1121.00094,2,939741,947139,+,7398
477,BUMA.1121.00093,2,2028316,2035732,-,7416
477,BUMA.1121.00097,2,691270,698618,+,7348
477,BUMA.1121.00109,2,508248,515671,-,7423
477,BUMA.1121.00018,2,2902159,2910898,-,8739
477,BUMA.1121.00110,2,1543190,1550617,-,7427
477,BUMA.1121.00079,2,896617,904015,+,7398
477,BUMA.1121.00075,2,1187939,1195358,+,7419
477,BUMA.1121.00066,2,880599,888019,+,7420
477,BUMA.1121.00089,2,884491,891889,+,7398
477,BUMA.1121.00057,2,1185768,1193186,-,7418
477,BUMA.1121.00090,2,1829062,1837802,+,8740
477,BUMA.1121.00027,2,1955000,1962430,+,7430
477,BUMA.1121.00062,2,878354,885773,-,7419
477,BUMA.1121.00091,2,2778162,2785581,-,7419
477,BUMA.1121.00098,2,1098067,1105498,+,7431
477,BUMA.1121.00092,2,909338,916755,+,7417
477,BUMA.1121.00031,2,30477,39197,+,8720
477,BUMA.1121.00096,2,1057302,1064689,+,7387
477,BUMA.1121.00073,2,874943,882363,+,7420
477,BUMA.1121.00103,2,2754489,2761863,+,7374
477,BUMA.1121.00084,2,2722846,2730280,+,7434
477,BUMA.1121.00014,2,963837,972557,+,8720
477,BUMA.1121.00111,2,115633,123060,+,7427
477,BUMA.1121.00007,2,937806,945248,+,7442
477,BUMA.1121.00072,2,871212,878632,+,7420
477,BUMA.1121.00071,2,874379,881799,+,7420
477,BUMA.1121.00077,2,2837066,2844495,-,7429
477,BUMA.1121.00003,2,3000457,3007860,-,7403
477,BUMA.1121.00104,2,990338,997758,+,7420
477,BUMA.1121.00074,2,96758,104170,-,7412
477,BUMA.1121.00060,2,1353582,1360992,-,7410
477,BUMA.1121.00088,2,839782,847195,+,7413
477,BUMA.1121.00053,2,1128718,1136141,+,7423
477,BUMA.1121.00025,2,157020,165759,-,8739
477,BUMA.1121.00070,2,874984,882404,+,7420
477,BUMA.1121.00049,2,2710361,2717791,+,7430
477,BUMA.1121.00078,2,2322194,2329616,-,7422
477,BUMA.1121.00069,2,872873,880293,+,7420
477,BUMA.1121.00102,2,890304,897727,+,7423
477,BUMA.1121.00112,2,264378,271808,-,7430
477,BUMA.1121.00041,2,1782701,1790126,+,7425
477,BUMA.1121.00068,2,2604278,2611692,+,7414
477,BUMA.1121.00076,2,1782028,1789448,+,7420
477,BUMA.1121.00033,2,1579999,1587412,+,7413
477,BUMA.1121.00101,2,2505352,2512764,-,7412
477,BUMA.1121.00105,2,1619001,1626419,-,7418
477,BUMA.1121.00061,2,864988,872408,+,7420
477,BUMA.1121.00063,2,874067,881487,+,7420
477,BUMA.1121.00059,2,2756304,2763723,-,7419
477,BUMA.1121.00058,2,1446696,1454131,+,7435
477,BUMA.1121.00043,2,1520067,1527507,-,7440
477,BUMA.1121.00055,2,1768946,1776343,-,7397
477,BUMA.1121.00065,2,888162,895538,+,7376
477,BUMA.1121.00064,2,810238,817669,+,7431
477,BUMA.1121.00047,2,1826739,1834137,+,7398
477,BUMA.1121.00037,2,1202998,1210324,+,7326
477,BUMA.1121.00106,2,917159,924578,-,7419
477,BUMA.1121.00051,2,896188,903586,+,7398
477,BUMA.1121.00045,2,732859,740270,+,7411
477,BUMA.1121.00056,2,1,7369,-,7368
477,BUMA.1121.00095,2,433107,440519,-,7412
477,BUMA.1121.00082,2,903353,910773,+,7420
477,BUMA.1121.00001,2,1360927,1369666,-,8739
477,BUMA.1121.00108,2,1124291,1131711,+,7420
477,BUMA.1121.00083,2,2700310,2707730,+,7420
477,BUMA.1121.00080,2,897411,904809,+,7398
477,BUMA.1121.00012,2,856571,863997,-,7426
478,BUMA.1121.00011,2,2782061,2818371,+,36310
478,BUMA.1121.00009,2,2802611,2838881,+,36270
478,BUMA.1121.00039,2,3023383,3059682,-,36299
478,BUMA.1121.00029,2,439956,476235,-,36279
478,BUMA.1121.00021,2,1366184,1402479,+,36295
478,BUMA.1121.00107,2,2962008,2998298,-,36290
478,BUMA.1121.00023,2,942909,979193,+,36284
478,BUMA.1121.00067,2,3037818,3074107,-,36289
478,BUMA.1121.00035,2,487188,523474,-,36286
478,BUMA.1121.00005,2,2288194,2324452,+,36258
478,BUMA.1121.00100,2,2009718,2046007,+,36289
478,BUMA.1121.00016,2,2893356,2929623,-,36267
478,BUMA.1121.00099,2,1110420,1146714,+,36294
478,BUMA.1121.00094,2,947140,983419,+,36279
478,BUMA.1121.00093,2,1992053,2028314,-,36261
478,BUMA.1121.00097,2,698619,734910,+,36291
478,BUMA.1121.00109,2,471941,508246,-,36305
478,BUMA.1121.00018,2,2865867,2902157,-,36290
478,BUMA.1121.00110,2,1506886,1543188,-,36302
478,BUMA.1121.00079,2,904016,940305,+,36289
478,BUMA.1121.00075,2,1195359,1231652,+,36293
478,BUMA.1121.00066,2,888020,924316,+,36296
478,BUMA.1121.00089,2,891890,928180,+,36290
478,BUMA.1121.00057,2,1149422,1185766,-,36344
478,BUMA.1121.00090,2,1837803,1874108,+,36305
478,BUMA.1121.00027,2,1962431,1998740,+,36309
478,BUMA.1121.00062,2,842058,878352,-,36294
478,BUMA.1121.00091,2,2741869,2778160,-,36291
478,BUMA.1121.00098,2,1105499,1141808,+,36309
478,BUMA.1121.00092,2,916756,953018,+,36262
478,BUMA.1121.00031,2,39198,75475,+,36277
478,BUMA.1121.00096,2,1064690,1100987,+,36297
478,BUMA.1121.00073,2,882364,918651,+,36287
478,BUMA.1121.00103,2,2761864,2798138,+,36274
478,BUMA.1121.00084,2,2730281,2766549,+,36268
478,BUMA.1121.00014,2,972558,1008837,+,36279
478,BUMA.1121.00111,2,123061,159347,+,36286
478,BUMA.1121.00007,2,945249,981539,+,36290
478,BUMA.1121.00072,2,878633,914860,+,36227
478,BUMA.1121.00071,2,881800,918064,+,36264
478,BUMA.1121.00077,2,2800763,2837064,-,36301
478,BUMA.1121.00003,2,2964188,3000455,-,36267
478,BUMA.1121.00104,2,997759,1034064,+,36305
478,BUMA.1121.00074,2,60479,96756,-,36277
478,BUMA.1121.00060,2,1317313,1353580,-,36267
478,BUMA.1121.00088,2,847196,883470,+,36274
478,BUMA.1121.00053,2,1136142,1172447,+,36305
478,BUMA.1121.00025,2,120728,157018,-,36290
478,BUMA.1121.00070,2,882405,918670,+,36265
478,BUMA.1121.00049,2,2717792,2754065,+,36273
478,BUMA.1121.00078,2,2285859,2322192,-,36333
478,BUMA.1121.00069,2,880294,916570,+,36276
478,BUMA.1121.00102,2,897728,934042,+,36314
478,BUMA.1121.00112,2,228102,264376,-,36274
478,BUMA.1121.00041,2,1790127,1826426,+,36299
478,BUMA.1121.00068,2,2611693,2647968,+,36275
478,BUMA.1121.00076,2,1789449,1825713,+,36264
478,BUMA.1121.00033,2,1587413,1623714,+,36301
478,BUMA.1121.00101,2,2469085,2505350,-,36265
478,BUMA.1121.00105,2,1582740,1618999,-,36259
478,BUMA.1121.00061,2,872409,908696,+,36287
478,BUMA.1121.00063,2,881488,917778,+,36290
478,BUMA.1121.00059,2,2720016,2756302,-,36286
478,BUMA.1121.00058,2,1454132,1490408,+,36276
478,BUMA.1121.00043,2,1483758,1520065,-,36307
478,BUMA.1121.00055,2,1732643,1768944,-,36301
478,BUMA.1121.00065,2,895539,931817,+,36278
478,BUMA.1121.00064,2,817670,853948,+,36278
478,BUMA.1121.00047,2,1834138,1870440,+,36302
478,BUMA.1121.00037,2,1210325,1246615,+,36290
478,BUMA.1121.00106,2,880819,917157,-,36338
478,BUMA.1121.00051,2,903587,939874,+,36287
478,BUMA.1121.00045,2,740271,776546,+,36275
478,BUMA.1121.00056,2,3065821,3102126,-,36305
478,BUMA.1121.00095,2,396808,433105,-,36297
478,BUMA.1121.00082,2,910774,947070,+,36296
478,BUMA.1121.00001,2,1324637,1360925,-,36288
478,BUMA.1121.00108,2,1131712,1167991,+,36279
478,BUMA.1121.00083,2,2707731,2744027,+,36296
478,BUMA.1121.00080,2,904810,941107,+,36297
478,BUMA.1121.00012,2,820301,856569,-,36268
479,BUMA.1121.00011,2,2818372,2825534,+,7162
479,BUMA.1121.00009,2,2838882,2846489,+,7607
479,BUMA.1121.00039,2,3016058,3023381,-,7323
479,BUMA.1121.00029,2,430213,437548,-,7335
479,BUMA.1121.00021,2,1402480,1409798,+,7318
479,BUMA.1121.00107,2,2954783,2962006,-,7223
479,BUMA.1121.00023,2,979194,986511,+,7317
479,BUMA.1121.00067,2,3030658,3037816,-,7158
479,BUMA.1121.00035,2,407410,414745,-,7335
479,BUMA.1121.00005,2,2324453,2331770,+,7317
479,BUMA.1121.00100,2,2046008,2053206,+,7198
479,BUMA.1121.00016,2,2814519,2821850,-,7331
479,BUMA.1121.00099,2,1146715,1154058,+,7343
479,BUMA.1121.00094,2,983420,990585,+,7165
479,BUMA.1121.00093,2,1984737,1992051,-,7314
479,BUMA.1121.00097,2,734911,742254,+,7343
479,BUMA.1121.00109,2,464737,471939,-,7202
479,BUMA.1121.00018,2,2858550,2865865,-,7315
479,BUMA.1121.00110,2,1499383,1506884,-,7501
479,BUMA.1121.00079,2,940306,947465,+,7159
479,BUMA.1121.00075,2,1231653,1238811,+,7158
479,BUMA.1121.00066,2,924317,931645,+,7328
479,BUMA.1121.00089,2,928181,935345,+,7164
479,BUMA.1121.00057,2,1142241,1149420,-,7179
479,BUMA.1121.00090,2,1874109,1881426,+,7317
479,BUMA.1121.00027,2,1998741,2006069,+,7328
479,BUMA.1121.00062,2,834891,842056,-,7165
479,BUMA.1121.00091,2,2734521,2741867,-,7346
479,BUMA.1121.00098,2,1141809,1149013,+,7204
479,BUMA.1121.00092,2,953019,960334,+,7315
479,BUMA.1121.00031,2,75476,82792,+,7316
479,BUMA.1121.00096,2,1100988,1108180,+,7192
479,BUMA.1121.00073,2,918652,925980,+,7328
479,BUMA.1121.00103,2,2798139,2805333,+,7194
479,BUMA.1121.00084,2,2766550,2773709,+,7159
479,BUMA.1121.00014,2,1008838,1016155,+,7317
479,BUMA.1121.00111,2,159348,166663,+,7315
479,BUMA.1121.00007,2,981540,988846,+,7306
479,BUMA.1121.00072,2,914861,922189,+,7328
479,BUMA.1121.00071,2,918065,925393,+,7328
479,BUMA.1121.00077,2,2793260,2800761,-,7501
479,BUMA.1121.00003,2,2956861,2964186,-,7325
479,BUMA.1121.00104,2,1034065,1041390,+,7325
479,BUMA.1121.00074,2,53319,60477,-,7158
479,BUMA.1121.00060,2,1309996,1317311,-,7315
479,BUMA.1121.00088,2,883471,890635,+,7164
479,BUMA.1121.00053,2,1172448,1179628,+,7180
479,BUMA.1121.00025,2,113411,120726,-,7315
479,BUMA.1121.00070,2,918671,925999,+,7328
479,BUMA.1121.00049,2,2754066,2761396,+,7330
479,BUMA.1121.00078,2,2278678,2285857,-,7179
479,BUMA.1121.00069,2,916571,923899,+,7328
479,BUMA.1121.00102,2,934043,941223,+,7180
479,BUMA.1121.00112,2,220784,228100,-,7316
479,BUMA.1121.00041,2,1826427,1833755,+,7328
479,BUMA.1121.00068,2,2647969,2655154,+,7185
479,BUMA.1121.00076,2,1825714,1832873,+,7159
479,BUMA.1121.00033,2,1623715,1631036,+,7321
479,BUMA.1121.00101,2,2461757,2469083,-,7326
479,BUMA.1121.00105,2,1575432,1582738,-,7306
479,BUMA.1121.00061,2,908697,916025,+,7328
479,BUMA.1121.00063,2,917779,925106,+,7327
479,BUMA.1121.00059,2,2712856,2720014,-,7158
479,BUMA.1121.00058,2,1490409,1497589,+,7180
479,BUMA.1121.00043,2,1476437,1483756,-,7319
479,BUMA.1121.00055,2,1725320,1732641,-,7321
479,BUMA.1121.00065,2,931818,939142,+,7324
479,BUMA.1121.00064,2,853949,861108,+,7159
479,BUMA.1121.00047,2,1870441,1877605,+,7164
479,BUMA.1121.00037,2,1246616,1253935,+,7319
479,BUMA.1121.00106,2,873660,880817,-,7157
479,BUMA.1121.00051,2,939875,947038,+,7163
479,BUMA.1121.00045,2,776547,783863,+,7316
479,BUMA.1121.00056,2,3058656,3065819,-,7163
479,BUMA.1121.00095,2,389633,396806,-,7173
479,BUMA.1121.00082,2,947071,954399,+,7328
479,BUMA.1121.00001,2,1317318,1324635,-,7317
479,BUMA.1121.00108,2,1167992,1175316,+,7324
479,BUMA.1121.00083,2,2744028,2751356,+,7328
479,BUMA.1121.00080,2,941108,948272,+,7164
479,BUMA.1121.00012,2,812983,820299,-,7316
480,BUMA.1121.00011,2,2825689,2851916,+,26227
480,BUMA.1121.00009,2,2846572,2872775,+,26203
480,BUMA.1121.00039,2,2989386,3016012,-,26626
480,BUMA.1121.00029,2,403796,430169,-,26373
480,BUMA.1121.00021,2,1409895,1436117,+,26222
480,BUMA.1121.00107,2,2928393,2954739,-,26346
480,BUMA.1121.00023,2,986636,1012852,+,26216
480,BUMA.1121.00067,2,3004488,3030614,-,26126
480,BUMA.1121.00035,2,380984,407366,-,26382
480,BUMA.1121.00005,2,2331873,2358149,+,26276
480,BUMA.1121.00100,2,2053289,2079405,+,26116
480,BUMA.1121.00016,2,2788094,2814473,-,26379
480,BUMA.1121.00099,2,1154161,1180402,+,26241
480,BUMA.1121.00094,2,990700,1016822,+,26122
480,BUMA.1121.00093,2,1958374,1984693,-,26319
480,BUMA.1121.00097,2,742349,768471,+,26122
480,BUMA.1121.00109,2,438416,464693,-,26277
480,BUMA.1121.00018,2,2832346,2858506,-,26160
480,BUMA.1121.00110,2,1473114,1499339,-,26225
480,BUMA.1121.00079,2,947586,973798,+,26212
480,BUMA.1121.00075,2,1238938,1265274,+,26336
480,BUMA.1121.00066,2,933353,959483,+,26130
480,BUMA.1121.00089,2,935478,961606,+,26128
480,BUMA.1121.00057,2,1115971,1142197,-,26226
480,BUMA.1121.00090,2,1881569,1907891,+,26322
480,BUMA.1121.00027,2,2007777,2033916,+,26139
480,BUMA.1121.00062,2,808539,834847,-,26308
480,BUMA.1121.00091,2,2708208,2734475,-,26267
480,BUMA.1121.00098,2,1149096,1175304,+,26208
480,BUMA.1121.00092,2,960465,986697,+,26232
480,BUMA.1121.00031,2,82953,109213,+,26260
480,BUMA.1121.00096,2,1108293,1134408,+,26115
480,BUMA.1121.00073,2,927688,953824,+,26136
480,BUMA.1121.00103,2,2807023,2833232,+,26209
480,BUMA.1121.00084,2,2773755,2800012,+,26257
480,BUMA.1121.00014,2,1016269,1042534,+,26265
480,BUMA.1121.00111,2,166806,193006,+,26200
480,BUMA.1121.00007,2,988955,1015104,+,26149
480,BUMA.1121.00072,2,923885,950012,+,26127
480,BUMA.1121.00071,2,927097,953127,+,26030
480,BUMA.1121.00077,2,2766991,2793216,-,26225
480,BUMA.1121.00003,2,2930635,2956815,-,26180
480,BUMA.1121.00104,2,1041479,1067581,+,26102
480,BUMA.1121.00074,2,27113,53275,-,26162
480,BUMA.1121.00060,2,1283812,1309952,-,26140
480,BUMA.1121.00088,2,890768,917146,+,26378
480,BUMA.1121.00053,2,1179743,1205937,+,26194
480,BUMA.1121.00025,2,87215,113367,-,26152
480,BUMA.1121.00070,2,927706,953842,+,26136
480,BUMA.1121.00049,2,2761497,2787608,+,26111
480,BUMA.1121.00078,2,2252212,2278632,-,26420
480,BUMA.1121.00069,2,925607,951730,+,26123
480,BUMA.1121.00102,2,941398,967641,+,26243
480,BUMA.1121.00112,2,194556,220740,-,26184
480,BUMA.1121.00041,2,1835395,1861794,+,26399
480,BUMA.1121.00068,2,2655275,2681355,+,26080
480,BUMA.1121.00076,2,1833006,1859357,+,26351
480,BUMA.1121.00033,2,1631137,1657291,+,26154
480,BUMA.1121.00101,2,2435430,2461713,-,26283
480,BUMA.1121.00105,2,1549179,1575386,-,26207
480,BUMA.1121.00061,2,917733,943860,+,26127
480,BUMA.1121.00063,2,926811,952927,+,26116
480,BUMA.1121.00059,2,2686384,2712812,-,26428
480,BUMA.1121.00058,2,1497714,1523921,+,26207
480,BUMA.1121.00043,2,1450233,1476393,-,26160
480,BUMA.1121.00055,2,1698952,1725274,-,26322
480,BUMA.1121.00065,2,939245,965422,+,26177
480,BUMA.1121.00064,2,861209,887262,+,26053
480,BUMA.1121.00047,2,1877726,1903830,+,26104
480,BUMA.1121.00037,2,1254065,1280283,+,26218
480,BUMA.1121.00106,2,845708,872020,-,26312
480,BUMA.1121.00051,2,947189,973327,+,26138
480,BUMA.1121.00045,2,783970,810053,+,26083
480,BUMA.1121.00056,2,3032395,3058610,-,26215
480,BUMA.1121.00095,2,363903,389589,-,25686
480,BUMA.1121.00082,2,956107,982246,+,26139
480,BUMA.1121.00001,2,1290834,1317274,-,26440
480,BUMA.1121.00108,2,1175399,1201467,+,26068
480,BUMA.1121.00083,2,2753064,2779203,+,26139
480,BUMA.1121.00080,2,948411,974521,+,26110
480,BUMA.1121.00012,2,786545,812937,-,26392
481,BUMA.1121.00011,2,2853265,2869700,+,16435
481,BUMA.1121.00009,2,2874975,2891387,+,16412
481,BUMA.1121.00039,2,2970817,2987194,-,16377
481,BUMA.1121.00029,2,385197,401606,-,16409
481,BUMA.1121.00021,2,1438309,1454701,+,16392
481,BUMA.1121.00107,2,2909718,2926192,-,16474
481,BUMA.1121.00023,2,1015042,1031451,+,16409
481,BUMA.1121.00067,2,2985846,3002280,-,16434
481,BUMA.1121.00035,2,362390,378794,-,16404
481,BUMA.1121.00005,2,2359523,2375947,+,16424
481,BUMA.1121.00100,2,2080763,2097171,+,16408
481,BUMA.1121.00016,2,2769498,2785904,-,16406
481,BUMA.1121.00099,2,1182594,1198980,+,16386
481,BUMA.1121.00094,2,1018178,1034628,+,16450
481,BUMA.1121.00093,2,1940599,1957000,-,16401
481,BUMA.1121.00097,2,769880,786280,+,16400
481,BUMA.1121.00109,2,420678,437069,-,16391
481,BUMA.1121.00018,2,2813759,2830156,-,16397
481,BUMA.1121.00110,2,1454597,1470924,-,16327
481,BUMA.1121.00079,2,975154,991594,+,16440
481,BUMA.1121.00075,2,1266639,1283081,+,16442
481,BUMA.1121.00066,2,960849,977240,+,16391
481,BUMA.1121.00089,2,962962,979412,+,16450
481,BUMA.1121.00057,2,1097367,1113772,-,16405
481,BUMA.1121.00090,2,1910081,1926505,+,16424
481,BUMA.1121.00027,2,2036114,2052560,+,16446
481,BUMA.1121.00062,2,790744,807164,-,16420
481,BUMA.1121.00091,2,2690397,2706834,-,16437
481,BUMA.1121.00098,2,1177513,1193867,+,16354
481,BUMA.1121.00092,2,988071,1004472,+,16401
481,BUMA.1121.00031,2,111403,127827,+,16424
481,BUMA.1121.00096,2,1135776,1152179,+,16403
481,BUMA.1121.00073,2,955192,971583,+,16391
481,BUMA.1121.00103,2,2835425,2851841,+,16416
481,BUMA.1121.00084,2,2802220,2818663,+,16443
481,BUMA.1121.00014,2,1044724,1061133,+,16409
481,BUMA.1121.00111,2,195198,211626,+,16428
481,BUMA.1121.00007,2,1017294,1033743,+,16449
481,BUMA.1121.00072,2,951379,967769,+,16390
481,BUMA.1121.00071,2,954493,970884,+,16391
481,BUMA.1121.00077,2,2748474,2764801,-,16327
481,BUMA.1121.00003,2,2911954,2928417,-,16463
481,BUMA.1121.00104,2,1068955,1085350,+,16395
481,BUMA.1121.00074,2,8492,24905,-,16413
481,BUMA.1121.00060,2,1266005,1282454,-,16449
481,BUMA.1121.00088,2,919354,935771,+,16417
481,BUMA.1121.00053,2,1207302,1223715,+,16413
481,BUMA.1121.00025,2,68628,85025,-,16397
481,BUMA.1121.00070,2,955208,971599,+,16391
481,BUMA.1121.00049,2,2789816,2806203,+,16387
481,BUMA.1121.00078,2,2234454,2250854,-,16400
481,BUMA.1121.00069,2,953096,969487,+,16391
481,BUMA.1121.00102,2,969006,985490,+,16484
481,BUMA.1121.00112,2,175875,192365,-,16490
481,BUMA.1121.00041,2,1863169,1879625,+,16456
481,BUMA.1121.00068,2,2682711,2699140,+,16429
481,BUMA.1121.00076,2,1860722,1877165,+,16443
481,BUMA.1121.00033,2,1659481,1675873,+,16392
481,BUMA.1121.00101,2,2417624,2434053,-,16429
481,BUMA.1121.00105,2,1530533,1546971,-,16438
481,BUMA.1121.00061,2,945227,961617,+,16390
481,BUMA.1121.00063,2,954294,970681,+,16387
481,BUMA.1121.00059,2,2667729,2684176,-,16447
481,BUMA.1121.00058,2,1525278,1541687,+,16409
481,BUMA.1121.00043,2,1431635,1448043,-,16408
481,BUMA.1121.00055,2,1680306,1696762,-,16456
481,BUMA.1121.00065,2,966796,983228,+,16432
481,BUMA.1121.00064,2,889479,905837,+,16358
481,BUMA.1121.00047,2,1905186,1921631,+,16445
481,BUMA.1121.00037,2,1282473,1298882,+,16409
481,BUMA.1121.00106,2,827876,844334,-,16458
481,BUMA.1121.00051,2,974683,991124,+,16441
481,BUMA.1121.00045,2,811411,827860,+,16449
481,BUMA.1121.00056,2,3014589,3031039,-,16450
481,BUMA.1121.00095,2,345285,361704,-,16419
481,BUMA.1121.00082,2,984445,1000836,+,16391
481,BUMA.1121.00001,2,1272235,1288644,-,16409
481,BUMA.1121.00108,2,1203657,1220017,+,16360
481,BUMA.1121.00083,2,2781402,2797793,+,16391
481,BUMA.1121.00080,2,975877,992318,+,16441
481,BUMA.1121.00012,2,767926,784355,-,16429
482,BUMA.1121.00011,2,2873840,2878150,+,4310
482,BUMA.1121.00009,2,2895528,2899837,+,4309
482,BUMA.1121.00039,2,2958484,2962783,-,4299
482,BUMA.1121.00029,2,321120,325419,-,4299
482,BUMA.1121.00021,2,1513132,1517431,+,4299
482,BUMA.1121.00107,2,2846957,2851267,-,4310
482,BUMA.1121.00023,2,1089244,1093553,+,4309
482,BUMA.1121.00067,2,2977395,2981704,-,4309
482,BUMA.1121.00035,2,299665,303964,-,4299
482,BUMA.1121.00005,2,2428765,2433064,+,4299
482,BUMA.1121.00100,2,2101310,2105619,+,4309
482,BUMA.1121.00016,2,2706772,2711071,-,4299
482,BUMA.1121.00099,2,1257378,1261687,+,4309
482,BUMA.1121.00094,2,1038769,1043081,+,4312
482,BUMA.1121.00093,2,1932148,1936457,-,4309
482,BUMA.1121.00097,2,844751,849060,+,4309
482,BUMA.1121.00109,2,412228,416537,-,4309
482,BUMA.1121.00018,2,2804218,2808527,-,4309
482,BUMA.1121.00110,2,1391848,1396157,-,4309
482,BUMA.1121.00079,2,995735,1000047,+,4312
482,BUMA.1121.00075,2,1287221,1291520,+,4299
482,BUMA.1121.00066,2,980946,985256,+,4310
482,BUMA.1121.00089,2,983553,987865,+,4312
482,BUMA.1121.00057,2,1088926,1093225,-,4299
482,BUMA.1121.00090,2,1984931,1989230,+,4299
482,BUMA.1121.00027,2,2056701,2060999,+,4298
482,BUMA.1121.00062,2,782292,786601,-,4309
482,BUMA.1121.00091,2,2627655,2631964,-,4309
482,BUMA.1121.00098,2,1252281,1256510,+,4229
482,BUMA.1121.00092,2,1008613,1012922,+,4309
482,BUMA.1121.00031,2,186249,190548,+,4299
482,BUMA.1121.00096,2,1210600,1214909,+,4309
482,BUMA.1121.00073,2,975289,979599,+,4310
482,BUMA.1121.00103,2,2910310,2914617,+,4307
482,BUMA.1121.00084,2,2822804,2827113,+,4309
482,BUMA.1121.00014,2,1119553,1123852,+,4299
482,BUMA.1121.00111,2,270887,275186,+,4299
482,BUMA.1121.00007,2,1037884,1042193,+,4309
482,BUMA.1121.00072,2,971475,975785,+,4310
482,BUMA.1121.00071,2,974589,978899,+,4310
482,BUMA.1121.00077,2,2685729,2690037,-,4308
482,BUMA.1121.00003,2,2903504,2907813,-,4309
482,BUMA.1121.00104,2,1089490,1093789,+,4299
482,BUMA.1121.00074,2,27,4350,-,4323
482,BUMA.1121.00060,2,1203265,1207574,-,4309
482,BUMA.1121.00088,2,939912,944221,+,4309
482,BUMA.1121.00053,2,1282151,1286460,+,4309
482,BUMA.1121.00025,2,59087,63396,-,4309
482,BUMA.1121.00070,2,975305,979615,+,4310
482,BUMA.1121.00049,2,2810342,2814651,+,4309
482,BUMA.1121.00078,2,2171737,2176036,-,4299
482,BUMA.1121.00069,2,973192,977502,+,4310
482,BUMA.1121.00102,2,1045265,1049574,+,4309
482,BUMA.1121.00112,2,113099,117408,-,4309
482,BUMA.1121.00041,2,1938063,1942372,+,4309
482,BUMA.1121.00068,2,2703281,2707590,+,4309
482,BUMA.1121.00076,2,1881305,1885604,+,4299
482,BUMA.1121.00033,2,1734303,1738612,+,4309
482,BUMA.1121.00101,2,2409172,2413482,-,4310
482,BUMA.1121.00105,2,1522092,1526391,-,4299
482,BUMA.1121.00061,2,965322,969632,+,4310
482,BUMA.1121.00063,2,974386,978696,+,4310
482,BUMA.1121.00059,2,2659278,2663587,-,4309
482,BUMA.1121.00058,2,1545828,1550136,+,4308
482,BUMA.1121.00043,2,1368911,1373210,-,4299
482,BUMA.1121.00055,2,1671854,1676163,-,4309
482,BUMA.1121.00065,2,1041674,1045983,+,4309
482,BUMA.1121.00064,2,909978,914287,+,4309
482,BUMA.1121.00047,2,1925772,1930084,+,4312
482,BUMA.1121.00037,2,1357304,1361601,+,4297
482,BUMA.1121.00106,2,819425,823734,-,4309
482,BUMA.1121.00051,2,995264,999576,+,4312
482,BUMA.1121.00045,2,886290,890599,+,4309
482,BUMA.1121.00056,2,3006135,3010447,-,4312
482,BUMA.1121.00095,2,282539,286838,-,4299
482,BUMA.1121.00082,2,1004975,1009285,+,4310
482,BUMA.1121.00001,2,1209513,1213812,-,4299
482,BUMA.1121.00108,2,1224157,1228466,+,4309
482,BUMA.1121.00083,2,2801932,2806242,+,4310
482,BUMA.1121.00080,2,996459,1000771,+,4312
482,BUMA.1121.00012,2,703848,708157,-,4309
483,BUMA.1121.00011,2,2878613,2884244,+,5631
483,BUMA.1121.00009,2,2900300,2905949,+,5649
483,BUMA.1121.00039,2,2952389,2958021,-,5632
483,BUMA.1121.00029,2,315025,320657,-,5632
483,BUMA.1121.00021,2,1517894,1523525,+,5631
483,BUMA.1121.00107,2,2840863,2846494,-,5631
483,BUMA.1121.00023,2,1094007,1099631,+,5624
483,BUMA.1121.00067,2,2971300,2976932,-,5632
483,BUMA.1121.00035,2,293570,299202,-,5632
483,BUMA.1121.00005,2,2433527,2439171,+,5644
483,BUMA.1121.00100,2,2106082,2111707,+,5625
483,BUMA.1121.00016,2,2700677,2706309,-,5632
483,BUMA.1121.00099,2,1262150,1267793,+,5643
483,BUMA.1121.00094,2,1043544,1049182,+,5638
483,BUMA.1121.00093,2,1926053,1931685,-,5632
483,BUMA.1121.00097,2,849523,855155,+,5632
483,BUMA.1121.00109,2,406134,411765,-,5631
483,BUMA.1121.00018,2,2798132,2803755,-,5623
483,BUMA.1121.00110,2,1385754,1391385,-,5631
483,BUMA.1121.00079,2,1000510,1006141,+,5631
483,BUMA.1121.00075,2,1291983,1297615,+,5632
483,BUMA.1121.00066,2,985719,991351,+,5632
483,BUMA.1121.00089,2,988328,993966,+,5638
483,BUMA.1121.00057,2,1082829,1088463,-,5634
483,BUMA.1121.00090,2,1989693,1995325,+,5632
483,BUMA.1121.00027,2,2061462,2067106,+,5644
483,BUMA.1121.00062,2,776198,781829,-,5631
483,BUMA.1121.00091,2,2621560,2627192,-,5632
483,BUMA.1121.00098,2,1256973,1262598,+,5625
483,BUMA.1121.00092,2,1013385,1019017,+,5632
483,BUMA.1121.00031,2,191011,196637,+,5626
483,BUMA.1121.00096,2,1215372,1221009,+,5637
483,BUMA.1121.00073,2,980062,985694,+,5632
483,BUMA.1121.00103,2,2915080,2920712,+,5632
483,BUMA.1121.00084,2,2827576,2833213,+,5637
483,BUMA.1121.00014,2,1124315,1129941,+,5626
483,BUMA.1121.00111,2,275649,281265,+,5616
483,BUMA.1121.00007,2,1042656,1048294,+,5638
483,BUMA.1121.00072,2,976248,981879,+,5631
483,BUMA.1121.00071,2,979362,984994,+,5632
483,BUMA.1121.00077,2,2679635,2685264,-,5629
483,BUMA.1121.00003,2,2897403,2903041,-,5638
483,BUMA.1121.00104,2,1094252,1099884,+,5632
483,BUMA.1121.00074,2,3357075,3362707,-,5632
483,BUMA.1121.00060,2,1197176,1202802,-,5626
483,BUMA.1121.00088,2,944684,950318,+,5634
483,BUMA.1121.00053,2,1286923,1292555,+,5632
483,BUMA.1121.00025,2,53001,58624,-,5623
483,BUMA.1121.00070,2,980078,985710,+,5632
483,BUMA.1121.00049,2,2815114,2820758,+,5644
483,BUMA.1121.00078,2,2165636,2171274,-,5638
483,BUMA.1121.00069,2,977965,983597,+,5632
483,BUMA.1121.00102,2,1050037,1055669,+,5632
483,BUMA.1121.00112,2,107010,112636,-,5626
483,BUMA.1121.00041,2,1942835,1948467,+,5632
483,BUMA.1121.00068,2,2708053,2713678,+,5625
483,BUMA.1121.00076,2,1886067,1891699,+,5632
483,BUMA.1121.00033,2,1739075,1744707,+,5632
483,BUMA.1121.00101,2,2403066,2408709,-,5643
483,BUMA.1121.00105,2,1515988,1521629,-,5641
483,BUMA.1121.00061,2,970095,975727,+,5632
483,BUMA.1121.00063,2,979159,984791,+,5632
483,BUMA.1121.00059,2,2653183,2658815,-,5632
483,BUMA.1121.00058,2,1550599,1556231,+,5632
483,BUMA.1121.00043,2,1362807,1368448,-,5641
483,BUMA.1121.00055,2,1665747,1671391,-,5644
483,BUMA.1121.00065,2,1046446,1052089,+,5643
483,BUMA.1121.00064,2,914750,920382,+,5632
483,BUMA.1121.00047,2,1930547,1936185,+,5638
483,BUMA.1121.00037,2,1362064,1367690,+,5626
483,BUMA.1121.00106,2,813330,818962,-,5632
483,BUMA.1121.00051,2,1000039,1005677,+,5638
483,BUMA.1121.00045,2,891062,896688,+,5626
483,BUMA.1121.00056,2,3000034,3005672,-,5638
483,BUMA.1121.00095,2,276447,282078,-,5631
483,BUMA.1121.00082,2,1009748,1015380,+,5632
483,BUMA.1121.00001,2,1203418,1209050,-,5632
483,BUMA.1121.00108,2,1228929,1234566,+,5637
483,BUMA.1121.00083,2,2806705,2812337,+,5632
483,BUMA.1121.00080,2,1001234,1006872,+,5638
483,BUMA.1121.00012,2,697753,703385,-,5632
484,BUMA.1121.00011,2,2885443,2898936,+,13493
484,BUMA.1121.00009,2,2907129,2920635,+,13506
484,BUMA.1121.00039,2,2937703,2951199,-,13496
484,BUMA.1121.00029,2,300355,313835,-,13480
484,BUMA.1121.00021,2,1524705,1538195,+,13490
484,BUMA.1121.00107,2,2826168,2839693,-,13525
484,BUMA.1121.00023,2,1100821,1114311,+,13490
484,BUMA.1121.00067,2,2956548,2970110,-,13562
484,BUMA.1121.00035,2,278900,292380,-,13480
484,BUMA.1121.00005,2,2440359,2453902,+,13543
484,BUMA.1121.00100,2,2112898,2126377,+,13479
484,BUMA.1121.00016,2,2685998,2699487,-,13489
484,BUMA.1121.00099,2,1268962,1282454,+,13492
484,BUMA.1121.00094,2,1050381,1063888,+,13507
484,BUMA.1121.00093,2,1911348,1924854,-,13506
484,BUMA.1121.00097,2,856336,869842,+,13506
484,BUMA.1121.00109,2,391457,404956,-,13499
484,BUMA.1121.00018,2,2783468,2796942,-,13474
484,BUMA.1121.00110,2,1371123,1384593,-,13470
484,BUMA.1121.00079,2,1007331,1020837,+,13506
484,BUMA.1121.00075,2,1298803,1312316,+,13513
484,BUMA.1121.00066,2,992539,1006081,+,13542
484,BUMA.1121.00089,2,995165,1008672,+,13507
484,BUMA.1121.00057,2,1068093,1081641,-,13548
484,BUMA.1121.00090,2,1996515,2010007,+,13492
484,BUMA.1121.00027,2,2068294,2081822,+,13528
484,BUMA.1121.00062,2,761479,774999,-,13520
484,BUMA.1121.00091,2,2606848,2620361,-,13513
484,BUMA.1121.00098,2,1263759,1277265,+,13506
484,BUMA.1121.00092,2,1020216,1033723,+,13507
484,BUMA.1121.00031,2,197827,211317,+,13490
484,BUMA.1121.00096,2,1222207,1235701,+,13494
484,BUMA.1121.00073,2,986882,1000405,+,13523
484,BUMA.1121.00103,2,2921891,2935426,+,13535
484,BUMA.1121.00084,2,2834422,2847938,+,13516
484,BUMA.1121.00014,2,1131131,1144621,+,13490
484,BUMA.1121.00111,2,284052,297540,+,13488
484,BUMA.1121.00007,2,1049493,1062998,+,13505
484,BUMA.1121.00072,2,983066,996608,+,13542
484,BUMA.1121.00071,2,986182,999723,+,13541
484,BUMA.1121.00077,2,2665004,2678474,-,13470
484,BUMA.1121.00003,2,2882698,2896225,-,13527
484,BUMA.1121.00104,2,1101063,1114582,+,13519
484,BUMA.1121.00074,2,3342372,3355885,-,13513
484,BUMA.1121.00060,2,1182484,1195997,-,13513
484,BUMA.1121.00088,2,951517,965038,+,13521
484,BUMA.1121.00053,2,1293743,1307271,+,13528
484,BUMA.1121.00025,2,38336,51811,-,13475
484,BUMA.1121.00070,2,986898,1000433,+,13535
484,BUMA.1121.00049,2,2821957,2835309,+,13352
484,BUMA.1121.00078,2,2150934,2164446,-,13512
484,BUMA.1121.00069,2,984785,998327,+,13542
484,BUMA.1121.00102,2,1056868,1070428,+,13560
484,BUMA.1121.00112,2,92266,105822,-,13556
484,BUMA.1121.00041,2,1949655,1963182,+,13527
484,BUMA.1121.00068,2,2714868,2728357,+,13489
484,BUMA.1121.00076,2,1892887,1906400,+,13513
484,BUMA.1121.00033,2,1745897,1759386,+,13489
484,BUMA.1121.00101,2,2388362,2401886,-,13524
484,BUMA.1121.00105,2,1501270,1514789,-,13519
484,BUMA.1121.00061,2,976915,990457,+,13542
484,BUMA.1121.00063,2,985979,999508,+,13529
484,BUMA.1121.00059,2,2638494,2651993,-,13499
484,BUMA.1121.00058,2,1557419,1570926,+,13507
484,BUMA.1121.00043,2,1348117,1361617,-,13500
484,BUMA.1121.00055,2,1651031,1664548,-,13517
484,BUMA.1121.00065,2,1053276,1066811,+,13535
484,BUMA.1121.00064,2,921581,935088,+,13507
484,BUMA.1121.00047,2,1937384,1950891,+,13507
484,BUMA.1121.00037,2,1368880,1382370,+,13490
484,BUMA.1121.00106,2,798545,812131,-,13586
484,BUMA.1121.00051,2,1006876,1020397,+,13521
484,BUMA.1121.00045,2,897867,911381,+,13514
484,BUMA.1121.00056,2,2985329,2998835,-,13506
484,BUMA.1121.00095,2,261724,275248,-,13524
484,BUMA.1121.00082,2,1016568,1030110,+,13542
484,BUMA.1121.00001,2,1188748,1202228,-,13480
484,BUMA.1121.00108,2,1235755,1249273,+,13518
484,BUMA.1121.00083,2,2813525,2827067,+,13542
484,BUMA.1121.00080,2,1008071,1021585,+,13514
484,BUMA.1121.00012,2,683046,696563,-,13517
485,BUMA.1121.00011,2,2903365,2913524,+,10159
485,BUMA.1121.00009,2,2925071,2935206,+,10135
485,BUMA.1121.00039,2,2923141,2933289,-,10148
485,BUMA.1121.00029,2,285736,295903,-,10167
485,BUMA.1121.00021,2,1542593,1552702,+,10109
485,BUMA.1121.00107,2,2811612,2821773,-,10161
485,BUMA.1121.00023,2,1118692,1128835,+,10143
485,BUMA.1121.00067,2,2942029,2952151,-,10122
485,BUMA.1121.00035,2,264319,274469,-,10150
485,BUMA.1121.00005,2,2458433,2468552,+,10119
485,BUMA.1121.00100,2,2130720,2140863,+,10143
485,BUMA.1121.00016,2,2671495,2681645,-,10150
485,BUMA.1121.00099,2,1283261,1293412,+,10151
485,BUMA.1121.00094,2,1068332,1078507,+,10175
485,BUMA.1121.00093,2,1896807,1906922,-,10115
485,BUMA.1121.00097,2,874258,884379,+,10121
485,BUMA.1121.00109,2,376934,387073,-,10139
485,BUMA.1121.00018,2,2768973,2779114,-,10141
485,BUMA.1121.00110,2,1356547,1366669,-,10122
485,BUMA.1121.00079,2,1025302,1035399,+,10097
485,BUMA.1121.00075,2,1316794,1326961,+,10167
485,BUMA.1121.00066,2,1006888,1016990,+,10102
485,BUMA.1121.00089,2,1013116,1023297,+,10181
485,BUMA.1121.00057,2,1057091,1067285,-,10194
485,BUMA.1121.00090,2,2012485,2022620,+,10135
485,BUMA.1121.00027,2,2082629,2092820,+,10191
485,BUMA.1121.00062,2,746974,757084,-,10110
485,BUMA.1121.00091,2,2592843,2602474,-,9631
485,BUMA.1121.00098,2,1281737,1291873,+,10136
485,BUMA.1121.00092,2,1038141,1048257,+,10116
485,BUMA.1121.00031,2,215704,225872,+,10168
485,BUMA.1121.00096,2,1240151,1250328,+,10177
485,BUMA.1121.00073,2,1001212,1011400,+,10188
485,BUMA.1121.00103,2,2939810,2949854,+,10044
485,BUMA.1121.00084,2,2852379,2862629,+,10250
485,BUMA.1121.00014,2,1149086,1159252,+,10166
485,BUMA.1121.00111,2,300018,310169,+,10151
485,BUMA.1121.00007,2,1067390,1077471,+,10081
485,BUMA.1121.00072,2,997415,1007568,+,10153
485,BUMA.1121.00071,2,1000530,1010661,+,10131
485,BUMA.1121.00077,2,2650351,2660473,-,10122
485,BUMA.1121.00003,2,2871818,2881892,-,10074
485,BUMA.1121.00104,2,1118997,1129191,+,10194
485,BUMA.1121.00074,2,3327791,3337989,-,10198
485,BUMA.1121.00060,2,1167879,1178021,-,10142
485,BUMA.1121.00088,2,969495,979726,+,10231
485,BUMA.1121.00053,2,1311727,1321954,+,10227
485,BUMA.1121.00025,2,23854,33996,-,10142
485,BUMA.1121.00070,2,1001240,1011409,+,10169
485,BUMA.1121.00049,2,2839745,2849961,+,10216
485,BUMA.1121.00078,2,2136290,2146455,-,10165
485,BUMA.1121.00069,2,999134,1009302,+,10168
485,BUMA.1121.00102,2,1074958,1085174,+,10216
485,BUMA.1121.00112,2,77608,87814,-,10206
485,BUMA.1121.00041,2,1967660,1977872,+,10212
485,BUMA.1121.00068,2,2732745,2742894,+,10149
485,BUMA.1121.00076,2,1910850,1921023,+,10173
485,BUMA.1121.00033,2,1763780,1773897,+,10117
485,BUMA.1121.00101,2,2377400,2387554,-,10154
485,BUMA.1121.00105,2,1486757,1496887,-,10130
485,BUMA.1121.00061,2,991264,1001440,+,10176
485,BUMA.1121.00063,2,1000315,1010452,+,10137
485,BUMA.1121.00059,2,2623902,2634057,-,10155
485,BUMA.1121.00058,2,1575339,1585490,+,10151
485,BUMA.1121.00043,2,1335487,1345638,-,10151
485,BUMA.1121.00055,2,1636333,1646598,-,10265
485,BUMA.1121.00065,2,1071232,1081394,+,10162
485,BUMA.1121.00064,2,939520,949682,+,10162
485,BUMA.1121.00047,2,1955356,1965448,+,10092
485,BUMA.1121.00037,2,1384848,1395126,+,10278
485,BUMA.1121.00106,2,783897,794157,-,10260
485,BUMA.1121.00051,2,1024855,1034948,+,10093
485,BUMA.1121.00045,2,915837,925979,+,10142
485,BUMA.1121.00056,2,2970704,2980884,-,10180
485,BUMA.1121.00095,2,250829,260921,-,10092
485,BUMA.1121.00082,2,1030917,1041112,+,10195
485,BUMA.1121.00001,2,1174119,1184268,-,10149
485,BUMA.1121.00108,2,1253723,1263860,+,10137
485,BUMA.1121.00083,2,2827874,2838069,+,10195
485,BUMA.1121.00080,2,1025980,1036078,+,10098
485,BUMA.1121.00012,2,668466,678615,-,10149
486,BUMA.1121.00011,2,2922335,2937164,+,14829
486,BUMA.1121.00009,2,2944113,2958954,+,14841
486,BUMA.1121.00039,2,2899591,2914362,-,14771
486,BUMA.1121.00029,2,262115,276944,-,14829
486,BUMA.1121.00021,2,1561481,1576309,+,14828
486,BUMA.1121.00107,2,2787686,2802521,-,14835
486,BUMA.1121.00023,2,1137606,1152434,+,14828
486,BUMA.1121.00067,2,2918402,2933245,-,14843
486,BUMA.1121.00035,2,240666,255495,-,14829
486,BUMA.1121.00005,2,2477464,2492446,+,14982
486,BUMA.1121.00100,2,2149801,2164652,+,14851
486,BUMA.1121.00016,2,2647823,2662652,-,14829
486,BUMA.1121.00099,2,1302628,1317462,+,14834
486,BUMA.1121.00094,2,1087443,1102278,+,14835
486,BUMA.1121.00093,2,1873022,1887855,-,14833
486,BUMA.1121.00097,2,893307,908141,+,14834
486,BUMA.1121.00109,2,353171,368035,-,14864
486,BUMA.1121.00018,2,2745349,2760186,-,14837
486,BUMA.1121.00110,2,1341591,1356433,-,14842
486,BUMA.1121.00079,2,1044487,1059322,+,14835
486,BUMA.1121.00075,2,1335851,1350679,+,14828
486,BUMA.1121.00066,2,1025912,1040632,+,14720
486,BUMA.1121.00089,2,1032233,1047068,+,14835
486,BUMA.1121.00057,2,1033390,1048227,-,14837
486,BUMA.1121.00090,2,2031383,2046209,+,14826
486,BUMA.1121.00027,2,2101694,2116682,+,14988
486,BUMA.1121.00062,2,723205,738022,-,14817
486,BUMA.1121.00091,2,2569125,2583963,-,14838
486,BUMA.1121.00098,2,1300665,1315505,+,14840
486,BUMA.1121.00092,2,1057201,1072033,+,14832
486,BUMA.1121.00031,2,234635,249471,+,14836
486,BUMA.1121.00096,2,1259288,1274116,+,14828
486,BUMA.1121.00073,2,1020322,1034894,+,14572
486,BUMA.1121.00103,2,2958726,2973573,+,14847
486,BUMA.1121.00084,2,2871541,2886372,+,14831
486,BUMA.1121.00014,2,1168007,1182843,+,14836
486,BUMA.1121.00111,2,318932,333759,+,14827
486,BUMA.1121.00007,2,1086362,1101204,+,14842
486,BUMA.1121.00072,2,1016488,1031058,+,14570
486,BUMA.1121.00071,2,1019615,1034184,+,14569
486,BUMA.1121.00077,2,2635395,2650237,-,14842
486,BUMA.1121.00003,2,2856906,2871704,-,14798
486,BUMA.1121.00104,2,1138138,1152971,+,14833
486,BUMA.1121.00074,2,3304065,3318900,-,14835
486,BUMA.1121.00060,2,1144161,1159004,-,14843
486,BUMA.1121.00088,2,988561,1003392,+,14831
486,BUMA.1121.00053,2,1330909,1345769,+,14860
486,BUMA.1121.00025,2,222,15059,-,14837
486,BUMA.1121.00070,2,1020329,1034915,+,14586
486,BUMA.1121.00049,2,2858881,2873713,+,14832
486,BUMA.1121.00078,2,2112504,2127336,-,14832
486,BUMA.1121.00069,2,1018257,1032993,+,14736
486,BUMA.1121.00102,2,1094310,1109146,+,14836
486,BUMA.1121.00112,2,62660,77494,-,14834
486,BUMA.1121.00041,2,1986712,2001546,+,14834
486,BUMA.1121.00068,2,2751799,2767862,+,16063
486,BUMA.1121.00076,2,1929906,1944734,+,14828
486,BUMA.1121.00033,2,1782652,1797473,+,14821
486,BUMA.1121.00101,2,2353505,2368511,-,15006
486,BUMA.1121.00105,2,1463064,1477890,-,14826
486,BUMA.1121.00061,2,1010360,1025080,+,14720
486,BUMA.1121.00063,2,1019354,1034076,+,14722
486,BUMA.1121.00059,2,2600276,2615067,-,14791
486,BUMA.1121.00058,2,1594530,1609358,+,14828
486,BUMA.1121.00043,2,1311721,1326556,-,14835
486,BUMA.1121.00055,2,1612656,1627498,-,14842
486,BUMA.1121.00065,2,1090293,1105128,+,14835
486,BUMA.1121.00064,2,958578,973426,+,14848
486,BUMA.1121.00047,2,1974411,1989243,+,14832
486,BUMA.1121.00037,2,1403965,1418794,+,14829
486,BUMA.1121.00106,2,760270,775102,-,14832
486,BUMA.1121.00051,2,1043966,1058801,+,14835
486,BUMA.1121.00045,2,934854,949696,+,14842
486,BUMA.1121.00056,2,2946932,2961768,-,14836
486,BUMA.1121.00095,2,235734,250715,-,14981
486,BUMA.1121.00082,2,1050067,1065049,+,14982
486,BUMA.1121.00001,2,1150499,1165327,-,14828
486,BUMA.1121.00108,2,1272671,1287506,+,14835
486,BUMA.1121.00083,2,2847024,2862006,+,14982
486,BUMA.1121.00080,2,1045078,1059913,+,14835
486,BUMA.1121.00012,2,644857,659703,-,14846
487,BUMA.1121.00011,2,2941068,2947001,+,5933
487,BUMA.1121.00009,2,2962541,2968470,+,5929
487,BUMA.1121.00039,2,2889794,2895724,-,5930
487,BUMA.1121.00029,2,252177,258103,-,5926
487,BUMA.1121.00021,2,1581673,1587564,+,5891
487,BUMA.1121.00107,2,2777894,2783826,-,5932
487,BUMA.1121.00023,2,1156447,1162373,+,5926
487,BUMA.1121.00067,2,2908867,2914794,-,5927
487,BUMA.1121.00035,2,230728,236654,-,5926
487,BUMA.1121.00005,2,2496329,2502257,+,5928
487,BUMA.1121.00100,2,2168560,2174488,+,5928
487,BUMA.1121.00016,2,2637873,2643801,-,5928
487,BUMA.1121.00099,2,1321092,1327021,+,5929
487,BUMA.1121.00094,2,1105920,1111849,+,5929
487,BUMA.1121.00093,2,1863595,1869533,-,5938
487,BUMA.1121.00097,2,911771,917699,+,5928
487,BUMA.1121.00109,2,343787,349702,-,5915
487,BUMA.1121.00018,2,2735281,2741208,-,5927
487,BUMA.1121.00110,2,1331918,1337833,-,5915
487,BUMA.1121.00079,2,1062964,1068893,+,5929
487,BUMA.1121.00075,2,1354321,1360249,+,5928
487,BUMA.1121.00066,2,1044233,1050162,+,5929
487,BUMA.1121.00089,2,1050710,1056639,+,5929
487,BUMA.1121.00057,2,1023864,1029794,-,5930
487,BUMA.1121.00090,2,2050222,2056150,+,5928
487,BUMA.1121.00027,2,2120281,2126209,+,5928
487,BUMA.1121.00062,2,713667,719597,-,5930
487,BUMA.1121.00091,2,2559448,2565377,-,5929
487,BUMA.1121.00098,2,1319350,1325277,+,5927
487,BUMA.1121.00092,2,1075523,1081460,+,5937
487,BUMA.1121.00031,2,253484,259412,+,5928
487,BUMA.1121.00096,2,1277871,1283799,+,5928
487,BUMA.1121.00073,2,1038645,1044574,+,5929
487,BUMA.1121.00103,2,2976666,2982597,+,5931
487,BUMA.1121.00084,2,2890077,2896005,+,5928
487,BUMA.1121.00014,2,1186856,1192784,+,5928
487,BUMA.1121.00111,2,337802,343730,+,5928
487,BUMA.1121.00007,2,1104443,1110371,+,5928
487,BUMA.1121.00072,2,1034809,1040738,+,5929
487,BUMA.1121.00071,2,1037935,1043864,+,5929
487,BUMA.1121.00077,2,2625593,2631508,-,5915
487,BUMA.1121.00003,2,2847241,2853168,-,5927
487,BUMA.1121.00104,2,1156666,1162595,+,5929
487,BUMA.1121.00074,2,3294530,3300457,-,5927
487,BUMA.1121.00060,2,1134101,1140032,-,5931
487,BUMA.1121.00088,2,1007087,1013016,+,5929
487,BUMA.1121.00053,2,1349368,1355297,+,5929
487,BUMA.1121.00025,2,3069139,3075066,-,5927
487,BUMA.1121.00070,2,1038666,1044595,+,5929
487,BUMA.1121.00049,2,2877183,2883112,+,5929
487,BUMA.1121.00078,2,2102838,2108767,-,5929
487,BUMA.1121.00069,2,1036544,1042473,+,5929
487,BUMA.1121.00102,2,1112778,1118706,+,5928
487,BUMA.1121.00112,2,53758,59686,-,5928
487,BUMA.1121.00041,2,2005391,2011319,+,5928
487,BUMA.1121.00068,2,2771345,2777276,+,5931
487,BUMA.1121.00076,2,1948376,1954304,+,5928
487,BUMA.1121.00033,2,1801516,1807442,+,5926
487,BUMA.1121.00101,2,2343973,2349902,-,5929
487,BUMA.1121.00105,2,1454563,1460492,-,5929
487,BUMA.1121.00061,2,1028680,1034609,+,5929
487,BUMA.1121.00063,2,1037677,1043606,+,5929
487,BUMA.1121.00059,2,2590577,2596506,-,5929
487,BUMA.1121.00058,2,1612249,1618183,+,5934
487,BUMA.1121.00043,2,1302140,1308066,-,5926
487,BUMA.1121.00055,2,1603129,1609058,-,5929
487,BUMA.1121.00065,2,1108770,1114697,+,5927
487,BUMA.1121.00064,2,977067,982995,+,5928
487,BUMA.1121.00047,2,1992285,1998214,+,5929
487,BUMA.1121.00037,2,1422432,1428361,+,5929
487,BUMA.1121.00106,2,750646,756576,-,5930
487,BUMA.1121.00051,2,1062416,1068345,+,5929
487,BUMA.1121.00045,2,953901,959831,+,5930
487,BUMA.1121.00056,2,2937361,2943291,-,5930
487,BUMA.1121.00095,2,225972,231901,-,5929
487,BUMA.1121.00082,2,1068650,1074579,+,5929
487,BUMA.1121.00001,2,1141454,1147391,-,5937
487,BUMA.1121.00108,2,1290371,1296305,+,5934
487,BUMA.1121.00083,2,2865607,2871536,+,5929
487,BUMA.1121.00080,2,1063555,1069484,+,5929
487,BUMA.1121.00012,2,634916,640845,-,5929
488,BUMA.1121.00011,2,2947932,2962250,+,14318
488,BUMA.1121.00009,2,2969401,2983734,+,14333
488,BUMA.1121.00039,2,2874508,2888863,-,14355
488,BUMA.1121.00029,2,236879,251246,-,14367
488,BUMA.1121.00021,2,1588495,1602800,+,14305
488,BUMA.1121.00107,2,2762626,2776963,-,14337
488,BUMA.1121.00023,2,1163304,1177609,+,14305
488,BUMA.1121.00067,2,2893593,2907936,-,14343
488,BUMA.1121.00035,2,215430,229797,-,14367
488,BUMA.1121.00005,2,2503188,2517512,+,14324
488,BUMA.1121.00100,2,2175419,2189748,+,14329
488,BUMA.1121.00016,2,2622645,2636942,-,14297
488,BUMA.1121.00099,2,1327952,1342242,+,14290
488,BUMA.1121.00094,2,1112780,1127089,+,14309
488,BUMA.1121.00093,2,1848233,1862664,-,14431
488,BUMA.1121.00097,2,918630,932946,+,14316
488,BUMA.1121.00109,2,328399,342856,-,14457
488,BUMA.1121.00018,2,2719968,2734350,-,14382
488,BUMA.1121.00110,2,1316513,1330987,-,14474
488,BUMA.1121.00079,2,1069824,1084134,+,14310
488,BUMA.1121.00075,2,1361180,1375467,+,14287
488,BUMA.1121.00066,2,1051093,1065420,+,14327
488,BUMA.1121.00089,2,1057570,1071879,+,14309
488,BUMA.1121.00057,2,1008670,1022933,-,14263
488,BUMA.1121.00090,2,2057081,2071386,+,14305
488,BUMA.1121.00027,2,2127140,2141474,+,14334
488,BUMA.1121.00062,2,698387,712736,-,14349
488,BUMA.1121.00091,2,2544195,2558517,-,14322
488,BUMA.1121.00098,2,1326208,1340482,+,14274
488,BUMA.1121.00092,2,1082391,1096709,+,14318
488,BUMA.1121.00031,2,260343,274638,+,14295
488,BUMA.1121.00096,2,1284730,1299034,+,14304
488,BUMA.1121.00073,2,1045505,1059832,+,14327
488,BUMA.1121.00103,2,2983528,2997820,+,14292
488,BUMA.1121.00084,2,2896936,2911269,+,14333
488,BUMA.1121.00014,2,1193715,1208010,+,14295
488,BUMA.1121.00111,2,344661,358977,+,14316
488,BUMA.1121.00007,2,1111302,1125630,+,14328
488,BUMA.1121.00072,2,1041669,1055996,+,14327
488,BUMA.1121.00071,2,1044795,1059122,+,14327
488,BUMA.1121.00077,2,2610188,2624662,-,14474
488,BUMA.1121.00003,2,2831939,2846310,-,14371
488,BUMA.1121.00104,2,1163526,1177853,+,14327
488,BUMA.1121.00074,2,3279232,3293599,-,14367
488,BUMA.1121.00060,2,1118863,1133170,-,14307
488,BUMA.1121.00088,2,1013947,1027021,+,13074
488,BUMA.1121.00053,2,1356228,1370543,+,14315
488,BUMA.1121.00025,2,3053832,3068208,-,14376
488,BUMA.1121.00070,2,1045526,1059853,+,14327
488,BUMA.1121.00049,2,2884043,2898382,+,14339
488,BUMA.1121.00078,2,2087636,2101907,-,14271
488,BUMA.1121.00069,2,1043404,1057731,+,14327
488,BUMA.1121.00102,2,1119637,1133942,+,14305
488,BUMA.1121.00112,2,38501,52827,-,14326
488,BUMA.1121.00041,2,2012250,2026574,+,14324
488,BUMA.1121.00068,2,2778207,2792531,+,14324
488,BUMA.1121.00076,2,1955235,1969525,+,14290
488,BUMA.1121.00033,2,1808373,1822690,+,14317
488,BUMA.1121.00101,2,2328636,2343042,-,14406
488,BUMA.1121.00105,2,1439279,1453632,-,14353
488,BUMA.1121.00061,2,1035540,1049867,+,14327
488,BUMA.1121.00063,2,1044537,1058864,+,14327
488,BUMA.1121.00059,2,2575278,2589646,-,14368
488,BUMA.1121.00058,2,1619114,1633428,+,14314
488,BUMA.1121.00043,2,1286804,1301209,-,14405
488,BUMA.1121.00055,2,1587859,1602198,-,14339
488,BUMA.1121.00065,2,1115628,1129928,+,14300
488,BUMA.1121.00064,2,983926,998228,+,14302
488,BUMA.1121.00047,2,1999145,2013455,+,14310
488,BUMA.1121.00037,2,1429292,1443610,+,14318
488,BUMA.1121.00106,2,735347,749715,-,14368
488,BUMA.1121.00051,2,1069276,1083587,+,14311
488,BUMA.1121.00045,2,960762,975057,+,14295
488,BUMA.1121.00056,2,2922086,2936430,-,14344
488,BUMA.1121.00095,2,210587,225041,-,14454
488,BUMA.1121.00082,2,1075510,1089837,+,14327
488,BUMA.1121.00001,2,1126132,1140523,-,14391
488,BUMA.1121.00108,2,1297236,1311499,+,14263
488,BUMA.1121.00083,2,2872467,2886794,+,14327
488,BUMA.1121.00080,2,1070415,1084725,+,14310
488,BUMA.1121.00012,2,619626,633985,-,14359
489,BUMA.1121.00011,2,2963644,2986793,+,23149
489,BUMA.1121.00009,2,2987629,3010671,+,23042
489,BUMA.1121.00039,2,2849886,2873125,-,23239
489,BUMA.1121.00029,2,212373,235544,-,23171
489,BUMA.1121.00021,2,1604230,1627403,+,23173
489,BUMA.1121.00107,2,2738155,2761304,-,23149
489,BUMA.1121.00023,2,1179040,1202254,+,23214
489,BUMA.1121.00067,2,2869116,2892259,-,23143
489,BUMA.1121.00035,2,190897,214083,-,23186
489,BUMA.1121.00005,2,2518828,2542002,+,23174
489,BUMA.1121.00100,2,2191166,2214267,+,23101
489,BUMA.1121.00016,2,2598020,2621269,-,23249
489,BUMA.1121.00099,2,1343600,1366651,+,23051
489,BUMA.1121.00094,2,1128430,1151616,+,23186
489,BUMA.1121.00093,2,1823774,1846893,-,23119
489,BUMA.1121.00097,2,934365,957540,+,23175
489,BUMA.1121.00109,2,303869,327059,-,23190
489,BUMA.1121.00018,2,2695503,2718651,-,23148
489,BUMA.1121.00110,2,1292105,1315185,-,23080
489,BUMA.1121.00079,2,1085504,1108665,+,23161
489,BUMA.1121.00075,2,1376873,1400029,+,23156
489,BUMA.1121.00066,2,1066780,1089924,+,23144
489,BUMA.1121.00089,2,1073244,1096430,+,23186
489,BUMA.1121.00057,2,984255,1007282,-,23027
489,BUMA.1121.00090,2,2072772,2096081,+,23309
489,BUMA.1121.00027,2,2142820,2165932,+,23112
489,BUMA.1121.00062,2,674025,697064,-,23039
489,BUMA.1121.00091,2,2519679,2542873,-,23194
489,BUMA.1121.00098,2,1341882,1364977,+,23095
489,BUMA.1121.00092,2,1098163,1121281,+,23118
489,BUMA.1121.00031,2,276051,299270,+,23219
489,BUMA.1121.00096,2,1300392,1323584,+,23192
489,BUMA.1121.00073,2,1061146,1084296,+,23150
489,BUMA.1121.00103,2,3000829,3023857,+,23028
489,BUMA.1121.00084,2,2912664,2935860,+,23196
489,BUMA.1121.00014,2,1209453,1232705,+,23252
489,BUMA.1121.00111,2,360324,383549,+,23225
489,BUMA.1121.00007,2,1127012,1150156,+,23144
489,BUMA.1121.00072,2,1057363,1080513,+,23150
489,BUMA.1121.00071,2,1060465,1083615,+,23150
489,BUMA.1121.00077,2,2585779,2608860,-,23081
489,BUMA.1121.00003,2,2807490,2830623,-,23133
489,BUMA.1121.00104,2,1179199,1202251,+,23052
489,BUMA.1121.00074,2,3254743,3277916,-,23173
489,BUMA.1121.00060,2,1094292,1117487,-,23195
489,BUMA.1121.00088,2,1028397,1051554,+,23157
489,BUMA.1121.00053,2,1372003,1395134,+,23131
489,BUMA.1121.00025,2,3029367,3052515,-,23148
489,BUMA.1121.00070,2,1061209,1084359,+,23150
489,BUMA.1121.00049,2,2899746,2922750,+,23004
489,BUMA.1121.00078,2,2063237,2086266,-,23029
489,BUMA.1121.00069,2,1059043,1082193,+,23150
489,BUMA.1121.00102,2,1135360,1158491,+,23131
489,BUMA.1121.00112,2,14040,37155,-,23115
489,BUMA.1121.00041,2,2027962,2051158,+,23196
489,BUMA.1121.00068,2,2793960,2817080,+,23120
489,BUMA.1121.00076,2,1970877,1994066,+,23189
489,BUMA.1121.00033,2,1824066,1847149,+,23083
489,BUMA.1121.00101,2,2304071,2327296,-,23225
489,BUMA.1121.00105,2,1414725,1437963,-,23238
489,BUMA.1121.00061,2,1051198,1074348,+,23150
489,BUMA.1121.00063,2,1060196,1083346,+,23150
489,BUMA.1121.00059,2,2550732,2573877,-,23145
489,BUMA.1121.00058,2,1634804,1657949,+,23145
489,BUMA.1121.00043,2,1262053,1285326,-,23273
489,BUMA.1121.00055,2,1563322,1586507,-,23185
489,BUMA.1121.00065,2,1131268,1154281,+,23013
489,BUMA.1121.00064,2,999610,1022671,+,23061
489,BUMA.1121.00047,2,2014801,2037984,+,23183
489,BUMA.1121.00037,2,1445028,1468344,+,23316
489,BUMA.1121.00106,2,710966,734007,-,23041
489,BUMA.1121.00051,2,1084927,1108121,+,23194
489,BUMA.1121.00045,2,976427,999621,+,23194
489,BUMA.1121.00056,2,2897570,2920757,-,23187
489,BUMA.1121.00095,2,186184,209247,-,23063
489,BUMA.1121.00082,2,1091237,1114387,+,23150
489,BUMA.1121.00001,2,1101647,1124809,-,23162
489,BUMA.1121.00108,2,1312863,1336067,+,23204
489,BUMA.1121.00083,2,2888194,2911344,+,23150
489,BUMA.1121.00080,2,1086083,1109260,+,23177
489,BUMA.1121.00012,2,595038,618309,-,23271
490,BUMA.1121.00011,2,2987450,2991762,+,4312
490,BUMA.1121.00009,2,3011328,3015654,+,4326
490,BUMA.1121.00039,2,2844918,2849230,-,4312
490,BUMA.1121.00029,2,207394,211717,-,4323
490,BUMA.1121.00021,2,1628060,1632382,+,4322
490,BUMA.1121.00107,2,2733176,2737499,-,4323
490,BUMA.1121.00023,2,1202911,1207224,+,4313
490,BUMA.1121.00067,2,2864126,2868460,-,4334
490,BUMA.1121.00035,2,185918,190241,-,4323
490,BUMA.1121.00005,2,2542659,2546969,+,4310
490,BUMA.1121.00100,2,2214924,2219231,+,4307
490,BUMA.1121.00016,2,2593041,2597364,-,4323
490,BUMA.1121.00099,2,1367308,1371627,+,4319
490,BUMA.1121.00094,2,1152273,1156599,+,4326
490,BUMA.1121.00093,2,1818791,1823118,-,4327
490,BUMA.1121.00097,2,958197,962500,+,4303
490,BUMA.1121.00109,2,298883,303213,-,4330
490,BUMA.1121.00018,2,2690542,2694847,-,4305
490,BUMA.1121.00110,2,1287129,1291449,-,4320
490,BUMA.1121.00079,2,1109322,1113656,+,4334
490,BUMA.1121.00075,2,1400686,1404991,+,4305
490,BUMA.1121.00066,2,1090581,1094878,+,4297
490,BUMA.1121.00089,2,1097087,1101413,+,4326
490,BUMA.1121.00057,2,979276,983599,-,4323
490,BUMA.1121.00090,2,2096738,2101051,+,4313
490,BUMA.1121.00027,2,2166589,2170913,+,4324
490,BUMA.1121.00062,2,669042,673369,-,4327
490,BUMA.1121.00091,2,2514700,2519023,-,4323
490,BUMA.1121.00098,2,1365634,1369948,+,4314
490,BUMA.1121.00092,2,1121938,1126264,+,4326
490,BUMA.1121.00031,2,299927,304240,+,4313
490,BUMA.1121.00096,2,1324241,1328556,+,4315
490,BUMA.1121.00073,2,1084953,1089275,+,4322
490,BUMA.1121.00103,2,3024514,3028858,+,4344
490,BUMA.1121.00084,2,2936517,2940840,+,4323
490,BUMA.1121.00014,2,1233362,1237675,+,4313
490,BUMA.1121.00111,2,384206,388528,+,4322
490,BUMA.1121.00007,2,1150813,1155118,+,4305
490,BUMA.1121.00072,2,1081170,1085473,+,4303
490,BUMA.1121.00071,2,1084272,1088573,+,4301
490,BUMA.1121.00077,2,2580803,2585123,-,4320
490,BUMA.1121.00003,2,2802527,2806834,-,4307
490,BUMA.1121.00104,2,1202908,1207234,+,4326
490,BUMA.1121.00074,2,3249753,3254087,-,4334
490,BUMA.1121.00060,2,1089302,1093636,-,4334
490,BUMA.1121.00088,2,1052211,1056533,+,4322
490,BUMA.1121.00053,2,1395791,1400113,+,4322
490,BUMA.1121.00025,2,3024406,3028711,-,4305
490,BUMA.1121.00070,2,1085016,1089330,+,4314
490,BUMA.1121.00049,2,2923407,2927733,+,4326
490,BUMA.1121.00078,2,2058254,2062581,-,4327
490,BUMA.1121.00069,2,1082850,1087172,+,4322
490,BUMA.1121.00102,2,1159148,1163470,+,4322
490,BUMA.1121.00112,2,9056,13384,-,4328
490,BUMA.1121.00041,2,2051815,2056150,+,4335
490,BUMA.1121.00068,2,2817737,2822055,+,4318
490,BUMA.1121.00076,2,1994723,1999028,+,4305
490,BUMA.1121.00033,2,1847806,1852128,+,4322
490,BUMA.1121.00101,2,2299084,2303415,-,4331
490,BUMA.1121.00105,2,1409733,1414069,-,4336
490,BUMA.1121.00061,2,1075005,1079321,+,4316
490,BUMA.1121.00063,2,1084003,1088325,+,4322
490,BUMA.1121.00059,2,2545749,2550076,-,4327
490,BUMA.1121.00058,2,1658606,1662932,+,4326
490,BUMA.1121.00043,2,1255693,1261397,-,5704
490,BUMA.1121.00055,2,1558338,1562666,-,4328
490,BUMA.1121.00065,2,1154938,1159260,+,4322
490,BUMA.1121.00064,2,1023328,1027650,+,4322
490,BUMA.1121.00047,2,2038641,2042976,+,4335
490,BUMA.1121.00037,2,1469001,1473314,+,4313
490,BUMA.1121.00106,2,705983,710310,-,4327
490,BUMA.1121.00051,2,1108778,1113112,+,4334
490,BUMA.1121.00045,2,1000278,1004611,+,4333
490,BUMA.1121.00056,2,2892587,2896914,-,4327
490,BUMA.1121.00095,2,181157,185528,-,4371
490,BUMA.1121.00082,2,1115044,1119366,+,4322
490,BUMA.1121.00001,2,1096668,1100991,-,4323
490,BUMA.1121.00108,2,1336724,1341068,+,4344
490,BUMA.1121.00083,2,2912001,2916323,+,4322
490,BUMA.1121.00080,2,1109917,1114252,+,4335
490,BUMA.1121.00012,2,590059,594382,-,4323
491,BUMA.1121.00011,2,2995721,3000932,+,5211
491,BUMA.1121.00009,2,3019548,3024780,+,5232
491,BUMA.1121.00039,2,2835747,2841008,-,5261
491,BUMA.1121.00029,2,198300,203492,-,5192
491,BUMA.1121.00021,2,1636285,1641519,+,5234
491,BUMA.1121.00107,2,2724051,2729277,-,5226
491,BUMA.1121.00023,2,1211123,1216331,+,5208
491,BUMA.1121.00067,2,2854974,2860202,-,5228
491,BUMA.1121.00035,2,176824,182016,-,5192
491,BUMA.1121.00005,2,2550853,2556084,+,5231
491,BUMA.1121.00100,2,2223105,2228342,+,5237
491,BUMA.1121.00016,2,2583894,2589133,-,5239
491,BUMA.1121.00099,2,1375514,1380762,+,5248
491,BUMA.1121.00094,2,1160514,1165705,+,5191
491,BUMA.1121.00093,2,1809692,1814900,-,5208
491,BUMA.1121.00097,2,966403,971642,+,5239
491,BUMA.1121.00109,2,289763,294993,-,5230
491,BUMA.1121.00018,2,2681367,2686593,-,5226
491,BUMA.1121.00110,2,1277982,1283198,-,5216
491,BUMA.1121.00079,2,1117561,1122791,+,5230
491,BUMA.1121.00075,2,1410480,1415719,+,5239
491,BUMA.1121.00066,2,1098782,1103928,+,5146
491,BUMA.1121.00089,2,1105328,1110519,+,5191
491,BUMA.1121.00057,2,970136,975372,-,5236
491,BUMA.1121.00090,2,2104954,2110229,+,5275
491,BUMA.1121.00027,2,2174827,2180054,+,5227
491,BUMA.1121.00062,2,659868,665116,-,5248
491,BUMA.1121.00091,2,2505579,2510809,-,5230
491,BUMA.1121.00098,2,1373847,1379071,+,5224
491,BUMA.1121.00092,2,1130156,1135364,+,5208
491,BUMA.1121.00031,2,308138,313436,+,5298
491,BUMA.1121.00096,2,1332436,1337721,+,5285
491,BUMA.1121.00073,2,1093180,1098404,+,5224
491,BUMA.1121.00103,2,3032760,3037939,+,5179
491,BUMA.1121.00084,2,2944732,2949966,+,5234
491,BUMA.1121.00014,2,1241573,1246853,+,5280
491,BUMA.1121.00111,2,392431,397679,+,5248
491,BUMA.1121.00007,2,1159018,1164285,+,5267
491,BUMA.1121.00072,2,1089372,1094523,+,5151
491,BUMA.1121.00071,2,1092477,1097701,+,5224
491,BUMA.1121.00077,2,2571656,2576872,-,5216
491,BUMA.1121.00003,2,2793406,2798616,-,5210
491,BUMA.1121.00104,2,1211148,1216378,+,5230
491,BUMA.1121.00074,2,3240610,3245838,-,5228
491,BUMA.1121.00060,2,1080204,1085393,-,5189
491,BUMA.1121.00088,2,1060425,1065659,+,5234
491,BUMA.1121.00053,2,1403997,1409215,+,5218
491,BUMA.1121.00025,2,3015231,3020457,-,5226
491,BUMA.1121.00070,2,1093235,1098459,+,5224
491,BUMA.1121.00049,2,2931631,2936861,+,5230
491,BUMA.1121.00078,2,2049154,2054368,-,5214
491,BUMA.1121.00069,2,1091077,1096226,+,5149
491,BUMA.1121.00102,2,1167373,1172577,+,5204
491,BUMA.1121.00112,2,1,5147,-,5146
491,BUMA.1121.00041,2,2060052,2065230,+,5178
491,BUMA.1121.00068,2,2825956,2831186,+,5230
491,BUMA.1121.00076,2,2004517,2009756,+,5239
491,BUMA.1121.00033,2,1856031,1861273,+,5242
491,BUMA.1121.00101,2,2289921,2295174,-,5253
491,BUMA.1121.00105,2,1400601,1405826,-,5225
491,BUMA.1121.00061,2,1083225,1088449,+,5224
491,BUMA.1121.00063,2,1092230,1097454,+,5224
491,BUMA.1121.00059,2,2536616,2541841,-,5225
491,BUMA.1121.00058,2,1666840,1672074,+,5234
491,BUMA.1121.00043,2,1246597,1251789,-,5192
491,BUMA.1121.00055,2,1549204,1554434,-,5230
491,BUMA.1121.00065,2,1163166,1168382,+,5216
491,BUMA.1121.00064,2,1032998,1038286,+,5288
491,BUMA.1121.00047,2,2046891,2052082,+,5191
491,BUMA.1121.00037,2,1477212,1482446,+,5234
491,BUMA.1121.00106,2,696831,702061,-,5230
491,BUMA.1121.00051,2,1117035,1122225,+,5190
491,BUMA.1121.00045,2,1008505,1013710,+,5205
491,BUMA.1121.00056,2,2883482,2888673,-,5191
491,BUMA.1121.00095,2,170634,175807,-,5173
491,BUMA.1121.00082,2,1123271,1128495,+,5224
491,BUMA.1121.00001,2,1087574,1092766,-,5192
491,BUMA.1121.00108,2,1344989,1350208,+,5219
491,BUMA.1121.00083,2,2920228,2925452,+,5224
491,BUMA.1121.00080,2,1118167,1123358,+,5191
491,BUMA.1121.00012,2,579340,584544,-,5204
492,BUMA.1121.00011,2,3000933,3005660,+,4727
492,BUMA.1121.00009,2,3024781,3029482,+,4701
492,BUMA.1121.00039,2,2831016,2835745,-,4729
492,BUMA.1121.00029,2,193646,198298,-,4652
492,BUMA.1121.00021,2,1641520,1646182,+,4662
492,BUMA.1121.00107,2,2719384,2724049,-,4665
492,BUMA.1121.00023,2,1216332,1221057,+,4725
492,BUMA.1121.00067,2,2850347,2854972,-,4625
492,BUMA.1121.00035,2,172146,176822,-,4676
492,BUMA.1121.00005,2,2556085,2560747,+,4662
492,BUMA.1121.00100,2,2228343,2233059,+,4716
492,BUMA.1121.00016,2,2579221,2583892,-,4671
492,BUMA.1121.00099,2,1380763,1385575,+,4812
492,BUMA.1121.00094,2,1165706,1170434,+,4728
492,BUMA.1121.00093,2,1804902,1809690,-,4788
492,BUMA.1121.00097,2,971643,976288,+,4645
492,BUMA.1121.00109,2,285086,289761,-,4675
492,BUMA.1121.00018,2,2676647,2681365,-,4718
492,BUMA.1121.00110,2,1273297,1277980,-,4683
492,BUMA.1121.00079,2,1122792,1127514,+,4722
492,BUMA.1121.00075,2,1415720,1420354,+,4634
492,BUMA.1121.00066,2,1103929,1108659,+,4730
492,BUMA.1121.00089,2,1110520,1115248,+,4728
492,BUMA.1121.00057,2,965393,970134,-,4741
492,BUMA.1121.00090,2,2110230,2114894,+,4664
492,BUMA.1121.00027,2,2180055,2184768,+,4713
492,BUMA.1121.00062,2,655149,659866,-,4717
492,BUMA.1121.00091,2,2500960,2505577,-,4617
492,BUMA.1121.00098,2,1379072,1383802,+,4730
492,BUMA.1121.00092,2,1135365,1140153,+,4788
492,BUMA.1121.00031,2,313437,318173,+,4736
492,BUMA.1121.00096,2,1337722,1342409,+,4687
492,BUMA.1121.00073,2,1098405,1103124,+,4719
492,BUMA.1121.00103,2,3037940,3042664,+,4724
492,BUMA.1121.00084,2,2949967,2954659,+,4692
492,BUMA.1121.00014,2,1246854,1251578,+,4724
492,BUMA.1121.00111,2,397680,402338,+,4658
492,BUMA.1121.00007,2,1164286,1168977,+,4691
492,BUMA.1121.00072,2,1094524,1099254,+,4730
492,BUMA.1121.00071,2,1097702,1102432,+,4730
492,BUMA.1121.00077,2,2566971,2571654,-,4683
492,BUMA.1121.00003,2,2788680,2793404,-,4724
492,BUMA.1121.00104,2,1216379,1221013,+,4634
492,BUMA.1121.00074,2,3235983,3240608,-,4625
492,BUMA.1121.00060,2,1075457,1080202,-,4745
492,BUMA.1121.00088,2,1065660,1070342,+,4682
492,BUMA.1121.00053,2,1409216,1413862,+,4646
492,BUMA.1121.00025,2,3010511,3015229,-,4718
492,BUMA.1121.00070,2,1098460,1103178,+,4718
492,BUMA.1121.00049,2,2936862,2941496,+,4634
492,BUMA.1121.00078,2,2044545,2049152,-,4607
492,BUMA.1121.00069,2,1096227,1100945,+,4718
492,BUMA.1121.00102,2,1172578,1177211,+,4633
492,BUMA.1121.00112,2,3262414,3267140,-,4726
492,BUMA.1121.00041,2,2065231,2069883,+,4652
492,BUMA.1121.00068,2,2831187,2835880,+,4693
492,BUMA.1121.00076,2,2009757,2014391,+,4634
492,BUMA.1121.00033,2,1861274,1865915,+,4641
492,BUMA.1121.00101,2,2285142,2289919,-,4777
492,BUMA.1121.00105,2,1395895,1400599,-,4704
492,BUMA.1121.00061,2,1088450,1093109,+,4659
492,BUMA.1121.00063,2,1097455,1102181,+,4726
492,BUMA.1121.00059,2,2531862,2536614,-,4752
492,BUMA.1121.00058,2,1672075,1676756,+,4681
492,BUMA.1121.00043,2,1241865,1246595,-,4730
492,BUMA.1121.00055,2,1544473,1549202,-,4729
492,BUMA.1121.00065,2,1168383,1173094,+,4711
492,BUMA.1121.00064,2,1038287,1043037,+,4750
492,BUMA.1121.00047,2,2052083,2056805,+,4722
492,BUMA.1121.00037,2,1482447,1487106,+,4659
492,BUMA.1121.00106,2,692189,696829,-,4640
492,BUMA.1121.00051,2,1122226,1126954,+,4728
492,BUMA.1121.00045,2,1013711,1018456,+,4745
492,BUMA.1121.00056,2,2878752,2883480,-,4728
492,BUMA.1121.00095,2,165950,170632,-,4682
492,BUMA.1121.00082,2,1128496,1133226,+,4730
492,BUMA.1121.00001,2,1082884,1087572,-,4688
492,BUMA.1121.00108,2,1350209,1354922,+,4713
492,BUMA.1121.00083,2,2925453,2930183,+,4730
492,BUMA.1121.00080,2,1123359,1128087,+,4728
492,BUMA.1121.00012,2,574685,579338,-,4653
493,BUMA.1121.00011,2,3006280,3028825,+,22545
493,BUMA.1121.00009,2,3030102,3052639,+,22537
493,BUMA.1121.00039,2,2807722,2830396,-,22674
493,BUMA.1121.00029,2,170355,193026,-,22671
493,BUMA.1121.00021,2,1646802,1669455,+,22653
493,BUMA.1121.00107,2,2696089,2718764,-,22675
493,BUMA.1121.00023,2,1221677,1244348,+,22671
493,BUMA.1121.00067,2,2827183,2849727,-,22544
493,BUMA.1121.00035,2,148855,171526,-,22671
493,BUMA.1121.00005,2,2561367,2583898,+,22531
493,BUMA.1121.00100,2,2233679,2256198,+,22519
493,BUMA.1121.00016,2,2555927,2578601,-,22674
493,BUMA.1121.00099,2,1386195,1408717,+,22522
493,BUMA.1121.00094,2,1171054,1193496,+,22442
493,BUMA.1121.00093,2,1781743,1804282,-,22539
493,BUMA.1121.00097,2,976908,999440,+,22532
493,BUMA.1121.00109,2,261791,284466,-,22675
493,BUMA.1121.00018,2,2653374,2676027,-,22653
493,BUMA.1121.00110,2,1250215,1272677,-,22462
493,BUMA.1121.00079,2,1128134,1150575,+,22441
493,BUMA.1121.00075,2,1420974,1443612,+,22638
493,BUMA.1121.00066,2,1109279,1131960,+,22681
493,BUMA.1121.00089,2,1115868,1138319,+,22451
493,BUMA.1121.00057,2,942092,964773,-,22681
493,BUMA.1121.00090,2,2115514,2138168,+,22654
493,BUMA.1121.00027,2,2185388,2208071,+,22683
493,BUMA.1121.00062,2,631964,654529,-,22565
493,BUMA.1121.00091,2,2477819,2500340,-,22521
493,BUMA.1121.00098,2,1384422,1406920,+,22498
493,BUMA.1121.00092,2,1140773,1163313,+,22540
493,BUMA.1121.00031,2,318793,341464,+,22671
493,BUMA.1121.00096,2,1343029,1365592,+,22563
493,BUMA.1121.00073,2,1103744,1126394,+,22650
493,BUMA.1121.00103,2,3043284,3065842,+,22558
493,BUMA.1121.00084,2,2955279,2977825,+,22546
493,BUMA.1121.00014,2,1252198,1274869,+,22671
493,BUMA.1121.00111,2,402958,425632,+,22674
493,BUMA.1121.00007,2,1169597,1192169,+,22572
493,BUMA.1121.00072,2,1099874,1122556,+,22682
493,BUMA.1121.00071,2,1103052,1125733,+,22681
493,BUMA.1121.00077,2,2543888,2566351,-,22463
493,BUMA.1121.00003,2,2765480,2788060,-,22580
493,BUMA.1121.00104,2,1221633,1244280,+,22647
493,BUMA.1121.00074,2,3212819,3235363,-,22544
493,BUMA.1121.00060,2,1052198,1074837,-,22639
493,BUMA.1121.00088,2,1070962,1093508,+,22546
493,BUMA.1121.00053,2,1414482,1436932,+,22450
493,BUMA.1121.00025,2,2987238,3009891,-,22653
493,BUMA.1121.00070,2,1103798,1126447,+,22649
493,BUMA.1121.00049,2,2942116,2964646,+,22530
493,BUMA.1121.00078,2,2021256,2043925,-,22669
493,BUMA.1121.00069,2,1101565,1124214,+,22649
493,BUMA.1121.00102,2,1177831,1200486,+,22655
493,BUMA.1121.00112,2,3239123,3261794,-,22671
493,BUMA.1121.00041,2,2070503,2093174,+,22671
493,BUMA.1121.00068,2,2836500,2859055,+,22555
493,BUMA.1121.00076,2,2015011,2037656,+,22645
493,BUMA.1121.00033,2,1866535,1889191,+,22656
493,BUMA.1121.00101,2,2261916,2284522,-,22606
493,BUMA.1121.00105,2,1372746,1395275,-,22529
493,BUMA.1121.00061,2,1093729,1116377,+,22648
493,BUMA.1121.00063,2,1102801,1125450,+,22649
493,BUMA.1121.00059,2,2508681,2531242,-,22561
493,BUMA.1121.00058,2,1677376,1699910,+,22534
493,BUMA.1121.00043,2,1218589,1241245,-,22656
493,BUMA.1121.00055,2,1521302,1543853,-,22551
493,BUMA.1121.00065,2,1173714,1196216,+,22502
493,BUMA.1121.00064,2,1043657,1066330,+,22673
493,BUMA.1121.00047,2,2057425,2079802,+,22377
493,BUMA.1121.00037,2,1487726,1510380,+,22654
493,BUMA.1121.00106,2,668888,691569,-,22681
493,BUMA.1121.00051,2,1127574,1150014,+,22440
493,BUMA.1121.00045,2,1019076,1041716,+,22640
493,BUMA.1121.00056,2,2855682,2878132,-,22450
493,BUMA.1121.00095,2,142742,165330,-,22588
493,BUMA.1121.00082,2,1133846,1156528,+,22682
493,BUMA.1121.00001,2,1059592,1082264,-,22672
493,BUMA.1121.00108,2,1355542,1378324,+,22782
493,BUMA.1121.00083,2,2930803,2953485,+,22682
493,BUMA.1121.00080,2,1128707,1151148,+,22441
493,BUMA.1121.00012,2,551412,574065,-,22653
494,BUMA.1121.00011,2,3029276,3045868,+,16592
494,BUMA.1121.00009,2,3053108,3069712,+,16604
494,BUMA.1121.00039,2,2790654,2807140,-,16486
494,BUMA.1121.00029,2,153232,169800,-,16568
494,BUMA.1121.00021,2,1669960,1686555,+,16595
494,BUMA.1121.00107,2,2678888,2695438,-,16550
494,BUMA.1121.00023,2,1244799,1261366,+,16567
494,BUMA.1121.00067,2,2810052,2826529,-,16477
494,BUMA.1121.00035,2,131725,148300,-,16575
494,BUMA.1121.00005,2,2584385,2600965,+,16580
494,BUMA.1121.00100,2,2256591,2273290,+,16699
494,BUMA.1121.00016,2,2538867,2555372,-,16505
494,BUMA.1121.00099,2,1409129,1425751,+,16622
494,BUMA.1121.00094,2,1194010,1210597,+,16587
494,BUMA.1121.00093,2,1764670,1781134,-,16464
494,BUMA.1121.00097,2,999909,1016514,+,16605
494,BUMA.1121.00109,2,244580,261038,-,16458
494,BUMA.1121.00018,2,2636342,2652819,-,16477
494,BUMA.1121.00110,2,1233138,1249624,-,16486
494,BUMA.1121.00079,2,1151242,1167906,+,16664
494,BUMA.1121.00075,2,1444140,1460712,+,16572
494,BUMA.1121.00066,2,1132501,1149142,+,16641
494,BUMA.1121.00089,2,1138833,1155416,+,16583
494,BUMA.1121.00057,2,924873,941357,-,16484
494,BUMA.1121.00090,2,2138646,2155227,+,16581
494,BUMA.1121.00027,2,2208738,2225327,+,16589
494,BUMA.1121.00062,2,614871,631364,-,16493
494,BUMA.1121.00091,2,2460798,2477264,-,16466
494,BUMA.1121.00098,2,1407407,1424044,+,16637
494,BUMA.1121.00092,2,1163818,1180386,+,16568
494,BUMA.1121.00031,2,341987,358566,+,16579
494,BUMA.1121.00096,2,1366115,1382703,+,16588
494,BUMA.1121.00073,2,1126935,1143585,+,16650
494,BUMA.1121.00103,2,3067913,3084467,+,16554
494,BUMA.1121.00084,2,2978330,2994959,+,16629
494,BUMA.1121.00014,2,1275356,1291949,+,16593
494,BUMA.1121.00111,2,426110,442803,+,16693
494,BUMA.1121.00007,2,1192701,1209295,+,16594
494,BUMA.1121.00072,2,1123097,1139747,+,16650
494,BUMA.1121.00071,2,1126274,1142923,+,16649
494,BUMA.1121.00077,2,2526805,2543297,-,16492
494,BUMA.1121.00003,2,2748379,2764862,-,16483
494,BUMA.1121.00104,2,1244830,1261438,+,16608
494,BUMA.1121.00074,2,3195713,3212183,-,16470
494,BUMA.1121.00060,2,1035150,1051643,-,16493
494,BUMA.1121.00088,2,1093995,1110596,+,16601
494,BUMA.1121.00053,2,1437491,1454071,+,16580
494,BUMA.1121.00025,2,2970206,2986683,-,16477
494,BUMA.1121.00070,2,1126988,1143638,+,16650
494,BUMA.1121.00049,2,2965103,2981651,+,16548
494,BUMA.1121.00078,2,2004066,2020552,-,16486
494,BUMA.1121.00069,2,1124755,1141392,+,16637
494,BUMA.1121.00102,2,1200991,1217588,+,16597
494,BUMA.1121.00112,2,3221990,3238505,-,16515
494,BUMA.1121.00041,2,2093735,2111289,+,17554
494,BUMA.1121.00068,2,2859603,2876218,+,16615
494,BUMA.1121.00076,2,2038179,2054753,+,16574
494,BUMA.1121.00033,2,1889651,1906231,+,16580
494,BUMA.1121.00101,2,2244808,2261343,-,16535
494,BUMA.1121.00105,2,1355673,1372164,-,16491
494,BUMA.1121.00061,2,1116918,1133560,+,16642
494,BUMA.1121.00063,2,1125991,1142633,+,16642
494,BUMA.1121.00059,2,2491504,2507982,-,16478
494,BUMA.1121.00058,2,1700406,1717036,+,16630
494,BUMA.1121.00043,2,1201571,1218007,-,16436
494,BUMA.1121.00055,2,1504207,1520747,-,16540
494,BUMA.1121.00065,2,1196730,1213328,+,16598
494,BUMA.1121.00064,2,1066790,1083366,+,16576
494,BUMA.1121.00047,2,2080469,2097134,+,16665
494,BUMA.1121.00037,2,1510858,1527432,+,16574
494,BUMA.1121.00106,2,651802,668288,-,16486
494,BUMA.1121.00051,2,1150708,1167366,+,16658
494,BUMA.1121.00045,2,1042167,1058764,+,16597
494,BUMA.1121.00056,2,2838585,2855064,-,16479
494,BUMA.1121.00095,2,125669,142142,-,16473
494,BUMA.1121.00082,2,1157069,1173719,+,16650
494,BUMA.1121.00001,2,1042546,1059037,-,16491
494,BUMA.1121.00108,2,1378899,1395607,+,16708
494,BUMA.1121.00083,2,2954026,2970676,+,16650
494,BUMA.1121.00080,2,1151878,1168543,+,16665
494,BUMA.1121.00012,2,534391,550839,-,16448
495,BUMA.1121.00011,2,3047312,3084749,+,37437
495,BUMA.1121.00009,2,3069844,3107259,+,37415
495,BUMA.1121.00039,2,2750138,2787536,-,37398
495,BUMA.1121.00029,2,114093,151508,-,37415
495,BUMA.1121.00021,2,1689591,1726990,+,37399
495,BUMA.1121.00107,2,2641284,2678756,-,37472
495,BUMA.1121.00023,2,1263090,1300505,+,37415
495,BUMA.1121.00067,2,2772457,2809918,-,37461
495,BUMA.1121.00035,2,92607,130001,-,37394
495,BUMA.1121.00005,2,2601099,2638638,+,37539
495,BUMA.1121.00100,2,2273421,2311057,+,37636
495,BUMA.1121.00016,2,2499614,2537144,-,37530
495,BUMA.1121.00099,2,1425882,1463183,+,37301
495,BUMA.1121.00094,2,1210727,1248152,+,37425
495,BUMA.1121.00093,2,1727117,1764539,-,37422
495,BUMA.1121.00097,2,1016645,1054010,+,37365
495,BUMA.1121.00109,2,206981,244449,-,37468
495,BUMA.1121.00018,2,2595830,2633304,-,37474
495,BUMA.1121.00110,2,1195526,1233007,-,37481
495,BUMA.1121.00079,2,1168036,1205496,+,37460
495,BUMA.1121.00075,2,1460843,1498351,+,37508
495,BUMA.1121.00066,2,1149273,1186712,+,37439
495,BUMA.1121.00089,2,1155550,1192976,+,37426
495,BUMA.1121.00057,2,887296,924743,-,37447
495,BUMA.1121.00090,2,2156953,2194434,+,37481
495,BUMA.1121.00027,2,2225457,2262882,+,37425
495,BUMA.1121.00062,2,577289,614737,-,37448
495,BUMA.1121.00091,2,2423218,2460664,-,37446
495,BUMA.1121.00098,2,1424175,1461552,+,37377
495,BUMA.1121.00092,2,1180517,1217960,+,37443
495,BUMA.1121.00031,2,360289,397712,+,37423
495,BUMA.1121.00096,2,1382838,1420414,+,37576
495,BUMA.1121.00073,2,1143716,1181155,+,37439
495,BUMA.1121.00103,2,3084598,3122015,+,37417
495,BUMA.1121.00084,2,2995090,3032490,+,37400
495,BUMA.1121.00014,2,1293672,1331193,+,37521
495,BUMA.1121.00111,2,444530,481915,+,37385
495,BUMA.1121.00007,2,1209427,1246742,+,37315
495,BUMA.1121.00072,2,1139878,1177313,+,37435
495,BUMA.1121.00071,2,1143054,1180493,+,37439
495,BUMA.1121.00077,2,2489177,2526674,-,37497
495,BUMA.1121.00003,2,2710705,2748245,-,37540
495,BUMA.1121.00104,2,1261569,1298983,+,37414
495,BUMA.1121.00074,2,3158153,3195579,-,37426
495,BUMA.1121.00060,2,997629,1035018,-,37389
495,BUMA.1121.00088,2,1110727,1148354,+,37627
495,BUMA.1121.00053,2,1454202,1491711,+,37509
495,BUMA.1121.00025,2,2929729,2967168,-,37439
495,BUMA.1121.00070,2,1143769,1181208,+,37439
495,BUMA.1121.00049,2,2981782,3019181,+,37399
495,BUMA.1121.00078,2,1966401,2003935,-,37534
495,BUMA.1121.00069,2,1141523,1178962,+,37439
495,BUMA.1121.00102,2,1217719,1255369,+,37650
495,BUMA.1121.00112,2,3184422,3221859,-,37437
495,BUMA.1121.00041,2,2111420,2148659,+,37239
495,BUMA.1121.00068,2,2876350,2914391,+,38041
495,BUMA.1121.00076,2,2054884,2092346,+,37462
495,BUMA.1121.00033,2,1907953,1945361,+,37408
495,BUMA.1121.00101,2,2207345,2244677,-,37332
495,BUMA.1121.00105,2,1318021,1355539,-,37518
495,BUMA.1121.00061,2,1133691,1171129,+,37438
495,BUMA.1121.00063,2,1142764,1180201,+,37437
495,BUMA.1121.00059,2,2453660,2491373,-,37713
495,BUMA.1121.00058,2,1717170,1754633,+,37463
495,BUMA.1121.00043,2,1162403,1199849,-,37446
495,BUMA.1121.00055,2,1466656,1504076,-,37420
495,BUMA.1121.00065,2,1215052,1252456,+,37404
495,BUMA.1121.00064,2,1083497,1120939,+,37442
495,BUMA.1121.00047,2,2097264,2134829,+,37565
495,BUMA.1121.00037,2,1529155,1566580,+,37425
495,BUMA.1121.00106,2,614241,651668,-,37427
495,BUMA.1121.00051,2,1167496,1204941,+,37445
495,BUMA.1121.00045,2,1058896,1096285,+,37389
495,BUMA.1121.00056,2,2801046,2838451,-,37405
495,BUMA.1121.00095,2,88015,125538,-,37523
495,BUMA.1121.00082,2,1173850,1211289,+,37439
495,BUMA.1121.00001,2,1003430,1040822,-,37392
495,BUMA.1121.00108,2,1395739,1433096,+,37357
495,BUMA.1121.00083,2,2970807,3008246,+,37439
495,BUMA.1121.00080,2,1168673,1206168,+,37495
495,BUMA.1121.00012,2,495185,532668,-,37483
496,BUMA.1121.00011,2,3089305,3117640,+,28335
496,BUMA.1121.00009,2,3111838,3140200,+,28362
496,BUMA.1121.00039,2,2717283,2745546,-,28263
496,BUMA.1121.00029,2,81173,109527,-,28354
496,BUMA.1121.00021,2,1731556,1759866,+,28310
496,BUMA.1121.00107,2,2608368,2636681,-,28313
496,BUMA.1121.00023,2,1305071,1333533,+,28462
496,BUMA.1121.00067,2,2739462,2767880,-,28418
496,BUMA.1121.00035,2,59693,88041,-,28348
496,BUMA.1121.00005,2,2643203,2671554,+,28351
496,BUMA.1121.00100,2,2315635,2343829,+,28194
496,BUMA.1121.00016,2,2466683,2495048,-,28365
496,BUMA.1121.00099,2,1467749,1496024,+,28275
496,BUMA.1121.00094,2,1252729,1281026,+,28297
496,BUMA.1121.00093,2,1694392,1722552,-,28160
496,BUMA.1121.00097,2,1058583,1086912,+,28329
496,BUMA.1121.00109,2,174035,202390,-,28355
496,BUMA.1121.00018,2,2562855,2591253,-,28398
496,BUMA.1121.00110,2,1162729,1190946,-,28217
496,BUMA.1121.00079,2,1210072,1238490,+,28418
496,BUMA.1121.00075,2,1502916,1531231,+,28315
496,BUMA.1121.00066,2,1191290,1219713,+,28423
496,BUMA.1121.00089,2,1197553,1225871,+,28318
496,BUMA.1121.00057,2,854182,882719,-,28537
496,BUMA.1121.00090,2,2199000,2227352,+,28352
496,BUMA.1121.00027,2,2267459,2295752,+,28293
496,BUMA.1121.00062,2,544452,572725,-,28273
496,BUMA.1121.00091,2,2388053,2416354,-,28301
496,BUMA.1121.00098,2,1466093,1494453,+,28360
496,BUMA.1121.00092,2,1222525,1250804,+,28279
496,BUMA.1121.00031,2,402272,430702,+,28430
496,BUMA.1121.00096,2,1424993,1453333,+,28340
496,BUMA.1121.00073,2,1185733,1214227,+,28494
496,BUMA.1121.00103,2,3126580,3154803,+,28223
496,BUMA.1121.00084,2,3037067,3065498,+,28431
496,BUMA.1121.00014,2,1335760,1364190,+,28430
496,BUMA.1121.00111,2,486481,514877,+,28396
496,BUMA.1121.00007,2,1251320,1279604,+,28284
496,BUMA.1121.00072,2,1181891,1210377,+,28486
496,BUMA.1121.00071,2,1185071,1213561,+,28490
496,BUMA.1121.00077,2,2456381,2484597,-,28216
496,BUMA.1121.00003,2,2675082,2703300,-,28218
496,BUMA.1121.00104,2,1303560,1332020,+,28460
496,BUMA.1121.00074,2,3125144,3153575,-,28431
496,BUMA.1121.00060,2,964746,993058,-,28312
496,BUMA.1121.00088,2,1152920,1181182,+,28262
496,BUMA.1121.00053,2,1498562,1526953,+,28391
496,BUMA.1121.00025,2,2896761,2925151,-,28390
496,BUMA.1121.00070,2,1185786,1214280,+,28494
496,BUMA.1121.00049,2,3023758,3052142,+,28384
496,BUMA.1121.00078,2,1938022,1966364,-,28342
496,BUMA.1121.00069,2,1183540,1212034,+,28494
496,BUMA.1121.00102,2,1262234,1290592,+,28358
496,BUMA.1121.00112,2,3151479,3179880,-,28401
496,BUMA.1121.00041,2,2153235,2181655,+,28420
496,BUMA.1121.00068,2,2918956,2947453,+,28497
496,BUMA.1121.00076,2,2096911,2125212,+,28301
496,BUMA.1121.00033,2,1949927,1978317,+,28390
496,BUMA.1121.00101,2,2174461,2202780,-,28319
496,BUMA.1121.00105,2,1285233,1313455,-,28222
496,BUMA.1121.00061,2,1175707,1204138,+,28431
496,BUMA.1121.00063,2,1184779,1213262,+,28483
496,BUMA.1121.00059,2,2420752,2449083,-,28331
496,BUMA.1121.00058,2,1759210,1787427,+,28217
496,BUMA.1121.00043,2,1129540,1157838,-,28298
496,BUMA.1121.00055,2,1433409,1462090,-,28681
496,BUMA.1121.00065,2,1257021,1285322,+,28301
496,BUMA.1121.00064,2,1125504,1153814,+,28310
496,BUMA.1121.00047,2,2139405,2167840,+,28435
496,BUMA.1121.00037,2,1571146,1599643,+,28497
496,BUMA.1121.00106,2,581271,609664,-,28393
496,BUMA.1121.00051,2,1209517,1238020,+,28503
496,BUMA.1121.00045,2,1100856,1129183,+,28327
496,BUMA.1121.00056,2,2768150,2796469,-,28319
496,BUMA.1121.00095,2,55251,83425,-,28174
496,BUMA.1121.00082,2,1215867,1244362,+,28495
496,BUMA.1121.00001,2,970556,998864,-,28308
496,BUMA.1121.00108,2,1437659,1466007,+,28348
496,BUMA.1121.00083,2,3012824,3041319,+,28495
496,BUMA.1121.00080,2,1210744,1239228,+,28484
496,BUMA.1121.00012,2,462364,490620,-,28256
497,BUMA.1121.00011,2,3118372,3128519,+,10147
497,BUMA.1121.00009,2,3140918,3151084,+,10166
497,BUMA.1121.00039,2,2706379,2716566,-,10187
497,BUMA.1121.00029,2,70280,80456,-,10176
497,BUMA.1121.00021,2,1760584,1770671,+,10087
497,BUMA.1121.00107,2,2597445,2607651,-,10206
497,BUMA.1121.00023,2,1334265,1344445,+,10180
497,BUMA.1121.00067,2,2728557,2738730,-,10173
497,BUMA.1121.00035,2,48800,58976,-,10176
497,BUMA.1121.00005,2,2672286,2682383,+,10097
497,BUMA.1121.00100,2,2344561,2354717,+,10156
497,BUMA.1121.00016,2,2455795,2465966,-,10171
497,BUMA.1121.00099,2,1496756,1506942,+,10186
497,BUMA.1121.00094,2,1281758,1291919,+,10161
497,BUMA.1121.00093,2,1683494,1693660,-,10166
497,BUMA.1121.00097,2,1087644,1097809,+,10165
497,BUMA.1121.00109,2,163135,173303,-,10168
497,BUMA.1121.00018,2,2551973,2562138,-,10165
497,BUMA.1121.00110,2,1151851,1161997,-,10146
497,BUMA.1121.00079,2,1239222,1249391,+,10169
497,BUMA.1121.00075,2,1531963,1542140,+,10177
497,BUMA.1121.00066,2,1220445,1230575,+,10130
497,BUMA.1121.00089,2,1226603,1236764,+,10161
497,BUMA.1121.00057,2,843286,853450,-,10164
497,BUMA.1121.00090,2,2228070,2238256,+,10186
497,BUMA.1121.00027,2,2296484,2306603,+,10119
497,BUMA.1121.00062,2,533554,543720,-,10166
497,BUMA.1121.00091,2,2377155,2387321,-,10166
497,BUMA.1121.00098,2,1495171,1505357,+,10186
497,BUMA.1121.00092,2,1251536,1261702,+,10166
497,BUMA.1121.00031,2,431420,441592,+,10172
497,BUMA.1121.00096,2,1454065,1464229,+,10164
497,BUMA.1121.00073,2,1214959,1225089,+,10130
497,BUMA.1121.00103,2,3155535,3165700,+,10165
497,BUMA.1121.00084,2,3066230,3076400,+,10170
497,BUMA.1121.00014,2,1364908,1375080,+,10172
497,BUMA.1121.00111,2,515595,525781,+,10186
497,BUMA.1121.00007,2,1280336,1290512,+,10176
497,BUMA.1121.00072,2,1211109,1221239,+,10130
497,BUMA.1121.00071,2,1214293,1224421,+,10128
497,BUMA.1121.00077,2,2445503,2455649,-,10146
497,BUMA.1121.00003,2,2664193,2674350,-,10157
497,BUMA.1121.00104,2,1332752,1342926,+,10174
497,BUMA.1121.00074,2,3114239,3124412,-,10173
497,BUMA.1121.00060,2,953842,964014,-,10172
497,BUMA.1121.00088,2,1181900,1192075,+,10175
497,BUMA.1121.00053,2,1527685,1537858,+,10173
497,BUMA.1121.00025,2,2885879,2896044,-,10165
497,BUMA.1121.00070,2,1215012,1225142,+,10130
497,BUMA.1121.00049,2,3052874,3063053,+,10179
497,BUMA.1121.00078,2,1927158,1937290,-,10132
497,BUMA.1121.00069,2,1212766,1222896,+,10130
497,BUMA.1121.00102,2,1291324,1301457,+,10133
497,BUMA.1121.00112,2,3140580,3150747,-,10167
497,BUMA.1121.00041,2,2182387,2192551,+,10164
497,BUMA.1121.00068,2,2948185,2958333,+,10148
497,BUMA.1121.00076,2,2125944,2136124,+,10180
497,BUMA.1121.00033,2,1979035,1989221,+,10186
497,BUMA.1121.00101,2,2163557,2173729,-,10172
497,BUMA.1121.00105,2,1274339,1284501,-,10162
497,BUMA.1121.00061,2,1204870,1215000,+,10130
497,BUMA.1121.00063,2,1213994,1224122,+,10128
497,BUMA.1121.00059,2,2409861,2420020,-,10159
497,BUMA.1121.00058,2,1788145,1798335,+,10190
497,BUMA.1121.00043,2,1118663,1128823,-,10160
497,BUMA.1121.00055,2,1422530,1432677,-,10147
497,BUMA.1121.00065,2,1286054,1296225,+,10171
497,BUMA.1121.00064,2,1154532,1164712,+,10180
497,BUMA.1121.00047,2,2168572,2178727,+,10155
497,BUMA.1121.00037,2,1600361,1610533,+,10172
497,BUMA.1121.00106,2,570373,580554,-,10181
497,BUMA.1121.00051,2,1238752,1248912,+,10160
497,BUMA.1121.00045,2,1129915,1140087,+,10172
497,BUMA.1121.00056,2,2757257,2767418,-,10161
497,BUMA.1121.00095,2,44353,54519,-,10166
497,BUMA.1121.00082,2,1245094,1255224,+,10130
497,BUMA.1121.00001,2,959663,969839,-,10176
497,BUMA.1121.00108,2,1466739,1476925,+,10186
497,BUMA.1121.00083,2,3042051,3052181,+,10130
497,BUMA.1121.00080,2,1239960,1250121,+,10161
497,BUMA.1121.00012,2,451461,461647,-,10186
498,BUMA.1121.00011,2,3129625,3144256,+,14631
498,BUMA.1121.00009,2,3152190,3166814,+,14624
498,BUMA.1121.00039,2,2690642,2705273,-,14631
498,BUMA.1121.00029,2,54540,69174,-,14634
498,BUMA.1121.00021,2,1771777,1786409,+,14632
498,BUMA.1121.00107,2,2581706,2596339,-,14633
498,BUMA.1121.00023,2,1345551,1360183,+,14632
498,BUMA.1121.00067,2,2712826,2727451,-,14625
498,BUMA.1121.00035,2,33060,47694,-,14634
498,BUMA.1121.00005,2,2683489,2698125,+,14636
498,BUMA.1121.00100,2,2355823,2370457,+,14634
498,BUMA.1121.00016,2,2440067,2454689,-,14622
498,BUMA.1121.00099,2,1508048,1522685,+,14637
498,BUMA.1121.00094,2,1293025,1307657,+,14632
498,BUMA.1121.00093,2,1667757,1682388,-,14631
498,BUMA.1121.00097,2,1098924,1113501,+,14577
498,BUMA.1121.00109,2,147396,162020,-,14624
498,BUMA.1121.00018,2,2536236,2550867,-,14631
498,BUMA.1121.00110,2,1136120,1150745,-,14625
498,BUMA.1121.00079,2,1250497,1265129,+,14632
498,BUMA.1121.00075,2,1543246,1557878,+,14632
498,BUMA.1121.00066,2,1231681,1246307,+,14626
498,BUMA.1121.00089,2,1237870,1252502,+,14632
498,BUMA.1121.00057,2,827549,842180,-,14631
498,BUMA.1121.00090,2,2239362,2253994,+,14632
498,BUMA.1121.00027,2,2307709,2322339,+,14630
498,BUMA.1121.00062,2,517817,532448,-,14631
498,BUMA.1121.00091,2,2361420,2376049,-,14629
498,BUMA.1121.00098,2,1506463,1520997,+,14534
498,BUMA.1121.00092,2,1262808,1277440,+,14632
498,BUMA.1121.00031,2,442698,457339,+,14641
498,BUMA.1121.00096,2,1465335,1479973,+,14638
498,BUMA.1121.00073,2,1226195,1240827,+,14632
498,BUMA.1121.00103,2,3166806,3182645,+,15839
498,BUMA.1121.00084,2,3077506,3092140,+,14634
498,BUMA.1121.00014,2,1376186,1390827,+,14641
498,BUMA.1121.00111,2,526887,541510,+,14623
498,BUMA.1121.00007,2,1291618,1306214,+,14596
498,BUMA.1121.00072,2,1222345,1236977,+,14632
498,BUMA.1121.00071,2,1225527,1240159,+,14632
498,BUMA.1121.00077,2,2429772,2444397,-,14625
498,BUMA.1121.00003,2,2648466,2663087,-,14621
498,BUMA.1121.00104,2,1344032,1358565,+,14533
498,BUMA.1121.00074,2,3098508,3113133,-,14625
498,BUMA.1121.00060,2,938105,952736,-,14631
498,BUMA.1121.00088,2,1193181,1207818,+,14637
498,BUMA.1121.00053,2,1538964,1553598,+,14634
498,BUMA.1121.00025,2,2870142,2884773,-,14631
498,BUMA.1121.00070,2,1226248,1240880,+,14632
498,BUMA.1121.00049,2,3064159,3078791,+,14632
498,BUMA.1121.00078,2,1911452,1926052,-,14600
498,BUMA.1121.00069,2,1224002,1238634,+,14632
498,BUMA.1121.00102,2,1302563,1317069,+,14506
498,BUMA.1121.00112,2,3124972,3139474,-,14502
498,BUMA.1121.00041,2,2193657,2208288,+,14631
498,BUMA.1121.00068,2,2959439,2974081,+,14642
498,BUMA.1121.00076,2,2137230,2151862,+,14632
498,BUMA.1121.00033,2,1990327,2004957,+,14630
498,BUMA.1121.00101,2,2147915,2162451,-,14536
498,BUMA.1121.00105,2,1258602,1273233,-,14631
498,BUMA.1121.00061,2,1216106,1230736,+,14630
498,BUMA.1121.00063,2,1225228,1239858,+,14630
498,BUMA.1121.00059,2,2394124,2408755,-,14631
498,BUMA.1121.00058,2,1799441,1814073,+,14632
498,BUMA.1121.00043,2,1102935,1117557,-,14622
498,BUMA.1121.00055,2,1406791,1421424,-,14633
498,BUMA.1121.00065,2,1297331,1311865,+,14534
498,BUMA.1121.00064,2,1165818,1180450,+,14632
498,BUMA.1121.00047,2,2179833,2194465,+,14632
498,BUMA.1121.00037,2,1611639,1626280,+,14641
498,BUMA.1121.00106,2,554636,569267,-,14631
498,BUMA.1121.00051,2,1250018,1264650,+,14632
498,BUMA.1121.00045,2,1141193,1155825,+,14632
498,BUMA.1121.00056,2,2741520,2756151,-,14631
498,BUMA.1121.00095,2,28626,43246,-,14620
498,BUMA.1121.00082,2,1256330,1270962,+,14632
498,BUMA.1121.00001,2,943923,958557,-,14634
498,BUMA.1121.00108,2,1478031,1492541,+,14510
498,BUMA.1121.00083,2,3053287,3067919,+,14632
498,BUMA.1121.00080,2,1251227,1265859,+,14632
498,BUMA.1121.00012,2,435724,450355,-,14631
499,BUMA.1121.00011,2,3144257,3147740,+,3483
499,BUMA.1121.00009,2,3166815,3170298,+,3483
499,BUMA.1121.00039,2,2687157,2690640,-,3483
499,BUMA.1121.00029,2,51056,54538,-,3482
499,BUMA.1121.00021,2,1786410,1789892,+,3482
499,BUMA.1121.00107,2,2578221,2581704,-,3483
499,BUMA.1121.00023,2,1360184,1363667,+,3483
499,BUMA.1121.00067,2,2709342,2712824,-,3482
499,BUMA.1121.00035,2,29576,33058,-,3482
499,BUMA.1121.00005,2,2698126,2701609,+,3483
499,BUMA.1121.00100,2,2370458,2373892,+,3434
499,BUMA.1121.00016,2,2436582,2440065,-,3483
499,BUMA.1121.00099,2,1522686,1526169,+,3483
499,BUMA.1121.00094,2,1307658,1311140,+,3482
499,BUMA.1121.00093,2,1664271,1667755,-,3484
499,BUMA.1121.00097,2,1113502,1116985,+,3483
499,BUMA.1121.00109,2,143910,147394,-,3484
499,BUMA.1121.00018,2,2532751,2536234,-,3483
499,BUMA.1121.00110,2,1132634,1136118,-,3484
499,BUMA.1121.00079,2,1265130,1268611,+,3481
499,BUMA.1121.00075,2,1557879,1561361,+,3482
499,BUMA.1121.00066,2,1246308,1249790,+,3482
499,BUMA.1121.00089,2,1252503,1255985,+,3482
499,BUMA.1121.00057,2,824063,827547,-,3484
499,BUMA.1121.00090,2,2253995,2257477,+,3482
499,BUMA.1121.00027,2,2322340,2325824,+,3484
499,BUMA.1121.00062,2,514331,517815,-,3484
499,BUMA.1121.00091,2,2357936,2361418,-,3482
499,BUMA.1121.00098,2,1520998,1524481,+,3483
499,BUMA.1121.00092,2,1277441,1280925,+,3484
499,BUMA.1121.00031,2,457340,460822,+,3482
499,BUMA.1121.00096,2,1479974,1483456,+,3482
499,BUMA.1121.00073,2,1240828,1244312,+,3484
499,BUMA.1121.00103,2,3182646,3186130,+,3484
499,BUMA.1121.00084,2,3092141,3095623,+,3482
499,BUMA.1121.00014,2,1390828,1394310,+,3482
499,BUMA.1121.00111,2,541511,544993,+,3482
499,BUMA.1121.00007,2,1306215,1309698,+,3483
499,BUMA.1121.00072,2,1236978,1240462,+,3484
499,BUMA.1121.00071,2,1240160,1243644,+,3484
499,BUMA.1121.00077,2,2426286,2429770,-,3484
499,BUMA.1121.00003,2,2644982,2648464,-,3482
499,BUMA.1121.00104,2,1358566,1362049,+,3483
499,BUMA.1121.00074,2,3095024,3098506,-,3482
499,BUMA.1121.00060,2,934620,938103,-,3483
499,BUMA.1121.00088,2,1207819,1211301,+,3482
499,BUMA.1121.00053,2,1553599,1557081,+,3482
499,BUMA.1121.00025,2,2866657,2870140,-,3483
499,BUMA.1121.00070,2,1240881,1244365,+,3484
499,BUMA.1121.00049,2,3078792,3082274,+,3482
499,BUMA.1121.00078,2,1872529,1876028,-,3499
499,BUMA.1121.00069,2,1238635,1242118,+,3483
499,BUMA.1121.00102,2,1317070,1320552,+,3482
499,BUMA.1121.00112,2,3121488,3124970,-,3482
499,BUMA.1121.00041,2,2208289,2211772,+,3483
499,BUMA.1121.00068,2,2974082,2977565,+,3483
499,BUMA.1121.00076,2,2151863,2155345,+,3482
499,BUMA.1121.00033,2,2004958,2008440,+,3482
499,BUMA.1121.00101,2,2144431,2147913,-,3482
499,BUMA.1121.00105,2,1255117,1258600,-,3483
499,BUMA.1121.00061,2,1230737,1234220,+,3483
499,BUMA.1121.00063,2,1239859,1243342,+,3483
499,BUMA.1121.00059,2,2390640,2394122,-,3482
499,BUMA.1121.00058,2,1814074,1817556,+,3482
499,BUMA.1121.00043,2,1099450,1102933,-,3483
499,BUMA.1121.00055,2,1403307,1406789,-,3482
499,BUMA.1121.00065,2,1311866,1315348,+,3482
499,BUMA.1121.00064,2,1180451,1183933,+,3482
499,BUMA.1121.00047,2,2194466,2197949,+,3483
499,BUMA.1121.00037,2,1626281,1629763,+,3482
499,BUMA.1121.00106,2,551152,554634,-,3482
499,BUMA.1121.00051,2,1264651,1268133,+,3482
499,BUMA.1121.00045,2,1155826,1159309,+,3483
499,BUMA.1121.00056,2,2738036,2741518,-,3482
499,BUMA.1121.00095,2,25141,28624,-,3483
499,BUMA.1121.00082,2,1270963,1274447,+,3484
499,BUMA.1121.00001,2,940439,943921,-,3482
499,BUMA.1121.00108,2,1492542,1496025,+,3483
499,BUMA.1121.00083,2,3067920,3071404,+,3484
499,BUMA.1121.00080,2,1265860,1269342,+,3482
499,BUMA.1121.00012,2,432240,435722,-,3482
500,BUMA.1121.00011,2,3148383,3172681,+,24298
500,BUMA.1121.00009,2,3170941,3195318,+,24377
500,BUMA.1121.00039,2,2662190,2686514,-,24324
500,BUMA.1121.00029,2,26090,50413,-,24323
500,BUMA.1121.00021,2,1790535,1814862,+,24327
500,BUMA.1121.00107,2,2553263,2577578,-,24315
500,BUMA.1121.00023,2,1364310,1388633,+,24323
500,BUMA.1121.00067,2,2684396,2708699,-,24303
500,BUMA.1121.00035,2,4609,28933,-,24324
500,BUMA.1121.00005,2,2702252,2726512,+,24260
500,BUMA.1121.00100,2,2374535,2398796,+,24261
500,BUMA.1121.00016,2,2411617,2435939,-,24322
500,BUMA.1121.00099,2,1526812,1551076,+,24264
500,BUMA.1121.00094,2,1311783,1336112,+,24329
500,BUMA.1121.00093,2,1639300,1663628,-,24328
500,BUMA.1121.00097,2,1117628,1141917,+,24289
500,BUMA.1121.00109,2,118997,143267,-,24270
500,BUMA.1121.00018,2,2507786,2532108,-,24322
500,BUMA.1121.00110,2,1107683,1131991,-,24308
500,BUMA.1121.00079,2,1269254,1293591,+,24337
500,BUMA.1121.00075,2,1562004,1586346,+,24342
500,BUMA.1121.00066,2,1250433,1274719,+,24286
500,BUMA.1121.00089,2,1256628,1280969,+,24341
500,BUMA.1121.00057,2,799090,823420,-,24330
500,BUMA.1121.00090,2,2258120,2282443,+,24323
500,BUMA.1121.00027,2,2326467,2350805,+,24338
500,BUMA.1121.00062,2,489373,513688,-,24315
500,BUMA.1121.00091,2,2332976,2357293,-,24317
500,BUMA.1121.00098,2,1525124,1549404,+,24280
500,BUMA.1121.00092,2,1281568,1305897,+,24329
500,BUMA.1121.00031,2,461465,485782,+,24317
500,BUMA.1121.00096,2,1484099,1508426,+,24327
500,BUMA.1121.00073,2,1244955,1269237,+,24282
500,BUMA.1121.00103,2,3186773,3211084,+,24311
500,BUMA.1121.00084,2,3096266,3120586,+,24320
500,BUMA.1121.00014,2,1394953,1419270,+,24317
500,BUMA.1121.00111,2,545636,569949,+,24313
500,BUMA.1121.00007,2,1310341,1334605,+,24264
500,BUMA.1121.00072,2,1241105,1265386,+,24281
500,BUMA.1121.00071,2,1244287,1268573,+,24286
500,BUMA.1121.00077,2,2401337,2425643,-,24306
500,BUMA.1121.00003,2,2619994,2644339,-,24345
500,BUMA.1121.00104,2,1362692,1387036,+,24344
500,BUMA.1121.00074,2,3070055,3094381,-,24326
500,BUMA.1121.00060,2,909635,933977,-,24342
500,BUMA.1121.00088,2,1211944,1236301,+,24357
500,BUMA.1121.00053,2,1557724,1582116,+,24392
500,BUMA.1121.00025,2,2841693,2866014,-,24321
500,BUMA.1121.00070,2,1245008,1269287,+,24279
500,BUMA.1121.00049,2,3082917,3107235,+,24318
500,BUMA.1121.00078,2,1847544,1871886,-,24342
500,BUMA.1121.00069,2,1242761,1267037,+,24276
500,BUMA.1121.00102,2,1321195,1345459,+,24264
500,BUMA.1121.00112,2,3096550,3120845,-,24295
500,BUMA.1121.00041,2,2212415,2236738,+,24323
500,BUMA.1121.00068,2,2978208,3002443,+,24235
500,BUMA.1121.00076,2,2155988,2180332,+,24344
500,BUMA.1121.00033,2,2009083,2033404,+,24321
500,BUMA.1121.00101,2,2119464,2143788,-,24324
500,BUMA.1121.00105,2,1230147,1254474,-,24327
500,BUMA.1121.00061,2,1234863,1259139,+,24276
500,BUMA.1121.00063,2,1243985,1268267,+,24282
500,BUMA.1121.00059,2,2365724,2389997,-,24273
500,BUMA.1121.00058,2,1818199,1842428,+,24229
500,BUMA.1121.00043,2,1074485,1098807,-,24322
500,BUMA.1121.00055,2,1378351,1402664,-,24313
500,BUMA.1121.00065,2,1315991,1340284,+,24293
500,BUMA.1121.00064,2,1184576,1208896,+,24320
500,BUMA.1121.00047,2,2198592,2222916,+,24324
500,BUMA.1121.00037,2,1630406,1654724,+,24318
500,BUMA.1121.00106,2,526174,550509,-,24335
500,BUMA.1121.00051,2,1268776,1293112,+,24336
500,BUMA.1121.00045,2,1159952,1184295,+,24343
500,BUMA.1121.00056,2,2713053,2737393,-,24340
500,BUMA.1121.00095,2,192,24498,-,24306
500,BUMA.1121.00082,2,1275090,1299376,+,24286
500,BUMA.1121.00001,2,915472,939796,-,24324
500,BUMA.1121.00108,2,1496668,1521010,+,24342
500,BUMA.1121.00083,2,3072047,3096333,+,24286
500,BUMA.1121.00080,2,1269985,1294318,+,24333
500,BUMA.1121.00012,2,407281,431597,-,24316
501,BUMA.1121.00011,2,3178162,3181440,+,3278
501,BUMA.1121.00009,2,3200783,3204052,+,3269
501,BUMA.1121.00039,2,2653429,2656707,-,3278
501,BUMA.1121.00029,2,17324,20593,-,3269
501,BUMA.1121.00021,2,1820345,1823623,+,3278
501,BUMA.1121.00107,2,2544495,2547773,-,3278
501,BUMA.1121.00023,2,1394116,1397394,+,3278
501,BUMA.1121.00067,2,2675610,2678888,-,3278
501,BUMA.1121.00035,2,3302383,3305652,-,3269
501,BUMA.1121.00005,2,2731999,2735277,+,3278
501,BUMA.1121.00100,2,2404286,2407564,+,3278
501,BUMA.1121.00016,2,2402856,2406134,-,3278
501,BUMA.1121.00099,2,1556566,1559834,+,3268
501,BUMA.1121.00094,2,1341601,1344870,+,3269
501,BUMA.1121.00093,2,1630503,1633781,-,3278
501,BUMA.1121.00097,2,1147392,1150670,+,3278
501,BUMA.1121.00109,2,110225,113512,-,3287
501,BUMA.1121.00018,2,2499022,2502300,-,3278
501,BUMA.1121.00110,2,1098904,1102182,-,3278
501,BUMA.1121.00079,2,1299036,1302305,+,3269
501,BUMA.1121.00075,2,1591833,1595102,+,3269
501,BUMA.1121.00066,2,1280208,1283477,+,3269
501,BUMA.1121.00089,2,1286458,1289727,+,3269
501,BUMA.1121.00057,2,790332,793601,-,3269
501,BUMA.1121.00090,2,2287926,2291204,+,3278
501,BUMA.1121.00027,2,2356309,2359587,+,3278
501,BUMA.1121.00062,2,480618,483896,-,3278
501,BUMA.1121.00091,2,2324222,2327499,-,3277
501,BUMA.1121.00098,2,1554923,1558201,+,3278
501,BUMA.1121.00092,2,1311416,1314694,+,3278
501,BUMA.1121.00031,2,491254,494523,+,3269
501,BUMA.1121.00096,2,1513915,1517193,+,3278
501,BUMA.1121.00073,2,1274726,1277995,+,3269
501,BUMA.1121.00103,2,3216563,3219841,+,3278
501,BUMA.1121.00084,2,3126069,3129347,+,3278
501,BUMA.1121.00014,2,1424742,1428011,+,3269
501,BUMA.1121.00111,2,575438,578716,+,3278
501,BUMA.1121.00007,2,1340095,1343373,+,3278
501,BUMA.1121.00072,2,1270878,1274147,+,3269
501,BUMA.1121.00071,2,1274062,1277331,+,3269
501,BUMA.1121.00077,2,2392558,2395836,-,3278
501,BUMA.1121.00003,2,2611243,2614521,-,3278
501,BUMA.1121.00104,2,1392525,1395803,+,3278
501,BUMA.1121.00074,2,3061286,3064573,-,3287
501,BUMA.1121.00060,2,900868,904146,-,3278
501,BUMA.1121.00088,2,1241744,1245022,+,3278
501,BUMA.1121.00053,2,1587612,1590881,+,3269
501,BUMA.1121.00025,2,2832929,2836207,-,3278
501,BUMA.1121.00070,2,1274776,1278045,+,3269
501,BUMA.1121.00049,2,3112721,3115997,+,3276
501,BUMA.1121.00078,2,1838747,1842025,-,3278
501,BUMA.1121.00069,2,1272529,1275798,+,3269
501,BUMA.1121.00102,2,1350955,1354224,+,3269
501,BUMA.1121.00112,2,3087764,3091042,-,3278
501,BUMA.1121.00041,2,2242237,2245506,+,3269
501,BUMA.1121.00068,2,3007927,3011214,+,3287
501,BUMA.1121.00076,2,2185819,2189088,+,3269
501,BUMA.1121.00033,2,2038897,2042175,+,3278
501,BUMA.1121.00101,2,2110678,2113965,-,3287
501,BUMA.1121.00105,2,1221425,1224703,-,3278
501,BUMA.1121.00061,2,1264631,1267900,+,3269
501,BUMA.1121.00063,2,1273759,1277028,+,3269
501,BUMA.1121.00059,2,2356963,2360241,-,3278
501,BUMA.1121.00058,2,1847912,1851190,+,3278
501,BUMA.1121.00043,2,1065709,1068988,-,3279
501,BUMA.1121.00055,2,1369586,1372864,-,3278
501,BUMA.1121.00065,2,1345783,1349061,+,3278
501,BUMA.1121.00064,2,1214380,1217658,+,3278
501,BUMA.1121.00047,2,2228405,2231674,+,3269
501,BUMA.1121.00037,2,1660214,1663483,+,3269
501,BUMA.1121.00106,2,517412,520687,-,3275
501,BUMA.1121.00051,2,1298599,1301868,+,3269
501,BUMA.1121.00045,2,1189784,1193062,+,3278
501,BUMA.1121.00056,2,2704295,2707564,-,3269
501,BUMA.1121.00095,2,3331487,3334764,-,3277
501,BUMA.1121.00082,2,1304865,1308134,+,3269
501,BUMA.1121.00001,2,906706,909975,-,3269
501,BUMA.1121.00108,2,1526502,1529780,+,3278
501,BUMA.1121.00083,2,3101822,3105091,+,3269
501,BUMA.1121.00080,2,1299807,1303076,+,3269
501,BUMA.1121.00012,2,398513,401791,-,3278
502,BUMA.1121.00011,2,3181848,3197552,+,15704
502,BUMA.1121.00009,2,3204466,3220161,+,15695
502,BUMA.1121.00039,2,2637358,2653017,-,15659
502,BUMA.1121.00029,2,1251,16912,-,15661
502,BUMA.1121.00021,2,1824035,1839718,+,15683
502,BUMA.1121.00107,2,2528389,2544077,-,15688
502,BUMA.1121.00023,2,1398731,1414374,+,15643
502,BUMA.1121.00067,2,2659657,2675198,-,15541
502,BUMA.1121.00035,2,3286309,3301971,-,15662
502,BUMA.1121.00005,2,2735680,2751390,+,15710
502,BUMA.1121.00100,2,2407970,2423662,+,15692
502,BUMA.1121.00016,2,2386782,2402444,-,15662
502,BUMA.1121.00099,2,1560172,1575888,+,15716
502,BUMA.1121.00094,2,1345329,1361001,+,15672
502,BUMA.1121.00093,2,1614273,1630091,-,15818
502,BUMA.1121.00097,2,1151090,1166787,+,15697
502,BUMA.1121.00109,2,94092,109812,-,15720
502,BUMA.1121.00018,2,2482935,2498610,-,15675
502,BUMA.1121.00110,2,1082771,1098491,-,15720
502,BUMA.1121.00079,2,1302741,1318379,+,15638
502,BUMA.1121.00075,2,1595505,1611172,+,15667
502,BUMA.1121.00066,2,1283924,1299564,+,15640
502,BUMA.1121.00089,2,1290184,1305856,+,15672
502,BUMA.1121.00057,2,774242,789882,-,15640
502,BUMA.1121.00090,2,2291616,2307275,+,15659
502,BUMA.1121.00027,2,2359999,2375733,+,15734
502,BUMA.1121.00062,2,464453,480204,-,15751
502,BUMA.1121.00091,2,2308183,2323808,-,15625
502,BUMA.1121.00098,2,1558614,1574286,+,15672
502,BUMA.1121.00092,2,1315106,1330924,+,15818
502,BUMA.1121.00031,2,494946,510613,+,15667
502,BUMA.1121.00096,2,1517607,1533314,+,15707
502,BUMA.1121.00073,2,1278415,1294055,+,15640
502,BUMA.1121.00103,2,3220255,3235982,+,15727
502,BUMA.1121.00084,2,3129741,3145431,+,15690
502,BUMA.1121.00014,2,1428434,1444101,+,15667
502,BUMA.1121.00111,2,579128,594790,+,15662
502,BUMA.1121.00007,2,1343786,1359489,+,15703
502,BUMA.1121.00072,2,1274596,1290236,+,15640
502,BUMA.1121.00071,2,1277748,1293388,+,15640
502,BUMA.1121.00077,2,2376425,2392145,-,15720
502,BUMA.1121.00003,2,2595056,2610823,-,15767
502,BUMA.1121.00104,2,1396215,1411920,+,15705
502,BUMA.1121.00074,2,3045097,3060873,-,15776
502,BUMA.1121.00060,2,884798,900462,-,15664
502,BUMA.1121.00088,2,1245416,1261149,+,15733
502,BUMA.1121.00053,2,1591291,1606981,+,15690
502,BUMA.1121.00025,2,2816842,2832517,-,15675
502,BUMA.1121.00070,2,1278459,1294099,+,15640
502,BUMA.1121.00049,2,3116391,3132105,+,15714
502,BUMA.1121.00078,2,1822655,1838333,-,15678
502,BUMA.1121.00069,2,1276004,1291644,+,15640
502,BUMA.1121.00102,2,1354627,1370402,+,15775
502,BUMA.1121.00112,2,3071645,3087324,-,15679
502,BUMA.1121.00041,2,2245914,2261611,+,15697
502,BUMA.1121.00068,2,3011631,3027312,+,15681
502,BUMA.1121.00076,2,2189491,2205158,+,15667
502,BUMA.1121.00033,2,2042587,2058239,+,15652
502,BUMA.1121.00101,2,2094547,2110266,-,15719
502,BUMA.1121.00105,2,1205323,1221012,-,15689
502,BUMA.1121.00061,2,1268059,1283699,+,15640
502,BUMA.1121.00063,2,1277200,1292840,+,15640
502,BUMA.1121.00059,2,2340887,2356569,-,15682
502,BUMA.1121.00058,2,1851552,1867347,+,15795
502,BUMA.1121.00043,2,1049636,1065297,-,15661
502,BUMA.1121.00055,2,1353441,1369172,-,15731
502,BUMA.1121.00065,2,1349473,1365176,+,15703
502,BUMA.1121.00064,2,1218052,1233734,+,15682
502,BUMA.1121.00047,2,2232117,2247757,+,15640
502,BUMA.1121.00037,2,1663895,1679554,+,15659
502,BUMA.1121.00106,2,501336,517018,-,15682
502,BUMA.1121.00051,2,1302311,1317950,+,15639
502,BUMA.1121.00045,2,1193468,1209132,+,15664
502,BUMA.1121.00056,2,2688166,2703838,-,15672
502,BUMA.1121.00095,2,3315373,3331077,-,15704
502,BUMA.1121.00082,2,1308591,1324231,+,15640
502,BUMA.1121.00001,2,890632,906294,-,15662
502,BUMA.1121.00108,2,1530194,1545890,+,15696
502,BUMA.1121.00083,2,3105548,3121188,+,15640
502,BUMA.1121.00080,2,1303519,1319158,+,15639
502,BUMA.1121.00012,2,381544,397202,-,15658
503,BUMA.1121.00011,2,3198777,3222326,+,23549
503,BUMA.1121.00009,2,3221402,3245009,+,23607
503,BUMA.1121.00039,2,2612784,2636125,-,23341
503,BUMA.1121.00029,2,3244490,3267789,-,23299
503,BUMA.1121.00021,2,1840963,1864271,+,23308
503,BUMA.1121.00107,2,2503690,2527158,-,23468
503,BUMA.1121.00023,2,1415631,1438952,+,23321
503,BUMA.1121.00067,2,2634773,2658388,-,23615
503,BUMA.1121.00035,2,3261768,3285076,-,23308
503,BUMA.1121.00005,2,2752635,2776009,+,23374
503,BUMA.1121.00100,2,2424917,2448398,+,23481
503,BUMA.1121.00016,2,2362263,2385570,-,23307
503,BUMA.1121.00099,2,1577135,1600685,+,23550
503,BUMA.1121.00094,2,1363695,1387005,+,23310
503,BUMA.1121.00093,2,1589523,1613028,-,23505
503,BUMA.1121.00097,2,1168042,1191574,+,23532
503,BUMA.1121.00109,2,69391,92867,-,23476
503,BUMA.1121.00018,2,2458255,2481702,-,23447
503,BUMA.1121.00110,2,1058124,1081524,-,23400
503,BUMA.1121.00079,2,1321073,1344432,+,23359
503,BUMA.1121.00075,2,1613862,1637356,+,23494
503,BUMA.1121.00066,2,1300822,1324269,+,23447
503,BUMA.1121.00089,2,1308550,1331803,+,23253
503,BUMA.1121.00057,2,749522,772981,-,23459
503,BUMA.1121.00090,2,2308508,2331950,+,23442
503,BUMA.1121.00027,2,2376993,2400503,+,23510
503,BUMA.1121.00062,2,439816,463206,-,23390
503,BUMA.1121.00091,2,2283549,2306940,-,23391
503,BUMA.1121.00098,2,1575553,1599109,+,23556
503,BUMA.1121.00092,2,1332169,1355672,+,23503
503,BUMA.1121.00031,2,511846,535172,+,23326
503,BUMA.1121.00096,2,1534577,1557941,+,23364
503,BUMA.1121.00073,2,1295313,1318795,+,23482
503,BUMA.1121.00103,2,3237235,3260616,+,23381
503,BUMA.1121.00084,2,3148124,3171414,+,23290
503,BUMA.1121.00014,2,1445334,1468666,+,23332
503,BUMA.1121.00111,2,596023,619383,+,23360
503,BUMA.1121.00007,2,1360746,1384317,+,23571
503,BUMA.1121.00072,2,1291496,1314919,+,23423
503,BUMA.1121.00071,2,1294646,1318121,+,23475
503,BUMA.1121.00077,2,2351778,2375178,-,23400
503,BUMA.1121.00003,2,2570307,2593821,-,23514
503,BUMA.1121.00104,2,1413163,1436435,+,23272
503,BUMA.1121.00074,2,3020407,3043864,-,23457
503,BUMA.1121.00060,2,860115,883533,-,23418
503,BUMA.1121.00088,2,1262382,1285751,+,23369
503,BUMA.1121.00053,2,1608224,1631454,+,23230
503,BUMA.1121.00025,2,2792153,2815609,-,23456
503,BUMA.1121.00070,2,1295357,1318839,+,23482
503,BUMA.1121.00049,2,3134802,3158067,+,23265
503,BUMA.1121.00078,2,1797870,1821412,-,23542
503,BUMA.1121.00069,2,1292904,1316370,+,23466
503,BUMA.1121.00102,2,1371645,1394967,+,23322
503,BUMA.1121.00112,2,3047035,3070414,-,23379
503,BUMA.1121.00041,2,2262856,2286225,+,23369
503,BUMA.1121.00068,2,3028559,3052072,+,23513
503,BUMA.1121.00076,2,2207854,2231317,+,23463
503,BUMA.1121.00033,2,2059472,2082738,+,23266
503,BUMA.1121.00101,2,2069976,2093304,-,23328
503,BUMA.1121.00105,2,1180694,1204066,-,23372
503,BUMA.1121.00061,2,1284959,1308435,+,23476
503,BUMA.1121.00063,2,1294099,1317545,+,23446
503,BUMA.1121.00059,2,2316350,2339648,-,23298
503,BUMA.1121.00058,2,1868586,1892015,+,23429
503,BUMA.1121.00043,2,1025076,1048403,-,23327
503,BUMA.1121.00055,2,1328874,1352198,-,23324
503,BUMA.1121.00065,2,1366419,1389780,+,23361
503,BUMA.1121.00064,2,1234979,1258402,+,23423
503,BUMA.1121.00047,2,2250451,2273800,+,23349
503,BUMA.1121.00037,2,1680787,1704123,+,23336
503,BUMA.1121.00106,2,475361,498638,-,23277
503,BUMA.1121.00051,2,1320644,1343912,+,23268
503,BUMA.1121.00045,2,1210397,1233851,+,23454
503,BUMA.1121.00056,2,2662218,2685472,-,23254
503,BUMA.1121.00095,2,3290629,3314118,-,23489
503,BUMA.1121.00082,2,1325492,1348975,+,23483
503,BUMA.1121.00001,2,866118,889399,-,23281
503,BUMA.1121.00108,2,1547143,1570672,+,23529
503,BUMA.1121.00083,2,3122449,3145932,+,23483
503,BUMA.1121.00080,2,1321852,1345193,+,23341
503,BUMA.1121.00012,2,357015,380311,-,23296
504,BUMA.1121.00011,2,3222327,3225998,+,3671
504,BUMA.1121.00009,2,3245010,3248519,+,3509
504,BUMA.1121.00039,2,2609162,2612782,-,3620
504,BUMA.1121.00029,2,3241012,3244488,-,3476
504,BUMA.1121.00021,2,1864272,1867784,+,3512
504,BUMA.1121.00107,2,2500212,2503688,-,3476
504,BUMA.1121.00023,2,1438953,1442438,+,3485
504,BUMA.1121.00067,2,2631193,2634771,-,3578
504,BUMA.1121.00035,2,3258236,3261766,-,3530
504,BUMA.1121.00005,2,2776010,2779569,+,3559
504,BUMA.1121.00100,2,2448399,2452028,+,3629
504,BUMA.1121.00016,2,2358605,2362261,-,3656
504,BUMA.1121.00099,2,1600686,1604168,+,3482
504,BUMA.1121.00094,2,1387006,1390596,+,3590
504,BUMA.1121.00093,2,1585751,1589521,-,3770
504,BUMA.1121.00097,2,1191575,1195105,+,3530
504,BUMA.1121.00109,2,65904,69389,-,3485
504,BUMA.1121.00018,2,2454777,2458253,-,3476
504,BUMA.1121.00110,2,1054772,1058122,-,3350
504,BUMA.1121.00079,2,1344433,1348284,+,3851
504,BUMA.1121.00075,2,1637357,1640815,+,3458
504,BUMA.1121.00066,2,1324270,1327725,+,3455
504,BUMA.1121.00089,2,1331804,1335658,+,3854
504,BUMA.1121.00057,2,746047,749520,-,3473
504,BUMA.1121.00090,2,2331951,2335400,+,3449
504,BUMA.1121.00027,2,2400504,2403977,+,3473
504,BUMA.1121.00062,2,436125,439814,-,3689
504,BUMA.1121.00091,2,2280053,2283547,-,3494
504,BUMA.1121.00098,2,1599110,1602676,+,3566
504,BUMA.1121.00092,2,1355673,1359425,+,3752
504,BUMA.1121.00031,2,535173,538676,+,3503
504,BUMA.1121.00096,2,1557942,1561427,+,3485
504,BUMA.1121.00073,2,1318796,1322251,+,3455
504,BUMA.1121.00103,2,3260617,3264150,+,3533
504,BUMA.1121.00084,2,3171415,3174969,+,3554
504,BUMA.1121.00014,2,1468667,1472116,+,3449
504,BUMA.1121.00111,2,619384,622860,+,3476
504,BUMA.1121.00007,2,1384318,1387839,+,3521
504,BUMA.1121.00072,2,1314920,1318375,+,3455
504,BUMA.1121.00071,2,1318122,1321547,+,3425
504,BUMA.1121.00077,2,2348426,2351776,-,3350
504,BUMA.1121.00003,2,2566706,2570305,-,3599
504,BUMA.1121.00104,2,1436436,1440002,+,3566
504,BUMA.1121.00074,2,3016797,3020405,-,3608
504,BUMA.1121.00060,2,856640,860113,-,3473
504,BUMA.1121.00088,2,1285752,1289297,+,3545
504,BUMA.1121.00053,2,1631455,1635021,+,3566
504,BUMA.1121.00025,2,2788693,2792151,-,3458
504,BUMA.1121.00070,2,1318840,1322295,+,3455
504,BUMA.1121.00049,2,11,3688,+,3677
504,BUMA.1121.00078,2,1794344,1797868,-,3524
504,BUMA.1121.00069,2,1316371,1319826,+,3455
504,BUMA.1121.00102,2,1394968,1398342,+,3374
504,BUMA.1121.00112,2,3043557,3047033,-,3476
504,BUMA.1121.00041,2,2286226,2289603,+,3377
504,BUMA.1121.00068,2,3052073,3055594,+,3521
504,BUMA.1121.00076,2,2231318,2234776,+,3458
504,BUMA.1121.00033,2,2082739,2086215,+,3476
504,BUMA.1121.00101,2,2066450,2069974,-,3524
504,BUMA.1121.00105,2,1177030,1180692,-,3662
504,BUMA.1121.00061,2,1308436,1311891,+,3455
504,BUMA.1121.00063,2,1317546,1321001,+,3455
504,BUMA.1121.00059,2,2312812,2316348,-,3536
504,BUMA.1121.00058,2,1892016,1895714,+,3698
504,BUMA.1121.00043,2,1021508,1025074,-,3566
504,BUMA.1121.00055,2,1325177,1328872,-,3695
504,BUMA.1121.00065,2,1389781,1393257,+,3476
504,BUMA.1121.00064,2,1258403,1261921,+,3518
504,BUMA.1121.00047,2,2273801,2277718,+,3917
504,BUMA.1121.00037,2,1704124,1707600,+,3476
504,BUMA.1121.00106,2,471850,475359,-,3509
504,BUMA.1121.00051,2,1343913,1347784,+,3871
504,BUMA.1121.00045,2,1233852,1237316,+,3464
504,BUMA.1121.00056,2,2658389,2662216,-,3827
504,BUMA.1121.00095,2,3287085,3290627,-,3542
504,BUMA.1121.00082,2,1348976,1352431,+,3455
504,BUMA.1121.00001,2,862595,866116,-,3521
504,BUMA.1121.00108,2,1570673,1574137,+,3464
504,BUMA.1121.00083,2,3145933,3149388,+,3455
504,BUMA.1121.00080,2,1345194,1348922,+,3728
504,BUMA.1121.00012,2,353543,357013,-,3470
505,BUMA.1121.00011,2,3227612,3232770,+,5158
505,BUMA.1121.00009,2,3250133,3255255,+,5122
505,BUMA.1121.00039,2,2602397,2607536,-,5139
505,BUMA.1121.00029,2,3234274,3239386,-,5112
505,BUMA.1121.00021,2,1869410,1874523,+,5113
505,BUMA.1121.00107,2,2493462,2498598,-,5136
505,BUMA.1121.00023,2,1444064,1449141,+,5077
505,BUMA.1121.00067,2,2624419,2629549,-,5130
505,BUMA.1121.00035,2,3251489,3256610,-,5121
505,BUMA.1121.00005,2,2781195,2786271,+,5076
505,BUMA.1121.00100,2,2453642,2458827,+,5185
505,BUMA.1121.00016,2,2351843,2356973,-,5130
505,BUMA.1121.00099,2,1605776,1610844,+,5068
505,BUMA.1121.00094,2,1392234,1397347,+,5113
505,BUMA.1121.00093,2,1579002,1584113,-,5111
505,BUMA.1121.00097,2,1196731,1201824,+,5093
505,BUMA.1121.00109,2,59091,64239,-,5148
505,BUMA.1121.00018,2,2448036,2453151,-,5115
505,BUMA.1121.00110,2,1048061,1053146,-,5085
505,BUMA.1121.00079,2,1349928,1355022,+,5094
505,BUMA.1121.00075,2,1642441,1647542,+,5101
505,BUMA.1121.00066,2,1329351,1334455,+,5104
505,BUMA.1121.00089,2,1337308,1342412,+,5104
505,BUMA.1121.00057,2,739318,744421,-,5103
505,BUMA.1121.00090,2,2337026,2342130,+,5104
505,BUMA.1121.00027,2,2405597,2410719,+,5122
505,BUMA.1121.00062,2,429399,434493,-,5094
505,BUMA.1121.00091,2,2273366,2278439,-,5073
505,BUMA.1121.00098,2,1604296,1609373,+,5077
505,BUMA.1121.00092,2,1361063,1366176,+,5113
505,BUMA.1121.00031,2,540308,545394,+,5086
505,BUMA.1121.00096,2,1563053,1568130,+,5077
505,BUMA.1121.00073,2,1323877,1328981,+,5104
505,BUMA.1121.00103,2,3265788,3270856,+,5068
505,BUMA.1121.00084,2,3176607,3181729,+,5122
505,BUMA.1121.00014,2,1473748,1478852,+,5104
505,BUMA.1121.00111,2,624486,629608,+,5122
505,BUMA.1121.00007,2,1389477,1394602,+,5125
505,BUMA.1121.00072,2,1320001,1325083,+,5082
505,BUMA.1121.00071,2,1323173,1328277,+,5104
505,BUMA.1121.00077,2,2341715,2346800,-,5085
505,BUMA.1121.00003,2,2559926,2565074,-,5148
505,BUMA.1121.00104,2,1441622,1446717,+,5095
505,BUMA.1121.00074,2,3010026,3015171,-,5145
505,BUMA.1121.00060,2,849855,855002,-,5147
505,BUMA.1121.00088,2,1290929,1296060,+,5131
505,BUMA.1121.00053,2,1636647,1641760,+,5113
505,BUMA.1121.00025,2,2781952,2787067,-,5115
505,BUMA.1121.00070,2,1323921,1329025,+,5104
505,BUMA.1121.00049,2,5320,10442,+,5122
505,BUMA.1121.00078,2,1787660,1792730,-,5070
505,BUMA.1121.00069,2,1321452,1326556,+,5104
505,BUMA.1121.00102,2,1399956,1405105,+,5149
505,BUMA.1121.00112,2,3036912,3041943,-,5031
505,BUMA.1121.00041,2,2291217,2296294,+,5077
505,BUMA.1121.00068,2,3057214,3062372,+,5158
505,BUMA.1121.00076,2,2236402,2241506,+,5104
505,BUMA.1121.00033,2,2087847,2092951,+,5104
505,BUMA.1121.00101,2,2059730,2064842,-,5112
505,BUMA.1121.00105,2,1170319,1175404,-,5085
505,BUMA.1121.00061,2,1313517,1318621,+,5104
505,BUMA.1121.00063,2,1322627,1327731,+,5104
505,BUMA.1121.00059,2,2306092,2311186,-,5094
505,BUMA.1121.00058,2,1897352,1902482,+,5130
505,BUMA.1121.00043,2,1014767,1019879,-,5112
505,BUMA.1121.00055,2,1318448,1323551,-,5103
505,BUMA.1121.00065,2,1394889,1400029,+,5140
505,BUMA.1121.00064,2,1263553,1268684,+,5131
505,BUMA.1121.00047,2,2279338,2284433,+,5095
505,BUMA.1121.00037,2,1709220,1714342,+,5122
505,BUMA.1121.00106,2,465103,470224,-,5121
505,BUMA.1121.00051,2,1349302,1354405,+,5103
505,BUMA.1121.00045,2,1238954,1244103,+,5149
505,BUMA.1121.00056,2,2651637,2656739,-,5102
505,BUMA.1121.00095,2,3280386,3285465,-,5079
505,BUMA.1121.00082,2,1354057,1359161,+,5104
505,BUMA.1121.00001,2,855857,860969,-,5112
505,BUMA.1121.00108,2,1575763,1580841,+,5078
505,BUMA.1121.00083,2,3151014,3156118,+,5104
505,BUMA.1121.00080,2,1350566,1355659,+,5093
505,BUMA.1121.00012,2,346805,351917,-,5112
506,BUMA.1121.00011,2,3232850,3237792,+,4942
506,BUMA.1121.00009,2,3255335,3260259,+,4924
506,BUMA.1121.00039,2,2597413,2602290,-,4877
506,BUMA.1121.00029,2,3229314,3234176,-,4862
506,BUMA.1121.00021,2,1874603,1879482,+,4879
506,BUMA.1121.00107,2,2488439,2493301,-,4862
506,BUMA.1121.00023,2,1449221,1454109,+,4888
506,BUMA.1121.00067,2,2619459,2624321,-,4862
506,BUMA.1121.00035,2,3246538,3251400,-,4862
506,BUMA.1121.00005,2,2786351,2791311,+,4960
506,BUMA.1121.00100,2,2458907,2463858,+,4951
506,BUMA.1121.00016,2,2346856,2351727,-,4871
506,BUMA.1121.00099,2,1610967,1615821,+,4854
506,BUMA.1121.00094,2,1397427,1402306,+,4879
506,BUMA.1121.00093,2,1573943,1578859,-,4916
506,BUMA.1121.00097,2,1201904,1206788,+,4884
506,BUMA.1121.00109,2,54086,58948,-,4862
506,BUMA.1121.00018,2,2443076,2447938,-,4862
506,BUMA.1121.00110,2,1043012,1047910,-,4898
506,BUMA.1121.00079,2,1355138,1360043,+,4905
506,BUMA.1121.00075,2,1647622,1652500,+,4878
506,BUMA.1121.00066,2,1334535,1339468,+,4933
506,BUMA.1121.00089,2,1342528,1347434,+,4906
506,BUMA.1121.00057,2,734304,739175,-,4871
506,BUMA.1121.00090,2,2342210,2347098,+,4888
506,BUMA.1121.00027,2,2410815,2415669,+,4854
506,BUMA.1121.00062,2,424439,429301,-,4862
506,BUMA.1121.00091,2,2268370,2273250,-,4880
506,BUMA.1121.00098,2,1609453,1614341,+,4888
506,BUMA.1121.00092,2,1366256,1371234,+,4978
506,BUMA.1121.00031,2,545474,550362,+,4888
506,BUMA.1121.00096,2,1568210,1573116,+,4906
506,BUMA.1121.00073,2,1329061,1333994,+,4933
506,BUMA.1121.00103,2,3270936,3275896,+,4960
506,BUMA.1121.00084,2,47,4944,+,4897
506,BUMA.1121.00014,2,1478932,1483835,+,4903
506,BUMA.1121.00111,2,629688,634566,+,4878
506,BUMA.1121.00007,2,1394682,1399615,+,4933
506,BUMA.1121.00072,2,1325163,1330096,+,4933
506,BUMA.1121.00071,2,1328366,1333290,+,4924
506,BUMA.1121.00077,2,2336665,2341563,-,4898
506,BUMA.1121.00003,2,2554975,2559846,-,4871
506,BUMA.1121.00104,2,1446797,1451676,+,4879
506,BUMA.1121.00074,2,3005075,3009930,-,4855
506,BUMA.1121.00060,2,844859,849739,-,4880
506,BUMA.1121.00088,2,1296140,1301037,+,4897
506,BUMA.1121.00053,2,1641865,1646719,+,4854
506,BUMA.1121.00025,2,2776992,2781854,-,4862
506,BUMA.1121.00070,2,1329105,1334038,+,4933
506,BUMA.1121.00049,2,10522,15464,+,4942
506,BUMA.1121.00078,2,1782618,1787490,-,4872
506,BUMA.1121.00069,2,1326690,1331569,+,4879
506,BUMA.1121.00102,2,1405185,1410070,+,4885
506,BUMA.1121.00112,2,3031919,3036832,-,4913
506,BUMA.1121.00041,2,2296374,2301352,+,4978
506,BUMA.1121.00068,2,3062452,3067376,+,4924
506,BUMA.1121.00076,2,2241586,2246465,+,4879
506,BUMA.1121.00033,2,2093031,2097955,+,4924
506,BUMA.1121.00101,2,2054714,2059650,-,4936
506,BUMA.1121.00105,2,1165323,1170185,-,4862
506,BUMA.1121.00061,2,1318710,1323634,+,4924
506,BUMA.1121.00063,2,1327820,1332744,+,4924
506,BUMA.1121.00059,2,2301132,2305994,-,4862
506,BUMA.1121.00058,2,1902562,1907504,+,4942
506,BUMA.1121.00043,2,1009807,1014669,-,4862
506,BUMA.1121.00055,2,1313452,1318341,-,4889
506,BUMA.1121.00065,2,1400109,1405039,+,4930
506,BUMA.1121.00064,2,1268764,1273634,+,4870
506,BUMA.1121.00047,2,2284549,2289455,+,4906
506,BUMA.1121.00037,2,1714422,1719292,+,4870
506,BUMA.1121.00106,2,460143,465005,-,4862
506,BUMA.1121.00051,2,1354521,1359426,+,4905
506,BUMA.1121.00045,2,1244201,1249098,+,4897
506,BUMA.1121.00056,2,2646614,2651476,-,4862
506,BUMA.1121.00095,2,3275373,3280306,-,4933
506,BUMA.1121.00082,2,1359241,1364174,+,4933
506,BUMA.1121.00001,2,850888,855750,-,4862
506,BUMA.1121.00108,2,1580921,1585845,+,4924
506,BUMA.1121.00083,2,3156198,3161131,+,4933
506,BUMA.1121.00080,2,1355775,1360681,+,4906
506,BUMA.1121.00012,2,341833,346705,-,4872
507,BUMA.1121.00009,2,33019,36447,+,3428
507,BUMA.1121.00023,2,1509656,1513084,-,3428
507,BUMA.1121.00035,2,783650,787078,-,3428
507,BUMA.1121.00033,1,51150,54578,-,3428
507,BUMA.1121.00075,2,1708763,1712191,-,3428
507,BUMA.1121.00090,2,1574042,1577470,+,3428
507,BUMA.1121.00031,2,3041103,3044531,+,3428
507,BUMA.1121.00014,2,708728,712156,+,3428
507,BUMA.1121.00078,2,1886485,1889913,+,3428
507,BUMA.1121.00112,2,835083,838505,+,3422
507,BUMA.1121.00076,2,2302729,2306157,-,3428
507,BUMA.1121.00043,2,950481,953897,+,3416
508,BUMA.1121.00009,2,40125,48255,+,8130
508,BUMA.1121.00023,2,1497852,1505977,-,8125
508,BUMA.1121.00035,2,771846,779971,-,8125
508,BUMA.1121.00075,2,1696955,1705085,-,8130
508,BUMA.1121.00090,2,1581149,1589274,+,8125
508,BUMA.1121.00031,2,3048210,3056335,+,8125
508,BUMA.1121.00014,2,715835,723960,+,8125
508,BUMA.1121.00078,2,1893591,1901721,+,8130
508,BUMA.1121.00112,2,842183,850313,+,8130
508,BUMA.1121.00076,2,2290921,2299051,-,8130
508,BUMA.1121.00043,2,957970,966060,+,8090
509,BUMA.1121.00009,2,52250,57464,+,5214
509,BUMA.1121.00023,2,1488642,1493857,-,5215
509,BUMA.1121.00035,2,762636,767851,-,5215
509,BUMA.1121.00075,2,1687745,1692960,-,5215
509,BUMA.1121.00090,2,1593269,1598483,+,5214
509,BUMA.1121.00031,2,3060330,3065544,+,5214
509,BUMA.1121.00014,2,727955,733169,+,5214
509,BUMA.1121.00078,2,1905716,1910930,+,5214
509,BUMA.1121.00112,2,854308,859522,+,5214
509,BUMA.1121.00076,2,2281711,2286926,-,5215
509,BUMA.1121.00043,2,970068,975303,+,5235
510,BUMA.1121.00009,2,1410648,1414192,+,3544
510,BUMA.1121.00039,2,1211342,1214886,-,3544
510,BUMA.1121.00029,2,1770278,1773822,-,3544
510,BUMA.1121.00021,2,113268,116812,+,3544
510,BUMA.1121.00107,2,1039171,1042719,-,3548
510,BUMA.1121.00023,2,2888923,2892467,+,3544
510,BUMA.1121.00067,2,1176745,1180289,-,3544
510,BUMA.1121.00035,2,1849542,1853086,-,3544
510,BUMA.1121.00100,2,784596,788140,+,3544
510,BUMA.1121.00016,2,958119,961663,-,3544
510,BUMA.1121.00094,2,2793541,2797085,+,3544
510,BUMA.1121.00097,2,2589403,2592947,+,3544
510,BUMA.1121.00109,2,1872258,1875802,-,3544
510,BUMA.1121.00018,2,1050506,1054050,-,3544
510,BUMA.1121.00110,2,2718738,2722282,+,3544
510,BUMA.1121.00079,2,2750930,2754474,+,3544
510,BUMA.1121.00075,2,80419,83963,-,3544
510,BUMA.1121.00066,2,2712894,2716438,+,3544
510,BUMA.1121.00089,2,2739421,2742965,+,3544
510,BUMA.1121.00057,2,2487462,2491006,-,3544
510,BUMA.1121.00090,2,493934,497478,+,3544
510,BUMA.1121.00027,2,660334,663876,+,3542
510,BUMA.1121.00031,2,1932486,1936030,+,3544
510,BUMA.1121.00096,2,3066692,3070236,+,3544
510,BUMA.1121.00073,2,2729118,2732662,+,3544
510,BUMA.1121.00084,2,1467596,1471140,+,3544
510,BUMA.1121.00014,2,2867281,2870825,+,3544
510,BUMA.1121.00111,2,2080168,2083713,+,3545
510,BUMA.1121.00007,2,2877063,2880607,+,3544
510,BUMA.1121.00072,2,2706102,2709646,+,3544
510,BUMA.1121.00071,2,2729092,2732636,+,3544
510,BUMA.1121.00077,2,893628,897172,-,3544
510,BUMA.1121.00104,2,2835729,2839273,+,3544
510,BUMA.1121.00074,2,1621504,1625048,-,3544
510,BUMA.1121.00088,2,2762581,2766125,+,3544
510,BUMA.1121.00025,2,1278837,1282381,+,3544
510,BUMA.1121.00070,2,2708449,2711993,+,3544
510,BUMA.1121.00049,2,1389940,1393484,+,3544
510,BUMA.1121.00078,2,379060,382611,-,3551
510,BUMA.1121.00069,2,2698330,2701874,+,3544
510,BUMA.1121.00112,2,1613012,1616556,-,3544
510,BUMA.1121.00041,2,484803,488347,+,3544
510,BUMA.1121.00068,2,1341967,1345511,+,3544
510,BUMA.1121.00076,2,513450,516994,+,3544
510,BUMA.1121.00033,2,302559,306101,+,3542
510,BUMA.1121.00061,2,2712157,2715701,+,3544
510,BUMA.1121.00063,2,2722287,2725831,+,3544
510,BUMA.1121.00058,2,146130,149674,+,3544
510,BUMA.1121.00043,2,2808353,2811897,-,3544
510,BUMA.1121.00055,2,3077505,3081049,-,3544
510,BUMA.1121.00065,2,2829857,2833401,+,3544
510,BUMA.1121.00064,2,2653796,2657340,+,3544
510,BUMA.1121.00047,2,567423,570967,+,3544
510,BUMA.1121.00037,2,3103226,3106770,+,3544
510,BUMA.1121.00106,2,2027860,2031404,+,3544
510,BUMA.1121.00051,2,2754194,2757738,+,3544
510,BUMA.1121.00056,2,1248784,1252328,-,3544
510,BUMA.1121.00082,2,2780887,2784431,+,3544
510,BUMA.1121.00001,2,2651944,2655487,-,3543
510,BUMA.1121.00108,2,2999483,3003027,+,3544
510,BUMA.1121.00083,2,1404803,1408347,+,3544
510,BUMA.1121.00080,2,2810547,2814091,+,3544
510,BUMA.1121.00012,2,2176181,2179725,-,3544
511,BUMA.1121.00009,2,2415594,2418992,+,3398
511,BUMA.1121.00099,2,706618,709971,+,3353
511,BUMA.1121.00101,2,2890787,2894201,-,3414
512,BUMA.1121.00039,2,650088,658576,+,8488
512,BUMA.1121.00029,2,1217032,1225514,+,8482
512,BUMA.1121.00021,2,610721,619204,-,8483
512,BUMA.1121.00107,2,507027,515525,+,8498
512,BUMA.1121.00023,2,204329,212812,-,8483
512,BUMA.1121.00067,2,650234,658732,+,8498
512,BUMA.1121.00035,2,1300576,1309058,+,8482
512,BUMA.1121.00005,2,598776,607256,+,8480
512,BUMA.1121.00016,2,449520,458003,+,8483
512,BUMA.1121.00099,2,290842,299341,-,8499
512,BUMA.1121.00094,2,149237,157724,-,8487
512,BUMA.1121.00093,2,2786341,2794821,+,8480
512,BUMA.1121.00109,2,1308285,1316795,+,8510
512,BUMA.1121.00018,2,554491,562973,+,8482
512,BUMA.1121.00110,2,19141,27626,-,8485
512,BUMA.1121.00079,2,150625,159112,-,8487
512,BUMA.1121.00075,2,2703896,2712381,+,8485
512,BUMA.1121.00066,2,148164,156649,-,8485
512,BUMA.1121.00089,2,150350,158837,-,8487
512,BUMA.1121.00057,2,1939648,1948135,+,8487
512,BUMA.1121.00090,2,1051915,1060398,-,8483
512,BUMA.1121.00027,2,1201740,1210239,-,8499
512,BUMA.1121.00062,2,1620516,1629014,+,8498
512,BUMA.1121.00091,2,321623,330117,+,8494
512,BUMA.1121.00098,2,357278,365767,-,8489
512,BUMA.1121.00092,2,150092,158573,-,8481
512,BUMA.1121.00031,2,2486708,2495191,-,8483
512,BUMA.1121.00084,2,1988720,1997219,-,8499
512,BUMA.1121.00014,2,154558,163046,-,8488
512,BUMA.1121.00111,2,2589086,2597575,-,8489
512,BUMA.1121.00007,2,160288,168786,-,8498
512,BUMA.1121.00072,2,140804,149289,-,8485
512,BUMA.1121.00071,2,142068,150553,-,8485
512,BUMA.1121.00077,2,331647,340130,+,8483
512,BUMA.1121.00104,2,255320,263806,-,8486
512,BUMA.1121.00074,2,1090739,1099237,+,8498
512,BUMA.1121.00088,2,101523,110022,-,8499
512,BUMA.1121.00053,2,376557,385060,-,8503
512,BUMA.1121.00025,2,1770064,1778547,-,8483
512,BUMA.1121.00049,2,1959953,1968439,-,8486
512,BUMA.1121.00078,2,3070301,3078784,+,8483
512,BUMA.1121.00102,2,150404,158914,-,8510
512,BUMA.1121.00112,2,1034307,1042808,+,8501
512,BUMA.1121.00041,2,1040452,1048950,-,8498
512,BUMA.1121.00068,2,1869358,1877860,-,8502
512,BUMA.1121.00076,2,1033238,1041724,-,8486
512,BUMA.1121.00033,2,817822,826302,-,8480
512,BUMA.1121.00105,2,2351358,2359843,+,8485
512,BUMA.1121.00063,2,141334,149819,-,8485
512,BUMA.1121.00059,2,322244,330742,+,8498
512,BUMA.1121.00043,2,2291333,2299815,+,8482
512,BUMA.1121.00055,2,2527159,2535643,+,8484
512,BUMA.1121.00065,2,150753,159238,-,8485
512,BUMA.1121.00064,2,149817,158304,-,8487
512,BUMA.1121.00047,2,1080899,1089384,-,8485
512,BUMA.1121.00037,2,403200,411683,-,8483
512,BUMA.1121.00106,2,2564864,2573363,-,8499
512,BUMA.1121.00051,2,150679,159166,-,8487
512,BUMA.1121.00056,2,732841,741327,+,8486
512,BUMA.1121.00082,2,150344,158829,-,8485
512,BUMA.1121.00001,2,2105073,2113555,+,8482
512,BUMA.1121.00083,2,1947293,1955778,-,8485
512,BUMA.1121.00080,2,150613,159100,-,8487
512,BUMA.1121.00012,2,1670406,1678894,+,8488
513,BUMA.1121.00039,2,723060,730473,+,7413
513,BUMA.1121.00021,2,541656,546381,-,4725
513,BUMA.1121.00107,2,579416,584140,+,4724
513,BUMA.1121.00067,2,722957,727683,+,4726
513,BUMA.1121.00016,2,522370,527093,+,4723
513,BUMA.1121.00099,2,221757,226482,-,4725
513,BUMA.1121.00094,2,80885,85611,-,4726
513,BUMA.1121.00093,2,2859333,2864059,+,4726
513,BUMA.1121.00097,2,3073888,3078613,-,4725
513,BUMA.1121.00109,2,1381381,1386108,+,4727
513,BUMA.1121.00018,2,627577,632301,+,4724
513,BUMA.1121.00079,2,80916,85643,-,4727
513,BUMA.1121.00075,2,2777995,2782687,+,4692
513,BUMA.1121.00089,2,80872,85599,-,4727
513,BUMA.1121.00062,2,1692686,1697412,+,4726
513,BUMA.1121.00091,2,394557,399250,+,4693
513,BUMA.1121.00098,2,288081,292806,-,4725
513,BUMA.1121.00092,2,80854,85581,-,4727
513,BUMA.1121.00031,2,2417488,2422212,-,4724
513,BUMA.1121.00096,2,192460,197178,-,4718
513,BUMA.1121.00103,2,1904251,1908976,-,4725
513,BUMA.1121.00084,2,1920092,1924819,-,4727
513,BUMA.1121.00014,2,84029,88754,-,4725
513,BUMA.1121.00111,2,2519838,2524563,-,4725
513,BUMA.1121.00007,2,89976,94701,-,4725
513,BUMA.1121.00104,2,186261,190988,-,4727
513,BUMA.1121.00074,2,1163435,1168161,+,4726
513,BUMA.1121.00060,2,2122091,2126815,+,4724
513,BUMA.1121.00088,2,31109,35836,-,4727
513,BUMA.1121.00025,2,1700741,1705466,-,4725
513,BUMA.1121.00049,2,1891236,1895960,-,4724
513,BUMA.1121.00102,2,81108,85834,-,4726
513,BUMA.1121.00112,2,1107279,1112002,+,4723
513,BUMA.1121.00076,2,962930,967623,-,4693
513,BUMA.1121.00105,2,2423545,2428271,+,4726
513,BUMA.1121.00059,2,394986,399712,+,4726
513,BUMA.1121.00058,2,595351,600078,-,4727
513,BUMA.1121.00043,2,2366689,2371413,+,4724
513,BUMA.1121.00055,2,2599848,2604574,+,4726
513,BUMA.1121.00064,2,80977,85704,-,4727
513,BUMA.1121.00047,2,1010065,1014792,-,4727
513,BUMA.1121.00037,2,331370,336095,-,4725
513,BUMA.1121.00106,2,2495941,2500668,-,4727
513,BUMA.1121.00051,2,81011,85738,-,4727
513,BUMA.1121.00045,2,3138313,3143038,-,4725
513,BUMA.1121.00056,2,805953,810679,+,4726
513,BUMA.1121.00108,2,270768,275493,-,4725
513,BUMA.1121.00080,2,80989,85716,-,4727
514,BUMA.1121.00039,2,1186464,1191963,+,5499
514,BUMA.1121.00023,2,2911846,2917345,-,5499
514,BUMA.1121.00005,2,1149454,1154953,+,5499
514,BUMA.1121.00099,2,3022772,3028271,-,5499
514,BUMA.1121.00097,2,2607534,2613033,-,5499
514,BUMA.1121.00110,2,2736873,2742372,-,5499
514,BUMA.1121.00066,2,2732308,2737807,-,5499
514,BUMA.1121.00057,2,2466075,2471574,+,5499
514,BUMA.1121.00090,2,516857,522356,-,5499
514,BUMA.1121.00027,2,679764,685263,-,5499
514,BUMA.1121.00091,2,859185,864684,+,5499
514,BUMA.1121.00098,2,3028048,3033547,-,5499
514,BUMA.1121.00031,2,1956744,1962243,-,5499
514,BUMA.1121.00096,2,3088476,3093975,-,5499
514,BUMA.1121.00073,2,2748544,2754043,-,5499
514,BUMA.1121.00103,2,1435712,1441211,-,5499
514,BUMA.1121.00014,2,2891461,2896975,-,5514
514,BUMA.1121.00072,2,2725424,2730923,-,5499
514,BUMA.1121.00071,2,2748507,2754006,-,5499
514,BUMA.1121.00077,2,873539,879036,+,5497
514,BUMA.1121.00060,2,2601104,2606604,+,5500
514,BUMA.1121.00053,2,3057136,3062635,-,5499
514,BUMA.1121.00070,2,2727871,2733370,-,5499
514,BUMA.1121.00078,2,357672,363171,+,5499
514,BUMA.1121.00102,2,2804886,2810385,-,5499
514,BUMA.1121.00112,2,1588134,1593633,+,5499
514,BUMA.1121.00041,2,502935,508434,-,5499
514,BUMA.1121.00061,2,2731572,2737071,-,5499
514,BUMA.1121.00063,2,2741702,2747201,-,5499
514,BUMA.1121.00065,2,2849286,2854785,-,5499
514,BUMA.1121.00045,2,2658490,2663990,-,5500
514,BUMA.1121.00095,2,1639539,1645038,-,5499
514,BUMA.1121.00082,2,2800319,2805818,-,5499
514,BUMA.1121.00083,2,1424235,1429734,-,5499
515,BUMA.1121.00039,2,1191965,1195890,+,3925
515,BUMA.1121.00023,2,2907920,2911845,-,3925
515,BUMA.1121.00005,2,1154955,1158880,+,3925
515,BUMA.1121.00099,2,3018846,3022771,-,3925
515,BUMA.1121.00097,2,2603607,2607533,-,3926
515,BUMA.1121.00110,2,2732942,2736872,-,3930
515,BUMA.1121.00066,2,2728381,2732307,-,3926
515,BUMA.1121.00057,2,2471576,2475502,+,3926
515,BUMA.1121.00090,2,512931,516856,-,3925
515,BUMA.1121.00027,2,675837,679763,-,3926
515,BUMA.1121.00091,2,864686,868612,+,3926
515,BUMA.1121.00098,2,3024131,3028047,-,3916
515,BUMA.1121.00031,2,1952818,1956743,-,3925
515,BUMA.1121.00096,2,3084549,3088475,-,3926
515,BUMA.1121.00073,2,2744617,2748543,-,3926
515,BUMA.1121.00103,2,1431785,1435711,-,3926
515,BUMA.1121.00014,2,2886279,2890192,-,3913
515,BUMA.1121.00072,2,2721497,2725423,-,3926
515,BUMA.1121.00071,2,2744580,2748506,-,3926
515,BUMA.1121.00077,2,879038,882968,+,3930
515,BUMA.1121.00060,2,2606606,2610532,+,3926
515,BUMA.1121.00053,2,3053212,3057135,-,3923
515,BUMA.1121.00070,2,2723944,2727870,-,3926
515,BUMA.1121.00078,2,363173,367103,+,3930
515,BUMA.1121.00102,2,2800958,2804885,-,3927
515,BUMA.1121.00112,2,1593635,1597560,+,3925
515,BUMA.1121.00041,2,499004,502934,-,3930
515,BUMA.1121.00061,2,2727645,2731571,-,3926
515,BUMA.1121.00063,2,2737775,2741701,-,3926
515,BUMA.1121.00065,2,2845359,2849285,-,3926
515,BUMA.1121.00045,2,2654563,2658489,-,3926
515,BUMA.1121.00095,2,1635612,1639538,-,3926
515,BUMA.1121.00082,2,2796392,2800318,-,3926
515,BUMA.1121.00083,2,1420308,1424234,-,3926
516,BUMA.1121.00029,2,328463,336424,+,7961
516,BUMA.1121.00021,2,1502128,1510088,-,7960
516,BUMA.1121.00107,2,2854312,2862274,+,7962
516,BUMA.1121.00023,2,1076904,1086199,-,9295
516,BUMA.1121.00035,2,307008,314969,+,7961
516,BUMA.1121.00005,2,2417760,2425721,-,7961
516,BUMA.1121.00016,2,2714116,2722077,+,7961
516,BUMA.1121.00099,2,1246380,1254332,-,7952
516,BUMA.1121.00097,2,833746,841706,-,7960
516,BUMA.1121.00110,2,1399203,1407163,+,7960
516,BUMA.1121.00090,2,1973925,1981886,-,7961
516,BUMA.1121.00091,2,2635010,2642970,+,7960
516,BUMA.1121.00098,2,1241283,1249235,-,7952
516,BUMA.1121.00031,2,175243,183203,-,7960
516,BUMA.1121.00096,2,1199594,1207554,-,7960
516,BUMA.1121.00103,2,2899305,2907265,-,7960
516,BUMA.1121.00014,2,1108546,1116507,-,7961
516,BUMA.1121.00111,2,259881,267841,-,7960
516,BUMA.1121.00077,2,2693083,2701042,+,7959
516,BUMA.1121.00060,2,1210620,1218581,+,7961
516,BUMA.1121.00053,2,1271146,1279107,-,7961
516,BUMA.1121.00078,2,2179082,2187043,+,7961
516,BUMA.1121.00102,2,1034255,1042220,-,7965
516,BUMA.1121.00112,2,120454,128414,+,7960
516,BUMA.1121.00041,2,1927057,1935017,-,7960
516,BUMA.1121.00033,2,1723298,1731258,-,7960
516,BUMA.1121.00043,2,1376254,1384215,+,7961
516,BUMA.1121.00065,2,1030664,1038629,-,7965
516,BUMA.1121.00037,2,1346299,1354260,-,7961
516,BUMA.1121.00045,2,875283,883244,-,7961
516,BUMA.1121.00095,2,289882,297844,+,7962
516,BUMA.1121.00001,2,1216856,1224817,+,7961
516,BUMA.1121.00012,2,711201,719162,+,7961
517,BUMA.1121.00029,2,342333,346601,+,4268
517,BUMA.1121.00021,2,1491951,1496220,-,4269
517,BUMA.1121.00107,2,2868183,2872452,+,4269
517,BUMA.1121.00023,2,1070001,1074261,-,4260
517,BUMA.1121.00035,2,320878,325147,+,4269
517,BUMA.1121.00005,2,2407583,2411852,-,4269
517,BUMA.1121.00016,2,2727986,2732254,+,4268
517,BUMA.1121.00099,2,1236203,1240472,-,4269
517,BUMA.1121.00097,2,823569,827838,-,4269
517,BUMA.1121.00110,2,1413072,1417341,+,4269
517,BUMA.1121.00090,2,1963748,1968017,-,4269
517,BUMA.1121.00091,2,2648879,2653147,+,4268
517,BUMA.1121.00098,2,1231106,1235375,-,4269
517,BUMA.1121.00031,2,165069,169335,-,4266
517,BUMA.1121.00096,2,1189416,1193686,-,4270
517,BUMA.1121.00103,2,2889128,2893397,-,4269
517,BUMA.1121.00014,2,1098373,1102638,-,4265
517,BUMA.1121.00111,2,249704,253973,-,4269
517,BUMA.1121.00077,2,2706951,2711220,+,4269
517,BUMA.1121.00060,2,1224490,1228761,+,4271
517,BUMA.1121.00053,2,1260969,1265238,-,4269
517,BUMA.1121.00078,2,2192952,2197221,+,4269
517,BUMA.1121.00102,2,1024078,1028347,-,4269
517,BUMA.1121.00112,2,134323,138592,+,4269
517,BUMA.1121.00041,2,1916879,1921148,-,4269
517,BUMA.1121.00033,2,1713125,1717391,-,4266
517,BUMA.1121.00043,2,1390124,1394393,+,4269
517,BUMA.1121.00065,2,1020488,1024756,-,4268
517,BUMA.1121.00037,2,1336125,1340391,-,4266
517,BUMA.1121.00045,2,865104,869375,-,4271
517,BUMA.1121.00095,2,303753,308022,+,4269
517,BUMA.1121.00001,2,1230726,1234993,+,4267
517,BUMA.1121.00012,2,725071,730675,+,5604
518,BUMA.1121.00029,2,346602,349844,+,3242
518,BUMA.1121.00021,2,1488708,1491949,-,3241
518,BUMA.1121.00107,2,2872453,2875695,+,3242
518,BUMA.1121.00023,2,1065459,1068713,-,3254
518,BUMA.1121.00035,2,325148,328390,+,3242
518,BUMA.1121.00005,2,2404340,2407581,-,3241
518,BUMA.1121.00016,2,2732255,2735497,+,3242
518,BUMA.1121.00099,2,1232960,1236201,-,3241
518,BUMA.1121.00097,2,820326,823567,-,3241
518,BUMA.1121.00110,2,1417342,1420584,+,3242
518,BUMA.1121.00090,2,1960505,1963746,-,3241
518,BUMA.1121.00091,2,2653148,2656390,+,3242
518,BUMA.1121.00098,2,1227865,1231104,-,3239
518,BUMA.1121.00031,2,161826,165067,-,3241
518,BUMA.1121.00096,2,1186173,1189414,-,3241
518,BUMA.1121.00103,2,2885885,2889126,-,3241
518,BUMA.1121.00014,2,1095131,1098371,-,3240
518,BUMA.1121.00111,2,246461,249702,-,3241
518,BUMA.1121.00077,2,2711221,2714462,+,3241
518,BUMA.1121.00060,2,1228762,1232002,+,3240
518,BUMA.1121.00053,2,1257726,1260967,-,3241
518,BUMA.1121.00078,2,2197222,2200463,+,3241
518,BUMA.1121.00102,2,1020835,1024076,-,3241
518,BUMA.1121.00112,2,138593,141835,+,3242
518,BUMA.1121.00041,2,1913637,1916877,-,3240
518,BUMA.1121.00033,2,1709882,1713123,-,3241
518,BUMA.1121.00043,2,1394394,1397636,+,3242
518,BUMA.1121.00065,2,1017245,1020486,-,3241
518,BUMA.1121.00037,2,1332882,1336123,-,3241
518,BUMA.1121.00045,2,861863,865102,-,3239
518,BUMA.1121.00095,2,308023,311265,+,3242
518,BUMA.1121.00001,2,1234994,1238236,+,3242
518,BUMA.1121.00012,2,730676,733918,+,3242
519,BUMA.1121.00029,2,349845,356539,+,6694
519,BUMA.1121.00021,2,1482013,1488706,-,6693
519,BUMA.1121.00107,2,2875696,2882389,+,6693
519,BUMA.1121.00023,2,1058764,1065457,-,6693
519,BUMA.1121.00035,2,328391,335085,+,6694
519,BUMA.1121.00016,2,2735498,2742192,+,6694
519,BUMA.1121.00099,2,1226267,1232958,-,6691
519,BUMA.1121.00097,2,813631,820324,-,6693
519,BUMA.1121.00110,2,1420585,1427279,+,6694
519,BUMA.1121.00090,2,1953810,1960503,-,6693
519,BUMA.1121.00091,2,2656391,2663085,+,6694
519,BUMA.1121.00098,2,1221172,1227863,-,6691
519,BUMA.1121.00031,2,155131,161824,-,6693
519,BUMA.1121.00096,2,1179478,1186171,-,6693
519,BUMA.1121.00103,2,2879190,2885883,-,6693
519,BUMA.1121.00014,2,1088436,1095129,-,6693
519,BUMA.1121.00111,2,239766,246459,-,6693
519,BUMA.1121.00077,2,2714463,2721157,+,6694
519,BUMA.1121.00060,2,1232003,1238695,+,6692
519,BUMA.1121.00053,2,1251031,1257724,-,6693
519,BUMA.1121.00078,2,2200464,2207158,+,6694
519,BUMA.1121.00102,2,1014140,1020833,-,6693
519,BUMA.1121.00112,2,141836,148530,+,6694
519,BUMA.1121.00041,2,1906942,1913635,-,6693
519,BUMA.1121.00033,2,1703187,1709880,-,6693
519,BUMA.1121.00043,2,1397637,1404331,+,6694
519,BUMA.1121.00065,2,1010550,1017243,-,6693
519,BUMA.1121.00037,2,1326187,1332880,-,6693
519,BUMA.1121.00045,2,855170,861861,-,6691
519,BUMA.1121.00095,2,311266,317960,+,6694
519,BUMA.1121.00001,2,1238237,1244931,+,6694
519,BUMA.1121.00012,2,733919,740613,+,6694
520,BUMA.1121.00029,2,359506,366073,+,6567
520,BUMA.1121.00021,2,1472478,1479046,-,6568
520,BUMA.1121.00107,2,2885356,2891924,+,6568
520,BUMA.1121.00023,2,1049229,1055797,-,6568
520,BUMA.1121.00035,2,338052,344620,+,6568
520,BUMA.1121.00005,2,2393715,2400283,-,6568
520,BUMA.1121.00016,2,2745159,2751726,+,6567
520,BUMA.1121.00099,2,1216733,1223301,-,6568
520,BUMA.1121.00097,2,804097,810665,-,6568
520,BUMA.1121.00110,2,1430239,1436807,+,6568
520,BUMA.1121.00090,2,1944275,1950843,-,6568
520,BUMA.1121.00091,2,2666045,2672613,+,6568
520,BUMA.1121.00098,2,1211638,1218206,-,6568
520,BUMA.1121.00031,2,145596,152164,-,6568
520,BUMA.1121.00096,2,1169950,1176518,-,6568
520,BUMA.1121.00103,2,2869662,2876230,-,6568
520,BUMA.1121.00014,2,1078902,1085469,-,6567
520,BUMA.1121.00111,2,230339,236805,-,6466
520,BUMA.1121.00077,2,2724117,2730685,+,6568
520,BUMA.1121.00060,2,1241661,1248229,+,6568
520,BUMA.1121.00053,2,1241502,1248070,-,6568
520,BUMA.1121.00078,2,2210117,2216685,+,6568
520,BUMA.1121.00102,2,1003271,1009839,-,6568
520,BUMA.1121.00112,2,151497,158059,+,6562
520,BUMA.1121.00041,2,1897413,1903981,-,6568
520,BUMA.1121.00033,2,1693652,1700220,-,6568
520,BUMA.1121.00043,2,1407298,1413866,+,6568
520,BUMA.1121.00065,2,1001022,1007590,-,6568
520,BUMA.1121.00037,2,1316652,1323220,-,6568
520,BUMA.1121.00045,2,845636,852204,-,6568
520,BUMA.1121.00095,2,320921,327483,+,6562
520,BUMA.1121.00001,2,1247898,1254465,+,6567
520,BUMA.1121.00012,2,743580,750148,+,6568
521,BUMA.1121.00029,2,366385,379494,+,13109
521,BUMA.1121.00021,2,1460410,1472166,-,11756
521,BUMA.1121.00107,2,2892236,2903991,+,11755
521,BUMA.1121.00023,2,1037161,1048917,-,11756
521,BUMA.1121.00035,2,344932,356687,+,11755
521,BUMA.1121.00005,2,2381647,2393403,-,11756
521,BUMA.1121.00016,2,2752038,2763793,+,11755
521,BUMA.1121.00099,2,1204665,1216421,-,11756
521,BUMA.1121.00097,2,792029,803785,-,11756
521,BUMA.1121.00110,2,1437119,1448874,+,11755
521,BUMA.1121.00090,2,1932207,1943963,-,11756
521,BUMA.1121.00091,2,2672925,2684680,+,11755
521,BUMA.1121.00098,2,1199633,1211326,-,11693
521,BUMA.1121.00031,2,133528,145284,-,11756
521,BUMA.1121.00096,2,1157883,1169638,-,11755
521,BUMA.1121.00103,2,2857594,2869350,-,11756
521,BUMA.1121.00014,2,1066834,1078590,-,11756
521,BUMA.1121.00111,2,217330,229069,-,11739
521,BUMA.1121.00077,2,2730997,2742751,+,11754
521,BUMA.1121.00060,2,1248541,1260296,+,11755
521,BUMA.1121.00053,2,1229434,1241190,-,11756
521,BUMA.1121.00078,2,2216997,2228752,+,11755
521,BUMA.1121.00102,2,991203,1002959,-,11756
521,BUMA.1121.00112,2,158377,170132,+,11755
521,BUMA.1121.00041,2,1885345,1897101,-,11756
521,BUMA.1121.00033,2,1681600,1693340,-,11740
521,BUMA.1121.00043,2,1414178,1425933,+,11755
521,BUMA.1121.00065,2,988955,1000710,-,11755
521,BUMA.1121.00037,2,1304584,1316340,-,11756
521,BUMA.1121.00045,2,833568,845324,-,11756
521,BUMA.1121.00095,2,327801,339556,+,11755
521,BUMA.1121.00001,2,1254777,1266532,+,11755
521,BUMA.1121.00012,2,750460,762215,+,11755
522,BUMA.1121.00029,2,3071827,3076553,+,4726
522,BUMA.1121.00021,2,2031740,2036465,-,4725
522,BUMA.1121.00035,2,3089109,3093835,+,4726
522,BUMA.1121.00033,2,2250759,2255482,-,4723
522,BUMA.1121.00043,2,807694,812420,+,4726
522,BUMA.1121.00001,2,693414,698140,+,4726
522,BUMA.1121.00012,2,174465,179191,+,4726
523,BUMA.1121.00107,2,1419926,1427701,+,7775
523,BUMA.1121.00101,2,1040157,1047928,+,7771
524,BUMA.1121.00107,2,2413884,2417060,+,3176
524,BUMA.1121.00100,2,2534982,2538159,-,3177
524,BUMA.1121.00103,2,3350669,3353846,-,3177
524,BUMA.1121.00007,2,1471382,1474559,-,3177
524,BUMA.1121.00095,2,3195989,3199180,+,3191
525,BUMA.1121.00023,2,1620605,1623729,+,3124
525,BUMA.1121.00088,1,2843135,2846259,-,3124
525,BUMA.1121.00090,2,2623142,2626264,+,3122
525,BUMA.1121.00053,1,1660397,1663521,-,3124
525,BUMA.1121.00112,1,1067143,1070267,+,3124
525,BUMA.1121.00111,2,779713,782837,+,3124
525,BUMA.1121.00033,2,2272237,2275359,-,3122
525,BUMA.1121.00033,2,2395310,2398431,-,3121
525,BUMA.1121.00043,2,787818,790940,+,3122
525,BUMA.1121.00039,1,2080328,2083452,-,3124
525,BUMA.1121.00084,1,2300835,2303959,-,3124
525,BUMA.1121.00049,1,3939606,3942730,+,3124
525,BUMA.1121.00090,1,11393,14517,-,3124
525,BUMA.1121.00102,1,3384300,3387424,+,3124
525,BUMA.1121.00075,1,1432278,1435402,-,3124
525,BUMA.1121.00076,1,3377522,3380646,+,3124
525,BUMA.1121.00111,1,2138132,2141256,-,3124
525,BUMA.1121.00012,2,154589,157711,+,3122
525,BUMA.1121.00005,1,653551,656675,-,3124
525,BUMA.1121.00105,1,3286169,3289293,+,3124
525,BUMA.1121.00041,1,3251119,3254243,-,3124
526,BUMA.1121.00067,2,1715458,1726321,+,10863
526,BUMA.1121.00110,2,2168551,2179024,-,10473
526,BUMA.1121.00027,2,122827,133515,-,10688
526,BUMA.1121.00077,2,1437058,1447531,+,10473
526,BUMA.1121.00080,2,2259578,2270520,-,10942
527,BUMA.1121.00067,2,1729280,1740182,+,10902
527,BUMA.1121.00110,2,2154099,2165492,-,11393
527,BUMA.1121.00027,2,108966,119868,-,10902
527,BUMA.1121.00077,2,1450590,1461982,+,11392
527,BUMA.1121.00080,2,2245915,2256818,-,10903
528,BUMA.1121.00088,1,738727,743943,+,5216
528,BUMA.1121.00106,1,3655991,3661204,+,5213
529,BUMA.1121.00088,1,2016139,2022183,+,6044
529,BUMA.1121.00047,1,1837502,1843546,-,6044
530,BUMA.1121.00035,2,441426,445502,+,4076
530,BUMA.1121.00016,2,2846838,2849861,+,3023
531,BUMA.1121.00035,2,456717,483738,+,27021
531,BUMA.1121.00016,2,2863585,2891388,+,27803
531,BUMA.1121.00012,1,35765,64088,-,28323
532,BUMA.1121.00035,2,932285,935908,+,3623
532,BUMA.1121.00001,2,1734952,1738579,+,3627
533,BUMA.1121.00005,2,368705,372881,+,4176
533,BUMA.1121.00091,2,88659,92836,+,4177
534,BUMA.1121.00005,2,374298,384018,+,9720
534,BUMA.1121.00091,2,98436,108156,+,9720
535,BUMA.1121.00005,2,386423,389913,+,3490
535,BUMA.1121.00091,2,110561,114051,+,3490
536,BUMA.1121.00005,2,390068,394433,+,4365
536,BUMA.1121.00091,2,114206,118571,+,4365
536,BUMA.1121.00103,2,625265,629596,-,4331
536,BUMA.1121.00095,2,871998,876349,-,4351
537,BUMA.1121.00005,2,3035460,3052157,+,16697
537,BUMA.1121.00041,2,2543984,2560681,+,16697
538,BUMA.1121.00092,1,3289652,3294581,+,4929
538,BUMA.1121.00074,1,3287017,3291946,+,4929
538,BUMA.1121.00093,1,1331845,1336773,-,4928
538,BUMA.1121.00080,1,615779,620707,-,4928
538,BUMA.1121.00067,1,3810731,3815660,+,4929
538,BUMA.1121.00098,1,3292899,3297842,-,4943
539,BUMA.1121.00092,1,3958039,3961386,+,3347
539,BUMA.1121.00093,1,665088,668434,-,3346
540,BUMA.1121.00100,2,394331,403124,+,8793
540,BUMA.1121.00075,2,469908,478701,-,8793
540,BUMA.1121.00078,2,766158,774951,-,8793
540,BUMA.1121.00068,2,954661,963454,+,8793
540,BUMA.1121.00076,2,118767,127560,+,8793
540,BUMA.1121.00108,2,2612454,2621247,+,8793
540,BUMA.1121.00012,2,2563853,2572636,-,8783
541,BUMA.1121.00100,2,1633585,1637590,+,4005
541,BUMA.1121.00098,2,727717,731722,+,4005
